"","Munic√≠pio","0 a 2","3 a 5","6 a 7","8 a 10","Ignorado","Total","Ano"
"1","TOTAL",8380,13356,51555,2683192,105385,2861868,"2010"
"2","110001 ALTA FLORESTA D'OESTE",1,2,9,438,2,452,"2010"
"3","110002 ARIQUEMES",2,5,17,1608,1,1633,"2010"
"4","110003 CABIXI",0,0,2,94,0,96,"2010"
"5","110004 CACOAL",3,3,16,1150,6,1178,"2010"
"6","110005 CEREJEIRAS",1,3,5,212,19,240,"2010"
"7","110006 COLORADO DO OESTE",0,2,4,239,17,262,"2010"
"8","110007 CORUMBIARA",1,1,1,111,17,131,"2010"
"9","110008 COSTA MARQUES",0,2,8,252,1,263,"2010"
"10","110009 ESPIGAO D'OESTE",3,2,9,478,3,495,"2010"
"11","110010 GUAJARA-MIRIM",6,3,14,857,2,882,"2010"
"12","110011 JARU",3,3,11,801,1,819,"2010"
"13","110012 JI-PARANA",3,4,25,1498,5,1535,"2010"
"14","110013 MACHADINHO D'OESTE",1,1,4,495,0,501,"2010"
"15","110014 NOVA BRASILANDIA D'OESTE",1,1,13,310,0,325,"2010"
"16","110015 OURO PRETO DO OESTE",1,2,9,643,0,655,"2010"
"17","110018 PIMENTA BUENO",2,7,23,571,1,604,"2010"
"18","110020 PORTO VELHO",11,16,134,7844,84,8089,"2010"
"19","110025 PRESIDENTE MEDICI",0,1,9,172,1,183,"2010"
"20","110026 RIO CRESPO",0,0,1,38,0,39,"2010"
"21","110028 ROLIM DE MOURA",1,1,8,780,3,793,"2010"
"22","110029 SANTA LUZIA D'OESTE",0,0,2,125,0,127,"2010"
"23","110030 VILHENA",5,2,14,1142,141,1304,"2010"
"24","110032 SAO MIGUEL DO GUAPORE",3,0,18,166,65,252,"2010"
"25","110033 NOVA MAMORE",1,5,17,392,2,417,"2010"
"26","110034 ALVORADA D'OESTE",1,3,5,178,3,190,"2010"
"27","110037 ALTO ALEGRE DOS PARECIS",1,4,5,194,0,204,"2010"
"28","110040 ALTO PARAISO",1,1,7,272,1,282,"2010"
"29","110045 BURITIS",1,3,4,647,1,656,"2010"
"30","110050 NOVO HORIZONTE DO OESTE",0,0,0,149,0,149,"2010"
"31","110060 CACAULANDIA",0,0,0,70,0,70,"2010"
"32","110070 CAMPO NOVO DE RONDONIA",2,0,3,178,0,183,"2010"
"33","110080 CANDEIAS DO JAMARI",0,1,6,349,9,365,"2010"
"34","110090 CASTANHEIRAS",0,1,2,50,0,53,"2010"
"35","110092 CHUPINGUAIA",1,0,1,108,13,123,"2010"
"36","110094 CUJUBIM",1,0,1,210,3,215,"2010"
"37","110100 GOVERNADOR JORGE TEIXEIRA",0,0,0,165,0,165,"2010"
"38","110110 ITAPUA DO OESTE",0,1,1,111,1,114,"2010"
"39","110120 MINISTRO ANDREAZZA",1,1,1,109,0,112,"2010"
"40","110130 MIRANTE DA SERRA",1,0,8,182,0,191,"2010"
"41","110140 MONTE NEGRO",1,0,8,213,0,222,"2010"
"42","110143 NOVA UNIAO",0,0,3,101,0,104,"2010"
"43","110145 PARECIS",0,0,2,69,0,71,"2010"
"44","110146 PIMENTEIRAS DO OESTE",0,0,0,41,4,45,"2010"
"45","110147 PRIMAVERA DE RONDONIA",0,0,1,47,0,48,"2010"
"46","110148 SAO FELIPE D'OESTE",0,0,0,75,0,75,"2010"
"47","110149 SAO FRANCISCO DO GUAPORE",1,3,6,245,0,255,"2010"
"48","110150 SERINGUEIRAS",0,1,3,189,1,194,"2010"
"49","110155 TEIXEIROPOLIS",1,0,0,50,0,51,"2010"
"50","110160 THEOBROMA",0,0,1,133,1,135,"2010"
"51","110170 URUPA",0,1,2,108,0,111,"2010"
"52","110175 VALE DO ANARI",0,0,3,77,0,80,"2010"
"53","110180 VALE DO PARAISO",0,0,2,94,1,97,"2010"
"54","120001 ACRELANDIA",0,1,5,212,16,234,"2010"
"55","120005 ASSIS BRASIL",1,3,6,160,82,252,"2010"
"56","120010 BRASILEIA",0,1,10,442,22,475,"2010"
"57","120013 BUJARI",0,0,3,168,14,185,"2010"
"58","120017 CAPIXABA",0,3,3,168,17,191,"2010"
"59","120020 CRUZEIRO DO SUL",1,7,20,1335,361,1724,"2010"
"60","120025 EPITACIOLANDIA",2,2,4,231,14,253,"2010"
"61","120030 FEIJO",1,1,2,751,172,927,"2010"
"62","120032 JORDAO",0,1,0,73,185,259,"2010"
"63","120033 MANCIO LIMA",0,1,4,343,61,409,"2010"
"64","120034 MANOEL URBANO",0,0,4,155,53,212,"2010"
"65","120035 MARECHAL THAUMATURGO",0,1,1,137,280,419,"2010"
"66","120038 PLACIDO DE CASTRO",0,1,4,306,25,336,"2010"
"67","120039 PORTO WALTER",1,1,7,213,129,351,"2010"
"68","120040 RIO BRANCO",5,14,50,5932,436,6437,"2010"
"69","120042 RODRIGUES ALVES",1,2,7,330,116,456,"2010"
"70","120043 SANTA ROSA DO PURUS",0,0,3,45,157,205,"2010"
"71","120045 SENADOR GUIOMARD",0,0,5,328,31,364,"2010"
"72","120050 SENA MADUREIRA",1,6,7,848,99,961,"2010"
"73","120060 TARAUACA",2,3,15,982,212,1214,"2010"
"74","120070 XAPURI",0,3,17,248,30,298,"2010"
"75","120080 PORTO ACRE",0,2,6,293,32,333,"2010"
"76","MUNICIPIO IGNORADO - AM",0,0,0,2,0,2,"2010"
"77","130002 ALVARAES",5,1,4,270,1,281,"2010"
"78","130006 AMATURA",0,1,2,117,110,230,"2010"
"79","130008 ANAMA",0,0,0,169,13,182,"2010"
"80","130010 ANORI",0,1,2,10,231,244,"2010"
"81","130014 APUI",2,2,5,223,3,235,"2010"
"82","130020 ATALAIA DO NORTE",0,1,6,251,2,260,"2010"
"83","130030 AUTAZES",2,4,18,643,132,799,"2010"
"84","130040 BARCELOS",0,0,7,230,25,262,"2010"
"85","130050 BARREIRINHA",1,0,2,649,35,687,"2010"
"86","130060 BENJAMIN CONSTANT",4,2,5,926,3,940,"2010"
"87","130063 BERURI",0,0,11,387,10,408,"2010"
"88","130068 BOA VISTA DO RAMOS",0,1,4,348,11,364,"2010"
"89","130070 BOCA DO ACRE",2,2,9,647,9,669,"2010"
"90","130080 BORBA",0,8,28,569,135,740,"2010"
"91","130083 CAAPIRANGA",0,0,1,140,52,193,"2010"
"92","130090 CANUTAMA",0,1,1,184,1,187,"2010"
"93","130100 CARAUARI",2,0,5,590,1,598,"2010"
"94","130110 CAREIRO",1,0,4,354,38,397,"2010"
"95","130115 CAREIRO DA VARZEA",1,1,2,163,52,219,"2010"
"96","130120 COARI",1,8,16,1679,1,1705,"2010"
"97","130130 CODAJAS",0,3,5,432,4,444,"2010"
"98","130140 EIRUNEPE",9,2,20,652,107,790,"2010"
"99","130150 ENVIRA",5,0,2,282,0,289,"2010"
"100","130160 FONTE BOA",1,2,7,460,1,471,"2010"
"101","130165 GUAJARA",0,1,6,307,50,364,"2010"
"102","130170 HUMAITA",1,5,7,806,10,829,"2010"
"103","130180 IPIXUNA",0,1,0,263,116,380,"2010"
"104","130185 IRANDUBA",1,1,10,856,11,879,"2010"
"105","130190 ITACOATIARA",4,4,18,1883,142,2051,"2010"
"106","130195 ITAMARATI",2,5,2,157,17,183,"2010"
"107","130200 ITAPIRANGA",0,1,2,181,6,190,"2010"
"108","130210 JAPURA",0,1,3,90,23,117,"2010"
"109","130220 JURUA",0,2,26,59,96,183,"2010"
"110","130230 JUTAI",1,0,4,239,77,321,"2010"
"111","130240 LABREA",0,0,4,698,0,702,"2010"
"112","130250 MANACAPURU",3,7,38,1738,161,1947,"2010"
"113","130255 MANAQUIRI",0,2,5,180,5,192,"2010"
"114","130260 MANAUS",67,135,463,38394,291,39350,"2010"
"115","130270 MANICORE",1,3,39,555,186,784,"2010"
"116","130280 MARAA",0,0,0,347,0,347,"2010"
"117","130290 MAUES",1,6,13,958,302,1280,"2010"
"118","130300 NHAMUNDA",0,3,14,273,3,293,"2010"
"119","130310 NOVA OLINDA DO NORTE",1,1,3,449,122,576,"2010"
"120","130320 NOVO AIRAO",1,1,2,255,3,262,"2010"
"121","130330 NOVO ARIPUANA",0,0,11,349,35,395,"2010"
"122","130340 PARINTINS",5,8,23,2104,14,2154,"2010"
"123","130350 PAUINI",0,1,4,245,14,264,"2010"
"124","130353 PRESIDENTE FIGUEIREDO",5,4,9,493,0,511,"2010"
"125","130356 RIO PRETO DA EVA",3,2,10,365,8,388,"2010"
"126","130360 SANTA ISABEL DO RIO NEGRO",0,0,9,168,133,310,"2010"
"127","130370 SANTO ANTONIO DO ICA",1,1,1,395,125,523,"2010"
"128","130380 SAO GABRIEL DA CACHOEIRA",1,0,3,430,490,924,"2010"
"129","130390 SAO PAULO DE OLIVENCA",0,0,0,7,776,783,"2010"
"130","130395 SAO SEBASTIAO DO UATUMA",3,0,1,164,1,169,"2010"
"131","130400 SILVES",1,1,1,186,16,205,"2010"
"132","130406 TABATINGA",2,6,9,968,403,1388,"2010"
"133","130410 TAPAUA",1,3,5,366,25,400,"2010"
"134","130420 TEFE",7,3,13,1526,110,1659,"2010"
"135","130423 TONANTINS",1,0,1,247,72,321,"2010"
"136","130426 UARINI",0,0,20,120,184,324,"2010"
"137","130430 URUCARA",1,1,12,262,30,306,"2010"
"138","130440 URUCURITUBA",0,0,3,273,62,338,"2010"
"139","140002 AMAJARI",2,1,1,118,140,262,"2010"
"140","140005 ALTO ALEGRE",1,1,3,203,368,576,"2010"
"141","140010 BOA VISTA",31,9,46,5913,40,6039,"2010"
"142","140015 BONFIM",1,0,1,222,17,241,"2010"
"143","140017 CANTA",2,0,5,251,20,278,"2010"
"144","140020 CARACARAI",2,3,6,306,49,366,"2010"
"145","140023 CAROEBE",1,1,2,163,1,168,"2010"
"146","140028 IRACEMA",1,1,0,111,41,154,"2010"
"147","140030 MUCAJAI",1,0,2,297,11,311,"2010"
"148","140040 NORMANDIA",0,1,4,215,21,241,"2010"
"149","140045 PACARAIMA",1,0,2,255,7,265,"2010"
"150","140047 RORAINOPOLIS",1,5,6,346,8,366,"2010"
"151","140050 SAO JOAO DA BALIZA",2,1,2,131,1,137,"2010"
"152","140060 SAO LUIZ",0,0,2,79,3,84,"2010"
"153","140070 UIRAMUTA",2,0,2,206,40,250,"2010"
"154","MUNICIPIO IGNORADO - PA",0,0,0,1,0,1,"2010"
"155","150010 ABAETETUBA",7,17,63,2477,30,2594,"2010"
"156","150013 ABEL FIGUEIREDO",0,0,4,108,0,112,"2010"
"157","150020 ACARA",2,3,8,795,3,811,"2010"
"158","150030 AFUA",3,2,11,643,9,668,"2010"
"159","150034 AGUA AZUL DO NORTE",0,0,7,175,1,183,"2010"
"160","150040 ALENQUER",2,4,11,1063,69,1149,"2010"
"161","150050 ALMEIRIM",1,3,29,689,1,723,"2010"
"162","150060 ALTAMIRA",6,7,41,1950,40,2044,"2010"
"163","150070 ANAJAS",1,8,18,509,77,613,"2010"
"164","150080 ANANINDEUA",12,39,100,9419,5,9575,"2010"
"165","150085 ANAPU",0,2,10,369,14,395,"2010"
"166","150090 AUGUSTO CORREA",4,13,14,869,209,1109,"2010"
"167","150095 AURORA DO PARA",5,6,19,366,26,422,"2010"
"168","150100 AVEIRO",1,4,19,148,57,229,"2010"
"169","150110 BAGRE",1,2,7,153,327,490,"2010"
"170","150120 BAIAO",4,2,7,491,82,586,"2010"
"171","150125 BANNACH",0,0,1,45,1,47,"2010"
"172","150130 BARCARENA",4,9,60,1901,12,1986,"2010"
"173","150140 BELEM",72,67,275,21663,36,22113,"2010"
"174","150145 BELTERRA",0,1,4,184,10,199,"2010"
"175","150150 BENEVIDES",4,4,260,715,2,985,"2010"
"176","150157 BOM JESUS DO TOCANTINS",1,0,5,236,0,242,"2010"
"177","150160 BONITO",0,1,3,194,7,205,"2010"
"178","150170 BRAGANCA",3,25,34,2079,125,2266,"2010"
"179","150172 BRASIL NOVO",1,7,17,261,0,286,"2010"
"180","150175 BREJO GRANDE DO ARAGUAIA",0,1,1,134,5,141,"2010"
"181","150178 BREU BRANCO",1,7,31,721,107,867,"2010"
"182","150180 BREVES",13,23,105,1787,3,1931,"2010"
"183","150190 BUJARU",2,2,48,388,78,518,"2010"
"184","150195 CACHOEIRA DO PIRIA",1,3,4,240,55,303,"2010"
"185","150200 CACHOEIRA DO ARARI",2,1,2,252,0,257,"2010"
"186","150210 CAMETA",3,11,30,1067,1554,2665,"2010"
"187","150215 CANAA DOS CARAJAS",2,5,32,636,3,678,"2010"
"188","150220 CAPANEMA",1,3,3,1142,28,1177,"2010"
"189","150230 CAPITAO POCO",9,2,12,756,24,803,"2010"
"190","150240 CASTANHAL",8,6,152,3237,4,3407,"2010"
"191","150250 CHAVES",0,1,3,165,96,265,"2010"
"192","150260 COLARES",1,0,2,116,45,164,"2010"
"193","150270 CONCEICAO DO ARAGUAIA",2,4,12,795,0,813,"2010"
"194","150275 CONCORDIA DO PARA",1,3,34,450,2,490,"2010"
"195","150276 CUMARU DO NORTE",0,0,1,115,15,131,"2010"
"196","150277 CURIONOPOLIS",0,2,20,298,0,320,"2010"
"197","150280 CURRALINHO",10,8,25,482,26,551,"2010"
"198","150285 CURUA",0,1,1,126,117,245,"2010"
"199","150290 CURUCA",2,2,19,472,13,508,"2010"
"200","150293 DOM ELISEU",1,4,18,768,4,795,"2010"
"201","150295 ELDORADO DOS CARAJAS",1,3,25,604,2,635,"2010"
"202","150300 FARO",0,1,6,136,7,150,"2010"
"203","150304 FLORESTA DO ARAGUAIA",1,1,5,292,2,301,"2010"
"204","150307 GARRAFAO DO NORTE",1,1,9,420,76,507,"2010"
"205","150309 GOIANESIA DO PARA",1,4,22,639,14,680,"2010"
"206","150310 GURUPA",2,6,14,509,108,639,"2010"
"207","150320 IGARAPE-ACU",0,3,44,552,7,606,"2010"
"208","150330 IGARAPE-MIRI",6,9,41,1165,78,1299,"2010"
"209","150340 INHANGAPI",0,0,12,145,1,158,"2010"
"210","150345 IPIXUNA DO PARA",3,21,54,464,52,594,"2010"
"211","150350 IRITUIA",3,1,23,427,69,523,"2010"
"212","150360 ITAITUBA",11,22,296,1675,18,2022,"2010"
"213","150370 ITUPIRANGA",2,6,13,993,39,1053,"2010"
"214","150375 JACAREACANGA",2,1,5,228,114,350,"2010"
"215","150380 JACUNDA",3,9,9,977,13,1011,"2010"
"216","150390 JURUTI",3,11,29,919,97,1059,"2010"
"217","150400 LIMOEIRO DO AJURU",0,1,27,490,8,526,"2010"
"218","150405 MAE DO RIO",0,3,14,638,1,656,"2010"
"219","150410 MAGALHAES BARATA",0,1,5,90,11,107,"2010"
"220","150420 MARABA",19,25,51,4871,20,4986,"2010"
"221","150430 MARACANA",0,1,20,335,77,433,"2010"
"222","150440 MARAPANIM",2,1,20,313,34,370,"2010"
"223","150442 MARITUBA",4,8,16,1436,5,1469,"2010"
"224","150445 MEDICILANDIA",5,4,11,471,1,492,"2010"
"225","150450 MELGACO",5,9,11,285,326,636,"2010"
"226","150460 MOCAJUBA",0,5,3,484,27,519,"2010"
"227","150470 MOJU",5,9,39,1133,109,1295,"2010"
"228","150480 MONTE ALEGRE",1,21,43,904,1,970,"2010"
"229","150490 MUANA",1,1,8,491,1,502,"2010"
"230","150495 NOVA ESPERANCA DO PIRIA",1,0,6,380,35,422,"2010"
"231","150497 NOVA IPIXUNA",0,0,2,216,13,231,"2010"
"232","150500 NOVA TIMBOTEUA",0,0,4,147,4,155,"2010"
"233","150503 NOVO PROGRESSO",4,5,6,381,4,400,"2010"
"234","150506 NOVO REPARTIMENTO",1,9,12,1340,19,1381,"2010"
"235","150510 OBIDOS",1,5,19,812,187,1024,"2010"
"236","150520 OEIRAS DO PARA",5,6,22,480,227,740,"2010"
"237","150530 ORIXIMINA",3,9,41,1371,72,1496,"2010"
"238","150540 OUREM",0,2,4,318,9,333,"2010"
"239","150543 OURILANDIA DO NORTE",3,3,1,543,0,550,"2010"
"240","150548 PACAJA",4,0,21,646,12,683,"2010"
"241","150549 PALESTINA DO PARA",2,2,1,150,2,157,"2010"
"242","150550 PARAGOMINAS",6,5,31,2050,4,2096,"2010"
"243","150553 PARAUAPEBAS",11,23,181,3617,8,3840,"2010"
"244","150555 PAU D'ARCO",0,0,7,127,0,134,"2010"
"245","150560 PEIXE-BOI",0,0,1,108,0,109,"2010"
"246","150563 PICARRA",0,0,5,168,1,174,"2010"
"247","150565 PLACAS",2,6,15,222,0,245,"2010"
"248","150570 PONTA DE PEDRAS",3,1,1,302,2,309,"2010"
"249","150580 PORTEL",3,3,13,963,110,1092,"2010"
"250","150590 PORTO DE MOZ",5,2,15,645,5,672,"2010"
"251","150600 PRAINHA",3,7,17,495,156,678,"2010"
"252","150610 PRIMAVERA",0,0,2,106,63,171,"2010"
"253","150611 QUATIPURU",0,0,3,144,23,170,"2010"
"254","150613 REDENCAO",4,8,19,1590,6,1627,"2010"
"255","150616 RIO MARIA",2,1,5,346,0,354,"2010"
"256","150618 RONDON DO PARA",3,8,50,785,3,849,"2010"
"257","150619 RUROPOLIS",1,2,28,399,2,432,"2010"
"258","150620 SALINOPOLIS",1,1,12,639,3,656,"2010"
"259","150630 SALVATERRA",0,1,5,347,2,355,"2010"
"260","150635 SANTA BARBARA DO PARA",0,2,62,258,1,323,"2010"
"261","150640 SANTA CRUZ DO ARARI",0,1,17,50,5,73,"2010"
"262","150650 SANTA IZABEL DO PARA",5,7,55,865,7,939,"2010"
"263","150655 SANTA LUZIA DO PARA",1,1,4,398,9,413,"2010"
"264","150658 SANTA MARIA DAS BARREIRAS",0,2,1,221,0,224,"2010"
"265","150660 SANTA MARIA DO PARA",1,0,12,432,0,445,"2010"
"266","150670 SANTANA DO ARAGUAIA",2,2,9,578,0,591,"2010"
"267","150680 SANTAREM",28,53,234,5767,596,6678,"2010"
"268","150690 SANTAREM NOVO",0,0,5,103,12,120,"2010"
"269","150700 SANTO ANTONIO DO TAUA",0,0,5,388,34,427,"2010"
"270","150710 SAO CAETANO DE ODIVELAS",1,2,5,204,9,221,"2010"
"271","150715 SAO DOMINGOS DO ARAGUAIA",0,1,2,420,2,425,"2010"
"272","150720 SAO DOMINGOS DO CAPIM",0,1,29,554,38,622,"2010"
"273","150730 SAO FELIX DO XINGU",1,3,15,928,6,953,"2010"
"274","150740 SAO FRANCISCO DO PARA",0,0,14,226,1,241,"2010"
"275","150745 SAO GERALDO DO ARAGUAIA",2,4,13,502,0,521,"2010"
"276","150746 SAO JOAO DA PONTA",0,0,2,64,15,81,"2010"
"277","150747 SAO JOAO DE PIRABAS",3,1,7,362,6,379,"2010"
"278","150750 SAO JOAO DO ARAGUAIA",0,1,2,199,5,207,"2010"
"279","150760 SAO MIGUEL DO GUAMA",4,3,48,991,18,1064,"2010"
"280","150770 SAO SEBASTIAO DA BOA VISTA",1,5,26,457,4,493,"2010"
"281","150775 SAPUCAIA",0,0,1,75,0,76,"2010"
"282","150780 SENADOR JOSE PORFIRIO",3,2,4,243,9,261,"2010"
"283","150790 SOURE",2,1,2,434,0,439,"2010"
"284","150795 TAILANDIA",2,5,13,1360,22,1402,"2010"
"285","150796 TERRA ALTA",1,0,14,170,0,185,"2010"
"286","150797 TERRA SANTA",1,2,14,255,1,273,"2010"
"287","150800 TOME-ACU",3,20,138,1102,1,1264,"2010"
"288","150803 TRACUATEUA",1,5,10,604,23,643,"2010"
"289","150805 TRAIRAO",0,4,23,188,0,215,"2010"
"290","150808 TUCUMA",0,1,5,663,1,670,"2010"
"291","150810 TUCURUI",2,11,45,1636,490,2184,"2010"
"292","150812 ULIANOPOLIS",1,1,17,424,3,446,"2010"
"293","150815 URUARA",3,3,12,793,3,814,"2010"
"294","150820 VIGIA",4,4,18,750,0,776,"2010"
"295","150830 VISEU",3,2,11,835,573,1424,"2010"
"296","150835 VITORIA DO XINGU",0,2,6,175,0,183,"2010"
"297","150840 XINGUARA",0,5,20,820,2,847,"2010"
"298","MUNICIPIO IGNORADO - AP",0,0,0,1,0,1,"2010"
"299","160005 SERRA DO NAVIO",0,0,1,72,0,73,"2010"
"300","160010 AMAPA",5,0,2,130,7,144,"2010"
"301","160015 PEDRA BRANCA DO AMAPARI",0,1,5,128,3,137,"2010"
"302","160020 CALCOENE",0,3,16,175,23,217,"2010"
"303","160021 CUTIAS",1,1,0,64,10,76,"2010"
"304","160023 FERREIRA GOMES",0,2,3,101,1,107,"2010"
"305","160025 ITAUBAL",0,1,0,50,15,66,"2010"
"306","160027 LARANJAL DO JARI",2,2,23,898,0,925,"2010"
"307","160030 MACAPA",46,47,138,9022,49,9302,"2010"
"308","160040 MAZAGAO",4,0,6,331,70,411,"2010"
"309","160050 OIAPOQUE",0,4,5,379,33,421,"2010"
"310","160053 PORTO GRANDE",1,2,4,307,4,318,"2010"
"311","160055 PRACUUBA",1,0,0,41,31,73,"2010"
"312","160060 SANTANA",12,10,37,2179,2,2240,"2010"
"313","160070 TARTARUGALZINHO",0,1,6,234,5,246,"2010"
"314","160080 VITORIA DO JARI",0,0,0,247,4,251,"2010"
"315","MUNICIPIO IGNORADO - TO",0,0,0,2,0,2,"2010"
"316","170025 ABREULANDIA",0,0,0,40,0,40,"2010"
"317","170030 AGUIARNOPOLIS",0,1,3,103,1,108,"2010"
"318","170035 ALIANCA DO TOCANTINS",0,0,1,70,0,71,"2010"
"319","170040 ALMAS",0,1,3,149,1,154,"2010"
"320","170070 ALVORADA",1,1,2,127,0,131,"2010"
"321","170100 ANANAS",2,1,1,169,0,173,"2010"
"322","170105 ANGICO",0,0,2,40,0,42,"2010"
"323","170110 APARECIDA DO RIO NEGRO",0,1,1,69,7,78,"2010"
"324","170130 ARAGOMINAS",0,1,1,72,0,74,"2010"
"325","170190 ARAGUACEMA",0,0,1,105,0,106,"2010"
"326","170200 ARAGUACU",0,0,16,90,0,106,"2010"
"327","170210 ARAGUAINA",4,4,66,2896,2,2972,"2010"
"328","170215 ARAGUANA",0,0,0,116,0,116,"2010"
"329","170220 ARAGUATINS",0,0,4,204,355,563,"2010"
"330","170230 ARAPOEMA",0,2,1,99,0,102,"2010"
"331","170240 ARRAIAS",1,0,7,173,2,183,"2010"
"332","170255 AUGUSTINOPOLIS",0,0,1,50,325,376,"2010"
"333","170270 AURORA DO TOCANTINS",0,0,2,29,0,31,"2010"
"334","170290 AXIXA DO TOCANTINS",0,0,2,31,181,214,"2010"
"335","170300 BABACULANDIA",0,1,2,129,1,133,"2010"
"336","170305 BANDEIRANTES DO TOCANTINS",0,0,1,41,0,42,"2010"
"337","170307 BARRA DO OURO",0,0,4,75,0,79,"2010"
"338","170310 BARROLANDIA",0,0,1,66,0,67,"2010"
"339","170320 BERNARDO SAYAO",0,0,2,68,0,70,"2010"
"340","170330 BOM JESUS DO TOCANTINS",0,0,0,60,0,60,"2010"
"341","170360 BRASILANDIA DO TOCANTINS",1,0,0,32,0,33,"2010"
"342","170370 BREJINHO DE NAZARE",0,0,1,91,0,92,"2010"
"343","170380 BURITI DO TOCANTINS",1,0,1,27,150,179,"2010"
"344","170382 CACHOEIRINHA",0,0,2,12,32,46,"2010"
"345","170384 CAMPOS LINDOS",1,0,1,106,30,138,"2010"
"346","170386 CARIRI DO TOCANTINS",0,0,0,40,0,40,"2010"
"347","170388 CARMOLANDIA",0,0,1,30,0,31,"2010"
"348","170389 CARRASCO BONITO",0,0,1,9,81,91,"2010"
"349","170390 CASEARA",0,0,0,82,0,82,"2010"
"350","170410 CENTENARIO",0,0,0,32,0,32,"2010"
"351","170460 CHAPADA DE AREIA",0,0,0,25,0,25,"2010"
"352","170510 CHAPADA DA NATIVIDADE",0,0,0,60,1,61,"2010"
"353","170550 COLINAS DO TOCANTINS",1,3,15,576,0,595,"2010"
"354","170555 COMBINADO",0,0,0,57,2,59,"2010"
"355","170560 CONCEICAO DO TOCANTINS",0,1,0,49,0,50,"2010"
"356","170600 COUTO MAGALHAES",1,0,5,62,2,70,"2010"
"357","170610 CRISTALANDIA",0,0,2,115,1,118,"2010"
"358","170625 CRIXAS DO TOCANTINS",0,0,0,23,0,23,"2010"
"359","170650 DARCINOPOLIS",0,2,0,85,2,89,"2010"
"360","170700 DIANOPOLIS",4,0,12,329,3,348,"2010"
"361","170710 DIVINOPOLIS DO TOCANTINS",0,0,2,108,0,110,"2010"
"362","170720 DOIS IRMAOS DO TOCANTINS",0,0,0,74,0,74,"2010"
"363","170730 DUERE",1,0,0,44,0,45,"2010"
"364","170740 ESPERANTINA",0,1,4,37,142,184,"2010"
"365","170755 FATIMA",1,0,1,46,0,48,"2010"
"366","170765 FIGUEIROPOLIS",0,0,2,62,0,64,"2010"
"367","170770 FILADELFIA",0,1,2,143,0,146,"2010"
"368","170820 FORMOSO DO ARAGUAIA",1,1,4,295,3,304,"2010"
"369","170825 FORTALEZA DO TABOCAO",0,0,0,37,0,37,"2010"
"370","170830 GOIANORTE",0,0,2,59,0,61,"2010"
"371","170900 GOIATINS",1,4,8,253,1,267,"2010"
"372","170930 GUARAI",0,3,10,406,0,419,"2010"
"373","170950 GURUPI",2,2,10,1292,0,1306,"2010"
"374","170980 IPUEIRAS",0,0,1,35,0,36,"2010"
"375","171050 ITACAJA",0,2,5,135,0,142,"2010"
"376","171070 ITAGUATINS",0,0,2,37,76,115,"2010"
"377","171090 ITAPIRATINS",0,0,1,46,1,48,"2010"
"378","171110 ITAPORA DO TOCANTINS",0,0,0,41,0,41,"2010"
"379","171150 JAU DO TOCANTINS",1,0,1,39,0,41,"2010"
"380","171180 JUARINA",0,0,0,32,0,32,"2010"
"381","171190 LAGOA DA CONFUSAO",0,1,1,170,4,176,"2010"
"382","171195 LAGOA DO TOCANTINS",0,0,1,67,4,72,"2010"
"383","171200 LAJEADO",0,0,1,45,0,46,"2010"
"384","171215 LAVANDEIRA",0,0,0,17,0,17,"2010"
"385","171240 LIZARDA",0,0,1,51,3,55,"2010"
"386","171245 LUZINOPOLIS",0,0,0,57,3,60,"2010"
"387","171250 MARIANOPOLIS DO TOCANTINS",0,0,0,60,0,60,"2010"
"388","171270 MATEIROS",0,0,0,32,6,38,"2010"
"389","171280 MAURILANDIA DO TOCANTINS",0,0,0,41,15,56,"2010"
"390","171320 MIRACEMA DO TOCANTINS",0,3,7,387,1,398,"2010"
"391","171330 MIRANORTE",1,1,1,178,1,182,"2010"
"392","171360 MONTE DO CARMO",0,3,4,99,2,108,"2010"
"393","171370 MONTE SANTO DO TOCANTINS",0,0,0,26,0,26,"2010"
"394","171380 PALMEIRAS DO TOCANTINS",1,0,3,81,0,85,"2010"
"395","171395 MURICILANDIA",0,0,2,57,0,59,"2010"
"396","171420 NATIVIDADE",0,0,1,153,2,156,"2010"
"397","171430 NAZARE",0,1,0,57,4,62,"2010"
"398","171488 NOVA OLINDA",0,0,4,190,0,194,"2010"
"399","171500 NOVA ROSALANDIA",0,0,0,41,0,41,"2010"
"400","171510 NOVO ACORDO",0,0,3,70,3,76,"2010"
"401","171515 NOVO ALEGRE",0,0,1,20,0,21,"2010"
"402","171525 NOVO JARDIM",0,0,0,46,0,46,"2010"
"403","171550 OLIVEIRA DE FATIMA",0,0,1,15,0,16,"2010"
"404","171570 PALMEIRANTE",0,0,0,66,0,66,"2010"
"405","171575 PALMEIROPOLIS",0,1,2,104,0,107,"2010"
"406","171610 PARAISO DO TOCANTINS",0,0,4,759,1,764,"2010"
"407","171620 PARANA",0,0,5,165,2,172,"2010"
"408","171630 PAU D'ARCO",1,0,0,72,1,74,"2010"
"409","171650 PEDRO AFONSO",1,1,1,211,0,214,"2010"
"410","171660 PEIXE",0,0,1,166,0,167,"2010"
"411","171665 PEQUIZEIRO",0,0,0,70,0,70,"2010"
"412","171670 COLMEIA",0,1,3,127,0,131,"2010"
"413","171700 PINDORAMA DO TOCANTINS",0,1,1,75,0,77,"2010"
"414","171720 PIRAQUE",0,0,0,39,0,39,"2010"
"415","171750 PIUM",1,1,2,79,1,84,"2010"
"416","171780 PONTE ALTA DO BOM JESUS",1,1,1,68,0,71,"2010"
"417","171790 PONTE ALTA DO TOCANTINS",0,1,2,125,2,130,"2010"
"418","171800 PORTO ALEGRE DO TOCANTINS",0,0,0,42,1,43,"2010"
"419","171820 PORTO NACIONAL",0,6,27,837,2,872,"2010"
"420","171830 PRAIA NORTE",0,0,0,12,141,153,"2010"
"421","171840 PRESIDENTE KENNEDY",0,0,0,49,0,49,"2010"
"422","171845 PUGMIL",0,0,2,47,0,49,"2010"
"423","171850 RECURSOLANDIA",0,0,0,71,0,71,"2010"
"424","171855 RIACHINHO",0,0,1,61,0,62,"2010"
"425","171865 RIO DA CONCEICAO",0,0,2,29,0,31,"2010"
"426","171870 RIO DOS BOIS",0,0,0,31,0,31,"2010"
"427","171875 RIO SONO",0,0,0,64,0,64,"2010"
"428","171880 SAMPAIO",0,0,0,10,97,107,"2010"
"429","171884 SANDOLANDIA",0,0,11,57,1,69,"2010"
"430","171886 SANTA FE DO ARAGUAIA",0,2,3,148,0,153,"2010"
"431","171888 SANTA MARIA DO TOCANTINS",0,0,0,33,1,34,"2010"
"432","171889 SANTA RITA DO TOCANTINS",0,0,0,22,0,22,"2010"
"433","171890 SANTA ROSA DO TOCANTINS",0,0,1,66,0,67,"2010"
"434","171900 SANTA TEREZA DO TOCANTINS",0,1,1,45,1,48,"2010"
"435","172000 SANTA TEREZINHA DO TOCANTINS",0,0,0,37,0,37,"2010"
"436","172010 SAO BENTO DO TOCANTINS",0,0,2,25,51,78,"2010"
"437","172015 SAO FELIX DO TOCANTINS",0,0,0,18,3,21,"2010"
"438","172020 SAO MIGUEL DO TOCANTINS",1,0,4,96,37,138,"2010"
"439","172025 SAO SALVADOR DO TOCANTINS",0,0,0,30,1,31,"2010"
"440","172030 SAO SEBASTIAO DO TOCANTINS",0,0,0,12,62,74,"2010"
"441","172049 SAO VALERIO",0,1,2,66,0,69,"2010"
"442","172065 SILVANOPOLIS",1,0,3,84,0,88,"2010"
"443","172080 SITIO NOVO DO TOCANTINS",0,0,0,61,91,152,"2010"
"444","172085 SUCUPIRA",0,0,0,29,0,29,"2010"
"445","172090 TAGUATINGA",1,4,3,226,1,235,"2010"
"446","172093 TAIPAS DO TOCANTINS",1,0,1,25,0,27,"2010"
"447","172097 TALISMA",0,0,0,21,0,21,"2010"
"448","172100 PALMAS",4,21,54,4348,28,4455,"2010"
"449","172110 TOCANTINIA",0,0,2,147,4,153,"2010"
"450","172120 TOCANTINOPOLIS",2,3,7,421,1,434,"2010"
"451","172125 TUPIRAMA",0,0,0,24,0,24,"2010"
"452","172130 TUPIRATINS",0,0,1,24,2,27,"2010"
"453","172208 WANDERLANDIA",0,0,0,138,0,138,"2010"
"454","172210 XAMBIOA",1,3,12,268,0,284,"2010"
"455","MUNICIPIO IGNORADO - MA",0,0,0,3,1,4,"2010"
"456","210005 ACAILANDIA",4,10,35,2002,43,2094,"2010"
"457","210010 AFONSO CUNHA",0,1,2,93,18,114,"2010"
"458","210015 AGUA DOCE DO MARANHAO",1,0,0,103,24,128,"2010"
"459","210020 ALCANTARA",2,2,3,200,41,248,"2010"
"460","210030 ALDEIAS ALTAS",0,1,6,514,4,525,"2010"
"461","210040 ALTAMIRA DO MARANHAO",0,1,3,56,28,88,"2010"
"462","210043 ALTO ALEGRE DO MARANHAO",2,2,34,357,30,425,"2010"
"463","210047 ALTO ALEGRE DO PINDARE",1,4,2,140,369,516,"2010"
"464","210050 ALTO PARNAIBA",0,2,4,94,97,197,"2010"
"465","210055 AMAPA DO MARANHAO",0,1,2,141,12,156,"2010"
"466","210060 AMARANTE DO MARANHAO",1,2,30,706,68,807,"2010"
"467","210070 ANAJATUBA",0,2,31,274,31,338,"2010"
"468","210080 ANAPURUS",1,4,10,238,5,258,"2010"
"469","210083 APICUM-ACU",5,147,3,49,80,284,"2010"
"470","210087 ARAGUANA",0,2,2,153,16,173,"2010"
"471","210090 ARAIOSES",2,28,60,337,182,609,"2010"
"472","210095 ARAME",0,2,18,760,4,784,"2010"
"473","210100 ARARI",1,5,23,400,14,443,"2010"
"474","210110 AXIXA",3,0,2,156,12,173,"2010"
"475","210120 BACABAL",19,33,102,1628,26,1808,"2010"
"476","210125 BACABEIRA",0,2,12,210,8,232,"2010"
"477","210130 BACURI",0,1,1,39,242,283,"2010"
"478","210135 BACURITUBA",0,0,0,56,6,62,"2010"
"479","210140 BALSAS",2,1,6,57,2007,2073,"2010"
"480","210150 BARAO DE GRAJAU",2,3,14,232,6,257,"2010"
"481","210160 BARRA DO CORDA",4,59,32,1475,101,1671,"2010"
"482","210170 BARREIRINHAS",3,10,20,1009,144,1186,"2010"
"483","210173 BELAGUA",0,0,0,27,175,202,"2010"
"484","210177 BELA VISTA DO MARANHAO",0,1,5,191,0,197,"2010"
"485","210180 BENEDITO LEITE",0,0,0,17,49,66,"2010"
"486","210190 BEQUIMAO",0,1,1,25,159,186,"2010"
"487","210193 BERNARDO DO MEARIM",1,0,2,73,1,77,"2010"
"488","210197 BOA VISTA DO GURUPI",0,0,18,137,0,155,"2010"
"489","210200 BOM JARDIM",1,3,6,111,550,671,"2010"
"490","210203 BOM JESUS DAS SELVAS",1,4,10,391,28,434,"2010"
"491","210207 BOM LUGAR",2,2,7,135,6,152,"2010"
"492","210210 BREJO",1,3,11,446,199,660,"2010"
"493","210215 BREJO DE AREIA",1,6,7,139,20,173,"2010"
"494","210220 BURITI",3,2,59,537,37,638,"2010"
"495","210230 BURITI BRAVO",2,5,6,420,1,434,"2010"
"496","210232 BURITICUPU",3,6,49,1420,15,1493,"2010"
"497","210235 BURITIRANA",0,0,9,158,24,191,"2010"
"498","210237 CACHOEIRA GRANDE",1,1,2,115,50,169,"2010"
"499","210240 CAJAPIO",0,1,0,2,149,152,"2010"
"500","210250 CAJARI",0,4,7,158,154,323,"2010"
"501","210255 CAMPESTRE DO MARANHAO",0,1,2,232,0,235,"2010"
"502","210260 CANDIDO MENDES",2,11,4,260,52,329,"2010"
"503","210270 CANTANHEDE",1,2,0,104,183,290,"2010"
"504","210275 CAPINZAL DO NORTE",1,0,4,71,94,170,"2010"
"505","210280 CAROLINA",0,0,21,401,3,425,"2010"
"506","210290 CARUTAPERA",0,3,8,440,8,459,"2010"
"507","210300 CAXIAS",1,9,18,2790,16,2834,"2010"
"508","210310 CEDRAL",0,1,6,125,24,156,"2010"
"509","210312 CENTRAL DO MARANHAO",0,0,0,19,113,132,"2010"
"510","210315 CENTRO DO GUILHERME",2,0,2,192,1,197,"2010"
"511","210317 CENTRO NOVO DO MARANHAO",0,1,1,194,101,297,"2010"
"512","210320 CHAPADINHA",13,23,80,1639,50,1805,"2010"
"513","210325 CIDELANDIA",1,1,8,213,41,264,"2010"
"514","210330 CODO",13,30,113,2076,98,2330,"2010"
"515","210340 COELHO NETO",2,2,17,972,23,1016,"2010"
"516","210350 COLINAS",1,3,37,727,2,770,"2010"
"517","210355 CONCEICAO DO LAGO-ACU",2,7,17,207,50,283,"2010"
"518","210360 COROATA",3,7,43,1193,37,1283,"2010"
"519","210370 CURURUPU",0,5,0,225,246,476,"2010"
"520","210375 DAVINOPOLIS",0,1,5,202,11,219,"2010"
"521","210380 DOM PEDRO",0,3,22,329,75,429,"2010"
"522","210390 DUQUE BACELAR",0,0,3,207,13,223,"2010"
"523","210400 ESPERANTINOPOLIS",1,1,1,355,6,364,"2010"
"524","210405 ESTREITO",1,4,14,675,4,698,"2010"
"525","210407 FEIRA NOVA DO MARANHAO",0,0,0,10,100,110,"2010"
"526","210408 FERNANDO FALCAO",0,1,3,107,120,231,"2010"
"527","210409 FORMOSA DA SERRA NEGRA",0,1,0,38,254,293,"2010"
"528","210410 FORTALEZA DOS NOGUEIRAS",0,0,0,185,29,214,"2010"
"529","210420 FORTUNA",2,1,2,337,23,365,"2010"
"530","210430 GODOFREDO VIANA",0,1,0,87,23,111,"2010"
"531","210440 GONCALVES DIAS",0,0,1,37,273,311,"2010"
"532","210450 GOVERNADOR ARCHER",0,0,0,159,6,165,"2010"
"533","210455 GOVERNADOR EDISON LOBAO",0,0,11,217,11,239,"2010"
"534","210460 GOVERNADOR EUGENIO BARROS",0,1,4,227,22,254,"2010"
"535","210462 GOVERNADOR LUIZ ROCHA",0,0,2,125,0,127,"2010"
"536","210465 GOVERNADOR NEWTON BELLO",2,0,8,124,44,178,"2010"
"537","210467 GOVERNADOR NUNES FREIRE",0,2,13,540,23,578,"2010"
"538","210470 GRACA ARANHA",1,0,0,59,23,83,"2010"
"539","210480 GRAJAU",0,7,27,1619,27,1680,"2010"
"540","210490 GUIMARAES",0,0,0,11,146,157,"2010"
"541","210500 HUMBERTO DE CAMPOS",1,1,13,328,209,552,"2010"
"542","210510 ICATU",0,3,21,329,79,432,"2010"
"543","210515 IGARAPE DO MEIO",0,1,0,272,7,280,"2010"
"544","210520 IGARAPE GRANDE",1,0,6,175,1,183,"2010"
"545","210530 IMPERATRIZ",12,19,150,4192,358,4731,"2010"
"546","210535 ITAIPAVA DO GRAJAU",0,0,52,212,1,265,"2010"
"547","210540 ITAPECURU MIRIM",0,2,2,66,1183,1253,"2010"
"548","210542 ITINGA DO MARANHAO",0,6,25,375,7,413,"2010"
"549","210545 JATOBA",0,4,7,139,4,154,"2010"
"550","210547 JENIPAPO DOS VIEIRAS",2,10,5,206,99,322,"2010"
"551","210550 JOAO LISBOA",0,1,18,388,22,429,"2010"
"552","210560 JOSELANDIA",0,1,4,231,35,271,"2010"
"553","210565 JUNCO DO MARANHAO",0,0,3,124,6,133,"2010"
"554","210570 LAGO DA PEDRA",2,6,10,939,9,966,"2010"
"555","210580 LAGO DO JUNCO",1,2,3,177,0,183,"2010"
"556","210590 LAGO VERDE",7,9,18,260,24,318,"2010"
"557","210592 LAGOA DO MATO",0,0,1,135,3,139,"2010"
"558","210594 LAGO DOS RODRIGUES",0,0,6,130,2,138,"2010"
"559","210596 LAGOA GRANDE DO MARANHAO",0,1,2,164,85,252,"2010"
"560","210598 LAJEADO NOVO",0,0,0,95,2,97,"2010"
"561","210600 LIMA CAMPOS",7,3,3,93,103,209,"2010"
"562","210610 LORETO",0,0,0,0,181,181,"2010"
"563","210620 LUIS DOMINGUES",0,0,3,90,2,95,"2010"
"564","210630 MAGALHAES DE ALMEIDA",0,1,2,252,1,256,"2010"
"565","210632 MARACACUME",0,1,6,407,12,426,"2010"
"566","210635 MARAJA DO SENA",3,1,4,113,7,128,"2010"
"567","210637 MARANHAOZINHO",1,0,1,173,5,180,"2010"
"568","210640 MATA ROMA",1,5,8,330,8,352,"2010"
"569","210650 MATINHA",2,2,2,59,375,440,"2010"
"570","210660 MATOES",0,3,7,552,26,588,"2010"
"571","210663 MATOES DO NORTE",0,1,3,74,27,105,"2010"
"572","210667 MILAGRES DO MARANHAO",0,0,1,107,15,123,"2010"
"573","210670 MIRADOR",0,1,8,367,1,377,"2010"
"574","210675 MIRANDA DO NORTE",3,1,10,308,34,356,"2010"
"575","210680 MIRINZAL",0,0,0,12,183,195,"2010"
"576","210690 MONCAO",0,3,11,462,110,586,"2010"
"577","210700 MONTES ALTOS",7,1,3,114,8,133,"2010"
"578","210710 MORROS",0,4,2,294,48,348,"2010"
"579","210720 NINA RODRIGUES",1,1,4,100,137,243,"2010"
"580","210725 NOVA COLINAS",0,0,3,65,13,81,"2010"
"581","210730 NOVA IORQUE",0,1,1,40,30,72,"2010"
"582","210735 NOVA OLINDA DO MARANHAO",0,2,22,279,13,316,"2010"
"583","210740 OLHO D'AGUA DAS CUNHAS",0,2,2,189,57,250,"2010"
"584","210745 OLINDA NOVA DO MARANHAO",0,0,1,7,186,194,"2010"
"585","210750 PACO DO LUMIAR",14,3,25,1385,120,1547,"2010"
"586","210760 PALMEIRANDIA",1,2,5,145,108,261,"2010"
"587","210770 PARAIBANO",0,0,8,298,0,306,"2010"
"588","210780 PARNARAMA",0,1,3,270,275,549,"2010"
"589","210790 PASSAGEM FRANCA",0,0,7,290,1,298,"2010"
"590","210800 PASTOS BONS",0,0,2,30,315,347,"2010"
"591","210805 PAULINO NEVES",0,1,5,205,82,293,"2010"
"592","210810 PAULO RAMOS",0,1,11,411,14,437,"2010"
"593","210820 PEDREIRAS",3,3,35,708,1,750,"2010"
"594","210825 PEDRO DO ROSARIO",2,68,77,103,117,367,"2010"
"595","210830 PENALVA",0,1,7,589,96,693,"2010"
"596","210840 PERI MIRIM",0,1,4,112,40,157,"2010"
"597","210845 PERITORO",2,3,11,346,37,399,"2010"
"598","210850 PINDARE-MIRIM",1,4,10,610,17,642,"2010"
"599","210860 PINHEIRO",4,18,40,1330,152,1544,"2010"
"600","210870 PIO XII",1,5,5,537,2,550,"2010"
"601","210880 PIRAPEMAS",0,0,0,18,313,331,"2010"
"602","210890 POCAO DE PEDRAS",0,1,2,308,1,312,"2010"
"603","210900 PORTO FRANCO",1,2,6,427,2,438,"2010"
"604","210905 PORTO RICO DO MARANHAO",1,0,0,14,77,92,"2010"
"605","210910 PRESIDENTE DUTRA",11,1,2,849,2,865,"2010"
"606","210920 PRESIDENTE JUSCELINO",0,0,4,132,75,211,"2010"
"607","210923 PRESIDENTE MEDICI",0,1,3,92,3,99,"2010"
"608","210927 PRESIDENTE SARNEY",0,3,9,271,54,337,"2010"
"609","210930 PRESIDENTE VARGAS",0,0,14,59,127,200,"2010"
"610","210940 PRIMEIRA CRUZ",0,1,2,108,99,210,"2010"
"611","210945 RAPOSA",2,2,12,535,7,558,"2010"
"612","210950 RIACHAO",0,1,4,28,371,404,"2010"
"613","210955 RIBAMAR FIQUENE",0,0,2,117,4,123,"2010"
"614","210960 ROSARIO",1,5,18,612,29,665,"2010"
"615","210970 SAMBAIBA",0,4,16,12,11,43,"2010"
"616","210975 SANTA FILOMENA DO MARANHAO",0,5,1,102,0,108,"2010"
"617","210980 SANTA HELENA",0,1,4,135,363,503,"2010"
"618","210990 SANTA INES",2,11,66,1646,26,1751,"2010"
"619","211000 SANTA LUZIA",1,16,24,1170,260,1471,"2010"
"620","211003 SANTA LUZIA DO PARUA",0,1,2,408,4,415,"2010"
"621","211010 SANTA QUITERIA DO MARANHAO",2,1,8,492,25,528,"2010"
"622","211020 SANTA RITA",3,15,90,411,17,536,"2010"
"623","211023 SANTANA DO MARANHAO",0,1,0,100,36,137,"2010"
"624","211027 SANTO AMARO DO MARANHAO",0,0,2,53,114,169,"2010"
"625","211030 SANTO ANTONIO DOS LOPES",0,0,1,61,202,264,"2010"
"626","211040 SAO BENEDITO DO RIO PRETO",0,0,3,46,356,405,"2010"
"627","211050 SAO BENTO",2,0,0,559,63,624,"2010"
"628","211060 SAO BERNARDO",0,1,3,544,5,553,"2010"
"629","211065 SAO DOMINGOS DO AZEITAO",0,0,2,1,129,132,"2010"
"630","211070 SAO DOMINGOS DO MARANHAO",2,2,7,552,116,679,"2010"
"631","211080 SAO FELIX DE BALSAS",0,0,0,3,46,49,"2010"
"632","211085 SAO FRANCISCO DO BREJAO",0,0,1,125,8,134,"2010"
"633","211090 SAO FRANCISCO DO MARANHAO",0,1,6,154,8,169,"2010"
"634","211100 SAO JOAO BATISTA",22,84,77,77,52,312,"2010"
"635","211102 SAO JOAO DO CARU",2,4,18,310,37,371,"2010"
"636","211105 SAO JOAO DO PARAISO",0,0,2,171,1,174,"2010"
"637","211107 SAO JOAO DO SOTER",0,0,2,243,13,258,"2010"
"638","211110 SAO JOAO DOS PATOS",1,1,13,368,8,391,"2010"
"639","211120 SAO JOSE DE RIBAMAR",6,11,53,2323,56,2449,"2010"
"640","211125 SAO JOSE DOS BASILIOS",1,0,2,92,2,97,"2010"
"641","211130 SAO LUIS",77,67,345,16515,291,17295,"2010"
"642","211140 SAO LUIS GONZAGA DO MARANHAO",3,5,5,331,15,359,"2010"
"643","211150 SAO MATEUS DO MARANHAO",0,4,63,683,4,754,"2010"
"644","211153 SAO PEDRO DA AGUA BRANCA",0,1,7,166,1,175,"2010"
"645","211157 SAO PEDRO DOS CRENTES",0,0,3,71,2,76,"2010"
"646","211160 SAO RAIMUNDO DAS MANGABEIRAS",1,0,0,6,370,377,"2010"
"647","211163 SAO RAIMUNDO DO DOCA BEZERRA",0,0,0,88,10,98,"2010"
"648","211167 SAO ROBERTO",0,0,0,89,6,95,"2010"
"649","211170 SAO VICENTE FERRER",0,1,0,24,327,352,"2010"
"650","211172 SATUBINHA",0,0,2,115,3,120,"2010"
"651","211174 SENADOR ALEXANDRE COSTA",2,1,5,117,60,185,"2010"
"652","211176 SENADOR LA ROCQUE",0,1,8,284,34,327,"2010"
"653","211178 SERRANO DO MARANHAO",0,0,0,51,93,144,"2010"
"654","211180 SITIO NOVO",0,1,8,269,3,281,"2010"
"655","211190 SUCUPIRA DO NORTE",0,1,9,123,40,173,"2010"
"656","211195 SUCUPIRA DO RIACHAO",0,0,0,86,3,89,"2010"
"657","211200 TASSO FRAGOSO",2,0,1,102,29,134,"2010"
"658","211210 TIMBIRAS",3,3,13,402,26,447,"2010"
"659","211220 TIMON",8,8,27,2601,7,2651,"2010"
"660","211223 TRIZIDELA DO VALE",2,1,6,327,5,341,"2010"
"661","211227 TUFILANDIA",0,0,5,121,7,133,"2010"
"662","211230 TUNTUM",1,0,9,632,7,649,"2010"
"663","211240 TURIACU",0,1,0,11,683,695,"2010"
"664","211245 TURILANDIA",0,2,8,152,191,353,"2010"
"665","211250 TUTOIA",37,16,27,561,435,1076,"2010"
"666","211260 URBANO SANTOS",0,3,14,125,575,717,"2010"
"667","211270 VARGEM GRANDE",1,3,6,185,688,883,"2010"
"668","211280 VIANA",7,4,25,651,227,914,"2010"
"669","211285 VILA NOVA DOS MARTIRIOS",0,0,10,125,11,146,"2010"
"670","211290 VITORIA DO MEARIM",3,2,7,332,244,588,"2010"
"671","211300 VITORINO FREIRE",0,2,16,507,15,540,"2010"
"672","211400 ZE DOCA",4,6,26,809,13,858,"2010"
"673","220005 ACAUA",1,1,4,81,5,92,"2010"
"674","220010 AGRICOLANDIA",1,0,0,62,4,67,"2010"
"675","220020 AGUA BRANCA",1,0,3,209,41,254,"2010"
"676","220025 ALAGOINHA DO PIAUI",0,0,0,88,0,88,"2010"
"677","220027 ALEGRETE DO PIAUI",0,0,1,66,0,67,"2010"
"678","220030 ALTO LONGA",0,1,2,133,4,140,"2010"
"679","220040 ALTOS",3,3,6,527,111,650,"2010"
"680","220045 ALVORADA DO GURGUEIA",0,0,0,9,90,99,"2010"
"681","220050 AMARANTE",1,4,12,289,7,313,"2010"
"682","220060 ANGICAL DO PIAUI",1,1,0,81,18,101,"2010"
"683","220070 ANISIO DE ABREU",0,0,0,21,107,128,"2010"
"684","220080 ANTONIO ALMEIDA",0,1,0,18,20,39,"2010"
"685","220090 AROAZES",0,0,3,70,7,80,"2010"
"686","220095 AROEIRAS DO ITAIM",0,1,1,30,0,32,"2010"
"687","220100 ARRAIAL",0,1,5,54,2,62,"2010"
"688","220105 ASSUNCAO DO PIAUI",0,0,0,117,55,172,"2010"
"689","220110 AVELINO LOPES",0,0,6,172,19,197,"2010"
"690","220115 BAIXA GRANDE DO RIBEIRO",0,0,1,13,179,193,"2010"
"691","220117 BARRA D'ALCANTARA",0,0,0,59,1,60,"2010"
"692","220120 BARRAS",7,3,14,754,9,787,"2010"
"693","220130 BARREIRAS DO PIAUI",0,0,0,18,26,44,"2010"
"694","220140 BARRO DURO",1,0,1,97,7,106,"2010"
"695","220150 BATALHA",0,6,6,312,9,333,"2010"
"696","220155 BELA VISTA DO PIAUI",0,1,1,47,0,49,"2010"
"697","220157 BELEM DO PIAUI",0,0,3,46,2,51,"2010"
"698","220160 BENEDITINOS",2,1,1,129,6,139,"2010"
"699","220170 BERTOLINIA",0,2,6,64,13,85,"2010"
"700","220173 BETANIA DO PIAUI",0,1,2,100,5,108,"2010"
"701","220177 BOA HORA",0,1,1,78,39,119,"2010"
"702","220180 BOCAINA",0,0,0,45,1,46,"2010"
"703","220190 BOM JESUS",0,1,0,20,404,425,"2010"
"704","220191 BOM PRINCIPIO DO PIAUI",0,1,2,108,6,117,"2010"
"705","220192 BONFIM DO PIAUI",0,1,1,8,64,74,"2010"
"706","220194 BOQUEIRAO DO PIAUI",0,1,0,66,56,123,"2010"
"707","220196 BRASILEIRA",1,0,1,76,22,100,"2010"
"708","220198 BREJO DO PIAUI",0,0,1,59,2,62,"2010"
"709","220200 BURITI DOS LOPES",2,2,4,323,2,333,"2010"
"710","220202 BURITI DOS MONTES",0,0,0,38,66,104,"2010"
"711","220205 CABECEIRAS DO PIAUI",2,0,0,124,39,165,"2010"
"712","220207 CAJAZEIRAS DO PIAUI",1,0,0,45,0,46,"2010"
"713","220208 CAJUEIRO DA PRAIA",0,1,0,89,0,90,"2010"
"714","220209 CALDEIRAO GRANDE DO PIAUI",0,1,5,74,6,86,"2010"
"715","220210 CAMPINAS DO PIAUI",0,0,0,79,6,85,"2010"
"716","220211 CAMPO ALEGRE DO FIDALGO",0,0,2,68,3,73,"2010"
"717","220213 CAMPO GRANDE DO PIAUI",1,2,1,91,0,95,"2010"
"718","220217 CAMPO LARGO DO PIAUI",0,2,0,106,7,115,"2010"
"719","220220 CAMPO MAIOR",0,2,5,476,317,800,"2010"
"720","220225 CANAVIEIRA",0,0,3,27,11,41,"2010"
"721","220230 CANTO DO BURITI",2,1,8,251,15,277,"2010"
"722","220240 CAPITAO DE CAMPOS",0,0,0,94,64,158,"2010"
"723","220245 CAPITAO GERVASIO OLIVEIRA",1,2,1,57,2,63,"2010"
"724","220250 CARACOL",0,0,0,22,141,163,"2010"
"725","220253 CARAUBAS DO PIAUI",0,0,0,83,1,84,"2010"
"726","220255 CARIDADE DO PIAUI",0,1,2,93,2,98,"2010"
"727","220260 CASTELO DO PIAUI",0,1,2,36,301,340,"2010"
"728","220265 CAXINGO",0,0,2,71,2,75,"2010"
"729","220270 COCAL",1,2,11,412,13,439,"2010"
"730","220271 COCAL DE TELHA",0,0,1,64,21,86,"2010"
"731","220272 COCAL DOS ALVES",1,2,1,78,0,82,"2010"
"732","220273 COIVARAS",0,0,0,45,13,58,"2010"
"733","220275 COLONIA DO GURGUEIA",0,1,6,68,21,96,"2010"
"734","220277 COLONIA DO PIAUI",0,1,2,82,0,85,"2010"
"735","220280 CONCEICAO DO CANINDE",2,0,1,66,2,71,"2010"
"736","220285 CORONEL JOSE DIAS",0,0,1,3,43,47,"2010"
"737","220290 CORRENTE",0,1,3,205,217,426,"2010"
"738","220300 CRISTALANDIA DO PIAUI",0,0,1,60,26,87,"2010"
"739","220310 CRISTINO CASTRO",0,0,0,4,175,179,"2010"
"740","220320 CURIMATA",3,0,4,162,25,194,"2010"
"741","220323 CURRAIS",0,0,0,0,99,99,"2010"
"742","220325 CURRALINHOS",1,0,1,61,1,64,"2010"
"743","220327 CURRAL NOVO DO PIAUI",0,0,1,68,6,75,"2010"
"744","220330 DEMERVAL LOBAO",0,0,0,164,11,175,"2010"
"745","220335 DIRCEU ARCOVERDE",0,0,0,22,61,83,"2010"
"746","220340 DOM EXPEDITO LOPES",1,0,0,79,0,80,"2010"
"747","220342 DOMINGOS MOURAO",0,0,1,56,26,83,"2010"
"748","220345 DOM INOCENCIO",0,0,1,27,74,102,"2010"
"749","220350 ELESBAO VELOSO",0,0,6,173,1,180,"2010"
"750","220360 ELISEU MARTINS",0,0,5,53,4,62,"2010"
"751","220370 ESPERANTINA",0,2,9,649,6,666,"2010"
"752","220375 FARTURA DO PIAUI",0,0,0,21,63,84,"2010"
"753","220380 FLORES DO PIAUI",0,1,3,72,0,76,"2010"
"754","220385 FLORESTA DO PIAUI",1,0,0,25,1,27,"2010"
"755","220390 FLORIANO",2,8,67,910,5,992,"2010"
"756","220400 FRANCINOPOLIS",0,0,2,84,0,86,"2010"
"757","220410 FRANCISCO AYRES",0,1,3,58,0,62,"2010"
"758","220415 FRANCISCO MACEDO",0,0,2,40,2,44,"2010"
"759","220420 FRANCISCO SANTOS",0,2,5,119,2,128,"2010"
"760","220430 FRONTEIRAS",1,0,1,133,0,135,"2010"
"761","220435 GEMINIANO",0,0,2,70,0,72,"2010"
"762","220440 GILBUES",0,1,0,119,72,192,"2010"
"763","220450 GUADALUPE",1,1,3,79,102,186,"2010"
"764","220455 GUARIBAS",0,0,0,6,58,64,"2010"
"765","220460 HUGO NAPOLEAO",0,0,1,59,5,65,"2010"
"766","220465 ILHA GRANDE",0,0,0,146,1,147,"2010"
"767","220470 INHUMA",2,1,3,199,2,207,"2010"
"768","220480 IPIRANGA DO PIAUI",0,0,6,120,3,129,"2010"
"769","220490 ISAIAS COELHO",1,2,3,123,9,138,"2010"
"770","220500 ITAINOPOLIS",2,1,4,109,2,118,"2010"
"771","220510 ITAUEIRA",0,1,10,142,0,153,"2010"
"772","220515 JACOBINA DO PIAUI",0,0,3,72,6,81,"2010"
"773","220520 JAICOS",0,0,10,283,3,296,"2010"
"774","220525 JARDIM DO MULATO",0,0,1,49,1,51,"2010"
"775","220527 JATOBA DO PIAUI",0,0,1,56,24,81,"2010"
"776","220530 JERUMENHA",0,0,4,59,5,68,"2010"
"777","220535 JOAO COSTA",1,0,0,43,3,47,"2010"
"778","220540 JOAQUIM PIRES",0,2,1,207,11,221,"2010"
"779","220545 JOCA MARQUES",0,1,1,93,1,96,"2010"
"780","220550 JOSE DE FREITAS",1,6,10,544,3,564,"2010"
"781","220551 JUAZEIRO DO PIAUI",0,0,2,53,39,94,"2010"
"782","220552 JULIO BORGES",0,0,0,49,22,71,"2010"
"783","220553 JUREMA",0,0,0,14,61,75,"2010"
"784","220554 LAGOINHA DO PIAUI",1,0,1,37,4,43,"2010"
"785","220555 LAGOA ALEGRE",0,0,0,66,27,93,"2010"
"786","220556 LAGOA DO BARRO DO PIAUI",1,0,1,51,7,60,"2010"
"787","220557 LAGOA DE SAO FRANCISCO",0,2,4,78,2,86,"2010"
"788","220558 LAGOA DO PIAUI",1,2,0,51,3,57,"2010"
"789","220559 LAGOA DO SITIO",1,1,0,68,0,70,"2010"
"790","220560 LANDRI SALES",0,1,2,63,14,80,"2010"
"791","220570 LUIS CORREIA",2,2,9,440,8,461,"2010"
"792","220580 LUZILANDIA",0,4,13,396,7,420,"2010"
"793","220585 MADEIRO",0,0,5,126,2,133,"2010"
"794","220590 MANOEL EMIDIO",3,7,8,51,0,69,"2010"
"795","220595 MARCOLANDIA",0,2,4,131,0,137,"2010"
"796","220600 MARCOS PARENTE",0,0,5,75,0,80,"2010"
"797","220605 MASSAPE DO PIAUI",0,1,2,74,3,80,"2010"
"798","220610 MATIAS OLIMPIO",1,4,6,180,1,192,"2010"
"799","220620 MIGUEL ALVES",3,2,4,481,104,594,"2010"
"800","220630 MIGUEL LEAO",0,0,0,17,1,18,"2010"
"801","220635 MILTON BRANDAO",0,0,5,79,3,87,"2010"
"802","220640 MONSENHOR GIL",0,0,0,109,10,119,"2010"
"803","220650 MONSENHOR HIPOLITO",0,2,1,109,2,114,"2010"
"804","220660 MONTE ALEGRE DO PIAUI",1,1,3,96,72,173,"2010"
"805","220665 MORRO CABECA NO TEMPO",2,1,3,71,14,91,"2010"
"806","220667 MORRO DO CHAPEU DO PIAUI",1,0,3,80,1,85,"2010"
"807","220669 MURICI DOS PORTELAS",0,0,2,102,5,109,"2010"
"808","220670 NAZARE DO PIAUI",0,0,4,100,0,104,"2010"
"809","220672 NAZARIA",0,0,1,114,1,116,"2010"
"810","220675 NOSSA SENHORA DE NAZARE",0,0,0,47,13,60,"2010"
"811","220680 NOSSA SENHORA DOS REMEDIOS",1,1,4,133,47,186,"2010"
"812","220690 NOVO ORIENTE DO PIAUI",0,1,0,81,3,85,"2010"
"813","220695 NOVO SANTO ANTONIO",0,1,1,28,0,30,"2010"
"814","220700 OEIRAS",5,4,6,520,5,540,"2010"
"815","220710 OLHO D'AGUA DO PIAUI",0,0,0,38,7,45,"2010"
"816","220720 PADRE MARCOS",0,2,4,76,6,88,"2010"
"817","220730 PAES LANDIM",1,2,1,60,0,64,"2010"
"818","220735 PAJEU DO PIAUI",0,0,1,31,0,32,"2010"
"819","220740 PALMEIRA DO PIAUI",0,0,0,1,88,89,"2010"
"820","220750 PALMEIRAIS",0,1,3,175,34,213,"2010"
"821","220755 PAQUETA",0,0,0,48,0,48,"2010"
"822","220760 PARNAGUA",0,1,0,42,145,188,"2010"
"823","220770 PARNAIBA",5,13,22,2140,8,2188,"2010"
"824","220775 PASSAGEM FRANCA DO PIAUI",1,0,0,68,5,74,"2010"
"825","220777 PATOS DO PIAUI",0,1,3,74,7,85,"2010"
"826","220779 PAU D'ARCO DO PIAUI",0,0,0,35,4,39,"2010"
"827","220780 PAULISTANA",1,3,5,288,32,329,"2010"
"828","220785 PAVUSSU",0,1,2,41,0,44,"2010"
"829","220790 PEDRO II",2,3,14,514,11,544,"2010"
"830","220793 PEDRO LAURENTINO",0,0,1,34,0,35,"2010"
"831","220795 NOVA SANTA RITA",0,1,2,58,0,61,"2010"
"832","220800 PICOS",5,5,23,1117,5,1155,"2010"
"833","220810 PIMENTEIRAS",1,1,2,133,5,142,"2010"
"834","220820 PIO IX",2,3,11,268,1,285,"2010"
"835","220830 PIRACURUCA",3,3,4,371,11,392,"2010"
"836","220840 PIRIPIRI",3,7,3,709,199,921,"2010"
"837","220850 PORTO",1,2,5,217,4,229,"2010"
"838","220855 PORTO ALEGRE DO PIAUI",0,1,3,32,2,38,"2010"
"839","220860 PRATA DO PIAUI",1,1,1,32,2,37,"2010"
"840","220865 QUEIMADA NOVA",0,0,2,79,8,89,"2010"
"841","220870 REDENCAO DO GURGUEIA",0,0,1,8,155,164,"2010"
"842","220880 REGENERACAO",0,2,4,290,9,305,"2010"
"843","220885 RIACHO FRIO",0,1,1,42,54,98,"2010"
"844","220887 RIBEIRA DO PIAUI",0,2,0,58,0,60,"2010"
"845","220890 RIBEIRO GONCALVES",0,0,1,9,95,105,"2010"
"846","220900 RIO GRANDE DO PIAUI",0,0,3,73,1,77,"2010"
"847","220910 SANTA CRUZ DO PIAUI",0,0,1,67,0,68,"2010"
"848","220915 SANTA CRUZ DOS MILAGRES",0,0,0,44,0,44,"2010"
"849","220920 SANTA FILOMENA",0,0,3,118,4,125,"2010"
"850","220930 SANTA LUZ",0,0,0,9,82,91,"2010"
"851","220935 SANTANA DO PIAUI",0,0,3,59,0,62,"2010"
"852","220937 SANTA ROSA DO PIAUI",2,0,0,62,0,64,"2010"
"853","220940 SANTO ANTONIO DE LISBOA",0,0,1,73,1,75,"2010"
"854","220945 SANTO ANTONIO DOS MILAGRES",1,0,0,24,9,34,"2010"
"855","220950 SANTO INACIO DO PIAUI",0,0,2,44,0,46,"2010"
"856","220955 SAO BRAZ DO PIAUI",1,0,0,7,78,86,"2010"
"857","220960 SAO FELIX DO PIAUI",0,0,0,26,0,26,"2010"
"858","220965 SAO FRANCISCO DE ASSIS DO PIAUI",0,0,1,79,4,84,"2010"
"859","220970 SAO FRANCISCO DO PIAUI",1,2,5,66,0,74,"2010"
"860","220975 SAO GONCALO DO GURGUEIA",0,0,0,15,18,33,"2010"
"861","220980 SAO GONCALO DO PIAUI",1,0,0,68,7,76,"2010"
"862","220985 SAO JOAO DA CANABRAVA",0,1,1,58,0,60,"2010"
"863","220987 SAO JOAO DA FRONTEIRA",0,0,0,62,13,75,"2010"
"864","220990 SAO JOAO DA SERRA",0,0,0,33,35,68,"2010"
"865","220995 SAO JOAO DA VARJOTA",0,1,2,91,1,95,"2010"
"866","220997 SAO JOAO DO ARRAIAL",1,2,1,137,0,141,"2010"
"867","221000 SAO JOAO DO PIAUI",4,4,12,326,2,348,"2010"
"868","221005 SAO JOSE DO DIVINO",0,1,0,51,1,53,"2010"
"869","221010 SAO JOSE DO PEIXE",0,2,0,45,0,47,"2010"
"870","221020 SAO JOSE DO PIAUI",0,2,1,104,0,107,"2010"
"871","221030 SAO JULIAO",0,0,5,74,0,79,"2010"
"872","221035 SAO LOURENCO DO PIAUI",0,0,0,7,46,53,"2010"
"873","221037 SAO LUIS DO PIAUI",0,0,1,23,0,24,"2010"
"874","221038 SAO MIGUEL DA BAIXA GRANDE",0,0,0,22,4,26,"2010"
"875","221039 SAO MIGUEL DO FIDALGO",0,0,1,39,0,40,"2010"
"876","221040 SAO MIGUEL DO TAPUIO",0,0,1,204,50,255,"2010"
"877","221050 SAO PEDRO DO PIAUI",0,0,3,143,60,206,"2010"
"878","221060 SAO RAIMUNDO NONATO",1,1,1,46,526,575,"2010"
"879","221062 SEBASTIAO BARROS",1,0,2,55,26,84,"2010"
"880","221063 SEBASTIAO LEAL",0,0,2,39,33,74,"2010"
"881","221065 SIGEFREDO PACHECO",0,1,1,72,56,130,"2010"
"882","221070 SIMOES",1,3,1,233,4,242,"2010"
"883","221080 SIMPLICIO MENDES",0,0,4,179,1,184,"2010"
"884","221090 SOCORRO DO PIAUI",1,0,1,57,2,61,"2010"
"885","221093 SUSSUAPARA",0,0,2,65,0,67,"2010"
"886","221095 TAMBORIL DO PIAUI",1,0,0,19,21,41,"2010"
"887","221097 TANQUE DO PIAUI",0,0,2,35,0,37,"2010"
"888","221100 TERESINA",46,49,138,13165,74,13472,"2010"
"889","221110 UNIAO",2,4,5,283,426,720,"2010"
"890","221120 URUCUI",0,3,2,54,334,393,"2010"
"891","221130 VALENCA DO PIAUI",1,1,3,302,0,307,"2010"
"892","221135 VARZEA BRANCA",0,0,0,11,68,79,"2010"
"893","221140 VARZEA GRANDE",0,0,1,48,3,52,"2010"
"894","221150 VERA MENDES",0,2,2,43,2,49,"2010"
"895","221160 VILA NOVA DO PIAUI",0,0,0,31,0,31,"2010"
"896","221170 WALL FERRAZ",0,0,0,45,19,64,"2010"
"897","MUNICIPIO IGNORADO - CE",0,0,0,4,0,4,"2010"
"898","230010 ABAIARA",0,0,2,142,0,144,"2010"
"899","230015 ACARAPE",2,1,2,207,1,213,"2010"
"900","230020 ACARAU",2,3,20,916,2,943,"2010"
"901","230030 ACOPIARA",2,5,51,671,5,734,"2010"
"902","230040 AIUABA",1,0,4,198,23,226,"2010"
"903","230050 ALCANTARAS",0,1,6,156,0,163,"2010"
"904","230060 ALTANEIRA",2,1,6,76,3,88,"2010"
"905","230070 ALTO SANTO",0,1,4,176,1,182,"2010"
"906","230075 AMONTADA",1,2,15,652,20,690,"2010"
"907","230080 ANTONINA DO NORTE",1,0,4,118,2,125,"2010"
"908","230090 APUIARES",2,0,8,132,3,145,"2010"
"909","230100 AQUIRAZ",4,5,19,866,5,899,"2010"
"910","230110 ARACATI",3,2,24,1012,6,1047,"2010"
"911","230120 ARACOIABA",0,3,7,327,3,340,"2010"
"912","230125 ARARENDA",0,1,1,136,2,140,"2010"
"913","230130 ARARIPE",0,2,12,382,0,396,"2010"
"914","230140 ARATUBA",0,1,7,194,3,205,"2010"
"915","230150 ARNEIROZ",0,0,2,89,6,97,"2010"
"916","230160 ASSARE",1,4,18,267,2,292,"2010"
"917","230170 AURORA",0,2,9,371,0,382,"2010"
"918","230180 BAIXIO",0,0,1,80,0,81,"2010"
"919","230185 BANABUIU",0,1,21,268,5,295,"2010"
"920","230190 BARBALHA",0,12,20,967,32,1031,"2010"
"921","230195 BARREIRA",1,1,5,265,2,274,"2010"
"922","230200 BARRO",0,1,9,265,4,279,"2010"
"923","230205 BARROQUINHA",0,1,3,198,2,204,"2010"
"924","230210 BATURITE",2,1,14,477,1,495,"2010"
"925","230220 BEBERIBE",3,1,11,524,5,544,"2010"
"926","230230 BELA CRUZ",1,3,10,406,1,421,"2010"
"927","230240 BOA VIAGEM",2,2,9,717,6,736,"2010"
"928","230250 BREJO SANTO",1,5,27,688,0,721,"2010"
"929","230260 CAMOCIM",2,3,24,958,0,987,"2010"
"930","230270 CAMPOS SALES",1,2,7,327,2,339,"2010"
"931","230280 CANINDE",2,4,22,1171,15,1214,"2010"
"932","230290 CAPISTRANO",1,2,9,225,0,237,"2010"
"933","230300 CARIDADE",1,0,6,236,0,243,"2010"
"934","230310 CARIRE",0,3,5,214,1,223,"2010"
"935","230320 CARIRIACU",4,6,21,393,1,425,"2010"
"936","230330 CARIUS",0,2,17,191,1,211,"2010"
"937","230340 CARNAUBAL",3,0,7,261,1,272,"2010"
"938","230350 CASCAVEL",1,2,11,886,10,910,"2010"
"939","230360 CATARINA",0,0,5,171,2,178,"2010"
"940","230365 CATUNDA",0,0,1,116,0,117,"2010"
"941","230370 CAUCAIA",13,22,92,4546,29,4702,"2010"
"942","230380 CEDRO",0,0,2,336,1,339,"2010"
"943","230390 CHAVAL",2,1,5,220,5,233,"2010"
"944","230393 CHORO",0,1,3,196,10,210,"2010"
"945","230395 CHOROZINHO",0,2,2,254,0,258,"2010"
"946","230400 COREAU",1,2,4,313,0,320,"2010"
"947","230410 CRATEUS",0,2,7,1081,25,1115,"2010"
"948","230420 CRATO",10,30,75,2000,21,2136,"2010"
"949","230423 CROATA",0,1,4,220,0,225,"2010"
"950","230425 CRUZ",1,1,4,349,0,355,"2010"
"951","230426 DEPUTADO IRAPUAN PINHEIRO",0,0,7,104,2,113,"2010"
"952","230427 ERERE",1,1,6,32,1,41,"2010"
"953","230428 EUSEBIO",1,4,27,750,3,785,"2010"
"954","230430 FARIAS BRITO",3,2,4,289,4,302,"2010"
"955","230435 FORQUILHA",2,3,5,300,4,314,"2010"
"956","230440 FORTALEZA",96,133,542,35435,549,36755,"2010"
"957","230445 FORTIM",1,0,6,182,0,189,"2010"
"958","230450 FRECHEIRINHA",2,0,4,191,0,197,"2010"
"959","230460 GENERAL SAMPAIO",1,0,3,109,3,116,"2010"
"960","230465 GRACA",0,3,1,180,0,184,"2010"
"961","230470 GRANJA",3,8,35,804,0,850,"2010"
"962","230480 GRANJEIRO",0,0,2,56,1,59,"2010"
"963","230490 GROAIRAS",0,0,2,120,0,122,"2010"
"964","230495 GUAIUBA",2,1,10,321,1,335,"2010"
"965","230500 GUARACIABA DO NORTE",0,4,20,609,3,636,"2010"
"966","230510 GUARAMIRANGA",0,1,2,75,1,79,"2010"
"967","230520 HIDROLANDIA",3,0,5,269,0,277,"2010"
"968","230523 HORIZONTE",2,6,24,910,7,949,"2010"
"969","230526 IBARETAMA",1,2,6,211,1,221,"2010"
"970","230530 IBIAPINA",1,0,8,370,2,381,"2010"
"971","230533 IBICUITINGA",0,0,3,158,0,161,"2010"
"972","230535 ICAPUI",2,1,4,217,3,227,"2010"
"973","230540 ICO",4,3,26,881,1,915,"2010"
"974","230550 IGUATU",5,23,95,1269,16,1408,"2010"
"975","230560 INDEPENDENCIA",1,0,4,332,7,344,"2010"
"976","230565 IPAPORANGA",0,2,3,162,6,173,"2010"
"977","230570 IPAUMIRIM",0,1,4,154,0,159,"2010"
"978","230580 IPU",3,0,7,591,0,601,"2010"
"979","230590 IPUEIRAS",1,6,24,533,7,571,"2010"
"980","230600 IRACEMA",0,0,5,170,0,175,"2010"
"981","230610 IRAUCUBA",1,3,13,379,5,401,"2010"
"982","230620 ITAICABA",0,0,4,106,0,110,"2010"
"983","230625 ITAITINGA",1,1,8,359,4,373,"2010"
"984","230630 ITAPAGE",1,6,18,778,4,807,"2010"
"985","230640 ITAPIPOCA",3,6,30,2052,31,2122,"2010"
"986","230650 ITAPIUNA",0,0,4,261,1,266,"2010"
"987","230655 ITAREMA",0,4,20,698,2,724,"2010"
"988","230660 ITATIRA",2,2,6,316,8,334,"2010"
"989","230670 JAGUARETAMA",0,3,3,220,1,227,"2010"
"990","230680 JAGUARIBARA",2,1,2,156,2,163,"2010"
"991","230690 JAGUARIBE",1,1,5,478,0,485,"2010"
"992","230700 JAGUARUANA",2,4,7,394,0,407,"2010"
"993","230710 JARDIM",3,3,4,478,2,490,"2010"
"994","230720 JATI",3,1,3,102,0,109,"2010"
"995","230725 JIJOCA DE JERICOACOARA",1,1,12,272,0,286,"2010"
"996","230730 JUAZEIRO DO NORTE",14,72,214,3810,17,4127,"2010"
"997","230740 JUCAS",1,3,10,355,6,375,"2010"
"998","230750 LAVRAS DA MANGABEIRA",1,4,9,395,4,413,"2010"
"999","230760 LIMOEIRO DO NORTE",2,4,23,744,1,774,"2010"
"1000","230763 MADALENA",0,1,9,222,1,233,"2010"
"1001","230765 MARACANAU",9,11,68,4439,27,4554,"2010"
"1002","230770 MARANGUAPE",1,2,19,1165,20,1207,"2010"
"1003","230780 MARCO",1,2,7,484,0,494,"2010"
"1004","230790 MARTINOPOLE",0,0,4,169,1,174,"2010"
"1005","230800 MASSAPE",2,3,17,576,2,600,"2010"
"1006","230810 MAURITI",3,2,16,735,0,756,"2010"
"1007","230820 MERUOCA",0,1,4,204,4,213,"2010"
"1008","230830 MILAGRES",1,1,11,425,1,439,"2010"
"1009","230835 MILHA",2,0,2,153,1,158,"2010"
"1010","230837 MIRAIMA",0,0,3,214,0,217,"2010"
"1011","230840 MISSAO VELHA",2,5,17,598,13,635,"2010"
"1012","230850 MOMBACA",3,4,16,576,11,610,"2010"
"1013","230860 MONSENHOR TABOSA",0,1,3,250,7,261,"2010"
"1014","230870 MORADA NOVA",1,2,11,841,5,860,"2010"
"1015","230880 MORAUJO",0,2,1,108,1,112,"2010"
"1016","230890 MORRINHOS",0,8,9,345,0,362,"2010"
"1017","230900 MUCAMBO",0,0,4,178,0,182,"2010"
"1018","230910 MULUNGU",0,0,2,142,0,144,"2010"
"1019","230920 NOVA OLINDA",0,2,3,254,4,263,"2010"
"1020","230930 NOVA RUSSAS",0,1,5,435,0,441,"2010"
"1021","230940 NOVO ORIENTE",0,1,8,319,8,336,"2010"
"1022","230945 OCARA",0,2,13,324,2,341,"2010"
"1023","230950 OROS",1,0,11,297,0,309,"2010"
"1024","230960 PACAJUS",3,3,15,898,6,925,"2010"
"1025","230970 PACATUBA",1,2,17,712,3,735,"2010"
"1026","230980 PACOTI",1,1,3,179,1,185,"2010"
"1027","230990 PACUJA",0,1,1,81,0,83,"2010"
"1028","231000 PALHANO",0,1,2,125,2,130,"2010"
"1029","231010 PALMACIA",0,2,5,104,17,128,"2010"
"1030","231020 PARACURU",2,3,12,444,0,461,"2010"
"1031","231025 PARAIPABA",2,2,6,438,2,450,"2010"
"1032","231030 PARAMBU",1,7,65,394,18,485,"2010"
"1033","231040 PARAMOTI",0,1,4,142,0,147,"2010"
"1034","231050 PEDRA BRANCA",5,3,19,609,3,639,"2010"
"1035","231060 PENAFORTE",0,0,11,175,0,186,"2010"
"1036","231070 PENTECOSTE",2,2,3,495,3,505,"2010"
"1037","231080 PEREIRO",0,0,9,211,2,222,"2010"
"1038","231085 PINDORETAMA",0,1,10,290,1,302,"2010"
"1039","231090 PIQUET CARNEIRO",1,1,4,156,0,162,"2010"
"1040","231095 PIRES FERREIRA",0,3,5,94,0,102,"2010"
"1041","231100 PORANGA",0,0,7,180,8,195,"2010"
"1042","231110 PORTEIRAS",0,1,11,282,0,294,"2010"
"1043","231120 POTENGI",0,3,5,189,1,198,"2010"
"1044","231123 POTIRETAMA",0,0,0,81,0,81,"2010"
"1045","231126 QUITERIANOPOLIS",0,2,10,275,7,294,"2010"
"1046","231130 QUIXADA",5,10,16,1229,2,1262,"2010"
"1047","231135 QUIXELO",0,3,21,209,1,234,"2010"
"1048","231140 QUIXERAMOBIM",3,7,32,1069,16,1127,"2010"
"1049","231150 QUIXERE",0,1,5,279,0,285,"2010"
"1050","231160 REDENCAO",5,2,8,447,1,463,"2010"
"1051","231170 RERIUTABA",0,0,11,282,0,293,"2010"
"1052","231180 RUSSAS",4,3,19,945,1,972,"2010"
"1053","231190 SABOEIRO",0,2,18,209,1,230,"2010"
"1054","231195 SALITRE",1,3,12,256,7,279,"2010"
"1055","231200 SANTANA DO ACARAU",1,1,13,476,0,491,"2010"
"1056","231210 SANTANA DO CARIRI",2,5,10,293,6,316,"2010"
"1057","231220 SANTA QUITERIA",3,4,7,562,0,576,"2010"
"1058","231230 SAO BENEDITO",1,6,38,803,0,848,"2010"
"1059","231240 SAO GONCALO DO AMARANTE",5,1,14,665,6,691,"2010"
"1060","231250 SAO JOAO DO JAGUARIBE",1,0,3,69,2,75,"2010"
"1061","231260 SAO LUIS DO CURU",1,0,5,157,3,166,"2010"
"1062","231270 SENADOR POMPEU",4,3,12,293,2,314,"2010"
"1063","231280 SENADOR SA",0,0,1,110,2,113,"2010"
"1064","231290 SOBRAL",6,23,64,2978,13,3084,"2010"
"1065","231300 SOLONOPOLE",0,1,8,207,0,216,"2010"
"1066","231310 TABULEIRO DO NORTE",2,4,8,409,2,425,"2010"
"1067","231320 TAMBORIL",1,2,4,365,10,382,"2010"
"1068","231325 TARRAFAS",0,4,5,115,0,124,"2010"
"1069","231330 TAUA",2,3,21,715,66,807,"2010"
"1070","231335 TEJUCUOCA",0,1,6,254,5,266,"2010"
"1071","231340 TIANGUA",2,3,23,1228,10,1266,"2010"
"1072","231350 TRAIRI",3,2,13,713,6,737,"2010"
"1073","231355 TURURU",1,3,9,236,0,249,"2010"
"1074","231360 UBAJARA",2,3,4,546,1,556,"2010"
"1075","231370 UMARI",0,1,2,100,1,104,"2010"
"1076","231375 UMIRIM",0,3,4,258,0,265,"2010"
"1077","231380 URUBURETAMA",1,0,7,347,2,357,"2010"
"1078","231390 URUOCA",0,2,5,172,0,179,"2010"
"1079","231395 VARJOTA",0,1,9,259,0,269,"2010"
"1080","231400 VARZEA ALEGRE",0,0,9,519,0,528,"2010"
"1081","231410 VICOSA DO CEARA",0,4,23,1021,7,1055,"2010"
"1082","MUNICIPIO IGNORADO - RN",0,0,0,4,0,4,"2010"
"1083","240010 ACARI",0,1,6,140,0,147,"2010"
"1084","240020 ACU",1,3,9,790,2,805,"2010"
"1085","240030 AFONSO BEZERRA",1,0,1,135,0,137,"2010"
"1086","240040 AGUA NOVA",0,0,1,54,0,55,"2010"
"1087","240050 ALEXANDRIA",1,0,1,189,0,191,"2010"
"1088","240060 ALMINO AFONSO",0,1,0,60,0,61,"2010"
"1089","240070 ALTO DO RODRIGUES",2,1,3,193,1,200,"2010"
"1090","240080 ANGICOS",0,0,4,137,0,141,"2010"
"1091","240090 ANTONIO MARTINS",1,2,2,98,0,103,"2010"
"1092","240100 APODI",1,0,5,406,0,412,"2010"
"1093","240110 AREIA BRANCA",1,2,14,379,0,396,"2010"
"1094","240120 ARES",1,2,4,197,0,204,"2010"
"1095","240130 AUGUSTO SEVERO",0,0,3,93,0,96,"2010"
"1096","240140 BAIA FORMOSA",3,0,6,136,2,147,"2010"
"1097","240145 BARAUNA",1,1,7,423,1,433,"2010"
"1098","240150 BARCELONA",0,0,1,38,0,39,"2010"
"1099","240160 BENTO FERNANDES",0,0,1,66,0,67,"2010"
"1100","240165 BODO",0,2,3,41,0,46,"2010"
"1101","240170 BOM JESUS",0,1,2,140,1,144,"2010"
"1102","240180 BREJINHO",0,1,4,155,0,160,"2010"
"1103","240185 CAICARA DO NORTE",0,2,0,82,0,84,"2010"
"1104","240190 CAICARA DO RIO DO VENTO",0,1,1,50,0,52,"2010"
"1105","240200 CAICO",1,5,41,696,0,743,"2010"
"1106","240210 CAMPO REDONDO",0,1,6,116,1,124,"2010"
"1107","240220 CANGUARETAMA",4,4,11,595,3,617,"2010"
"1108","240230 CARAUBAS",1,3,4,242,0,250,"2010"
"1109","240240 CARNAUBA DOS DANTAS",1,0,8,81,0,90,"2010"
"1110","240250 CARNAUBAIS",0,1,5,134,0,140,"2010"
"1111","240260 CEARA-MIRIM",3,2,22,1118,6,1151,"2010"
"1112","240270 CERRO CORA",0,1,16,155,0,172,"2010"
"1113","240280 CORONEL EZEQUIEL",0,2,2,64,0,68,"2010"
"1114","240290 CORONEL JOAO PESSOA",0,1,1,63,0,65,"2010"
"1115","240300 CRUZETA",0,1,4,100,0,105,"2010"
"1116","240310 CURRAIS NOVOS",1,2,39,528,1,571,"2010"
"1117","240320 DOUTOR SEVERIANO",0,0,2,103,0,105,"2010"
"1118","240325 PARNAMIRIM",13,12,38,3516,9,3588,"2010"
"1119","240330 ENCANTO",0,1,0,82,0,83,"2010"
"1120","240340 EQUADOR",0,1,4,89,0,94,"2010"
"1121","240350 ESPIRITO SANTO",0,1,0,105,1,107,"2010"
"1122","240360 EXTREMOZ",1,5,10,416,2,434,"2010"
"1123","240370 FELIPE GUERRA",0,0,0,64,1,65,"2010"
"1124","240375 FERNANDO PEDROZA",0,0,2,44,0,46,"2010"
"1125","240380 FLORANIA",1,0,8,117,0,126,"2010"
"1126","240390 FRANCISCO DANTAS",0,0,0,33,1,34,"2010"
"1127","240400 FRUTUOSO GOMES",0,0,1,74,0,75,"2010"
"1128","240410 GALINHOS",0,0,0,30,2,32,"2010"
"1129","240420 GOIANINHA",1,3,4,430,1,439,"2010"
"1130","240430 GOVERNADOR DIX-SEPT ROSADO",0,2,2,161,0,165,"2010"
"1131","240440 GROSSOS",0,0,1,113,0,114,"2010"
"1132","240450 GUAMARE",1,0,2,288,0,291,"2010"
"1133","240460 IELMO MARINHO",0,1,2,117,0,120,"2010"
"1134","240470 IPANGUACU",1,0,3,235,1,240,"2010"
"1135","240480 IPUEIRA",0,0,0,23,0,23,"2010"
"1136","240485 ITAJA",0,0,1,123,0,124,"2010"
"1137","240490 ITAU",0,2,0,69,0,71,"2010"
"1138","240500 JACANA",1,1,2,107,0,111,"2010"
"1139","240510 JANDAIRA",2,1,1,108,0,112,"2010"
"1140","240520 JANDUIS",0,0,1,89,1,91,"2010"
"1141","240530 JANUARIO CICCO",0,1,2,123,1,127,"2010"
"1142","240540 JAPI",1,0,1,99,0,101,"2010"
"1143","240550 JARDIM DE ANGICOS",0,1,2,48,0,51,"2010"
"1144","240560 JARDIM DE PIRANHAS",1,1,2,173,1,178,"2010"
"1145","240570 JARDIM DO SERIDO",0,1,2,119,0,122,"2010"
"1146","240580 JOAO CAMARA",1,0,15,540,0,556,"2010"
"1147","240590 JOAO DIAS",0,0,1,51,0,52,"2010"
"1148","240600 JOSE DA PENHA",0,0,1,77,0,78,"2010"
"1149","240610 JUCURUTU",2,0,5,257,0,264,"2010"
"1150","240615 JUNDIA",1,0,0,31,0,32,"2010"
"1151","240620 LAGOA D'ANTA",0,1,2,87,1,91,"2010"
"1152","240630 LAGOA DE PEDRAS",0,0,3,79,0,82,"2010"
"1153","240640 LAGOA DE VELHOS",0,0,2,31,0,33,"2010"
"1154","240650 LAGOA NOVA",1,1,24,232,1,259,"2010"
"1155","240660 LAGOA SALGADA",0,0,7,142,1,150,"2010"
"1156","240670 LAJES",0,1,6,101,0,108,"2010"
"1157","240680 LAJES PINTADAS",0,0,1,77,0,78,"2010"
"1158","240690 LUCRECIA",0,1,1,38,0,40,"2010"
"1159","240700 LUIS GOMES",2,1,1,169,0,173,"2010"
"1160","240710 MACAIBA",4,2,26,917,4,953,"2010"
"1161","240720 MACAU",0,0,3,383,0,386,"2010"
"1162","240725 MAJOR SALES",0,0,0,57,0,57,"2010"
"1163","240730 MARCELINO VIEIRA",0,1,2,110,0,113,"2010"
"1164","240740 MARTINS",0,1,4,96,1,102,"2010"
"1165","240750 MAXARANGUAPE",1,0,3,145,2,151,"2010"
"1166","240760 MESSIAS TARGINO",0,0,1,52,0,53,"2010"
"1167","240770 MONTANHAS",1,1,2,164,1,169,"2010"
"1168","240780 MONTE ALEGRE",0,4,8,252,2,266,"2010"
"1169","240790 MONTE DAS GAMELEIRAS",0,0,2,47,1,50,"2010"
"1170","240800 MOSSORO",11,22,81,3786,6,3906,"2010"
"1171","240810 NATAL",20,54,218,11213,43,11548,"2010"
"1172","240820 NISIA FLORESTA",1,0,3,331,0,335,"2010"
"1173","240830 NOVA CRUZ",5,6,9,560,3,583,"2010"
"1174","240840 OLHO-D'AGUA DO BORGES",0,0,0,43,0,43,"2010"
"1175","240850 OURO BRANCO",0,1,1,71,0,73,"2010"
"1176","240860 PARANA",0,0,0,65,0,65,"2010"
"1177","240870 PARAU",0,0,0,45,0,45,"2010"
"1178","240880 PARAZINHO",0,0,2,75,0,77,"2010"
"1179","240890 PARELHAS",0,2,7,319,0,328,"2010"
"1180","240895 RIO DO FOGO",0,1,5,168,1,175,"2010"
"1181","240910 PASSA E FICA",0,5,9,156,0,170,"2010"
"1182","240920 PASSAGEM",0,0,0,32,0,32,"2010"
"1183","240930 PATU",0,0,0,167,0,167,"2010"
"1184","240933 SANTA MARIA",0,0,2,62,0,64,"2010"
"1185","240940 PAU DOS FERROS",1,0,1,482,0,484,"2010"
"1186","240950 PEDRA GRANDE",0,0,3,59,0,62,"2010"
"1187","240960 PEDRA PRETA",0,0,1,44,0,45,"2010"
"1188","240970 PEDRO AVELINO",0,2,0,82,1,85,"2010"
"1189","240980 PEDRO VELHO",1,0,5,205,0,211,"2010"
"1190","240990 PENDENCIAS",0,0,1,182,0,183,"2010"
"1191","241000 PILOES",0,0,0,41,0,41,"2010"
"1192","241010 POCO BRANCO",0,0,2,167,1,170,"2010"
"1193","241020 PORTALEGRE",0,0,0,136,0,136,"2010"
"1194","241025 PORTO DO MANGUE",0,0,0,71,0,71,"2010"
"1195","241030 SERRA CAIADA",0,3,3,140,1,147,"2010"
"1196","241040 PUREZA",0,2,7,137,1,147,"2010"
"1197","241050 RAFAEL FERNANDES",0,0,1,78,0,79,"2010"
"1198","241060 RAFAEL GODEIRO",0,0,1,43,0,44,"2010"
"1199","241070 RIACHO DA CRUZ",0,0,1,59,0,60,"2010"
"1200","241080 RIACHO DE SANTANA",0,0,1,61,0,62,"2010"
"1201","241090 RIACHUELO",1,2,3,82,0,88,"2010"
"1202","241100 RODOLFO FERNANDES",0,0,0,57,0,57,"2010"
"1203","241105 TIBAU",0,0,2,62,0,64,"2010"
"1204","241110 RUY BARBOSA",0,1,0,25,0,26,"2010"
"1205","241120 SANTA CRUZ",0,5,12,579,4,600,"2010"
"1206","241140 SANTANA DO MATOS",2,1,6,138,1,148,"2010"
"1207","241142 SANTANA DO SERIDO",0,1,0,30,0,31,"2010"
"1208","241150 SANTO ANTONIO",2,1,9,374,2,388,"2010"
"1209","241160 SAO BENTO DO NORTE",0,1,0,48,0,49,"2010"
"1210","241170 SAO BENTO DO TRAIRI",0,0,2,72,1,75,"2010"
"1211","241180 SAO FERNANDO",1,1,2,46,0,50,"2010"
"1212","241190 SAO FRANCISCO DO OESTE",0,0,0,37,0,37,"2010"
"1213","241200 SAO GONCALO DO AMARANTE",3,6,42,1632,2,1685,"2010"
"1214","241210 SAO JOAO DO SABUGI",0,0,3,53,0,56,"2010"
"1215","241220 SAO JOSE DE MIPIBU",2,4,5,660,2,673,"2010"
"1216","241230 SAO JOSE DO CAMPESTRE",1,0,6,181,0,188,"2010"
"1217","241240 SAO JOSE DO SERIDO",0,0,1,42,0,43,"2010"
"1218","241250 SAO MIGUEL",0,2,4,372,0,378,"2010"
"1219","241255 SAO MIGUEL DO GOSTOSO",1,0,4,94,0,99,"2010"
"1220","241260 SAO PAULO DO POTENGI",0,2,5,218,1,226,"2010"
"1221","241270 SAO PEDRO",0,0,1,80,1,82,"2010"
"1222","241280 SAO RAFAEL",1,0,2,78,1,82,"2010"
"1223","241290 SAO TOME",0,1,6,125,0,132,"2010"
"1224","241300 SAO VICENTE",0,1,6,64,0,71,"2010"
"1225","241310 SENADOR ELOI DE SOUZA",0,0,1,80,0,81,"2010"
"1226","241320 SENADOR GEORGINO AVELINO",1,0,1,75,0,77,"2010"
"1227","241330 SERRA DE SAO BENTO",0,0,1,78,0,79,"2010"
"1228","241335 SERRA DO MEL",0,3,1,189,0,193,"2010"
"1229","241340 SERRA NEGRA DO NORTE",0,1,4,89,0,94,"2010"
"1230","241350 SERRINHA",0,1,0,93,0,94,"2010"
"1231","241355 SERRINHA DOS PINTOS",0,0,1,51,0,52,"2010"
"1232","241360 SEVERIANO MELO",0,2,1,92,0,95,"2010"
"1233","241370 SITIO NOVO",0,2,4,67,2,75,"2010"
"1234","241380 TABOLEIRO GRANDE",0,0,0,33,0,33,"2010"
"1235","241390 TAIPU",0,1,7,189,0,197,"2010"
"1236","241400 TANGARA",0,1,6,227,0,234,"2010"
"1237","241410 TENENTE ANANIAS",0,1,2,151,0,154,"2010"
"1238","241415 TENENTE LAURENTINO CRUZ",0,1,3,99,0,103,"2010"
"1239","241420 TIBAU DO SUL",2,1,4,159,1,167,"2010"
"1240","241430 TIMBAUBA DOS BATISTAS",0,0,0,18,0,18,"2010"
"1241","241440 TOUROS",2,2,10,408,3,425,"2010"
"1242","241445 TRIUNFO POTIGUAR",0,0,1,47,0,48,"2010"
"1243","241450 UMARIZAL",1,1,2,129,0,133,"2010"
"1244","241460 UPANEMA",1,2,4,195,1,203,"2010"
"1245","241470 VARZEA",0,1,2,71,0,74,"2010"
"1246","241475 VENHA-VER",1,0,1,50,0,52,"2010"
"1247","241480 VERA CRUZ",0,0,4,157,0,161,"2010"
"1248","241490 VICOSA",0,0,2,36,0,38,"2010"
"1249","241500 VILA FLOR",1,0,0,36,0,37,"2010"
"1250","250010 AGUA BRANCA",0,1,6,119,0,126,"2010"
"1251","250020 AGUIAR",1,1,0,37,32,71,"2010"
"1252","250030 ALAGOA GRANDE",3,1,6,417,2,429,"2010"
"1253","250040 ALAGOA NOVA",1,1,4,319,0,325,"2010"
"1254","250050 ALAGOINHA",0,0,9,216,1,226,"2010"
"1255","250053 ALCANTIL",0,0,1,139,0,140,"2010"
"1256","250057 ALGODAO DE JANDAIRA",0,0,0,50,0,50,"2010"
"1257","250060 ALHANDRA",3,6,9,355,1,374,"2010"
"1258","250070 SAO JOAO DO RIO DO PEIXE",1,2,3,171,1,178,"2010"
"1259","250073 AMPARO",0,0,2,43,0,45,"2010"
"1260","250077 APARECIDA",0,0,0,106,0,106,"2010"
"1261","250080 ARACAGI",0,1,5,204,2,212,"2010"
"1262","250090 ARARA",0,0,1,157,1,159,"2010"
"1263","250100 ARARUNA",0,2,10,280,2,294,"2010"
"1264","250110 AREIA",0,3,4,361,2,370,"2010"
"1265","250115 AREIA DE BARAUNAS",0,0,0,29,1,30,"2010"
"1266","250120 AREIAL",0,2,0,114,1,117,"2010"
"1267","250130 AROEIRAS",7,0,3,281,1,292,"2010"
"1268","250135 ASSUNCAO",1,0,0,61,0,62,"2010"
"1269","250140 BAIA DA TRAICAO",0,1,0,143,1,145,"2010"
"1270","250150 BANANEIRAS",0,1,10,274,1,286,"2010"
"1271","250153 BARAUNA",0,0,0,63,0,63,"2010"
"1272","250157 BARRA DE SANTANA",0,0,5,112,2,119,"2010"
"1273","250160 BARRA DE SANTA ROSA",0,0,2,190,0,192,"2010"
"1274","250170 BARRA DE SAO MIGUEL",1,0,0,107,1,109,"2010"
"1275","250180 BAYEUX",3,10,39,1332,3,1387,"2010"
"1276","250190 BELEM",1,0,6,236,0,243,"2010"
"1277","250200 BELEM DO BREJO DO CRUZ",0,0,2,106,1,109,"2010"
"1278","250205 BERNARDINO BATISTA",1,0,1,62,0,64,"2010"
"1279","250210 BOA VENTURA",0,0,0,79,2,81,"2010"
"1280","250215 BOA VISTA",0,0,2,121,0,123,"2010"
"1281","250220 BOM JESUS",0,0,4,37,0,41,"2010"
"1282","250230 BOM SUCESSO",1,0,0,74,0,75,"2010"
"1283","250240 BONITO DE SANTA FE",0,3,6,189,2,200,"2010"
"1284","250250 BOQUEIRAO",0,1,10,276,1,288,"2010"
"1285","250260 IGARACY",0,0,2,54,26,82,"2010"
"1286","250270 BORBOREMA",0,0,4,74,1,79,"2010"
"1287","250280 BREJO DO CRUZ",0,0,0,222,1,223,"2010"
"1288","250290 BREJO DOS SANTOS",0,0,0,89,0,89,"2010"
"1289","250300 CAAPORA",0,2,0,386,1,389,"2010"
"1290","250310 CABACEIRAS",0,0,2,71,0,73,"2010"
"1291","250320 CABEDELO",2,6,23,943,2,976,"2010"
"1292","250330 CACHOEIRA DOS INDIOS",0,2,5,133,0,140,"2010"
"1293","250340 CACIMBA DE AREIA",0,0,0,46,0,46,"2010"
"1294","250350 CACIMBA DE DENTRO",0,0,6,259,1,266,"2010"
"1295","250355 CACIMBAS",1,2,6,160,9,178,"2010"
"1296","250360 CAICARA",1,0,2,93,0,96,"2010"
"1297","250370 CAJAZEIRAS",6,6,25,834,0,871,"2010"
"1298","250375 CAJAZEIRINHAS",0,0,0,10,52,62,"2010"
"1299","250380 CALDAS BRANDAO",0,1,3,56,0,60,"2010"
"1300","250390 CAMALAU",0,0,1,103,0,104,"2010"
"1301","250400 CAMPINA GRANDE",9,28,94,6129,74,6334,"2010"
"1302","250403 CAPIM",0,1,1,109,0,111,"2010"
"1303","250407 CARAUBAS",1,0,0,69,0,70,"2010"
"1304","250410 CARRAPATEIRA",0,1,0,26,0,27,"2010"
"1305","250415 CASSERENGUE",0,0,3,108,1,112,"2010"
"1306","250420 CATINGUEIRA",1,1,2,61,1,66,"2010"
"1307","250430 CATOLE DO ROCHA",1,2,7,415,0,425,"2010"
"1308","250435 CATURITE",0,0,2,73,1,76,"2010"
"1309","250440 CONCEICAO",0,0,4,215,20,239,"2010"
"1310","250450 CONDADO",0,0,5,121,30,156,"2010"
"1311","250460 CONDE",0,1,7,384,7,399,"2010"
"1312","250470 CONGO",0,0,1,83,2,86,"2010"
"1313","250480 COREMAS",0,13,38,166,6,223,"2010"
"1314","250485 COXIXOLA",0,0,1,23,0,24,"2010"
"1315","250490 CRUZ DO ESPIRITO SANTO",0,4,8,278,0,290,"2010"
"1316","250500 CUBATI",0,0,0,110,0,110,"2010"
"1317","250510 CUITE",2,1,4,285,0,292,"2010"
"1318","250520 CUITEGI",0,0,2,134,1,137,"2010"
"1319","250523 CUITE DE MAMANGUAPE",0,0,0,93,1,94,"2010"
"1320","250527 CURRAL DE CIMA",0,0,1,78,0,79,"2010"
"1321","250530 CURRAL VELHO",0,0,1,21,1,23,"2010"
"1322","250535 DAMIAO",0,0,1,87,1,89,"2010"
"1323","250540 DESTERRO",0,1,2,109,1,113,"2010"
"1324","250550 VISTA SERRANA",0,0,2,42,4,48,"2010"
"1325","250560 DIAMANTE",0,1,0,73,6,80,"2010"
"1326","250570 DONA INES",0,1,4,166,0,171,"2010"
"1327","250580 DUAS ESTRADAS",0,0,1,54,1,56,"2010"
"1328","250590 EMAS",1,0,1,39,1,42,"2010"
"1329","250600 ESPERANCA",1,5,7,577,2,592,"2010"
"1330","250610 FAGUNDES",0,3,3,184,3,193,"2010"
"1331","250620 FREI MARTINHO",0,1,1,42,0,44,"2010"
"1332","250625 GADO BRAVO",0,0,5,156,1,162,"2010"
"1333","250630 GUARABIRA",4,6,21,807,2,840,"2010"
"1334","250640 GURINHEM",1,0,3,154,0,158,"2010"
"1335","250650 GURJAO",0,0,0,38,0,38,"2010"
"1336","250660 IBIARA",0,2,1,68,6,77,"2010"
"1337","250670 IMACULADA",0,2,3,162,2,169,"2010"
"1338","250680 INGA",0,1,1,257,3,262,"2010"
"1339","250690 ITABAIANA",0,3,10,263,0,276,"2010"
"1340","250700 ITAPORANGA",0,1,7,285,24,317,"2010"
"1341","250710 ITAPOROROCA",0,2,5,260,4,271,"2010"
"1342","250720 ITATUBA",0,1,6,154,2,163,"2010"
"1343","250730 JACARAU",0,0,7,207,6,220,"2010"
"1344","250740 JERICO",0,1,1,100,6,108,"2010"
"1345","250750 JOAO PESSOA",27,42,155,11254,25,11503,"2010"
"1346","250760 JUAREZ TAVORA",0,1,2,114,3,120,"2010"
"1347","250770 JUAZEIRINHO",0,3,1,277,2,283,"2010"
"1348","250780 JUNCO DO SERIDO",0,0,2,120,2,124,"2010"
"1349","250790 JURIPIRANGA",0,1,4,143,1,149,"2010"
"1350","250800 JURU",0,2,1,145,0,148,"2010"
"1351","250810 LAGOA",0,0,0,36,14,50,"2010"
"1352","250820 LAGOA DE DENTRO",2,1,2,109,3,117,"2010"
"1353","250830 LAGOA SECA",0,6,11,443,1,461,"2010"
"1354","250840 LASTRO",0,0,0,53,0,53,"2010"
"1355","250850 LIVRAMENTO",0,1,1,125,2,129,"2010"
"1356","250855 LOGRADOURO",0,0,2,43,0,45,"2010"
"1357","250860 LUCENA",0,0,7,194,0,201,"2010"
"1358","250870 MAE D'AGUA",0,0,1,56,1,58,"2010"
"1359","250880 MALTA",0,0,3,73,0,76,"2010"
"1360","250890 MAMANGUAPE",3,8,21,665,8,705,"2010"
"1361","250900 MANAIRA",0,3,5,173,3,184,"2010"
"1362","250905 MARCACAO",0,0,3,132,4,139,"2010"
"1363","250910 MARI",0,1,2,280,1,284,"2010"
"1364","250915 MARIZOPOLIS",0,0,1,92,0,93,"2010"
"1365","250920 MASSARANDUBA",0,0,3,196,5,204,"2010"
"1366","250930 MATARACA",0,0,2,135,2,139,"2010"
"1367","250933 MATINHAS",0,0,2,66,1,69,"2010"
"1368","250937 MATO GROSSO",0,0,0,33,0,33,"2010"
"1369","250939 MATUREIA",0,0,3,95,0,98,"2010"
"1370","250940 MOGEIRO",0,0,1,147,2,150,"2010"
"1371","250950 MONTADAS",0,0,1,79,1,81,"2010"
"1372","250960 MONTE HOREBE",1,1,4,74,1,81,"2010"
"1373","250970 MONTEIRO",0,1,9,436,0,446,"2010"
"1374","250980 MULUNGU",0,0,0,128,2,130,"2010"
"1375","250990 NATUBA",1,0,2,100,0,103,"2010"
"1376","251000 NAZAREZINHO",0,1,2,88,0,91,"2010"
"1377","251010 NOVA FLORESTA",0,1,4,151,1,157,"2010"
"1378","251020 NOVA OLINDA",1,0,2,62,63,128,"2010"
"1379","251030 NOVA PALMEIRA",0,0,1,42,0,43,"2010"
"1380","251040 OLHO D'AGUA",0,0,3,111,11,125,"2010"
"1381","251050 OLIVEDOS",0,0,0,38,0,38,"2010"
"1382","251060 OURO VELHO",1,0,1,45,0,47,"2010"
"1383","251065 PARARI",0,1,1,25,0,27,"2010"
"1384","251070 PASSAGEM",0,0,0,33,0,33,"2010"
"1385","251080 PATOS",6,14,38,1447,14,1519,"2010"
"1386","251090 PAULISTA",0,0,2,53,101,156,"2010"
"1387","251100 PEDRA BRANCA",0,0,3,45,22,70,"2010"
"1388","251110 PEDRA LAVRADA",0,1,5,110,0,116,"2010"
"1389","251120 PEDRAS DE FOGO",2,5,9,412,1,429,"2010"
"1390","251130 PIANCO",0,2,3,97,105,207,"2010"
"1391","251140 PICUI",0,1,3,280,2,286,"2010"
"1392","251150 PILAR",0,0,3,151,0,154,"2010"
"1393","251160 PILOES",1,1,4,132,0,138,"2010"
"1394","251170 PILOEZINHOS",1,0,1,93,0,95,"2010"
"1395","251180 PIRPIRITUBA",0,0,2,152,0,154,"2010"
"1396","251190 PITIMBU",0,3,6,295,1,305,"2010"
"1397","251200 POCINHOS",0,1,6,284,2,293,"2010"
"1398","251203 POCO DANTAS",0,0,1,75,1,77,"2010"
"1399","251207 POCO DE JOSE DE MOURA",0,1,0,47,0,48,"2010"
"1400","251210 POMBAL",1,0,2,39,360,402,"2010"
"1401","251220 PRATA",0,0,1,59,0,60,"2010"
"1402","251230 PRINCESA ISABEL",1,8,6,319,2,336,"2010"
"1403","251240 PUXINANA",0,1,2,193,3,199,"2010"
"1404","251250 QUEIMADAS",1,7,10,636,6,660,"2010"
"1405","251260 QUIXABA",0,0,1,21,0,22,"2010"
"1406","251270 REMIGIO",0,1,5,273,3,282,"2010"
"1407","251272 PEDRO REGIS",0,1,2,78,5,86,"2010"
"1408","251274 RIACHAO",0,0,0,65,1,66,"2010"
"1409","251275 RIACHAO DO BACAMARTE",0,0,0,48,2,50,"2010"
"1410","251276 RIACHAO DO POCO",0,0,0,54,0,54,"2010"
"1411","251278 RIACHO DE SANTO ANTONIO",0,0,0,42,1,43,"2010"
"1412","251280 RIACHO DOS CAVALOS",0,1,2,144,2,149,"2010"
"1413","251290 RIO TINTO",2,3,5,329,1,340,"2010"
"1414","251300 SALGADINHO",0,1,0,46,0,47,"2010"
"1415","251310 SALGADO DE SAO FELIX",0,2,4,78,0,84,"2010"
"1416","251315 SANTA CECILIA",0,0,1,94,0,95,"2010"
"1417","251320 SANTA CRUZ",0,1,1,80,2,84,"2010"
"1418","251330 SANTA HELENA",0,1,1,70,0,72,"2010"
"1419","251335 SANTA INES",0,0,3,58,5,66,"2010"
"1420","251340 SANTA LUZIA",0,3,6,193,4,206,"2010"
"1421","251350 SANTANA DE MANGUEIRA",0,3,1,78,8,90,"2010"
"1422","251360 SANTANA DOS GARROTES",0,0,0,44,51,95,"2010"
"1423","251365 JOCA CLAUDINO",0,1,1,36,0,38,"2010"
"1424","251370 SANTA RITA",10,12,41,2116,1,2180,"2010"
"1425","251380 SANTA TERESINHA",0,1,0,71,1,73,"2010"
"1426","251385 SANTO ANDRE",0,1,0,34,1,36,"2010"
"1427","251390 SAO BENTO",0,2,9,454,4,469,"2010"
"1428","251392 SAO BENTINHO",0,0,2,3,45,50,"2010"
"1429","251394 SAO DOMINGOS DO CARIRI",0,0,0,47,0,47,"2010"
"1430","251396 SAO DOMINGOS",0,0,0,9,32,41,"2010"
"1431","251398 SAO FRANCISCO",0,0,0,43,0,43,"2010"
"1432","251400 SAO JOAO DO CARIRI",0,1,0,68,0,69,"2010"
"1433","251410 SAO JOAO DO TIGRE",0,0,4,59,1,64,"2010"
"1434","251420 SAO JOSE DA LAGOA TAPADA",0,0,5,80,1,86,"2010"
"1435","251430 SAO JOSE DE CAIANA",1,0,1,83,8,93,"2010"
"1436","251440 SAO JOSE DE ESPINHARAS",0,0,1,61,0,62,"2010"
"1437","251445 SAO JOSE DOS RAMOS",0,0,3,79,0,82,"2010"
"1438","251450 SAO JOSE DE PIRANHAS",2,2,10,242,4,260,"2010"
"1439","251455 SAO JOSE DE PRINCESA",1,1,1,56,0,59,"2010"
"1440","251460 SAO JOSE DO BONFIM",0,0,0,49,0,49,"2010"
"1441","251465 SAO JOSE DO BREJO DO CRUZ",0,0,1,26,0,27,"2010"
"1442","251470 SAO JOSE DO SABUGI",0,1,1,38,0,40,"2010"
"1443","251480 SAO JOSE DOS CORDEIROS",0,0,1,55,0,56,"2010"
"1444","251490 SAO MAMEDE",2,0,1,88,0,91,"2010"
"1445","251500 SAO MIGUEL DE TAIPU",0,0,3,113,0,116,"2010"
"1446","251510 SAO SEBASTIAO DE LAGOA DE ROCA",0,0,3,145,3,151,"2010"
"1447","251520 SAO SEBASTIAO DO UMBUZEIRO",0,0,1,48,0,49,"2010"
"1448","251530 SAPE",0,4,23,740,2,769,"2010"
"1449","251540 SAO VICENTE DO SERIDO",0,0,1,180,0,181,"2010"
"1450","251550 SERRA BRANCA",0,0,2,161,1,164,"2010"
"1451","251560 SERRA DA RAIZ",0,0,1,44,0,45,"2010"
"1452","251570 SERRA GRANDE",0,0,1,49,2,52,"2010"
"1453","251580 SERRA REDONDA",0,1,3,82,1,87,"2010"
"1454","251590 SERRARIA",0,0,7,74,1,82,"2010"
"1455","251593 SERTAOZINHO",0,1,0,75,3,79,"2010"
"1456","251597 SOBRADO",0,2,2,122,0,126,"2010"
"1457","251600 SOLANEA",2,3,12,390,0,407,"2010"
"1458","251610 SOLEDADE",0,1,6,213,2,222,"2010"
"1459","251615 SOSSEGO",0,0,1,44,0,45,"2010"
"1460","251620 SOUSA",5,8,11,915,3,942,"2010"
"1461","251630 SUME",0,0,5,238,1,244,"2010"
"1462","251640 TACIMA",0,1,1,118,0,120,"2010"
"1463","251650 TAPEROA",1,0,4,205,6,216,"2010"
"1464","251660 TAVARES",1,3,13,237,2,256,"2010"
"1465","251670 TEIXEIRA",0,1,4,242,0,247,"2010"
"1466","251675 TENORIO",0,0,2,40,0,42,"2010"
"1467","251680 TRIUNFO",0,4,4,108,0,116,"2010"
"1468","251690 UIRAUNA",0,0,1,182,0,183,"2010"
"1469","251700 UMBUZEIRO",0,0,4,114,0,118,"2010"
"1470","251710 VARZEA",0,1,2,21,0,24,"2010"
"1471","251720 VIEIROPOLIS",1,0,2,52,0,55,"2010"
"1472","251740 ZABELE",0,0,0,39,0,39,"2010"
"1473","260005 ABREU E LIMA",6,9,17,1317,2,1351,"2010"
"1474","260010 AFOGADOS DA INGAZEIRA",2,2,13,554,3,574,"2010"
"1475","260020 AFRANIO",0,4,3,144,161,312,"2010"
"1476","260030 AGRESTINA",0,2,7,282,0,291,"2010"
"1477","260040 AGUA PRETA",1,2,12,444,9,468,"2010"
"1478","260050 AGUAS BELAS",3,4,10,599,195,811,"2010"
"1479","260060 ALAGOINHA",0,0,6,232,0,238,"2010"
"1480","260070 ALIANCA",3,1,12,562,0,578,"2010"
"1481","260080 ALTINHO",0,0,2,251,2,255,"2010"
"1482","260090 AMARAJI",1,0,6,288,3,298,"2010"
"1483","260100 ANGELIM",0,1,1,137,3,142,"2010"
"1484","260105 ARACOIABA",2,1,5,298,4,310,"2010"
"1485","260110 ARARIPINA",12,15,40,1610,15,1692,"2010"
"1486","260120 ARCOVERDE",9,3,19,1040,8,1079,"2010"
"1487","260130 BARRA DE GUABIRABA",0,3,3,184,1,191,"2010"
"1488","260140 BARREIROS",1,2,13,688,6,710,"2010"
"1489","260150 BELEM DE MARIA",0,0,1,142,0,143,"2010"
"1490","260160 BELEM DE SAO FRANCISCO",0,2,9,388,0,399,"2010"
"1491","260170 BELO JARDIM",3,7,22,1139,4,1175,"2010"
"1492","260180 BETANIA",1,2,19,189,1,212,"2010"
"1493","260190 BEZERROS",2,4,7,767,1,781,"2010"
"1494","260200 BODOCO",1,2,10,591,9,613,"2010"
"1495","260210 BOM CONSELHO",1,3,9,725,8,746,"2010"
"1496","260220 BOM JARDIM",1,1,4,553,0,559,"2010"
"1497","260230 BONITO",4,0,6,614,0,624,"2010"
"1498","260240 BREJAO",2,1,4,166,0,173,"2010"
"1499","260250 BREJINHO",0,1,1,100,1,103,"2010"
"1500","260260 BREJO DA MADRE DE DEUS",4,9,16,679,8,716,"2010"
"1501","260270 BUENOS AIRES",0,1,5,207,0,213,"2010"
"1502","260280 BUIQUE",5,5,20,1027,8,1065,"2010"
"1503","260290 CABO DE SANTO AGOSTINHO",6,13,72,3212,19,3322,"2010"
"1504","260300 CABROBO",1,3,11,537,2,554,"2010"
"1505","260310 CACHOEIRINHA",1,3,9,284,1,298,"2010"
"1506","260320 CAETES",2,3,14,466,3,488,"2010"
"1507","260330 CALCADO",0,1,1,151,0,153,"2010"
"1508","260340 CALUMBI",0,4,5,87,0,96,"2010"
"1509","260345 CAMARAGIBE",7,9,40,2075,12,2143,"2010"
"1510","260350 CAMOCIM DE SAO FELIX",0,1,2,243,0,246,"2010"
"1511","260360 CAMUTANGA",2,0,4,105,0,111,"2010"
"1512","260370 CANHOTINHO",1,6,8,340,1,356,"2010"
"1513","260380 CAPOEIRAS",0,0,5,334,0,339,"2010"
"1514","260390 CARNAIBA",3,2,4,301,0,310,"2010"
"1515","260392 CARNAUBEIRA DA PENHA",1,0,15,290,20,326,"2010"
"1516","260400 CARPINA",5,4,11,1021,1,1042,"2010"
"1517","260410 CARUARU",18,21,56,5005,32,5132,"2010"
"1518","260415 CASINHAS",0,0,1,201,0,202,"2010"
"1519","260420 CATENDE",1,2,8,558,4,573,"2010"
"1520","260430 CEDRO",1,0,7,198,0,206,"2010"
"1521","260440 CHA DE ALEGRIA",0,0,2,185,2,189,"2010"
"1522","260450 CHA GRANDE",0,3,2,263,2,270,"2010"
"1523","260460 CONDADO",0,1,3,281,0,285,"2010"
"1524","260470 CORRENTES",1,3,3,227,0,234,"2010"
"1525","260480 CORTES",0,1,2,185,0,188,"2010"
"1526","260490 CUMARU",0,3,2,206,1,212,"2010"
"1527","260500 CUPIRA",0,3,5,334,0,342,"2010"
"1528","260510 CUSTODIA",2,6,18,541,0,567,"2010"
"1529","260515 DORMENTES",1,3,4,204,129,341,"2010"
"1530","260520 ESCADA",2,3,9,979,7,1000,"2010"
"1531","260530 EXU",2,3,4,583,18,610,"2010"
"1532","260540 FEIRA NOVA",1,1,4,323,1,330,"2010"
"1533","260545 FERNANDO DE NORONHA",0,0,1,21,1,23,"2010"
"1534","260550 FERREIROS",0,0,2,177,2,181,"2010"
"1535","260560 FLORES",4,0,14,286,1,305,"2010"
"1536","260570 FLORESTA",2,5,12,571,3,593,"2010"
"1537","260580 FREI MIGUELINHO",0,0,6,161,0,167,"2010"
"1538","260590 GAMELEIRA",0,2,4,307,0,313,"2010"
"1539","260600 GARANHUNS",3,9,31,2364,3,2410,"2010"
"1540","260610 GLORIA DO GOITA",1,0,7,404,0,412,"2010"
"1541","260620 GOIANA",1,2,30,1107,3,1143,"2010"
"1542","260630 GRANITO",1,0,0,60,43,104,"2010"
"1543","260640 GRAVATA",4,3,17,1075,7,1106,"2010"
"1544","260650 IATI",1,2,3,312,1,319,"2010"
"1545","260660 IBIMIRIM",2,2,5,489,4,502,"2010"
"1546","260670 IBIRAJUBA",0,0,1,98,3,102,"2010"
"1547","260680 IGARASSU",4,9,26,1331,9,1379,"2010"
"1548","260690 IGUARACY",3,0,0,173,0,176,"2010"
"1549","260700 INAJA",3,4,10,280,35,332,"2010"
"1550","260710 INGAZEIRA",0,2,2,65,1,70,"2010"
"1551","260720 IPOJUCA",5,5,26,1424,8,1468,"2010"
"1552","260730 IPUBI",5,5,8,599,5,622,"2010"
"1553","260740 ITACURUBA",2,0,0,87,0,89,"2010"
"1554","260750 ITAIBA",2,3,6,313,121,445,"2010"
"1555","260760 ILHA DE ITAMARACA",0,2,5,248,4,259,"2010"
"1556","260765 ITAMBE",4,4,13,571,0,592,"2010"
"1557","260770 ITAPETIM",0,2,2,217,0,221,"2010"
"1558","260775 ITAPISSUMA",1,1,3,308,4,317,"2010"
"1559","260780 ITAQUITINGA",0,4,9,258,3,274,"2010"
"1560","260790 JABOATAO DOS GUARARAPES",18,33,129,8617,39,8836,"2010"
"1561","260795 JAQUEIRA",1,1,2,147,1,152,"2010"
"1562","260800 JATAUBA",0,1,16,262,5,284,"2010"
"1563","260805 JATOBA",1,2,4,167,52,226,"2010"
"1564","260810 JOAO ALFREDO",0,2,6,369,0,377,"2010"
"1565","260820 JOAQUIM NABUCO",0,1,2,204,1,208,"2010"
"1566","260825 JUCATI",1,1,2,179,0,183,"2010"
"1567","260830 JUPI",2,2,5,278,0,287,"2010"
"1568","260840 JUREMA",0,2,4,216,1,223,"2010"
"1569","260845 LAGOA DO CARRO",0,0,0,228,1,229,"2010"
"1570","260850 LAGOA DE ITAENGA",1,0,9,361,1,372,"2010"
"1571","260860 LAGOA DO OURO",1,1,6,211,0,219,"2010"
"1572","260870 LAGOA DOS GATOS",0,2,0,201,1,204,"2010"
"1573","260875 LAGOA GRANDE",0,9,12,392,12,425,"2010"
"1574","260880 LAJEDO",1,1,18,657,4,681,"2010"
"1575","260890 LIMOEIRO",2,5,7,759,1,774,"2010"
"1576","260900 MACAPARANA",2,1,10,341,1,355,"2010"
"1577","260910 MACHADOS",2,2,2,208,2,216,"2010"
"1578","260915 MANARI",3,4,7,294,55,363,"2010"
"1579","260920 MARAIAL",1,0,1,179,3,184,"2010"
"1580","260930 MIRANDIBA",0,1,13,287,2,303,"2010"
"1581","260940 MORENO",1,3,8,708,3,723,"2010"
"1582","260950 NAZARE DA MATA",5,2,6,427,1,441,"2010"
"1583","260960 OLINDA",21,18,87,5863,23,6012,"2010"
"1584","260970 OROBO",0,0,3,290,1,294,"2010"
"1585","260980 OROCO",0,1,2,234,6,243,"2010"
"1586","260990 OURICURI",3,3,16,986,40,1048,"2010"
"1587","261000 PALMARES",3,6,12,859,5,885,"2010"
"1588","261010 PALMEIRINA",0,2,1,132,0,135,"2010"
"1589","261020 PANELAS",1,3,9,400,4,417,"2010"
"1590","261030 PARANATAMA",0,0,2,198,3,203,"2010"
"1591","261040 PARNAMIRIM",0,3,1,388,6,398,"2010"
"1592","261050 PASSIRA",1,0,9,483,2,495,"2010"
"1593","261060 PAUDALHO",1,2,6,839,2,850,"2010"
"1594","261070 PAULISTA",15,18,60,3515,10,3618,"2010"
"1595","261080 PEDRA",6,3,10,368,1,388,"2010"
"1596","261090 PESQUEIRA",4,6,15,1095,5,1125,"2010"
"1597","261100 PETROLANDIA",1,6,11,611,18,647,"2010"
"1598","261110 PETROLINA",26,35,116,5037,138,5352,"2010"
"1599","261120 POCAO",0,0,6,222,0,228,"2010"
"1600","261130 POMBOS",0,0,6,349,1,356,"2010"
"1601","261140 PRIMAVERA",0,0,2,177,1,180,"2010"
"1602","261150 QUIPAPA",0,1,4,344,0,349,"2010"
"1603","261153 QUIXABA",0,2,2,83,2,89,"2010"
"1604","261160 RECIFE",71,96,284,21276,69,21796,"2010"
"1605","261170 RIACHO DAS ALMAS",0,2,3,264,1,270,"2010"
"1606","261180 RIBEIRAO",0,0,11,568,3,582,"2010"
"1607","261190 RIO FORMOSO",1,3,9,400,2,415,"2010"
"1608","261200 SAIRE",0,0,2,135,0,137,"2010"
"1609","261210 SALGADINHO",0,2,1,92,1,96,"2010"
"1610","261220 SALGUEIRO",7,7,42,1005,4,1065,"2010"
"1611","261230 SALOA",0,1,1,245,0,247,"2010"
"1612","261240 SANHARO",2,2,6,301,0,311,"2010"
"1613","261245 SANTA CRUZ",2,3,8,401,6,420,"2010"
"1614","261247 SANTA CRUZ DA BAIXA VERDE",2,4,16,233,1,256,"2010"
"1615","261250 SANTA CRUZ DO CAPIBARIBE",7,2,27,1012,2,1050,"2010"
"1616","261255 SANTA FILOMENA",0,0,1,187,83,271,"2010"
"1617","261260 SANTA MARIA DA BOA VISTA",2,5,10,437,346,800,"2010"
"1618","261270 SANTA MARIA DO CAMBUCA",1,1,2,198,0,202,"2010"
"1619","261280 SANTA TEREZINHA",2,0,5,147,2,156,"2010"
"1620","261290 SAO BENEDITO DO SUL",0,0,2,125,0,127,"2010"
"1621","261300 SAO BENTO DO UNA",1,2,5,796,3,807,"2010"
"1622","261310 SAO CAITANO",1,4,5,571,1,582,"2010"
"1623","261320 SAO JOAO",2,4,11,315,0,332,"2010"
"1624","261330 SAO JOAQUIM DO MONTE",0,0,8,350,0,358,"2010"
"1625","261340 SAO JOSE DA COROA GRANDE",2,2,3,297,3,307,"2010"
"1626","261350 SAO JOSE DO BELMONTE",1,1,17,490,2,511,"2010"
"1627","261360 SAO JOSE DO EGITO",0,3,6,379,1,389,"2010"
"1628","261370 SAO LOURENCO DA MATA",6,9,26,1419,3,1463,"2010"
"1629","261380 SAO VICENTE FERRER",0,3,8,275,0,286,"2010"
"1630","261390 SERRA TALHADA",6,16,80,1231,7,1340,"2010"
"1631","261400 SERRITA",1,3,6,319,3,332,"2010"
"1632","261410 SERTANIA",3,2,14,476,2,497,"2010"
"1633","261420 SIRINHAEM",1,5,35,634,2,677,"2010"
"1634","261430 MOREILANDIA",2,0,5,140,3,150,"2010"
"1635","261440 SOLIDAO",0,1,0,102,1,104,"2010"
"1636","261450 SURUBIM",2,2,10,884,0,898,"2010"
"1637","261460 TABIRA",2,1,7,377,1,388,"2010"
"1638","261470 TACAIMBO",0,5,2,188,0,195,"2010"
"1639","261480 TACARATU",1,2,16,291,42,352,"2010"
"1640","261485 TAMANDARE",2,0,4,366,2,374,"2010"
"1641","261500 TAQUARITINGA DO NORTE",0,2,17,368,0,387,"2010"
"1642","261510 TEREZINHA",0,2,1,107,0,110,"2010"
"1643","261520 TERRA NOVA",1,2,9,138,0,150,"2010"
"1644","261530 TIMBAUBA",2,2,10,813,3,830,"2010"
"1645","261540 TORITAMA",2,4,15,603,1,625,"2010"
"1646","261550 TRACUNHAEM",0,1,1,228,1,231,"2010"
"1647","261560 TRINDADE",0,4,4,630,4,642,"2010"
"1648","261570 TRIUNFO",0,0,6,205,1,212,"2010"
"1649","261580 TUPANATINGA",2,0,8,356,18,384,"2010"
"1650","261590 TUPARETAMA",1,0,1,123,1,126,"2010"
"1651","261600 VENTUROSA",1,2,6,274,1,284,"2010"
"1652","261610 VERDEJANTE",0,0,9,151,1,161,"2010"
"1653","261618 VERTENTE DO LERIO",0,0,1,132,0,133,"2010"
"1654","261620 VERTENTES",0,2,8,299,1,310,"2010"
"1655","261630 VICENCIA",1,2,7,403,1,414,"2010"
"1656","261640 VITORIA DE SANTO ANTAO",7,4,28,1942,7,1988,"2010"
"1657","261650 XEXEU",1,0,2,267,3,273,"2010"
"1658","270010 AGUA BRANCA",1,1,4,113,281,400,"2010"
"1659","270020 ANADIA",2,1,2,228,49,282,"2010"
"1660","270030 ARAPIRACA",7,16,89,3683,5,3800,"2010"
"1661","270040 ATALAIA",2,1,11,501,274,789,"2010"
"1662","270050 BARRA DE SANTO ANTONIO",0,0,3,250,24,277,"2010"
"1663","270060 BARRA DE SAO MIGUEL",0,0,2,139,0,141,"2010"
"1664","270070 BATALHA",1,1,9,310,0,321,"2010"
"1665","270080 BELEM",0,0,2,74,0,76,"2010"
"1666","270090 BELO MONTE",0,1,0,93,0,94,"2010"
"1667","270100 BOCA DA MATA",2,3,14,443,4,466,"2010"
"1668","270110 BRANQUINHA",0,0,3,196,1,200,"2010"
"1669","270120 CACIMBINHAS",2,0,4,191,2,199,"2010"
"1670","270130 CAJUEIRO",1,1,5,219,167,393,"2010"
"1671","270135 CAMPESTRE",0,0,1,106,18,125,"2010"
"1672","270140 CAMPO ALEGRE",0,4,6,567,19,596,"2010"
"1673","270150 CAMPO GRANDE",1,2,2,190,3,198,"2010"
"1674","270160 CANAPI",0,0,6,172,174,352,"2010"
"1675","270170 CAPELA",1,3,3,291,6,304,"2010"
"1676","270180 CARNEIROS",0,0,2,144,42,188,"2010"
"1677","270190 CHA PRETA",0,0,0,86,31,117,"2010"
"1678","270200 COITE DO NOIA",0,2,2,161,0,165,"2010"
"1679","270210 COLONIA LEOPOLDINA",1,3,3,310,1,318,"2010"
"1680","270220 COQUEIRO SECO",0,0,3,89,0,92,"2010"
"1681","270230 CORURIPE",0,1,16,717,157,891,"2010"
"1682","270235 CRAIBAS",0,2,13,382,36,433,"2010"
"1683","270240 DELMIRO GOUVEIA",1,5,8,197,682,893,"2010"
"1684","270250 DOIS RIACHOS",0,1,2,119,38,160,"2010"
"1685","270255 ESTRELA DE ALAGOAS",0,1,10,246,1,258,"2010"
"1686","270260 FEIRA GRANDE",0,6,7,391,2,406,"2010"
"1687","270270 FELIZ DESERTO",0,0,2,93,13,108,"2010"
"1688","270280 FLEXEIRAS",1,0,2,234,0,237,"2010"
"1689","270290 GIRAU DO PONCIANO",1,4,14,545,2,566,"2010"
"1690","270300 IBATEGUARA",1,0,0,292,8,301,"2010"
"1691","270310 IGACI",4,2,9,406,3,424,"2010"
"1692","270320 IGREJA NOVA",1,5,10,423,19,458,"2010"
"1693","270330 INHAPI",1,0,4,80,299,384,"2010"
"1694","270340 JACARE DOS HOMENS",0,0,0,108,3,111,"2010"
"1695","270350 JACUIPE",1,0,1,100,0,102,"2010"
"1696","270360 JAPARATINGA",0,0,2,163,3,168,"2010"
"1697","270370 JARAMATAIA",1,0,4,112,2,119,"2010"
"1698","270375 JEQUIA DA PRAIA",1,0,0,161,17,179,"2010"
"1699","270380 JOAQUIM GOMES",0,7,5,451,12,475,"2010"
"1700","270390 JUNDIA",0,1,1,44,2,48,"2010"
"1701","270400 JUNQUEIRO",2,2,9,366,2,381,"2010"
"1702","270410 LAGOA DA CANOA",1,1,9,320,0,331,"2010"
"1703","270420 LIMOEIRO DE ANADIA",0,2,5,321,2,330,"2010"
"1704","270430 MACEIO",38,40,162,14939,22,15201,"2010"
"1705","270440 MAJOR ISIDORO",0,0,4,163,129,296,"2010"
"1706","270450 MARAGOGI",4,3,5,508,8,528,"2010"
"1707","270460 MARAVILHA",0,0,3,110,59,172,"2010"
"1708","270470 MARECHAL DEODORO",1,5,9,818,5,838,"2010"
"1709","270480 MARIBONDO",0,1,10,199,1,211,"2010"
"1710","270490 MAR VERMELHO",0,0,0,46,5,51,"2010"
"1711","270500 MATA GRANDE",0,1,5,103,306,415,"2010"
"1712","270510 MATRIZ DE CAMARAGIBE",4,4,6,408,4,426,"2010"
"1713","270520 MESSIAS",1,1,2,306,1,311,"2010"
"1714","270530 MINADOR DO NEGRAO",1,0,2,84,6,93,"2010"
"1715","270540 MONTEIROPOLIS",1,1,3,99,26,130,"2010"
"1716","270550 MURICI",2,1,1,220,260,484,"2010"
"1717","270560 NOVO LINO",4,1,1,132,55,193,"2010"
"1718","270570 OLHO D'AGUA DAS FLORES",1,2,5,385,29,422,"2010"
"1719","270580 OLHO D'AGUA DO CASADO",0,0,0,131,50,181,"2010"
"1720","270590 OLHO D'AGUA GRANDE",1,0,1,59,2,63,"2010"
"1721","270600 OLIVENCA",0,0,0,129,56,185,"2010"
"1722","270610 OURO BRANCO",0,0,1,144,72,217,"2010"
"1723","270620 PALESTINA",0,0,3,41,43,87,"2010"
"1724","270630 PALMEIRA DOS INDIOS",0,5,20,1294,5,1324,"2010"
"1725","270640 PAO DE ACUCAR",3,2,6,247,210,468,"2010"
"1726","270642 PARICONHA",0,0,4,53,135,192,"2010"
"1727","270644 PARIPUEIRA",1,0,0,181,0,182,"2010"
"1728","270650 PASSO DE CAMARAGIBE",2,1,3,269,10,285,"2010"
"1729","270660 PAULO JACINTO",1,2,2,100,17,122,"2010"
"1730","270670 PENEDO",1,6,24,969,44,1044,"2010"
"1731","270680 PIACABUCU",1,3,6,265,14,289,"2010"
"1732","270690 PILAR",2,1,9,440,154,606,"2010"
"1733","270700 PINDOBA",0,0,1,26,11,38,"2010"
"1734","270710 PIRANHAS",3,3,4,403,88,501,"2010"
"1735","270720 POCO DAS TRINCHEIRAS",0,0,3,176,93,272,"2010"
"1736","270730 PORTO CALVO",3,2,8,492,2,507,"2010"
"1737","270740 PORTO DE PEDRAS",0,0,3,122,3,128,"2010"
"1738","270750 PORTO REAL DO COLEGIO",0,3,8,281,10,302,"2010"
"1739","270760 QUEBRANGULO",0,0,4,143,38,185,"2010"
"1740","270770 RIO LARGO",4,3,13,1043,10,1073,"2010"
"1741","270780 ROTEIRO",0,0,0,136,5,141,"2010"
"1742","270790 SANTA LUZIA DO NORTE",1,0,0,89,1,91,"2010"
"1743","270800 SANTANA DO IPANEMA",2,8,10,527,339,886,"2010"
"1744","270810 SANTANA DO MUNDAU",0,0,0,176,3,179,"2010"
"1745","270820 SAO BRAS",0,0,4,81,4,89,"2010"
"1746","270830 SAO JOSE DA LAJE",0,3,4,358,23,388,"2010"
"1747","270840 SAO JOSE DA TAPERA",0,4,10,554,79,647,"2010"
"1748","270850 SAO LUIS DO QUITUNDE",1,3,11,665,13,693,"2010"
"1749","270860 SAO MIGUEL DOS CAMPOS",1,4,10,882,8,905,"2010"
"1750","270870 SAO MIGUEL DOS MILAGRES",0,0,1,129,6,136,"2010"
"1751","270880 SAO SEBASTIAO",2,4,9,619,4,638,"2010"
"1752","270890 SATUBA",1,0,3,161,1,166,"2010"
"1753","270895 SENADOR RUI PALMEIRA",0,2,3,162,82,249,"2010"
"1754","270900 TANQUE D'ARCA",0,1,2,101,2,106,"2010"
"1755","270910 TAQUARANA",1,0,6,313,25,345,"2010"
"1756","270915 TEOTONIO VILELA",1,0,4,408,327,740,"2010"
"1757","270920 TRAIPU",1,3,12,405,6,427,"2010"
"1758","270930 UNIAO DOS PALMARES",4,3,12,1174,12,1205,"2010"
"1759","270940 VICOSA",0,2,15,272,166,455,"2010"
"1760","280010 AMPARO DE SAO FRANCISCO",0,0,3,35,1,39,"2010"
"1761","280020 AQUIDABA",3,1,11,239,14,268,"2010"
"1762","280030 ARACAJU",42,37,197,9028,63,9367,"2010"
"1763","280040 ARAUA",0,0,1,180,2,183,"2010"
"1764","280050 AREIA BRANCA",0,2,4,275,4,285,"2010"
"1765","280060 BARRA DOS COQUEIROS",1,2,4,386,3,396,"2010"
"1766","280067 BOQUIM",2,1,1,406,6,416,"2010"
"1767","280070 BREJO GRANDE",0,0,3,133,10,146,"2010"
"1768","280100 CAMPO DO BRITO",0,1,1,279,1,282,"2010"
"1769","280110 CANHOBA",0,0,2,53,19,74,"2010"
"1770","280120 CANINDE DE SAO FRANCISCO",2,2,16,526,83,629,"2010"
"1771","280130 CAPELA",3,2,12,470,46,533,"2010"
"1772","280140 CARIRA",2,1,5,316,7,331,"2010"
"1773","280150 CARMOPOLIS",2,0,5,236,13,256,"2010"
"1774","280160 CEDRO DE SAO JOAO",1,0,2,68,2,73,"2010"
"1775","280170 CRISTINAPOLIS",1,1,10,316,0,328,"2010"
"1776","280190 CUMBE",0,1,2,42,6,51,"2010"
"1777","280200 DIVINA PASTORA",0,1,2,65,0,68,"2010"
"1778","280210 ESTANCIA",4,5,20,1080,0,1109,"2010"
"1779","280220 FEIRA NOVA",0,1,2,66,19,88,"2010"
"1780","280230 FREI PAULO",2,2,1,228,1,234,"2010"
"1781","280240 GARARU",0,1,0,116,39,156,"2010"
"1782","280250 GENERAL MAYNARD",0,1,0,38,0,39,"2010"
"1783","280260 GRACHO CARDOSO",1,0,0,62,21,84,"2010"
"1784","280270 ILHA DAS FLORES",3,2,5,140,10,160,"2010"
"1785","280280 INDIAROBA",2,3,3,269,12,289,"2010"
"1786","280290 ITABAIANA",3,9,14,1446,6,1478,"2010"
"1787","280300 ITABAIANINHA",2,3,12,667,8,692,"2010"
"1788","280310 ITABI",1,0,2,36,7,46,"2010"
"1789","280320 ITAPORANGA D'AJUDA",2,3,14,544,0,563,"2010"
"1790","280330 JAPARATUBA",1,1,9,255,10,276,"2010"
"1791","280340 JAPOATA",1,0,2,189,27,219,"2010"
"1792","280350 LAGARTO",7,3,38,1315,19,1382,"2010"
"1793","280360 LARANJEIRAS",4,3,12,413,22,454,"2010"
"1794","280370 MACAMBIRA",0,0,0,94,0,94,"2010"
"1795","280380 MALHADA DOS BOIS",1,0,2,59,6,68,"2010"
"1796","280390 MALHADOR",0,1,1,196,0,198,"2010"
"1797","280400 MARUIM",1,0,6,306,9,322,"2010"
"1798","280410 MOITA BONITA",0,2,4,164,2,172,"2010"
"1799","280420 MONTE ALEGRE DE SERGIPE",3,1,5,172,58,239,"2010"
"1800","280430 MURIBECA",0,2,3,84,4,93,"2010"
"1801","280440 NEOPOLIS",3,1,12,244,15,275,"2010"
"1802","280445 NOSSA SENHORA APARECIDA",1,1,0,120,1,123,"2010"
"1803","280450 NOSSA SENHORA DA GLORIA",2,0,8,334,157,501,"2010"
"1804","280460 NOSSA SENHORA DAS DORES",2,1,15,303,40,361,"2010"
"1805","280470 NOSSA SENHORA DE LOURDES",0,0,3,80,13,96,"2010"
"1806","280480 NOSSA SENHORA DO SOCORRO",13,14,82,2597,14,2720,"2010"
"1807","280490 PACATUBA",0,0,6,171,18,195,"2010"
"1808","280500 PEDRA MOLE",0,0,0,43,0,43,"2010"
"1809","280510 PEDRINHAS",0,0,2,105,1,108,"2010"
"1810","280520 PINHAO",1,1,5,96,0,103,"2010"
"1811","280530 PIRAMBU",0,0,2,112,2,116,"2010"
"1812","280540 POCO REDONDO",2,2,15,372,156,547,"2010"
"1813","280550 POCO VERDE",1,0,2,263,5,271,"2010"
"1814","280560 PORTO DA FOLHA",3,2,13,378,91,487,"2010"
"1815","280570 PROPRIA",1,3,5,361,36,406,"2010"
"1816","280580 RIACHAO DO DANTAS",1,1,6,297,13,318,"2010"
"1817","280590 RIACHUELO",3,0,3,174,3,183,"2010"
"1818","280600 RIBEIROPOLIS",0,1,2,214,1,218,"2010"
"1819","280610 ROSARIO DO CATETE",0,1,3,177,4,185,"2010"
"1820","280620 SALGADO",1,1,3,254,6,265,"2010"
"1821","280630 SANTA LUZIA DO ITANHY",0,2,2,263,1,268,"2010"
"1822","280640 SANTANA DO SAO FRANCISCO",0,1,6,120,9,136,"2010"
"1823","280650 SANTA ROSA DE LIMA",2,1,2,56,1,62,"2010"
"1824","280660 SANTO AMARO DAS BROTAS",4,1,5,176,3,189,"2010"
"1825","280670 SAO CRISTOVAO",11,6,34,1280,7,1338,"2010"
"1826","280680 SAO DOMINGOS",1,1,1,145,0,148,"2010"
"1827","280690 SAO FRANCISCO",0,0,0,41,5,46,"2010"
"1828","280700 SAO MIGUEL DO ALEIXO",0,1,1,56,5,63,"2010"
"1829","280710 SIMAO DIAS",3,3,19,500,4,529,"2010"
"1830","280720 SIRIRI",0,0,5,143,5,153,"2010"
"1831","280730 TELHA",0,0,0,34,1,35,"2010"
"1832","280740 TOBIAS BARRETO",2,2,14,682,17,717,"2010"
"1833","280750 TOMAR DO GERU",0,1,1,219,2,223,"2010"
"1834","280760 UMBAUBA",1,0,5,402,0,408,"2010"
"1835","MUNICIPIO IGNORADO - BA",0,0,0,7,1,8,"2010"
"1836","290010 ABAIRA",0,0,0,42,5,47,"2010"
"1837","290020 ABARE",3,0,13,286,4,306,"2010"
"1838","290030 ACAJUTIBA",2,4,1,234,4,245,"2010"
"1839","290035 ADUSTINA",1,1,8,180,0,190,"2010"
"1840","290040 AGUA FRIA",0,0,2,126,56,184,"2010"
"1841","290050 ERICO CARDOSO",1,1,1,66,50,119,"2010"
"1842","290060 AIQUARA",0,1,2,63,1,67,"2010"
"1843","290070 ALAGOINHAS",5,20,49,1828,225,2127,"2010"
"1844","290080 ALCOBACA",1,2,5,284,6,298,"2010"
"1845","290090 ALMADINA",1,0,4,89,1,95,"2010"
"1846","290100 AMARGOSA",2,6,11,450,2,471,"2010"
"1847","290110 AMELIA RODRIGUES",2,1,6,243,109,361,"2010"
"1848","290115 AMERICA DOURADA",1,1,11,245,1,259,"2010"
"1849","290120 ANAGE",1,1,7,248,18,275,"2010"
"1850","290130 ANDARAI",0,2,5,168,8,183,"2010"
"1851","290135 ANDORINHA",1,2,6,164,10,183,"2010"
"1852","290140 ANGICAL",0,1,5,219,3,228,"2010"
"1853","290150 ANGUERA",0,0,0,38,77,115,"2010"
"1854","290160 ANTAS",0,1,6,146,2,155,"2010"
"1855","290170 ANTONIO CARDOSO",0,0,4,112,68,184,"2010"
"1856","290180 ANTONIO GONCALVES",0,0,0,41,98,139,"2010"
"1857","290190 APORA",0,2,6,200,18,226,"2010"
"1858","290195 APUAREMA",0,0,6,104,3,113,"2010"
"1859","290200 ARACATU",0,1,1,132,14,148,"2010"
"1860","290205 ARACAS",0,1,6,195,11,213,"2010"
"1861","290210 ARACI",3,5,9,656,60,733,"2010"
"1862","290220 ARAMARI",0,2,3,101,21,127,"2010"
"1863","290225 ARATACA",0,0,5,149,3,157,"2010"
"1864","290230 ARATUIPE",0,0,6,89,1,96,"2010"
"1865","290240 AURELINO LEAL",0,0,2,132,81,215,"2010"
"1866","290250 BAIANOPOLIS",0,0,2,183,14,199,"2010"
"1867","290260 BAIXA GRANDE",3,3,6,204,17,233,"2010"
"1868","290265 BANZAE",0,0,1,23,186,210,"2010"
"1869","290270 BARRA",4,3,8,861,2,878,"2010"
"1870","290280 BARRA DA ESTIVA",4,3,5,354,9,375,"2010"
"1871","290290 BARRA DO CHOCA",2,3,9,465,54,533,"2010"
"1872","290300 BARRA DO MENDES",0,4,5,186,0,195,"2010"
"1873","290310 BARRA DO ROCHA",0,0,3,78,1,82,"2010"
"1874","290320 BARREIRAS",2,11,48,2500,32,2593,"2010"
"1875","290323 BARRO ALTO",1,0,2,165,0,168,"2010"
"1876","290327 BARROCAS",0,2,3,198,28,231,"2010"
"1877","290330 BARRO PRETO",1,0,0,81,2,84,"2010"
"1878","290340 BELMONTE",0,0,3,351,3,357,"2010"
"1879","290350 BELO CAMPO",0,2,8,208,0,218,"2010"
"1880","290360 BIRITINGA",2,1,7,224,37,271,"2010"
"1881","290370 BOA NOVA",0,3,21,163,19,206,"2010"
"1882","290380 BOA VISTA DO TUPIM",2,3,8,272,51,336,"2010"
"1883","290390 BOM JESUS DA LAPA",6,4,16,1051,23,1100,"2010"
"1884","290395 BOM JESUS DA SERRA",1,1,4,129,6,141,"2010"
"1885","290400 BONINAL",0,0,7,170,2,179,"2010"
"1886","290405 BONITO",1,1,4,232,3,241,"2010"
"1887","290410 BOQUIRA",0,1,2,252,16,271,"2010"
"1888","290420 BOTUPORA",1,1,2,101,25,130,"2010"
"1889","290430 BREJOES",0,3,10,225,2,240,"2010"
"1890","290440 BREJOLANDIA",0,1,2,84,4,91,"2010"
"1891","290450 BROTAS DE MACAUBAS",0,1,4,105,12,122,"2010"
"1892","290460 BRUMADO",4,2,17,865,60,948,"2010"
"1893","290470 BUERAREMA",1,2,5,288,2,298,"2010"
"1894","290475 BURITIRAMA",0,1,6,247,2,256,"2010"
"1895","290480 CAATIBA",0,0,0,58,16,74,"2010"
"1896","290485 CABACEIRAS DO PARAGUACU",0,0,0,176,63,239,"2010"
"1897","290490 CACHOEIRA",0,2,3,119,293,417,"2010"
"1898","290500 CACULE",1,0,4,278,2,285,"2010"
"1899","290510 CAEM",4,0,1,134,25,164,"2010"
"1900","290515 CAETANOS",1,1,0,123,3,128,"2010"
"1901","290520 CAETITE",5,2,8,610,4,629,"2010"
"1902","290530 CAFARNAUM",0,2,12,275,1,290,"2010"
"1903","290540 CAIRU",4,1,55,165,3,228,"2010"
"1904","290550 CALDEIRAO GRANDE",0,2,2,172,10,186,"2010"
"1905","290560 CAMACAN",4,1,10,563,15,593,"2010"
"1906","290570 CAMACARI",8,22,88,4006,51,4175,"2010"
"1907","290580 CAMAMU",2,1,41,462,54,560,"2010"
"1908","290590 CAMPO ALEGRE DE LOURDES",1,0,1,513,13,528,"2010"
"1909","290600 CAMPO FORMOSO",0,0,1,79,1063,1143,"2010"
"1910","290610 CANAPOLIS",0,1,11,140,2,154,"2010"
"1911","290620 CANARANA",0,4,13,339,1,357,"2010"
"1912","290630 CANAVIEIRAS",1,1,9,350,123,484,"2010"
"1913","290640 CANDEAL",0,0,2,41,49,92,"2010"
"1914","290650 CANDEIAS",8,4,24,1138,38,1212,"2010"
"1915","290660 CANDIBA",0,1,2,147,0,150,"2010"
"1916","290670 CANDIDO SALES",2,2,17,425,1,447,"2010"
"1917","290680 CANSANCAO",0,0,13,160,213,386,"2010"
"1918","290682 CANUDOS",0,0,2,130,113,245,"2010"
"1919","290685 CAPELA DO ALTO ALEGRE",2,0,8,88,7,105,"2010"
"1920","290687 CAPIM GROSSO",1,1,5,376,30,413,"2010"
"1921","290689 CARAIBAS",1,1,7,108,0,117,"2010"
"1922","290690 CARAVELAS",1,1,6,301,5,314,"2010"
"1923","290700 CARDEAL DA SILVA",0,0,0,148,9,157,"2010"
"1924","290710 CARINHANHA",3,3,11,488,4,509,"2010"
"1925","290720 CASA NOVA",5,4,22,1107,36,1174,"2010"
"1926","290730 CASTRO ALVES",6,1,7,295,6,315,"2010"
"1927","290740 CATOLANDIA",0,0,2,48,1,51,"2010"
"1928","290750 CATU",2,4,20,705,9,740,"2010"
"1929","290755 CATURAMA",0,0,0,50,60,110,"2010"
"1930","290760 CENTRAL",2,2,9,277,3,293,"2010"
"1931","290770 CHORROCHO",2,5,7,157,8,179,"2010"
"1932","290780 CICERO DANTAS",1,3,14,321,58,397,"2010"
"1933","290790 CIPO",0,0,2,156,114,272,"2010"
"1934","290800 COARACI",3,0,6,328,9,346,"2010"
"1935","290810 COCOS",0,0,2,192,39,233,"2010"
"1936","290820 CONCEICAO DA FEIRA",0,1,1,130,114,246,"2010"
"1937","290830 CONCEICAO DO ALMEIDA",1,3,5,173,2,184,"2010"
"1938","290840 CONCEICAO DO COITE",3,5,22,841,62,933,"2010"
"1939","290850 CONCEICAO DO JACUIPE",1,3,3,250,148,405,"2010"
"1940","290860 CONDE",1,1,10,348,10,370,"2010"
"1941","290870 CONDEUBA",1,4,6,185,3,199,"2010"
"1942","290880 CONTENDAS DO SINCORA",0,0,1,46,6,53,"2010"
"1943","290890 CORACAO DE MARIA",0,0,4,201,158,363,"2010"
"1944","290900 CORDEIROS",0,0,0,85,0,85,"2010"
"1945","290910 CORIBE",0,0,2,73,124,199,"2010"
"1946","290920 CORONEL JOAO SA",0,1,6,239,1,247,"2010"
"1947","290930 CORRENTINA",0,3,32,168,260,463,"2010"
"1948","290940 COTEGIPE",0,0,1,138,26,165,"2010"
"1949","290950 CRAVOLANDIA",0,2,3,58,1,64,"2010"
"1950","290960 CRISOPOLIS",0,2,5,269,11,287,"2010"
"1951","290970 CRISTOPOLIS",0,1,6,175,5,187,"2010"
"1952","290980 CRUZ DAS ALMAS",9,5,10,864,17,905,"2010"
"1953","290990 CURACA",1,6,9,477,18,511,"2010"
"1954","291000 DARIO MEIRA",0,0,1,139,17,157,"2010"
"1955","291005 DIAS D'AVILA",2,5,28,1030,10,1075,"2010"
"1956","291010 DOM BASILIO",0,1,2,115,1,119,"2010"
"1957","291020 DOM MACEDO COSTA",0,0,1,66,0,67,"2010"
"1958","291030 ELISIO MEDRADO",0,1,3,100,0,104,"2010"
"1959","291040 ENCRUZILHADA",3,3,9,284,19,318,"2010"
"1960","291050 ENTRE RIOS",1,3,10,560,19,593,"2010"
"1961","291060 ESPLANADA",1,1,13,484,11,510,"2010"
"1962","291070 EUCLIDES DA CUNHA",0,1,6,192,649,848,"2010"
"1963","291072 EUNAPOLIS",1,5,28,811,1015,1860,"2010"
"1964","291075 FATIMA",0,0,7,159,17,183,"2010"
"1965","291077 FEIRA DA MATA",0,0,1,23,11,35,"2010"
"1966","291080 FEIRA DE SANTANA",7,13,87,5667,3646,9420,"2010"
"1967","291085 FILADELFIA",1,2,9,215,17,244,"2010"
"1968","291090 FIRMINO ALVES",0,3,6,64,7,80,"2010"
"1969","291100 FLORESTA AZUL",0,1,2,157,3,163,"2010"
"1970","291110 FORMOSA DO RIO PRETO",2,3,12,438,8,463,"2010"
"1971","291120 GANDU",0,6,29,515,1,551,"2010"
"1972","291125 GAVIAO",0,0,1,38,0,39,"2010"
"1973","291130 GENTIO DO OURO",0,1,5,135,1,142,"2010"
"1974","291140 GLORIA",2,0,4,137,110,253,"2010"
"1975","291150 GONGOGI",1,1,3,71,6,82,"2010"
"1976","291160 GOVERNADOR MANGABEIRA",1,0,3,176,100,280,"2010"
"1977","291165 GUAJERU",0,1,1,104,6,112,"2010"
"1978","291170 GUANAMBI",3,9,15,1139,11,1177,"2010"
"1979","291180 GUARATINGA",7,1,0,297,30,335,"2010"
"1980","291185 HELIOPOLIS",0,1,4,71,56,132,"2010"
"1981","291190 IACU",0,1,16,393,8,418,"2010"
"1982","291200 IBIASSUCE",2,2,1,124,1,130,"2010"
"1983","291210 IBICARAI",3,0,10,310,7,330,"2010"
"1984","291220 IBICOARA",1,2,5,323,17,348,"2010"
"1985","291230 IBICUI",1,2,5,211,1,220,"2010"
"1986","291240 IBIPEBA",0,3,12,246,2,263,"2010"
"1987","291250 IBIPITANGA",0,0,2,120,51,173,"2010"
"1988","291260 IBIQUERA",0,1,1,70,5,77,"2010"
"1989","291270 IBIRAPITANGA",0,4,8,268,133,413,"2010"
"1990","291280 IBIRAPUA",0,0,4,79,2,85,"2010"
"1991","291290 IBIRATAIA",0,3,5,385,3,396,"2010"
"1992","291300 IBITIARA",1,1,8,156,9,175,"2010"
"1993","291310 IBITITA",1,1,8,232,14,256,"2010"
"1994","291320 IBOTIRAMA",1,2,18,338,13,372,"2010"
"1995","291330 ICHU",0,0,1,48,14,63,"2010"
"1996","291340 IGAPORA",1,0,8,189,2,200,"2010"
"1997","291345 IGRAPIUNA",3,1,21,154,6,185,"2010"
"1998","291350 IGUAI",0,2,7,355,8,372,"2010"
"1999","291360 ILHEUS",3,2,8,314,2513,2840,"2010"
"2000","291370 INHAMBUPE",0,1,9,493,19,522,"2010"
"2001","291380 IPECAETA",0,1,3,138,69,211,"2010"
"2002","291390 IPIAU",0,3,11,684,7,705,"2010"
"2003","291400 IPIRA",2,1,20,934,12,969,"2010"
"2004","291410 IPUPIARA",0,3,0,119,0,122,"2010"
"2005","291420 IRAJUBA",1,0,4,96,0,101,"2010"
"2006","291430 IRAMAIA",0,0,4,165,2,171,"2010"
"2007","291440 IRAQUARA",1,3,13,403,1,421,"2010"
"2008","291450 IRARA",0,2,2,265,136,405,"2010"
"2009","291460 IRECE",5,6,38,1072,7,1128,"2010"
"2010","291465 ITABELA",7,3,17,484,57,568,"2010"
"2011","291470 ITABERABA",4,5,20,864,27,920,"2010"
"2012","291480 ITABUNA",11,8,96,3235,5,3355,"2010"
"2013","291490 ITACARE",1,0,2,149,189,341,"2010"
"2014","291500 ITAETE",0,1,4,218,15,238,"2010"
"2015","291510 ITAGI",0,2,7,206,7,222,"2010"
"2016","291520 ITAGIBA",1,2,3,218,0,224,"2010"
"2017","291530 ITAGIMIRIM",0,0,1,60,31,92,"2010"
"2018","291535 ITAGUACU DA BAHIA",1,2,4,184,1,192,"2010"
"2019","291540 ITAJU DO COLONIA",2,1,2,74,0,79,"2010"
"2020","291550 ITAJUIPE",1,3,16,302,0,322,"2010"
"2021","291560 ITAMARAJU",7,7,27,1208,6,1255,"2010"
"2022","291570 ITAMARI",1,0,6,138,1,146,"2010"
"2023","291580 ITAMBE",1,9,19,283,11,323,"2010"
"2024","291590 ITANAGRA",0,1,2,80,14,97,"2010"
"2025","291600 ITANHEM",0,2,15,211,1,229,"2010"
"2026","291610 ITAPARICA",0,6,4,207,63,280,"2010"
"2027","291620 ITAPE",0,1,7,175,0,183,"2010"
"2028","291630 ITAPEBI",0,3,3,99,81,186,"2010"
"2029","291640 ITAPETINGA",2,0,10,472,707,1191,"2010"
"2030","291650 ITAPICURU",1,3,14,401,30,449,"2010"
"2031","291660 ITAPITANGA",0,1,3,85,2,91,"2010"
"2032","291670 ITAQUARA",0,0,7,110,2,119,"2010"
"2033","291680 ITARANTIM",1,1,1,213,26,242,"2010"
"2034","291685 ITATIM",0,3,5,168,33,209,"2010"
"2035","291690 ITIRUCU",0,0,10,166,0,176,"2010"
"2036","291700 ITIUBA",0,1,6,427,177,611,"2010"
"2037","291710 ITORORO",1,5,7,231,107,351,"2010"
"2038","291720 ITUACU",1,2,11,226,11,251,"2010"
"2039","291730 ITUBERA",2,2,37,388,16,445,"2010"
"2040","291733 IUIU",0,0,4,136,30,170,"2010"
"2041","291735 JABORANDI",1,0,2,127,1,131,"2010"
"2042","291740 JACARACI",0,0,1,151,0,152,"2010"
"2043","291750 JACOBINA",5,18,13,951,241,1228,"2010"
"2044","291760 JAGUAQUARA",4,4,20,820,8,856,"2010"
"2045","291770 JAGUARARI",2,2,8,328,80,420,"2010"
"2046","291780 JAGUARIPE",0,0,15,219,6,240,"2010"
"2047","291790 JANDAIRA",0,1,3,144,3,151,"2010"
"2048","291800 JEQUIE",5,14,61,2236,46,2362,"2010"
"2049","291810 JEREMOABO",8,2,26,367,169,572,"2010"
"2050","291820 JIQUIRICA",1,1,6,178,2,188,"2010"
"2051","291830 JITAUNA",0,2,3,181,6,192,"2010"
"2052","291835 JOAO DOURADO",2,6,14,421,0,443,"2010"
"2053","291840 JUAZEIRO",9,36,71,3803,41,3960,"2010"
"2054","291845 JUCURUCU",0,0,1,53,4,58,"2010"
"2055","291850 JUSSARA",1,1,15,266,3,286,"2010"
"2056","291855 JUSSARI",0,2,2,93,0,97,"2010"
"2057","291860 JUSSIAPE",0,0,0,70,1,71,"2010"
"2058","291870 LAFAIETE COUTINHO",0,0,1,40,0,41,"2010"
"2059","291875 LAGOA REAL",0,0,4,156,5,165,"2010"
"2060","291880 LAJE",2,0,12,331,0,345,"2010"
"2061","291890 LAJEDAO",0,0,1,46,2,49,"2010"
"2062","291900 LAJEDINHO",0,0,1,63,2,66,"2010"
"2063","291905 LAJEDO DO TABOCAL",0,0,4,78,3,85,"2010"
"2064","291910 LAMARAO",0,0,4,81,6,91,"2010"
"2065","291915 LAPAO",1,5,24,421,1,452,"2010"
"2066","291920 LAURO DE FREITAS",9,13,43,2873,18,2956,"2010"
"2067","291930 LENCOIS",1,0,2,150,6,159,"2010"
"2068","291940 LICINIO DE ALMEIDA",0,0,6,165,0,171,"2010"
"2069","291950 LIVRAMENTO DE NOSSA SENHORA",2,5,10,561,2,580,"2010"
"2070","291955 LUIS EDUARDO MAGALHAES",0,10,17,1291,63,1381,"2010"
"2071","291960 MACAJUBA",0,0,3,155,7,165,"2010"
"2072","291970 MACARANI",0,4,3,196,20,223,"2010"
"2073","291980 MACAUBAS",0,5,11,528,21,565,"2010"
"2074","291990 MACURURE",1,0,3,98,19,121,"2010"
"2075","291992 MADRE DE DEUS",2,0,11,218,9,240,"2010"
"2076","291995 MAETINGA",0,1,2,59,1,63,"2010"
"2077","292000 MAIQUINIQUE",0,0,3,100,17,120,"2010"
"2078","292010 MAIRI",0,1,7,250,6,264,"2010"
"2079","292020 MALHADA",2,6,4,256,0,268,"2010"
"2080","292030 MALHADA DE PEDRAS",1,0,1,81,9,92,"2010"
"2081","292040 MANOEL VITORINO",0,0,6,212,6,224,"2010"
"2082","292045 MANSIDAO",2,2,1,82,0,87,"2010"
"2083","292050 MARACAS",3,3,14,330,3,353,"2010"
"2084","292060 MARAGOGIPE",0,0,9,342,230,581,"2010"
"2085","292070 MARAU",0,1,7,102,104,214,"2010"
"2086","292080 MARCIONILIO SOUZA",2,1,3,153,5,164,"2010"
"2087","292090 MASCOTE",2,1,1,224,9,237,"2010"
"2088","292100 MATA DE SAO JOAO",3,6,25,679,13,726,"2010"
"2089","292105 MATINA",0,3,3,185,3,194,"2010"
"2090","292110 MEDEIROS NETO",0,3,17,310,0,330,"2010"
"2091","292120 MIGUEL CALMON",0,4,11,380,16,411,"2010"
"2092","292130 MILAGRES",0,0,1,172,13,186,"2010"
"2093","292140 MIRANGABA",1,1,4,161,31,198,"2010"
"2094","292145 MIRANTE",1,3,6,99,4,113,"2010"
"2095","292150 MONTE SANTO",1,4,44,689,66,804,"2010"
"2096","292160 MORPARA",0,0,1,119,1,121,"2010"
"2097","292170 MORRO DO CHAPEU",4,3,22,598,12,639,"2010"
"2098","292180 MORTUGABA",1,0,1,145,0,147,"2010"
"2099","292190 MUCUGE",0,0,0,161,31,192,"2010"
"2100","292200 MUCURI",4,3,26,662,2,697,"2010"
"2101","292205 MULUNGU DO MORRO",0,4,9,219,0,232,"2010"
"2102","292210 MUNDO NOVO",1,2,6,308,11,328,"2010"
"2103","292220 MUNIZ FERREIRA",1,0,3,108,0,112,"2010"
"2104","292225 MUQUEM DE SAO FRANCISCO",2,1,2,161,4,170,"2010"
"2105","292230 MURITIBA",0,1,8,265,82,356,"2010"
"2106","292240 MUTUIPE",1,3,21,241,1,267,"2010"
"2107","292250 NAZARE",0,2,10,407,3,422,"2010"
"2108","292260 NILO PECANHA",1,1,30,128,1,161,"2010"
"2109","292265 NORDESTINA",1,1,1,149,3,155,"2010"
"2110","292270 NOVA CANAA",3,1,9,198,3,214,"2010"
"2111","292273 NOVA FATIMA",0,2,5,72,7,86,"2010"
"2112","292275 NOVA IBIA",0,0,8,75,1,84,"2010"
"2113","292280 NOVA ITARANA",0,2,4,101,3,110,"2010"
"2114","292285 NOVA REDENCAO",0,1,0,97,5,103,"2010"
"2115","292290 NOVA SOURE",1,0,4,308,115,428,"2010"
"2116","292300 NOVA VICOSA",1,7,17,642,0,667,"2010"
"2117","292303 NOVO HORIZONTE",0,1,11,120,2,134,"2010"
"2118","292305 NOVO TRIUNFO",0,1,5,116,4,126,"2010"
"2119","292310 OLINDINA",1,3,8,277,40,329,"2010"
"2120","292320 OLIVEIRA DOS BREJINHOS",1,2,4,241,7,255,"2010"
"2121","292330 OURICANGAS",0,2,2,109,5,118,"2010"
"2122","292335 OUROLANDIA",0,5,2,199,59,265,"2010"
"2123","292340 PALMAS DE MONTE ALTO",2,3,9,272,0,286,"2010"
"2124","292350 PALMEIRAS",2,0,2,134,5,143,"2010"
"2125","292360 PARAMIRIM",2,0,0,117,162,281,"2010"
"2126","292370 PARATINGA",0,5,14,367,6,392,"2010"
"2127","292380 PARIPIRANGA",0,2,10,358,5,375,"2010"
"2128","292390 PAU BRASIL",1,0,3,152,16,172,"2010"
"2129","292400 PAULO AFONSO",15,5,28,831,943,1822,"2010"
"2130","292405 PE DE SERRA",4,2,3,154,17,180,"2010"
"2131","292410 PEDRAO",0,1,2,66,15,84,"2010"
"2132","292420 PEDRO ALEXANDRE",0,1,5,204,10,220,"2010"
"2133","292430 PIATA",0,1,8,223,8,240,"2010"
"2134","292440 PILAO ARCADO",2,2,5,542,80,631,"2010"
"2135","292450 PINDAI",4,0,2,152,1,159,"2010"
"2136","292460 PINDOBACU",0,4,4,303,6,317,"2010"
"2137","292465 PINTADAS",0,0,1,66,19,86,"2010"
"2138","292467 PIRAI DO NORTE",0,0,5,98,12,115,"2010"
"2139","292470 PIRIPA",1,1,1,110,2,115,"2010"
"2140","292480 PIRITIBA",0,1,10,281,15,307,"2010"
"2141","292490 PLANALTINO",0,1,8,91,1,101,"2010"
"2142","292500 PLANALTO",0,5,14,343,15,377,"2010"
"2143","292510 POCOES",2,7,89,600,28,726,"2010"
"2144","292520 POJUCA",2,3,12,571,2,590,"2010"
"2145","292525 PONTO NOVO",1,2,6,160,113,282,"2010"
"2146","292530 PORTO SEGURO",3,17,66,2218,154,2458,"2010"
"2147","292540 POTIRAGUA",0,1,3,151,8,163,"2010"
"2148","292550 PRADO",0,1,5,403,2,411,"2010"
"2149","292560 PRESIDENTE DUTRA",0,2,9,233,0,244,"2010"
"2150","292570 PRESIDENTE JANIO QUADROS",0,1,2,122,13,138,"2010"
"2151","292575 PRESIDENTE TANCREDO NEVES",3,2,60,307,33,405,"2010"
"2152","292580 QUEIMADAS",1,2,12,295,14,324,"2010"
"2153","292590 QUIJINGUE",0,1,6,248,129,384,"2010"
"2154","292593 QUIXABEIRA",0,1,3,78,10,92,"2010"
"2155","292595 RAFAEL JAMBEIRO",1,0,4,271,24,300,"2010"
"2156","292600 REMANSO",0,4,6,754,11,775,"2010"
"2157","292610 RETIROLANDIA",4,0,3,179,14,200,"2010"
"2158","292620 RIACHAO DAS NEVES",0,2,6,330,10,348,"2010"
"2159","292630 RIACHAO DO JACUIPE",3,5,14,336,16,374,"2010"
"2160","292640 RIACHO DE SANTANA",1,3,6,368,36,414,"2010"
"2161","292650 RIBEIRA DO AMPARO",0,1,0,64,158,223,"2010"
"2162","292660 RIBEIRA DO POMBAL",1,2,2,90,672,767,"2010"
"2163","292665 RIBEIRAO DO LARGO",1,6,8,106,7,128,"2010"
"2164","292670 RIO DE CONTAS",0,0,2,132,2,136,"2010"
"2165","292680 RIO DO ANTONIO",3,0,3,137,6,149,"2010"
"2166","292690 RIO DO PIRES",0,0,0,67,48,115,"2010"
"2167","292700 RIO REAL",1,5,12,544,1,563,"2010"
"2168","292710 RODELAS",0,1,7,131,13,152,"2010"
"2169","292720 RUY BARBOSA",0,1,18,404,6,429,"2010"
"2170","292730 SALINAS DA MARGARIDA",1,0,4,192,4,201,"2010"
"2171","292740 SALVADOR",170,207,702,34929,419,36427,"2010"
"2172","292750 SANTA BARBARA",0,0,1,196,131,328,"2010"
"2173","292760 SANTA BRIGIDA",2,1,10,132,129,274,"2010"
"2174","292770 SANTA CRUZ CABRALIA",0,0,8,371,4,383,"2010"
"2175","292780 SANTA CRUZ DA VITORIA",0,0,1,64,15,80,"2010"
"2176","292790 SANTA INES",0,1,8,125,1,135,"2010"
"2177","292800 SANTALUZ",1,6,19,489,8,523,"2010"
"2178","292805 SANTA LUZIA",0,1,5,177,9,192,"2010"
"2179","292810 SANTA MARIA DA VITORIA",1,9,52,498,13,573,"2010"
"2180","292820 SANTANA",0,3,6,363,2,374,"2010"
"2181","292830 SANTANOPOLIS",2,0,1,83,47,133,"2010"
"2182","292840 SANTA RITA DE CASSIA",1,2,11,495,2,511,"2010"
"2183","292850 SANTA TERESINHA",0,1,6,134,6,147,"2010"
"2184","292860 SANTO AMARO",6,6,29,697,18,756,"2010"
"2185","292870 SANTO ANTONIO DE JESUS",1,2,15,1409,1,1428,"2010"
"2186","292880 SANTO ESTEVAO",1,4,14,585,218,822,"2010"
"2187","292890 SAO DESIDERIO",0,2,13,444,22,481,"2010"
"2188","292895 SAO DOMINGOS",0,0,3,90,9,102,"2010"
"2189","292900 SAO FELIX",0,1,1,89,78,169,"2010"
"2190","292905 SAO FELIX DO CORIBE",0,0,8,128,0,136,"2010"
"2191","292910 SAO FELIPE",1,1,6,232,2,242,"2010"
"2192","292920 SAO FRANCISCO DO CONDE",3,6,18,605,8,640,"2010"
"2193","292925 SAO GABRIEL",2,5,11,283,3,304,"2010"
"2194","292930 SAO GONCALO DOS CAMPOS",1,2,7,297,167,474,"2010"
"2195","292935 SAO JOSE DA VITORIA",0,1,1,81,2,85,"2010"
"2196","292937 SAO JOSE DO JACUIPE",2,0,16,118,8,144,"2010"
"2197","292940 SAO MIGUEL DAS MATAS",0,0,11,139,0,150,"2010"
"2198","292950 SAO SEBASTIAO DO PASSE",2,1,18,544,19,584,"2010"
"2199","292960 SAPEACU",0,4,2,192,2,200,"2010"
"2200","292970 SATIRO DIAS",1,3,8,249,10,271,"2010"
"2201","292975 SAUBARA",1,1,8,133,3,146,"2010"
"2202","292980 SAUDE",1,1,3,133,6,144,"2010"
"2203","292990 SEABRA",2,2,19,688,17,728,"2010"
"2204","293000 SEBASTIAO LARANJEIRAS",0,1,1,125,0,127,"2010"
"2205","293010 SENHOR DO BONFIM",9,15,33,1105,21,1183,"2010"
"2206","293015 SERRA DO RAMALHO",1,10,16,457,2,486,"2010"
"2207","293020 SENTO SE",2,0,17,530,28,577,"2010"
"2208","293030 SERRA DOURADA",0,1,9,258,0,268,"2010"
"2209","293040 SERRA PRETA",1,0,1,78,126,206,"2010"
"2210","293050 SERRINHA",1,11,25,1110,53,1200,"2010"
"2211","293060 SERROLANDIA",0,3,2,159,14,178,"2010"
"2212","293070 SIMOES FILHO",27,11,29,1546,351,1964,"2010"
"2213","293075 SITIO DO MATO",0,2,3,177,5,187,"2010"
"2214","293076 SITIO DO QUINTO",0,0,12,142,9,163,"2010"
"2215","293077 SOBRADINHO",1,5,7,362,8,383,"2010"
"2216","293080 SOUTO SOARES",0,2,10,292,4,308,"2010"
"2217","293090 TABOCAS DO BREJO VELHO",0,0,3,148,0,151,"2010"
"2218","293100 TANHACU",1,1,6,214,16,238,"2010"
"2219","293105 TANQUE NOVO",0,0,6,183,22,211,"2010"
"2220","293110 TANQUINHO",0,2,2,57,37,98,"2010"
"2221","293120 TAPEROA",4,1,73,218,20,316,"2010"
"2222","293130 TAPIRAMUTA",1,2,17,230,12,262,"2010"
"2223","293135 TEIXEIRA DE FREITAS",5,17,53,2459,14,2548,"2010"
"2224","293140 TEODORO SAMPAIO",0,0,1,67,34,102,"2010"
"2225","293150 TEOFILANDIA",1,0,7,343,22,373,"2010"
"2226","293160 TEOLANDIA",3,2,24,158,27,214,"2010"
"2227","293170 TERRA NOVA",0,0,5,127,22,154,"2010"
"2228","293180 TREMEDAL",5,1,4,211,6,227,"2010"
"2229","293190 TUCANO",3,4,5,574,119,705,"2010"
"2230","293200 UAUA",0,2,6,307,12,327,"2010"
"2231","293210 UBAIRA",1,1,7,320,1,330,"2010"
"2232","293220 UBAITABA",1,1,6,209,160,377,"2010"
"2233","293230 UBATA",0,4,5,289,6,304,"2010"
"2234","293240 UIBAI",0,2,4,184,1,191,"2010"
"2235","293245 UMBURANAS",11,28,18,111,28,196,"2010"
"2236","293250 UNA",0,1,4,133,188,326,"2010"
"2237","293260 URANDI",2,3,3,200,2,210,"2010"
"2238","293270 URUCUCA",0,3,5,263,82,353,"2010"
"2239","293280 UTINGA",0,2,5,246,9,262,"2010"
"2240","293290 VALENCA",20,0,366,856,5,1247,"2010"
"2241","293300 VALENTE",0,4,7,277,27,315,"2010"
"2242","293305 VARZEA DA ROCA",0,0,8,151,5,164,"2010"
"2243","293310 VARZEA DO POCO",1,9,7,85,3,105,"2010"
"2244","293315 VARZEA NOVA",1,3,5,150,22,181,"2010"
"2245","293317 VARZEDO",0,0,2,117,0,119,"2010"
"2246","293320 VERA CRUZ",0,3,11,484,73,571,"2010"
"2247","293325 VEREDA",0,0,2,67,0,69,"2010"
"2248","293330 VITORIA DA CONQUISTA",20,35,150,5028,36,5269,"2010"
"2249","293340 WAGNER",0,0,1,126,10,137,"2010"
"2250","293345 WANDERLEY",0,1,3,157,18,179,"2010"
"2251","293350 WENCESLAU GUIMARAES",2,4,27,286,34,353,"2010"
"2252","293360 XIQUE-XIQUE",0,4,28,783,3,818,"2010"
"2253","MUNICIPIO IGNORADO - MG",0,0,0,11,0,11,"2010"
"2254","310010 ABADIA DOS DOURADOS",1,0,2,84,0,87,"2010"
"2255","310020 ABAETE",0,0,3,217,0,220,"2010"
"2256","310030 ABRE CAMPO",1,1,2,138,5,147,"2010"
"2257","310040 ACAIACA",0,1,1,45,1,48,"2010"
"2258","310050 ACUCENA",0,0,1,95,6,102,"2010"
"2259","310060 AGUA BOA",0,1,3,180,5,189,"2010"
"2260","310070 AGUA COMPRIDA",0,0,0,13,0,13,"2010"
"2261","310080 AGUANIL",0,0,0,32,0,32,"2010"
"2262","310090 AGUAS FORMOSAS",0,0,8,295,6,309,"2010"
"2263","310100 AGUAS VERMELHAS",0,0,2,16,0,18,"2010"
"2264","310110 AIMORES",0,0,7,324,7,338,"2010"
"2265","310120 AIURUOCA",0,0,0,59,0,59,"2010"
"2266","310130 ALAGOA",0,0,0,23,0,23,"2010"
"2267","310140 ALBERTINA",0,0,0,25,0,25,"2010"
"2268","310150 ALEM PARAIBA",3,3,7,439,1,453,"2010"
"2269","310160 ALFENAS",2,6,17,938,3,966,"2010"
"2270","310163 ALFREDO VASCONCELOS",1,0,1,52,0,54,"2010"
"2271","310170 ALMENARA",40,6,5,505,18,574,"2010"
"2272","310180 ALPERCATA",0,0,4,75,11,90,"2010"
"2273","310190 ALPINOPOLIS",2,1,1,226,0,230,"2010"
"2274","310200 ALTEROSA",1,0,2,170,0,173,"2010"
"2275","310205 ALTO CAPARAO",0,0,1,36,34,71,"2010"
"2276","310210 ALTO RIO DOCE",0,0,1,123,0,124,"2010"
"2277","310220 ALVARENGA",0,2,0,54,0,56,"2010"
"2278","310230 ALVINOPOLIS",0,3,8,130,2,143,"2010"
"2279","310240 ALVORADA DE MINAS",1,1,0,59,2,63,"2010"
"2280","310250 AMPARO DO SERRA",0,0,2,71,0,73,"2010"
"2281","310260 ANDRADAS",0,1,6,446,0,453,"2010"
"2282","310270 CACHOEIRA DE PAJEU",0,0,6,76,2,84,"2010"
"2283","310280 ANDRELANDIA",0,0,2,131,0,133,"2010"
"2284","310285 ANGELANDIA",1,1,3,112,3,120,"2010"
"2285","310290 ANTONIO CARLOS",0,0,1,115,3,119,"2010"
"2286","310300 ANTONIO DIAS",0,1,0,93,1,95,"2010"
"2287","310310 ANTONIO PRADO DE MINAS",0,0,0,14,0,14,"2010"
"2288","310320 ARACAI",0,0,1,27,0,28,"2010"
"2289","310330 ARACITABA",0,0,0,15,0,15,"2010"
"2290","310340 ARACUAI",2,1,10,468,5,486,"2010"
"2291","310350 ARAGUARI",4,2,13,1339,3,1361,"2010"
"2292","310360 ARANTINA",0,0,0,37,0,37,"2010"
"2293","310370 ARAPONGA",0,0,3,65,6,74,"2010"
"2294","310375 ARAPORA",0,1,0,106,0,107,"2010"
"2295","310380 ARAPUA",0,0,0,20,0,20,"2010"
"2296","310390 ARAUJOS",0,0,2,105,1,108,"2010"
"2297","310400 ARAXA",1,3,10,1138,3,1155,"2010"
"2298","310410 ARCEBURGO",0,0,3,98,1,102,"2010"
"2299","310420 ARCOS",1,1,6,429,0,437,"2010"
"2300","310430 AREADO",0,1,6,200,0,207,"2010"
"2301","310440 ARGIRITA",0,0,0,22,0,22,"2010"
"2302","310445 ARICANDUVA",0,0,3,50,0,53,"2010"
"2303","310450 ARINOS",1,1,3,176,0,181,"2010"
"2304","310460 ASTOLFO DUTRA",2,0,4,149,0,155,"2010"
"2305","310470 ATALEIA",0,0,0,158,0,158,"2010"
"2306","310480 AUGUSTO DE LIMA",0,0,2,66,0,68,"2010"
"2307","310490 BAEPENDI",0,0,1,206,2,209,"2010"
"2308","310500 BALDIM",0,0,0,75,0,75,"2010"
"2309","310510 BAMBUI",2,1,2,199,1,205,"2010"
"2310","310520 BANDEIRA",6,2,1,36,0,45,"2010"
"2311","310530 BANDEIRA DO SUL",0,0,2,60,0,62,"2010"
"2312","310540 BARAO DE COCAIS",0,1,7,382,7,397,"2010"
"2313","310550 BARAO DE MONTE ALTO",0,2,4,44,0,50,"2010"
"2314","310560 BARBACENA",1,5,45,1461,2,1514,"2010"
"2315","310570 BARRA LONGA",0,1,2,56,0,59,"2010"
"2316","310590 BARROSO",0,1,1,263,0,265,"2010"
"2317","310600 BELA VISTA DE MINAS",0,2,2,110,1,115,"2010"
"2318","310610 BELMIRO BRAGA",0,0,0,37,0,37,"2010"
"2319","310620 BELO HORIZONTE",110,115,391,30407,124,31147,"2010"
"2320","310630 BELO ORIENTE",1,0,3,328,7,339,"2010"
"2321","310640 BELO VALE",0,0,2,63,0,65,"2010"
"2322","310650 BERILO",1,0,0,127,0,128,"2010"
"2323","310660 BERTOPOLIS",1,1,0,78,31,111,"2010"
"2324","310665 BERIZAL",0,0,0,61,1,62,"2010"
"2325","310670 BETIM",6,24,79,5868,39,6016,"2010"
"2326","310680 BIAS FORTES",0,0,0,32,0,32,"2010"
"2327","310690 BICAS",0,1,6,156,0,163,"2010"
"2328","310700 BIQUINHAS",1,0,0,20,0,21,"2010"
"2329","310710 BOA ESPERANCA",4,1,1,528,2,536,"2010"
"2330","310720 BOCAINA DE MINAS",1,0,1,32,0,34,"2010"
"2331","310730 BOCAIUVA",3,2,12,597,5,619,"2010"
"2332","310740 BOM DESPACHO",0,2,8,546,1,557,"2010"
"2333","310750 BOM JARDIM DE MINAS",0,1,1,40,30,72,"2010"
"2334","310760 BOM JESUS DA PENHA",0,0,0,35,0,35,"2010"
"2335","310770 BOM JESUS DO AMPARO",1,0,0,66,2,69,"2010"
"2336","310780 BOM JESUS DO GALHO",1,0,62,130,2,195,"2010"
"2337","310790 BOM REPOUSO",0,0,0,89,0,89,"2010"
"2338","310800 BOM SUCESSO",1,1,1,198,1,202,"2010"
"2339","310810 BONFIM",0,0,1,54,0,55,"2010"
"2340","310820 BONFINOPOLIS DE MINAS",0,0,0,68,0,68,"2010"
"2341","310825 BONITO DE MINAS",2,0,0,117,0,119,"2010"
"2342","310830 BORDA DA MATA",0,2,4,210,0,216,"2010"
"2343","310840 BOTELHOS",1,0,4,145,4,154,"2010"
"2344","310850 BOTUMIRIM",0,0,5,66,2,73,"2010"
"2345","310855 BRASILANDIA DE MINAS",0,3,6,160,5,174,"2010"
"2346","310860 BRASILIA DE MINAS",3,2,13,451,1,470,"2010"
"2347","310870 BRAS PIRES",0,0,1,44,0,45,"2010"
"2348","310880 BRAUNAS",0,0,0,36,1,37,"2010"
"2349","310890 BRAZOPOLIS",0,1,2,170,3,176,"2010"
"2350","310900 BRUMADINHO",0,3,6,410,0,419,"2010"
"2351","310910 BUENO BRANDAO",1,1,1,87,0,90,"2010"
"2352","310920 BUENOPOLIS",1,1,1,100,1,104,"2010"
"2353","310925 BUGRE",0,0,1,43,1,45,"2010"
"2354","310930 BURITIS",1,2,7,355,1,366,"2010"
"2355","310940 BURITIZEIRO",0,3,5,330,15,353,"2010"
"2356","310945 CABECEIRA GRANDE",0,0,1,67,3,71,"2010"
"2357","310950 CABO VERDE",0,0,1,174,0,175,"2010"
"2358","310960 CACHOEIRA DA PRATA",0,0,1,37,0,38,"2010"
"2359","310970 CACHOEIRA DE MINAS",0,0,1,104,1,106,"2010"
"2360","310980 CACHOEIRA DOURADA",0,0,1,23,2,26,"2010"
"2361","310990 CAETANOPOLIS",0,1,3,116,3,123,"2010"
"2362","311000 CAETE",2,4,12,416,21,455,"2010"
"2363","311010 CAIANA",0,0,1,58,0,59,"2010"
"2364","311020 CAJURI",0,0,0,29,1,30,"2010"
"2365","311030 CALDAS",0,0,2,113,0,115,"2010"
"2366","311040 CAMACHO",0,0,3,26,0,29,"2010"
"2367","311050 CAMANDUCAIA",0,1,2,203,4,210,"2010"
"2368","311060 CAMBUI",2,1,2,321,1,327,"2010"
"2369","311070 CAMBUQUIRA",3,1,3,126,14,147,"2010"
"2370","311080 CAMPANARIO",0,1,0,42,2,45,"2010"
"2371","311090 CAMPANHA",0,0,0,157,4,161,"2010"
"2372","311100 CAMPESTRE",0,0,2,231,0,233,"2010"
"2373","311110 CAMPINA VERDE",1,2,2,208,0,213,"2010"
"2374","311115 CAMPO AZUL",0,0,1,48,1,50,"2010"
"2375","311120 CAMPO BELO",1,2,30,684,0,717,"2010"
"2376","311130 CAMPO DO MEIO",2,0,1,112,0,115,"2010"
"2377","311140 CAMPO FLORIDO",0,0,0,88,5,93,"2010"
"2378","311150 CAMPOS ALTOS",1,0,4,193,0,198,"2010"
"2379","311160 CAMPOS GERAIS",0,2,5,322,0,329,"2010"
"2380","311170 CANAA",0,1,0,32,0,33,"2010"
"2381","311180 CANAPOLIS",0,0,1,131,16,148,"2010"
"2382","311190 CANA VERDE",0,0,1,71,0,72,"2010"
"2383","311200 CANDEIAS",0,0,6,96,0,102,"2010"
"2384","311205 CANTAGALO",1,1,1,61,0,64,"2010"
"2385","311210 CAPARAO",0,0,0,67,1,68,"2010"
"2386","311220 CAPELA NOVA",0,0,1,68,0,69,"2010"
"2387","311230 CAPELINHA",4,5,23,579,1,612,"2010"
"2388","311240 CAPETINGA",0,0,15,35,0,50,"2010"
"2389","311250 CAPIM BRANCO",0,0,1,82,17,100,"2010"
"2390","311260 CAPINOPOLIS",1,0,0,230,0,231,"2010"
"2391","311265 CAPITAO ANDRADE",1,1,0,59,4,65,"2010"
"2392","311270 CAPITAO ENEAS",1,1,6,193,2,203,"2010"
"2393","311280 CAPITOLIO",0,0,1,69,1,71,"2010"
"2394","311290 CAPUTIRA",0,0,0,7,126,133,"2010"
"2395","311300 CARAI",1,0,7,298,10,316,"2010"
"2396","311310 CARANAIBA",0,0,0,34,0,34,"2010"
"2397","311320 CARANDAI",0,1,9,282,0,292,"2010"
"2398","311330 CARANGOLA",2,0,3,406,5,416,"2010"
"2399","311340 CARATINGA",2,5,27,1178,15,1227,"2010"
"2400","311350 CARBONITA",0,0,1,86,0,87,"2010"
"2401","311360 CAREACU",0,2,0,71,2,75,"2010"
"2402","311370 CARLOS CHAGAS",0,1,3,231,1,236,"2010"
"2403","311380 CARMESIA",0,0,1,36,1,38,"2010"
"2404","311390 CARMO DA CACHOEIRA",0,1,0,108,42,151,"2010"
"2405","311400 CARMO DA MATA",1,0,1,90,3,95,"2010"
"2406","311410 CARMO DE MINAS",0,1,2,178,0,181,"2010"
"2407","311420 CARMO DO CAJURU",0,0,9,234,0,243,"2010"
"2408","311430 CARMO DO PARANAIBA",0,0,1,349,0,350,"2010"
"2409","311440 CARMO DO RIO CLARO",1,1,6,176,0,184,"2010"
"2410","311450 CARMOPOLIS DE MINAS",0,0,0,196,7,203,"2010"
"2411","311455 CARNEIRINHO",0,1,3,100,0,104,"2010"
"2412","311460 CARRANCAS",0,0,0,42,1,43,"2010"
"2413","311470 CARVALHOPOLIS",0,0,1,49,0,50,"2010"
"2414","311480 CARVALHOS",0,0,2,32,1,35,"2010"
"2415","311490 CASA GRANDE",0,0,0,13,0,13,"2010"
"2416","311500 CASCALHO RICO",0,0,1,21,0,22,"2010"
"2417","311510 CASSIA",0,7,65,142,0,214,"2010"
"2418","311520 CONCEICAO DA BARRA DE MINAS",1,0,0,29,9,39,"2010"
"2419","311530 CATAGUASES",0,3,30,682,3,718,"2010"
"2420","311535 CATAS ALTAS",0,1,1,70,2,74,"2010"
"2421","311540 CATAS ALTAS DA NORUEGA",0,0,1,37,1,39,"2010"
"2422","311545 CATUJI",0,0,0,134,2,136,"2010"
"2423","311547 CATUTI",0,0,0,51,24,75,"2010"
"2424","311550 CAXAMBU",0,0,2,211,48,261,"2010"
"2425","311560 CEDRO DO ABAETE",1,0,1,8,0,10,"2010"
"2426","311570 CENTRAL DE MINAS",0,0,2,101,1,104,"2010"
"2427","311580 CENTRALINA",0,0,1,52,11,64,"2010"
"2428","311590 CHACARA",0,0,1,21,0,22,"2010"
"2429","311600 CHALE",0,0,1,60,20,81,"2010"
"2430","311610 CHAPADA DO NORTE",0,1,0,188,0,189,"2010"
"2431","311615 CHAPADA GAUCHA",2,0,2,147,3,154,"2010"
"2432","311620 CHIADOR",0,0,3,23,0,26,"2010"
"2433","311630 CIPOTANEA",0,0,1,73,1,75,"2010"
"2434","311640 CLARAVAL",0,0,0,31,1,32,"2010"
"2435","311650 CLARO DOS POCOES",0,0,5,77,2,84,"2010"
"2436","311660 CLAUDIO",0,1,2,352,0,355,"2010"
"2437","311670 COIMBRA",0,0,0,80,1,81,"2010"
"2438","311680 COLUNA",1,1,0,107,0,109,"2010"
"2439","311690 COMENDADOR GOMES",0,0,0,26,1,27,"2010"
"2440","311700 COMERCINHO",1,0,0,41,2,44,"2010"
"2441","311710 CONCEICAO DA APARECIDA",0,2,6,120,0,128,"2010"
"2442","311720 CONCEICAO DAS PEDRAS",1,0,0,27,0,28,"2010"
"2443","311730 CONCEICAO DAS ALAGOAS",0,1,3,389,0,393,"2010"
"2444","311740 CONCEICAO DE IPANEMA",0,0,0,61,2,63,"2010"
"2445","311750 CONCEICAO DO MATO DENTRO",0,0,1,173,3,177,"2010"
"2446","311760 CONCEICAO DO PARA",0,0,0,23,29,52,"2010"
"2447","311770 CONCEICAO DO RIO VERDE",0,1,2,166,1,170,"2010"
"2448","311780 CONCEICAO DOS OUROS",0,0,2,126,0,128,"2010"
"2449","311783 CONEGO MARINHO",0,0,2,71,3,76,"2010"
"2450","311787 CONFINS",0,0,0,67,9,76,"2010"
"2451","311790 CONGONHAL",0,0,0,89,0,89,"2010"
"2452","311800 CONGONHAS",0,3,11,665,0,679,"2010"
"2453","311810 CONGONHAS DO NORTE",0,2,1,50,0,53,"2010"
"2454","311820 CONQUISTA",1,0,0,67,1,69,"2010"
"2455","311830 CONSELHEIRO LAFAIETE",5,1,22,1481,3,1512,"2010"
"2456","311840 CONSELHEIRO PENA",1,1,12,248,2,264,"2010"
"2457","311850 CONSOLACAO",0,0,0,16,0,16,"2010"
"2458","311860 CONTAGEM",17,31,102,8047,48,8245,"2010"
"2459","311870 COQUEIRAL",0,0,1,38,52,91,"2010"
"2460","311880 CORACAO DE JESUS",4,3,8,283,5,303,"2010"
"2461","311890 CORDISBURGO",0,0,0,71,2,73,"2010"
"2462","311900 CORDISLANDIA",0,0,1,53,0,54,"2010"
"2463","311910 CORINTO",4,1,10,253,1,269,"2010"
"2464","311920 COROACI",0,0,1,74,14,89,"2010"
"2465","311930 COROMANDEL",0,1,3,309,0,313,"2010"
"2466","311940 CORONEL FABRICIANO",2,8,21,1272,59,1362,"2010"
"2467","311950 CORONEL MURTA",1,0,1,73,19,94,"2010"
"2468","311960 CORONEL PACHECO",0,2,0,27,0,29,"2010"
"2469","311970 CORONEL XAVIER CHAVES",0,0,2,39,1,42,"2010"
"2470","311980 CORREGO DANTA",0,1,0,21,0,22,"2010"
"2471","311990 CORREGO DO BOM JESUS",0,0,0,26,1,27,"2010"
"2472","311995 CORREGO FUNDO",0,0,0,49,0,49,"2010"
"2473","312000 CORREGO NOVO",0,0,1,34,0,35,"2010"
"2474","312010 COUTO DE MAGALHAES DE MINAS",0,0,0,64,0,64,"2010"
"2475","312015 CRISOLITA",0,0,1,98,3,102,"2010"
"2476","312020 CRISTAIS",0,0,7,115,0,122,"2010"
"2477","312030 CRISTALIA",1,0,1,91,4,97,"2010"
"2478","312040 CRISTIANO OTONI",0,0,0,75,2,77,"2010"
"2479","312050 CRISTINA",0,1,2,102,0,105,"2010"
"2480","312060 CRUCILANDIA",0,1,1,55,0,57,"2010"
"2481","312070 CRUZEIRO DA FORTALEZA",0,0,0,56,0,56,"2010"
"2482","312080 CRUZILIA",0,0,2,185,0,187,"2010"
"2483","312083 CUPARAQUE",0,0,5,49,1,55,"2010"
"2484","312087 CURRAL DE DENTRO",0,1,1,34,81,117,"2010"
"2485","312090 CURVELO",4,10,23,906,3,946,"2010"
"2486","312100 DATAS",1,0,2,79,0,82,"2010"
"2487","312110 DELFIM MOREIRA",0,0,0,74,0,74,"2010"
"2488","312120 DELFINOPOLIS",0,1,9,66,1,77,"2010"
"2489","312125 DELTA",0,0,1,126,0,127,"2010"
"2490","312130 DESCOBERTO",0,2,1,52,0,55,"2010"
"2491","312140 DESTERRO DE ENTRE RIOS",0,1,4,58,0,63,"2010"
"2492","312150 DESTERRO DO MELO",0,0,1,27,0,28,"2010"
"2493","312160 DIAMANTINA",3,1,4,636,1,645,"2010"
"2494","312170 DIOGO DE VASCONCELOS",0,1,1,30,0,32,"2010"
"2495","312180 DIONISIO",0,0,0,61,0,61,"2010"
"2496","312190 DIVINESIA",1,0,3,42,0,46,"2010"
"2497","312200 DIVINO",1,2,2,292,3,300,"2010"
"2498","312210 DIVINO DAS LARANJEIRAS",0,0,1,47,9,57,"2010"
"2499","312220 DIVINOLANDIA DE MINAS",0,0,1,102,2,105,"2010"
"2500","312230 DIVINOPOLIS",6,8,45,2499,3,2561,"2010"
"2501","312235 DIVISA ALEGRE",0,0,6,62,0,68,"2010"
"2502","312240 DIVISA NOVA",0,0,1,82,1,84,"2010"
"2503","312245 DIVISOPOLIS",1,0,3,85,2,91,"2010"
"2504","312247 DOM BOSCO",0,0,0,40,2,42,"2010"
"2505","312250 DOM CAVATI",1,0,1,75,0,77,"2010"
"2506","312260 DOM JOAQUIM",0,0,0,60,1,61,"2010"
"2507","312270 DOM SILVERIO",0,0,2,57,0,59,"2010"
"2508","312280 DOM VICOSO",0,0,0,25,0,25,"2010"
"2509","312290 DONA EUSEBIA",0,1,4,51,0,56,"2010"
"2510","312300 DORES DE CAMPOS",0,0,1,120,0,121,"2010"
"2511","312310 DORES DE GUANHAES",0,0,0,47,2,49,"2010"
"2512","312320 DORES DO INDAIA",0,1,1,145,0,147,"2010"
"2513","312330 DORES DO TURVO",0,1,2,38,0,41,"2010"
"2514","312340 DORESOPOLIS",0,0,0,10,1,11,"2010"
"2515","312350 DOURADOQUARA",0,0,1,23,0,24,"2010"
"2516","312352 DURANDE",0,0,0,11,109,120,"2010"
"2517","312360 ELOI MENDES",0,0,1,309,1,311,"2010"
"2518","312370 ENGENHEIRO CALDAS",1,0,1,132,8,142,"2010"
"2519","312380 ENGENHEIRO NAVARRO",0,0,0,98,3,101,"2010"
"2520","312385 ENTRE FOLHAS",1,0,0,71,1,73,"2010"
"2521","312390 ENTRE RIOS DE MINAS",2,3,4,177,0,186,"2010"
"2522","312400 ERVALIA",0,1,5,201,7,214,"2010"
"2523","312410 ESMERALDAS",5,1,16,709,4,735,"2010"
"2524","312420 ESPERA FELIZ",1,2,6,287,7,303,"2010"
"2525","312430 ESPINOSA",1,2,4,440,11,458,"2010"
"2526","312440 ESPIRITO SANTO DO DOURADO",1,0,2,44,0,47,"2010"
"2527","312450 ESTIVA",0,2,3,104,0,109,"2010"
"2528","312460 ESTRELA DALVA",0,1,1,35,0,37,"2010"
"2529","312470 ESTRELA DO INDAIA",0,0,0,37,1,38,"2010"
"2530","312480 ESTRELA DO SUL",0,0,1,91,0,92,"2010"
"2531","312490 EUGENOPOLIS",0,0,7,110,1,118,"2010"
"2532","312500 EWBANK DA CAMARA",0,0,3,40,0,43,"2010"
"2533","312510 EXTREMA",1,3,2,375,1,382,"2010"
"2534","312520 FAMA",0,0,0,25,0,25,"2010"
"2535","312530 FARIA LEMOS",0,0,0,39,0,39,"2010"
"2536","312540 FELICIO DOS SANTOS",0,0,0,69,0,69,"2010"
"2537","312550 SAO GONCALO DO RIO PRETO",0,0,1,38,0,39,"2010"
"2538","312560 FELISBURGO",0,2,4,87,3,96,"2010"
"2539","312570 FELIXLANDIA",2,2,8,146,0,158,"2010"
"2540","312580 FERNANDES TOURINHO",0,1,0,28,8,37,"2010"
"2541","312590 FERROS",1,0,0,93,4,98,"2010"
"2542","312595 FERVEDOURO",1,2,0,160,0,163,"2010"
"2543","312600 FLORESTAL",0,1,1,75,1,78,"2010"
"2544","312610 FORMIGA",0,0,3,723,0,726,"2010"
"2545","312620 FORMOSO",0,1,2,103,0,106,"2010"
"2546","312630 FORTALEZA DE MINAS",0,0,2,47,0,49,"2010"
"2547","312640 FORTUNA DE MINAS",1,0,2,20,2,25,"2010"
"2548","312650 FRANCISCO BADARO",0,0,1,62,0,63,"2010"
"2549","312660 FRANCISCO DUMONT",0,1,0,54,0,55,"2010"
"2550","312670 FRANCISCO SA",0,1,4,312,11,328,"2010"
"2551","312675 FRANCISCOPOLIS",0,1,1,66,3,71,"2010"
"2552","312680 FREI GASPAR",0,1,1,84,1,87,"2010"
"2553","312690 FREI INOCENCIO",1,0,1,128,5,135,"2010"
"2554","312695 FREI LAGONEGRO",1,0,1,49,0,51,"2010"
"2555","312700 FRONTEIRA",0,0,6,156,1,163,"2010"
"2556","312705 FRONTEIRA DOS VALES",0,0,1,64,1,66,"2010"
"2557","312707 FRUTA DE LEITE",1,1,0,5,94,101,"2010"
"2558","312710 FRUTAL",2,3,21,708,9,743,"2010"
"2559","312720 FUNILANDIA",0,0,0,51,2,53,"2010"
"2560","312730 GALILEIA",0,0,1,88,6,95,"2010"
"2561","312733 GAMELEIRAS",0,1,0,14,48,63,"2010"
"2562","312735 GLAUCILANDIA",0,0,1,24,0,25,"2010"
"2563","312737 GOIABEIRA",0,1,3,39,1,44,"2010"
"2564","312738 GOIANA",0,0,1,39,0,40,"2010"
"2565","312740 GONCALVES",0,0,1,43,0,44,"2010"
"2566","312750 GONZAGA",0,0,0,74,3,77,"2010"
"2567","312760 GOUVEIA",0,0,1,148,0,149,"2010"
"2568","312770 GOVERNADOR VALADARES",4,12,53,3334,291,3694,"2010"
"2569","312780 GRAO MOGOL",1,1,2,169,8,181,"2010"
"2570","312790 GRUPIARA",0,0,0,13,0,13,"2010"
"2571","312800 GUANHAES",1,4,5,367,8,385,"2010"
"2572","312810 GUAPE",0,0,2,124,0,126,"2010"
"2573","312820 GUARACIABA",0,0,1,105,0,106,"2010"
"2574","312825 GUARACIAMA",0,0,1,61,0,62,"2010"
"2575","312830 GUARANESIA",1,2,1,175,28,207,"2010"
"2576","312840 GUARANI",0,0,0,105,0,105,"2010"
"2577","312850 GUARARA",0,0,0,44,0,44,"2010"
"2578","312860 GUARDA-MOR",1,2,0,75,1,79,"2010"
"2579","312870 GUAXUPE",0,10,23,599,0,632,"2010"
"2580","312880 GUIDOVAL",0,0,1,75,0,76,"2010"
"2581","312890 GUIMARANIA",0,0,1,94,0,95,"2010"
"2582","312900 GUIRICEMA",0,0,0,88,0,88,"2010"
"2583","312910 GURINHATA",0,0,1,49,1,51,"2010"
"2584","312920 HELIODORA",0,0,2,75,0,77,"2010"
"2585","312930 IAPU",0,1,1,122,0,124,"2010"
"2586","312940 IBERTIOGA",0,0,3,56,0,59,"2010"
"2587","312950 IBIA",0,0,3,275,0,278,"2010"
"2588","312960 IBIAI",1,1,6,130,9,147,"2010"
"2589","312965 IBIRACATU",0,0,0,84,1,85,"2010"
"2590","312970 IBIRACI",0,4,7,137,0,148,"2010"
"2591","312980 IBIRITE",7,14,64,2529,17,2631,"2010"
"2592","312990 IBITIURA DE MINAS",0,0,0,27,0,27,"2010"
"2593","313000 IBITURUNA",0,0,3,32,0,35,"2010"
"2594","313005 ICARAI DE MINAS",1,0,1,115,1,118,"2010"
"2595","313010 IGARAPE",1,1,7,471,2,482,"2010"
"2596","313020 IGARATINGA",0,1,1,105,4,111,"2010"
"2597","313030 IGUATAMA",0,0,0,78,0,78,"2010"
"2598","313040 IJACI",0,0,2,67,1,70,"2010"
"2599","313050 ILICINEA",0,0,0,136,4,140,"2010"
"2600","313055 IMBE DE MINAS",0,0,2,72,3,77,"2010"
"2601","313060 INCONFIDENTES",0,1,0,59,0,60,"2010"
"2602","313065 INDAIABIRA",0,0,0,71,4,75,"2010"
"2603","313070 INDIANOPOLIS",0,1,0,63,0,64,"2010"
"2604","313080 INGAI",0,0,0,30,0,30,"2010"
"2605","313090 INHAPIM",5,2,3,222,0,232,"2010"
"2606","313100 INHAUMA",0,0,1,64,2,67,"2010"
"2607","313110 INIMUTABA",0,1,2,81,0,84,"2010"
"2608","313115 IPABA",3,3,7,280,1,294,"2010"
"2609","313120 IPANEMA",1,1,6,215,13,236,"2010"
"2610","313130 IPATINGA",6,14,35,3308,38,3401,"2010"
"2611","313140 IPIACU",1,0,1,37,0,39,"2010"
"2612","313150 IPUIUNA",0,1,3,88,0,92,"2010"
"2613","313160 IRAI DE MINAS",0,2,2,91,0,95,"2010"
"2614","313170 ITABIRA",8,8,11,1353,38,1418,"2010"
"2615","313180 ITABIRINHA",0,0,3,143,1,147,"2010"
"2616","313190 ITABIRITO",3,2,22,655,1,683,"2010"
"2617","313200 ITACAMBIRA",0,0,1,45,0,46,"2010"
"2618","313210 ITACARAMBI",0,1,4,304,0,309,"2010"
"2619","313220 ITAGUARA",0,0,0,131,0,131,"2010"
"2620","313230 ITAIPE",1,1,0,208,0,210,"2010"
"2621","313240 ITAJUBA",2,4,12,1216,2,1236,"2010"
"2622","313250 ITAMARANDIBA",3,1,7,464,2,477,"2010"
"2623","313260 ITAMARATI DE MINAS",0,0,3,46,0,49,"2010"
"2624","313270 ITAMBACURI",0,4,2,347,1,354,"2010"
"2625","313280 ITAMBE DO MATO DENTRO",0,0,0,29,2,31,"2010"
"2626","313290 ITAMOGI",0,0,0,111,0,111,"2010"
"2627","313300 ITAMONTE",0,0,1,157,0,158,"2010"
"2628","313310 ITANHANDU",2,1,4,183,0,190,"2010"
"2629","313320 ITANHOMI",0,1,1,181,4,187,"2010"
"2630","313330 ITAOBIM",2,2,2,294,2,302,"2010"
"2631","313340 ITAPAGIPE",0,2,1,129,0,132,"2010"
"2632","313350 ITAPECERICA",2,0,9,206,0,217,"2010"
"2633","313360 ITAPEVA",1,0,0,108,0,109,"2010"
"2634","313370 ITATIAIUCU",0,0,0,115,2,117,"2010"
"2635","313375 ITAU DE MINAS",2,0,4,156,0,162,"2010"
"2636","313380 ITAUNA",3,2,13,967,4,989,"2010"
"2637","313390 ITAVERAVA",0,0,1,52,0,53,"2010"
"2638","313400 ITINGA",2,1,5,172,3,183,"2010"
"2639","313410 ITUETA",0,0,3,61,2,66,"2010"
"2640","313420 ITUIUTABA",7,1,9,1165,25,1207,"2010"
"2641","313430 ITUMIRIM",0,0,2,64,0,66,"2010"
"2642","313440 ITURAMA",1,1,10,436,1,449,"2010"
"2643","313450 ITUTINGA",0,0,0,41,0,41,"2010"
"2644","313460 JABOTICATUBAS",0,1,5,158,1,165,"2010"
"2645","313470 JACINTO",4,2,4,145,1,156,"2010"
"2646","313480 JACUI",0,0,1,80,0,81,"2010"
"2647","313490 JACUTINGA",1,1,0,261,0,263,"2010"
"2648","313500 JAGUARACU",0,0,0,44,2,46,"2010"
"2649","313505 JAIBA",4,4,17,511,6,542,"2010"
"2650","313507 JAMPRUCA",0,0,1,62,5,68,"2010"
"2651","313510 JANAUBA",3,3,41,986,3,1036,"2010"
"2652","313520 JANUARIA",2,1,6,1017,2,1028,"2010"
"2653","313530 JAPARAIBA",0,0,3,56,0,59,"2010"
"2654","313535 JAPONVAR",1,0,1,96,1,99,"2010"
"2655","313540 JECEABA",0,0,2,51,0,53,"2010"
"2656","313545 JENIPAPO DE MINAS",0,0,0,93,0,93,"2010"
"2657","313550 JEQUERI",0,0,1,140,1,142,"2010"
"2658","313560 JEQUITAI",0,0,3,87,3,93,"2010"
"2659","313570 JEQUITIBA",0,0,2,55,3,60,"2010"
"2660","313580 JEQUITINHONHA",0,0,0,30,225,255,"2010"
"2661","313590 JESUANIA",0,0,2,38,0,40,"2010"
"2662","313600 JOAIMA",0,0,1,10,134,145,"2010"
"2663","313610 JOANESIA",0,0,0,45,0,45,"2010"
"2664","313620 JOAO MONLEVADE",4,4,14,896,2,920,"2010"
"2665","313630 JOAO PINHEIRO",1,3,11,607,1,623,"2010"
"2666","313640 JOAQUIM FELICIO",0,4,0,43,0,47,"2010"
"2667","313650 JORDANIA",3,0,0,108,11,122,"2010"
"2668","313652 JOSE GONCALVES DE MINAS",0,0,0,54,0,54,"2010"
"2669","313655 JOSE RAYDAN",0,0,0,42,0,42,"2010"
"2670","313657 JOSENOPOLIS",0,1,0,49,4,54,"2010"
"2671","313660 NOVA UNIAO",0,0,3,59,8,70,"2010"
"2672","313665 JUATUBA",2,1,2,340,2,347,"2010"
"2673","313670 JUIZ DE FORA",19,54,109,5995,43,6220,"2010"
"2674","313680 JURAMENTO",0,0,0,44,0,44,"2010"
"2675","313690 JURUAIA",0,0,0,82,0,82,"2010"
"2676","313695 JUVENILIA",0,0,0,18,52,70,"2010"
"2677","313700 LADAINHA",1,2,5,204,7,219,"2010"
"2678","313710 LAGAMAR",0,0,1,81,0,82,"2010"
"2679","313720 LAGOA DA PRATA",2,2,11,561,0,576,"2010"
"2680","313730 LAGOA DOS PATOS",0,0,1,39,1,41,"2010"
"2681","313740 LAGOA DOURADA",0,2,3,138,5,148,"2010"
"2682","313750 LAGOA FORMOSA",0,1,2,200,0,203,"2010"
"2683","313753 LAGOA GRANDE",0,0,1,95,1,97,"2010"
"2684","313760 LAGOA SANTA",0,2,6,627,3,638,"2010"
"2685","313770 LAJINHA",0,1,5,231,66,303,"2010"
"2686","313780 LAMBARI",0,0,6,235,0,241,"2010"
"2687","313790 LAMIM",0,0,0,47,0,47,"2010"
"2688","313800 LARANJAL",0,0,1,49,1,51,"2010"
"2689","313810 LASSANCE",0,0,0,83,0,83,"2010"
"2690","313820 LAVRAS",1,5,6,1216,3,1231,"2010"
"2691","313830 LEANDRO FERREIRA",0,0,0,30,9,39,"2010"
"2692","313835 LEME DO PRADO",0,0,0,53,0,53,"2010"
"2693","313840 LEOPOLDINA",1,0,6,588,2,597,"2010"
"2694","313850 LIBERDADE",0,0,1,40,0,41,"2010"
"2695","313860 LIMA DUARTE",1,0,0,149,0,150,"2010"
"2696","313862 LIMEIRA DO OESTE",0,0,0,51,4,55,"2010"
"2697","313865 LONTRA",0,1,0,98,0,99,"2010"
"2698","313867 LUISBURGO",0,0,0,1,79,80,"2010"
"2699","313868 LUISLANDIA",0,0,4,91,3,98,"2010"
"2700","313870 LUMINARIAS",0,0,0,49,0,49,"2010"
"2701","313880 LUZ",1,4,4,216,0,225,"2010"
"2702","313890 MACHACALIS",0,0,4,90,0,94,"2010"
"2703","313900 MACHADO",1,3,8,475,0,487,"2010"
"2704","313910 MADRE DE DEUS DE MINAS",0,0,0,43,5,48,"2010"
"2705","313920 MALACACHETA",0,1,6,253,6,266,"2010"
"2706","313925 MAMONAS",0,0,0,11,52,63,"2010"
"2707","313930 MANGA",1,1,2,317,7,328,"2010"
"2708","313940 MANHUACU",0,0,0,38,1275,1313,"2010"
"2709","313950 MANHUMIRIM",2,1,6,161,136,306,"2010"
"2710","313960 MANTENA",1,0,14,381,0,396,"2010"
"2711","313970 MARAVILHAS",0,0,1,86,2,89,"2010"
"2712","313980 MAR DE ESPANHA",0,0,10,111,0,121,"2010"
"2713","313990 MARIA DA FE",1,3,2,172,0,178,"2010"
"2714","314000 MARIANA",3,8,16,705,67,799,"2010"
"2715","314010 MARILAC",1,1,1,53,4,60,"2010"
"2716","314015 MARIO CAMPOS",1,2,2,182,2,189,"2010"
"2717","314020 MARIPA DE MINAS",0,0,0,36,0,36,"2010"
"2718","314030 MARLIERIA",0,0,0,38,0,38,"2010"
"2719","314040 MARMELOPOLIS",0,1,0,29,0,30,"2010"
"2720","314050 MARTINHO CAMPOS",1,1,1,90,26,119,"2010"
"2721","314053 MARTINS SOARES",0,0,0,27,89,116,"2010"
"2722","314055 MATA VERDE",0,0,2,100,3,105,"2010"
"2723","314060 MATERLANDIA",0,1,0,51,0,52,"2010"
"2724","314070 MATEUS LEME",2,0,3,371,2,378,"2010"
"2725","314080 MATIAS BARBOSA",0,3,1,127,0,131,"2010"
"2726","314085 MATIAS CARDOSO",0,0,5,141,6,152,"2010"
"2727","314090 MATIPO",0,3,9,171,79,262,"2010"
"2728","314100 MATO VERDE",0,2,2,135,5,144,"2010"
"2729","314110 MATOZINHOS",1,0,3,327,160,491,"2010"
"2730","314120 MATUTINA",0,0,0,37,0,37,"2010"
"2731","314130 MEDEIROS",0,0,1,35,0,36,"2010"
"2732","314140 MEDINA",2,3,3,214,0,222,"2010"
"2733","314150 MENDES PIMENTEL",0,1,1,58,5,65,"2010"
"2734","314160 MERCES",0,0,1,103,0,104,"2010"
"2735","314170 MESQUITA",0,0,0,54,1,55,"2010"
"2736","314180 MINAS NOVAS",0,2,3,397,10,412,"2010"
"2737","314190 MINDURI",0,0,0,30,0,30,"2010"
"2738","314200 MIRABELA",2,2,4,187,0,195,"2010"
"2739","314210 MIRADOURO",0,1,6,128,1,136,"2010"
"2740","314220 MIRAI",0,2,2,147,5,156,"2010"
"2741","314225 MIRAVANIA",1,3,0,58,3,65,"2010"
"2742","314230 MOEDA",0,0,0,61,0,61,"2010"
"2743","314240 MOEMA",0,2,0,85,3,90,"2010"
"2744","314250 MONJOLOS",0,0,0,22,0,22,"2010"
"2745","314260 MONSENHOR PAULO",0,0,0,53,1,54,"2010"
"2746","314270 MONTALVANIA",0,0,1,26,163,190,"2010"
"2747","314280 MONTE ALEGRE DE MINAS",0,0,2,103,101,206,"2010"
"2748","314290 MONTE AZUL",0,0,3,31,239,273,"2010"
"2749","314300 MONTE BELO",1,0,0,107,1,109,"2010"
"2750","314310 MONTE CARMELO",1,4,8,635,0,648,"2010"
"2751","314315 MONTE FORMOSO",0,1,0,31,27,59,"2010"
"2752","314320 MONTE SANTO DE MINAS",0,3,2,204,0,209,"2010"
"2753","314330 MONTES CLAROS",8,14,142,5583,18,5765,"2010"
"2754","314340 MONTE SIAO",1,2,3,169,1,176,"2010"
"2755","314345 MONTEZUMA",1,0,3,90,1,95,"2010"
"2756","314350 MORADA NOVA DE MINAS",0,1,2,66,0,69,"2010"
"2757","314360 MORRO DA GARCA",0,0,1,27,0,28,"2010"
"2758","314370 MORRO DO PILAR",0,1,2,26,0,29,"2010"
"2759","314380 MUNHOZ",1,0,0,41,0,42,"2010"
"2760","314390 MURIAE",4,6,31,1184,7,1232,"2010"
"2761","314400 MUTUM",0,0,2,332,7,341,"2010"
"2762","314410 MUZAMBINHO",1,0,2,236,0,239,"2010"
"2763","314420 NACIP RAYDAN",0,0,0,26,3,29,"2010"
"2764","314430 NANUQUE",1,2,13,547,2,565,"2010"
"2765","314435 NAQUE",0,0,1,102,0,103,"2010"
"2766","314437 NATALANDIA",0,0,2,37,1,40,"2010"
"2767","314440 NATERCIA",0,0,0,34,0,34,"2010"
"2768","314450 NAZARENO",0,2,1,98,1,102,"2010"
"2769","314460 NEPOMUCENO",0,3,3,296,1,303,"2010"
"2770","314465 NINHEIRA",0,1,2,101,0,104,"2010"
"2771","314467 NOVA BELEM",0,0,1,59,0,60,"2010"
"2772","314470 NOVA ERA",2,0,0,202,0,204,"2010"
"2773","314480 NOVA LIMA",7,5,10,1174,0,1196,"2010"
"2774","314490 NOVA MODICA",0,0,1,54,0,55,"2010"
"2775","314500 NOVA PONTE",0,1,1,164,0,166,"2010"
"2776","314505 NOVA PORTEIRINHA",0,1,5,102,1,109,"2010"
"2777","314510 NOVA RESENDE",0,2,7,182,0,191,"2010"
"2778","314520 NOVA SERRANA",6,3,9,1101,31,1150,"2010"
"2779","314530 NOVO CRUZEIRO",2,8,9,482,19,520,"2010"
"2780","314535 NOVO ORIENTE DE MINAS",0,0,1,122,4,127,"2010"
"2781","314537 NOVORIZONTE",0,0,0,11,56,67,"2010"
"2782","314540 OLARIA",0,0,0,17,1,18,"2010"
"2783","314545 OLHOS-D'AGUA",0,0,1,60,0,61,"2010"
"2784","314550 OLIMPIO NORONHA",0,0,2,25,0,27,"2010"
"2785","314560 OLIVEIRA",0,1,4,410,25,440,"2010"
"2786","314570 OLIVEIRA FORTES",1,0,0,17,0,18,"2010"
"2787","314580 ONCA DE PITANGUI",0,0,0,26,4,30,"2010"
"2788","314585 ORATORIOS",0,1,1,70,0,72,"2010"
"2789","314587 ORIZANIA",0,3,2,89,6,100,"2010"
"2790","314590 OURO BRANCO",0,3,11,473,2,489,"2010"
"2791","314600 OURO FINO",0,1,4,315,0,320,"2010"
"2792","314610 OURO PRETO",3,7,23,774,12,819,"2010"
"2793","314620 OURO VERDE DE MINAS",0,0,1,101,3,105,"2010"
"2794","314625 PADRE CARVALHO",0,0,0,6,89,95,"2010"
"2795","314630 PADRE PARAISO",1,0,3,274,1,279,"2010"
"2796","314640 PAINEIRAS",0,0,0,44,1,45,"2010"
"2797","314650 PAINS",0,0,1,77,0,78,"2010"
"2798","314655 PAI PEDRO",0,2,4,67,1,74,"2010"
"2799","314660 PAIVA",0,0,0,7,0,7,"2010"
"2800","314670 PALMA",0,0,0,72,0,72,"2010"
"2801","314675 PALMOPOLIS",2,0,1,104,2,109,"2010"
"2802","314690 PAPAGAIOS",0,0,7,181,22,210,"2010"
"2803","314700 PARACATU",2,2,25,1168,4,1201,"2010"
"2804","314710 PARA DE MINAS",3,1,16,992,50,1062,"2010"
"2805","314720 PARAGUACU",1,1,6,218,0,226,"2010"
"2806","314730 PARAISOPOLIS",2,1,3,215,0,221,"2010"
"2807","314740 PARAOPEBA",0,2,3,330,6,341,"2010"
"2808","314750 PASSABEM",0,0,0,17,1,18,"2010"
"2809","314760 PASSA QUATRO",0,2,5,172,0,179,"2010"
"2810","314770 PASSA TEMPO",0,0,1,66,1,68,"2010"
"2811","314780 PASSA-VINTE",0,0,0,13,0,13,"2010"
"2812","314790 PASSOS",2,7,16,1339,1,1365,"2010"
"2813","314795 PATIS",0,0,3,63,0,66,"2010"
"2814","314800 PATOS DE MINAS",3,6,14,1568,0,1591,"2010"
"2815","314810 PATROCINIO",4,5,22,1047,3,1081,"2010"
"2816","314820 PATROCINIO DO MURIAE",0,1,1,42,0,44,"2010"
"2817","314830 PAULA CANDIDO",0,0,4,105,1,110,"2010"
"2818","314840 PAULISTAS",1,0,1,64,0,66,"2010"
"2819","314850 PAVAO",0,0,3,90,2,95,"2010"
"2820","314860 PECANHA",1,1,1,274,4,281,"2010"
"2821","314870 PEDRA AZUL",4,7,29,397,7,444,"2010"
"2822","314875 PEDRA BONITA",1,0,0,94,6,101,"2010"
"2823","314880 PEDRA DO ANTA",0,1,0,26,3,30,"2010"
"2824","314890 PEDRA DO INDAIA",0,1,0,39,0,40,"2010"
"2825","314900 PEDRA DOURADA",0,0,0,24,1,25,"2010"
"2826","314910 PEDRALVA",0,0,1,123,0,124,"2010"
"2827","314915 PEDRAS DE MARIA DA CRUZ",0,0,2,121,0,123,"2010"
"2828","314920 PEDRINOPOLIS",0,1,1,38,0,40,"2010"
"2829","314930 PEDRO LEOPOLDO",3,1,14,750,7,775,"2010"
"2830","314940 PEDRO TEIXEIRA",0,0,0,20,0,20,"2010"
"2831","314950 PEQUERI",0,1,1,46,0,48,"2010"
"2832","314960 PEQUI",0,0,0,41,0,41,"2010"
"2833","314970 PERDIGAO",0,1,2,97,14,114,"2010"
"2834","314980 PERDIZES",1,1,5,150,0,157,"2010"
"2835","314990 PERDOES",0,0,3,171,2,176,"2010"
"2836","314995 PERIQUITO",1,0,2,87,9,99,"2010"
"2837","315000 PESCADOR",1,0,1,46,0,48,"2010"
"2838","315010 PIAU",0,0,1,31,0,32,"2010"
"2839","315015 PIEDADE DE CARATINGA",0,0,1,112,1,114,"2010"
"2840","315020 PIEDADE DE PONTE NOVA",0,1,1,50,0,52,"2010"
"2841","315030 PIEDADE DO RIO GRANDE",0,0,1,48,1,50,"2010"
"2842","315040 PIEDADE DOS GERAIS",0,0,2,30,0,32,"2010"
"2843","315050 PIMENTA",0,0,1,94,0,95,"2010"
"2844","315053 PINGO-D'AGUA",0,1,3,54,0,58,"2010"
"2845","315057 PINTOPOLIS",1,1,1,91,4,98,"2010"
"2846","315060 PIRACEMA",0,0,1,68,0,69,"2010"
"2847","315070 PIRAJUBA",0,1,0,54,1,56,"2010"
"2848","315080 PIRANGA",0,1,9,181,1,192,"2010"
"2849","315090 PIRANGUCU",0,0,0,48,0,48,"2010"
"2850","315100 PIRANGUINHO",0,0,0,88,0,88,"2010"
"2851","315110 PIRAPETINGA",0,0,1,140,1,142,"2010"
"2852","315120 PIRAPORA",2,0,12,729,83,826,"2010"
"2853","315130 PIRAUBA",0,1,0,132,0,133,"2010"
"2854","315140 PITANGUI",1,0,1,50,298,350,"2010"
"2855","315150 PIUMHI",1,1,4,340,0,346,"2010"
"2856","315160 PLANURA",0,0,2,140,2,144,"2010"
"2857","315170 POCO FUNDO",0,0,1,157,0,158,"2010"
"2858","315180 POCOS DE CALDAS",8,13,31,1971,11,2034,"2010"
"2859","315190 POCRANE",0,1,0,73,3,77,"2010"
"2860","315200 POMPEU",0,5,4,396,0,405,"2010"
"2861","315210 PONTE NOVA",0,2,7,659,2,670,"2010"
"2862","315213 PONTO CHIQUE",0,0,2,55,1,58,"2010"
"2863","315217 PONTO DOS VOLANTES",1,1,5,157,5,169,"2010"
"2864","315220 PORTEIRINHA",2,0,16,496,4,518,"2010"
"2865","315230 PORTO FIRME",0,1,1,75,3,80,"2010"
"2866","315240 POTE",2,1,1,205,0,209,"2010"
"2867","315250 POUSO ALEGRE",3,10,19,1713,6,1751,"2010"
"2868","315260 POUSO ALTO",0,1,1,73,0,75,"2010"
"2869","315270 PRADOS",1,0,6,84,14,105,"2010"
"2870","315280 PRATA",0,0,1,334,0,335,"2010"
"2871","315290 PRATAPOLIS",0,0,1,92,0,93,"2010"
"2872","315300 PRATINHA",0,0,0,19,0,19,"2010"
"2873","315310 PRESIDENTE BERNARDES",0,1,1,43,0,45,"2010"
"2874","315320 PRESIDENTE JUSCELINO",0,0,1,29,1,31,"2010"
"2875","315330 PRESIDENTE KUBITSCHEK",1,0,0,57,0,58,"2010"
"2876","315340 PRESIDENTE OLEGARIO",0,1,2,212,1,216,"2010"
"2877","315350 ALTO JEQUITIBA",0,0,4,52,47,103,"2010"
"2878","315360 PRUDENTE DE MORAIS",0,0,2,129,10,141,"2010"
"2879","315370 QUARTEL GERAL",2,0,0,33,0,35,"2010"
"2880","315380 QUELUZITO",0,0,0,21,0,21,"2010"
"2881","315390 RAPOSOS",1,1,4,211,0,217,"2010"
"2882","315400 RAUL SOARES",0,2,3,236,2,243,"2010"
"2883","315410 RECREIO",0,1,0,81,0,82,"2010"
"2884","315415 REDUTO",0,0,0,7,75,82,"2010"
"2885","315420 RESENDE COSTA",0,0,0,146,0,146,"2010"
"2886","315430 RESPLENDOR",2,2,2,195,1,202,"2010"
"2887","315440 RESSAQUINHA",0,0,2,58,0,60,"2010"
"2888","315445 RIACHINHO",0,0,1,45,3,49,"2010"
"2889","315450 RIACHO DOS MACHADOS",0,1,1,132,12,146,"2010"
"2890","315460 RIBEIRAO DAS NEVES",9,19,51,4266,55,4400,"2010"
"2891","315470 RIBEIRAO VERMELHO",0,0,0,36,0,36,"2010"
"2892","315480 RIO ACIMA",0,1,1,131,0,133,"2010"
"2893","315490 RIO CASCA",1,2,0,169,0,172,"2010"
"2894","315500 RIO DOCE",0,0,0,20,0,20,"2010"
"2895","315510 RIO DO PRADO",1,0,1,81,5,88,"2010"
"2896","315520 RIO ESPERA",0,0,0,42,0,42,"2010"
"2897","315530 RIO MANSO",0,0,1,38,0,39,"2010"
"2898","315540 RIO NOVO",0,0,1,75,0,76,"2010"
"2899","315550 RIO PARANAIBA",0,0,1,123,2,126,"2010"
"2900","315560 RIO PARDO DE MINAS",0,1,8,386,3,398,"2010"
"2901","315570 RIO PIRACICABA",2,0,3,161,0,166,"2010"
"2902","315580 RIO POMBA",0,1,3,171,0,175,"2010"
"2903","315590 RIO PRETO",0,0,0,45,0,45,"2010"
"2904","315600 RIO VERMELHO",2,3,5,165,0,175,"2010"
"2905","315610 RITAPOLIS",0,0,0,52,0,52,"2010"
"2906","315620 ROCHEDO DE MINAS",0,0,0,29,1,30,"2010"
"2907","315630 RODEIRO",0,0,3,99,0,102,"2010"
"2908","315640 ROMARIA",0,0,0,34,0,34,"2010"
"2909","315645 ROSARIO DA LIMEIRA",0,0,3,40,0,43,"2010"
"2910","315650 RUBELITA",0,0,1,5,93,99,"2010"
"2911","315660 RUBIM",1,2,3,117,1,124,"2010"
"2912","315670 SABARA",6,9,31,1699,11,1756,"2010"
"2913","315680 SABINOPOLIS",1,1,5,223,1,231,"2010"
"2914","315690 SACRAMENTO",0,0,0,322,0,322,"2010"
"2915","315700 SALINAS",3,0,0,27,576,606,"2010"
"2916","315710 SALTO DA DIVISA",2,1,5,99,5,112,"2010"
"2917","315720 SANTA BARBARA",1,1,12,342,26,382,"2010"
"2918","315725 SANTA BARBARA DO LESTE",0,0,3,108,2,113,"2010"
"2919","315727 SANTA BARBARA DO MONTE VERDE",0,0,1,43,1,45,"2010"
"2920","315730 SANTA BARBARA DO TUGURIO",0,0,1,53,0,54,"2010"
"2921","315733 SANTA CRUZ DE MINAS",0,2,2,83,21,108,"2010"
"2922","315737 SANTA CRUZ DE SALINAS",1,0,0,22,41,64,"2010"
"2923","315740 SANTA CRUZ DO ESCALVADO",0,0,0,35,2,37,"2010"
"2924","315750 SANTA EFIGENIA DE MINAS",0,0,2,62,5,69,"2010"
"2925","315760 SANTA FE DE MINAS",0,0,0,40,6,46,"2010"
"2926","315765 SANTA HELENA DE MINAS",1,1,4,67,24,97,"2010"
"2927","315770 SANTA JULIANA",0,1,1,149,1,152,"2010"
"2928","315780 SANTA LUZIA",2,10,52,2985,7,3056,"2010"
"2929","315790 SANTA MARGARIDA",1,2,9,187,48,247,"2010"
"2930","315800 SANTA MARIA DE ITABIRA",0,0,1,122,8,131,"2010"
"2931","315810 SANTA MARIA DO SALTO",0,1,3,56,4,64,"2010"
"2932","315820 SANTA MARIA DO SUACUI",0,0,2,205,4,211,"2010"
"2933","315830 SANTANA DA VARGEM",0,1,0,20,55,76,"2010"
"2934","315840 SANTANA DE CATAGUASES",0,0,2,37,0,39,"2010"
"2935","315850 SANTANA DE PIRAPAMA",0,0,1,82,0,83,"2010"
"2936","315860 SANTANA DO DESERTO",0,0,0,47,0,47,"2010"
"2937","315870 SANTANA DO GARAMBEU",0,0,0,14,0,14,"2010"
"2938","315880 SANTANA DO JACARE",1,0,0,46,0,47,"2010"
"2939","315890 SANTANA DO MANHUACU",0,0,0,9,127,136,"2010"
"2940","315895 SANTANA DO PARAISO",1,1,6,374,3,385,"2010"
"2941","315900 SANTANA DO RIACHO",0,0,0,37,2,39,"2010"
"2942","315910 SANTANA DOS MONTES",0,0,1,33,0,34,"2010"
"2943","315920 SANTA RITA DE CALDAS",0,1,1,75,0,77,"2010"
"2944","315930 SANTA RITA DE JACUTINGA",0,0,0,39,5,44,"2010"
"2945","315935 SANTA RITA DE MINAS",0,0,3,93,1,97,"2010"
"2946","315940 SANTA RITA DE IBITIPOCA",1,0,1,30,0,32,"2010"
"2947","315950 SANTA RITA DO ITUETO",1,0,0,74,1,76,"2010"
"2948","315960 SANTA RITA DO SAPUCAI",1,2,4,486,0,493,"2010"
"2949","315970 SANTA ROSA DA SERRA",0,1,0,36,0,37,"2010"
"2950","315980 SANTA VITORIA",0,0,0,259,0,259,"2010"
"2951","315990 SANTO ANTONIO DO AMPARO",2,1,7,216,0,226,"2010"
"2952","316000 SANTO ANTONIO DO AVENTUREIRO",0,0,2,27,0,29,"2010"
"2953","316010 SANTO ANTONIO DO GRAMA",0,0,1,43,0,44,"2010"
"2954","316020 SANTO ANTONIO DO ITAMBE",0,0,0,54,1,55,"2010"
"2955","316030 SANTO ANTONIO DO JACINTO",3,3,6,175,2,189,"2010"
"2956","316040 SANTO ANTONIO DO MONTE",0,0,2,351,0,353,"2010"
"2957","316045 SANTO ANTONIO DO RETIRO",0,1,1,23,92,117,"2010"
"2958","316050 SANTO ANTONIO DO RIO ABAIXO",1,0,0,19,1,21,"2010"
"2959","316060 SANTO HIPOLITO",0,0,0,28,0,28,"2010"
"2960","316070 SANTOS DUMONT",5,4,6,545,0,560,"2010"
"2961","316080 SAO BENTO ABADE",0,1,0,17,44,62,"2010"
"2962","316090 SAO BRAS DO SUACUI",0,1,2,42,0,45,"2010"
"2963","316095 SAO DOMINGOS DAS DORES",1,0,1,75,2,79,"2010"
"2964","316100 SAO DOMINGOS DO PRATA",0,2,3,180,1,186,"2010"
"2965","316105 SAO FELIX DE MINAS",1,0,1,40,1,43,"2010"
"2966","316110 SAO FRANCISCO",1,4,18,963,9,995,"2010"
"2967","316120 SAO FRANCISCO DE PAULA",0,0,1,56,2,59,"2010"
"2968","316130 SAO FRANCISCO DE SALES",0,0,1,50,4,55,"2010"
"2969","316140 SAO FRANCISCO DO GLORIA",0,1,1,45,0,47,"2010"
"2970","316150 SAO GERALDO",1,0,3,89,0,93,"2010"
"2971","316160 SAO GERALDO DA PIEDADE",1,0,2,53,9,65,"2010"
"2972","316165 SAO GERALDO DO BAIXIO",0,0,0,42,4,46,"2010"
"2973","316170 SAO GONCALO DO ABAETE",3,0,2,62,0,67,"2010"
"2974","316180 SAO GONCALO DO PARA",0,1,1,120,1,123,"2010"
"2975","316190 SAO GONCALO DO RIO ABAIXO",0,0,0,88,0,88,"2010"
"2976","316200 SAO GONCALO DO SAPUCAI",0,4,8,318,3,333,"2010"
"2977","316210 SAO GOTARDO",1,1,2,444,0,448,"2010"
"2978","316220 SAO JOAO BATISTA DO GLORIA",1,1,0,54,0,56,"2010"
"2979","316225 SAO JOAO DA LAGOA",0,0,0,34,0,34,"2010"
"2980","316230 SAO JOAO DA MATA",0,0,0,28,0,28,"2010"
"2981","316240 SAO JOAO DA PONTE",0,2,3,300,1,306,"2010"
"2982","316245 SAO JOAO DAS MISSOES",0,0,10,237,29,276,"2010"
"2983","316250 SAO JOAO DEL REI",1,6,19,891,25,942,"2010"
"2984","316255 SAO JOAO DO MANHUACU",1,0,0,38,98,137,"2010"
"2985","316257 SAO JOAO DO MANTENINHA",0,0,2,76,0,78,"2010"
"2986","316260 SAO JOAO DO ORIENTE",1,0,1,82,1,85,"2010"
"2987","316265 SAO JOAO DO PACUI",0,0,2,47,1,50,"2010"
"2988","316270 SAO JOAO DO PARAISO",0,2,0,285,4,291,"2010"
"2989","316280 SAO JOAO EVANGELISTA",0,1,0,174,0,175,"2010"
"2990","316290 SAO JOAO NEPOMUCENO",3,1,6,301,0,311,"2010"
"2991","316292 SAO JOAQUIM DE BICAS",1,0,3,330,2,336,"2010"
"2992","316294 SAO JOSE DA BARRA",0,1,1,70,0,72,"2010"
"2993","316295 SAO JOSE DA LAPA",0,2,2,261,3,268,"2010"
"2994","316300 SAO JOSE DA SAFIRA",0,1,0,58,7,66,"2010"
"2995","316310 SAO JOSE DA VARGINHA",0,0,1,39,5,45,"2010"
"2996","316320 SAO JOSE DO ALEGRE",0,0,1,49,0,50,"2010"
"2997","316330 SAO JOSE DO DIVINO",0,0,1,45,1,47,"2010"
"2998","316340 SAO JOSE DO GOIABAL",0,2,1,61,1,65,"2010"
"2999","316350 SAO JOSE DO JACURI",0,0,1,74,0,75,"2010"
"3000","316360 SAO JOSE DO MANTIMENTO",0,0,0,12,31,43,"2010"
"3001","316370 SAO LOURENCO",0,3,10,503,0,516,"2010"
"3002","316380 SAO MIGUEL DO ANTA",0,1,0,44,7,52,"2010"
"3003","316390 SAO PEDRO DA UNIAO",0,1,2,39,1,43,"2010"
"3004","316400 SAO PEDRO DOS FERROS",0,0,0,68,1,69,"2010"
"3005","316410 SAO PEDRO DO SUACUI",0,0,0,55,0,55,"2010"
"3006","316420 SAO ROMAO",1,1,5,158,2,167,"2010"
"3007","316430 SAO ROQUE DE MINAS",0,0,0,52,0,52,"2010"
"3008","316440 SAO SEBASTIAO DA BELA VISTA",0,0,2,63,2,67,"2010"
"3009","316443 SAO SEBASTIAO DA VARGEM ALEGRE",0,0,1,34,0,35,"2010"
"3010","316447 SAO SEBASTIAO DO ANTA",1,1,0,103,1,106,"2010"
"3011","316450 SAO SEBASTIAO DO MARANHAO",0,0,1,106,5,112,"2010"
"3012","316460 SAO SEBASTIAO DO OESTE",1,0,2,77,1,81,"2010"
"3013","316470 SAO SEBASTIAO DO PARAISO",0,2,16,923,2,943,"2010"
"3014","316480 SAO SEBASTIAO DO RIO PRETO",0,0,0,16,1,17,"2010"
"3015","316490 SAO SEBASTIAO DO RIO VERDE",0,0,2,21,0,23,"2010"
"3016","316500 SAO TIAGO",0,1,5,116,1,123,"2010"
"3017","316510 SAO TOMAS DE AQUINO",0,1,1,91,0,93,"2010"
"3018","316520 SAO THOME DAS LETRAS",0,0,1,15,37,53,"2010"
"3019","316530 SAO VICENTE DE MINAS",0,0,3,96,0,99,"2010"
"3020","316540 SAPUCAI-MIRIM",0,1,1,81,0,83,"2010"
"3021","316550 SARDOA",1,1,6,66,12,86,"2010"
"3022","316553 SARZEDO",1,1,2,384,1,389,"2010"
"3023","316555 SETUBINHA",1,1,1,164,19,186,"2010"
"3024","316556 SEM-PEIXE",0,0,0,29,0,29,"2010"
"3025","316557 SENADOR AMARAL",0,0,2,88,1,91,"2010"
"3026","316560 SENADOR CORTES",0,1,1,33,0,35,"2010"
"3027","316570 SENADOR FIRMINO",1,0,2,80,0,83,"2010"
"3028","316580 SENADOR JOSE BENTO",0,1,0,16,0,17,"2010"
"3029","316590 SENADOR MODESTINO GONCALVES",0,0,1,51,0,52,"2010"
"3030","316600 SENHORA DE OLIVEIRA",0,1,0,66,0,67,"2010"
"3031","316610 SENHORA DO PORTO",0,1,1,45,5,52,"2010"
"3032","316620 SENHORA DOS REMEDIOS",0,0,3,100,0,103,"2010"
"3033","316630 SERICITA",0,1,0,122,2,125,"2010"
"3034","316640 SERITINGA",0,0,0,22,0,22,"2010"
"3035","316650 SERRA AZUL DE MINAS",0,0,0,62,0,62,"2010"
"3036","316660 SERRA DA SAUDADE",0,0,0,7,0,7,"2010"
"3037","316670 SERRA DOS AIMORES",1,0,3,118,2,124,"2010"
"3038","316680 SERRA DO SALITRE",2,0,2,134,0,138,"2010"
"3039","316690 SERRANIA",0,0,2,96,1,99,"2010"
"3040","316695 SERRANOPOLIS DE MINAS",0,1,0,53,1,55,"2010"
"3041","316700 SERRANOS",1,0,0,21,0,22,"2010"
"3042","316710 SERRO",0,0,0,282,5,287,"2010"
"3043","316720 SETE LAGOAS",7,13,36,2660,60,2776,"2010"
"3044","316730 SILVEIRANIA",0,0,1,22,0,23,"2010"
"3045","316740 SILVIANOPOLIS",0,0,0,62,0,62,"2010"
"3046","316750 SIMAO PEREIRA",0,0,0,32,0,32,"2010"
"3047","316760 SIMONESIA",0,2,0,17,247,266,"2010"
"3048","316770 SOBRALIA",0,0,2,51,7,60,"2010"
"3049","316780 SOLEDADE DE MINAS",0,0,4,84,0,88,"2010"
"3050","316790 TABULEIRO",0,0,0,35,0,35,"2010"
"3051","316800 TAIOBEIRAS",0,4,4,469,2,479,"2010"
"3052","316805 TAPARUBA",0,0,1,44,0,45,"2010"
"3053","316810 TAPIRA",1,0,1,33,1,36,"2010"
"3054","316820 TAPIRAI",0,0,0,13,0,13,"2010"
"3055","316830 TAQUARACU DE MINAS",0,0,0,35,0,35,"2010"
"3056","316840 TARUMIRIM",0,2,5,164,4,175,"2010"
"3057","316850 TEIXEIRAS",0,1,0,90,4,95,"2010"
"3058","316860 TEOFILO OTONI",4,9,37,1788,14,1852,"2010"
"3059","316870 TIMOTEO",2,2,12,887,26,929,"2010"
"3060","316880 TIRADENTES",0,0,2,71,7,80,"2010"
"3061","316890 TIROS",0,0,0,58,0,58,"2010"
"3062","316900 TOCANTINS",1,0,5,157,0,163,"2010"
"3063","316905 TOCOS DO MOJI",0,0,0,30,0,30,"2010"
"3064","316910 TOLEDO",0,0,2,51,0,53,"2010"
"3065","316920 TOMBOS",0,0,2,128,1,131,"2010"
"3066","316930 TRES CORACOES",1,3,7,451,580,1042,"2010"
"3067","316935 TRES MARIAS",0,2,3,376,1,382,"2010"
"3068","316940 TRES PONTAS",0,0,3,193,533,729,"2010"
"3069","316950 TUMIRITINGA",0,0,2,80,11,93,"2010"
"3070","316960 TUPACIGUARA",0,0,4,258,2,264,"2010"
"3071","316970 TURMALINA",1,1,2,270,0,274,"2010"
"3072","316980 TURVOLANDIA",0,0,1,70,0,71,"2010"
"3073","316990 UBA",10,10,20,1223,1,1264,"2010"
"3074","317000 UBAI",0,1,7,203,1,212,"2010"
"3075","317005 UBAPORANGA",0,0,14,138,0,152,"2010"
"3076","317010 UBERABA",15,10,25,3746,9,3805,"2010"
"3077","317020 UBERLANDIA",25,18,77,8273,33,8426,"2010"
"3078","317030 UMBURATIBA",0,0,1,38,1,40,"2010"
"3079","317040 UNAI",2,4,13,1003,14,1036,"2010"
"3080","317043 UNIAO DE MINAS",1,0,1,41,9,52,"2010"
"3081","317047 URUANA DE MINAS",0,0,0,46,0,46,"2010"
"3082","317050 URUCANIA",0,2,2,110,0,114,"2010"
"3083","317052 URUCUIA",4,2,1,202,2,211,"2010"
"3084","317057 VARGEM ALEGRE",0,0,5,79,0,84,"2010"
"3085","317060 VARGEM BONITA",0,0,0,23,0,23,"2010"
"3086","317065 VARGEM GRANDE DO RIO PARDO",0,0,1,62,2,65,"2010"
"3087","317070 VARGINHA",0,3,14,1619,19,1655,"2010"
"3088","317075 VARJAO DE MINAS",1,0,0,91,0,92,"2010"
"3089","317080 VARZEA DA PALMA",0,2,8,430,10,450,"2010"
"3090","317090 VARZELANDIA",2,2,6,258,3,271,"2010"
"3091","317100 VAZANTE",1,1,2,259,0,263,"2010"
"3092","317103 VERDELANDIA",1,2,5,148,2,158,"2010"
"3093","317107 VEREDINHA",0,1,0,44,1,46,"2010"
"3094","317110 VERISSIMO",0,0,1,41,1,43,"2010"
"3095","317115 VERMELHO NOVO",1,1,2,53,5,62,"2010"
"3096","317120 VESPASIANO",8,5,30,1555,3,1601,"2010"
"3097","317130 VICOSA",1,3,11,601,16,632,"2010"
"3098","317140 VIEIRAS",1,0,0,51,0,52,"2010"
"3099","317150 MATHIAS LOBATO",0,1,0,46,5,52,"2010"
"3100","317160 VIRGEM DA LAPA",0,1,1,126,7,135,"2010"
"3101","317170 VIRGINIA",1,0,1,117,0,119,"2010"
"3102","317180 VIRGINOPOLIS",0,1,2,128,0,131,"2010"
"3103","317190 VIRGOLANDIA",0,0,2,68,0,70,"2010"
"3104","317200 VISCONDE DO RIO BRANCO",0,1,5,478,2,486,"2010"
"3105","317210 VOLTA GRANDE",0,0,2,47,0,49,"2010"
"3106","317220 WENCESLAU BRAZ",0,0,0,28,0,28,"2010"
"3107","MUNICIPIO IGNORADO - ES",0,0,0,3,0,3,"2010"
"3108","320010 AFONSO CLAUDIO",3,5,2,443,0,453,"2010"
"3109","320013 AGUIA BRANCA",0,1,5,122,0,128,"2010"
"3110","320016 AGUA DOCE DO NORTE",0,1,2,155,2,160,"2010"
"3111","320020 ALEGRE",1,0,3,391,3,398,"2010"
"3112","320030 ALFREDO CHAVES",0,1,1,113,1,116,"2010"
"3113","320035 ALTO RIO NOVO",0,1,2,106,0,109,"2010"
"3114","320040 ANCHIETA",1,1,4,310,0,316,"2010"
"3115","320050 APIACA",0,2,0,77,0,79,"2010"
"3116","320060 ARACRUZ",1,3,12,1239,50,1305,"2010"
"3117","320070 ATILIO VIVACQUA",0,0,0,116,2,118,"2010"
"3118","320080 BAIXO GUANDU",1,0,3,341,46,391,"2010"
"3119","320090 BARRA DE SAO FRANCISCO",4,2,12,603,1,622,"2010"
"3120","320100 BOA ESPERANCA",1,2,1,173,15,192,"2010"
"3121","320110 BOM JESUS DO NORTE",0,1,0,73,1,75,"2010"
"3122","320115 BREJETUBA",0,0,4,169,0,173,"2010"
"3123","320120 CACHOEIRO DE ITAPEMIRIM",2,6,31,2599,19,2657,"2010"
"3124","320130 CARIACICA",69,14,80,5723,56,5942,"2010"
"3125","320140 CASTELO",0,0,1,221,203,425,"2010"
"3126","320150 COLATINA",3,4,16,1364,11,1398,"2010"
"3127","320160 CONCEICAO DA BARRA",0,4,10,433,5,452,"2010"
"3128","320170 CONCEICAO DO CASTELO",0,1,3,136,0,140,"2010"
"3129","320180 DIVINO DE SAO LOURENCO",0,0,1,49,2,52,"2010"
"3130","320190 DOMINGOS MARTINS",0,2,8,414,1,425,"2010"
"3131","320200 DORES DO RIO PRETO",1,1,4,87,0,93,"2010"
"3132","320210 ECOPORANGA",0,0,3,286,0,289,"2010"
"3133","320220 FUNDAO",0,1,5,271,2,279,"2010"
"3134","320225 GOVERNADOR LINDENBERG",0,0,1,113,1,115,"2010"
"3135","320230 GUACUI",2,0,8,408,1,419,"2010"
"3136","320240 GUARAPARI",10,5,16,1506,2,1539,"2010"
"3137","320245 IBATIBA",2,2,4,320,6,334,"2010"
"3138","320250 IBIRACU",0,0,1,132,1,134,"2010"
"3139","320255 IBITIRAMA",2,0,2,130,2,136,"2010"
"3140","320260 ICONHA",0,1,3,129,1,134,"2010"
"3141","320265 IRUPI",0,1,5,147,10,163,"2010"
"3142","320270 ITAGUACU",0,0,4,135,12,151,"2010"
"3143","320280 ITAPEMIRIM",1,2,8,450,10,471,"2010"
"3144","320290 ITARANA",0,0,0,100,4,104,"2010"
"3145","320300 IUNA",0,3,4,339,24,370,"2010"
"3146","320305 JAGUARE",2,2,5,368,17,394,"2010"
"3147","320310 JERONIMO MONTEIRO",0,1,8,115,0,124,"2010"
"3148","320313 JOAO NEIVA",0,2,1,168,1,172,"2010"
"3149","320316 LARANJA DA TERRA",1,0,0,89,8,98,"2010"
"3150","320320 LINHARES",0,1,2,574,1823,2400,"2010"
"3151","320330 MANTENOPOLIS",1,3,4,188,0,196,"2010"
"3152","320332 MARATAIZES",1,1,6,469,9,486,"2010"
"3153","320334 MARECHAL FLORIANO",0,0,4,199,2,205,"2010"
"3154","320335 MARILANDIA",0,0,0,110,2,112,"2010"
"3155","320340 MIMOSO DO SUL",0,0,4,303,1,308,"2010"
"3156","320350 MONTANHA",1,2,5,220,3,231,"2010"
"3157","320360 MUCURICI",0,1,1,85,1,88,"2010"
"3158","320370 MUNIZ FREIRE",24,0,1,264,1,290,"2010"
"3159","320380 MUQUI",0,0,2,159,0,161,"2010"
"3160","320390 NOVA VENECIA",4,4,4,634,7,653,"2010"
"3161","320400 PANCAS",2,0,1,247,1,251,"2010"
"3162","320405 PEDRO CANARIO",0,1,6,397,5,409,"2010"
"3163","320410 PINHEIROS",0,0,3,54,325,382,"2010"
"3164","320420 PIUMA",0,1,4,200,0,205,"2010"
"3165","320425 PONTO BELO",0,0,1,89,4,94,"2010"
"3166","320430 PRESIDENTE KENNEDY",0,0,3,133,2,138,"2010"
"3167","320435 RIO BANANAL",0,1,1,93,136,231,"2010"
"3168","320440 RIO NOVO DO SUL",1,0,1,125,0,127,"2010"
"3169","320450 SANTA LEOPOLDINA",0,0,0,98,0,98,"2010"
"3170","320455 SANTA MARIA DE JETIBA",3,1,5,577,1,587,"2010"
"3171","320460 SANTA TERESA",0,0,1,258,0,259,"2010"
"3172","320465 SAO DOMINGOS DO NORTE",0,1,0,104,0,105,"2010"
"3173","320470 SAO GABRIEL DA PALHA",1,1,8,440,1,451,"2010"
"3174","320480 SAO JOSE DO CALCADO",0,0,5,120,0,125,"2010"
"3175","320490 SAO MATEUS",1,13,26,1618,37,1695,"2010"
"3176","320495 SAO ROQUE DO CANAA",1,1,1,120,2,125,"2010"
"3177","320500 SERRA",13,32,88,6953,73,7159,"2010"
"3178","320501 SOORETAMA",0,0,2,93,366,461,"2010"
"3179","320503 VARGEM ALTA",0,2,4,278,0,284,"2010"
"3180","320506 VENDA NOVA DO IMIGRANTE",0,1,6,271,2,280,"2010"
"3181","320510 VIANA",4,1,18,922,11,956,"2010"
"3182","320515 VILA PAVAO",0,1,0,106,0,107,"2010"
"3183","320517 VILA VALERIO",0,0,0,141,10,151,"2010"
"3184","320520 VILA VELHA",324,14,81,5366,35,5820,"2010"
"3185","320530 VITORIA",21,7,83,4449,15,4575,"2010"
"3186","MUNICIPIO IGNORADO - RJ",0,0,0,13,3,16,"2010"
"3187","330010 ANGRA DOS REIS",0,8,53,2395,20,2476,"2010"
"3188","330015 APERIBE",0,1,1,110,4,116,"2010"
"3189","330020 ARARUAMA",6,16,81,1459,11,1573,"2010"
"3190","330022 AREAL",0,0,4,129,2,135,"2010"
"3191","330023 ARMACAO DOS BUZIOS",2,8,26,580,0,616,"2010"
"3192","330025 ARRAIAL DO CABO",0,2,9,249,77,337,"2010"
"3193","330030 BARRA DO PIRAI",3,10,40,973,0,1026,"2010"
"3194","330040 BARRA MANSA",2,15,68,2161,5,2251,"2010"
"3195","330045 BELFORD ROXO",12,38,141,6894,44,7129,"2010"
"3196","330050 BOM JARDIM",1,0,3,358,2,364,"2010"
"3197","330060 BOM JESUS DO ITABAPOANA",0,2,6,498,1,507,"2010"
"3198","330070 CABO FRIO",14,13,48,2603,28,2706,"2010"
"3199","330080 CACHOEIRAS DE MACACU",0,2,13,676,24,715,"2010"
"3200","330090 CAMBUCI",0,2,5,135,0,142,"2010"
"3201","330093 CARAPEBUS",0,2,3,113,2,120,"2010"
"3202","330095 COMENDADOR LEVY GASPARIAN",0,1,0,99,1,101,"2010"
"3203","330100 CAMPOS DOS GOYTACAZES",16,24,156,5726,960,6882,"2010"
"3204","330110 CANTAGALO",0,1,3,214,0,218,"2010"
"3205","330115 CARDOSO MOREIRA",1,3,3,122,13,142,"2010"
"3206","330120 CARMO",2,0,3,203,1,209,"2010"
"3207","330130 CASIMIRO DE ABREU",4,2,4,385,1,396,"2010"
"3208","330140 CONCEICAO DE MACABU",1,1,6,152,41,201,"2010"
"3209","330150 CORDEIRO",0,0,2,243,0,245,"2010"
"3210","330160 DUAS BARRAS",0,0,2,115,14,131,"2010"
"3211","330170 DUQUE DE CAXIAS",24,80,318,11987,102,12511,"2010"
"3212","330180 ENGENHEIRO PAULO DE FRONTIN",1,2,0,120,2,125,"2010"
"3213","330185 GUAPIMIRIM",1,3,18,642,8,672,"2010"
"3214","330187 IGUABA GRANDE",1,0,4,242,0,247,"2010"
"3215","330190 ITABORAI",6,13,63,3015,28,3125,"2010"
"3216","330200 ITAGUAI",1,10,33,1695,21,1760,"2010"
"3217","330205 ITALVA",0,0,10,151,0,161,"2010"
"3218","330210 ITAOCARA",0,2,5,260,3,270,"2010"
"3219","330220 ITAPERUNA",2,5,37,1125,0,1169,"2010"
"3220","330225 ITATIAIA",1,7,12,354,0,374,"2010"
"3221","330227 JAPERI",3,4,28,1522,4,1561,"2010"
"3222","330230 LAJE DO MURIAE",0,0,3,73,0,76,"2010"
"3223","330240 MACAE",10,27,74,3490,12,3613,"2010"
"3224","330245 MACUCO",0,0,0,127,0,127,"2010"
"3225","330250 MAGE",8,13,40,3190,2,3253,"2010"
"3226","330260 MANGARATIBA",4,7,26,448,2,487,"2010"
"3227","330270 MARICA",3,7,20,821,576,1427,"2010"
"3228","330280 MENDES",0,2,8,199,4,213,"2010"
"3229","330285 MESQUITA",5,9,54,2251,7,2326,"2010"
"3230","330290 MIGUEL PEREIRA",1,4,4,281,3,293,"2010"
"3231","330300 MIRACEMA",1,3,7,358,1,370,"2010"
"3232","330310 NATIVIDADE",1,3,8,178,0,190,"2010"
"3233","330320 NILOPOLIS",4,6,39,2020,5,2074,"2010"
"3234","330330 NITEROI",29,34,126,5763,14,5966,"2010"
"3235","330340 NOVA FRIBURGO",10,6,37,2303,17,2373,"2010"
"3236","330350 NOVA IGUACU",51,76,280,11143,47,11597,"2010"
"3237","330360 PARACAMBI",2,3,12,502,1,520,"2010"
"3238","330370 PARAIBA DO SUL",0,2,6,448,75,531,"2010"
"3239","330380 PARATY",4,1,6,573,3,587,"2010"
"3240","330385 PATY DO ALFERES",2,4,13,349,6,374,"2010"
"3241","330390 PETROPOLIS",34,29,107,3624,26,3820,"2010"
"3242","330395 PINHEIRAL",0,1,4,330,0,335,"2010"
"3243","330400 PIRAI",1,3,11,332,0,347,"2010"
"3244","330410 PORCIUNCULA",0,4,6,257,0,267,"2010"
"3245","330411 PORTO REAL",1,1,6,278,0,286,"2010"
"3246","330412 QUATIS",0,1,5,162,1,169,"2010"
"3247","330414 QUEIMADOS",9,4,29,2264,1,2307,"2010"
"3248","330415 QUISSAMA",2,2,14,293,5,316,"2010"
"3249","330420 RESENDE",3,5,48,1594,0,1650,"2010"
"3250","330430 RIO BONITO",1,0,11,711,6,729,"2010"
"3251","330440 RIO CLARO",0,0,5,214,1,220,"2010"
"3252","330450 RIO DAS FLORES",0,1,3,105,1,110,"2010"
"3253","330452 RIO DAS OSTRAS",6,17,44,1695,1,1763,"2010"
"3254","330455 RIO DE JANEIRO",159,444,1772,80348,500,83223,"2010"
"3255","330460 SANTA MARIA MADALENA",0,1,9,86,4,100,"2010"
"3256","330470 SANTO ANTONIO DE PADUA",0,2,4,404,55,465,"2010"
"3257","330475 SAO FRANCISCO DE ITABAPOANA",0,1,4,444,59,508,"2010"
"3258","330480 SAO FIDELIS",1,1,8,343,13,366,"2010"
"3259","330490 SAO GONCALO",49,53,258,10882,69,11311,"2010"
"3260","330500 SAO JOAO DA BARRA",1,1,7,223,187,419,"2010"
"3261","330510 SAO JOAO DE MERITI",24,33,135,6352,12,6556,"2010"
"3262","330513 SAO JOSE DE UBA",0,1,3,99,0,103,"2010"
"3263","330515 SAO JOSE DO VALE DO RIO PRETO",2,0,4,223,0,229,"2010"
"3264","330520 SAO PEDRO DA ALDEIA",5,8,5,1171,2,1191,"2010"
"3265","330530 SAO SEBASTIAO DO ALTO",1,0,3,112,0,116,"2010"
"3266","330540 SAPUCAIA",0,0,1,174,3,178,"2010"
"3267","330550 SAQUAREMA",0,4,5,395,439,843,"2010"
"3268","330555 SEROPEDICA",5,6,27,983,8,1029,"2010"
"3269","330560 SILVA JARDIM",1,3,4,305,3,316,"2010"
"3270","330570 SUMIDOURO",0,0,4,178,1,183,"2010"
"3271","330575 TANGUA",0,1,4,372,4,381,"2010"
"3272","330580 TERESOPOLIS",6,8,48,2134,4,2200,"2010"
"3273","330590 TRAJANO DE MORAES",0,0,1,80,0,81,"2010"
"3274","330600 TRES RIOS",3,4,14,1160,6,1187,"2010"
"3275","330610 VALENCA",1,5,23,917,4,950,"2010"
"3276","330615 VARRE-SAI",2,1,2,124,6,135,"2010"
"3277","330620 VASSOURAS",3,4,12,477,4,500,"2010"
"3278","330630 VOLTA REDONDA",6,18,55,3163,5,3247,"2010"
"3279","MUNICIPIO IGNORADO - SP",1,0,0,3,3,7,"2010"
"3280","350010 ADAMANTINA",0,1,8,375,0,384,"2010"
"3281","350020 ADOLFO",0,0,0,33,0,33,"2010"
"3282","350030 AGUAI",0,1,7,478,4,490,"2010"
"3283","350040 AGUAS DA PRATA",0,1,0,62,3,66,"2010"
"3284","350050 AGUAS DE LINDOIA",0,0,4,270,1,275,"2010"
"3285","350055 AGUAS DE SANTA BARBARA",0,0,1,78,0,79,"2010"
"3286","350060 AGUAS DE SAO PEDRO",0,0,0,27,0,27,"2010"
"3287","350070 AGUDOS",2,2,7,482,3,496,"2010"
"3288","350075 ALAMBARI",0,0,3,61,0,64,"2010"
"3289","350080 ALFREDO MARCONDES",0,0,0,37,0,37,"2010"
"3290","350090 ALTAIR",0,0,1,44,0,45,"2010"
"3291","350100 ALTINOPOLIS",0,1,8,180,2,191,"2010"
"3292","350110 ALTO ALEGRE",0,1,0,35,1,37,"2010"
"3293","350115 ALUMINIO",0,1,3,237,0,241,"2010"
"3294","350120 ALVARES FLORENCE",0,0,1,24,0,25,"2010"
"3295","350130 ALVARES MACHADO",1,0,3,319,0,323,"2010"
"3296","350140 ALVARO DE CARVALHO",0,0,1,42,0,43,"2010"
"3297","350150 ALVINLANDIA",0,1,0,46,0,47,"2010"
"3298","350160 AMERICANA",4,7,22,2566,1,2600,"2010"
"3299","350170 AMERICO BRASILIENSE",0,1,3,552,0,556,"2010"
"3300","350180 AMERICO DE CAMPOS",0,0,0,55,1,56,"2010"
"3301","350190 AMPARO",0,1,4,724,1,730,"2010"
"3302","350200 ANALANDIA",0,0,0,45,1,46,"2010"
"3303","350210 ANDRADINA",1,8,39,657,4,709,"2010"
"3304","350220 ANGATUBA",0,2,10,288,1,301,"2010"
"3305","350230 ANHEMBI",0,0,2,67,0,69,"2010"
"3306","350240 ANHUMAS",0,0,1,42,0,43,"2010"
"3307","350250 APARECIDA",2,3,5,505,0,515,"2010"
"3308","350260 APARECIDA D'OESTE",0,0,2,42,0,44,"2010"
"3309","350270 APIAI",0,3,9,345,2,359,"2010"
"3310","350275 ARACARIGUAMA",1,0,4,267,1,273,"2010"
"3311","350280 ARACATUBA",1,8,26,2060,105,2200,"2010"
"3312","350290 ARACOIABA DA SERRA",1,2,9,397,0,409,"2010"
"3313","350300 ARAMINA",0,0,1,80,1,82,"2010"
"3314","350310 ARANDU",1,1,1,67,0,70,"2010"
"3315","350315 ARAPEI",0,0,1,20,0,21,"2010"
"3316","350320 ARARAQUARA",6,7,21,2492,6,2532,"2010"
"3317","350330 ARARAS",4,11,25,1439,1,1480,"2010"
"3318","350335 ARCO-IRIS",0,0,0,12,0,12,"2010"
"3319","350340 AREALVA",2,1,0,85,1,89,"2010"
"3320","350350 AREIAS",0,0,1,48,0,49,"2010"
"3321","350360 AREIOPOLIS",0,2,5,146,0,153,"2010"
"3322","350370 ARIRANHA",0,1,2,104,4,111,"2010"
"3323","350380 ARTUR NOGUEIRA",3,2,8,555,4,572,"2010"
"3324","350390 ARUJA",2,5,36,1276,1,1320,"2010"
"3325","350395 ASPASIA",0,0,0,17,0,17,"2010"
"3326","350400 ASSIS",3,2,3,1228,10,1246,"2010"
"3327","350410 ATIBAIA",6,8,35,1895,8,1952,"2010"
"3328","350420 AURIFLAMA",0,0,3,144,4,151,"2010"
"3329","350430 AVAI",0,0,1,61,0,62,"2010"
"3330","350440 AVANHANDAVA",0,1,2,150,0,153,"2010"
"3331","350450 AVARE",2,5,14,1160,0,1181,"2010"
"3332","350460 BADY BASSITT",0,2,0,161,0,163,"2010"
"3333","350470 BALBINOS",0,0,1,11,0,12,"2010"
"3334","350480 BALSAMO",1,0,1,90,0,92,"2010"
"3335","350490 BANANAL",1,0,1,113,0,115,"2010"
"3336","350500 BARAO DE ANTONINA",0,0,0,35,0,35,"2010"
"3337","350510 BARBOSA",1,0,5,88,1,95,"2010"
"3338","350520 BARIRI",0,1,6,345,9,361,"2010"
"3339","350530 BARRA BONITA",1,1,8,357,0,367,"2010"
"3340","350535 BARRA DO CHAPEU",1,1,0,55,1,58,"2010"
"3341","350540 BARRA DO TURVO",0,1,1,100,13,115,"2010"
"3342","350550 BARRETOS",7,10,14,1367,1,1399,"2010"
"3343","350560 BARRINHA",1,0,3,475,3,482,"2010"
"3344","350570 BARUERI",13,11,51,5280,91,5446,"2010"
"3345","350580 BASTOS",0,1,5,256,0,262,"2010"
"3346","350590 BATATAIS",1,3,2,668,0,674,"2010"
"3347","350600 BAURU",7,14,33,4302,73,4429,"2010"
"3348","350610 BEBEDOURO",2,3,7,847,0,859,"2010"
"3349","350620 BENTO DE ABREU",0,0,3,38,1,42,"2010"
"3350","350630 BERNARDINO DE CAMPOS",0,0,0,142,0,142,"2010"
"3351","350635 BERTIOGA",2,7,29,914,5,957,"2010"
"3352","350640 BILAC",0,0,0,68,7,75,"2010"
"3353","350650 BIRIGUI",5,3,17,1237,18,1280,"2010"
"3354","350660 BIRITIBA-MIRIM",1,2,7,377,11,398,"2010"
"3355","350670 BOA ESPERANCA DO SUL",0,1,3,196,2,202,"2010"
"3356","350680 BOCAINA",0,0,0,152,12,164,"2010"
"3357","350690 BOFETE",1,1,4,119,0,125,"2010"
"3358","350700 BOITUVA",2,5,6,702,0,715,"2010"
"3359","350710 BOM JESUS DOS PERDOES",0,2,8,255,2,267,"2010"
"3360","350715 BOM SUCESSO DE ITARARE",2,2,2,49,1,56,"2010"
"3361","350720 BORA",0,0,0,5,0,5,"2010"
"3362","350730 BORACEIA",0,0,0,61,4,65,"2010"
"3363","350740 BORBOREMA",0,0,2,157,0,159,"2010"
"3364","350745 BOREBI",0,0,1,40,0,41,"2010"
"3365","350750 BOTUCATU",4,10,44,1577,9,1644,"2010"
"3366","350760 BRAGANCA PAULISTA",4,4,42,2001,2,2053,"2010"
"3367","350770 BRAUNA",0,0,3,44,1,48,"2010"
"3368","350775 BREJO ALEGRE",0,0,1,23,0,24,"2010"
"3369","350780 BRODOWSKI",0,0,4,247,1,252,"2010"
"3370","350790 BROTAS",2,4,6,277,0,289,"2010"
"3371","350800 BURI",0,3,14,323,2,342,"2010"
"3372","350810 BURITAMA",1,2,3,179,1,186,"2010"
"3373","350820 BURITIZAL",0,0,2,45,0,47,"2010"
"3374","350830 CABRALIA PAULISTA",0,0,0,55,0,55,"2010"
"3375","350840 CABREUVA",1,5,5,665,1,677,"2010"
"3376","350850 CACAPAVA",3,1,14,1297,0,1315,"2010"
"3377","350860 CACHOEIRA PAULISTA",0,2,3,387,2,394,"2010"
"3378","350870 CACONDE",1,1,5,189,0,196,"2010"
"3379","350880 CAFELANDIA",0,1,0,260,1,262,"2010"
"3380","350890 CAIABU",0,0,3,51,0,54,"2010"
"3381","350900 CAIEIRAS",3,2,32,1308,3,1348,"2010"
"3382","350910 CAIUA",0,0,0,47,0,47,"2010"
"3383","350920 CAJAMAR",1,1,16,1030,2,1050,"2010"
"3384","350925 CAJATI",0,0,7,445,18,470,"2010"
"3385","350930 CAJOBI",0,0,3,111,0,114,"2010"
"3386","350940 CAJURU",1,5,5,372,2,385,"2010"
"3387","350945 CAMPINA DO MONTE ALEGRE",0,0,5,78,0,83,"2010"
"3388","350950 CAMPINAS",55,58,191,14670,30,15004,"2010"
"3389","350960 CAMPO LIMPO PAULISTA",1,9,26,1071,7,1114,"2010"
"3390","350970 CAMPOS DO JORDAO",3,3,18,775,1,800,"2010"
"3391","350980 CAMPOS NOVOS PAULISTA",1,0,2,54,0,57,"2010"
"3392","350990 CANANEIA",0,0,5,175,13,193,"2010"
"3393","350995 CANAS",0,0,0,59,2,61,"2010"
"3394","351000 CANDIDO MOTA",0,0,3,350,1,354,"2010"
"3395","351010 CANDIDO RODRIGUES",0,0,1,22,0,23,"2010"
"3396","351015 CANITAR",0,1,0,66,0,67,"2010"
"3397","351020 CAPAO BONITO",2,2,8,715,0,727,"2010"
"3398","351030 CAPELA DO ALTO",0,1,3,235,1,240,"2010"
"3399","351040 CAPIVARI",1,2,3,695,6,707,"2010"
"3400","351050 CARAGUATATUBA",9,5,23,1458,5,1500,"2010"
"3401","351060 CARAPICUIBA",3,29,93,6594,39,6758,"2010"
"3402","351070 CARDOSO",1,0,2,122,0,125,"2010"
"3403","351080 CASA BRANCA",1,1,5,353,2,362,"2010"
"3404","351090 CASSIA DOS COQUEIROS",0,0,1,18,0,19,"2010"
"3405","351100 CASTILHO",0,2,11,218,3,234,"2010"
"3406","351110 CATANDUVA",0,2,8,1317,4,1331,"2010"
"3407","351120 CATIGUA",0,0,0,71,2,73,"2010"
"3408","351130 CEDRAL",0,0,0,87,1,88,"2010"
"3409","351140 CERQUEIRA CESAR",2,1,3,222,0,228,"2010"
"3410","351150 CERQUILHO",0,0,6,510,1,517,"2010"
"3411","351160 CESARIO LANGE",0,1,1,190,0,192,"2010"
"3412","351170 CHARQUEADA",0,1,4,214,2,221,"2010"
"3413","351190 CLEMENTINA",0,0,2,107,1,110,"2010"
"3414","351200 COLINA",0,1,3,215,1,220,"2010"
"3415","351210 COLOMBIA",0,1,2,89,2,94,"2010"
"3416","351220 CONCHAL",0,2,9,368,5,384,"2010"
"3417","351230 CONCHAS",0,1,5,240,1,247,"2010"
"3418","351240 CORDEIROPOLIS",0,1,4,290,3,298,"2010"
"3419","351250 COROADOS",0,0,1,44,1,46,"2010"
"3420","351260 CORONEL MACEDO",1,0,0,54,0,55,"2010"
"3421","351270 CORUMBATAI",0,0,0,47,2,49,"2010"
"3422","351280 COSMOPOLIS",1,3,31,840,3,878,"2010"
"3423","351290 COSMORAMA",0,0,0,71,0,71,"2010"
"3424","351300 COTIA",8,10,42,3628,17,3705,"2010"
"3425","351310 CRAVINHOS",0,1,7,410,1,419,"2010"
"3426","351320 CRISTAIS PAULISTA",0,1,1,92,0,94,"2010"
"3427","351330 CRUZALIA",0,0,1,26,0,27,"2010"
"3428","351340 CRUZEIRO",2,9,14,981,0,1006,"2010"
"3429","351350 CUBATAO",2,14,31,1814,2,1863,"2010"
"3430","351360 CUNHA",1,1,3,272,1,278,"2010"
"3431","351370 DESCALVADO",0,0,1,350,0,351,"2010"
"3432","351380 DIADEMA",22,29,105,6081,19,6256,"2010"
"3433","351385 DIRCE REIS",0,0,0,20,0,20,"2010"
"3434","351390 DIVINOLANDIA",0,0,3,120,0,123,"2010"
"3435","351400 DOBRADA",0,0,2,130,0,132,"2010"
"3436","351410 DOIS CORREGOS",1,0,7,392,0,400,"2010"
"3437","351420 DOLCINOPOLIS",0,0,0,25,0,25,"2010"
"3438","351430 DOURADO",0,0,0,87,1,88,"2010"
"3439","351440 DRACENA",1,1,8,484,1,495,"2010"
"3440","351450 DUARTINA",0,1,2,142,0,145,"2010"
"3441","351460 DUMONT",1,0,2,93,0,96,"2010"
"3442","351470 ECHAPORA",1,0,2,83,1,87,"2010"
"3443","351480 ELDORADO",1,0,4,211,16,232,"2010"
"3444","351490 ELIAS FAUSTO",0,0,2,206,2,210,"2010"
"3445","351492 ELISIARIO",0,0,0,24,0,24,"2010"
"3446","351495 EMBAUBA",0,0,0,28,0,28,"2010"
"3447","351500 EMBU DAS ARTES",10,20,70,4419,13,4532,"2010"
"3448","351510 EMBU-GUACU",5,8,6,900,1,920,"2010"
"3449","351512 EMILIANOPOLIS",0,0,0,26,0,26,"2010"
"3450","351515 ENGENHEIRO COELHO",0,0,9,230,8,247,"2010"
"3451","351518 ESPIRITO SANTO DO PINHAL",1,2,11,453,2,469,"2010"
"3452","351519 ESPIRITO SANTO DO TURVO",1,0,1,59,0,61,"2010"
"3453","351520 ESTRELA D'OESTE",0,0,1,92,0,93,"2010"
"3454","351530 ESTRELA DO NORTE",0,1,2,33,0,36,"2010"
"3455","351535 EUCLIDES DA CUNHA PAULISTA",0,1,1,127,0,129,"2010"
"3456","351540 FARTURA",0,0,1,198,0,199,"2010"
"3457","351550 FERNANDOPOLIS",1,5,10,674,3,693,"2010"
"3458","351560 FERNANDO PRESTES",0,0,1,49,0,50,"2010"
"3459","351565 FERNAO",0,0,1,12,0,13,"2010"
"3460","351570 FERRAZ DE VASCONCELOS",9,17,53,2765,17,2861,"2010"
"3461","351580 FLORA RICA",0,0,0,7,0,7,"2010"
"3462","351590 FLOREAL",0,0,0,24,0,24,"2010"
"3463","351600 FLORIDA PAULISTA",0,0,4,146,0,150,"2010"
"3464","351610 FLORINIA",0,0,1,40,0,41,"2010"
"3465","351620 FRANCA",14,17,49,4430,8,4518,"2010"
"3466","351630 FRANCISCO MORATO",5,14,64,2625,9,2717,"2010"
"3467","351640 FRANCO DA ROCHA",8,9,35,2096,17,2165,"2010"
"3468","351650 GABRIEL MONTEIRO",0,0,0,18,0,18,"2010"
"3469","351660 GALIA",0,1,2,66,0,69,"2010"
"3470","351670 GARCA",0,4,7,559,0,570,"2010"
"3471","351680 GASTAO VIDIGAL",0,0,0,60,0,60,"2010"
"3472","351685 GAVIAO PEIXOTO",0,0,1,62,1,64,"2010"
"3473","351690 GENERAL SALGADO",0,0,1,120,0,121,"2010"
"3474","351700 GETULINA",0,1,1,115,0,117,"2010"
"3475","351710 GLICERIO",0,0,1,50,0,51,"2010"
"3476","351720 GUAICARA",0,1,1,152,0,154,"2010"
"3477","351730 GUAIMBE",0,0,1,70,0,71,"2010"
"3478","351740 GUAIRA",0,1,5,438,0,444,"2010"
"3479","351750 GUAPIACU",0,1,1,212,0,214,"2010"
"3480","351760 GUAPIARA",1,0,12,259,0,272,"2010"
"3481","351770 GUARA",0,0,0,236,3,239,"2010"
"3482","351780 GUARACAI",0,0,4,97,0,101,"2010"
"3483","351790 GUARACI",0,0,1,131,0,132,"2010"
"3484","351800 GUARANI D'OESTE",0,0,0,19,0,19,"2010"
"3485","351810 GUARANTA",0,0,1,81,0,82,"2010"
"3486","351820 GUARARAPES",3,1,7,411,6,428,"2010"
"3487","351830 GUARAREMA",2,2,6,397,0,407,"2010"
"3488","351840 GUARATINGUETA",6,9,21,1421,2,1459,"2010"
"3489","351850 GUAREI",0,1,3,141,1,146,"2010"
"3490","351860 GUARIBA",2,1,5,531,0,539,"2010"
"3491","351870 GUARUJA",14,64,228,4027,195,4528,"2010"
"3492","351880 GUARULHOS",50,112,318,19901,82,20463,"2010"
"3493","351885 GUATAPARA",0,0,2,86,0,88,"2010"
"3494","351890 GUZOLANDIA",0,0,0,61,0,61,"2010"
"3495","351900 HERCULANDIA",0,0,0,120,0,120,"2010"
"3496","351905 HOLAMBRA",1,0,7,170,2,180,"2010"
"3497","351907 HORTOLANDIA",4,4,32,2687,16,2743,"2010"
"3498","351910 IACANGA",1,1,1,119,11,133,"2010"
"3499","351920 IACRI",2,0,2,75,0,79,"2010"
"3500","351925 IARAS",0,0,1,75,0,76,"2010"
"3501","351930 IBATE",0,4,2,480,0,486,"2010"
"3502","351940 IBIRA",0,1,1,133,0,135,"2010"
"3503","351950 IBIRAREMA",0,1,1,84,0,86,"2010"
"3504","351960 IBITINGA",1,4,9,687,3,704,"2010"
"3505","351970 IBIUNA",5,5,19,883,3,915,"2010"
"3506","351980 ICEM",0,0,2,109,0,111,"2010"
"3507","351990 IEPE",0,0,1,106,0,107,"2010"
"3508","352000 IGARACU DO TIETE",0,1,8,348,2,359,"2010"
"3509","352010 IGARAPAVA",1,3,4,355,7,370,"2010"
"3510","352020 IGARATA",0,0,3,117,1,121,"2010"
"3511","352030 IGUAPE",0,2,7,335,23,367,"2010"
"3512","352040 ILHABELA",0,2,8,477,0,487,"2010"
"3513","352042 ILHA COMPRIDA",0,1,1,110,7,119,"2010"
"3514","352044 ILHA SOLTEIRA",1,0,6,278,0,285,"2010"
"3515","352050 INDAIATUBA",7,7,22,2733,24,2793,"2010"
"3516","352060 INDIANA",0,0,1,60,0,61,"2010"
"3517","352070 INDIAPORA",0,2,1,49,0,52,"2010"
"3518","352080 INUBIA PAULISTA",0,0,0,45,0,45,"2010"
"3519","352090 IPAUSSU",0,0,3,181,3,187,"2010"
"3520","352100 IPERO",0,2,4,374,1,381,"2010"
"3521","352110 IPEUNA",0,0,2,75,0,77,"2010"
"3522","352115 IPIGUA",0,1,0,52,0,53,"2010"
"3523","352120 IPORANGA",0,0,1,52,3,56,"2010"
"3524","352130 IPUA",0,4,3,200,1,208,"2010"
"3525","352140 IRACEMAPOLIS",0,3,4,242,3,252,"2010"
"3526","352150 IRAPUA",1,0,0,75,1,77,"2010"
"3527","352160 IRAPURU",2,1,1,65,0,69,"2010"
"3528","352170 ITABERA",1,0,2,232,1,236,"2010"
"3529","352180 ITAI",1,5,4,315,0,325,"2010"
"3530","352190 ITAJOBI",0,1,0,140,0,141,"2010"
"3531","352200 ITAJU",0,0,0,28,1,29,"2010"
"3532","352210 ITANHAEM",6,6,14,1362,16,1404,"2010"
"3533","352215 ITAOCA",0,0,0,29,1,30,"2010"
"3534","352220 ITAPECERICA DA SERRA",4,10,53,2694,7,2768,"2010"
"3535","352230 ITAPETININGA",8,11,31,2043,7,2100,"2010"
"3536","352240 ITAPEVA",3,11,49,1324,6,1393,"2010"
"3537","352250 ITAPEVI",8,14,54,3742,14,3832,"2010"
"3538","352260 ITAPIRA",1,0,12,743,1,757,"2010"
"3539","352265 ITAPIRAPUA PAULISTA",0,1,1,39,1,42,"2010"
"3540","352270 ITAPOLIS",0,1,8,460,0,469,"2010"
"3541","352280 ITAPORANGA",0,0,1,218,0,219,"2010"
"3542","352290 ITAPUI",0,0,1,160,1,162,"2010"
"3543","352300 ITAPURA",0,0,0,49,1,50,"2010"
"3544","352310 ITAQUAQUECETUBA",7,25,85,5190,35,5342,"2010"
"3545","352320 ITARARE",2,2,17,591,1,613,"2010"
"3546","352330 ITARIRI",2,1,3,147,4,157,"2010"
"3547","352340 ITATIBA",1,5,7,1357,1,1371,"2010"
"3548","352350 ITATINGA",0,3,6,311,1,321,"2010"
"3549","352360 ITIRAPINA",2,0,1,171,1,175,"2010"
"3550","352370 ITIRAPUA",0,0,1,49,0,50,"2010"
"3551","352380 ITOBI",0,0,1,76,0,77,"2010"
"3552","352390 ITU",3,6,30,2283,12,2334,"2010"
"3553","352400 ITUPEVA",2,5,16,754,4,781,"2010"
"3554","352410 ITUVERAVA",0,2,4,500,3,509,"2010"
"3555","352420 JABORANDI",0,1,2,84,1,88,"2010"
"3556","352430 JABOTICABAL",2,0,6,831,1,840,"2010"
"3557","352440 JACAREI",5,19,38,3025,5,3092,"2010"
"3558","352450 JACI",0,0,0,54,0,54,"2010"
"3559","352460 JACUPIRANGA",0,0,5,221,11,237,"2010"
"3560","352470 JAGUARIUNA",3,2,7,655,1,668,"2010"
"3561","352480 JALES",0,0,7,515,0,522,"2010"
"3562","352490 JAMBEIRO",0,0,0,49,0,49,"2010"
"3563","352500 JANDIRA",1,6,26,1594,20,1647,"2010"
"3564","352510 JARDINOPOLIS",0,2,15,472,1,490,"2010"
"3565","352520 JARINU",1,2,8,345,0,356,"2010"
"3566","352530 JAU",3,2,17,1666,7,1695,"2010"
"3567","352540 JERIQUARA",0,0,0,43,1,44,"2010"
"3568","352550 JOANOPOLIS",0,0,1,125,2,128,"2010"
"3569","352560 JOAO RAMALHO",1,0,0,55,0,56,"2010"
"3570","352570 JOSE BONIFACIO",3,1,4,388,0,396,"2010"
"3571","352580 JULIO MESQUITA",1,1,0,60,1,63,"2010"
"3572","352585 JUMIRIM",0,0,0,23,0,23,"2010"
"3573","352590 JUNDIAI",9,24,95,5046,2,5176,"2010"
"3574","352600 JUNQUEIROPOLIS",3,0,1,221,1,226,"2010"
"3575","352610 JUQUIA",0,4,6,259,8,277,"2010"
"3576","352620 JUQUITIBA",1,1,9,452,2,465,"2010"
"3577","352630 LAGOINHA",0,0,1,44,1,46,"2010"
"3578","352640 LARANJAL PAULISTA",2,1,4,316,1,324,"2010"
"3579","352650 LAVINIA",0,1,2,50,1,54,"2010"
"3580","352660 LAVRINHAS",0,0,1,110,1,112,"2010"
"3581","352670 LEME",2,1,33,1284,0,1320,"2010"
"3582","352680 LENCOIS PAULISTA",1,9,19,777,3,809,"2010"
"3583","352690 LIMEIRA",4,15,50,3405,31,3505,"2010"
"3584","352700 LINDOIA",0,0,0,74,0,74,"2010"
"3585","352710 LINS",1,3,7,883,5,899,"2010"
"3586","352720 LORENA",3,3,8,1129,28,1171,"2010"
"3587","352725 LOURDES",0,0,0,20,0,20,"2010"
"3588","352730 LOUVEIRA",6,0,15,604,0,625,"2010"
"3589","352740 LUCELIA",0,1,2,225,0,228,"2010"
"3590","352750 LUCIANOPOLIS",0,0,1,18,1,20,"2010"
"3591","352760 LUIS ANTONIO",0,0,0,158,0,158,"2010"
"3592","352770 LUIZIANIA",0,1,0,68,0,69,"2010"
"3593","352780 LUPERCIO",0,0,1,61,0,62,"2010"
"3594","352790 LUTECIA",0,0,2,33,0,35,"2010"
"3595","352800 MACATUBA",0,2,4,234,3,243,"2010"
"3596","352810 MACAUBAL",0,0,1,46,0,47,"2010"
"3597","352820 MACEDONIA",0,0,0,34,0,34,"2010"
"3598","352830 MAGDA",0,0,0,46,0,46,"2010"
"3599","352840 MAIRINQUE",2,1,3,611,4,621,"2010"
"3600","352850 MAIRIPORA",1,7,18,1132,5,1163,"2010"
"3601","352860 MANDURI",0,2,0,105,0,107,"2010"
"3602","352870 MARABA PAULISTA",0,0,1,46,1,48,"2010"
"3603","352880 MARACAI",0,0,1,180,1,182,"2010"
"3604","352885 MARAPOAMA",0,0,2,31,0,33,"2010"
"3605","352890 MARIAPOLIS",0,0,0,53,0,53,"2010"
"3606","352900 MARILIA",3,11,43,2754,3,2814,"2010"
"3607","352910 MARINOPOLIS",0,1,0,20,0,21,"2010"
"3608","352920 MARTINOPOLIS",2,2,6,279,1,290,"2010"
"3609","352930 MATAO",0,11,10,927,1,949,"2010"
"3610","352940 MAUA",6,25,106,5614,36,5787,"2010"
"3611","352950 MENDONCA",0,0,1,33,0,34,"2010"
"3612","352960 MERIDIANO",0,0,1,28,0,29,"2010"
"3613","352965 MESOPOLIS",2,0,0,29,0,31,"2010"
"3614","352970 MIGUELOPOLIS",0,0,1,32,262,295,"2010"
"3615","352980 MINEIROS DO TIETE",0,0,3,172,0,175,"2010"
"3616","352990 MIRACATU",0,0,6,330,4,340,"2010"
"3617","353000 MIRA ESTRELA",0,0,0,29,0,29,"2010"
"3618","353010 MIRANDOPOLIS",0,0,11,329,1,341,"2010"
"3619","353020 MIRANTE DO PARANAPANEMA",1,1,5,174,3,184,"2010"
"3620","353030 MIRASSOL",0,1,6,612,0,619,"2010"
"3621","353040 MIRASSOLANDIA",0,0,0,56,0,56,"2010"
"3622","353050 MOCOCA",2,3,11,805,0,821,"2010"
"3623","353060 MOGI DAS CRUZES",8,31,92,5716,31,5878,"2010"
"3624","353070 MOGI GUACU",4,10,19,1798,4,1835,"2010"
"3625","353080 MOGI MIRIM",2,5,20,1122,9,1158,"2010"
"3626","353090 MOMBUCA",0,0,0,49,0,49,"2010"
"3627","353100 MONCOES",0,0,0,26,0,26,"2010"
"3628","353110 MONGAGUA",0,6,8,635,6,655,"2010"
"3629","353120 MONTE ALEGRE DO SUL",1,0,2,82,1,86,"2010"
"3630","353130 MONTE ALTO",1,2,4,520,2,529,"2010"
"3631","353140 MONTE APRAZIVEL",0,2,1,212,0,215,"2010"
"3632","353150 MONTE AZUL PAULISTA",0,3,1,236,0,240,"2010"
"3633","353160 MONTE CASTELO",0,0,1,35,0,36,"2010"
"3634","353170 MONTEIRO LOBATO",0,2,1,42,0,45,"2010"
"3635","353180 MONTE MOR",1,4,8,718,17,748,"2010"
"3636","353190 MORRO AGUDO",2,1,4,467,1,475,"2010"
"3637","353200 MORUNGABA",2,1,1,166,0,170,"2010"
"3638","353205 MOTUCA",0,0,0,42,0,42,"2010"
"3639","353210 MURUTINGA DO SUL",0,0,2,28,0,30,"2010"
"3640","353215 NANTES",0,0,0,43,0,43,"2010"
"3641","353220 NARANDIBA",0,0,1,71,0,72,"2010"
"3642","353230 NATIVIDADE DA SERRA",0,0,2,50,1,53,"2010"
"3643","353240 NAZARE PAULISTA",0,0,9,239,4,252,"2010"
"3644","353250 NEVES PAULISTA",0,0,1,73,0,74,"2010"
"3645","353260 NHANDEARA",0,0,1,91,0,92,"2010"
"3646","353270 NIPOA",1,0,1,58,0,60,"2010"
"3647","353280 NOVA ALIANCA",1,1,2,65,0,69,"2010"
"3648","353282 NOVA CAMPINA",1,1,4,105,1,112,"2010"
"3649","353284 NOVA CANAA PAULISTA",0,0,0,12,0,12,"2010"
"3650","353286 NOVA CASTILHO",0,0,0,7,0,7,"2010"
"3651","353290 NOVA EUROPA",0,1,1,120,0,122,"2010"
"3652","353300 NOVA GRANADA",0,1,2,240,0,243,"2010"
"3653","353310 NOVA GUATAPORANGA",0,0,0,19,0,19,"2010"
"3654","353320 NOVA INDEPENDENCIA",0,0,5,50,2,57,"2010"
"3655","353325 NOVAIS",0,0,1,75,0,76,"2010"
"3656","353330 NOVA LUZITANIA",0,0,1,35,0,36,"2010"
"3657","353340 NOVA ODESSA",0,0,3,605,4,612,"2010"
"3658","353350 NOVO HORIZONTE",0,0,3,452,0,455,"2010"
"3659","353360 NUPORANGA",0,0,1,82,1,84,"2010"
"3660","353370 OCAUCU",0,1,0,51,0,52,"2010"
"3661","353380 OLEO",1,0,0,33,0,34,"2010"
"3662","353390 OLIMPIA",1,3,17,607,0,628,"2010"
"3663","353400 ONDA VERDE",0,1,0,44,0,45,"2010"
"3664","353410 ORIENTE",0,1,0,70,0,71,"2010"
"3665","353420 ORINDIUVA",0,0,3,66,0,69,"2010"
"3666","353430 ORLANDIA",1,3,3,548,0,555,"2010"
"3667","353440 OSASCO",35,29,120,10266,30,10480,"2010"
"3668","353450 OSCAR BRESSANE",0,0,0,31,0,31,"2010"
"3669","353460 OSVALDO CRUZ",3,1,2,291,0,297,"2010"
"3670","353470 OURINHOS",2,3,10,1456,7,1478,"2010"
"3671","353475 OUROESTE",0,0,1,122,0,123,"2010"
"3672","353480 OURO VERDE",0,2,3,97,1,103,"2010"
"3673","353490 PACAEMBU",0,1,3,112,0,116,"2010"
"3674","353500 PALESTINA",0,0,0,121,0,121,"2010"
"3675","353510 PALMARES PAULISTA",0,0,3,139,0,142,"2010"
"3676","353520 PALMEIRA D'OESTE",0,1,2,85,0,88,"2010"
"3677","353530 PALMITAL",0,1,2,285,0,288,"2010"
"3678","353540 PANORAMA",0,0,6,185,0,191,"2010"
"3679","353550 PARAGUACU PAULISTA",1,1,2,577,3,584,"2010"
"3680","353560 PARAIBUNA",0,0,4,212,1,217,"2010"
"3681","353570 PARAISO",0,0,1,74,0,75,"2010"
"3682","353580 PARANAPANEMA",0,1,4,262,0,267,"2010"
"3683","353590 PARANAPUA",0,1,0,37,0,38,"2010"
"3684","353600 PARAPUA",0,1,2,98,0,101,"2010"
"3685","353610 PARDINHO",3,0,1,93,0,97,"2010"
"3686","353620 PARIQUERA-ACU",0,2,5,277,15,299,"2010"
"3687","353625 PARISI",0,0,0,18,0,18,"2010"
"3688","353630 PATROCINIO PAULISTA",2,0,12,195,0,209,"2010"
"3689","353640 PAULICEIA",0,1,1,79,0,81,"2010"
"3690","353650 PAULINIA",7,3,17,1301,5,1333,"2010"
"3691","353657 PAULISTANIA",0,0,0,13,0,13,"2010"
"3692","353660 PAULO DE FARIA",0,1,2,108,0,111,"2010"
"3693","353670 PEDERNEIRAS",1,1,10,536,3,551,"2010"
"3694","353680 PEDRA BELA",1,0,1,68,0,70,"2010"
"3695","353690 PEDRANOPOLIS",0,0,1,21,0,22,"2010"
"3696","353700 PEDREGULHO",0,1,0,235,1,237,"2010"
"3697","353710 PEDREIRA",1,2,6,512,3,524,"2010"
"3698","353715 PEDRINHAS PAULISTA",0,0,0,24,0,24,"2010"
"3699","353720 PEDRO DE TOLEDO",0,5,0,122,2,129,"2010"
"3700","353730 PENAPOLIS",2,1,31,677,7,718,"2010"
"3701","353740 PEREIRA BARRETO",0,4,12,314,2,332,"2010"
"3702","353750 PEREIRAS",0,1,2,76,0,79,"2010"
"3703","353760 PERUIBE",3,4,28,886,165,1086,"2010"
"3704","353770 PIACATU",0,0,2,55,3,60,"2010"
"3705","353780 PIEDADE",2,1,10,672,1,686,"2010"
"3706","353790 PILAR DO SUL",2,1,9,404,0,416,"2010"
"3707","353800 PINDAMONHANGABA",3,8,29,2122,9,2171,"2010"
"3708","353810 PINDORAMA",1,0,2,161,0,164,"2010"
"3709","353820 PINHALZINHO",0,0,3,131,1,135,"2010"
"3710","353830 PIQUEROBI",0,1,1,27,0,29,"2010"
"3711","353850 PIQUETE",0,0,1,138,7,146,"2010"
"3712","353860 PIRACAIA",0,1,2,325,4,332,"2010"
"3713","353870 PIRACICABA",8,11,46,4570,101,4736,"2010"
"3714","353880 PIRAJU",1,2,3,358,0,364,"2010"
"3715","353890 PIRAJUI",0,2,0,202,2,206,"2010"
"3716","353900 PIRANGI",0,0,1,104,1,106,"2010"
"3717","353910 PIRAPORA DO BOM JESUS",0,1,3,198,3,205,"2010"
"3718","353920 PIRAPOZINHO",3,0,8,324,0,335,"2010"
"3719","353930 PIRASSUNUNGA",0,4,5,839,6,854,"2010"
"3720","353940 PIRATININGA",0,1,1,141,1,144,"2010"
"3721","353950 PITANGUEIRAS",2,0,5,538,0,545,"2010"
"3722","353960 PLANALTO",0,1,1,78,0,80,"2010"
"3723","353970 PLATINA",0,0,3,46,2,51,"2010"
"3724","353980 POA",5,11,30,1652,7,1705,"2010"
"3725","353990 POLONI",0,0,0,63,0,63,"2010"
"3726","354000 POMPEIA",0,1,1,235,0,237,"2010"
"3727","354010 PONGAI",0,0,2,28,0,30,"2010"
"3728","354020 PONTAL",2,1,6,658,0,667,"2010"
"3729","354025 PONTALINDA",0,0,0,62,0,62,"2010"
"3730","354030 PONTES GESTAL",0,0,0,31,0,31,"2010"
"3731","354040 POPULINA",0,0,0,42,0,42,"2010"
"3732","354050 PORANGABA",0,1,3,77,2,83,"2010"
"3733","354060 PORTO FELIZ",0,1,1,654,0,656,"2010"
"3734","354070 PORTO FERREIRA",4,1,4,673,2,684,"2010"
"3735","354075 POTIM",1,0,2,254,0,257,"2010"
"3736","354080 POTIRENDABA",0,0,1,179,1,181,"2010"
"3737","354085 PRACINHA",0,0,0,11,0,11,"2010"
"3738","354090 PRADOPOLIS",0,0,3,259,0,262,"2010"
"3739","354100 PRAIA GRANDE",5,23,71,3814,15,3928,"2010"
"3740","354105 PRATANIA",0,0,2,68,0,70,"2010"
"3741","354110 PRESIDENTE ALVES",0,0,0,46,0,46,"2010"
"3742","354120 PRESIDENTE BERNARDES",0,1,1,133,2,137,"2010"
"3743","354130 PRESIDENTE EPITACIO",3,3,6,540,1,553,"2010"
"3744","354140 PRESIDENTE PRUDENTE",9,12,35,2599,10,2665,"2010"
"3745","354150 PRESIDENTE VENCESLAU",0,6,13,404,3,426,"2010"
"3746","354160 PROMISSAO",0,2,6,523,0,531,"2010"
"3747","354165 QUADRA",0,0,1,28,0,29,"2010"
"3748","354170 QUATA",0,0,3,191,1,195,"2010"
"3749","354180 QUEIROZ",0,0,0,33,0,33,"2010"
"3750","354190 QUELUZ",0,0,4,125,0,129,"2010"
"3751","354200 QUINTANA",0,0,1,62,0,63,"2010"
"3752","354210 RAFARD",0,0,5,128,0,133,"2010"
"3753","354220 RANCHARIA",1,1,10,358,0,370,"2010"
"3754","354230 REDENCAO DA SERRA",1,0,2,38,2,43,"2010"
"3755","354240 REGENTE FEIJO",1,1,1,215,0,218,"2010"
"3756","354250 REGINOPOLIS",0,0,1,43,1,45,"2010"
"3757","354260 REGISTRO",1,1,4,801,7,814,"2010"
"3758","354270 RESTINGA",0,0,1,111,2,114,"2010"
"3759","354280 RIBEIRA",0,0,0,36,0,36,"2010"
"3760","354290 RIBEIRAO BONITO",1,1,0,193,0,195,"2010"
"3761","354300 RIBEIRAO BRANCO",0,3,8,180,70,261,"2010"
"3762","354310 RIBEIRAO CORRENTE",0,0,0,66,0,66,"2010"
"3763","354320 RIBEIRAO DO SUL",0,0,0,35,0,35,"2010"
"3764","354323 RIBEIRAO DOS INDIOS",0,0,0,22,0,22,"2010"
"3765","354325 RIBEIRAO GRANDE",0,0,1,99,0,100,"2010"
"3766","354330 RIBEIRAO PIRES",1,4,13,1388,3,1409,"2010"
"3767","354340 RIBEIRAO PRETO",16,31,93,7969,32,8141,"2010"
"3768","354350 RIVERSUL",0,0,2,81,0,83,"2010"
"3769","354360 RIFAINA",0,2,1,23,0,26,"2010"
"3770","354370 RINCAO",0,1,1,132,0,134,"2010"
"3771","354380 RINOPOLIS",0,0,3,108,1,112,"2010"
"3772","354390 RIO CLARO",5,7,19,2286,13,2330,"2010"
"3773","354400 RIO DAS PEDRAS",1,1,2,382,1,387,"2010"
"3774","354410 RIO GRANDE DA SERRA",0,0,7,596,4,607,"2010"
"3775","354420 RIOLANDIA",0,0,1,137,1,139,"2010"
"3776","354425 ROSANA",0,0,8,234,0,242,"2010"
"3777","354430 ROSEIRA",0,1,2,119,1,123,"2010"
"3778","354440 RUBIACEA",0,0,1,27,1,29,"2010"
"3779","354450 RUBINEIA",0,0,0,26,0,26,"2010"
"3780","354460 SABINO",0,0,0,74,0,74,"2010"
"3781","354470 SAGRES",1,0,0,26,0,27,"2010"
"3782","354480 SALES",0,0,0,76,1,77,"2010"
"3783","354490 SALES OLIVEIRA",0,0,1,109,0,110,"2010"
"3784","354500 SALESOPOLIS",0,0,5,238,0,243,"2010"
"3785","354510 SALMOURAO",1,0,0,51,0,52,"2010"
"3786","354515 SALTINHO",0,0,0,65,0,65,"2010"
"3787","354520 SALTO",1,5,20,1365,5,1396,"2010"
"3788","354530 SALTO DE PIRAPORA",0,3,18,566,1,588,"2010"
"3789","354540 SALTO GRANDE",0,0,1,126,0,127,"2010"
"3790","354550 SANDOVALINA",0,0,1,64,1,66,"2010"
"3791","354560 SANTA ADELIA",0,0,4,155,0,159,"2010"
"3792","354570 SANTA ALBERTINA",0,0,0,48,3,51,"2010"
"3793","354580 SANTA BARBARA D'OESTE",4,8,37,2202,8,2259,"2010"
"3794","354600 SANTA BRANCA",0,0,3,176,1,180,"2010"
"3795","354610 SANTA CLARA D'OESTE",0,0,0,21,0,21,"2010"
"3796","354620 SANTA CRUZ DA CONCEICAO",0,0,1,29,0,30,"2010"
"3797","354625 SANTA CRUZ DA ESPERANCA",0,0,0,21,1,22,"2010"
"3798","354630 SANTA CRUZ DAS PALMEIRAS",0,0,8,417,1,426,"2010"
"3799","354640 SANTA CRUZ DO RIO PARDO",1,3,7,595,0,606,"2010"
"3800","354650 SANTA ERNESTINA",1,0,2,62,0,65,"2010"
"3801","354660 SANTA FE DO SUL",0,1,2,310,0,313,"2010"
"3802","354670 SANTA GERTRUDES",1,2,2,299,1,305,"2010"
"3803","354680 SANTA ISABEL",1,5,21,715,2,744,"2010"
"3804","354690 SANTA LUCIA",0,0,1,127,1,129,"2010"
"3805","354700 SANTA MARIA DA SERRA",0,1,2,72,2,77,"2010"
"3806","354710 SANTA MERCEDES",0,0,0,32,0,32,"2010"
"3807","354720 SANTANA DA PONTE PENSA",0,0,0,14,0,14,"2010"
"3808","354730 SANTANA DE PARNAIBA",2,7,14,1725,9,1757,"2010"
"3809","354740 SANTA RITA D'OESTE",0,0,0,18,0,18,"2010"
"3810","354750 SANTA RITA DO PASSA QUATRO",1,6,5,260,18,290,"2010"
"3811","354760 SANTA ROSA DE VITERBO",1,0,5,278,0,284,"2010"
"3812","354765 SANTA SALETE",0,0,0,14,0,14,"2010"
"3813","354770 SANTO ANASTACIO",0,1,7,236,0,244,"2010"
"3814","354780 SANTO ANDRE",34,28,116,9056,19,9253,"2010"
"3815","354790 SANTO ANTONIO DA ALEGRIA",0,0,0,64,0,64,"2010"
"3816","354800 SANTO ANTONIO DE POSSE",0,1,1,253,1,256,"2010"
"3817","354805 SANTO ANTONIO DO ARACANGUA",1,0,0,117,3,121,"2010"
"3818","354810 SANTO ANTONIO DO JARDIM",0,1,2,56,0,59,"2010"
"3819","354820 SANTO ANTONIO DO PINHAL",0,0,3,81,0,84,"2010"
"3820","354830 SANTO EXPEDITO",0,0,0,29,0,29,"2010"
"3821","354840 SANTOPOLIS DO AGUAPEI",0,0,1,56,0,57,"2010"
"3822","354850 SANTOS",18,30,91,4760,9,4908,"2010"
"3823","354860 SAO BENTO DO SAPUCAI",1,1,0,133,0,135,"2010"
"3824","354870 SAO BERNARDO DO CAMPO",28,54,163,10621,24,10890,"2010"
"3825","354880 SAO CAETANO DO SUL",2,2,19,1614,1,1638,"2010"
"3826","354890 SAO CARLOS",9,6,17,2796,3,2831,"2010"
"3827","354900 SAO FRANCISCO",0,0,1,33,0,34,"2010"
"3828","354910 SAO JOAO DA BOA VISTA",5,1,8,898,28,940,"2010"
"3829","354920 SAO JOAO DAS DUAS PONTES",0,1,0,22,0,23,"2010"
"3830","354925 SAO JOAO DE IRACEMA",0,0,1,20,0,21,"2010"
"3831","354930 SAO JOAO DO PAU D'ALHO",0,0,1,15,0,16,"2010"
"3832","354940 SAO JOAQUIM DA BARRA",3,3,12,613,1,632,"2010"
"3833","354950 SAO JOSE DA BELA VISTA",0,1,1,109,0,111,"2010"
"3834","354960 SAO JOSE DO BARREIRO",0,0,1,52,1,54,"2010"
"3835","354970 SAO JOSE DO RIO PARDO",2,3,13,634,0,652,"2010"
"3836","354980 SAO JOSE DO RIO PRETO",4,13,39,5169,3,5228,"2010"
"3837","354990 SAO JOSE DOS CAMPOS",17,19,126,9449,26,9637,"2010"
"3838","354995 SAO LOURENCO DA SERRA",1,1,2,191,2,197,"2010"
"3839","355000 SAO LUIS DO PARAITINGA",0,0,4,121,3,128,"2010"
"3840","355010 SAO MANUEL",0,3,14,506,0,523,"2010"
"3841","355020 SAO MIGUEL ARCANJO",0,4,8,430,1,443,"2010"
"3842","355030 SAO PAULO",489,718,2433,170107,518,174265,"2010"
"3843","355040 SAO PEDRO",0,3,5,367,0,375,"2010"
"3844","355050 SAO PEDRO DO TURVO",0,1,2,86,0,89,"2010"
"3845","355060 SAO ROQUE",4,4,10,1095,2,1115,"2010"
"3846","355070 SAO SEBASTIAO",1,7,16,1228,9,1261,"2010"
"3847","355080 SAO SEBASTIAO DA GRAMA",0,0,0,141,0,141,"2010"
"3848","355090 SAO SIMAO",0,1,3,170,1,175,"2010"
"3849","355100 SAO VICENTE",17,37,149,4801,27,5031,"2010"
"3850","355110 SARAPUI",0,0,0,121,0,121,"2010"
"3851","355120 SARUTAIA",0,0,0,51,0,51,"2010"
"3852","355130 SEBASTIANOPOLIS DO SUL",0,0,0,30,0,30,"2010"
"3853","355140 SERRA AZUL",0,1,1,122,1,125,"2010"
"3854","355150 SERRANA",1,7,8,604,0,620,"2010"
"3855","355160 SERRA NEGRA",0,0,2,262,21,285,"2010"
"3856","355170 SERTAOZINHO",2,1,11,1597,3,1614,"2010"
"3857","355180 SETE BARRAS",0,0,1,201,3,205,"2010"
"3858","355190 SEVERINIA",1,1,6,193,0,201,"2010"
"3859","355200 SILVEIRAS",1,0,0,53,0,54,"2010"
"3860","355210 SOCORRO",4,2,0,424,1,431,"2010"
"3861","355220 SOROCABA",15,38,168,8086,16,8323,"2010"
"3862","355230 SUD MENNUCCI",0,0,1,105,2,108,"2010"
"3863","355240 SUMARE",8,14,39,3611,62,3734,"2010"
"3864","355250 SUZANO",13,26,97,4050,21,4207,"2010"
"3865","355255 SUZANAPOLIS",0,0,0,55,0,55,"2010"
"3866","355260 TABAPUA",2,0,0,115,0,117,"2010"
"3867","355270 TABATINGA",0,0,2,176,0,178,"2010"
"3868","355280 TABOAO DA SERRA",17,24,55,4406,10,4512,"2010"
"3869","355290 TACIBA",0,1,0,61,0,62,"2010"
"3870","355300 TAGUAI",1,1,4,179,1,186,"2010"
"3871","355310 TAIACU",0,1,1,60,0,62,"2010"
"3872","355320 TAIUVA",0,1,1,39,0,41,"2010"
"3873","355330 TAMBAU",2,0,3,284,8,297,"2010"
"3874","355340 TANABI",0,4,4,281,0,289,"2010"
"3875","355350 TAPIRAI",1,2,4,101,1,109,"2010"
"3876","355360 TAPIRATIBA",0,0,3,138,0,141,"2010"
"3877","355365 TAQUARAL",0,0,1,34,0,35,"2010"
"3878","355370 TAQUARITINGA",0,4,5,649,1,659,"2010"
"3879","355380 TAQUARITUBA",0,3,9,318,0,330,"2010"
"3880","355385 TAQUARIVAI",0,1,2,71,0,74,"2010"
"3881","355390 TARABAI",0,0,5,75,0,80,"2010"
"3882","355395 TARUMA",1,0,0,202,2,205,"2010"
"3883","355400 TATUI",2,5,17,1622,4,1650,"2010"
"3884","355410 TAUBATE",4,14,41,3696,37,3792,"2010"
"3885","355420 TEJUPA",0,0,2,72,0,74,"2010"
"3886","355430 TEODORO SAMPAIO",1,0,10,293,0,304,"2010"
"3887","355440 TERRA ROXA",0,0,2,46,51,99,"2010"
"3888","355450 TIETE",0,1,10,477,0,488,"2010"
"3889","355460 TIMBURI",0,0,0,25,0,25,"2010"
"3890","355465 TORRE DE PEDRA",0,0,2,18,0,20,"2010"
"3891","355470 TORRINHA",0,0,1,95,0,96,"2010"
"3892","355475 TRABIJU",0,0,0,22,0,22,"2010"
"3893","355480 TREMEMBE",0,2,4,540,9,555,"2010"
"3894","355490 TRES FRONTEIRAS",0,0,1,71,0,72,"2010"
"3895","355495 TUIUTI",0,0,0,62,1,63,"2010"
"3896","355500 TUPA",2,0,10,666,0,678,"2010"
"3897","355510 TUPI PAULISTA",0,1,2,122,0,125,"2010"
"3898","355520 TURIUBA",0,0,0,17,0,17,"2010"
"3899","355530 TURMALINA",0,0,1,10,0,11,"2010"
"3900","355535 UBARANA",0,2,4,68,0,74,"2010"
"3901","355540 UBATUBA",2,3,18,1077,7,1107,"2010"
"3902","355550 UBIRAJARA",0,2,1,68,0,71,"2010"
"3903","355560 UCHOA",0,0,1,94,0,95,"2010"
"3904","355570 UNIAO PAULISTA",0,1,0,22,0,23,"2010"
"3905","355580 URANIA",0,1,1,78,0,80,"2010"
"3906","355590 URU",0,0,0,17,0,17,"2010"
"3907","355600 URUPES",0,1,0,157,0,158,"2010"
"3908","355610 VALENTIM GENTIL",0,0,2,130,1,133,"2010"
"3909","355620 VALINHOS",8,8,18,1274,2,1310,"2010"
"3910","355630 VALPARAISO",0,1,4,285,8,298,"2010"
"3911","355635 VARGEM",0,0,2,90,1,93,"2010"
"3912","355640 VARGEM GRANDE DO SUL",0,3,3,536,0,542,"2010"
"3913","355645 VARGEM GRANDE PAULISTA",2,3,11,669,4,689,"2010"
"3914","355650 VARZEA PAULISTA",3,10,45,1690,1,1749,"2010"
"3915","355660 VERA CRUZ",0,0,2,111,0,113,"2010"
"3916","355670 VINHEDO",1,6,5,903,0,915,"2010"
"3917","355680 VIRADOURO",0,0,2,222,1,225,"2010"
"3918","355690 VISTA ALEGRE DO ALTO",0,0,0,76,0,76,"2010"
"3919","355695 VITORIA BRASIL",0,0,0,18,1,19,"2010"
"3920","355700 VOTORANTIM",3,7,28,1608,0,1646,"2010"
"3921","355710 VOTUPORANGA",3,1,4,996,6,1010,"2010"
"3922","355715 ZACARIAS",0,0,0,25,0,25,"2010"
"3923","355720 CHAVANTES",0,2,3,181,0,186,"2010"
"3924","355730 ESTIVA GERBI",0,1,6,122,1,130,"2010"
"3925","MUNICIPIO IGNORADO - PR",0,0,0,2,0,2,"2010"
"3926","410010 ABATIA",0,0,0,80,0,80,"2010"
"3927","410020 ADRIANOPOLIS",0,0,3,66,2,71,"2010"
"3928","410030 AGUDOS DO SUL",0,1,3,105,1,110,"2010"
"3929","410040 ALMIRANTE TAMANDARE",6,10,24,1794,12,1846,"2010"
"3930","410045 ALTAMIRA DO PARANA",0,0,1,60,0,61,"2010"
"3931","410050 ALTONIA",3,1,6,251,0,261,"2010"
"3932","410060 ALTO PARANA",1,0,2,193,0,196,"2010"
"3933","410070 ALTO PIQUIRI",1,0,5,151,0,157,"2010"
"3934","410080 ALVORADA DO SUL",0,1,0,98,0,99,"2010"
"3935","410090 AMAPORA",0,0,3,104,0,107,"2010"
"3936","410100 AMPERE",2,3,4,223,0,232,"2010"
"3937","410105 ANAHY",0,0,3,40,0,43,"2010"
"3938","410110 ANDIRA",0,0,3,268,0,271,"2010"
"3939","410115 ANGULO",0,0,0,32,0,32,"2010"
"3940","410120 ANTONINA",0,1,3,286,0,290,"2010"
"3941","410130 ANTONIO OLINTO",1,0,0,69,0,70,"2010"
"3942","410140 APUCARANA",13,8,23,1613,1,1658,"2010"
"3943","410150 ARAPONGAS",5,12,25,1458,0,1500,"2010"
"3944","410160 ARAPOTI",2,3,9,406,1,421,"2010"
"3945","410165 ARAPUA",0,0,0,57,0,57,"2010"
"3946","410170 ARARUNA",0,1,0,164,0,165,"2010"
"3947","410180 ARAUCARIA",7,5,29,2045,3,2089,"2010"
"3948","410185 ARIRANHA DO IVAI",0,0,0,43,0,43,"2010"
"3949","410190 ASSAI",0,1,4,224,0,229,"2010"
"3950","410200 ASSIS CHATEAUBRIAND",2,2,6,379,0,389,"2010"
"3951","410210 ASTORGA",2,2,1,316,0,321,"2010"
"3952","410220 ATALAIA",1,0,0,39,0,40,"2010"
"3953","410230 BALSA NOVA",0,1,1,173,0,175,"2010"
"3954","410240 BANDEIRANTES",3,1,1,442,0,447,"2010"
"3955","410250 BARBOSA FERRAZ",0,0,3,127,0,130,"2010"
"3956","410260 BARRACAO",1,1,0,131,2,135,"2010"
"3957","410270 BARRA DO JACARE",0,0,2,21,0,23,"2010"
"3958","410275 BELA VISTA DA CAROBA",1,0,1,45,0,47,"2010"
"3959","410280 BELA VISTA DO PARAISO",1,0,2,208,0,211,"2010"
"3960","410290 BITURUNA",1,0,1,235,0,237,"2010"
"3961","410300 BOA ESPERANCA",0,0,0,46,0,46,"2010"
"3962","410302 BOA ESPERANCA DO IGUACU",1,0,0,27,0,28,"2010"
"3963","410304 BOA VENTURA DE SAO ROQUE",0,2,0,85,1,88,"2010"
"3964","410305 BOA VISTA DA APARECIDA",0,0,3,110,0,113,"2010"
"3965","410310 BOCAIUVA DO SUL",1,1,3,136,4,145,"2010"
"3966","410315 BOM JESUS DO SUL",0,0,0,46,1,47,"2010"
"3967","410320 BOM SUCESSO",0,0,6,96,0,102,"2010"
"3968","410322 BOM SUCESSO DO SUL",0,0,0,31,0,31,"2010"
"3969","410330 BORRAZOPOLIS",0,2,1,109,0,112,"2010"
"3970","410335 BRAGANEY",0,1,2,78,0,81,"2010"
"3971","410337 BRASILANDIA DO SUL",0,1,2,40,0,43,"2010"
"3972","410340 CAFEARA",0,0,1,36,0,37,"2010"
"3973","410345 CAFELANDIA",0,0,3,206,0,209,"2010"
"3974","410347 CAFEZAL DO SUL",0,0,3,44,0,47,"2010"
"3975","410350 CALIFORNIA",2,0,2,112,0,116,"2010"
"3976","410360 CAMBARA",0,0,3,268,0,271,"2010"
"3977","410370 CAMBE",1,6,15,1180,0,1202,"2010"
"3978","410380 CAMBIRA",0,0,0,65,0,65,"2010"
"3979","410390 CAMPINA DA LAGOA",0,1,3,242,0,246,"2010"
"3980","410395 CAMPINA DO SIMAO",0,0,1,60,0,61,"2010"
"3981","410400 CAMPINA GRANDE DO SUL",2,4,11,728,2,747,"2010"
"3982","410405 CAMPO BONITO",0,0,1,39,0,40,"2010"
"3983","410410 CAMPO DO TENENTE",1,0,0,97,0,98,"2010"
"3984","410420 CAMPO LARGO",1,7,37,1647,5,1697,"2010"
"3985","410425 CAMPO MAGRO",0,2,5,386,5,398,"2010"
"3986","410430 CAMPO MOURAO",5,6,21,1213,1,1246,"2010"
"3987","410440 CANDIDO DE ABREU",0,1,0,225,3,229,"2010"
"3988","410442 CANDOI",1,0,4,247,0,252,"2010"
"3989","410445 CANTAGALO",2,3,3,178,1,187,"2010"
"3990","410450 CAPANEMA",0,0,0,245,0,245,"2010"
"3991","410460 CAPITAO LEONIDAS MARQUES",1,0,3,185,0,189,"2010"
"3992","410465 CARAMBEI",0,1,9,342,0,352,"2010"
"3993","410470 CARLOPOLIS",0,2,0,163,0,165,"2010"
"3994","410480 CASCAVEL",7,10,76,4303,10,4406,"2010"
"3995","410490 CASTRO",4,6,18,1248,7,1283,"2010"
"3996","410500 CATANDUVAS",0,0,5,108,0,113,"2010"
"3997","410510 CENTENARIO DO SUL",0,0,4,135,0,139,"2010"
"3998","410520 CERRO AZUL",0,3,3,189,1,196,"2010"
"3999","410530 CEU AZUL",0,0,2,119,0,121,"2010"
"4000","410540 CHOPINZINHO",1,2,2,278,1,284,"2010"
"4001","410550 CIANORTE",0,1,7,944,0,952,"2010"
"4002","410560 CIDADE GAUCHA",0,0,1,166,0,167,"2010"
"4003","410570 CLEVELANDIA",1,2,5,251,1,260,"2010"
"4004","410580 COLOMBO",8,14,43,3608,8,3681,"2010"
"4005","410590 COLORADO",1,0,14,233,0,248,"2010"
"4006","410600 CONGONHINHAS",0,1,1,117,0,119,"2010"
"4007","410610 CONSELHEIRO MAIRINCK",0,0,3,52,0,55,"2010"
"4008","410620 CONTENDA",0,0,4,196,0,200,"2010"
"4009","410630 CORBELIA",0,0,8,202,0,210,"2010"
"4010","410640 CORNELIO PROCOPIO",1,0,5,549,0,555,"2010"
"4011","410645 CORONEL DOMINGOS SOARES",0,1,1,134,2,138,"2010"
"4012","410650 CORONEL VIVIDA",0,2,4,278,0,284,"2010"
"4013","410655 CORUMBATAI DO SUL",0,0,0,43,0,43,"2010"
"4014","410657 CRUZEIRO DO IGUACU",0,1,0,51,0,52,"2010"
"4015","410660 CRUZEIRO DO OESTE",1,2,2,231,0,236,"2010"
"4016","410670 CRUZEIRO DO SUL",1,0,1,80,0,82,"2010"
"4017","410680 CRUZ MACHADO",1,0,2,219,1,223,"2010"
"4018","410685 CRUZMALTINA",0,1,0,34,0,35,"2010"
"4019","410690 CURITIBA",42,126,364,24753,60,25345,"2010"
"4020","410700 CURIUVA",2,0,1,201,0,204,"2010"
"4021","410710 DIAMANTE DO NORTE",0,0,3,68,0,71,"2010"
"4022","410712 DIAMANTE DO SUL",1,0,0,39,0,40,"2010"
"4023","410715 DIAMANTE D'OESTE",0,0,0,79,1,80,"2010"
"4024","410720 DOIS VIZINHOS",1,1,3,499,0,504,"2010"
"4025","410725 DOURADINA",0,0,0,101,0,101,"2010"
"4026","410730 DOUTOR CAMARGO",0,1,1,58,0,60,"2010"
"4027","410740 ENEAS MARQUES",0,0,2,78,0,80,"2010"
"4028","410750 ENGENHEIRO BELTRAO",1,0,5,163,0,169,"2010"
"4029","410752 ESPERANCA NOVA",0,0,0,26,0,26,"2010"
"4030","410753 ENTRE RIOS DO OESTE",0,0,3,40,0,43,"2010"
"4031","410754 ESPIGAO ALTO DO IGUACU",0,0,3,70,0,73,"2010"
"4032","410755 FAROL",0,0,0,40,0,40,"2010"
"4033","410760 FAXINAL",0,1,11,258,0,270,"2010"
"4034","410765 FAZENDA RIO GRANDE",5,9,24,1456,0,1494,"2010"
"4035","410770 FENIX",0,0,2,58,0,60,"2010"
"4036","410773 FERNANDES PINHEIRO",0,0,1,92,0,93,"2010"
"4037","410775 FIGUEIRA",0,1,1,115,0,117,"2010"
"4038","410780 FLORAI",0,0,0,48,0,48,"2010"
"4039","410785 FLOR DA SERRA DO SUL",0,0,1,59,0,60,"2010"
"4040","410790 FLORESTA",0,3,0,88,0,91,"2010"
"4041","410800 FLORESTOPOLIS",0,1,3,145,0,149,"2010"
"4042","410810 FLORIDA",0,1,0,23,0,24,"2010"
"4043","410820 FORMOSA DO OESTE",0,0,1,70,0,71,"2010"
"4044","410830 FOZ DO IGUACU",9,8,54,4218,18,4307,"2010"
"4045","410832 FRANCISCO ALVES",0,1,6,88,0,95,"2010"
"4046","410840 FRANCISCO BELTRAO",6,3,8,1184,1,1202,"2010"
"4047","410845 FOZ DO JORDAO",0,0,4,89,1,94,"2010"
"4048","410850 GENERAL CARNEIRO",0,1,5,189,0,195,"2010"
"4049","410855 GODOY MOREIRA",0,0,0,49,0,49,"2010"
"4050","410860 GOIOERE",3,0,4,357,0,364,"2010"
"4051","410865 GOIOXIM",0,2,1,123,0,126,"2010"
"4052","410870 GRANDES RIOS",0,1,2,86,0,89,"2010"
"4053","410880 GUAIRA",1,1,6,469,3,480,"2010"
"4054","410890 GUAIRACA",0,1,3,89,0,93,"2010"
"4055","410895 GUAMIRANGA",0,0,2,103,2,107,"2010"
"4056","410900 GUAPIRAMA",0,0,2,48,1,51,"2010"
"4057","410910 GUAPOREMA",0,0,0,20,0,20,"2010"
"4058","410920 GUARACI",0,0,1,73,0,74,"2010"
"4059","410930 GUARANIACU",0,0,3,190,0,193,"2010"
"4060","410940 GUARAPUAVA",9,16,33,2678,5,2741,"2010"
"4061","410950 GUARAQUECABA",0,1,5,106,3,115,"2010"
"4062","410960 GUARATUBA",2,5,6,438,1,452,"2010"
"4063","410965 HONORIO SERPA",1,0,2,86,0,89,"2010"
"4064","410970 IBAITI",0,1,7,429,2,439,"2010"
"4065","410975 IBEMA",0,0,3,97,0,100,"2010"
"4066","410980 IBIPORA",2,1,10,659,0,672,"2010"
"4067","410990 ICARAIMA",0,0,7,103,0,110,"2010"
"4068","411000 IGUARACU",0,0,0,51,0,51,"2010"
"4069","411005 IGUATU",0,0,1,24,0,25,"2010"
"4070","411007 IMBAU",1,1,5,177,0,184,"2010"
"4071","411010 IMBITUVA",3,8,9,421,0,441,"2010"
"4072","411020 INACIO MARTINS",1,2,1,178,2,184,"2010"
"4073","411030 INAJA",0,0,0,38,0,38,"2010"
"4074","411040 INDIANOPOLIS",0,0,0,51,0,51,"2010"
"4075","411050 IPIRANGA",0,3,5,193,0,201,"2010"
"4076","411060 IPORA",0,1,8,177,0,186,"2010"
"4077","411065 IRACEMA DO OESTE",0,0,0,30,0,30,"2010"
"4078","411070 IRATI",1,4,4,844,0,853,"2010"
"4079","411080 IRETAMA",0,0,10,115,0,125,"2010"
"4080","411090 ITAGUAJE",0,0,2,67,0,69,"2010"
"4081","411095 ITAIPULANDIA",0,1,6,127,0,134,"2010"
"4082","411100 ITAMBARACA",1,0,1,73,0,75,"2010"
"4083","411110 ITAMBE",0,0,1,69,0,70,"2010"
"4084","411120 ITAPEJARA D'OESTE",0,0,0,127,0,127,"2010"
"4085","411125 ITAPERUCU",3,1,4,441,3,452,"2010"
"4086","411130 ITAUNA DO SUL",0,1,1,59,0,61,"2010"
"4087","411140 IVAI",1,4,6,199,1,211,"2010"
"4088","411150 IVAIPORA",2,1,8,439,2,452,"2010"
"4089","411155 IVATE",0,2,2,89,0,93,"2010"
"4090","411160 IVATUBA",1,0,1,22,0,24,"2010"
"4091","411170 JABOTI",0,0,0,71,0,71,"2010"
"4092","411180 JACAREZINHO",2,2,12,585,4,605,"2010"
"4093","411190 JAGUAPITA",0,0,1,176,0,177,"2010"
"4094","411200 JAGUARIAIVA",3,4,10,544,3,564,"2010"
"4095","411210 JANDAIA DO SUL",0,2,4,272,0,278,"2010"
"4096","411220 JANIOPOLIS",0,0,2,66,0,68,"2010"
"4097","411230 JAPIRA",2,0,2,55,0,59,"2010"
"4098","411240 JAPURA",0,0,0,93,0,93,"2010"
"4099","411250 JARDIM ALEGRE",0,2,3,125,0,130,"2010"
"4100","411260 JARDIM OLINDA",0,0,0,24,0,24,"2010"
"4101","411270 JATAIZINHO",2,1,5,175,0,183,"2010"
"4102","411275 JESUITAS",0,0,0,84,0,84,"2010"
"4103","411280 JOAQUIM TAVORA",2,0,1,135,0,138,"2010"
"4104","411290 JUNDIAI DO SUL",0,0,2,32,0,34,"2010"
"4105","411295 JURANDA",0,0,1,95,0,96,"2010"
"4106","411300 JUSSARA",0,0,0,91,0,91,"2010"
"4107","411310 KALORE",0,1,1,58,0,60,"2010"
"4108","411320 LAPA",2,9,18,613,2,644,"2010"
"4109","411325 LARANJAL",0,0,2,79,0,81,"2010"
"4110","411330 LARANJEIRAS DO SUL",0,1,10,446,1,458,"2010"
"4111","411340 LEOPOLIS",1,0,0,47,0,48,"2010"
"4112","411342 LIDIANOPOLIS",0,0,0,48,0,48,"2010"
"4113","411345 LINDOESTE",0,0,3,58,0,61,"2010"
"4114","411350 LOANDA",0,2,0,314,0,316,"2010"
"4115","411360 LOBATO",0,0,1,40,0,41,"2010"
"4116","411370 LONDRINA",25,23,87,6770,11,6916,"2010"
"4117","411373 LUIZIANA",0,1,3,115,0,119,"2010"
"4118","411375 LUNARDELLI",0,1,1,54,0,56,"2010"
"4119","411380 LUPIONOPOLIS",0,0,1,70,0,71,"2010"
"4120","411390 MALLET",0,0,5,163,0,168,"2010"
"4121","411400 MAMBORE",0,0,2,181,0,183,"2010"
"4122","411410 MANDAGUACU",2,0,1,243,0,246,"2010"
"4123","411420 MANDAGUARI",2,0,2,404,0,408,"2010"
"4124","411430 MANDIRITUBA",0,4,10,337,1,352,"2010"
"4125","411435 MANFRINOPOLIS",0,0,0,39,0,39,"2010"
"4126","411440 MANGUEIRINHA",1,7,12,262,0,282,"2010"
"4127","411450 MANOEL RIBAS",1,2,1,192,1,197,"2010"
"4128","411460 MARECHAL CANDIDO RONDON",1,0,10,574,1,586,"2010"
"4129","411470 MARIA HELENA",0,0,1,49,0,50,"2010"
"4130","411480 MARIALVA",0,1,5,428,0,434,"2010"
"4131","411490 MARILANDIA DO SUL",1,0,0,120,0,121,"2010"
"4132","411500 MARILENA",0,0,3,77,0,80,"2010"
"4133","411510 MARILUZ",0,1,4,167,1,173,"2010"
"4134","411520 MARINGA",10,14,66,4550,4,4644,"2010"
"4135","411530 MARIOPOLIS",0,1,1,84,0,86,"2010"
"4136","411535 MARIPA",0,0,0,61,1,62,"2010"
"4137","411540 MARMELEIRO",1,1,5,156,0,163,"2010"
"4138","411545 MARQUINHO",0,0,1,87,1,89,"2010"
"4139","411550 MARUMBI",1,0,2,46,0,49,"2010"
"4140","411560 MATELANDIA",0,1,5,238,0,244,"2010"
"4141","411570 MATINHOS",2,5,2,406,0,415,"2010"
"4142","411573 MATO RICO",0,0,1,43,0,44,"2010"
"4143","411575 MAUA DA SERRA",1,1,10,152,0,164,"2010"
"4144","411580 MEDIANEIRA",0,1,17,602,0,620,"2010"
"4145","411585 MERCEDES",0,0,0,77,0,77,"2010"
"4146","411590 MIRADOR",0,0,0,31,0,31,"2010"
"4147","411600 MIRASELVA",0,0,0,20,0,20,"2010"
"4148","411605 MISSAL",0,0,1,107,0,108,"2010"
"4149","411610 MOREIRA SALES",0,0,1,155,1,157,"2010"
"4150","411620 MORRETES",0,2,3,217,0,222,"2010"
"4151","411630 MUNHOZ DE MELO",0,0,2,34,1,37,"2010"
"4152","411640 NOSSA SENHORA DAS GRACAS",0,1,0,37,0,38,"2010"
"4153","411650 NOVA ALIANCA DO IVAI",0,0,0,30,0,30,"2010"
"4154","411660 NOVA AMERICA DA COLINA",0,0,1,36,0,37,"2010"
"4155","411670 NOVA AURORA",1,0,1,129,0,131,"2010"
"4156","411680 NOVA CANTU",0,0,1,97,0,98,"2010"
"4157","411690 NOVA ESPERANCA",0,1,5,324,0,330,"2010"
"4158","411695 NOVA ESPERANCA DO SUDOESTE",0,0,2,78,0,80,"2010"
"4159","411700 NOVA FATIMA",1,2,2,96,0,101,"2010"
"4160","411705 NOVA LARANJEIRAS",0,1,4,189,7,201,"2010"
"4161","411710 NOVA LONDRINA",0,0,2,158,0,160,"2010"
"4162","411720 NOVA OLIMPIA",1,0,1,79,0,81,"2010"
"4163","411721 NOVA SANTA BARBARA",0,0,1,56,0,57,"2010"
"4164","411722 NOVA SANTA ROSA",0,0,2,81,0,83,"2010"
"4165","411725 NOVA PRATA DO IGUACU",0,0,1,127,0,128,"2010"
"4166","411727 NOVA TEBAS",0,0,3,87,0,90,"2010"
"4167","411729 NOVO ITACOLOMI",0,0,0,28,0,28,"2010"
"4168","411730 ORTIGUEIRA",0,3,4,287,1,295,"2010"
"4169","411740 OURIZONA",0,0,0,49,0,49,"2010"
"4170","411745 OURO VERDE DO OESTE",0,0,0,76,0,76,"2010"
"4171","411750 PAICANDU",1,2,4,484,0,491,"2010"
"4172","411760 PALMAS",0,0,4,826,3,833,"2010"
"4173","411770 PALMEIRA",0,1,6,445,0,452,"2010"
"4174","411780 PALMITAL",0,1,10,260,1,272,"2010"
"4175","411790 PALOTINA",2,3,10,399,1,415,"2010"
"4176","411800 PARAISO DO NORTE",1,0,0,173,0,174,"2010"
"4177","411810 PARANACITY",1,0,2,133,1,137,"2010"
"4178","411820 PARANAGUA",4,13,32,2269,4,2322,"2010"
"4179","411830 PARANAPOEMA",0,0,1,36,1,38,"2010"
"4180","411840 PARANAVAI",1,2,7,1078,0,1088,"2010"
"4181","411845 PATO BRAGADO",1,0,1,54,0,56,"2010"
"4182","411850 PATO BRANCO",3,3,12,1052,1,1071,"2010"
"4183","411860 PAULA FREITAS",0,0,0,71,0,71,"2010"
"4184","411870 PAULO FRONTIN",0,0,3,87,0,90,"2010"
"4185","411880 PEABIRU",0,0,4,180,0,184,"2010"
"4186","411885 PEROBAL",0,1,1,77,0,79,"2010"
"4187","411890 PEROLA",0,2,1,106,0,109,"2010"
"4188","411900 PEROLA D'OESTE",1,0,1,76,0,78,"2010"
"4189","411910 PIEN",0,0,0,150,0,150,"2010"
"4190","411915 PINHAIS",4,8,29,1879,7,1927,"2010"
"4191","411920 PINHALAO",0,0,0,92,0,92,"2010"
"4192","411925 PINHAL DE SAO BENTO",1,0,1,40,0,42,"2010"
"4193","411930 PINHAO",0,2,10,542,9,563,"2010"
"4194","411940 PIRAI DO SUL",1,1,10,339,0,351,"2010"
"4195","411950 PIRAQUARA",8,6,23,1462,5,1504,"2010"
"4196","411960 PITANGA",1,1,10,482,2,496,"2010"
"4197","411965 PITANGUEIRAS",0,0,0,35,0,35,"2010"
"4198","411970 PLANALTINA DO PARANA",0,0,0,67,0,67,"2010"
"4199","411980 PLANALTO",0,0,1,110,0,111,"2010"
"4200","411990 PONTA GROSSA",17,27,166,4909,1,5120,"2010"
"4201","411995 PONTAL DO PARANA",1,0,6,261,1,269,"2010"
"4202","412000 PORECATU",0,1,1,172,0,174,"2010"
"4203","412010 PORTO AMAZONAS",1,0,1,55,0,57,"2010"
"4204","412015 PORTO BARREIRO",0,0,1,46,1,48,"2010"
"4205","412020 PORTO RICO",0,0,0,35,0,35,"2010"
"4206","412030 PORTO VITORIA",0,0,1,47,0,48,"2010"
"4207","412033 PRADO FERREIRA",0,0,1,39,0,40,"2010"
"4208","412035 PRANCHITA",0,0,1,75,0,76,"2010"
"4209","412040 PRESIDENTE CASTELO BRANCO",0,0,1,65,0,66,"2010"
"4210","412050 PRIMEIRO DE MAIO",0,0,0,99,0,99,"2010"
"4211","412060 PRUDENTOPOLIS",2,0,25,713,6,746,"2010"
"4212","412065 QUARTO CENTENARIO",0,0,2,69,0,71,"2010"
"4213","412070 QUATIGUA",0,0,2,88,0,90,"2010"
"4214","412080 QUATRO BARRAS",0,1,1,316,1,319,"2010"
"4215","412085 QUATRO PONTES",0,0,0,32,0,32,"2010"
"4216","412090 QUEDAS DO IGUACU",4,3,10,423,0,440,"2010"
"4217","412100 QUERENCIA DO NORTE",0,3,9,165,0,177,"2010"
"4218","412110 QUINTA DO SOL",0,0,0,68,0,68,"2010"
"4219","412120 QUITANDINHA",1,2,4,149,0,156,"2010"
"4220","412125 RAMILANDIA",1,0,5,55,0,61,"2010"
"4221","412130 RANCHO ALEGRE",0,1,0,49,0,50,"2010"
"4222","412135 RANCHO ALEGRE D'OESTE",0,0,1,34,0,35,"2010"
"4223","412140 REALEZA",1,0,5,233,2,241,"2010"
"4224","412150 REBOUCAS",0,0,1,173,0,174,"2010"
"4225","412160 RENASCENCA",0,0,0,70,0,70,"2010"
"4226","412170 RESERVA",0,0,8,389,5,402,"2010"
"4227","412175 RESERVA DO IGUACU",1,1,3,101,0,106,"2010"
"4228","412180 RIBEIRAO CLARO",0,0,1,115,0,116,"2010"
"4229","412190 RIBEIRAO DO PINHAL",0,1,1,180,0,182,"2010"
"4230","412200 RIO AZUL",1,0,2,224,0,227,"2010"
"4231","412210 RIO BOM",0,1,0,32,1,34,"2010"
"4232","412215 RIO BONITO DO IGUACU",0,1,1,209,1,212,"2010"
"4233","412217 RIO BRANCO DO IVAI",0,0,1,52,0,53,"2010"
"4234","412220 RIO BRANCO DO SUL",0,1,12,497,2,512,"2010"
"4235","412230 RIO NEGRO",4,4,3,381,1,393,"2010"
"4236","412240 ROLANDIA",2,7,6,765,0,780,"2010"
"4237","412250 RONCADOR",0,1,5,130,0,136,"2010"
"4238","412260 RONDON",0,0,1,119,0,120,"2010"
"4239","412265 ROSARIO DO IVAI",0,0,0,74,1,75,"2010"
"4240","412270 SABAUDIA",0,0,0,49,0,49,"2010"
"4241","412280 SALGADO FILHO",0,0,2,61,1,64,"2010"
"4242","412290 SALTO DO ITARARE",0,0,0,67,0,67,"2010"
"4243","412300 SALTO DO LONTRA",1,0,0,164,1,166,"2010"
"4244","412310 SANTA AMELIA",0,0,1,59,0,60,"2010"
"4245","412320 SANTA CECILIA DO PAVAO",2,0,0,47,0,49,"2010"
"4246","412330 SANTA CRUZ DE MONTE CASTELO",0,1,1,106,0,108,"2010"
"4247","412340 SANTA FE",2,1,2,111,0,116,"2010"
"4248","412350 SANTA HELENA",0,2,4,288,1,295,"2010"
"4249","412360 SANTA INES",0,0,0,21,0,21,"2010"
"4250","412370 SANTA ISABEL DO IVAI",0,1,2,96,0,99,"2010"
"4251","412380 SANTA IZABEL DO OESTE",0,0,0,144,1,145,"2010"
"4252","412382 SANTA LUCIA",0,0,2,67,0,69,"2010"
"4253","412385 SANTA MARIA DO OESTE",0,2,3,172,0,177,"2010"
"4254","412390 SANTA MARIANA",0,0,1,118,0,119,"2010"
"4255","412395 SANTA MONICA",0,0,0,36,0,36,"2010"
"4256","412400 SANTANA DO ITARARE",0,0,0,50,0,50,"2010"
"4257","412402 SANTA TEREZA DO OESTE",0,0,5,177,0,182,"2010"
"4258","412405 SANTA TEREZINHA DE ITAIPU",0,0,3,279,0,282,"2010"
"4259","412410 SANTO ANTONIO DA PLATINA",2,2,8,664,0,676,"2010"
"4260","412420 SANTO ANTONIO DO CAIUA",0,0,0,25,0,25,"2010"
"4261","412430 SANTO ANTONIO DO PARAISO",0,0,0,34,0,34,"2010"
"4262","412440 SANTO ANTONIO DO SUDOESTE",1,0,3,293,2,299,"2010"
"4263","412450 SANTO INACIO",0,1,2,65,0,68,"2010"
"4264","412460 SAO CARLOS DO IVAI",0,0,0,86,0,86,"2010"
"4265","412470 SAO JERONIMO DA SERRA",0,0,3,162,0,165,"2010"
"4266","412480 SAO JOAO",0,0,1,106,0,107,"2010"
"4267","412490 SAO JOAO DO CAIUA",1,0,1,69,0,71,"2010"
"4268","412500 SAO JOAO DO IVAI",1,1,0,133,0,135,"2010"
"4269","412510 SAO JOAO DO TRIUNFO",0,0,6,166,1,173,"2010"
"4270","412520 SAO JORGE D'OESTE",1,0,0,103,0,104,"2010"
"4271","412530 SAO JORGE DO IVAI",0,0,2,65,0,67,"2010"
"4272","412535 SAO JORGE DO PATROCINIO",0,0,3,69,0,72,"2010"
"4273","412540 SAO JOSE DA BOA VISTA",0,0,0,47,0,47,"2010"
"4274","412545 SAO JOSE DAS PALMEIRAS",0,1,0,51,0,52,"2010"
"4275","412550 SAO JOSE DOS PINHAIS",15,20,84,4411,19,4549,"2010"
"4276","412555 SAO MANOEL DO PARANA",0,0,1,22,0,23,"2010"
"4277","412560 SAO MATEUS DO SUL",1,1,5,581,0,588,"2010"
"4278","412570 SAO MIGUEL DO IGUACU",0,1,1,365,10,377,"2010"
"4279","412575 SAO PEDRO DO IGUACU",0,0,0,74,0,74,"2010"
"4280","412580 SAO PEDRO DO IVAI",0,1,5,127,0,133,"2010"
"4281","412590 SAO PEDRO DO PARANA",0,0,0,27,0,27,"2010"
"4282","412600 SAO SEBASTIAO DA AMOREIRA",0,2,1,123,0,126,"2010"
"4283","412610 SAO TOME",1,0,2,74,0,77,"2010"
"4284","412620 SAPOPEMA",0,0,1,86,1,88,"2010"
"4285","412625 SARANDI",1,3,18,1168,0,1190,"2010"
"4286","412627 SAUDADE DO IGUACU",0,0,1,84,0,85,"2010"
"4287","412630 SENGES",2,2,9,284,1,298,"2010"
"4288","412635 SERRANOPOLIS DO IGUACU",0,0,0,46,0,46,"2010"
"4289","412640 SERTANEJA",0,0,0,62,0,62,"2010"
"4290","412650 SERTANOPOLIS",1,0,0,171,0,172,"2010"
"4291","412660 SIQUEIRA CAMPOS",0,2,2,236,0,240,"2010"
"4292","412665 SULINA",0,0,1,38,0,39,"2010"
"4293","412667 TAMARANA",1,2,1,188,0,192,"2010"
"4294","412670 TAMBOARA",0,1,0,57,0,58,"2010"
"4295","412680 TAPEJARA",0,1,1,204,0,206,"2010"
"4296","412690 TAPIRA",1,1,1,66,0,69,"2010"
"4297","412700 TEIXEIRA SOARES",0,1,3,132,0,136,"2010"
"4298","412710 TELEMACO BORBA",2,8,15,1137,4,1166,"2010"
"4299","412720 TERRA BOA",0,0,2,184,0,186,"2010"
"4300","412730 TERRA RICA",1,1,7,229,0,238,"2010"
"4301","412740 TERRA ROXA",1,1,2,210,0,214,"2010"
"4302","412750 TIBAGI",0,1,4,295,0,300,"2010"
"4303","412760 TIJUCAS DO SUL",0,1,3,162,1,167,"2010"
"4304","412770 TOLEDO",3,6,12,1672,0,1693,"2010"
"4305","412780 TOMAZINA",0,0,4,79,0,83,"2010"
"4306","412785 TRES BARRAS DO PARANA",1,1,1,151,0,154,"2010"
"4307","412788 TUNAS DO PARANA",0,0,0,139,4,143,"2010"
"4308","412790 TUNEIRAS DO OESTE",0,2,2,119,0,123,"2010"
"4309","412795 TUPASSI",0,0,0,86,1,87,"2010"
"4310","412796 TURVO",0,0,4,223,0,227,"2010"
"4311","412800 UBIRATA",0,1,1,278,0,280,"2010"
"4312","412810 UMUARAMA",1,8,38,1340,0,1387,"2010"
"4313","412820 UNIAO DA VITORIA",0,0,8,751,1,760,"2010"
"4314","412830 UNIFLOR",0,0,0,32,0,32,"2010"
"4315","412840 URAI",1,0,0,122,0,123,"2010"
"4316","412850 WENCESLAU BRAZ",0,1,2,245,0,248,"2010"
"4317","412853 VENTANIA",3,0,1,116,3,123,"2010"
"4318","412855 VERA CRUZ DO OESTE",0,0,4,111,0,115,"2010"
"4319","412860 VERE",0,0,0,71,0,71,"2010"
"4320","412862 ALTO PARAISO",0,0,0,39,0,39,"2010"
"4321","412863 DOUTOR ULYSSES",1,0,2,59,0,62,"2010"
"4322","412865 VIRMOND",0,0,0,61,0,61,"2010"
"4323","412870 VITORINO",0,0,0,85,0,85,"2010"
"4324","412880 XAMBRE",1,1,2,55,0,59,"2010"
"4325","420005 ABDON BATISTA",0,0,0,35,0,35,"2010"
"4326","420010 ABELARDO LUZ",0,0,2,262,0,264,"2010"
"4327","420020 AGROLANDIA",0,0,0,127,0,127,"2010"
"4328","420030 AGRONOMICA",0,0,0,59,0,59,"2010"
"4329","420040 AGUA DOCE",2,1,0,86,0,89,"2010"
"4330","420050 AGUAS DE CHAPECO",0,0,4,92,0,96,"2010"
"4331","420055 AGUAS FRIAS",0,0,0,25,0,25,"2010"
"4332","420060 AGUAS MORNAS",0,0,0,51,0,51,"2010"
"4333","420070 ALFREDO WAGNER",0,0,1,125,0,126,"2010"
"4334","420075 ALTO BELA VISTA",0,0,0,17,0,17,"2010"
"4335","420080 ANCHIETA",0,0,1,83,0,84,"2010"
"4336","420090 ANGELINA",0,0,2,66,0,68,"2010"
"4337","420100 ANITA GARIBALDI",0,0,3,103,0,106,"2010"
"4338","420110 ANITAPOLIS",0,1,0,34,0,35,"2010"
"4339","420120 ANTONIO CARLOS",0,0,0,105,0,105,"2010"
"4340","420125 APIUNA",0,0,1,108,0,109,"2010"
"4341","420127 ARABUTA",0,0,1,36,0,37,"2010"
"4342","420130 ARAQUARI",0,2,6,379,0,387,"2010"
"4343","420140 ARARANGUA",2,4,10,870,0,886,"2010"
"4344","420150 ARMAZEM",1,1,1,101,0,104,"2010"
"4345","420160 ARROIO TRINTA",0,1,3,27,0,31,"2010"
"4346","420165 ARVOREDO",0,0,0,31,0,31,"2010"
"4347","420170 ASCURRA",0,2,1,71,0,74,"2010"
"4348","420180 ATALANTA",0,0,0,32,0,32,"2010"
"4349","420190 AURORA",0,0,5,63,0,68,"2010"
"4350","420195 BALNEARIO ARROIO DO SILVA",1,1,0,111,0,113,"2010"
"4351","420200 BALNEARIO CAMBORIU",9,6,21,1297,1,1334,"2010"
"4352","420205 BALNEARIO BARRA DO SUL",0,0,0,88,0,88,"2010"
"4353","420207 BALNEARIO GAIVOTA",0,0,0,114,0,114,"2010"
"4354","420208 BANDEIRANTE",0,0,1,22,0,23,"2010"
"4355","420209 BARRA BONITA",0,0,1,21,0,22,"2010"
"4356","420210 BARRA VELHA",1,0,4,314,6,325,"2010"
"4357","420213 BELA VISTA DO TOLDO",0,0,2,56,3,61,"2010"
"4358","420215 BELMONTE",1,1,1,27,0,30,"2010"
"4359","420220 BENEDITO NOVO",0,0,3,118,0,121,"2010"
"4360","420230 BIGUACU",3,2,16,783,4,808,"2010"
"4361","420240 BLUMENAU",8,9,43,4003,3,4066,"2010"
"4362","420243 BOCAINA DO SUL",0,0,0,38,0,38,"2010"
"4363","420245 BOMBINHAS",2,0,2,213,0,217,"2010"
"4364","420250 BOM JARDIM DA SERRA",0,0,2,48,0,50,"2010"
"4365","420253 BOM JESUS",0,0,0,33,0,33,"2010"
"4366","420257 BOM JESUS DO OESTE",0,0,0,24,0,24,"2010"
"4367","420260 BOM RETIRO",1,3,2,126,1,133,"2010"
"4368","420270 BOTUVERA",0,0,1,38,0,39,"2010"
"4369","420280 BRACO DO NORTE",1,0,3,390,0,394,"2010"
"4370","420285 BRACO DO TROMBUDO",0,0,0,48,0,48,"2010"
"4371","420287 BRUNOPOLIS",0,0,2,27,0,29,"2010"
"4372","420290 BRUSQUE",10,6,21,1461,1,1499,"2010"
"4373","420300 CACADOR",5,11,30,1073,2,1121,"2010"
"4374","420310 CAIBI",0,0,2,51,0,53,"2010"
"4375","420315 CALMON",0,0,3,67,0,70,"2010"
"4376","420320 CAMBORIU",6,5,15,1036,0,1062,"2010"
"4377","420325 CAPAO ALTO",1,1,0,21,1,24,"2010"
"4378","420330 CAMPO ALEGRE",0,2,1,128,0,131,"2010"
"4379","420340 CAMPO BELO DO SUL",0,0,0,94,1,95,"2010"
"4380","420350 CAMPO ERE",0,0,3,127,0,130,"2010"
"4381","420360 CAMPOS NOVOS",0,1,1,457,0,459,"2010"
"4382","420370 CANELINHA",0,0,2,119,0,121,"2010"
"4383","420380 CANOINHAS",3,6,20,760,6,795,"2010"
"4384","420390 CAPINZAL",0,1,5,309,0,315,"2010"
"4385","420395 CAPIVARI DE BAIXO",0,1,7,319,2,329,"2010"
"4386","420400 CATANDUVAS",0,1,1,134,0,136,"2010"
"4387","420410 CAXAMBU DO SUL",0,0,1,46,0,47,"2010"
"4388","420415 CELSO RAMOS",0,0,0,30,0,30,"2010"
"4389","420417 CERRO NEGRO",0,0,3,32,0,35,"2010"
"4390","420419 CHAPADAO DO LAGEADO",0,0,3,31,0,34,"2010"
"4391","420420 CHAPECO",5,13,50,2797,2,2867,"2010"
"4392","420425 COCAL DO SUL",0,1,0,165,1,167,"2010"
"4393","420430 CONCORDIA",0,3,21,937,4,965,"2010"
"4394","420435 CORDILHEIRA ALTA",0,0,1,35,0,36,"2010"
"4395","420440 CORONEL FREITAS",1,0,4,83,0,88,"2010"
"4396","420445 CORONEL MARTINS",0,0,0,20,0,20,"2010"
"4397","420450 CORUPA",0,0,1,191,0,192,"2010"
"4398","420455 CORREIA PINTO",2,3,6,177,0,188,"2010"
"4399","420460 CRICIUMA",2,4,17,2515,0,2538,"2010"
"4400","420470 CUNHA PORA",1,0,0,113,0,114,"2010"
"4401","420475 CUNHATAI",0,0,0,25,0,25,"2010"
"4402","420480 CURITIBANOS",0,1,8,615,3,627,"2010"
"4403","420490 DESCANSO",0,0,0,83,0,83,"2010"
"4404","420500 DIONISIO CERQUEIRA",0,0,2,228,0,230,"2010"
"4405","420510 DONA EMMA",0,0,0,52,0,52,"2010"
"4406","420515 DOUTOR PEDRINHO",0,0,0,28,0,28,"2010"
"4407","420517 ENTRE RIOS",0,0,0,41,2,43,"2010"
"4408","420519 ERMO",0,0,1,34,0,35,"2010"
"4409","420520 ERVAL VELHO",0,0,1,36,0,37,"2010"
"4410","420530 FAXINAL DOS GUEDES",0,0,2,158,0,160,"2010"
"4411","420535 FLOR DO SERTAO",0,1,0,17,0,18,"2010"
"4412","420540 FLORIANOPOLIS",5,14,57,5201,21,5298,"2010"
"4413","420543 FORMOSA DO SUL",0,0,0,33,0,33,"2010"
"4414","420545 FORQUILHINHA",1,0,5,303,0,309,"2010"
"4415","420550 FRAIBURGO",0,4,15,547,1,567,"2010"
"4416","420555 FREI ROGERIO",0,0,0,25,0,25,"2010"
"4417","420560 GALVAO",0,0,1,43,0,44,"2010"
"4418","420570 GAROPABA",0,0,0,205,0,205,"2010"
"4419","420580 GARUVA",0,4,4,241,1,250,"2010"
"4420","420590 GASPAR",2,2,17,722,0,743,"2010"
"4421","420600 GOVERNADOR CELSO RAMOS",1,1,0,146,0,148,"2010"
"4422","420610 GRAO PARA",0,0,0,72,0,72,"2010"
"4423","420620 GRAVATAL",0,1,1,121,0,123,"2010"
"4424","420630 GUABIRUBA",3,0,2,207,0,212,"2010"
"4425","420640 GUARACIABA",1,1,1,86,0,89,"2010"
"4426","420650 GUARAMIRIM",1,3,3,466,0,473,"2010"
"4427","420660 GUARUJA DO SUL",0,0,1,65,0,66,"2010"
"4428","420665 GUATAMBU",0,0,1,55,1,57,"2010"
"4429","420670 HERVAL D'OESTE",0,2,0,267,0,269,"2010"
"4430","420675 IBIAM",0,0,0,14,0,14,"2010"
"4431","420680 IBICARE",0,0,0,30,0,30,"2010"
"4432","420690 IBIRAMA",1,1,3,263,0,268,"2010"
"4433","420700 ICARA",0,1,4,825,0,830,"2010"
"4434","420710 ILHOTA",2,1,1,153,0,157,"2010"
"4435","420720 IMARUI",1,1,2,84,0,88,"2010"
"4436","420730 IMBITUBA",1,3,2,444,0,450,"2010"
"4437","420740 IMBUIA",0,0,0,78,0,78,"2010"
"4438","420750 INDAIAL",4,1,2,812,0,819,"2010"
"4439","420757 IOMERE",0,0,0,18,0,18,"2010"
"4440","420760 IPIRA",0,0,1,43,0,44,"2010"
"4441","420765 IPORA DO OESTE",1,0,1,103,0,105,"2010"
"4442","420768 IPUACU",0,1,2,125,8,136,"2010"
"4443","420770 IPUMIRIM",0,1,3,84,0,88,"2010"
"4444","420775 IRACEMINHA",0,0,1,48,0,49,"2010"
"4445","420780 IRANI",0,0,1,103,0,104,"2010"
"4446","420785 IRATI",0,0,0,23,0,23,"2010"
"4447","420790 IRINEOPOLIS",0,1,0,128,0,129,"2010"
"4448","420800 ITA",1,0,2,80,0,83,"2010"
"4449","420810 ITAIOPOLIS",1,3,3,282,2,291,"2010"
"4450","420820 ITAJAI",19,12,73,2624,1,2729,"2010"
"4451","420830 ITAPEMA",5,2,8,609,0,624,"2010"
"4452","420840 ITAPIRANGA",2,2,0,206,0,210,"2010"
"4453","420845 ITAPOA",0,0,1,166,0,167,"2010"
"4454","420850 ITUPORANGA",1,1,11,317,0,330,"2010"
"4455","420860 JABORA",0,0,1,33,0,34,"2010"
"4456","420870 JACINTO MACHADO",0,0,1,120,0,121,"2010"
"4457","420880 JAGUARUNA",0,0,0,202,0,202,"2010"
"4458","420890 JARAGUA DO SUL",3,4,40,2068,0,2115,"2010"
"4459","420895 JARDINOPOLIS",0,0,2,22,0,24,"2010"
"4460","420900 JOACABA",0,2,3,334,0,339,"2010"
"4461","420910 JOINVILLE",9,26,111,7121,12,7279,"2010"
"4462","420915 JOSE BOITEUX",1,0,1,78,0,80,"2010"
"4463","420917 JUPIA",0,1,0,21,0,22,"2010"
"4464","420920 LACERDOPOLIS",0,0,0,20,0,20,"2010"
"4465","420930 LAGES",3,15,90,2200,2,2310,"2010"
"4466","420940 LAGUNA",1,0,15,573,0,589,"2010"
"4467","420945 LAJEADO GRANDE",0,0,0,12,0,12,"2010"
"4468","420950 LAURENTINO",0,0,1,72,1,74,"2010"
"4469","420960 LAURO MULLER",1,1,6,199,0,207,"2010"
"4470","420970 LEBON REGIS",1,0,2,158,1,162,"2010"
"4471","420980 LEOBERTO LEAL",0,0,3,44,0,47,"2010"
"4472","420985 LINDOIA DO SUL",0,0,0,50,0,50,"2010"
"4473","420990 LONTRAS",0,0,1,128,1,130,"2010"
"4474","421000 LUIZ ALVES",1,0,1,140,0,142,"2010"
"4475","421003 LUZERNA",0,0,1,55,0,56,"2010"
"4476","421005 MACIEIRA",0,0,0,26,0,26,"2010"
"4477","421010 MAFRA",0,2,8,741,0,751,"2010"
"4478","421020 MAJOR GERCINO",0,0,0,24,0,24,"2010"
"4479","421030 MAJOR VIEIRA",0,1,2,98,0,101,"2010"
"4480","421040 MARACAJA",0,0,0,73,0,73,"2010"
"4481","421050 MARAVILHA",1,0,1,273,0,275,"2010"
"4482","421055 MAREMA",0,0,0,17,0,17,"2010"
"4483","421060 MASSARANDUBA",1,0,2,181,0,184,"2010"
"4484","421070 MATOS COSTA",0,0,2,41,0,43,"2010"
"4485","421080 MELEIRO",1,0,0,76,0,77,"2010"
"4486","421085 MIRIM DOCE",0,0,0,24,0,24,"2010"
"4487","421090 MODELO",0,0,0,41,0,41,"2010"
"4488","421100 MONDAI",0,1,2,101,0,104,"2010"
"4489","421105 MONTE CARLO",0,0,0,129,0,129,"2010"
"4490","421110 MONTE CASTELO",0,0,0,118,1,119,"2010"
"4491","421120 MORRO DA FUMACA",0,2,0,237,0,239,"2010"
"4492","421125 MORRO GRANDE",0,0,1,32,0,33,"2010"
"4493","421130 NAVEGANTES",3,4,14,919,0,940,"2010"
"4494","421140 NOVA ERECHIM",1,0,0,41,0,42,"2010"
"4495","421145 NOVA ITABERABA",0,1,2,45,0,48,"2010"
"4496","421150 NOVA TRENTO",0,2,2,126,0,130,"2010"
"4497","421160 NOVA VENEZA",2,2,0,144,0,148,"2010"
"4498","421165 NOVO HORIZONTE",0,1,0,31,0,32,"2010"
"4499","421170 ORLEANS",2,1,4,247,0,254,"2010"
"4500","421175 OTACILIO COSTA",0,1,4,224,0,229,"2010"
"4501","421180 OURO",0,0,0,88,0,88,"2010"
"4502","421185 OURO VERDE",0,1,0,23,0,24,"2010"
"4503","421187 PAIAL",0,0,0,23,0,23,"2010"
"4504","421189 PAINEL",0,0,0,19,0,19,"2010"
"4505","421190 PALHOCA",5,5,20,1974,7,2011,"2010"
"4506","421200 PALMA SOLA",0,0,1,112,0,113,"2010"
"4507","421205 PALMEIRA",0,0,1,24,0,25,"2010"
"4508","421210 PALMITOS",0,0,3,195,0,198,"2010"
"4509","421220 PAPANDUVA",0,0,3,243,2,248,"2010"
"4510","421223 PARAISO",0,0,1,49,0,50,"2010"
"4511","421225 PASSO DE TORRES",0,0,0,81,0,81,"2010"
"4512","421227 PASSOS MAIA",0,0,0,74,2,76,"2010"
"4513","421230 PAULO LOPES",0,1,0,92,0,93,"2010"
"4514","421240 PEDRAS GRANDES",0,0,0,36,0,36,"2010"
"4515","421250 PENHA",5,0,8,346,0,359,"2010"
"4516","421260 PERITIBA",0,0,0,23,0,23,"2010"
"4517","421270 PETROLANDIA",0,0,2,76,0,78,"2010"
"4518","421280 BALNEARIO PICARRAS",4,0,10,235,1,250,"2010"
"4519","421290 PINHALZINHO",1,1,0,208,0,210,"2010"
"4520","421300 PINHEIRO PRETO",0,0,1,29,0,30,"2010"
"4521","421310 PIRATUBA",0,0,1,62,2,65,"2010"
"4522","421315 PLANALTO ALEGRE",0,0,0,24,0,24,"2010"
"4523","421320 POMERODE",2,2,10,335,0,349,"2010"
"4524","421330 PONTE ALTA",0,1,3,68,0,72,"2010"
"4525","421335 PONTE ALTA DO NORTE",0,0,0,46,0,46,"2010"
"4526","421340 PONTE SERRADA",0,0,3,180,1,184,"2010"
"4527","421350 PORTO BELO",0,1,4,170,0,175,"2010"
"4528","421360 PORTO UNIAO",0,5,7,460,1,473,"2010"
"4529","421370 POUSO REDONDO",0,2,5,197,2,206,"2010"
"4530","421380 PRAIA GRANDE",0,1,1,94,0,96,"2010"
"4531","421390 PRESIDENTE CASTELLO BRANCO",0,0,1,16,0,17,"2010"
"4532","421400 PRESIDENTE GETULIO",0,0,4,181,0,185,"2010"
"4533","421410 PRESIDENTE NEREU",0,0,0,23,0,23,"2010"
"4534","421415 PRINCESA",0,0,1,24,0,25,"2010"
"4535","421420 QUILOMBO",0,0,2,109,0,111,"2010"
"4536","421430 RANCHO QUEIMADO",0,0,0,31,0,31,"2010"
"4537","421440 RIO DAS ANTAS",0,1,1,49,0,51,"2010"
"4538","421450 RIO DO CAMPO",0,0,2,80,0,82,"2010"
"4539","421460 RIO DO OESTE",1,0,2,65,0,68,"2010"
"4540","421470 RIO DOS CEDROS",0,0,2,116,1,119,"2010"
"4541","421480 RIO DO SUL",1,7,13,824,1,846,"2010"
"4542","421490 RIO FORTUNA",0,0,1,59,0,60,"2010"
"4543","421500 RIO NEGRINHO",2,2,7,569,0,580,"2010"
"4544","421505 RIO RUFINO",0,0,3,22,0,25,"2010"
"4545","421507 RIQUEZA",0,0,0,43,0,43,"2010"
"4546","421510 RODEIO",1,0,0,100,0,101,"2010"
"4547","421520 ROMELANDIA",0,1,0,49,0,50,"2010"
"4548","421530 SALETE",0,0,1,83,1,85,"2010"
"4549","421535 SALTINHO",0,1,2,58,0,61,"2010"
"4550","421540 SALTO VELOSO",1,0,1,52,0,54,"2010"
"4551","421545 SANGAO",0,0,0,177,1,178,"2010"
"4552","421550 SANTA CECILIA",1,0,9,295,0,305,"2010"
"4553","421555 SANTA HELENA",0,0,0,18,0,18,"2010"
"4554","421560 SANTA ROSA DE LIMA",0,0,0,26,0,26,"2010"
"4555","421565 SANTA ROSA DO SUL",1,0,1,92,0,94,"2010"
"4556","421567 SANTA TEREZINHA",0,0,0,94,0,94,"2010"
"4557","421568 SANTA TEREZINHA DO PROGRESSO",0,0,2,26,0,28,"2010"
"4558","421569 SANTIAGO DO SUL",0,0,0,13,0,13,"2010"
"4559","421570 SANTO AMARO DA IMPERATRIZ",0,0,1,230,0,231,"2010"
"4560","421575 SAO BERNARDINO",0,0,1,24,0,25,"2010"
"4561","421580 SAO BENTO DO SUL",2,6,7,1076,4,1095,"2010"
"4562","421590 SAO BONIFACIO",0,0,1,20,0,21,"2010"
"4563","421600 SAO CARLOS",1,0,2,115,0,118,"2010"
"4564","421605 SAO CRISTOVAO DO SUL",0,0,1,66,0,67,"2010"
"4565","421610 SAO DOMINGOS",0,1,2,120,0,123,"2010"
"4566","421620 SAO FRANCISCO DO SUL",0,3,11,624,0,638,"2010"
"4567","421625 SAO JOAO DO OESTE",0,0,2,47,1,50,"2010"
"4568","421630 SAO JOAO BATISTA",1,2,5,407,0,415,"2010"
"4569","421635 SAO JOAO DO ITAPERIU",0,1,2,40,0,43,"2010"
"4570","421640 SAO JOAO DO SUL",0,1,0,63,0,64,"2010"
"4571","421650 SAO JOAQUIM",1,2,12,367,0,382,"2010"
"4572","421660 SAO JOSE",4,8,25,2792,1,2830,"2010"
"4573","421670 SAO JOSE DO CEDRO",0,1,3,152,0,156,"2010"
"4574","421680 SAO JOSE DO CERRITO",0,0,3,66,2,71,"2010"
"4575","421690 SAO LOURENCO DO OESTE",1,0,4,331,0,336,"2010"
"4576","421700 SAO LUDGERO",0,0,1,142,0,143,"2010"
"4577","421710 SAO MARTINHO",0,0,0,35,0,35,"2010"
"4578","421715 SAO MIGUEL DA BOA VISTA",0,0,0,14,0,14,"2010"
"4579","421720 SAO MIGUEL DO OESTE",2,4,6,443,0,455,"2010"
"4580","421725 SAO PEDRO DE ALCANTARA",0,0,1,28,0,29,"2010"
"4581","421730 SAUDADES",0,0,1,96,0,97,"2010"
"4582","421740 SCHROEDER",0,0,6,220,0,226,"2010"
"4583","421750 SEARA",0,1,2,213,0,216,"2010"
"4584","421755 SERRA ALTA",0,0,0,31,0,31,"2010"
"4585","421760 SIDEROPOLIS",1,1,1,127,0,130,"2010"
"4586","421770 SOMBRIO",0,3,3,395,1,402,"2010"
"4587","421775 SUL BRASIL",0,0,0,29,0,29,"2010"
"4588","421780 TAIO",3,0,4,212,1,220,"2010"
"4589","421790 TANGARA",0,0,5,105,0,110,"2010"
"4590","421795 TIGRINHOS",0,0,0,15,0,15,"2010"
"4591","421800 TIJUCAS",2,0,3,474,0,479,"2010"
"4592","421810 TIMBE DO SUL",1,0,1,54,0,56,"2010"
"4593","421820 TIMBO",2,2,4,410,0,418,"2010"
"4594","421825 TIMBO GRANDE",0,1,0,120,0,121,"2010"
"4595","421830 TRES BARRAS",3,4,6,279,1,293,"2010"
"4596","421835 TREVISO",0,0,0,35,0,35,"2010"
"4597","421840 TREZE DE MAIO",0,0,1,78,0,79,"2010"
"4598","421850 TREZE TILIAS",0,0,2,90,0,92,"2010"
"4599","421860 TROMBUDO CENTRAL",0,0,4,97,0,101,"2010"
"4600","421870 TUBARAO",1,3,7,1161,0,1172,"2010"
"4601","421875 TUNAPOLIS",0,1,0,45,0,46,"2010"
"4602","421880 TURVO",2,0,3,134,0,139,"2010"
"4603","421885 UNIAO DO OESTE",0,0,0,30,0,30,"2010"
"4604","421890 URUBICI",0,1,3,149,0,153,"2010"
"4605","421895 URUPEMA",0,0,1,23,0,24,"2010"
"4606","421900 URUSSANGA",1,1,2,188,0,192,"2010"
"4607","421910 VARGEAO",0,0,0,51,0,51,"2010"
"4608","421915 VARGEM",0,0,0,30,0,30,"2010"
"4609","421917 VARGEM BONITA",0,0,0,65,0,65,"2010"
"4610","421920 VIDAL RAMOS",0,0,4,76,0,80,"2010"
"4611","421930 VIDEIRA",3,3,15,689,0,710,"2010"
"4612","421935 VITOR MEIRELES",0,2,0,80,0,82,"2010"
"4613","421940 WITMARSUM",1,0,1,55,0,57,"2010"
"4614","421950 XANXERE",0,3,6,588,1,598,"2010"
"4615","421960 XAVANTINA",0,0,3,47,0,50,"2010"
"4616","421970 XAXIM",0,1,3,397,0,401,"2010"
"4617","421985 ZORTEA",0,0,0,42,0,42,"2010"
"4618","430003 ACEGUA",0,0,0,58,0,58,"2010"
"4619","430005 AGUA SANTA",0,0,0,35,0,35,"2010"
"4620","430010 AGUDO",1,1,4,146,0,152,"2010"
"4621","430020 AJURICABA",0,0,1,69,0,70,"2010"
"4622","430030 ALECRIM",0,0,3,61,0,64,"2010"
"4623","430040 ALEGRETE",1,3,11,917,5,937,"2010"
"4624","430045 ALEGRIA",0,0,0,22,0,22,"2010"
"4625","430047 ALMIRANTE TAMANDARE DO SUL",0,0,0,16,0,16,"2010"
"4626","430050 ALPESTRE",0,0,0,80,0,80,"2010"
"4627","430055 ALTO ALEGRE",0,0,1,11,0,12,"2010"
"4628","430057 ALTO FELIZ",0,0,0,23,0,23,"2010"
"4629","430060 ALVORADA",5,11,54,2968,16,3054,"2010"
"4630","430063 AMARAL FERRADOR",0,0,2,68,0,70,"2010"
"4631","430064 AMETISTA DO SUL",0,0,0,70,0,70,"2010"
"4632","430066 ANDRE DA ROCHA",0,0,0,10,0,10,"2010"
"4633","430070 ANTA GORDA",0,0,0,41,0,41,"2010"
"4634","430080 ANTONIO PRADO",0,0,0,121,0,121,"2010"
"4635","430085 ARAMBARE",0,0,0,25,0,25,"2010"
"4636","430087 ARARICA",0,0,1,70,0,71,"2010"
"4637","430090 ARATIBA",0,0,0,49,0,49,"2010"
"4638","430100 ARROIO DO MEIO",0,2,2,211,0,215,"2010"
"4639","430105 ARROIO DO SAL",1,0,3,84,0,88,"2010"
"4640","430107 ARROIO DO PADRE",0,0,0,27,0,27,"2010"
"4641","430110 ARROIO DOS RATOS",0,1,3,159,0,163,"2010"
"4642","430120 ARROIO DO TIGRE",0,0,1,152,1,154,"2010"
"4643","430130 ARROIO GRANDE",0,1,6,199,1,207,"2010"
"4644","430140 ARVOREZINHA",0,2,5,114,0,121,"2010"
"4645","430150 AUGUSTO PESTANA",0,0,2,62,0,64,"2010"
"4646","430155 AUREA",0,0,0,23,0,23,"2010"
"4647","430160 BAGE",5,3,14,1514,9,1545,"2010"
"4648","430163 BALNEARIO PINHAL",0,0,4,111,1,116,"2010"
"4649","430165 BARAO",0,1,0,34,0,35,"2010"
"4650","430170 BARAO DE COTEGIPE",0,0,0,59,0,59,"2010"
"4651","430175 BARAO DO TRIUNFO",0,0,0,67,1,68,"2010"
"4652","430180 BARRACAO",0,1,0,58,0,59,"2010"
"4653","430185 BARRA DO GUARITA",1,0,0,32,0,33,"2010"
"4654","430187 BARRA DO QUARAI",0,0,1,28,19,48,"2010"
"4655","430190 BARRA DO RIBEIRO",0,1,1,125,3,130,"2010"
"4656","430192 BARRA DO RIO AZUL",0,0,0,11,0,11,"2010"
"4657","430195 BARRA FUNDA",0,0,0,25,0,25,"2010"
"4658","430200 BARROS CASSAL",0,0,4,121,0,125,"2010"
"4659","430205 BENJAMIN CONSTANT DO SUL",0,0,1,27,0,28,"2010"
"4660","430210 BENTO GONCALVES",3,2,26,1219,2,1252,"2010"
"4661","430215 BOA VISTA DAS MISSOES",0,0,0,31,0,31,"2010"
"4662","430220 BOA VISTA DO BURICA",0,0,0,55,0,55,"2010"
"4663","430222 BOA VISTA DO CADEADO",0,0,0,17,0,17,"2010"
"4664","430223 BOA VISTA DO INCRA",0,0,0,36,0,36,"2010"
"4665","430225 BOA VISTA DO SUL",0,0,1,9,0,10,"2010"
"4666","430230 BOM JESUS",1,2,6,156,1,166,"2010"
"4667","430235 BOM PRINCIPIO",0,1,1,113,0,115,"2010"
"4668","430237 BOM PROGRESSO",0,0,1,17,0,18,"2010"
"4669","430240 BOM RETIRO DO SUL",0,2,3,134,0,139,"2010"
"4670","430245 BOQUEIRAO DO LEAO",0,0,3,103,0,106,"2010"
"4671","430250 BOSSOROCA",0,0,0,66,0,66,"2010"
"4672","430258 BOZANO",0,0,0,15,0,15,"2010"
"4673","430260 BRAGA",0,0,2,49,0,51,"2010"
"4674","430265 BROCHIER",0,0,0,43,0,43,"2010"
"4675","430270 BUTIA",0,0,4,247,0,251,"2010"
"4676","430280 CACAPAVA DO SUL",2,0,3,364,5,374,"2010"
"4677","430290 CACEQUI",2,2,2,117,1,124,"2010"
"4678","430300 CACHOEIRA DO SUL",6,4,13,981,7,1011,"2010"
"4679","430310 CACHOEIRINHA",3,15,22,1627,6,1673,"2010"
"4680","430320 CACIQUE DOBLE",0,0,1,54,0,55,"2010"
"4681","430330 CAIBATE",0,0,2,45,0,47,"2010"
"4682","430340 CAICARA",0,0,0,56,0,56,"2010"
"4683","430350 CAMAQUA",1,0,13,702,11,727,"2010"
"4684","430355 CAMARGO",0,0,0,17,0,17,"2010"
"4685","430360 CAMBARA DO SUL",0,0,3,68,0,71,"2010"
"4686","430367 CAMPESTRE DA SERRA",0,0,0,14,1,15,"2010"
"4687","430370 CAMPINA DAS MISSOES",0,0,1,26,0,27,"2010"
"4688","430380 CAMPINAS DO SUL",0,0,1,47,0,48,"2010"
"4689","430390 CAMPO BOM",2,3,11,773,3,792,"2010"
"4690","430400 CAMPO NOVO",0,0,1,78,0,79,"2010"
"4691","430410 CAMPOS BORGES",0,1,0,26,0,27,"2010"
"4692","430420 CANDELARIA",0,0,11,325,1,337,"2010"
"4693","430430 CANDIDO GODOI",0,0,1,55,0,56,"2010"
"4694","430435 CANDIOTA",0,0,1,125,1,127,"2010"
"4695","430440 CANELA",0,2,10,535,3,550,"2010"
"4696","430450 CANGUCU",3,2,11,537,0,553,"2010"
"4697","430460 CANOAS",8,12,63,4706,23,4812,"2010"
"4698","430461 CANUDOS DO VALE",0,0,0,18,0,18,"2010"
"4699","430462 CAPAO BONITO DO SUL",0,0,0,3,0,3,"2010"
"4700","430463 CAPAO DA CANOA",3,3,16,748,0,770,"2010"
"4701","430465 CAPAO DO CIPO",0,0,0,36,0,36,"2010"
"4702","430466 CAPAO DO LEAO",1,2,10,296,1,310,"2010"
"4703","430467 CAPIVARI DO SUL",0,0,1,55,0,56,"2010"
"4704","430468 CAPELA DE SANTANA",0,0,2,103,0,105,"2010"
"4705","430469 CAPITAO",0,0,0,20,0,20,"2010"
"4706","430470 CARAZINHO",0,3,9,757,3,772,"2010"
"4707","430471 CARAA",1,0,1,54,0,56,"2010"
"4708","430480 CARLOS BARBOSA",0,1,0,246,1,248,"2010"
"4709","430485 CARLOS GOMES",0,0,1,13,0,14,"2010"
"4710","430490 CASCA",0,2,1,81,0,84,"2010"
"4711","430495 CASEIROS",0,0,0,8,0,8,"2010"
"4712","430500 CATUIPE",0,0,1,95,0,96,"2010"
"4713","430510 CAXIAS DO SUL",25,41,93,5871,13,6043,"2010"
"4714","430511 CENTENARIO",0,0,2,24,0,26,"2010"
"4715","430512 CERRITO",0,0,1,43,0,44,"2010"
"4716","430513 CERRO BRANCO",0,0,0,30,0,30,"2010"
"4717","430515 CERRO GRANDE",0,0,0,25,0,25,"2010"
"4718","430517 CERRO GRANDE DO SUL",0,2,0,130,0,132,"2010"
"4719","430520 CERRO LARGO",0,0,1,121,0,122,"2010"
"4720","430530 CHAPADA",0,0,0,88,0,88,"2010"
"4721","430535 CHARQUEADAS",0,2,9,392,1,404,"2010"
"4722","430537 CHARRUA",0,0,0,58,0,58,"2010"
"4723","430540 CHIAPETTA",0,0,1,37,0,38,"2010"
"4724","430543 CHUI",0,0,0,41,0,41,"2010"
"4725","430544 CHUVISCA",0,0,0,57,0,57,"2010"
"4726","430545 CIDREIRA",0,1,5,135,0,141,"2010"
"4727","430550 CIRIACO",0,0,1,42,0,43,"2010"
"4728","430558 COLINAS",0,0,0,14,0,14,"2010"
"4729","430560 COLORADO",0,1,0,24,0,25,"2010"
"4730","430570 CONDOR",0,0,0,25,0,25,"2010"
"4731","430580 CONSTANTINA",0,0,1,95,0,96,"2010"
"4732","430583 COQUEIRO BAIXO",0,0,0,5,0,5,"2010"
"4733","430585 COQUEIROS DO SUL",0,0,0,13,0,13,"2010"
"4734","430587 CORONEL BARROS",0,0,0,23,0,23,"2010"
"4735","430590 CORONEL BICACO",0,0,0,101,0,101,"2010"
"4736","430593 CORONEL PILAR",0,0,0,4,0,4,"2010"
"4737","430595 COTIPORA",0,0,0,20,0,20,"2010"
"4738","430597 COXILHA",0,0,0,30,0,30,"2010"
"4739","430600 CRISSIUMAL",0,1,1,115,0,117,"2010"
"4740","430605 CRISTAL",0,1,3,85,0,89,"2010"
"4741","430607 CRISTAL DO SUL",0,0,0,34,0,34,"2010"
"4742","430610 CRUZ ALTA",1,3,18,903,1,926,"2010"
"4743","430613 CRUZALTENSE",0,0,1,12,0,13,"2010"
"4744","430620 CRUZEIRO DO SUL",0,0,2,108,0,110,"2010"
"4745","430630 DAVID CANABARRO",0,0,1,33,1,35,"2010"
"4746","430632 DERRUBADAS",0,0,0,37,0,37,"2010"
"4747","430635 DEZESSEIS DE NOVEMBRO",0,0,0,21,0,21,"2010"
"4748","430637 DILERMANDO DE AGUIAR",0,0,0,31,0,31,"2010"
"4749","430640 DOIS IRMAOS",2,2,5,307,0,316,"2010"
"4750","430642 DOIS IRMAOS DAS MISSOES",0,0,1,37,0,38,"2010"
"4751","430645 DOIS LAJEADOS",0,0,0,26,0,26,"2010"
"4752","430650 DOM FELICIANO",0,0,4,171,1,176,"2010"
"4753","430655 DOM PEDRO DE ALCANTARA",0,0,0,17,0,17,"2010"
"4754","430660 DOM PEDRITO",2,0,12,475,3,492,"2010"
"4755","430670 DONA FRANCISCA",0,0,0,47,0,47,"2010"
"4756","430673 DOUTOR MAURICIO CARDOSO",1,1,2,36,1,41,"2010"
"4757","430675 DOUTOR RICARDO",0,0,0,15,0,15,"2010"
"4758","430676 ELDORADO DO SUL",1,6,14,510,0,531,"2010"
"4759","430680 ENCANTADO",0,3,0,210,0,213,"2010"
"4760","430690 ENCRUZILHADA DO SUL",1,2,4,268,3,278,"2010"
"4761","430692 ENGENHO VELHO",0,0,0,13,0,13,"2010"
"4762","430693 ENTRE-IJUIS",0,0,3,92,0,95,"2010"
"4763","430695 ENTRE RIOS DO SUL",0,0,0,27,0,27,"2010"
"4764","430697 EREBANGO",0,0,0,26,0,26,"2010"
"4765","430700 ERECHIM",0,2,25,1178,0,1205,"2010"
"4766","430705 ERNESTINA",0,0,1,27,0,28,"2010"
"4767","430710 HERVAL",0,0,5,81,1,87,"2010"
"4768","430720 ERVAL GRANDE",0,0,1,46,0,47,"2010"
"4769","430730 ERVAL SECO",0,0,1,96,0,97,"2010"
"4770","430740 ESMERALDA",0,0,2,30,6,38,"2010"
"4771","430745 ESPERANCA DO SUL",0,0,0,31,0,31,"2010"
"4772","430750 ESPUMOSO",1,0,3,194,0,198,"2010"
"4773","430755 ESTACAO",0,0,1,71,0,72,"2010"
"4774","430760 ESTANCIA VELHA",1,2,10,557,1,571,"2010"
"4775","430770 ESTEIO",0,3,25,1101,2,1131,"2010"
"4776","430780 ESTRELA",1,1,5,370,0,377,"2010"
"4777","430781 ESTRELA VELHA",0,0,0,37,1,38,"2010"
"4778","430783 EUGENIO DE CASTRO",0,0,0,19,0,19,"2010"
"4779","430786 FAGUNDES VARELA",0,0,0,20,0,20,"2010"
"4780","430790 FARROUPILHA",4,2,13,741,0,760,"2010"
"4781","430800 FAXINAL DO SOTURNO",0,0,0,63,0,63,"2010"
"4782","430805 FAXINALZINHO",0,0,0,22,0,22,"2010"
"4783","430807 FAZENDA VILANOVA",0,0,3,50,0,53,"2010"
"4784","430810 FELIZ",0,0,3,131,0,134,"2010"
"4785","430820 FLORES DA CUNHA",0,0,1,292,0,293,"2010"
"4786","430825 FLORIANO PEIXOTO",0,0,0,11,0,11,"2010"
"4787","430830 FONTOURA XAVIER",0,1,2,118,1,122,"2010"
"4788","430840 FORMIGUEIRO",0,0,2,54,0,56,"2010"
"4789","430843 FORQUETINHA",0,0,0,10,0,10,"2010"
"4790","430845 FORTALEZA DOS VALOS",0,1,0,47,1,49,"2010"
"4791","430850 FREDERICO WESTPHALEN",0,2,7,325,0,334,"2010"
"4792","430860 GARIBALDI",1,0,4,291,0,296,"2010"
"4793","430865 GARRUCHOS",0,1,0,35,1,37,"2010"
"4794","430870 GAURAMA",0,0,1,45,0,46,"2010"
"4795","430880 GENERAL CAMARA",0,0,2,77,0,79,"2010"
"4796","430885 GENTIL",0,0,0,15,0,15,"2010"
"4797","430890 GETULIO VARGAS",0,0,5,166,0,171,"2010"
"4798","430900 GIRUA",0,0,2,207,1,210,"2010"
"4799","430905 GLORINHA",0,0,1,89,0,90,"2010"
"4800","430910 GRAMADO",1,2,11,442,0,456,"2010"
"4801","430912 GRAMADO DOS LOUREIROS",0,0,0,36,0,36,"2010"
"4802","430915 GRAMADO XAVIER",0,0,3,39,0,42,"2010"
"4803","430920 GRAVATAI",4,10,51,3219,2,3286,"2010"
"4804","430925 GUABIJU",0,0,0,9,0,9,"2010"
"4805","430930 GUAIBA",0,7,28,1204,12,1251,"2010"
"4806","430940 GUAPORE",0,1,0,250,0,251,"2010"
"4807","430950 GUARANI DAS MISSOES",0,2,1,72,0,75,"2010"
"4808","430955 HARMONIA",0,0,0,27,0,27,"2010"
"4809","430957 HERVEIRAS",0,0,2,27,0,29,"2010"
"4810","430960 HORIZONTINA",0,1,2,196,0,199,"2010"
"4811","430965 HULHA NEGRA",0,1,0,94,0,95,"2010"
"4812","430970 HUMAITA",0,0,0,43,0,43,"2010"
"4813","430975 IBARAMA",0,0,0,58,0,58,"2010"
"4814","430980 IBIACA",0,0,0,35,0,35,"2010"
"4815","430990 IBIRAIARAS",0,0,1,20,0,21,"2010"
"4816","430995 IBIRAPUITA",0,0,1,41,0,42,"2010"
"4817","431000 IBIRUBA",3,0,2,220,0,225,"2010"
"4818","431010 IGREJINHA",2,2,5,505,0,514,"2010"
"4819","431020 IJUI",3,7,13,954,2,979,"2010"
"4820","431030 ILOPOLIS",0,1,1,45,0,47,"2010"
"4821","431033 IMBE",0,0,4,247,0,251,"2010"
"4822","431036 IMIGRANTE",0,2,3,20,0,25,"2010"
"4823","431040 INDEPENDENCIA",0,0,2,37,0,39,"2010"
"4824","431041 INHACORA",0,1,0,31,0,32,"2010"
"4825","431043 IPE",0,2,1,73,0,76,"2010"
"4826","431046 IPIRANGA DO SUL",0,0,1,16,0,17,"2010"
"4827","431050 IRAI",0,0,0,102,0,102,"2010"
"4828","431053 ITAARA",1,0,0,60,0,61,"2010"
"4829","431055 ITACURUBI",0,0,0,35,0,35,"2010"
"4830","431057 ITAPUCA",0,0,0,18,1,19,"2010"
"4831","431060 ITAQUI",1,0,2,114,494,611,"2010"
"4832","431065 ITATI",0,0,0,19,0,19,"2010"
"4833","431070 ITATIBA DO SUL",0,0,1,43,0,44,"2010"
"4834","431075 IVORA",0,0,1,13,0,14,"2010"
"4835","431080 IVOTI",2,3,4,236,0,245,"2010"
"4836","431085 JABOTICABA",0,0,0,36,1,37,"2010"
"4837","431087 JACUIZINHO",0,0,0,27,0,27,"2010"
"4838","431090 JACUTINGA",0,0,0,21,0,21,"2010"
"4839","431100 JAGUARAO",0,0,4,360,0,364,"2010"
"4840","431110 JAGUARI",0,0,0,109,0,109,"2010"
"4841","431112 JAQUIRANA",0,0,2,63,1,66,"2010"
"4842","431113 JARI",0,0,2,43,0,45,"2010"
"4843","431115 JOIA",0,1,3,98,2,104,"2010"
"4844","431120 JULIO DE CASTILHOS",3,1,0,259,2,265,"2010"
"4845","431123 LAGOA BONITA DO SUL",0,0,1,27,0,28,"2010"
"4846","431125 LAGOAO",1,0,1,77,1,80,"2010"
"4847","431127 LAGOA DOS TRES CANTOS",0,0,2,7,0,9,"2010"
"4848","431130 LAGOA VERMELHA",1,2,5,404,0,412,"2010"
"4849","431140 LAJEADO",0,1,12,806,1,820,"2010"
"4850","431142 LAJEADO DO BUGRE",0,0,0,40,0,40,"2010"
"4851","431150 LAVRAS DO SUL",1,1,1,79,1,83,"2010"
"4852","431160 LIBERATO SALZANO",0,0,2,56,0,58,"2010"
"4853","431162 LINDOLFO COLLOR",0,0,1,68,0,69,"2010"
"4854","431164 LINHA NOVA",0,0,0,9,0,9,"2010"
"4855","431170 MACHADINHO",0,1,1,52,0,54,"2010"
"4856","431171 MACAMBARA",1,0,2,47,7,57,"2010"
"4857","431173 MAMPITUBA",0,2,1,37,0,40,"2010"
"4858","431175 MANOEL VIANA",0,1,1,91,1,94,"2010"
"4859","431177 MAQUINE",0,0,1,66,1,68,"2010"
"4860","431179 MARATA",0,0,0,19,0,19,"2010"
"4861","431180 MARAU",1,4,4,488,0,497,"2010"
"4862","431190 MARCELINO RAMOS",0,0,0,48,0,48,"2010"
"4863","431198 MARIANA PIMENTEL",0,0,1,28,0,29,"2010"
"4864","431200 MARIANO MORO",0,0,0,13,0,13,"2010"
"4865","431205 MARQUES DE SOUZA",0,0,1,31,0,32,"2010"
"4866","431210 MATA",0,0,2,61,1,64,"2010"
"4867","431213 MATO CASTELHANO",0,2,0,41,0,43,"2010"
"4868","431215 MATO LEITAO",0,0,0,35,0,35,"2010"
"4869","431217 MATO QUEIMADO",0,0,1,21,0,22,"2010"
"4870","431220 MAXIMILIANO DE ALMEIDA",0,0,1,44,0,45,"2010"
"4871","431225 MINAS DO LEAO",0,0,2,98,0,100,"2010"
"4872","431230 MIRAGUAI",0,0,0,51,0,51,"2010"
"4873","431235 MONTAURI",0,0,0,14,0,14,"2010"
"4874","431237 MONTE ALEGRE DOS CAMPOS",0,0,1,26,5,32,"2010"
"4875","431238 MONTE BELO DO SUL",0,0,0,19,0,19,"2010"
"4876","431240 MONTENEGRO",2,2,4,799,1,808,"2010"
"4877","431242 MORMACO",0,0,0,32,0,32,"2010"
"4878","431244 MORRINHOS DO SUL",0,1,1,20,0,22,"2010"
"4879","431245 MORRO REDONDO",0,1,0,59,0,60,"2010"
"4880","431247 MORRO REUTER",0,0,1,42,0,43,"2010"
"4881","431250 MOSTARDAS",0,0,2,122,0,124,"2010"
"4882","431260 MUCUM",0,0,0,34,0,34,"2010"
"4883","431261 MUITOS CAPOES",0,1,0,28,4,33,"2010"
"4884","431262 MULITERNO",0,0,1,21,0,22,"2010"
"4885","431265 NAO-ME-TOQUE",0,0,5,164,0,169,"2010"
"4886","431267 NICOLAU VERGUEIRO",0,0,0,22,0,22,"2010"
"4887","431270 NONOAI",1,1,1,144,0,147,"2010"
"4888","431275 NOVA ALVORADA",0,0,0,25,0,25,"2010"
"4889","431280 NOVA ARACA",0,0,0,32,0,32,"2010"
"4890","431290 NOVA BASSANO",0,1,1,82,0,84,"2010"
"4891","431295 NOVA BOA VISTA",0,0,0,8,0,8,"2010"
"4892","431300 NOVA BRESCIA",0,0,0,18,0,18,"2010"
"4893","431301 NOVA CANDELARIA",0,0,0,25,0,25,"2010"
"4894","431303 NOVA ESPERANCA DO SUL",0,0,1,51,0,52,"2010"
"4895","431306 NOVA HARTZ",1,1,4,279,0,285,"2010"
"4896","431308 NOVA PADUA",0,0,0,14,0,14,"2010"
"4897","431310 NOVA PALMA",0,0,0,71,0,71,"2010"
"4898","431320 NOVA PETROPOLIS",1,2,6,161,0,170,"2010"
"4899","431330 NOVA PRATA",0,0,1,279,0,280,"2010"
"4900","431333 NOVA RAMADA",0,0,0,29,0,29,"2010"
"4901","431335 NOVA ROMA DO SUL",0,0,0,19,0,19,"2010"
"4902","431337 NOVA SANTA RITA",0,2,3,283,1,289,"2010"
"4903","431339 NOVO CABRAIS",0,0,0,42,0,42,"2010"
"4904","431340 NOVO HAMBURGO",7,13,42,2889,2,2953,"2010"
"4905","431342 NOVO MACHADO",0,0,3,32,1,36,"2010"
"4906","431344 NOVO TIRADENTES",0,0,0,29,0,29,"2010"
"4907","431346 NOVO XINGU",0,0,1,15,0,16,"2010"
"4908","431349 NOVO BARREIRO",1,0,0,43,0,44,"2010"
"4909","431350 OSORIO",0,1,8,516,0,525,"2010"
"4910","431360 PAIM FILHO",0,0,0,31,0,31,"2010"
"4911","431365 PALMARES DO SUL",0,2,1,110,0,113,"2010"
"4912","431370 PALMEIRA DAS MISSOES",1,1,6,480,1,489,"2010"
"4913","431380 PALMITINHO",0,1,0,72,0,73,"2010"
"4914","431390 PANAMBI",0,1,8,525,1,535,"2010"
"4915","431395 PANTANO GRANDE",0,0,4,93,1,98,"2010"
"4916","431400 PARAI",0,1,1,69,0,71,"2010"
"4917","431402 PARAISO DO SUL",0,0,0,66,0,66,"2010"
"4918","431403 PARECI NOVO",0,0,0,20,0,20,"2010"
"4919","431405 PAROBE",2,5,9,767,2,785,"2010"
"4920","431406 PASSA SETE",0,0,1,64,0,65,"2010"
"4921","431407 PASSO DO SOBRADO",0,0,3,59,0,62,"2010"
"4922","431410 PASSO FUNDO",5,15,64,2511,7,2602,"2010"
"4923","431413 PAULO BENTO",0,0,2,17,0,19,"2010"
"4924","431415 PAVERAMA",0,0,1,63,0,64,"2010"
"4925","431417 PEDRAS ALTAS",0,0,0,15,1,16,"2010"
"4926","431420 PEDRO OSORIO",0,0,4,94,0,98,"2010"
"4927","431430 PEJUCARA",0,0,1,45,0,46,"2010"
"4928","431440 PELOTAS",8,19,96,3772,19,3914,"2010"
"4929","431442 PICADA CAFE",0,1,1,47,0,49,"2010"
"4930","431445 PINHAL",0,0,0,28,0,28,"2010"
"4931","431446 PINHAL DA SERRA",0,0,0,22,2,24,"2010"
"4932","431447 PINHAL GRANDE",0,0,0,55,0,55,"2010"
"4933","431449 PINHEIRINHO DO VALE",0,0,0,50,0,50,"2010"
"4934","431450 PINHEIRO MACHADO",1,1,2,124,2,130,"2010"
"4935","431455 PIRAPO",0,0,0,19,0,19,"2010"
"4936","431460 PIRATINI",0,3,2,195,1,201,"2010"
"4937","431470 PLANALTO",0,0,2,136,0,138,"2010"
"4938","431475 POCO DAS ANTAS",0,0,1,18,0,19,"2010"
"4939","431477 PONTAO",0,0,1,42,0,43,"2010"
"4940","431478 PONTE PRETA",0,0,1,17,0,18,"2010"
"4941","431480 PORTAO",1,1,4,359,0,365,"2010"
"4942","431490 PORTO ALEGRE",27,92,372,17754,76,18321,"2010"
"4943","431500 PORTO LUCENA",0,0,0,29,0,29,"2010"
"4944","431505 PORTO MAUA",0,0,0,21,0,21,"2010"
"4945","431507 PORTO VERA CRUZ",0,0,1,15,0,16,"2010"
"4946","431510 PORTO XAVIER",0,0,0,134,0,134,"2010"
"4947","431513 POUSO NOVO",0,0,0,19,0,19,"2010"
"4948","431514 PRESIDENTE LUCENA",0,0,0,16,0,16,"2010"
"4949","431515 PROGRESSO",0,0,6,68,0,74,"2010"
"4950","431517 PROTASIO ALVES",0,0,0,13,0,13,"2010"
"4951","431520 PUTINGA",0,0,0,31,0,31,"2010"
"4952","431530 QUARAI",2,4,17,261,1,285,"2010"
"4953","431531 QUATRO IRMAOS",0,0,1,24,0,25,"2010"
"4954","431532 QUEVEDOS",0,0,0,18,0,18,"2010"
"4955","431535 QUINZE DE NOVEMBRO",0,0,0,44,0,44,"2010"
"4956","431540 REDENTORA",0,0,2,166,10,178,"2010"
"4957","431545 RELVADO",0,0,0,10,0,10,"2010"
"4958","431550 RESTINGA SECA",0,1,0,172,0,173,"2010"
"4959","431555 RIO DOS INDIOS",0,0,1,25,0,26,"2010"
"4960","431560 RIO GRANDE",4,14,65,2348,105,2536,"2010"
"4961","431570 RIO PARDO",1,2,3,347,0,353,"2010"
"4962","431575 RIOZINHO",0,0,1,37,0,38,"2010"
"4963","431580 ROCA SALES",0,0,1,88,0,89,"2010"
"4964","431590 RODEIO BONITO",0,1,0,77,0,78,"2010"
"4965","431595 ROLADOR",0,0,1,25,0,26,"2010"
"4966","431600 ROLANTE",1,4,5,223,1,234,"2010"
"4967","431610 RONDA ALTA",0,0,4,123,0,127,"2010"
"4968","431620 RONDINHA",0,2,0,50,0,52,"2010"
"4969","431630 ROQUE GONZALES",0,1,0,77,1,79,"2010"
"4970","431640 ROSARIO DO SUL",0,2,4,408,1,415,"2010"
"4971","431642 SAGRADA FAMILIA",0,1,0,36,0,37,"2010"
"4972","431643 SALDANHA MARINHO",0,0,0,24,0,24,"2010"
"4973","431645 SALTO DO JACUI",0,0,2,164,2,168,"2010"
"4974","431647 SALVADOR DAS MISSOES",0,0,2,16,0,18,"2010"
"4975","431650 SALVADOR DO SUL",0,0,2,70,0,72,"2010"
"4976","431660 SANANDUVA",2,1,3,166,0,172,"2010"
"4977","431670 SANTA BARBARA DO SUL",0,2,0,96,0,98,"2010"
"4978","431673 SANTA CECILIA DO SUL",0,0,0,12,0,12,"2010"
"4979","431675 SANTA CLARA DO SUL",0,0,1,42,0,43,"2010"
"4980","431680 SANTA CRUZ DO SUL",2,4,17,1422,2,1447,"2010"
"4981","431690 SANTA MARIA",4,9,47,3235,5,3300,"2010"
"4982","431695 SANTA MARIA DO HERVAL",0,0,0,36,0,36,"2010"
"4983","431697 SANTA MARGARIDA DO SUL",0,0,0,17,0,17,"2010"
"4984","431700 SANTANA DA BOA VISTA",1,1,2,71,1,76,"2010"
"4985","431710 SANT'ANA DO LIVRAMENTO",4,5,16,1048,11,1084,"2010"
"4986","431720 SANTA ROSA",4,0,21,820,1,846,"2010"
"4987","431725 SANTA TEREZA",0,0,0,12,0,12,"2010"
"4988","431730 SANTA VITORIA DO PALMAR",1,2,9,320,3,335,"2010"
"4989","431740 SANTIAGO",0,2,5,560,0,567,"2010"
"4990","431750 SANTO ANGELO",2,2,7,922,2,935,"2010"
"4991","431755 SANTO ANTONIO DO PALMA",0,0,0,11,0,11,"2010"
"4992","431760 SANTO ANTONIO DA PATRULHA",0,2,6,373,3,384,"2010"
"4993","431770 SANTO ANTONIO DAS MISSOES",2,2,1,115,2,122,"2010"
"4994","431775 SANTO ANTONIO DO PLANALTO",0,0,1,22,0,23,"2010"
"4995","431780 SANTO AUGUSTO",0,0,1,168,0,169,"2010"
"4996","431790 SANTO CRISTO",0,0,6,142,0,148,"2010"
"4997","431795 SANTO EXPEDITO DO SUL",0,0,0,29,0,29,"2010"
"4998","431800 SAO BORJA",1,2,6,744,41,794,"2010"
"4999","431805 SAO DOMINGOS DO SUL",0,0,0,25,0,25,"2010"
"5000","431810 SAO FRANCISCO DE ASSIS",0,0,0,176,0,176,"2010"
"5001","431820 SAO FRANCISCO DE PAULA",0,0,5,277,0,282,"2010"
"5002","431830 SAO GABRIEL",1,1,15,727,4,748,"2010"
"5003","431840 SAO JERONIMO",0,0,2,264,0,266,"2010"
"5004","431842 SAO JOAO DA URTIGA",0,0,0,31,0,31,"2010"
"5005","431843 SAO JOAO DO POLESINE",0,1,0,19,0,20,"2010"
"5006","431844 SAO JORGE",0,0,0,29,0,29,"2010"
"5007","431845 SAO JOSE DAS MISSOES",0,1,0,33,0,34,"2010"
"5008","431846 SAO JOSE DO HERVAL",0,0,0,14,0,14,"2010"
"5009","431848 SAO JOSE DO HORTENCIO",0,0,0,37,0,37,"2010"
"5010","431849 SAO JOSE DO INHACORA",0,0,0,17,0,17,"2010"
"5011","431850 SAO JOSE DO NORTE",0,3,5,275,7,290,"2010"
"5012","431860 SAO JOSE DO OURO",1,0,0,66,0,67,"2010"
"5013","431861 SAO JOSE DO SUL",0,0,0,22,0,22,"2010"
"5014","431862 SAO JOSE DOS AUSENTES",0,0,1,40,4,45,"2010"
"5015","431870 SAO LEOPOLDO",1,18,36,2886,9,2950,"2010"
"5016","431880 SAO LOURENCO DO SUL",1,1,7,476,1,486,"2010"
"5017","431890 SAO LUIZ GONZAGA",1,3,2,415,0,421,"2010"
"5018","431900 SAO MARCOS",0,0,1,233,0,234,"2010"
"5019","431910 SAO MARTINHO",0,0,0,62,0,62,"2010"
"5020","431912 SAO MARTINHO DA SERRA",0,0,0,28,0,28,"2010"
"5021","431915 SAO MIGUEL DAS MISSOES",0,2,0,90,0,92,"2010"
"5022","431920 SAO NICOLAU",1,0,2,63,0,66,"2010"
"5023","431930 SAO PAULO DAS MISSOES",0,0,0,62,0,62,"2010"
"5024","431935 SAO PEDRO DA SERRA",0,0,0,32,0,32,"2010"
"5025","431936 SAO PEDRO DAS MISSOES",0,0,1,16,0,17,"2010"
"5026","431937 SAO PEDRO DO BUTIA",0,0,0,22,0,22,"2010"
"5027","431940 SAO PEDRO DO SUL",1,0,2,168,0,171,"2010"
"5028","431950 SAO SEBASTIAO DO CAI",2,2,4,307,0,315,"2010"
"5029","431960 SAO SEPE",1,0,2,292,0,295,"2010"
"5030","431970 SAO VALENTIM",0,0,1,25,0,26,"2010"
"5031","431971 SAO VALENTIM DO SUL",0,0,0,4,0,4,"2010"
"5032","431973 SAO VALERIO DO SUL",0,0,0,43,0,43,"2010"
"5033","431975 SAO VENDELINO",0,0,1,13,0,14,"2010"
"5034","431980 SAO VICENTE DO SUL",0,1,0,80,0,81,"2010"
"5035","431990 SAPIRANGA",1,5,21,1064,2,1093,"2010"
"5036","432000 SAPUCAIA DO SUL",3,6,31,1560,1,1601,"2010"
"5037","432010 SARANDI",0,1,7,261,0,269,"2010"
"5038","432020 SEBERI",0,1,1,133,0,135,"2010"
"5039","432023 SEDE NOVA",0,1,0,23,0,24,"2010"
"5040","432026 SEGREDO",0,1,0,117,0,118,"2010"
"5041","432030 SELBACH",0,0,2,50,0,52,"2010"
"5042","432032 SENADOR SALGADO FILHO",0,0,0,37,0,37,"2010"
"5043","432035 SENTINELA DO SUL",0,0,0,54,0,54,"2010"
"5044","432040 SERAFINA CORREA",0,0,1,172,0,173,"2010"
"5045","432045 SERIO",0,0,0,26,0,26,"2010"
"5046","432050 SERTAO",0,0,1,43,0,44,"2010"
"5047","432055 SERTAO SANTANA",1,0,1,63,0,65,"2010"
"5048","432057 SETE DE SETEMBRO",0,0,0,19,0,19,"2010"
"5049","432060 SEVERIANO DE ALMEIDA",0,0,1,32,0,33,"2010"
"5050","432065 SILVEIRA MARTINS",0,0,0,28,0,28,"2010"
"5051","432067 SINIMBU",0,0,0,71,0,71,"2010"
"5052","432070 SOBRADINHO",0,0,0,157,0,157,"2010"
"5053","432080 SOLEDADE",1,2,8,363,0,374,"2010"
"5054","432085 TABAI",0,0,0,51,0,51,"2010"
"5055","432090 TAPEJARA",1,1,1,217,0,220,"2010"
"5056","432100 TAPERA",1,2,1,147,0,151,"2010"
"5057","432110 TAPES",0,0,5,174,0,179,"2010"
"5058","432120 TAQUARA",1,5,12,560,3,581,"2010"
"5059","432130 TAQUARI",1,3,4,283,0,291,"2010"
"5060","432132 TAQUARUCU DO SUL",1,0,0,31,0,32,"2010"
"5061","432135 TAVARES",0,0,0,32,0,32,"2010"
"5062","432140 TENENTE PORTELA",0,0,2,181,0,183,"2010"
"5063","432143 TERRA DE AREIA",0,0,1,94,0,95,"2010"
"5064","432145 TEUTONIA",0,0,2,340,0,342,"2010"
"5065","432146 TIO HUGO",0,0,0,34,0,34,"2010"
"5066","432147 TIRADENTES DO SUL",2,0,0,70,0,72,"2010"
"5067","432149 TOROPI",0,0,0,32,0,32,"2010"
"5068","432150 TORRES",0,2,6,448,0,456,"2010"
"5069","432160 TRAMANDAI",1,2,9,598,0,610,"2010"
"5070","432162 TRAVESSEIRO",0,0,0,15,0,15,"2010"
"5071","432163 TRES ARROIOS",0,0,2,13,0,15,"2010"
"5072","432166 TRES CACHOEIRAS",0,0,0,106,0,106,"2010"
"5073","432170 TRES COROAS",0,3,3,334,1,341,"2010"
"5074","432180 TRES DE MAIO",0,1,3,274,0,278,"2010"
"5075","432183 TRES FORQUILHAS",0,0,0,25,0,25,"2010"
"5076","432185 TRES PALMEIRAS",0,0,2,50,0,52,"2010"
"5077","432190 TRES PASSOS",1,0,1,249,0,251,"2010"
"5078","432195 TRINDADE DO SUL",0,0,0,66,0,66,"2010"
"5079","432200 TRIUNFO",1,2,4,383,0,390,"2010"
"5080","432210 TUCUNDUVA",0,0,1,45,0,46,"2010"
"5081","432215 TUNAS",0,0,0,54,0,54,"2010"
"5082","432218 TUPANCI DO SUL",0,0,0,7,0,7,"2010"
"5083","432220 TUPANCIRETA",1,5,15,297,0,318,"2010"
"5084","432225 TUPANDI",0,0,0,46,0,46,"2010"
"5085","432230 TUPARENDI",0,0,0,70,0,70,"2010"
"5086","432232 TURUCU",0,0,0,22,0,22,"2010"
"5087","432234 UBIRETAMA",0,0,0,26,0,26,"2010"
"5088","432235 UNIAO DA SERRA",0,0,2,8,0,10,"2010"
"5089","432237 UNISTALDA",0,0,0,27,1,28,"2010"
"5090","432240 URUGUAIANA",1,9,15,1159,791,1975,"2010"
"5091","432250 VACARIA",1,2,19,754,110,886,"2010"
"5092","432252 VALE VERDE",0,0,0,32,0,32,"2010"
"5093","432253 VALE DO SOL",1,0,0,65,0,66,"2010"
"5094","432254 VALE REAL",0,0,1,67,0,68,"2010"
"5095","432255 VANINI",1,0,0,23,0,24,"2010"
"5096","432260 VENANCIO AIRES",4,1,13,720,0,738,"2010"
"5097","432270 VERA CRUZ",0,1,4,260,0,265,"2010"
"5098","432280 VERANOPOLIS",3,0,3,224,0,230,"2010"
"5099","432285 VESPASIANO CORREA",0,0,0,24,0,24,"2010"
"5100","432290 VIADUTOS",0,0,1,38,0,39,"2010"
"5101","432300 VIAMAO",19,19,71,3083,31,3223,"2010"
"5102","432310 VICENTE DUTRA",0,0,1,74,0,75,"2010"
"5103","432320 VICTOR GRAEFF",1,0,2,17,1,21,"2010"
"5104","432330 VILA FLORES",0,0,0,33,0,33,"2010"
"5105","432335 VILA LANGARO",0,0,0,13,0,13,"2010"
"5106","432340 VILA MARIA",0,0,0,30,0,30,"2010"
"5107","432345 VILA NOVA DO SUL",0,0,0,48,2,50,"2010"
"5108","432350 VISTA ALEGRE",0,0,0,18,0,18,"2010"
"5109","432360 VISTA ALEGRE DO PRATA",0,0,0,14,0,14,"2010"
"5110","432370 VISTA GAUCHA",0,0,0,22,0,22,"2010"
"5111","432375 VITORIA DAS MISSOES",1,0,0,43,0,44,"2010"
"5112","432377 WESTFALIA",0,0,0,25,0,25,"2010"
"5113","432380 XANGRI-LA",0,1,7,165,1,174,"2010"
"5114","MUNICIPIO IGNORADO - MS",0,0,0,1,0,1,"2010"
"5115","500020 AGUA CLARA",0,0,3,267,1,271,"2010"
"5116","500025 ALCINOPOLIS",0,0,0,42,0,42,"2010"
"5117","500060 AMAMBAI",0,1,11,700,0,712,"2010"
"5118","500070 ANASTACIO",1,0,3,334,50,388,"2010"
"5119","500080 ANAURILANDIA",0,0,2,88,0,90,"2010"
"5120","500085 ANGELICA",0,0,2,122,0,124,"2010"
"5121","500090 ANTONIO JOAO",0,0,5,153,0,158,"2010"
"5122","500100 APARECIDA DO TABOADO",0,1,9,299,0,309,"2010"
"5123","500110 AQUIDAUANA",6,3,10,755,21,795,"2010"
"5124","500124 ARAL MOREIRA",1,57,6,109,3,176,"2010"
"5125","500150 BANDEIRANTES",0,0,0,75,0,75,"2010"
"5126","500190 BATAGUASSU",1,0,3,300,0,304,"2010"
"5127","500200 BATAYPORA",0,0,6,189,0,195,"2010"
"5128","500210 BELA VISTA",0,5,7,441,2,455,"2010"
"5129","500215 BODOQUENA",0,0,1,128,0,129,"2010"
"5130","500220 BONITO",0,1,0,333,1,335,"2010"
"5131","500230 BRASILANDIA",1,0,2,190,0,193,"2010"
"5132","500240 CAARAPO",29,3,1,503,0,536,"2010"
"5133","500260 CAMAPUA",1,0,2,188,2,193,"2010"
"5134","500270 CAMPO GRANDE",15,28,138,12253,365,12799,"2010"
"5135","500280 CARACOL",0,1,0,72,0,73,"2010"
"5136","500290 CASSILANDIA",0,0,1,267,0,268,"2010"
"5137","500295 CHAPADAO DO SUL",4,1,3,351,0,359,"2010"
"5138","500310 CORGUINHO",0,0,0,41,1,42,"2010"
"5139","500315 CORONEL SAPUCAIA",0,1,3,291,5,300,"2010"
"5140","500320 CORUMBA",6,12,25,1920,1,1964,"2010"
"5141","500325 COSTA RICA",1,1,5,315,2,324,"2010"
"5142","500330 COXIM",0,4,6,515,1,526,"2010"
"5143","500345 DEODAPOLIS",0,2,4,177,0,183,"2010"
"5144","500348 DOIS IRMAOS DO BURITI",1,0,0,85,40,126,"2010"
"5145","500350 DOURADINA",0,2,2,60,2,66,"2010"
"5146","500370 DOURADOS",4,16,84,2856,16,2976,"2010"
"5147","500375 ELDORADO",1,0,0,223,0,224,"2010"
"5148","500380 FATIMA DO SUL",0,1,4,241,0,246,"2010"
"5149","500390 FIGUEIRAO",0,0,0,24,0,24,"2010"
"5150","500400 GLORIA DE DOURADOS",1,0,3,102,0,106,"2010"
"5151","500410 GUIA LOPES DA LAGUNA",0,1,3,176,3,183,"2010"
"5152","500430 IGUATEMI",2,0,5,268,1,276,"2010"
"5153","500440 INOCENCIA",0,0,3,102,1,106,"2010"
"5154","500450 ITAPORA",0,1,3,170,1,175,"2010"
"5155","500460 ITAQUIRAI",0,1,2,252,0,255,"2010"
"5156","500470 IVINHEMA",2,2,8,310,0,322,"2010"
"5157","500480 JAPORA",0,0,2,210,24,236,"2010"
"5158","500490 JARAGUARI",0,0,0,49,1,50,"2010"
"5159","500500 JARDIM",1,0,1,415,6,423,"2010"
"5160","500510 JATEI",0,3,1,48,0,52,"2010"
"5161","500515 JUTI",0,0,1,86,0,87,"2010"
"5162","500520 LADARIO",1,2,4,387,0,394,"2010"
"5163","500525 LAGUNA CARAPA",1,1,0,107,5,114,"2010"
"5164","500540 MARACAJU",0,2,13,570,1,586,"2010"
"5165","500560 MIRANDA",2,3,14,515,3,537,"2010"
"5166","500568 MUNDO NOVO",0,2,3,208,0,213,"2010"
"5167","500570 NAVIRAI",1,2,18,863,1,885,"2010"
"5168","500580 NIOAQUE",0,0,2,157,14,173,"2010"
"5169","500600 NOVA ALVORADA DO SUL",0,1,6,307,1,315,"2010"
"5170","500620 NOVA ANDRADINA",0,4,3,650,29,686,"2010"
"5171","500625 NOVO HORIZONTE DO SUL",0,1,2,62,0,65,"2010"
"5172","500630 PARANAIBA",1,2,7,489,0,499,"2010"
"5173","500635 PARANHOS",1,2,1,233,21,258,"2010"
"5174","500640 PEDRO GOMES",0,0,2,92,0,94,"2010"
"5175","500660 PONTA PORA",8,14,35,1432,367,1856,"2010"
"5176","500690 PORTO MURTINHO",0,1,5,248,11,265,"2010"
"5177","500710 RIBAS DO RIO PARDO",1,2,2,272,2,279,"2010"
"5178","500720 RIO BRILHANTE",2,0,10,544,0,556,"2010"
"5179","500730 RIO NEGRO",0,0,0,34,1,35,"2010"
"5180","500740 RIO VERDE DE MATO GROSSO",1,2,1,242,2,248,"2010"
"5181","500750 ROCHEDO",0,0,0,60,3,63,"2010"
"5182","500755 SANTA RITA DO PARDO",0,0,0,101,1,102,"2010"
"5183","500769 SAO GABRIEL DO OESTE",1,1,6,366,3,377,"2010"
"5184","500770 SETE QUEDAS",0,1,2,158,12,173,"2010"
"5185","500780 SELVIRIA",0,0,2,57,0,59,"2010"
"5186","500790 SIDROLANDIA",0,0,9,678,5,692,"2010"
"5187","500793 SONORA",1,1,3,262,0,267,"2010"
"5188","500795 TACURU",4,1,4,208,0,217,"2010"
"5189","500797 TAQUARUSSU",0,0,0,34,0,34,"2010"
"5190","500800 TERENOS",1,1,2,163,8,175,"2010"
"5191","500830 TRES LAGOAS",1,5,9,1586,2,1603,"2010"
"5192","500840 VICENTINA",0,1,0,59,0,60,"2010"
"5193","MUNICIPIO IGNORADO - MT",0,0,0,2,0,2,"2010"
"5194","510010 ACORIZAL",0,0,0,55,1,56,"2010"
"5195","510020 AGUA BOA",2,0,3,271,4,280,"2010"
"5196","510025 ALTA FLORESTA",1,2,10,835,1,849,"2010"
"5197","510030 ALTO ARAGUAIA",1,0,2,226,0,229,"2010"
"5198","510035 ALTO BOA VISTA",0,0,0,45,0,45,"2010"
"5199","510040 ALTO GARCAS",0,1,2,123,0,126,"2010"
"5200","510050 ALTO PARAGUAI",0,0,2,91,0,93,"2010"
"5201","510060 ALTO TAQUARI",0,0,4,157,0,161,"2010"
"5202","510080 APIACAS",0,2,6,125,0,133,"2010"
"5203","510100 ARAGUAIANA",0,0,0,31,0,31,"2010"
"5204","510120 ARAGUAINHA",0,0,1,10,0,11,"2010"
"5205","510125 ARAPUTANGA",0,0,1,271,0,272,"2010"
"5206","510130 ARENAPOLIS",1,2,5,130,0,138,"2010"
"5207","510140 ARIPUANA",1,3,5,377,0,386,"2010"
"5208","510160 BARAO DE MELGACO",0,0,0,58,1,59,"2010"
"5209","510170 BARRA DO BUGRES",2,9,12,517,6,546,"2010"
"5210","510180 BARRA DO GARCAS",0,4,7,818,9,838,"2010"
"5211","510185 BOM JESUS DO ARAGUAIA",0,0,1,65,0,66,"2010"
"5212","510190 BRASNORTE",0,2,1,225,19,247,"2010"
"5213","510250 CACERES",4,2,10,1374,3,1393,"2010"
"5214","510260 CAMPINAPOLIS",1,1,2,126,7,137,"2010"
"5215","510263 CAMPO NOVO DO PARECIS",1,3,14,516,0,534,"2010"
"5216","510267 CAMPO VERDE",1,4,7,576,0,588,"2010"
"5217","510268 CAMPOS DE JULIO",1,0,0,96,0,97,"2010"
"5218","510269 CANABRAVA DO NORTE",0,0,2,78,0,80,"2010"
"5219","510270 CANARANA",0,3,4,337,6,350,"2010"
"5220","510279 CARLINDA",1,1,2,136,0,140,"2010"
"5221","510285 CASTANHEIRA",0,0,2,110,1,113,"2010"
"5222","510300 CHAPADA DOS GUIMARAES",0,1,2,267,1,271,"2010"
"5223","510305 CLAUDIA",0,0,1,142,0,143,"2010"
"5224","510310 COCALINHO",0,1,1,76,0,78,"2010"
"5225","510320 COLIDER",1,1,18,427,0,447,"2010"
"5226","510325 COLNIZA",0,2,6,409,0,417,"2010"
"5227","510330 COMODORO",3,1,4,335,24,367,"2010"
"5228","510335 CONFRESA",14,1,2,358,4,379,"2010"
"5229","510336 CONQUISTA D'OESTE",1,0,0,37,1,39,"2010"
"5230","510337 COTRIGUACU",1,2,2,226,0,231,"2010"
"5231","510340 CUIABA",45,30,129,9125,16,9345,"2010"
"5232","510343 CURVELANDIA",0,0,1,54,0,55,"2010"
"5233","510345 DENISE",0,0,3,112,0,115,"2010"
"5234","510350 DIAMANTINO",2,1,6,334,1,344,"2010"
"5235","510360 DOM AQUINO",1,0,1,90,0,92,"2010"
"5236","510370 FELIZ NATAL",1,0,1,145,19,166,"2010"
"5237","510380 FIGUEIROPOLIS D'OESTE",0,0,0,56,0,56,"2010"
"5238","510385 GAUCHA DO NORTE",0,0,0,55,8,63,"2010"
"5239","510390 GENERAL CARNEIRO",0,0,2,80,0,82,"2010"
"5240","510395 GLORIA D'OESTE",0,0,0,31,0,31,"2010"
"5241","510410 GUARANTA DO NORTE",2,1,9,394,0,406,"2010"
"5242","510420 GUIRATINGA",2,0,2,133,0,137,"2010"
"5243","510450 INDIAVAI",0,0,0,53,0,53,"2010"
"5244","510452 IPIRANGA DO NORTE",0,0,0,88,0,88,"2010"
"5245","510454 ITANHANGA",0,0,1,85,0,86,"2010"
"5246","510455 ITAUBA",0,0,1,62,0,63,"2010"
"5247","510460 ITIQUIRA",0,0,3,147,0,150,"2010"
"5248","510480 JACIARA",4,2,2,416,0,424,"2010"
"5249","510490 JANGADA",2,2,2,112,1,119,"2010"
"5250","510500 JAURU",0,0,6,121,0,127,"2010"
"5251","510510 JUARA",1,2,1,604,6,614,"2010"
"5252","510515 JUINA",2,2,5,631,18,658,"2010"
"5253","510517 JURUENA",1,0,4,140,0,145,"2010"
"5254","510520 JUSCIMEIRA",0,0,1,146,0,147,"2010"
"5255","510523 LAMBARI D'OESTE",0,0,0,71,0,71,"2010"
"5256","510525 LUCAS DO RIO VERDE",3,1,6,909,1,920,"2010"
"5257","510530 LUCIARA",0,0,0,26,0,26,"2010"
"5258","510550 VILA BELA DA SANTISSIMA TRINDADE",0,1,4,211,8,224,"2010"
"5259","510558 MARCELANDIA",0,4,25,155,1,185,"2010"
"5260","510560 MATUPA",1,0,4,193,0,198,"2010"
"5261","510562 MIRASSOL D'OESTE",0,1,7,357,1,366,"2010"
"5262","510590 NOBRES",0,1,6,246,3,256,"2010"
"5263","510600 NORTELANDIA",1,0,3,92,0,96,"2010"
"5264","510610 NOSSA SENHORA DO LIVRAMENTO",0,3,1,97,3,104,"2010"
"5265","510615 NOVA BANDEIRANTES",1,1,2,151,0,155,"2010"
"5266","510617 NOVA NAZARE",0,0,0,27,0,27,"2010"
"5267","510618 NOVA LACERDA",0,0,0,84,0,84,"2010"
"5268","510619 NOVA SANTA HELENA",0,0,2,45,1,48,"2010"
"5269","510620 NOVA BRASILANDIA",0,0,0,42,0,42,"2010"
"5270","510621 NOVA CANAA DO NORTE",0,1,6,182,0,189,"2010"
"5271","510622 NOVA MUTUM",2,1,9,546,0,558,"2010"
"5272","510623 NOVA OLIMPIA",0,0,1,302,0,303,"2010"
"5273","510624 NOVA UBIRATA",0,1,0,145,0,146,"2010"
"5274","510625 NOVA XAVANTINA",0,0,2,245,3,250,"2010"
"5275","510626 NOVO MUNDO",0,0,3,90,1,94,"2010"
"5276","510627 NOVO HORIZONTE DO NORTE",0,1,0,25,0,26,"2010"
"5277","510628 NOVO SAO JOAQUIM",0,0,2,85,1,88,"2010"
"5278","510629 PARANAITA",0,1,0,137,0,138,"2010"
"5279","510630 PARANATINGA",0,2,2,323,22,349,"2010"
"5280","510631 NOVO SANTO ANTONIO",0,0,1,22,0,23,"2010"
"5281","510637 PEDRA PRETA",1,0,3,194,2,200,"2010"
"5282","510642 PEIXOTO DE AZEVEDO",1,4,14,435,0,454,"2010"
"5283","510645 PLANALTO DA SERRA",0,0,0,30,0,30,"2010"
"5284","510650 POCONE",3,0,9,515,5,532,"2010"
"5285","510665 PONTAL DO ARAGUAIA",0,3,1,60,0,64,"2010"
"5286","510670 PONTE BRANCA",0,0,8,14,0,22,"2010"
"5287","510675 PONTES E LACERDA",1,1,10,719,6,737,"2010"
"5288","510677 PORTO ALEGRE DO NORTE",1,1,3,131,0,136,"2010"
"5289","510680 PORTO DOS GAUCHOS",0,0,0,82,0,82,"2010"
"5290","510682 PORTO ESPERIDIAO",0,0,0,155,0,155,"2010"
"5291","510685 PORTO ESTRELA",0,2,1,48,0,51,"2010"
"5292","510700 POXOREO",0,0,0,215,0,215,"2010"
"5293","510704 PRIMAVERA DO LESTE",2,1,9,954,2,968,"2010"
"5294","510706 QUERENCIA",0,0,1,197,11,209,"2010"
"5295","510710 SAO JOSE DOS QUATRO MARCOS",0,0,1,209,0,210,"2010"
"5296","510715 RESERVA DO CABACAL",1,0,1,38,0,40,"2010"
"5297","510718 RIBEIRAO CASCALHEIRA",0,0,1,96,0,97,"2010"
"5298","510719 RIBEIRAOZINHO",0,0,0,24,0,24,"2010"
"5299","510720 RIO BRANCO",1,0,1,66,0,68,"2010"
"5300","510724 SANTA CARMEM",0,0,1,44,0,45,"2010"
"5301","510726 SANTO AFONSO",0,0,0,26,0,26,"2010"
"5302","510729 SAO JOSE DO POVO",0,0,0,22,0,22,"2010"
"5303","510730 SAO JOSE DO RIO CLARO",1,0,0,240,0,241,"2010"
"5304","510735 SAO JOSE DO XINGU",1,0,0,95,1,97,"2010"
"5305","510740 SAO PEDRO DA CIPA",1,0,1,71,0,73,"2010"
"5306","510757 RONDOLANDIA",0,0,0,28,0,28,"2010"
"5307","510760 RONDONOPOLIS",9,8,40,3465,6,3528,"2010"
"5308","510770 ROSARIO OESTE",1,3,5,172,2,183,"2010"
"5309","510774 SANTA CRUZ DO XINGU",1,0,1,20,0,22,"2010"
"5310","510775 SALTO DO CEU",0,0,1,38,0,39,"2010"
"5311","510776 SANTA RITA DO TRIVELATO",0,0,0,46,0,46,"2010"
"5312","510777 SANTA TEREZINHA",40,0,2,76,3,121,"2010"
"5313","510779 SANTO ANTONIO DO LESTE",0,0,0,31,1,32,"2010"
"5314","510780 SANTO ANTONIO DO LEVERGER",1,0,4,218,2,225,"2010"
"5315","510785 SAO FELIX DO ARAGUAIA",0,1,2,122,3,128,"2010"
"5316","510787 SAPEZAL",0,0,9,333,0,342,"2010"
"5317","510788 SERRA NOVA DOURADA",0,0,0,10,0,10,"2010"
"5318","510790 SINOP",1,7,23,2015,1,2047,"2010"
"5319","510792 SORRISO",5,4,20,1192,2,1223,"2010"
"5320","510794 TABAPORA",0,0,2,124,0,126,"2010"
"5321","510795 TANGARA DA SERRA",1,9,41,1433,5,1489,"2010"
"5322","510800 TAPURAH",0,1,2,136,0,139,"2010"
"5323","510805 TERRA NOVA DO NORTE",2,1,0,141,0,144,"2010"
"5324","510810 TESOURO",0,0,3,27,0,30,"2010"
"5325","510820 TORIXOREU",0,0,4,44,0,48,"2010"
"5326","510830 UNIAO DO SUL",0,0,0,53,0,53,"2010"
"5327","510835 VALE DE SAO DOMINGOS",0,0,0,53,0,53,"2010"
"5328","510840 VARZEA GRANDE",17,17,87,4283,12,4416,"2010"
"5329","510850 VERA",0,0,0,130,0,130,"2010"
"5330","510860 VILA RICA",5,1,1,330,2,339,"2010"
"5331","510880 NOVA GUARITA",0,1,1,58,0,60,"2010"
"5332","510885 NOVA MARILANDIA",0,0,2,32,0,34,"2010"
"5333","510890 NOVA MARINGA",0,1,1,92,0,94,"2010"
"5334","510895 NOVA MONTE VERDE",0,1,1,96,0,98,"2010"
"5335","MUNICIPIO IGNORADO - GO",0,0,2,7,0,9,"2010"
"5336","520005 ABADIA DE GOIAS",1,1,2,105,1,110,"2010"
"5337","520010 ABADIANIA",0,3,3,178,0,184,"2010"
"5338","520013 ACREUNA",0,0,73,251,0,324,"2010"
"5339","520015 ADELANDIA",0,0,1,24,0,25,"2010"
"5340","520017 AGUA FRIA DE GOIAS",0,0,0,40,1,41,"2010"
"5341","520020 AGUA LIMPA",1,0,0,12,0,13,"2010"
"5342","520025 AGUAS LINDAS DE GOIAS",23,11,49,2405,99,2587,"2010"
"5343","520030 ALEXANIA",2,0,8,340,1,351,"2010"
"5344","520050 ALOANDIA",1,0,0,15,0,16,"2010"
"5345","520055 ALTO HORIZONTE",0,0,1,71,0,72,"2010"
"5346","520060 ALTO PARAISO DE GOIAS",2,2,1,90,2,97,"2010"
"5347","520080 ALVORADA DO NORTE",0,1,1,148,0,150,"2010"
"5348","520082 AMARALINA",0,0,0,17,1,18,"2010"
"5349","520085 AMERICANO DO BRASIL",0,0,7,64,0,71,"2010"
"5350","520090 AMORINOPOLIS",0,0,2,45,0,47,"2010"
"5351","520110 ANAPOLIS",31,30,156,5035,15,5267,"2010"
"5352","520120 ANHANGUERA",0,0,1,11,0,12,"2010"
"5353","520130 ANICUNS",1,3,3,199,1,207,"2010"
"5354","520140 APARECIDA DE GOIANIA",32,37,104,7478,29,7680,"2010"
"5355","520145 APARECIDA DO RIO DOCE",0,0,0,36,0,36,"2010"
"5356","520150 APORE",0,0,0,64,0,64,"2010"
"5357","520160 ARACU",0,0,0,31,0,31,"2010"
"5358","520170 ARAGARCAS",0,3,21,283,10,317,"2010"
"5359","520180 ARAGOIANIA",1,0,3,93,1,98,"2010"
"5360","520215 ARAGUAPAZ",1,0,3,70,1,75,"2010"
"5361","520235 ARENOPOLIS",0,0,0,40,1,41,"2010"
"5362","520250 ARUANA",0,0,0,61,3,64,"2010"
"5363","520260 AURILANDIA",0,0,0,39,0,39,"2010"
"5364","520280 AVELINOPOLIS",0,1,1,28,0,30,"2010"
"5365","520310 BALIZA",0,0,1,28,0,29,"2010"
"5366","520320 BARRO ALTO",0,2,3,80,0,85,"2010"
"5367","520330 BELA VISTA DE GOIAS",1,1,3,288,4,297,"2010"
"5368","520340 BOM JARDIM DE GOIAS",1,0,1,79,0,81,"2010"
"5369","520350 BOM JESUS DE GOIAS",1,4,4,281,0,290,"2010"
"5370","520355 BONFINOPOLIS",1,0,2,103,0,106,"2010"
"5371","520357 BONOPOLIS",0,0,0,48,0,48,"2010"
"5372","520360 BRAZABRANTES",0,0,0,26,0,26,"2010"
"5373","520380 BRITANIA",0,0,1,84,1,86,"2010"
"5374","520390 BURITI ALEGRE",1,0,1,122,1,125,"2010"
"5375","520393 BURITI DE GOIAS",0,0,1,33,0,34,"2010"
"5376","520396 BURITINOPOLIS",0,1,1,36,0,38,"2010"
"5377","520400 CABECEIRAS",2,0,0,83,0,85,"2010"
"5378","520410 CACHOEIRA ALTA",1,1,0,97,0,99,"2010"
"5379","520420 CACHOEIRA DE GOIAS",0,0,0,14,0,14,"2010"
"5380","520425 CACHOEIRA DOURADA",0,1,0,114,0,115,"2010"
"5381","520430 CACU",1,1,6,131,0,139,"2010"
"5382","520440 CAIAPONIA",1,1,2,178,0,182,"2010"
"5383","520450 CALDAS NOVAS",1,3,12,1004,1,1021,"2010"
"5384","520455 CALDAZINHA",0,0,2,41,0,43,"2010"
"5385","520460 CAMPESTRE DE GOIAS",0,0,1,30,0,31,"2010"
"5386","520465 CAMPINACU",0,0,1,35,0,36,"2010"
"5387","520470 CAMPINORTE",0,0,3,132,0,135,"2010"
"5388","520480 CAMPO ALEGRE DE GOIAS",0,0,2,75,1,78,"2010"
"5389","520485 CAMPO LIMPO DE GOIAS",1,2,3,98,0,104,"2010"
"5390","520490 CAMPOS BELOS",2,1,4,324,0,331,"2010"
"5391","520495 CAMPOS VERDES",0,0,0,60,0,60,"2010"
"5392","520500 CARMO DO RIO VERDE",1,1,2,86,0,90,"2010"
"5393","520505 CASTELANDIA",1,0,0,50,0,51,"2010"
"5394","520510 CATALAO",2,4,17,1321,0,1344,"2010"
"5395","520520 CATURAI",0,0,2,62,0,64,"2010"
"5396","520530 CAVALCANTE",1,0,4,158,3,166,"2010"
"5397","520540 CERES",0,1,6,247,0,254,"2010"
"5398","520545 CEZARINA",0,1,3,103,0,107,"2010"
"5399","520547 CHAPADAO DO CEU",0,0,2,133,0,135,"2010"
"5400","520549 CIDADE OCIDENTAL",1,3,16,833,26,879,"2010"
"5401","520551 COCALZINHO DE GOIAS",2,4,4,158,7,175,"2010"
"5402","520552 COLINAS DO SUL",0,0,1,44,0,45,"2010"
"5403","520570 CORREGO DO OURO",0,0,1,26,0,27,"2010"
"5404","520580 CORUMBA DE GOIAS",1,1,5,98,2,107,"2010"
"5405","520590 CORUMBAIBA",0,0,1,89,0,90,"2010"
"5406","520620 CRISTALINA",2,3,18,632,15,670,"2010"
"5407","520630 CRISTIANOPOLIS",0,0,0,22,0,22,"2010"
"5408","520640 CRIXAS",0,1,2,199,0,202,"2010"
"5409","520650 CROMINIA",0,0,0,39,0,39,"2010"
"5410","520660 CUMARI",0,0,1,27,0,28,"2010"
"5411","520670 DAMIANOPOLIS",0,0,1,58,0,59,"2010"
"5412","520680 DAMOLANDIA",0,0,1,22,0,23,"2010"
"5413","520690 DAVINOPOLIS",0,0,0,13,0,13,"2010"
"5414","520710 DIORAMA",0,0,1,31,0,32,"2010"
"5415","520725 DOVERLANDIA",0,0,9,72,0,81,"2010"
"5416","520735 EDEALINA",0,0,1,39,1,41,"2010"
"5417","520740 EDEIA",1,1,3,132,0,137,"2010"
"5418","520750 ESTRELA DO NORTE",0,0,2,34,0,36,"2010"
"5419","520753 FAINA",0,0,0,47,0,47,"2010"
"5420","520760 FAZENDA NOVA",1,1,5,67,0,74,"2010"
"5421","520780 FIRMINOPOLIS",0,1,1,89,0,91,"2010"
"5422","520790 FLORES DE GOIAS",0,0,2,86,0,88,"2010"
"5423","520800 FORMOSA",3,3,6,1701,0,1713,"2010"
"5424","520810 FORMOSO",0,0,0,65,0,65,"2010"
"5425","520815 GAMELEIRA DE GOIAS",1,1,1,34,0,37,"2010"
"5426","520830 DIVINOPOLIS DE GOIAS",0,0,2,84,0,86,"2010"
"5427","520840 GOIANAPOLIS",0,0,9,157,1,167,"2010"
"5428","520850 GOIANDIRA",0,0,2,41,0,43,"2010"
"5429","520860 GOIANESIA",4,1,24,911,0,940,"2010"
"5430","520870 GOIANIA",68,72,290,19504,80,20014,"2010"
"5431","520880 GOIANIRA",2,2,5,482,3,494,"2010"
"5432","520890 GOIAS",0,1,9,314,3,327,"2010"
"5433","520910 GOIATUBA",0,1,3,396,1,401,"2010"
"5434","520915 GOUVELANDIA",0,0,0,56,0,56,"2010"
"5435","520920 GUAPO",0,1,2,179,1,183,"2010"
"5436","520929 GUARAITA",0,1,0,18,0,19,"2010"
"5437","520940 GUARANI DE GOIAS",0,0,0,37,0,37,"2010"
"5438","520945 GUARINOS",0,0,0,26,0,26,"2010"
"5439","520960 HEITORAI",1,0,1,39,0,41,"2010"
"5440","520970 HIDROLANDIA",2,0,1,193,0,196,"2010"
"5441","520980 HIDROLINA",0,0,0,29,0,29,"2010"
"5442","520990 IACIARA",0,2,9,191,0,202,"2010"
"5443","520993 INACIOLANDIA",1,0,1,74,0,76,"2010"
"5444","520995 INDIARA",1,2,4,184,2,193,"2010"
"5445","521000 INHUMAS",1,4,16,658,0,679,"2010"
"5446","521010 IPAMERI",0,0,5,294,0,299,"2010"
"5447","521015 IPIRANGA DE GOIAS",0,0,0,32,0,32,"2010"
"5448","521020 IPORA",1,0,10,358,1,370,"2010"
"5449","521030 ISRAELANDIA",0,0,0,25,0,25,"2010"
"5450","521040 ITABERAI",0,2,7,468,0,477,"2010"
"5451","521056 ITAGUARI",0,1,2,65,0,68,"2010"
"5452","521060 ITAGUARU",0,0,0,41,0,41,"2010"
"5453","521080 ITAJA",0,0,1,73,0,74,"2010"
"5454","521090 ITAPACI",0,1,3,298,1,303,"2010"
"5455","521100 ITAPIRAPUA",0,0,1,81,0,82,"2010"
"5456","521120 ITAPURANGA",2,1,3,322,0,328,"2010"
"5457","521130 ITARUMA",0,1,1,78,0,80,"2010"
"5458","521140 ITAUCU",0,1,1,73,0,75,"2010"
"5459","521150 ITUMBIARA",2,4,11,1250,2,1269,"2010"
"5460","521160 IVOLANDIA",0,0,1,14,0,15,"2010"
"5461","521170 JANDAIA",0,0,1,85,0,86,"2010"
"5462","521180 JARAGUA",2,2,13,570,1,588,"2010"
"5463","521190 JATAI",8,9,29,1313,1,1360,"2010"
"5464","521200 JAUPACI",0,0,2,32,1,35,"2010"
"5465","521205 JESUPOLIS",0,0,2,22,0,24,"2010"
"5466","521210 JOVIANIA",1,0,1,94,0,96,"2010"
"5467","521220 JUSSARA",0,3,4,226,1,234,"2010"
"5468","521225 LAGOA SANTA",0,0,0,13,0,13,"2010"
"5469","521230 LEOPOLDO DE BULHOES",0,1,1,79,0,81,"2010"
"5470","521250 LUZIANIA",4,9,55,2706,65,2839,"2010"
"5471","521260 MAIRIPOTABA",0,0,0,28,1,29,"2010"
"5472","521270 MAMBAI",1,0,1,107,0,109,"2010"
"5473","521280 MARA ROSA",1,0,2,116,0,119,"2010"
"5474","521290 MARZAGAO",0,0,0,21,0,21,"2010"
"5475","521295 MATRINCHA",0,0,0,42,0,42,"2010"
"5476","521300 MAURILANDIA",0,0,1,205,1,207,"2010"
"5477","521305 MIMOSO DE GOIAS",0,0,1,13,1,15,"2010"
"5478","521308 MINACU",2,1,3,441,1,448,"2010"
"5479","521310 MINEIROS",4,2,11,827,0,844,"2010"
"5480","521340 MOIPORA",0,0,0,10,0,10,"2010"
"5481","521350 MONTE ALEGRE DE GOIAS",3,3,4,106,3,119,"2010"
"5482","521370 MONTES CLAROS DE GOIAS",0,0,2,66,1,69,"2010"
"5483","521375 MONTIVIDIU",0,3,13,162,0,178,"2010"
"5484","521377 MONTIVIDIU DO NORTE",0,0,2,32,0,34,"2010"
"5485","521380 MORRINHOS",0,1,8,516,3,528,"2010"
"5486","521385 MORRO AGUDO DE GOIAS",0,0,0,20,0,20,"2010"
"5487","521390 MOSSAMEDES",0,1,1,14,0,16,"2010"
"5488","521400 MOZARLANDIA",0,2,3,182,1,188,"2010"
"5489","521405 MUNDO NOVO",1,0,0,69,0,70,"2010"
"5490","521410 MUTUNOPOLIS",0,0,4,57,0,61,"2010"
"5491","521440 NAZARIO",0,0,1,102,0,103,"2010"
"5492","521450 NEROPOLIS",1,2,7,375,2,387,"2010"
"5493","521460 NIQUELANDIA",2,5,12,558,0,577,"2010"
"5494","521470 NOVA AMERICA",1,0,0,24,0,25,"2010"
"5495","521480 NOVA AURORA",0,0,0,22,0,22,"2010"
"5496","521483 NOVA CRIXAS",0,0,2,149,0,151,"2010"
"5497","521486 NOVA GLORIA",3,0,4,85,0,92,"2010"
"5498","521487 NOVA IGUACU DE GOIAS",0,1,0,40,0,41,"2010"
"5499","521490 NOVA ROMA",0,0,0,21,0,21,"2010"
"5500","521500 NOVA VENEZA",0,1,0,85,1,87,"2010"
"5501","521520 NOVO BRASIL",0,0,1,32,0,33,"2010"
"5502","521523 NOVO GAMA",5,5,41,1640,53,1744,"2010"
"5503","521525 NOVO PLANALTO",0,0,1,42,1,44,"2010"
"5504","521530 ORIZONA",0,0,2,151,0,153,"2010"
"5505","521540 OURO VERDE DE GOIAS",0,0,2,38,0,40,"2010"
"5506","521550 OUVIDOR",0,2,0,65,0,67,"2010"
"5507","521560 PADRE BERNARDO",6,0,9,290,18,323,"2010"
"5508","521565 PALESTINA DE GOIAS",0,0,1,32,0,33,"2010"
"5509","521570 PALMEIRAS DE GOIAS",0,1,2,266,0,269,"2010"
"5510","521580 PALMELO",0,0,0,19,0,19,"2010"
"5511","521590 PALMINOPOLIS",0,0,0,21,0,21,"2010"
"5512","521600 PANAMA",0,0,0,29,0,29,"2010"
"5513","521630 PARANAIGUARA",0,0,0,134,0,134,"2010"
"5514","521640 PARAUNA",1,1,6,159,0,167,"2010"
"5515","521645 PEROLANDIA",0,1,0,50,1,52,"2010"
"5516","521680 PETROLINA DE GOIAS",0,1,2,95,0,98,"2010"
"5517","521690 PILAR DE GOIAS",0,0,1,29,0,30,"2010"
"5518","521710 PIRACANJUBA",0,1,3,232,0,236,"2010"
"5519","521720 PIRANHAS",0,1,5,114,0,120,"2010"
"5520","521730 PIRENOPOLIS",0,2,11,248,0,261,"2010"
"5521","521740 PIRES DO RIO",1,1,8,297,0,307,"2010"
"5522","521760 PLANALTINA",6,12,23,1200,4,1245,"2010"
"5523","521770 PONTALINA",0,2,0,165,3,170,"2010"
"5524","521800 PORANGATU",2,3,19,593,4,621,"2010"
"5525","521805 PORTEIRAO",0,0,0,38,0,38,"2010"
"5526","521810 PORTELANDIA",0,0,1,75,0,76,"2010"
"5527","521830 POSSE",1,1,10,548,0,560,"2010"
"5528","521839 PROFESSOR JAMIL",0,0,1,20,0,21,"2010"
"5529","521850 QUIRINOPOLIS",2,1,1,512,1,517,"2010"
"5530","521860 RIALMA",1,0,4,128,0,133,"2010"
"5531","521870 RIANAPOLIS",0,1,2,64,0,67,"2010"
"5532","521878 RIO QUENTE",1,0,1,23,0,25,"2010"
"5533","521880 RIO VERDE",6,8,24,2916,0,2954,"2010"
"5534","521890 RUBIATABA",1,2,8,204,1,216,"2010"
"5535","521900 SANCLERLANDIA",0,0,3,66,1,70,"2010"
"5536","521910 SANTA BARBARA DE GOIAS",0,0,1,75,0,76,"2010"
"5537","521920 SANTA CRUZ DE GOIAS",2,0,0,24,1,27,"2010"
"5538","521925 SANTA FE DE GOIAS",0,0,0,81,0,81,"2010"
"5539","521930 SANTA HELENA DE GOIAS",0,1,11,555,0,567,"2010"
"5540","521935 SANTA ISABEL",0,0,1,25,0,26,"2010"
"5541","521940 SANTA RITA DO ARAGUAIA",1,2,2,70,0,75,"2010"
"5542","521945 SANTA RITA DO NOVO DESTINO",0,0,0,23,0,23,"2010"
"5543","521950 SANTA ROSA DE GOIAS",0,0,1,20,0,21,"2010"
"5544","521960 SANTA TEREZA DE GOIAS",0,0,3,23,1,27,"2010"
"5545","521970 SANTA TEREZINHA DE GOIAS",0,1,1,106,0,108,"2010"
"5546","521971 SANTO ANTONIO DA BARRA",0,0,1,56,0,57,"2010"
"5547","521973 SANTO ANTONIO DE GOIAS",0,0,0,73,1,74,"2010"
"5548","521975 SANTO ANTONIO DO DESCOBERTO",5,1,9,689,4,708,"2010"
"5549","521980 SAO DOMINGOS",1,1,4,150,1,157,"2010"
"5550","521990 SAO FRANCISCO DE GOIAS",0,0,3,56,1,60,"2010"
"5551","522000 SAO JOAO D'ALIANCA",1,0,1,103,2,107,"2010"
"5552","522005 SAO JOAO DA PARAUNA",0,0,0,17,0,17,"2010"
"5553","522010 SAO LUIS DE MONTES BELOS",0,0,3,351,3,357,"2010"
"5554","522015 SAO LUIZ DO NORTE",0,0,4,62,0,66,"2010"
"5555","522020 SAO MIGUEL DO ARAGUAIA",1,1,2,271,0,275,"2010"
"5556","522026 SAO MIGUEL DO PASSA QUATRO",0,0,1,42,0,43,"2010"
"5557","522028 SAO PATRICIO",0,0,0,26,0,26,"2010"
"5558","522040 SAO SIMAO",1,0,1,230,0,232,"2010"
"5559","522045 SENADOR CANEDO",3,10,23,1422,4,1462,"2010"
"5560","522050 SERRANOPOLIS",1,0,1,61,0,63,"2010"
"5561","522060 SILVANIA",0,0,1,211,0,212,"2010"
"5562","522068 SIMOLANDIA",0,0,1,97,0,98,"2010"
"5563","522070 SITIO D'ABADIA",0,0,0,20,0,20,"2010"
"5564","522100 TAQUARAL DE GOIAS",0,0,1,29,0,30,"2010"
"5565","522108 TERESINA DE GOIAS",0,0,0,53,0,53,"2010"
"5566","522119 TEREZOPOLIS DE GOIAS",0,2,6,89,1,98,"2010"
"5567","522130 TRES RANCHOS",0,0,1,32,0,33,"2010"
"5568","522140 TRINDADE",8,10,29,1174,18,1239,"2010"
"5569","522145 TROMBAS",0,0,1,33,1,35,"2010"
"5570","522150 TURVANIA",0,0,0,55,1,56,"2010"
"5571","522155 TURVELANDIA",0,0,1,62,0,63,"2010"
"5572","522157 UIRAPURU",0,0,0,39,0,39,"2010"
"5573","522160 URUACU",0,5,24,519,2,550,"2010"
"5574","522170 URUANA",0,0,1,163,0,164,"2010"
"5575","522180 URUTAI",0,0,0,25,0,25,"2010"
"5576","522185 VALPARAISO DE GOIAS",8,10,38,2037,50,2143,"2010"
"5577","522190 VARJAO",0,0,0,29,1,30,"2010"
"5578","522200 VIANOPOLIS",1,0,2,164,1,168,"2010"
"5579","522205 VICENTINOPOLIS",0,2,3,104,0,109,"2010"
"5580","522220 VILA BOA",0,0,2,61,1,64,"2010"
"5581","522230 VILA PROPICIO",0,0,1,56,0,57,"2010"
"5582","MUNICIPIO IGNORADO - DF",0,0,0,6,0,6,"2010"
"5583","530010 BRASILIA",229,153,605,42883,375,44245,"2010"
"5584","TOTAL",9411,12851,51202,2740976,98720,2913160,"2011"
"5585","MUNICIPIO IGNORADO - RO",0,0,0,1,0,1,"2011"
"5586","110001 ALTA FLORESTA D'OESTE",0,0,3,394,1,398,"2011"
"5587","110002 ARIQUEMES",1,2,10,1559,7,1579,"2011"
"5588","110003 CABIXI",0,0,1,81,8,90,"2011"
"5589","110004 CACOAL",3,2,17,1275,7,1304,"2011"
"5590","110005 CEREJEIRAS",1,0,6,206,13,226,"2011"
"5591","110006 COLORADO DO OESTE",0,1,0,211,25,237,"2011"
"5592","110007 CORUMBIARA",0,2,1,84,11,98,"2011"
"5593","110008 COSTA MARQUES",0,1,6,249,1,257,"2011"
"5594","110009 ESPIGAO D'OESTE",3,3,5,482,3,496,"2011"
"5595","110010 GUAJARA-MIRIM",3,1,8,943,1,956,"2011"
"5596","110011 JARU",0,5,14,832,1,852,"2011"
"5597","110012 JI-PARANA",1,7,31,2244,3,2286,"2011"
"5598","110013 MACHADINHO D'OESTE",0,3,4,559,3,569,"2011"
"5599","110014 NOVA BRASILANDIA D'OESTE",1,0,11,281,0,293,"2011"
"5600","110015 OURO PRETO DO OESTE",1,1,3,626,0,631,"2011"
"5601","110018 PIMENTA BUENO",1,3,13,550,4,571,"2011"
"5602","110020 PORTO VELHO",17,24,104,8442,155,8742,"2011"
"5603","110025 PRESIDENTE MEDICI",0,1,10,178,1,190,"2011"
"5604","110026 RIO CRESPO",0,0,0,40,0,40,"2011"
"5605","110028 ROLIM DE MOURA",0,2,8,922,0,932,"2011"
"5606","110029 SANTA LUZIA D'OESTE",0,1,0,105,0,106,"2011"
"5607","110030 VILHENA",4,2,7,1115,356,1484,"2011"
"5608","110032 SAO MIGUEL DO GUAPORE",15,1,7,293,2,318,"2011"
"5609","110033 NOVA MAMORE",1,0,16,399,1,417,"2011"
"5610","110034 ALVORADA D'OESTE",0,1,10,189,0,200,"2011"
"5611","110037 ALTO ALEGRE DOS PARECIS",0,4,3,191,1,199,"2011"
"5612","110040 ALTO PARAISO",0,1,2,263,2,268,"2011"
"5613","110045 BURITIS",2,5,8,676,2,693,"2011"
"5614","110050 NOVO HORIZONTE DO OESTE",0,0,0,105,0,105,"2011"
"5615","110060 CACAULANDIA",0,0,0,66,2,68,"2011"
"5616","110070 CAMPO NOVO DE RONDONIA",0,1,3,176,0,180,"2011"
"5617","110080 CANDEIAS DO JAMARI",1,4,5,396,13,419,"2011"
"5618","110090 CASTANHEIRAS",0,0,0,51,0,51,"2011"
"5619","110092 CHUPINGUAIA",0,0,0,81,21,102,"2011"
"5620","110094 CUJUBIM",1,0,3,221,0,225,"2011"
"5621","110100 GOVERNADOR JORGE TEIXEIRA",0,1,4,160,2,167,"2011"
"5622","110110 ITAPUA DO OESTE",0,2,4,131,0,137,"2011"
"5623","110120 MINISTRO ANDREAZZA",0,1,2,117,0,120,"2011"
"5624","110130 MIRANTE DA SERRA",0,1,3,137,0,141,"2011"
"5625","110140 MONTE NEGRO",0,1,4,226,0,231,"2011"
"5626","110143 NOVA UNIAO",1,1,1,87,0,90,"2011"
"5627","110145 PARECIS",0,0,0,67,1,68,"2011"
"5628","110146 PIMENTEIRAS DO OESTE",0,1,0,31,5,37,"2011"
"5629","110147 PRIMAVERA DE RONDONIA",1,0,1,44,0,46,"2011"
"5630","110148 SAO FELIPE D'OESTE",0,0,0,72,0,72,"2011"
"5631","110149 SAO FRANCISCO DO GUAPORE",0,4,5,252,2,263,"2011"
"5632","110150 SERINGUEIRAS",0,0,3,174,1,178,"2011"
"5633","110155 TEIXEIROPOLIS",0,0,0,70,0,70,"2011"
"5634","110160 THEOBROMA",0,0,3,136,0,139,"2011"
"5635","110170 URUPA",1,1,4,146,0,152,"2011"
"5636","110175 VALE DO ANARI",1,1,4,81,0,87,"2011"
"5637","110180 VALE DO PARAISO",0,0,2,75,0,77,"2011"
"5638","120001 ACRELANDIA",0,0,5,248,36,289,"2011"
"5639","120005 ASSIS BRASIL",0,3,4,210,43,260,"2011"
"5640","120010 BRASILEIA",1,1,15,476,41,534,"2011"
"5641","120013 BUJARI",0,0,1,177,17,195,"2011"
"5642","120017 CAPIXABA",0,0,3,172,32,207,"2011"
"5643","120020 CRUZEIRO DO SUL",2,4,24,1575,247,1852,"2011"
"5644","120025 EPITACIOLANDIA",2,3,13,269,25,312,"2011"
"5645","120030 FEIJO",5,1,2,744,155,907,"2011"
"5646","120032 JORDAO",0,0,0,86,157,243,"2011"
"5647","120033 MANCIO LIMA",2,5,3,406,71,487,"2011"
"5648","120034 MANOEL URBANO",0,1,9,191,52,253,"2011"
"5649","120035 MARECHAL THAUMATURGO",0,2,8,202,338,550,"2011"
"5650","120038 PLACIDO DE CASTRO",0,0,3,348,39,390,"2011"
"5651","120039 PORTO WALTER",1,0,4,229,117,351,"2011"
"5652","120040 RIO BRANCO",3,7,54,5969,869,6902,"2011"
"5653","120042 RODRIGUES ALVES",0,1,4,380,80,465,"2011"
"5654","120043 SANTA ROSA DO PURUS",0,0,1,88,143,232,"2011"
"5655","120045 SENADOR GUIOMARD",0,3,5,387,49,444,"2011"
"5656","120050 SENA MADUREIRA",1,3,10,925,104,1043,"2011"
"5657","120060 TARAUACA",6,6,13,1047,145,1217,"2011"
"5658","120070 XAPURI",0,0,12,286,30,328,"2011"
"5659","120080 PORTO ACRE",1,1,4,309,41,356,"2011"
"5660","MUNICIPIO IGNORADO - AM",0,0,0,16,0,16,"2011"
"5661","130002 ALVARAES",6,0,6,328,0,340,"2011"
"5662","130006 AMATURA",3,1,1,112,125,242,"2011"
"5663","130008 ANAMA",0,0,0,192,7,199,"2011"
"5664","130010 ANORI",1,0,0,26,219,246,"2011"
"5665","130014 APUI",1,1,6,186,1,195,"2011"
"5666","130020 ATALAIA DO NORTE",0,1,6,275,63,345,"2011"
"5667","130030 AUTAZES",4,4,13,698,165,884,"2011"
"5668","130040 BARCELOS",0,1,18,260,19,298,"2011"
"5669","130050 BARREIRINHA",0,2,5,604,63,674,"2011"
"5670","130060 BENJAMIN CONSTANT",2,2,7,889,17,917,"2011"
"5671","130063 BERURI",0,0,11,375,14,400,"2011"
"5672","130068 BOA VISTA DO RAMOS",0,0,6,241,36,283,"2011"
"5673","130070 BOCA DO ACRE",1,2,11,651,11,676,"2011"
"5674","130080 BORBA",1,0,12,580,125,718,"2011"
"5675","130083 CAAPIRANGA",0,1,0,119,43,163,"2011"
"5676","130090 CANUTAMA",0,0,2,174,2,178,"2011"
"5677","130100 CARAUARI",0,0,6,561,1,568,"2011"
"5678","130110 CAREIRO",3,4,8,392,56,463,"2011"
"5679","130115 CAREIRO DA VARZEA",0,2,2,186,33,223,"2011"
"5680","130120 COARI",10,10,16,1727,7,1770,"2011"
"5681","130130 CODAJAS",2,4,6,398,2,412,"2011"
"5682","130140 EIRUNEPE",2,7,24,668,125,826,"2011"
"5683","130150 ENVIRA",1,1,3,308,1,314,"2011"
"5684","130160 FONTE BOA",0,2,6,515,0,523,"2011"
"5685","130165 GUAJARA",2,1,7,302,48,360,"2011"
"5686","130170 HUMAITA",2,1,16,881,7,907,"2011"
"5687","130180 IPIXUNA",0,0,2,285,119,406,"2011"
"5688","130185 IRANDUBA",1,4,12,912,7,936,"2011"
"5689","130190 ITACOATIARA",4,15,18,1796,132,1965,"2011"
"5690","130195 ITAMARATI",1,1,3,120,35,160,"2011"
"5691","130200 ITAPIRANGA",1,0,1,166,9,177,"2011"
"5692","130210 JAPURA",2,0,12,134,1,149,"2011"
"5693","130220 JURUA",0,1,27,100,47,175,"2011"
"5694","130230 JUTAI",0,2,2,333,24,361,"2011"
"5695","130240 LABREA",0,4,26,640,1,671,"2011"
"5696","130250 MANACAPURU",5,6,24,1852,152,2039,"2011"
"5697","130255 MANAQUIRI",2,0,0,218,7,227,"2011"
"5698","130260 MANAUS",117,129,478,39340,386,40450,"2011"
"5699","130270 MANICORE",1,5,33,625,174,838,"2011"
"5700","130280 MARAA",1,2,5,290,0,298,"2011"
"5701","130290 MAUES",4,8,23,989,322,1346,"2011"
"5702","130300 NHAMUNDA",0,4,10,270,1,285,"2011"
"5703","130310 NOVA OLINDA DO NORTE",2,0,11,442,102,557,"2011"
"5704","130320 NOVO AIRAO",2,0,3,268,0,273,"2011"
"5705","130330 NOVO ARIPUANA",0,0,1,333,44,378,"2011"
"5706","130340 PARINTINS",5,8,19,2033,100,2165,"2011"
"5707","130350 PAUINI",0,1,1,329,14,345,"2011"
"5708","130353 PRESIDENTE FIGUEIREDO",4,0,5,530,7,546,"2011"
"5709","130356 RIO PRETO DA EVA",3,1,3,351,5,363,"2011"
"5710","130360 SANTA ISABEL DO RIO NEGRO",0,3,16,162,98,279,"2011"
"5711","130370 SANTO ANTONIO DO ICA",2,2,4,486,132,626,"2011"
"5712","130380 SAO GABRIEL DA CACHOEIRA",0,2,7,431,610,1050,"2011"
"5713","130390 SAO PAULO DE OLIVENCA",5,5,7,267,600,884,"2011"
"5714","130395 SAO SEBASTIAO DO UATUMA",0,0,2,181,0,183,"2011"
"5715","130400 SILVES",0,0,2,156,12,170,"2011"
"5716","130406 TABATINGA",1,5,12,1121,473,1612,"2011"
"5717","130410 TAPAUA",1,2,5,356,24,388,"2011"
"5718","130420 TEFE",11,8,14,1433,59,1525,"2011"
"5719","130423 TONANTINS",0,0,1,273,31,305,"2011"
"5720","130426 UARINI",2,0,26,136,178,342,"2011"
"5721","130430 URUCARA",0,4,15,250,24,293,"2011"
"5722","130440 URUCURITUBA",0,0,8,231,56,295,"2011"
"5723","MUNICIPIO IGNORADO - RR",0,0,0,3,0,3,"2011"
"5724","140002 AMAJARI",4,0,1,137,117,259,"2011"
"5725","140005 ALTO ALEGRE",5,0,3,191,142,341,"2011"
"5726","140010 BOA VISTA",100,21,45,6086,1,6253,"2011"
"5727","140015 BONFIM",5,0,1,224,56,286,"2011"
"5728","140017 CANTA",12,1,1,274,18,306,"2011"
"5729","140020 CARACARAI",3,1,7,298,40,349,"2011"
"5730","140023 CAROEBE",1,0,3,138,3,145,"2011"
"5731","140028 IRACEMA",4,0,0,84,12,100,"2011"
"5732","140030 MUCAJAI",1,1,1,292,14,309,"2011"
"5733","140040 NORMANDIA",4,0,2,251,84,341,"2011"
"5734","140045 PACARAIMA",9,0,5,222,50,286,"2011"
"5735","140047 RORAINOPOLIS",4,2,6,368,8,388,"2011"
"5736","140050 SAO JOAO DA BALIZA",0,0,2,120,1,123,"2011"
"5737","140060 SAO LUIZ",0,0,1,87,1,89,"2011"
"5738","140070 UIRAMUTA",5,1,4,214,143,367,"2011"
"5739","MUNICIPIO IGNORADO - PA",0,1,0,2,0,3,"2011"
"5740","150010 ABAETETUBA",4,15,58,2399,53,2529,"2011"
"5741","150013 ABEL FIGUEIREDO",1,0,7,108,1,117,"2011"
"5742","150020 ACARA",3,2,21,992,13,1031,"2011"
"5743","150030 AFUA",2,3,11,729,14,759,"2011"
"5744","150034 AGUA AZUL DO NORTE",0,0,3,187,1,191,"2011"
"5745","150040 ALENQUER",4,1,6,1143,77,1231,"2011"
"5746","150050 ALMEIRIM",5,8,13,728,2,756,"2011"
"5747","150060 ALTAMIRA",7,12,35,1932,7,1993,"2011"
"5748","150070 ANAJAS",1,6,23,618,69,717,"2011"
"5749","150080 ANANINDEUA",19,18,84,9167,31,9319,"2011"
"5750","150085 ANAPU",2,5,4,367,3,381,"2011"
"5751","150090 AUGUSTO CORREA",6,7,24,904,185,1126,"2011"
"5752","150095 AURORA DO PARA",2,7,24,389,22,444,"2011"
"5753","150100 AVEIRO",0,0,14,174,38,226,"2011"
"5754","150110 BAGRE",0,3,20,206,245,474,"2011"
"5755","150120 BAIAO",2,1,8,547,42,600,"2011"
"5756","150125 BANNACH",0,0,0,45,0,45,"2011"
"5757","150130 BARCARENA",8,7,84,1888,7,1994,"2011"
"5758","150140 BELEM",48,70,231,21558,74,21981,"2011"
"5759","150145 BELTERRA",0,1,22,168,10,201,"2011"
"5760","150150 BENEVIDES",3,1,325,783,3,1115,"2011"
"5761","150157 BOM JESUS DO TOCANTINS",0,0,2,253,0,255,"2011"
"5762","150160 BONITO",2,0,4,170,4,180,"2011"
"5763","150170 BRAGANCA",4,19,32,1972,144,2171,"2011"
"5764","150172 BRASIL NOVO",0,3,24,236,0,263,"2011"
"5765","150175 BREJO GRANDE DO ARAGUAIA",0,1,1,103,5,110,"2011"
"5766","150178 BREU BRANCO",2,3,14,628,173,820,"2011"
"5767","150180 BREVES",7,16,170,1917,15,2125,"2011"
"5768","150190 BUJARU",0,5,53,426,66,550,"2011"
"5769","150195 CACHOEIRA DO PIRIA",2,1,9,274,81,367,"2011"
"5770","150200 CACHOEIRA DO ARARI",1,3,8,273,0,285,"2011"
"5771","150210 CAMETA",10,15,111,1785,687,2608,"2011"
"5772","150215 CANAA DOS CARAJAS",0,2,28,705,1,736,"2011"
"5773","150220 CAPANEMA",2,3,23,1108,38,1174,"2011"
"5774","150230 CAPITAO POCO",15,1,17,886,28,947,"2011"
"5775","150240 CASTANHAL",6,11,339,2993,3,3352,"2011"
"5776","150250 CHAVES",0,3,6,194,64,267,"2011"
"5777","150260 COLARES",1,1,2,112,43,159,"2011"
"5778","150270 CONCEICAO DO ARAGUAIA",2,5,13,834,0,854,"2011"
"5779","150275 CONCORDIA DO PARA",3,4,22,429,3,461,"2011"
"5780","150276 CUMARU DO NORTE",0,1,4,164,8,177,"2011"
"5781","150277 CURIONOPOLIS",0,1,15,369,0,385,"2011"
"5782","150280 CURRALINHO",23,8,3,457,63,554,"2011"
"5783","150285 CURUA",0,3,3,145,82,233,"2011"
"5784","150290 CURUCA",1,3,44,449,16,513,"2011"
"5785","150293 DOM ELISEU",5,9,20,742,1,777,"2011"
"5786","150295 ELDORADO DOS CARAJAS",1,2,12,595,0,610,"2011"
"5787","150300 FARO",0,0,5,150,13,168,"2011"
"5788","150304 FLORESTA DO ARAGUAIA",2,4,3,257,0,266,"2011"
"5789","150307 GARRAFAO DO NORTE",7,0,11,385,69,472,"2011"
"5790","150309 GOIANESIA DO PARA",0,4,18,817,12,851,"2011"
"5791","150310 GURUPA",1,3,8,514,159,685,"2011"
"5792","150320 IGARAPE-ACU",1,4,66,498,4,573,"2011"
"5793","150330 IGARAPE-MIRI",5,5,62,1210,93,1375,"2011"
"5794","150340 INHANGAPI",0,0,21,172,2,195,"2011"
"5795","150345 IPIXUNA DO PARA",5,4,24,453,32,518,"2011"
"5796","150350 IRITUIA",0,2,22,420,55,499,"2011"
"5797","150360 ITAITUBA",5,26,287,1837,22,2177,"2011"
"5798","150370 ITUPIRANGA",3,4,12,885,37,941,"2011"
"5799","150375 JACAREACANGA",3,1,8,255,226,493,"2011"
"5800","150380 JACUNDA",2,5,12,958,8,985,"2011"
"5801","150390 JURUTI",2,17,34,857,72,982,"2011"
"5802","150400 LIMOEIRO DO AJURU",0,7,30,426,8,471,"2011"
"5803","150405 MAE DO RIO",0,2,14,602,1,619,"2011"
"5804","150410 MAGALHAES BARATA",0,0,6,90,10,106,"2011"
"5805","150420 MARABA",10,13,59,4906,82,5070,"2011"
"5806","150430 MARACANA",1,1,30,332,60,424,"2011"
"5807","150440 MARAPANIM",0,1,28,290,35,354,"2011"
"5808","150442 MARITUBA",3,7,17,1501,2,1530,"2011"
"5809","150445 MEDICILANDIA",4,3,8,460,0,475,"2011"
"5810","150450 MELGACO",17,16,13,374,220,640,"2011"
"5811","150460 MOCAJUBA",1,6,7,481,17,512,"2011"
"5812","150470 MOJU",3,6,35,1135,66,1245,"2011"
"5813","150480 MONTE ALEGRE",5,14,70,954,1,1044,"2011"
"5814","150490 MUANA",2,0,13,544,0,559,"2011"
"5815","150495 NOVA ESPERANCA DO PIRIA",1,0,3,354,60,418,"2011"
"5816","150497 NOVA IPIXUNA",0,0,5,202,8,215,"2011"
"5817","150500 NOVA TIMBOTEUA",0,0,5,135,4,144,"2011"
"5818","150503 NOVO PROGRESSO",0,0,6,514,1,521,"2011"
"5819","150506 NOVO REPARTIMENTO",2,4,11,1278,15,1310,"2011"
"5820","150510 OBIDOS",2,6,16,835,187,1046,"2011"
"5821","150520 OEIRAS DO PARA",6,6,22,580,103,717,"2011"
"5822","150530 ORIXIMINA",3,9,35,1182,79,1308,"2011"
"5823","150540 OUREM",4,2,6,282,10,304,"2011"
"5824","150543 OURILANDIA DO NORTE",0,1,2,631,2,636,"2011"
"5825","150548 PACAJA",3,2,8,713,6,732,"2011"
"5826","150549 PALESTINA DO PARA",0,2,1,119,4,126,"2011"
"5827","150550 PARAGOMINAS",5,5,36,2190,10,2246,"2011"
"5828","150553 PARAUAPEBAS",9,15,106,3840,11,3981,"2011"
"5829","150555 PAU D'ARCO",0,0,2,141,0,143,"2011"
"5830","150560 PEIXE-BOI",0,0,5,107,0,112,"2011"
"5831","150563 PICARRA",0,0,0,169,0,169,"2011"
"5832","150565 PLACAS",0,2,3,250,3,258,"2011"
"5833","150570 PONTA DE PEDRAS",0,3,0,295,0,298,"2011"
"5834","150580 PORTEL",4,7,16,1061,62,1150,"2011"
"5835","150590 PORTO DE MOZ",3,2,9,601,0,615,"2011"
"5836","150600 PRAINHA",0,7,15,547,100,669,"2011"
"5837","150610 PRIMAVERA",1,0,3,122,47,173,"2011"
"5838","150611 QUATIPURU",0,0,6,178,15,199,"2011"
"5839","150613 REDENCAO",2,5,19,1555,2,1583,"2011"
"5840","150616 RIO MARIA",4,0,7,346,1,358,"2011"
"5841","150618 RONDON DO PARA",0,7,49,798,1,855,"2011"
"5842","150619 RUROPOLIS",1,4,16,366,0,387,"2011"
"5843","150620 SALINOPOLIS",0,1,10,722,1,734,"2011"
"5844","150630 SALVATERRA",2,2,1,349,1,355,"2011"
"5845","150635 SANTA BARBARA DO PARA",0,2,51,257,0,310,"2011"
"5846","150640 SANTA CRUZ DO ARARI",0,1,2,61,8,72,"2011"
"5847","150650 SANTA IZABEL DO PARA",1,2,72,892,1,968,"2011"
"5848","150655 SANTA LUZIA DO PARA",2,1,16,376,11,406,"2011"
"5849","150658 SANTA MARIA DAS BARREIRAS",0,0,4,190,1,195,"2011"
"5850","150660 SANTA MARIA DO PARA",1,1,17,385,3,407,"2011"
"5851","150670 SANTANA DO ARAGUAIA",3,1,7,585,0,596,"2011"
"5852","150680 SANTAREM",19,42,230,5854,636,6781,"2011"
"5853","150690 SANTAREM NOVO",0,0,5,88,4,97,"2011"
"5854","150700 SANTO ANTONIO DO TAUA",0,1,7,452,24,484,"2011"
"5855","150710 SAO CAETANO DE ODIVELAS",5,0,5,215,3,228,"2011"
"5856","150715 SAO DOMINGOS DO ARAGUAIA",0,0,6,403,3,412,"2011"
"5857","150720 SAO DOMINGOS DO CAPIM",1,3,50,512,44,610,"2011"
"5858","150730 SAO FELIX DO XINGU",0,1,10,1000,10,1021,"2011"
"5859","150740 SAO FRANCISCO DO PARA",0,0,39,199,2,240,"2011"
"5860","150745 SAO GERALDO DO ARAGUAIA",1,2,11,498,2,514,"2011"
"5861","150746 SAO JOAO DA PONTA",0,1,6,64,4,75,"2011"
"5862","150747 SAO JOAO DE PIRABAS",1,2,11,323,7,344,"2011"
"5863","150750 SAO JOAO DO ARAGUAIA",0,1,2,177,3,183,"2011"
"5864","150760 SAO MIGUEL DO GUAMA",2,3,46,973,4,1028,"2011"
"5865","150770 SAO SEBASTIAO DA BOA VISTA",3,5,33,439,1,481,"2011"
"5866","150775 SAPUCAIA",0,0,0,93,0,93,"2011"
"5867","150780 SENADOR JOSE PORFIRIO",1,2,7,274,4,288,"2011"
"5868","150790 SOURE",1,2,0,446,0,449,"2011"
"5869","150795 TAILANDIA",7,8,22,1362,25,1424,"2011"
"5870","150796 TERRA ALTA",1,0,26,132,1,160,"2011"
"5871","150797 TERRA SANTA",0,0,16,250,1,267,"2011"
"5872","150800 TOME-ACU",3,23,84,1343,3,1456,"2011"
"5873","150803 TRACUATEUA",4,4,10,567,22,607,"2011"
"5874","150805 TRAIRAO",2,0,18,204,0,224,"2011"
"5875","150808 TUCUMA",1,3,13,765,0,782,"2011"
"5876","150810 TUCURUI",3,7,17,1450,668,2145,"2011"
"5877","150812 ULIANOPOLIS",3,3,10,413,6,435,"2011"
"5878","150815 URUARA",3,1,15,772,0,791,"2011"
"5879","150820 VIGIA",1,5,8,758,4,776,"2011"
"5880","150830 VISEU",1,4,19,914,516,1454,"2011"
"5881","150835 VITORIA DO XINGU",1,2,2,219,1,225,"2011"
"5882","150840 XINGUARA",4,3,9,772,1,789,"2011"
"5883","160005 SERRA DO NAVIO",2,1,1,66,0,70,"2011"
"5884","160010 AMAPA",3,3,2,130,17,155,"2011"
"5885","160015 PEDRA BRANCA DO AMAPARI",1,1,5,167,14,188,"2011"
"5886","160020 CALCOENE",2,1,8,162,18,191,"2011"
"5887","160021 CUTIAS",0,1,0,69,17,87,"2011"
"5888","160023 FERREIRA GOMES",0,0,2,103,4,109,"2011"
"5889","160025 ITAUBAL",0,0,3,78,16,97,"2011"
"5890","160027 LARANJAL DO JARI",3,2,18,840,0,863,"2011"
"5891","160030 MACAPA",66,43,132,9072,91,9404,"2011"
"5892","160040 MAZAGAO",4,3,6,325,72,410,"2011"
"5893","160050 OIAPOQUE",0,5,15,430,36,486,"2011"
"5894","160053 PORTO GRANDE",0,2,7,330,3,342,"2011"
"5895","160055 PRACUUBA",0,1,1,37,39,78,"2011"
"5896","160060 SANTANA",16,13,36,2054,7,2126,"2011"
"5897","160070 TARTARUGALZINHO",0,2,1,240,2,245,"2011"
"5898","160080 VITORIA DO JARI",0,0,5,258,0,263,"2011"
"5899","MUNICIPIO IGNORADO - TO",0,0,0,2,0,2,"2011"
"5900","170025 ABREULANDIA",0,0,0,32,1,33,"2011"
"5901","170030 AGUIARNOPOLIS",0,0,0,83,1,84,"2011"
"5902","170035 ALIANCA DO TOCANTINS",0,0,1,92,0,93,"2011"
"5903","170040 ALMAS",0,0,2,145,3,150,"2011"
"5904","170070 ALVORADA",0,0,3,126,1,130,"2011"
"5905","170100 ANANAS",0,1,2,168,2,173,"2011"
"5906","170105 ANGICO",0,0,1,51,0,52,"2011"
"5907","170110 APARECIDA DO RIO NEGRO",0,0,1,60,4,65,"2011"
"5908","170130 ARAGOMINAS",0,1,1,77,0,79,"2011"
"5909","170190 ARAGUACEMA",1,2,2,106,0,111,"2011"
"5910","170200 ARAGUACU",0,2,8,89,0,99,"2011"
"5911","170210 ARAGUAINA",3,5,33,2925,7,2973,"2011"
"5912","170215 ARAGUANA",0,0,3,95,0,98,"2011"
"5913","170220 ARAGUATINS",1,2,4,197,388,592,"2011"
"5914","170230 ARAPOEMA",0,2,2,96,1,101,"2011"
"5915","170240 ARRAIAS",0,0,1,190,1,192,"2011"
"5916","170255 AUGUSTINOPOLIS",0,0,2,20,506,528,"2011"
"5917","170270 AURORA DO TOCANTINS",0,0,0,48,1,49,"2011"
"5918","170290 AXIXA DO TOCANTINS",0,0,0,18,174,192,"2011"
"5919","170300 BABACULANDIA",0,1,0,132,0,133,"2011"
"5920","170305 BANDEIRANTES DO TOCANTINS",0,0,0,42,0,42,"2011"
"5921","170307 BARRA DO OURO",0,0,0,67,1,68,"2011"
"5922","170310 BARROLANDIA",0,0,0,65,0,65,"2011"
"5923","170320 BERNARDO SAYAO",1,0,2,55,2,60,"2011"
"5924","170330 BOM JESUS DO TOCANTINS",1,1,3,71,1,77,"2011"
"5925","170360 BRASILANDIA DO TOCANTINS",0,0,0,25,0,25,"2011"
"5926","170370 BREJINHO DE NAZARE",0,1,2,92,1,96,"2011"
"5927","170380 BURITI DO TOCANTINS",0,1,1,15,158,175,"2011"
"5928","170382 CACHOEIRINHA",0,0,0,6,23,29,"2011"
"5929","170384 CAMPOS LINDOS",0,0,1,131,22,154,"2011"
"5930","170386 CARIRI DO TOCANTINS",0,0,1,43,0,44,"2011"
"5931","170388 CARMOLANDIA",0,0,1,41,0,42,"2011"
"5932","170389 CARRASCO BONITO",0,0,0,6,68,74,"2011"
"5933","170390 CASEARA",0,1,0,75,0,76,"2011"
"5934","170410 CENTENARIO",0,0,1,31,0,32,"2011"
"5935","170460 CHAPADA DE AREIA",0,0,0,25,0,25,"2011"
"5936","170510 CHAPADA DA NATIVIDADE",1,0,0,53,0,54,"2011"
"5937","170550 COLINAS DO TOCANTINS",3,0,7,624,3,637,"2011"
"5938","170555 COMBINADO",0,0,0,62,0,62,"2011"
"5939","170560 CONCEICAO DO TOCANTINS",0,0,0,75,25,100,"2011"
"5940","170600 COUTO MAGALHAES",0,0,0,65,0,65,"2011"
"5941","170610 CRISTALANDIA",0,1,0,101,0,102,"2011"
"5942","170625 CRIXAS DO TOCANTINS",0,0,0,24,0,24,"2011"
"5943","170650 DARCINOPOLIS",0,0,3,95,0,98,"2011"
"5944","170700 DIANOPOLIS",0,6,2,327,6,341,"2011"
"5945","170710 DIVINOPOLIS DO TOCANTINS",1,0,1,117,1,120,"2011"
"5946","170720 DOIS IRMAOS DO TOCANTINS",0,0,0,75,0,75,"2011"
"5947","170730 DUERE",1,0,1,68,0,70,"2011"
"5948","170740 ESPERANTINA",0,0,1,27,123,151,"2011"
"5949","170755 FATIMA",0,0,2,52,1,55,"2011"
"5950","170765 FIGUEIROPOLIS",0,0,1,73,1,75,"2011"
"5951","170770 FILADELFIA",0,0,0,103,0,103,"2011"
"5952","170820 FORMOSO DO ARAGUAIA",1,3,1,298,7,310,"2011"
"5953","170825 FORTALEZA DO TABOCAO",0,1,2,49,0,52,"2011"
"5954","170830 GOIANORTE",0,1,3,46,0,50,"2011"
"5955","170900 GOIATINS",2,1,5,269,5,282,"2011"
"5956","170930 GUARAI",0,1,7,427,0,435,"2011"
"5957","170950 GURUPI",2,7,17,1283,5,1314,"2011"
"5958","170980 IPUEIRAS",0,0,0,28,0,28,"2011"
"5959","171050 ITACAJA",1,1,1,150,11,164,"2011"
"5960","171070 ITAGUATINS",1,0,0,10,70,81,"2011"
"5961","171090 ITAPIRATINS",0,0,0,41,0,41,"2011"
"5962","171110 ITAPORA DO TOCANTINS",1,0,1,46,0,48,"2011"
"5963","171150 JAU DO TOCANTINS",0,0,2,43,0,45,"2011"
"5964","171180 JUARINA",0,0,0,33,0,33,"2011"
"5965","171190 LAGOA DA CONFUSAO",1,1,0,208,8,218,"2011"
"5966","171195 LAGOA DO TOCANTINS",0,1,1,70,2,74,"2011"
"5967","171200 LAJEADO",0,1,1,51,0,53,"2011"
"5968","171215 LAVANDEIRA",0,0,0,28,0,28,"2011"
"5969","171240 LIZARDA",0,0,0,45,1,46,"2011"
"5970","171245 LUZINOPOLIS",0,0,2,46,2,50,"2011"
"5971","171250 MARIANOPOLIS DO TOCANTINS",0,0,1,63,0,64,"2011"
"5972","171270 MATEIROS",2,0,0,46,2,50,"2011"
"5973","171280 MAURILANDIA DO TOCANTINS",0,0,0,26,13,39,"2011"
"5974","171320 MIRACEMA DO TOCANTINS",1,1,4,343,0,349,"2011"
"5975","171330 MIRANORTE",3,0,4,156,0,163,"2011"
"5976","171360 MONTE DO CARMO",0,1,3,94,5,103,"2011"
"5977","171370 MONTE SANTO DO TOCANTINS",0,0,0,30,0,30,"2011"
"5978","171380 PALMEIRAS DO TOCANTINS",0,0,1,77,2,80,"2011"
"5979","171395 MURICILANDIA",0,1,0,58,0,59,"2011"
"5980","171420 NATIVIDADE",0,0,2,120,0,122,"2011"
"5981","171430 NAZARE",1,0,1,67,7,76,"2011"
"5982","171488 NOVA OLINDA",0,0,3,236,2,241,"2011"
"5983","171500 NOVA ROSALANDIA",0,0,0,55,1,56,"2011"
"5984","171510 NOVO ACORDO",0,0,0,61,1,62,"2011"
"5985","171515 NOVO ALEGRE",0,0,0,28,0,28,"2011"
"5986","171525 NOVO JARDIM",0,0,1,27,0,28,"2011"
"5987","171550 OLIVEIRA DE FATIMA",0,0,0,18,0,18,"2011"
"5988","171570 PALMEIRANTE",1,4,2,68,0,75,"2011"
"5989","171575 PALMEIROPOLIS",0,0,1,74,1,76,"2011"
"5990","171610 PARAISO DO TOCANTINS",1,1,4,778,1,785,"2011"
"5991","171620 PARANA",0,0,3,166,2,171,"2011"
"5992","171630 PAU D'ARCO",0,0,0,60,2,62,"2011"
"5993","171650 PEDRO AFONSO",0,0,9,238,2,249,"2011"
"5994","171660 PEIXE",1,0,1,152,0,154,"2011"
"5995","171665 PEQUIZEIRO",0,0,1,69,0,70,"2011"
"5996","171670 COLMEIA",1,1,3,107,0,112,"2011"
"5997","171700 PINDORAMA DO TOCANTINS",0,0,0,71,1,72,"2011"
"5998","171720 PIRAQUE",0,0,0,34,0,34,"2011"
"5999","171750 PIUM",0,0,0,101,0,101,"2011"
"6000","171780 PONTE ALTA DO BOM JESUS",0,0,2,58,1,61,"2011"
"6001","171790 PONTE ALTA DO TOCANTINS",2,1,0,134,0,137,"2011"
"6002","171800 PORTO ALEGRE DO TOCANTINS",0,0,0,50,0,50,"2011"
"6003","171820 PORTO NACIONAL",3,4,10,969,3,989,"2011"
"6004","171830 PRAIA NORTE",0,0,0,8,112,120,"2011"
"6005","171840 PRESIDENTE KENNEDY",0,0,0,48,0,48,"2011"
"6006","171845 PUGMIL",0,0,1,35,0,36,"2011"
"6007","171850 RECURSOLANDIA",0,0,2,78,0,80,"2011"
"6008","171855 RIACHINHO",0,1,0,59,1,61,"2011"
"6009","171865 RIO DA CONCEICAO",0,0,0,30,1,31,"2011"
"6010","171870 RIO DOS BOIS",0,0,0,35,0,35,"2011"
"6011","171875 RIO SONO",0,1,1,61,1,64,"2011"
"6012","171880 SAMPAIO",0,0,1,3,66,70,"2011"
"6013","171884 SANDOLANDIA",0,0,6,50,0,56,"2011"
"6014","171886 SANTA FE DO ARAGUAIA",0,1,3,132,0,136,"2011"
"6015","171888 SANTA MARIA DO TOCANTINS",0,0,4,38,0,42,"2011"
"6016","171889 SANTA RITA DO TOCANTINS",0,0,0,22,0,22,"2011"
"6017","171890 SANTA ROSA DO TOCANTINS",0,1,1,88,0,90,"2011"
"6018","171900 SANTA TEREZA DO TOCANTINS",0,0,2,49,1,52,"2011"
"6019","172000 SANTA TEREZINHA DO TOCANTINS",0,0,0,36,0,36,"2011"
"6020","172010 SAO BENTO DO TOCANTINS",0,0,1,19,55,75,"2011"
"6021","172015 SAO FELIX DO TOCANTINS",0,0,0,35,2,37,"2011"
"6022","172020 SAO MIGUEL DO TOCANTINS",1,2,4,105,37,149,"2011"
"6023","172025 SAO SALVADOR DO TOCANTINS",1,0,1,39,1,42,"2011"
"6024","172030 SAO SEBASTIAO DO TOCANTINS",0,0,1,10,72,83,"2011"
"6025","172049 SAO VALERIO",0,0,0,65,0,65,"2011"
"6026","172065 SILVANOPOLIS",0,0,2,98,0,100,"2011"
"6027","172080 SITIO NOVO DO TOCANTINS",0,0,0,47,97,144,"2011"
"6028","172085 SUCUPIRA",0,0,1,25,0,26,"2011"
"6029","172090 TAGUATINGA",0,0,5,190,1,196,"2011"
"6030","172093 TAIPAS DO TOCANTINS",0,1,0,36,3,40,"2011"
"6031","172097 TALISMA",0,0,0,27,0,27,"2011"
"6032","172100 PALMAS",10,13,59,4554,37,4673,"2011"
"6033","172110 TOCANTINIA",0,1,2,180,7,190,"2011"
"6034","172120 TOCANTINOPOLIS",4,0,5,463,10,482,"2011"
"6035","172125 TUPIRAMA",0,0,0,26,0,26,"2011"
"6036","172130 TUPIRATINS",0,0,1,30,0,31,"2011"
"6037","172208 WANDERLANDIA",0,1,1,146,0,148,"2011"
"6038","172210 XAMBIOA",0,0,10,249,0,259,"2011"
"6039","MUNICIPIO IGNORADO - MA",0,0,0,3,0,3,"2011"
"6040","210005 ACAILANDIA",13,6,44,1945,16,2024,"2011"
"6041","210010 AFONSO CUNHA",1,0,7,107,10,125,"2011"
"6042","210015 AGUA DOCE DO MARANHAO",2,0,6,121,25,154,"2011"
"6043","210020 ALCANTARA",5,2,8,190,28,233,"2011"
"6044","210030 ALDEIAS ALTAS",0,2,4,539,2,547,"2011"
"6045","210040 ALTAMIRA DO MARANHAO",0,0,2,60,36,98,"2011"
"6046","210043 ALTO ALEGRE DO MARANHAO",2,2,34,363,26,427,"2011"
"6047","210047 ALTO ALEGRE DO PINDARE",6,8,5,278,232,529,"2011"
"6048","210050 ALTO PARNAIBA",0,1,2,157,25,185,"2011"
"6049","210055 AMAPA DO MARANHAO",0,0,4,88,10,102,"2011"
"6050","210060 AMARANTE DO MARANHAO",1,3,15,740,75,834,"2011"
"6051","210070 ANAJATUBA",0,2,32,262,29,325,"2011"
"6052","210080 ANAPURUS",0,2,3,273,10,288,"2011"
"6053","210083 APICUM-ACU",3,116,3,78,93,293,"2011"
"6054","210087 ARAGUANA",1,0,10,108,42,161,"2011"
"6055","210090 ARAIOSES",51,36,105,406,25,623,"2011"
"6056","210095 ARAME",0,0,19,723,0,742,"2011"
"6057","210100 ARARI",1,6,18,453,22,500,"2011"
"6058","210110 AXIXA",1,0,4,178,17,200,"2011"
"6059","210120 BACABAL",15,14,93,1601,27,1750,"2011"
"6060","210125 BACABEIRA",0,1,23,212,4,240,"2011"
"6061","210130 BACURI",0,1,0,48,277,326,"2011"
"6062","210135 BACURITUBA",0,0,0,60,0,60,"2011"
"6063","210140 BALSAS",1,1,5,58,1942,2007,"2011"
"6064","210150 BARAO DE GRAJAU",0,3,23,248,7,281,"2011"
"6065","210160 BARRA DO CORDA",4,28,22,1384,176,1614,"2011"
"6066","210170 BARREIRINHAS",5,9,18,1009,142,1183,"2011"
"6067","210173 BELAGUA",0,0,2,29,194,225,"2011"
"6068","210177 BELA VISTA DO MARANHAO",0,3,6,168,1,178,"2011"
"6069","210180 BENEDITO LEITE",0,0,1,10,72,83,"2011"
"6070","210190 BEQUIMAO",0,0,1,74,93,168,"2011"
"6071","210193 BERNARDO DO MEARIM",1,0,1,87,2,91,"2011"
"6072","210197 BOA VISTA DO GURUPI",1,0,3,159,2,165,"2011"
"6073","210200 BOM JARDIM",1,0,5,126,438,570,"2011"
"6074","210203 BOM JESUS DAS SELVAS",1,3,12,486,14,516,"2011"
"6075","210207 BOM LUGAR",0,2,9,130,8,149,"2011"
"6076","210210 BREJO",1,1,5,479,82,568,"2011"
"6077","210215 BREJO DE AREIA",0,1,9,121,19,150,"2011"
"6078","210220 BURITI",1,4,24,547,15,591,"2011"
"6079","210230 BURITI BRAVO",1,2,10,415,1,429,"2011"
"6080","210232 BURITICUPU",5,6,63,1291,41,1406,"2011"
"6081","210235 BURITIRANA",0,2,8,161,18,189,"2011"
"6082","210237 CACHOEIRA GRANDE",0,2,4,109,55,170,"2011"
"6083","210240 CAJAPIO",0,1,1,79,88,169,"2011"
"6084","210250 CAJARI",0,2,5,169,156,332,"2011"
"6085","210255 CAMPESTRE DO MARANHAO",0,0,7,242,1,250,"2011"
"6086","210260 CANDIDO MENDES",1,11,5,257,51,325,"2011"
"6087","210270 CANTANHEDE",1,1,2,113,178,295,"2011"
"6088","210275 CAPINZAL DO NORTE",0,1,8,124,33,166,"2011"
"6089","210280 CAROLINA",1,1,19,426,0,447,"2011"
"6090","210290 CARUTAPERA",0,0,5,390,0,395,"2011"
"6091","210300 CAXIAS",7,7,14,2919,12,2959,"2011"
"6092","210310 CEDRAL",2,0,2,102,28,134,"2011"
"6093","210312 CENTRAL DO MARANHAO",0,0,0,50,81,131,"2011"
"6094","210315 CENTRO DO GUILHERME",0,1,1,213,5,220,"2011"
"6095","210317 CENTRO NOVO DO MARANHAO",0,2,4,206,70,282,"2011"
"6096","210320 CHAPADINHA",1,28,84,1655,41,1809,"2011"
"6097","210325 CIDELANDIA",2,1,8,160,14,185,"2011"
"6098","210330 CODO",13,18,98,2241,102,2472,"2011"
"6099","210340 COELHO NETO",2,1,22,984,26,1035,"2011"
"6100","210350 COLINAS",0,2,68,734,1,805,"2011"
"6101","210355 CONCEICAO DO LAGO-ACU",1,2,12,216,70,301,"2011"
"6102","210360 COROATA",2,5,46,1092,20,1165,"2011"
"6103","210370 CURURUPU",0,2,0,346,213,561,"2011"
"6104","210375 DAVINOPOLIS",2,1,11,199,1,214,"2011"
"6105","210380 DOM PEDRO",6,3,107,286,36,438,"2011"
"6106","210390 DUQUE BACELAR",0,0,3,170,68,241,"2011"
"6107","210400 ESPERANTINOPOLIS",1,1,6,368,7,383,"2011"
"6108","210405 ESTREITO",3,4,16,700,6,729,"2011"
"6109","210407 FEIRA NOVA DO MARANHAO",0,1,0,19,112,132,"2011"
"6110","210408 FERNANDO FALCAO",0,2,4,122,94,222,"2011"
"6111","210409 FORMOSA DA SERRA NEGRA",0,0,0,51,228,279,"2011"
"6112","210410 FORTALEZA DOS NOGUEIRAS",0,0,0,199,10,209,"2011"
"6113","210420 FORTUNA",1,0,6,336,13,356,"2011"
"6114","210430 GODOFREDO VIANA",0,0,1,92,46,139,"2011"
"6115","210440 GONCALVES DIAS",0,0,1,41,244,286,"2011"
"6116","210450 GOVERNADOR ARCHER",0,0,7,119,7,133,"2011"
"6117","210455 GOVERNADOR EDISON LOBAO",0,2,11,272,6,291,"2011"
"6118","210460 GOVERNADOR EUGENIO BARROS",2,0,2,228,49,281,"2011"
"6119","210462 GOVERNADOR LUIZ ROCHA",0,3,2,89,0,94,"2011"
"6120","210465 GOVERNADOR NEWTON BELLO",1,0,7,122,45,175,"2011"
"6121","210467 GOVERNADOR NUNES FREIRE",0,1,3,494,22,520,"2011"
"6122","210470 GRACA ARANHA",6,0,1,77,3,87,"2011"
"6123","210480 GRAJAU",9,6,28,1543,78,1664,"2011"
"6124","210490 GUIMARAES",0,0,3,3,152,158,"2011"
"6125","210500 HUMBERTO DE CAMPOS",0,0,5,410,116,531,"2011"
"6126","210510 ICATU",0,3,7,320,74,404,"2011"
"6127","210515 IGARAPE DO MEIO",0,2,15,268,1,286,"2011"
"6128","210520 IGARAPE GRANDE",1,1,0,190,1,193,"2011"
"6129","210530 IMPERATRIZ",19,26,141,4712,78,4976,"2011"
"6130","210535 ITAIPAVA DO GRAJAU",1,0,11,207,7,226,"2011"
"6131","210540 ITAPECURU MIRIM",2,2,10,76,1158,1248,"2011"
"6132","210542 ITINGA DO MARANHAO",1,2,29,357,0,389,"2011"
"6133","210545 JATOBA",0,1,15,133,0,149,"2011"
"6134","210547 JENIPAPO DOS VIEIRAS",0,6,5,218,79,308,"2011"
"6135","210550 JOAO LISBOA",1,2,12,386,5,406,"2011"
"6136","210560 JOSELANDIA",0,1,11,188,27,227,"2011"
"6137","210565 JUNCO DO MARANHAO",0,0,2,107,6,115,"2011"
"6138","210570 LAGO DA PEDRA",1,5,16,970,0,992,"2011"
"6139","210580 LAGO DO JUNCO",0,2,3,143,1,149,"2011"
"6140","210590 LAGO VERDE",5,1,19,264,16,305,"2011"
"6141","210592 LAGOA DO MATO",1,1,2,135,8,147,"2011"
"6142","210594 LAGO DOS RODRIGUES",3,1,0,153,1,158,"2011"
"6143","210596 LAGOA GRANDE DO MARANHAO",0,1,2,173,53,229,"2011"
"6144","210598 LAJEADO NOVO",1,0,1,118,1,121,"2011"
"6145","210600 LIMA CAMPOS",1,0,3,139,50,193,"2011"
"6146","210610 LORETO",0,0,2,17,172,191,"2011"
"6147","210620 LUIS DOMINGUES",0,1,0,57,51,109,"2011"
"6148","210630 MAGALHAES DE ALMEIDA",1,0,1,258,1,261,"2011"
"6149","210632 MARACACUME",4,0,1,392,7,404,"2011"
"6150","210635 MARAJA DO SENA",1,1,7,104,7,120,"2011"
"6151","210637 MARANHAOZINHO",1,0,5,183,10,199,"2011"
"6152","210640 MATA ROMA",1,1,8,344,3,357,"2011"
"6153","210650 MATINHA",1,2,7,97,339,446,"2011"
"6154","210660 MATOES",0,0,8,502,35,545,"2011"
"6155","210663 MATOES DO NORTE",0,0,1,56,62,119,"2011"
"6156","210667 MILAGRES DO MARANHAO",1,0,4,113,5,123,"2011"
"6157","210670 MIRADOR",0,2,8,371,2,383,"2011"
"6158","210675 MIRANDA DO NORTE",1,5,7,234,32,279,"2011"
"6159","210680 MIRINZAL",0,2,0,16,120,138,"2011"
"6160","210690 MONCAO",1,4,23,500,117,645,"2011"
"6161","210700 MONTES ALTOS",2,2,1,142,6,153,"2011"
"6162","210710 MORROS",0,1,3,340,56,400,"2011"
"6163","210720 NINA RODRIGUES",0,1,4,157,69,231,"2011"
"6164","210725 NOVA COLINAS",0,0,3,63,9,75,"2011"
"6165","210730 NOVA IORQUE",0,0,0,20,49,69,"2011"
"6166","210735 NOVA OLINDA DO MARANHAO",0,5,29,304,17,355,"2011"
"6167","210740 OLHO D'AGUA DAS CUNHAS",2,1,4,190,51,248,"2011"
"6168","210745 OLINDA NOVA DO MARANHAO",1,5,2,20,179,207,"2011"
"6169","210750 PACO DO LUMIAR",7,5,23,1426,114,1575,"2011"
"6170","210760 PALMEIRANDIA",0,1,5,146,153,305,"2011"
"6171","210770 PARAIBANO",1,1,22,317,0,341,"2011"
"6172","210780 PARNARAMA",0,3,3,323,254,583,"2011"
"6173","210790 PASSAGEM FRANCA",0,0,8,380,1,389,"2011"
"6174","210800 PASTOS BONS",0,0,2,41,302,345,"2011"
"6175","210805 PAULINO NEVES",0,0,3,182,84,269,"2011"
"6176","210810 PAULO RAMOS",1,0,15,425,22,463,"2011"
"6177","210820 PEDREIRAS",6,2,7,723,1,739,"2011"
"6178","210825 PEDRO DO ROSARIO",2,17,55,125,101,300,"2011"
"6179","210830 PENALVA",0,3,13,570,115,701,"2011"
"6180","210840 PERI MIRIM",0,1,4,120,46,171,"2011"
"6181","210845 PERITORO",2,4,17,377,45,445,"2011"
"6182","210850 PINDARE-MIRIM",2,5,18,562,15,602,"2011"
"6183","210860 PINHEIRO",1,8,51,1382,169,1611,"2011"
"6184","210870 PIO XII",2,3,5,522,4,536,"2011"
"6185","210880 PIRAPEMAS",0,0,3,48,274,325,"2011"
"6186","210890 POCAO DE PEDRAS",0,1,0,282,1,284,"2011"
"6187","210900 PORTO FRANCO",0,0,5,458,5,468,"2011"
"6188","210905 PORTO RICO DO MARANHAO",2,0,1,31,68,102,"2011"
"6189","210910 PRESIDENTE DUTRA",2,1,2,767,5,777,"2011"
"6190","210920 PRESIDENTE JUSCELINO",0,0,7,156,50,213,"2011"
"6191","210923 PRESIDENTE MEDICI",0,0,4,109,5,118,"2011"
"6192","210927 PRESIDENTE SARNEY",0,1,7,217,62,287,"2011"
"6193","210930 PRESIDENTE VARGAS",0,0,6,50,141,197,"2011"
"6194","210940 PRIMEIRA CRUZ",0,3,11,131,71,216,"2011"
"6195","210945 RAPOSA",3,3,12,501,18,537,"2011"
"6196","210950 RIACHAO",0,2,13,326,65,406,"2011"
"6197","210955 RIBAMAR FIQUENE",0,0,1,131,3,135,"2011"
"6198","210960 ROSARIO",2,3,22,636,25,688,"2011"
"6199","210970 SAMBAIBA",0,1,15,11,25,52,"2011"
"6200","210975 SANTA FILOMENA DO MARANHAO",1,0,5,110,1,117,"2011"
"6201","210980 SANTA HELENA",1,1,4,76,428,510,"2011"
"6202","210990 SANTA INES",6,12,80,1489,14,1601,"2011"
"6203","211000 SANTA LUZIA",3,6,30,1134,304,1477,"2011"
"6204","211003 SANTA LUZIA DO PARUA",0,1,3,439,0,443,"2011"
"6205","211010 SANTA QUITERIA DO MARANHAO",0,0,13,495,24,532,"2011"
"6206","211020 SANTA RITA",3,17,128,510,27,685,"2011"
"6207","211023 SANTANA DO MARANHAO",0,0,9,87,30,126,"2011"
"6208","211027 SANTO AMARO DO MARANHAO",1,0,1,44,135,181,"2011"
"6209","211030 SANTO ANTONIO DOS LOPES",2,0,2,66,201,271,"2011"
"6210","211040 SAO BENEDITO DO RIO PRETO",2,0,8,40,431,481,"2011"
"6211","211050 SAO BENTO",1,0,1,560,55,617,"2011"
"6212","211060 SAO BERNARDO",0,3,18,471,11,503,"2011"
"6213","211065 SAO DOMINGOS DO AZEITAO",0,0,0,11,96,107,"2011"
"6214","211070 SAO DOMINGOS DO MARANHAO",3,4,5,612,53,677,"2011"
"6215","211080 SAO FELIX DE BALSAS",0,0,0,2,48,50,"2011"
"6216","211085 SAO FRANCISCO DO BREJAO",1,0,4,116,3,124,"2011"
"6217","211090 SAO FRANCISCO DO MARANHAO",0,1,6,124,21,152,"2011"
"6218","211100 SAO JOAO BATISTA",1,72,42,144,39,298,"2011"
"6219","211102 SAO JOAO DO CARU",0,6,15,212,16,249,"2011"
"6220","211105 SAO JOAO DO PARAISO",0,0,2,169,4,175,"2011"
"6221","211107 SAO JOAO DO SOTER",1,0,1,277,26,305,"2011"
"6222","211110 SAO JOAO DOS PATOS",2,4,18,403,13,440,"2011"
"6223","211120 SAO JOSE DE RIBAMAR",1,11,42,2478,81,2613,"2011"
"6224","211125 SAO JOSE DOS BASILIOS",3,0,6,129,1,139,"2011"
"6225","211130 SAO LUIS",70,94,358,17432,362,18316,"2011"
"6226","211140 SAO LUIS GONZAGA DO MARANHAO",1,0,3,420,3,427,"2011"
"6227","211150 SAO MATEUS DO MARANHAO",3,5,64,706,13,791,"2011"
"6228","211153 SAO PEDRO DA AGUA BRANCA",0,0,5,142,3,150,"2011"
"6229","211157 SAO PEDRO DOS CRENTES",0,1,3,84,2,90,"2011"
"6230","211160 SAO RAIMUNDO DAS MANGABEIRAS",0,2,2,5,331,340,"2011"
"6231","211163 SAO RAIMUNDO DO DOCA BEZERRA",0,1,2,76,7,86,"2011"
"6232","211167 SAO ROBERTO",0,0,1,86,8,95,"2011"
"6233","211170 SAO VICENTE FERRER",1,0,2,175,221,399,"2011"
"6234","211172 SATUBINHA",3,1,4,152,2,162,"2011"
"6235","211174 SENADOR ALEXANDRE COSTA",0,0,4,133,51,188,"2011"
"6236","211176 SENADOR LA ROCQUE",1,1,7,329,7,345,"2011"
"6237","211178 SERRANO DO MARANHAO",0,0,0,69,123,192,"2011"
"6238","211180 SITIO NOVO",0,0,6,284,3,293,"2011"
"6239","211190 SUCUPIRA DO NORTE",0,4,9,165,28,206,"2011"
"6240","211195 SUCUPIRA DO RIACHAO",1,2,6,87,2,98,"2011"
"6241","211200 TASSO FRAGOSO",2,3,2,89,48,144,"2011"
"6242","211210 TIMBIRAS",1,6,10,461,4,482,"2011"
"6243","211220 TIMON",7,4,22,2380,37,2450,"2011"
"6244","211223 TRIZIDELA DO VALE",2,1,5,276,3,287,"2011"
"6245","211227 TUFILANDIA",1,1,1,105,5,113,"2011"
"6246","211230 TUNTUM",3,4,8,634,13,662,"2011"
"6247","211240 TURIACU",0,1,0,21,747,769,"2011"
"6248","211245 TURILANDIA",0,2,7,104,209,322,"2011"
"6249","211250 TUTOIA",17,16,22,610,304,969,"2011"
"6250","211260 URBANO SANTOS",1,9,5,164,580,759,"2011"
"6251","211270 VARGEM GRANDE",2,2,22,842,77,945,"2011"
"6252","211280 VIANA",5,9,41,679,354,1088,"2011"
"6253","211285 VILA NOVA DOS MARTIRIOS",0,1,6,158,3,168,"2011"
"6254","211290 VITORIA DO MEARIM",2,0,8,270,329,609,"2011"
"6255","211300 VITORINO FREIRE",0,3,26,473,7,509,"2011"
"6256","211400 ZE DOCA",2,6,40,765,9,822,"2011"
"6257","220005 ACAUA",0,0,0,97,7,104,"2011"
"6258","220010 AGRICOLANDIA",0,0,2,62,1,65,"2011"
"6259","220020 AGUA BRANCA",0,0,1,226,20,247,"2011"
"6260","220025 ALAGOINHA DO PIAUI",1,1,4,94,0,100,"2011"
"6261","220027 ALEGRETE DO PIAUI",0,0,2,89,0,91,"2011"
"6262","220030 ALTO LONGA",1,2,1,129,9,142,"2011"
"6263","220040 ALTOS",1,1,6,459,139,606,"2011"
"6264","220045 ALVORADA DO GURGUEIA",2,0,1,15,77,95,"2011"
"6265","220050 AMARANTE",0,0,12,231,20,263,"2011"
"6266","220060 ANGICAL DO PIAUI",2,2,1,68,16,89,"2011"
"6267","220070 ANISIO DE ABREU",0,0,0,60,81,141,"2011"
"6268","220080 ANTONIO ALMEIDA",1,0,2,14,20,37,"2011"
"6269","220090 AROAZES",1,0,0,77,0,78,"2011"
"6270","220095 AROEIRAS DO ITAIM",0,0,6,20,1,27,"2011"
"6271","220100 ARRAIAL",0,0,4,71,1,76,"2011"
"6272","220105 ASSUNCAO DO PIAUI",0,2,1,105,41,149,"2011"
"6273","220110 AVELINO LOPES",2,0,4,149,28,183,"2011"
"6274","220115 BAIXA GRANDE DO RIBEIRO",0,0,4,11,216,231,"2011"
"6275","220117 BARRA D'ALCANTARA",0,0,1,51,3,55,"2011"
"6276","220120 BARRAS",3,4,5,736,8,756,"2011"
"6277","220130 BARREIRAS DO PIAUI",0,0,0,14,26,40,"2011"
"6278","220140 BARRO DURO",0,0,4,86,10,100,"2011"
"6279","220150 BATALHA",1,3,5,368,6,383,"2011"
"6280","220155 BELA VISTA DO PIAUI",0,1,0,38,0,39,"2011"
"6281","220157 BELEM DO PIAUI",0,1,6,30,1,38,"2011"
"6282","220160 BENEDITINOS",0,1,0,101,15,117,"2011"
"6283","220170 BERTOLINIA",1,0,4,73,8,86,"2011"
"6284","220173 BETANIA DO PIAUI",0,1,0,116,6,123,"2011"
"6285","220177 BOA HORA",0,1,1,57,53,112,"2011"
"6286","220180 BOCAINA",1,0,15,41,0,57,"2011"
"6287","220190 BOM JESUS",0,2,0,53,394,449,"2011"
"6288","220191 BOM PRINCIPIO DO PIAUI",0,0,3,94,3,100,"2011"
"6289","220192 BONFIM DO PIAUI",1,0,0,26,53,80,"2011"
"6290","220194 BOQUEIRAO DO PIAUI",0,0,0,57,73,130,"2011"
"6291","220196 BRASILEIRA",1,0,0,96,5,102,"2011"
"6292","220198 BREJO DO PIAUI",0,3,0,43,2,48,"2011"
"6293","220200 BURITI DOS LOPES",0,0,4,334,4,342,"2011"
"6294","220202 BURITI DOS MONTES",0,0,0,37,40,77,"2011"
"6295","220205 CABECEIRAS DO PIAUI",0,0,1,105,48,154,"2011"
"6296","220207 CAJAZEIRAS DO PIAUI",0,0,0,39,1,40,"2011"
"6297","220208 CAJUEIRO DA PRAIA",1,0,1,96,1,99,"2011"
"6298","220209 CALDEIRAO GRANDE DO PIAUI",0,1,5,52,3,61,"2011"
"6299","220210 CAMPINAS DO PIAUI",0,0,3,68,1,72,"2011"
"6300","220211 CAMPO ALEGRE DO FIDALGO",0,1,1,72,3,77,"2011"
"6301","220213 CAMPO GRANDE DO PIAUI",1,0,8,85,0,94,"2011"
"6302","220217 CAMPO LARGO DO PIAUI",2,0,2,108,9,121,"2011"
"6303","220220 CAMPO MAIOR",0,1,6,376,506,889,"2011"
"6304","220225 CANAVIEIRA",1,0,4,51,9,65,"2011"
"6305","220230 CANTO DO BURITI",0,3,5,271,10,289,"2011"
"6306","220240 CAPITAO DE CAMPOS",1,0,1,92,72,166,"2011"
"6307","220245 CAPITAO GERVASIO OLIVEIRA",0,0,1,56,0,57,"2011"
"6308","220250 CARACOL",3,0,1,81,88,173,"2011"
"6309","220253 CARAUBAS DO PIAUI",1,0,1,89,1,92,"2011"
"6310","220255 CARIDADE DO PIAUI",2,0,2,68,0,72,"2011"
"6311","220260 CASTELO DO PIAUI",0,0,0,46,233,279,"2011"
"6312","220265 CAXINGO",0,1,0,96,0,97,"2011"
"6313","220270 COCAL",1,4,10,407,25,447,"2011"
"6314","220271 COCAL DE TELHA",0,0,1,39,29,69,"2011"
"6315","220272 COCAL DOS ALVES",0,0,0,84,4,88,"2011"
"6316","220273 COIVARAS",0,0,0,40,16,56,"2011"
"6317","220275 COLONIA DO GURGUEIA",0,3,2,78,18,101,"2011"
"6318","220277 COLONIA DO PIAUI",0,2,3,72,0,77,"2011"
"6319","220280 CONCEICAO DO CANINDE",0,1,5,62,6,74,"2011"
"6320","220285 CORONEL JOSE DIAS",0,0,0,22,28,50,"2011"
"6321","220290 CORRENTE",0,0,1,106,335,442,"2011"
"6322","220300 CRISTALANDIA DO PIAUI",0,0,3,89,46,138,"2011"
"6323","220310 CRISTINO CASTRO",0,0,0,26,161,187,"2011"
"6324","220320 CURIMATA",5,0,5,162,31,203,"2011"
"6325","220323 CURRAIS",1,0,0,7,94,102,"2011"
"6326","220325 CURRALINHOS",0,0,1,56,2,59,"2011"
"6327","220327 CURRAL NOVO DO PIAUI",0,0,0,77,5,82,"2011"
"6328","220330 DEMERVAL LOBAO",0,2,0,200,10,212,"2011"
"6329","220335 DIRCEU ARCOVERDE",0,0,0,51,38,89,"2011"
"6330","220340 DOM EXPEDITO LOPES",0,0,8,78,0,86,"2011"
"6331","220342 DOMINGOS MOURAO",1,0,1,61,2,65,"2011"
"6332","220345 DOM INOCENCIO",0,0,1,41,48,90,"2011"
"6333","220350 ELESBAO VELOSO",1,0,2,180,8,191,"2011"
"6334","220360 ELISEU MARTINS",0,0,0,40,3,43,"2011"
"6335","220370 ESPERANTINA",5,4,7,607,14,637,"2011"
"6336","220375 FARTURA DO PIAUI",0,0,1,33,33,67,"2011"
"6337","220380 FLORES DO PIAUI",1,0,3,69,0,73,"2011"
"6338","220385 FLORESTA DO PIAUI",0,1,0,22,1,24,"2011"
"6339","220390 FLORIANO",6,9,62,973,11,1061,"2011"
"6340","220400 FRANCINOPOLIS",3,1,0,47,3,54,"2011"
"6341","220410 FRANCISCO AYRES",1,0,7,53,1,62,"2011"
"6342","220415 FRANCISCO MACEDO",0,1,1,49,1,52,"2011"
"6343","220420 FRANCISCO SANTOS",0,0,10,99,1,110,"2011"
"6344","220430 FRONTEIRAS",0,1,3,164,0,168,"2011"
"6345","220435 GEMINIANO",0,1,7,75,0,83,"2011"
"6346","220440 GILBUES",0,0,3,84,85,172,"2011"
"6347","220450 GUADALUPE",0,2,9,131,63,205,"2011"
"6348","220455 GUARIBAS",0,0,0,29,56,85,"2011"
"6349","220460 HUGO NAPOLEAO",0,0,0,51,3,54,"2011"
"6350","220465 ILHA GRANDE",0,0,2,112,0,114,"2011"
"6351","220470 INHUMA",1,1,2,189,1,194,"2011"
"6352","220480 IPIRANGA DO PIAUI",0,1,5,128,1,135,"2011"
"6353","220490 ISAIAS COELHO",0,1,1,123,4,129,"2011"
"6354","220500 ITAINOPOLIS",0,1,3,97,2,103,"2011"
"6355","220510 ITAUEIRA",0,0,4,139,1,144,"2011"
"6356","220515 JACOBINA DO PIAUI",0,0,2,75,1,78,"2011"
"6357","220520 JAICOS",0,0,9,299,3,311,"2011"
"6358","220525 JARDIM DO MULATO",0,0,1,51,3,55,"2011"
"6359","220527 JATOBA DO PIAUI",0,0,1,41,36,78,"2011"
"6360","220530 JERUMENHA",0,0,5,72,4,81,"2011"
"6361","220535 JOAO COSTA",0,0,1,35,1,37,"2011"
"6362","220540 JOAQUIM PIRES",0,0,4,219,1,224,"2011"
"6363","220545 JOCA MARQUES",0,1,0,93,2,96,"2011"
"6364","220550 JOSE DE FREITAS",1,1,4,550,18,574,"2011"
"6365","220551 JUAZEIRO DO PIAUI",0,0,0,33,30,63,"2011"
"6366","220552 JULIO BORGES",0,1,4,49,18,72,"2011"
"6367","220553 JUREMA",0,1,1,32,56,90,"2011"
"6368","220554 LAGOINHA DO PIAUI",0,0,0,33,4,37,"2011"
"6369","220555 LAGOA ALEGRE",0,0,1,107,22,130,"2011"
"6370","220556 LAGOA DO BARRO DO PIAUI",0,0,0,54,7,61,"2011"
"6371","220557 LAGOA DE SAO FRANCISCO",0,1,2,93,1,97,"2011"
"6372","220558 LAGOA DO PIAUI",0,0,1,52,2,55,"2011"
"6373","220559 LAGOA DO SITIO",0,0,1,63,3,67,"2011"
"6374","220560 LANDRI SALES",0,0,3,55,5,63,"2011"
"6375","220570 LUIS CORREIA",2,1,4,473,11,491,"2011"
"6376","220580 LUZILANDIA",1,3,11,419,35,469,"2011"
"6377","220585 MADEIRO",0,0,2,147,12,161,"2011"
"6378","220590 MANOEL EMIDIO",2,0,3,80,5,90,"2011"
"6379","220595 MARCOLANDIA",1,3,8,133,0,145,"2011"
"6380","220600 MARCOS PARENTE",1,0,5,54,5,65,"2011"
"6381","220605 MASSAPE DO PIAUI",0,0,4,73,1,78,"2011"
"6382","220610 MATIAS OLIMPIO",1,0,8,185,2,196,"2011"
"6383","220620 MIGUEL ALVES",4,2,8,502,57,573,"2011"
"6384","220630 MIGUEL LEAO",0,0,1,23,1,25,"2011"
"6385","220635 MILTON BRANDAO",0,1,1,73,3,78,"2011"
"6386","220640 MONSENHOR GIL",0,1,2,112,9,124,"2011"
"6387","220650 MONSENHOR HIPOLITO",0,0,1,102,0,103,"2011"
"6388","220660 MONTE ALEGRE DO PIAUI",2,3,0,56,81,142,"2011"
"6389","220665 MORRO CABECA NO TEMPO",2,0,1,68,13,84,"2011"
"6390","220667 MORRO DO CHAPEU DO PIAUI",1,1,2,84,1,89,"2011"
"6391","220669 MURICI DOS PORTELAS",1,0,0,110,11,122,"2011"
"6392","220670 NAZARE DO PIAUI",0,0,6,84,1,91,"2011"
"6393","220672 NAZARIA",2,0,3,140,3,148,"2011"
"6394","220675 NOSSA SENHORA DE NAZARE",0,0,0,28,33,61,"2011"
"6395","220680 NOSSA SENHORA DOS REMEDIOS",1,2,0,142,23,168,"2011"
"6396","220690 NOVO ORIENTE DO PIAUI",0,0,0,82,2,84,"2011"
"6397","220695 NOVO SANTO ANTONIO",0,0,0,32,0,32,"2011"
"6398","220700 OEIRAS",3,3,5,445,8,464,"2011"
"6399","220710 OLHO D'AGUA DO PIAUI",0,2,0,37,3,42,"2011"
"6400","220720 PADRE MARCOS",0,2,10,83,8,103,"2011"
"6401","220730 PAES LANDIM",0,0,1,53,0,54,"2011"
"6402","220735 PAJEU DO PIAUI",1,0,0,27,0,28,"2011"
"6403","220740 PALMEIRA DO PIAUI",0,0,1,15,81,97,"2011"
"6404","220750 PALMEIRAIS",0,1,4,170,62,237,"2011"
"6405","220755 PAQUETA",1,0,1,43,0,45,"2011"
"6406","220760 PARNAGUA",0,0,1,38,156,195,"2011"
"6407","220770 PARNAIBA",5,8,37,2238,20,2308,"2011"
"6408","220775 PASSAGEM FRANCA DO PIAUI",0,0,1,66,6,73,"2011"
"6409","220777 PATOS DO PIAUI",0,1,9,57,2,69,"2011"
"6410","220779 PAU D'ARCO DO PIAUI",0,0,0,30,2,32,"2011"
"6411","220780 PAULISTANA",1,3,3,305,23,335,"2011"
"6412","220785 PAVUSSU",0,2,1,56,1,60,"2011"
"6413","220790 PEDRO II",1,4,15,531,11,562,"2011"
"6414","220793 PEDRO LAURENTINO",0,0,0,36,0,36,"2011"
"6415","220795 NOVA SANTA RITA",0,2,2,67,0,71,"2011"
"6416","220800 PICOS",3,6,89,1013,7,1118,"2011"
"6417","220810 PIMENTEIRAS",1,2,2,128,5,138,"2011"
"6418","220820 PIO IX",1,0,10,270,1,282,"2011"
"6419","220830 PIRACURUCA",0,0,3,439,5,447,"2011"
"6420","220840 PIRIPIRI",1,1,9,862,39,912,"2011"
"6421","220850 PORTO",1,0,3,250,3,257,"2011"
"6422","220855 PORTO ALEGRE DO PIAUI",0,0,2,28,8,38,"2011"
"6423","220860 PRATA DO PIAUI",0,0,3,37,1,41,"2011"
"6424","220865 QUEIMADA NOVA",0,1,2,101,7,111,"2011"
"6425","220870 REDENCAO DO GURGUEIA",1,0,0,20,134,155,"2011"
"6426","220880 REGENERACAO",5,1,6,335,8,355,"2011"
"6427","220885 RIACHO FRIO",0,0,0,26,49,75,"2011"
"6428","220887 RIBEIRA DO PIAUI",0,2,1,59,3,65,"2011"
"6429","220890 RIBEIRO GONCALVES",0,0,21,16,89,126,"2011"
"6430","220900 RIO GRANDE DO PIAUI",0,0,3,81,2,86,"2011"
"6431","220910 SANTA CRUZ DO PIAUI",0,1,2,65,0,68,"2011"
"6432","220915 SANTA CRUZ DOS MILAGRES",0,0,0,47,0,47,"2011"
"6433","220920 SANTA FILOMENA",1,1,0,96,13,111,"2011"
"6434","220930 SANTA LUZ",0,0,0,3,84,87,"2011"
"6435","220935 SANTANA DO PIAUI",0,1,2,47,1,51,"2011"
"6436","220937 SANTA ROSA DO PIAUI",0,2,4,63,0,69,"2011"
"6437","220940 SANTO ANTONIO DE LISBOA",0,1,5,70,0,76,"2011"
"6438","220945 SANTO ANTONIO DOS MILAGRES",0,1,0,25,4,30,"2011"
"6439","220950 SANTO INACIO DO PIAUI",1,1,1,45,0,48,"2011"
"6440","220955 SAO BRAZ DO PIAUI",1,0,0,27,33,61,"2011"
"6441","220960 SAO FELIX DO PIAUI",0,0,0,17,3,20,"2011"
"6442","220965 SAO FRANCISCO DE ASSIS DO PIAUI",0,0,0,67,1,68,"2011"
"6443","220970 SAO FRANCISCO DO PIAUI",0,0,2,81,0,83,"2011"
"6444","220975 SAO GONCALO DO GURGUEIA",0,0,0,9,31,40,"2011"
"6445","220980 SAO GONCALO DO PIAUI",3,0,0,73,6,82,"2011"
"6446","220985 SAO JOAO DA CANABRAVA",0,0,1,60,2,63,"2011"
"6447","220987 SAO JOAO DA FRONTEIRA",0,0,0,77,1,78,"2011"
"6448","220990 SAO JOAO DA SERRA",0,1,0,41,36,78,"2011"
"6449","220995 SAO JOAO DA VARJOTA",0,1,1,77,0,79,"2011"
"6450","220997 SAO JOAO DO ARRAIAL",0,1,1,137,4,143,"2011"
"6451","221000 SAO JOAO DO PIAUI",0,3,10,325,1,339,"2011"
"6452","221005 SAO JOSE DO DIVINO",0,0,0,66,0,66,"2011"
"6453","221010 SAO JOSE DO PEIXE",1,1,4,57,2,65,"2011"
"6454","221020 SAO JOSE DO PIAUI",0,1,8,84,0,93,"2011"
"6455","221030 SAO JULIAO",0,1,10,95,3,109,"2011"
"6456","221035 SAO LOURENCO DO PIAUI",0,0,0,20,33,53,"2011"
"6457","221037 SAO LUIS DO PIAUI",0,1,1,27,5,34,"2011"
"6458","221038 SAO MIGUEL DA BAIXA GRANDE",0,0,0,32,3,35,"2011"
"6459","221039 SAO MIGUEL DO FIDALGO",0,0,0,36,0,36,"2011"
"6460","221040 SAO MIGUEL DO TAPUIO",1,0,2,191,36,230,"2011"
"6461","221050 SAO PEDRO DO PIAUI",11,3,6,142,31,193,"2011"
"6462","221060 SAO RAIMUNDO NONATO",1,0,4,249,330,584,"2011"
"6463","221062 SEBASTIAO BARROS",1,1,1,40,34,77,"2011"
"6464","221063 SEBASTIAO LEAL",0,0,1,19,29,49,"2011"
"6465","221065 SIGEFREDO PACHECO",0,0,2,53,28,83,"2011"
"6466","221070 SIMOES",0,1,2,238,2,243,"2011"
"6467","221080 SIMPLICIO MENDES",1,1,2,174,0,178,"2011"
"6468","221090 SOCORRO DO PIAUI",0,1,1,49,3,54,"2011"
"6469","221093 SUSSUAPARA",0,0,3,78,0,81,"2011"
"6470","221095 TAMBORIL DO PIAUI",0,0,0,25,18,43,"2011"
"6471","221097 TANQUE DO PIAUI",0,1,0,28,0,29,"2011"
"6472","221100 TERESINA",52,37,165,13394,288,13936,"2011"
"6473","221110 UNIAO",0,3,2,353,389,747,"2011"
"6474","221120 URUCUI",0,0,3,47,347,397,"2011"
"6475","221130 VALENCA DO PIAUI",1,0,2,288,3,294,"2011"
"6476","221135 VARZEA BRANCA",1,0,0,37,49,87,"2011"
"6477","221140 VARZEA GRANDE",0,1,1,56,2,60,"2011"
"6478","221150 VERA MENDES",1,1,3,31,0,36,"2011"
"6479","221160 VILA NOVA DO PIAUI",0,0,4,29,0,33,"2011"
"6480","221170 WALL FERRAZ",3,2,4,47,5,61,"2011"
"6481","MUNICIPIO IGNORADO - CE",0,0,0,3,0,3,"2011"
"6482","230010 ABAIARA",0,0,5,144,2,151,"2011"
"6483","230015 ACARAPE",2,1,3,188,1,195,"2011"
"6484","230020 ACARAU",1,5,13,936,9,964,"2011"
"6485","230030 ACOPIARA",4,6,60,607,5,682,"2011"
"6486","230040 AIUABA",0,4,5,183,4,196,"2011"
"6487","230050 ALCANTARAS",0,1,1,128,0,130,"2011"
"6488","230060 ALTANEIRA",0,1,7,86,2,96,"2011"
"6489","230070 ALTO SANTO",0,1,5,207,0,213,"2011"
"6490","230075 AMONTADA",2,4,13,657,30,706,"2011"
"6491","230080 ANTONINA DO NORTE",0,1,9,111,0,121,"2011"
"6492","230090 APUIARES",0,0,3,173,2,178,"2011"
"6493","230100 AQUIRAZ",4,2,32,955,5,998,"2011"
"6494","230110 ARACATI",6,3,25,937,5,976,"2011"
"6495","230120 ARACOIABA",2,1,12,358,5,378,"2011"
"6496","230125 ARARENDA",0,1,0,132,2,135,"2011"
"6497","230130 ARARIPE",2,2,17,376,3,400,"2011"
"6498","230140 ARATUBA",1,0,5,160,2,168,"2011"
"6499","230150 ARNEIROZ",0,1,5,88,2,96,"2011"
"6500","230160 ASSARE",0,3,5,285,1,294,"2011"
"6501","230170 AURORA",0,2,12,333,1,348,"2011"
"6502","230180 BAIXIO",1,0,1,52,0,54,"2011"
"6503","230185 BANABUIU",1,0,38,235,1,275,"2011"
"6504","230190 BARBALHA",3,6,27,1061,38,1135,"2011"
"6505","230195 BARREIRA",2,0,4,289,1,296,"2011"
"6506","230200 BARRO",1,1,7,296,0,305,"2011"
"6507","230205 BARROQUINHA",0,1,5,191,0,197,"2011"
"6508","230210 BATURITE",6,1,8,472,4,491,"2011"
"6509","230220 BEBERIBE",2,3,17,591,1,614,"2011"
"6510","230230 BELA CRUZ",0,4,7,367,0,378,"2011"
"6511","230240 BOA VIAGEM",2,3,9,714,4,732,"2011"
"6512","230250 BREJO SANTO",0,0,16,694,1,711,"2011"
"6513","230260 CAMOCIM",2,3,28,1030,3,1066,"2011"
"6514","230270 CAMPOS SALES",0,3,13,390,1,407,"2011"
"6515","230280 CANINDE",4,7,25,1023,13,1072,"2011"
"6516","230290 CAPISTRANO",0,1,4,232,1,238,"2011"
"6517","230300 CARIDADE",0,1,2,218,0,221,"2011"
"6518","230310 CARIRE",1,2,5,188,0,196,"2011"
"6519","230320 CARIRIACU",0,0,16,339,2,357,"2011"
"6520","230330 CARIUS",1,3,14,208,0,226,"2011"
"6521","230340 CARNAUBAL",1,0,5,231,1,238,"2011"
"6522","230350 CASCAVEL",1,3,22,899,11,936,"2011"
"6523","230360 CATARINA",0,4,7,156,0,167,"2011"
"6524","230365 CATUNDA",1,0,3,102,0,106,"2011"
"6525","230370 CAUCAIA",20,17,93,4738,61,4929,"2011"
"6526","230380 CEDRO",2,5,2,310,1,320,"2011"
"6527","230390 CHAVAL",0,1,5,231,1,238,"2011"
"6528","230393 CHORO",0,1,9,186,7,203,"2011"
"6529","230395 CHOROZINHO",1,1,6,279,1,288,"2011"
"6530","230400 COREAU",1,2,10,327,0,340,"2011"
"6531","230410 CRATEUS",1,0,7,1025,23,1056,"2011"
"6532","230420 CRATO",2,28,87,1983,8,2108,"2011"
"6533","230423 CROATA",2,5,10,207,1,225,"2011"
"6534","230425 CRUZ",0,1,8,344,4,357,"2011"
"6535","230426 DEPUTADO IRAPUAN PINHEIRO",1,1,9,101,0,112,"2011"
"6536","230427 ERERE",0,1,3,32,1,37,"2011"
"6537","230428 EUSEBIO",2,3,30,782,4,821,"2011"
"6538","230430 FARIAS BRITO",3,3,19,277,1,303,"2011"
"6539","230435 FORQUILHA",1,2,3,323,2,331,"2011"
"6540","230440 FORTALEZA",97,126,543,36269,476,37511,"2011"
"6541","230445 FORTIM",0,2,2,144,0,148,"2011"
"6542","230450 FRECHEIRINHA",2,0,7,202,1,212,"2011"
"6543","230460 GENERAL SAMPAIO",0,0,2,120,4,126,"2011"
"6544","230465 GRACA",0,1,5,196,0,202,"2011"
"6545","230470 GRANJA",3,11,31,766,1,812,"2011"
"6546","230480 GRANJEIRO",1,0,4,70,1,76,"2011"
"6547","230490 GROAIRAS",0,0,7,125,0,132,"2011"
"6548","230495 GUAIUBA",0,2,7,359,1,369,"2011"
"6549","230500 GUARACIABA DO NORTE",2,2,23,618,5,650,"2011"
"6550","230510 GUARAMIRANGA",0,0,2,93,1,96,"2011"
"6551","230520 HIDROLANDIA",2,4,3,203,1,213,"2011"
"6552","230523 HORIZONTE",2,4,25,1003,5,1039,"2011"
"6553","230526 IBARETAMA",0,2,9,184,3,198,"2011"
"6554","230530 IBIAPINA",1,0,9,334,1,345,"2011"
"6555","230533 IBICUITINGA",0,2,2,171,0,175,"2011"
"6556","230535 ICAPUI",0,2,4,245,1,252,"2011"
"6557","230540 ICO",2,3,15,850,1,871,"2011"
"6558","230550 IGUATU",13,31,119,1198,6,1367,"2011"
"6559","230560 INDEPENDENCIA",0,2,7,302,11,322,"2011"
"6560","230565 IPAPORANGA",0,0,4,161,4,169,"2011"
"6561","230570 IPAUMIRIM",0,1,4,157,0,162,"2011"
"6562","230580 IPU",1,6,8,570,1,586,"2011"
"6563","230590 IPUEIRAS",7,1,15,535,10,568,"2011"
"6564","230600 IRACEMA",1,1,5,165,1,173,"2011"
"6565","230610 IRAUCUBA",2,4,3,368,1,378,"2011"
"6566","230620 ITAICABA",0,0,1,80,2,83,"2011"
"6567","230625 ITAITINGA",0,1,5,438,5,449,"2011"
"6568","230630 ITAPAGE",3,3,16,745,3,770,"2011"
"6569","230640 ITAPIPOCA",4,4,24,2017,25,2074,"2011"
"6570","230650 ITAPIUNA",1,1,6,270,2,280,"2011"
"6571","230655 ITAREMA",1,2,8,673,1,685,"2011"
"6572","230660 ITATIRA",4,3,5,273,4,289,"2011"
"6573","230670 JAGUARETAMA",0,2,2,227,0,231,"2011"
"6574","230680 JAGUARIBARA",1,1,2,142,1,147,"2011"
"6575","230690 JAGUARIBE",0,6,8,465,2,481,"2011"
"6576","230700 JAGUARUANA",2,3,11,361,0,377,"2011"
"6577","230710 JARDIM",2,4,11,387,5,409,"2011"
"6578","230720 JATI",0,1,7,125,0,133,"2011"
"6579","230725 JIJOCA DE JERICOACOARA",3,1,11,243,1,259,"2011"
"6580","230730 JUAZEIRO DO NORTE",29,48,185,3961,45,4268,"2011"
"6581","230740 JUCAS",4,3,12,351,0,370,"2011"
"6582","230750 LAVRAS DA MANGABEIRA",2,4,8,341,0,355,"2011"
"6583","230760 LIMOEIRO DO NORTE",0,11,18,791,1,821,"2011"
"6584","230763 MADALENA",1,4,3,239,0,247,"2011"
"6585","230765 MARACANAU",4,14,72,4259,22,4371,"2011"
"6586","230770 MARANGUAPE",1,2,22,1296,22,1343,"2011"
"6587","230780 MARCO",2,1,10,487,2,502,"2011"
"6588","230790 MARTINOPOLE",0,0,6,156,1,163,"2011"
"6589","230800 MASSAPE",0,6,7,503,1,517,"2011"
"6590","230810 MAURITI",1,2,10,695,0,708,"2011"
"6591","230820 MERUOCA",0,2,8,194,6,210,"2011"
"6592","230830 MILAGRES",1,0,4,400,3,408,"2011"
"6593","230835 MILHA",0,3,8,146,0,157,"2011"
"6594","230837 MIRAIMA",1,1,2,208,0,212,"2011"
"6595","230840 MISSAO VELHA",1,4,14,552,7,578,"2011"
"6596","230850 MOMBACA",2,2,24,515,8,551,"2011"
"6597","230860 MONSENHOR TABOSA",0,0,4,205,2,211,"2011"
"6598","230870 MORADA NOVA",2,2,8,771,4,787,"2011"
"6599","230880 MORAUJO",0,0,2,100,0,102,"2011"
"6600","230890 MORRINHOS",0,1,6,268,1,276,"2011"
"6601","230900 MUCAMBO",0,0,7,182,0,189,"2011"
"6602","230910 MULUNGU",0,0,1,127,0,128,"2011"
"6603","230920 NOVA OLINDA",2,0,8,225,3,238,"2011"
"6604","230930 NOVA RUSSAS",1,4,8,406,2,421,"2011"
"6605","230940 NOVO ORIENTE",1,1,8,343,10,363,"2011"
"6606","230945 OCARA",2,2,2,298,3,307,"2011"
"6607","230950 OROS",1,1,6,290,1,299,"2011"
"6608","230960 PACAJUS",1,4,20,830,4,859,"2011"
"6609","230970 PACATUBA",0,5,23,733,5,766,"2011"
"6610","230980 PACOTI",0,2,3,179,2,186,"2011"
"6611","230990 PACUJA",0,0,0,78,1,79,"2011"
"6612","231000 PALHANO",0,0,4,112,1,117,"2011"
"6613","231010 PALMACIA",0,1,2,117,1,121,"2011"
"6614","231020 PARACURU",2,1,13,552,3,571,"2011"
"6615","231025 PARAIPABA",2,0,11,439,3,455,"2011"
"6616","231030 PARAMBU",0,23,47,363,6,439,"2011"
"6617","231040 PARAMOTI",2,0,1,130,0,133,"2011"
"6618","231050 PEDRA BRANCA",2,1,10,563,0,576,"2011"
"6619","231060 PENAFORTE",0,0,6,161,0,167,"2011"
"6620","231070 PENTECOSTE",0,4,6,520,3,533,"2011"
"6621","231080 PEREIRO",1,2,6,196,0,205,"2011"
"6622","231085 PINDORETAMA",0,1,4,282,1,288,"2011"
"6623","231090 PIQUET CARNEIRO",1,1,15,160,1,178,"2011"
"6624","231095 PIRES FERREIRA",0,0,4,114,2,120,"2011"
"6625","231100 PORANGA",0,2,6,148,4,160,"2011"
"6626","231110 PORTEIRAS",0,2,6,247,0,255,"2011"
"6627","231120 POTENGI",2,1,7,138,0,148,"2011"
"6628","231123 POTIRETAMA",1,0,2,80,0,83,"2011"
"6629","231126 QUITERIANOPOLIS",0,2,4,270,6,282,"2011"
"6630","231130 QUIXADA",2,17,30,1288,11,1348,"2011"
"6631","231135 QUIXELO",0,4,13,190,1,208,"2011"
"6632","231140 QUIXERAMOBIM",6,9,61,1041,12,1129,"2011"
"6633","231150 QUIXERE",2,2,6,289,1,300,"2011"
"6634","231160 REDENCAO",6,2,5,389,2,404,"2011"
"6635","231170 RERIUTABA",1,2,5,240,1,249,"2011"
"6636","231180 RUSSAS",5,4,18,939,1,967,"2011"
"6637","231190 SABOEIRO",0,5,19,174,4,202,"2011"
"6638","231195 SALITRE",1,1,12,244,0,258,"2011"
"6639","231200 SANTANA DO ACARAU",1,3,4,466,2,476,"2011"
"6640","231210 SANTANA DO CARIRI",2,5,3,217,0,227,"2011"
"6641","231220 SANTA QUITERIA",0,3,10,559,1,573,"2011"
"6642","231230 SAO BENEDITO",3,6,23,785,7,824,"2011"
"6643","231240 SAO GONCALO DO AMARANTE",7,3,14,740,10,774,"2011"
"6644","231250 SAO JOAO DO JAGUARIBE",0,0,2,81,0,83,"2011"
"6645","231260 SAO LUIS DO CURU",0,1,4,168,1,174,"2011"
"6646","231270 SENADOR POMPEU",0,0,8,299,1,308,"2011"
"6647","231280 SENADOR SA",0,1,2,101,1,105,"2011"
"6648","231290 SOBRAL",4,21,71,3086,11,3193,"2011"
"6649","231300 SOLONOPOLE",1,3,5,197,0,206,"2011"
"6650","231310 TABULEIRO DO NORTE",1,3,15,404,0,423,"2011"
"6651","231320 TAMBORIL",0,0,5,319,6,330,"2011"
"6652","231325 TARRAFAS",0,0,8,72,0,80,"2011"
"6653","231330 TAUA",0,2,30,714,12,758,"2011"
"6654","231335 TEJUCUOCA",1,1,6,252,4,264,"2011"
"6655","231340 TIANGUA",5,8,17,1182,14,1226,"2011"
"6656","231350 TRAIRI",0,4,16,753,5,778,"2011"
"6657","231355 TURURU",1,1,2,258,2,264,"2011"
"6658","231360 UBAJARA",6,3,11,498,6,524,"2011"
"6659","231370 UMARI",0,1,2,74,1,78,"2011"
"6660","231375 UMIRIM",0,0,1,305,2,308,"2011"
"6661","231380 URUBURETAMA",1,0,8,400,2,411,"2011"
"6662","231390 URUOCA",0,1,2,197,0,200,"2011"
"6663","231395 VARJOTA",0,0,8,268,3,279,"2011"
"6664","231400 VARZEA ALEGRE",0,3,12,502,3,520,"2011"
"6665","231410 VICOSA DO CEARA",2,3,23,944,13,985,"2011"
"6666","MUNICIPIO IGNORADO - RN",0,0,0,16,0,16,"2011"
"6667","240010 ACARI",0,2,7,154,0,163,"2011"
"6668","240020 ACU",3,1,7,815,0,826,"2011"
"6669","240030 AFONSO BEZERRA",2,1,1,142,1,147,"2011"
"6670","240040 AGUA NOVA",0,1,1,52,0,54,"2011"
"6671","240050 ALEXANDRIA",0,1,2,171,0,174,"2011"
"6672","240060 ALMINO AFONSO",0,0,0,77,0,77,"2011"
"6673","240070 ALTO DO RODRIGUES",0,0,1,135,1,137,"2011"
"6674","240080 ANGICOS",2,0,3,148,1,154,"2011"
"6675","240090 ANTONIO MARTINS",0,1,0,92,0,93,"2011"
"6676","240100 APODI",0,2,1,434,0,437,"2011"
"6677","240110 AREIA BRANCA",1,0,13,297,0,311,"2011"
"6678","240120 ARES",2,2,6,183,3,196,"2011"
"6679","240130 AUGUSTO SEVERO",0,1,2,89,0,92,"2011"
"6680","240140 BAIA FORMOSA",0,1,3,113,1,118,"2011"
"6681","240145 BARAUNA",0,5,7,345,2,359,"2011"
"6682","240150 BARCELONA",0,0,1,36,1,38,"2011"
"6683","240160 BENTO FERNANDES",0,1,2,68,1,72,"2011"
"6684","240165 BODO",0,0,2,38,0,40,"2011"
"6685","240170 BOM JESUS",0,1,2,130,1,134,"2011"
"6686","240180 BREJINHO",0,1,2,160,1,164,"2011"
"6687","240185 CAICARA DO NORTE",0,0,1,89,0,90,"2011"
"6688","240190 CAICARA DO RIO DO VENTO",0,0,0,42,0,42,"2011"
"6689","240200 CAICO",3,13,42,730,0,788,"2011"
"6690","240210 CAMPO REDONDO",2,0,3,124,0,129,"2011"
"6691","240220 CANGUARETAMA",3,4,6,628,9,650,"2011"
"6692","240230 CARAUBAS",1,2,5,319,0,327,"2011"
"6693","240240 CARNAUBA DOS DANTAS",0,0,3,92,1,96,"2011"
"6694","240250 CARNAUBAIS",1,0,2,137,0,140,"2011"
"6695","240260 CEARA-MIRIM",6,4,23,1180,9,1222,"2011"
"6696","240270 CERRO CORA",1,1,8,165,0,175,"2011"
"6697","240280 CORONEL EZEQUIEL",0,1,3,69,0,73,"2011"
"6698","240290 CORONEL JOAO PESSOA",0,1,0,53,0,54,"2011"
"6699","240300 CRUZETA",1,1,4,101,0,107,"2011"
"6700","240310 CURRAIS NOVOS",1,2,28,554,2,587,"2011"
"6701","240320 DOUTOR SEVERIANO",0,0,1,103,0,104,"2011"
"6702","240325 PARNAMIRIM",8,18,53,3326,13,3418,"2011"
"6703","240330 ENCANTO",0,1,1,86,1,89,"2011"
"6704","240340 EQUADOR",0,0,3,80,1,84,"2011"
"6705","240350 ESPIRITO SANTO",0,0,2,137,4,143,"2011"
"6706","240360 EXTREMOZ",0,1,9,433,2,445,"2011"
"6707","240370 FELIPE GUERRA",0,0,0,80,1,81,"2011"
"6708","240375 FERNANDO PEDROZA",0,0,2,46,0,48,"2011"
"6709","240380 FLORANIA",0,1,5,116,1,123,"2011"
"6710","240390 FRANCISCO DANTAS",0,0,0,33,0,33,"2011"
"6711","240400 FRUTUOSO GOMES",0,0,1,72,0,73,"2011"
"6712","240410 GALINHOS",0,0,0,19,0,19,"2011"
"6713","240420 GOIANINHA",2,2,12,532,4,552,"2011"
"6714","240430 GOVERNADOR DIX-SEPT ROSADO",0,4,5,161,0,170,"2011"
"6715","240440 GROSSOS",0,0,5,106,1,112,"2011"
"6716","240450 GUAMARE",0,2,5,235,1,243,"2011"
"6717","240460 IELMO MARINHO",0,0,3,114,1,118,"2011"
"6718","240470 IPANGUACU",0,1,5,235,1,242,"2011"
"6719","240480 IPUEIRA",0,0,2,16,0,18,"2011"
"6720","240485 ITAJA",0,0,2,121,0,123,"2011"
"6721","240490 ITAU",0,1,0,73,0,74,"2011"
"6722","240500 JACANA",0,1,3,99,0,103,"2011"
"6723","240510 JANDAIRA",1,1,4,77,0,83,"2011"
"6724","240520 JANDUIS",0,0,4,75,0,79,"2011"
"6725","240530 JANUARIO CICCO",0,0,2,122,3,127,"2011"
"6726","240540 JAPI",0,1,0,92,1,94,"2011"
"6727","240550 JARDIM DE ANGICOS",0,0,0,33,0,33,"2011"
"6728","240560 JARDIM DE PIRANHAS",1,1,10,178,0,190,"2011"
"6729","240570 JARDIM DO SERIDO",0,1,6,111,0,118,"2011"
"6730","240580 JOAO CAMARA",0,4,18,540,5,567,"2011"
"6731","240590 JOAO DIAS",0,0,0,36,0,36,"2011"
"6732","240600 JOSE DA PENHA",0,0,1,75,0,76,"2011"
"6733","240610 JUCURUTU",2,3,6,255,3,269,"2011"
"6734","240615 JUNDIA",0,0,0,37,1,38,"2011"
"6735","240620 LAGOA D'ANTA",0,1,4,93,3,101,"2011"
"6736","240630 LAGOA DE PEDRAS",0,1,3,86,1,91,"2011"
"6737","240640 LAGOA DE VELHOS",0,0,0,33,0,33,"2011"
"6738","240650 LAGOA NOVA",0,0,14,245,0,259,"2011"
"6739","240660 LAGOA SALGADA",2,1,2,161,2,168,"2011"
"6740","240670 LAJES",0,0,1,120,0,121,"2011"
"6741","240680 LAJES PINTADAS",0,1,3,65,0,69,"2011"
"6742","240690 LUCRECIA",0,0,0,59,0,59,"2011"
"6743","240700 LUIS GOMES",0,1,1,193,0,195,"2011"
"6744","240710 MACAIBA",3,9,20,813,8,853,"2011"
"6745","240720 MACAU",0,1,4,200,0,205,"2011"
"6746","240725 MAJOR SALES",0,0,1,61,0,62,"2011"
"6747","240730 MARCELINO VIEIRA",0,0,1,109,0,110,"2011"
"6748","240740 MARTINS",0,1,0,78,0,79,"2011"
"6749","240750 MAXARANGUAPE",0,0,1,167,5,173,"2011"
"6750","240760 MESSIAS TARGINO",0,0,2,50,0,52,"2011"
"6751","240770 MONTANHAS",0,1,4,181,3,189,"2011"
"6752","240780 MONTE ALEGRE",1,4,4,288,3,300,"2011"
"6753","240790 MONTE DAS GAMELEIRAS",0,0,1,35,1,37,"2011"
"6754","240800 MOSSORO",9,27,82,3799,11,3928,"2011"
"6755","240810 NATAL",25,72,233,11810,59,12199,"2011"
"6756","240820 NISIA FLORESTA",1,1,6,331,2,341,"2011"
"6757","240830 NOVA CRUZ",1,0,14,546,20,581,"2011"
"6758","240840 OLHO-D'AGUA DO BORGES",0,0,0,39,0,39,"2011"
"6759","240850 OURO BRANCO",0,0,2,62,0,64,"2011"
"6760","240860 PARANA",0,0,0,57,0,57,"2011"
"6761","240870 PARAU",0,0,0,53,0,53,"2011"
"6762","240880 PARAZINHO",0,0,3,68,0,71,"2011"
"6763","240890 PARELHAS",1,0,7,291,0,299,"2011"
"6764","240895 RIO DO FOGO",1,0,4,158,1,164,"2011"
"6765","240910 PASSA E FICA",0,0,8,139,1,148,"2011"
"6766","240920 PASSAGEM",0,1,0,43,0,44,"2011"
"6767","240930 PATU",0,0,3,155,1,159,"2011"
"6768","240933 SANTA MARIA",0,0,1,55,0,56,"2011"
"6769","240940 PAU DOS FERROS",1,3,3,451,0,458,"2011"
"6770","240950 PEDRA GRANDE",0,0,2,59,1,62,"2011"
"6771","240960 PEDRA PRETA",0,0,0,31,0,31,"2011"
"6772","240970 PEDRO AVELINO",0,0,3,76,1,80,"2011"
"6773","240980 PEDRO VELHO",0,0,2,216,2,220,"2011"
"6774","240990 PENDENCIAS",0,2,0,128,0,130,"2011"
"6775","241000 PILOES",0,0,0,54,0,54,"2011"
"6776","241010 POCO BRANCO",0,0,6,179,0,185,"2011"
"6777","241020 PORTALEGRE",0,1,1,114,0,116,"2011"
"6778","241025 PORTO DO MANGUE",0,0,1,63,1,65,"2011"
"6779","241030 SERRA CAIADA",0,0,4,162,2,168,"2011"
"6780","241040 PUREZA",0,1,5,111,1,118,"2011"
"6781","241050 RAFAEL FERNANDES",0,0,1,69,0,70,"2011"
"6782","241060 RAFAEL GODEIRO",0,0,0,38,0,38,"2011"
"6783","241070 RIACHO DA CRUZ",0,1,1,41,0,43,"2011"
"6784","241080 RIACHO DE SANTANA",0,0,2,68,0,70,"2011"
"6785","241090 RIACHUELO",0,0,4,75,0,79,"2011"
"6786","241100 RODOLFO FERNANDES",0,0,2,75,0,77,"2011"
"6787","241105 TIBAU",0,0,2,69,0,71,"2011"
"6788","241110 RUY BARBOSA",0,1,1,37,0,39,"2011"
"6789","241120 SANTA CRUZ",2,2,12,561,1,578,"2011"
"6790","241140 SANTANA DO MATOS",1,1,5,163,1,171,"2011"
"6791","241142 SANTANA DO SERIDO",0,0,0,34,0,34,"2011"
"6792","241150 SANTO ANTONIO",2,1,6,347,12,368,"2011"
"6793","241160 SAO BENTO DO NORTE",0,0,0,52,0,52,"2011"
"6794","241170 SAO BENTO DO TRAIRI",0,0,1,69,3,73,"2011"
"6795","241180 SAO FERNANDO",1,0,1,41,0,43,"2011"
"6796","241190 SAO FRANCISCO DO OESTE",0,0,0,44,0,44,"2011"
"6797","241200 SAO GONCALO DO AMARANTE",2,4,29,1651,4,1690,"2011"
"6798","241210 SAO JOAO DO SABUGI",0,1,4,80,1,86,"2011"
"6799","241220 SAO JOSE DE MIPIBU",2,4,10,750,3,769,"2011"
"6800","241230 SAO JOSE DO CAMPESTRE",0,2,3,185,3,193,"2011"
"6801","241240 SAO JOSE DO SERIDO",0,0,3,62,0,65,"2011"
"6802","241250 SAO MIGUEL",0,2,2,364,1,369,"2011"
"6803","241255 SAO MIGUEL DO GOSTOSO",1,1,3,88,1,94,"2011"
"6804","241260 SAO PAULO DO POTENGI",1,0,2,181,1,185,"2011"
"6805","241270 SAO PEDRO",0,1,1,83,1,86,"2011"
"6806","241280 SAO RAFAEL",1,0,1,95,0,97,"2011"
"6807","241290 SAO TOME",1,0,0,118,0,119,"2011"
"6808","241300 SAO VICENTE",0,0,7,72,3,82,"2011"
"6809","241310 SENADOR ELOI DE SOUZA",0,0,1,63,0,64,"2011"
"6810","241320 SENADOR GEORGINO AVELINO",0,0,0,57,0,57,"2011"
"6811","241330 SERRA DE SAO BENTO",0,0,2,77,2,81,"2011"
"6812","241335 SERRA DO MEL",0,2,7,209,0,218,"2011"
"6813","241340 SERRA NEGRA DO NORTE",0,0,6,107,0,113,"2011"
"6814","241350 SERRINHA",1,0,1,97,1,100,"2011"
"6815","241355 SERRINHA DOS PINTOS",1,0,0,43,0,44,"2011"
"6816","241360 SEVERIANO MELO",0,0,1,87,1,89,"2011"
"6817","241370 SITIO NOVO",0,1,1,89,1,92,"2011"
"6818","241380 TABOLEIRO GRANDE",0,0,0,34,0,34,"2011"
"6819","241390 TAIPU",0,1,6,193,0,200,"2011"
"6820","241400 TANGARA",0,2,4,203,1,210,"2011"
"6821","241410 TENENTE ANANIAS",1,1,3,149,0,154,"2011"
"6822","241415 TENENTE LAURENTINO CRUZ",0,1,8,111,1,121,"2011"
"6823","241420 TIBAU DO SUL",0,1,1,179,0,181,"2011"
"6824","241430 TIMBAUBA DOS BATISTAS",1,0,2,20,0,23,"2011"
"6825","241440 TOUROS",1,2,9,407,5,424,"2011"
"6826","241445 TRIUNFO POTIGUAR",1,1,1,67,1,71,"2011"
"6827","241450 UMARIZAL",0,1,3,121,0,125,"2011"
"6828","241460 UPANEMA",0,0,4,197,0,201,"2011"
"6829","241470 VARZEA",1,0,3,64,1,69,"2011"
"6830","241475 VENHA-VER",0,1,0,63,0,64,"2011"
"6831","241480 VERA CRUZ",1,0,3,162,1,167,"2011"
"6832","241490 VICOSA",0,1,0,22,0,23,"2011"
"6833","241500 VILA FLOR",0,0,0,38,0,38,"2011"
"6834","MUNICIPIO IGNORADO - PB",0,0,0,1,0,1,"2011"
"6835","250010 AGUA BRANCA",0,1,3,118,11,133,"2011"
"6836","250020 AGUIAR",0,1,1,48,18,68,"2011"
"6837","250030 ALAGOA GRANDE",4,7,5,457,1,474,"2011"
"6838","250040 ALAGOA NOVA",0,4,1,343,4,352,"2011"
"6839","250050 ALAGOINHA",1,2,6,180,2,191,"2011"
"6840","250053 ALCANTIL",1,0,0,102,2,105,"2011"
"6841","250057 ALGODAO DE JANDAIRA",2,0,0,51,0,53,"2011"
"6842","250060 ALHANDRA",1,1,5,376,6,389,"2011"
"6843","250070 SAO JOAO DO RIO DO PEIXE",1,2,8,219,0,230,"2011"
"6844","250073 AMPARO",0,0,0,43,0,43,"2011"
"6845","250077 APARECIDA",1,1,0,99,0,101,"2011"
"6846","250080 ARACAGI",0,0,3,201,6,210,"2011"
"6847","250090 ARARA",2,1,1,178,0,182,"2011"
"6848","250100 ARARUNA",0,5,16,229,1,251,"2011"
"6849","250110 AREIA",2,3,8,366,4,383,"2011"
"6850","250115 AREIA DE BARAUNAS",0,0,0,27,2,29,"2011"
"6851","250120 AREIAL",1,2,0,83,1,87,"2011"
"6852","250130 AROEIRAS",3,2,6,311,3,325,"2011"
"6853","250135 ASSUNCAO",0,0,0,66,1,67,"2011"
"6854","250140 BAIA DA TRAICAO",1,1,2,190,0,194,"2011"
"6855","250150 BANANEIRAS",1,2,5,318,1,327,"2011"
"6856","250153 BARAUNA",0,0,0,54,0,54,"2011"
"6857","250157 BARRA DE SANTANA",0,1,1,120,1,123,"2011"
"6858","250160 BARRA DE SANTA ROSA",1,0,2,186,2,191,"2011"
"6859","250170 BARRA DE SAO MIGUEL",1,0,0,84,3,88,"2011"
"6860","250180 BAYEUX",0,15,49,1348,3,1415,"2011"
"6861","250190 BELEM",1,2,9,236,0,248,"2011"
"6862","250200 BELEM DO BREJO DO CRUZ",0,0,0,79,0,79,"2011"
"6863","250205 BERNARDINO BATISTA",0,0,0,54,1,55,"2011"
"6864","250210 BOA VENTURA",0,0,1,77,3,81,"2011"
"6865","250215 BOA VISTA",0,0,1,109,1,111,"2011"
"6866","250220 BOM JESUS",0,2,0,37,0,39,"2011"
"6867","250230 BOM SUCESSO",0,0,0,53,0,53,"2011"
"6868","250240 BONITO DE SANTA FE",1,2,5,209,1,218,"2011"
"6869","250250 BOQUEIRAO",0,4,6,331,2,343,"2011"
"6870","250260 IGARACY",0,0,0,66,6,72,"2011"
"6871","250270 BORBOREMA",0,1,4,67,0,72,"2011"
"6872","250280 BREJO DO CRUZ",0,0,1,149,12,162,"2011"
"6873","250290 BREJO DOS SANTOS",0,0,1,87,2,90,"2011"
"6874","250300 CAAPORA",0,5,7,389,1,402,"2011"
"6875","250310 CABACEIRAS",0,0,4,64,2,70,"2011"
"6876","250320 CABEDELO",0,4,18,898,5,925,"2011"
"6877","250330 CACHOEIRA DOS INDIOS",1,4,5,143,2,155,"2011"
"6878","250340 CACIMBA DE AREIA",0,0,2,46,0,48,"2011"
"6879","250350 CACIMBA DE DENTRO",0,1,7,198,0,206,"2011"
"6880","250355 CACIMBAS",0,1,6,112,13,132,"2011"
"6881","250360 CAICARA",0,0,4,94,0,98,"2011"
"6882","250370 CAJAZEIRAS",2,4,25,844,4,879,"2011"
"6883","250375 CAJAZEIRINHAS",0,0,0,1,70,71,"2011"
"6884","250380 CALDAS BRANDAO",0,1,0,72,0,73,"2011"
"6885","250390 CAMALAU",0,0,3,83,0,86,"2011"
"6886","250400 CAMPINA GRANDE",20,24,81,5952,74,6151,"2011"
"6887","250403 CAPIM",1,0,1,90,0,92,"2011"
"6888","250407 CARAUBAS",0,1,0,54,1,56,"2011"
"6889","250410 CARRAPATEIRA",0,0,0,26,0,26,"2011"
"6890","250415 CASSERENGUE",1,0,3,90,0,94,"2011"
"6891","250420 CATINGUEIRA",0,0,3,72,2,77,"2011"
"6892","250430 CATOLE DO ROCHA",0,0,3,405,0,408,"2011"
"6893","250435 CATURITE",0,0,2,70,2,74,"2011"
"6894","250440 CONCEICAO",0,1,2,222,6,231,"2011"
"6895","250450 CONDADO",0,0,1,87,30,118,"2011"
"6896","250460 CONDE",1,2,7,438,4,452,"2011"
"6897","250470 CONGO",0,0,1,76,0,77,"2011"
"6898","250480 COREMAS",0,14,50,131,8,203,"2011"
"6899","250485 COXIXOLA",0,0,0,16,0,16,"2011"
"6900","250490 CRUZ DO ESPIRITO SANTO",0,2,8,261,0,271,"2011"
"6901","250500 CUBATI",0,0,0,101,1,102,"2011"
"6902","250510 CUITE",0,0,0,254,2,256,"2011"
"6903","250520 CUITEGI",0,0,1,85,1,87,"2011"
"6904","250523 CUITE DE MAMANGUAPE",0,0,0,89,1,90,"2011"
"6905","250527 CURRAL DE CIMA",0,2,2,91,0,95,"2011"
"6906","250530 CURRAL VELHO",0,0,1,24,1,26,"2011"
"6907","250535 DAMIAO",0,0,1,65,0,66,"2011"
"6908","250540 DESTERRO",0,1,4,125,2,132,"2011"
"6909","250550 VISTA SERRANA",0,1,0,34,6,41,"2011"
"6910","250560 DIAMANTE",0,2,4,80,6,92,"2011"
"6911","250570 DONA INES",0,2,1,149,1,153,"2011"
"6912","250580 DUAS ESTRADAS",0,0,2,48,0,50,"2011"
"6913","250590 EMAS",0,1,2,51,0,54,"2011"
"6914","250600 ESPERANCA",0,2,6,521,2,531,"2011"
"6915","250610 FAGUNDES",3,0,2,158,8,171,"2011"
"6916","250620 FREI MARTINHO",0,0,0,31,0,31,"2011"
"6917","250625 GADO BRAVO",0,0,1,133,2,136,"2011"
"6918","250630 GUARABIRA",2,5,18,822,5,852,"2011"
"6919","250640 GURINHEM",1,2,4,172,1,180,"2011"
"6920","250650 GURJAO",0,0,0,40,1,41,"2011"
"6921","250660 IBIARA",1,1,2,69,2,75,"2011"
"6922","250670 IMACULADA",0,0,0,127,6,133,"2011"
"6923","250680 INGA",0,1,4,228,2,235,"2011"
"6924","250690 ITABAIANA",0,1,4,318,0,323,"2011"
"6925","250700 ITAPORANGA",1,2,6,294,23,326,"2011"
"6926","250710 ITAPOROROCA",0,2,8,222,1,233,"2011"
"6927","250720 ITATUBA",1,0,2,162,1,166,"2011"
"6928","250730 JACARAU",2,0,5,199,5,211,"2011"
"6929","250740 JERICO",0,0,1,64,38,103,"2011"
"6930","250750 JOAO PESSOA",24,46,160,11362,49,11641,"2011"
"6931","250760 JUAREZ TAVORA",0,0,2,127,3,132,"2011"
"6932","250770 JUAZEIRINHO",0,3,5,318,3,329,"2011"
"6933","250780 JUNCO DO SERIDO",0,0,4,95,5,104,"2011"
"6934","250790 JURIPIRANGA",0,2,3,181,1,187,"2011"
"6935","250800 JURU",1,1,5,129,0,136,"2011"
"6936","250810 LAGOA",0,0,0,47,25,72,"2011"
"6937","250820 LAGOA DE DENTRO",0,1,4,104,4,113,"2011"
"6938","250830 LAGOA SECA",1,1,6,426,4,438,"2011"
"6939","250840 LASTRO",0,0,1,48,0,49,"2011"
"6940","250850 LIVRAMENTO",0,0,4,85,2,91,"2011"
"6941","250855 LOGRADOURO",0,0,3,47,0,50,"2011"
"6942","250860 LUCENA",2,0,3,239,0,244,"2011"
"6943","250870 MAE D'AGUA",1,1,1,43,4,50,"2011"
"6944","250880 MALTA",0,2,1,53,6,62,"2011"
"6945","250890 MAMANGUAPE",2,4,9,779,4,798,"2011"
"6946","250900 MANAIRA",3,1,6,168,9,187,"2011"
"6947","250905 MARCACAO",0,1,1,153,0,155,"2011"
"6948","250910 MARI",0,2,8,254,1,265,"2011"
"6949","250915 MARIZOPOLIS",0,1,0,78,0,79,"2011"
"6950","250920 MASSARANDUBA",1,2,5,183,3,194,"2011"
"6951","250930 MATARACA",0,0,4,156,2,162,"2011"
"6952","250933 MATINHAS",0,0,1,69,1,71,"2011"
"6953","250937 MATO GROSSO",0,0,0,30,0,30,"2011"
"6954","250939 MATUREIA",1,0,2,79,1,83,"2011"
"6955","250940 MOGEIRO",1,0,2,175,5,183,"2011"
"6956","250950 MONTADAS",0,0,1,78,0,79,"2011"
"6957","250960 MONTE HOREBE",0,1,3,84,1,89,"2011"
"6958","250970 MONTEIRO",2,0,2,464,1,469,"2011"
"6959","250980 MULUNGU",1,1,1,121,1,125,"2011"
"6960","250990 NATUBA",1,0,7,127,3,138,"2011"
"6961","251000 NAZAREZINHO",0,0,0,88,1,89,"2011"
"6962","251010 NOVA FLORESTA",0,0,2,153,1,156,"2011"
"6963","251020 NOVA OLINDA",0,0,2,88,16,106,"2011"
"6964","251030 NOVA PALMEIRA",0,1,0,44,0,45,"2011"
"6965","251040 OLHO D'AGUA",0,0,2,86,3,91,"2011"
"6966","251050 OLIVEDOS",0,0,0,41,1,42,"2011"
"6967","251060 OURO VELHO",1,0,0,48,1,50,"2011"
"6968","251065 PARARI",0,0,0,25,0,25,"2011"
"6969","251070 PASSAGEM",0,0,0,36,0,36,"2011"
"6970","251080 PATOS",6,18,27,1450,17,1518,"2011"
"6971","251090 PAULISTA",0,0,4,44,122,170,"2011"
"6972","251100 PEDRA BRANCA",0,0,0,41,12,53,"2011"
"6973","251110 PEDRA LAVRADA",0,0,1,100,0,101,"2011"
"6974","251120 PEDRAS DE FOGO",0,3,8,474,3,488,"2011"
"6975","251130 PIANCO",0,0,1,182,32,215,"2011"
"6976","251140 PICUI",1,1,4,281,0,287,"2011"
"6977","251150 PILAR",1,1,3,187,1,193,"2011"
"6978","251160 PILOES",0,0,3,153,2,158,"2011"
"6979","251170 PILOEZINHOS",1,1,4,68,0,74,"2011"
"6980","251180 PIRPIRITUBA",0,0,3,128,2,133,"2011"
"6981","251190 PITIMBU",3,1,6,264,0,274,"2011"
"6982","251200 POCINHOS",0,1,6,277,1,285,"2011"
"6983","251203 POCO DANTAS",0,0,2,68,4,74,"2011"
"6984","251207 POCO DE JOSE DE MOURA",1,1,0,53,0,55,"2011"
"6985","251210 POMBAL",1,0,4,39,386,430,"2011"
"6986","251220 PRATA",0,0,1,59,0,60,"2011"
"6987","251230 PRINCESA ISABEL",1,7,12,335,3,358,"2011"
"6988","251240 PUXINANA",0,0,3,190,1,194,"2011"
"6989","251250 QUEIMADAS",2,3,10,638,2,655,"2011"
"6990","251260 QUIXABA",0,0,1,25,0,26,"2011"
"6991","251270 REMIGIO",0,1,2,272,2,277,"2011"
"6992","251272 PEDRO REGIS",0,0,1,78,5,84,"2011"
"6993","251274 RIACHAO",0,0,1,54,0,55,"2011"
"6994","251275 RIACHAO DO BACAMARTE",0,0,2,60,0,62,"2011"
"6995","251276 RIACHAO DO POCO",0,0,2,63,0,65,"2011"
"6996","251278 RIACHO DE SANTO ANTONIO",0,0,1,41,0,42,"2011"
"6997","251280 RIACHO DOS CAVALOS",1,0,0,113,1,115,"2011"
"6998","251290 RIO TINTO",1,2,6,337,2,348,"2011"
"6999","251300 SALGADINHO",0,0,1,46,0,47,"2011"
"7000","251310 SALGADO DE SAO FELIX",0,0,5,125,1,131,"2011"
"7001","251315 SANTA CECILIA",0,0,2,87,0,89,"2011"
"7002","251320 SANTA CRUZ",1,0,0,72,2,75,"2011"
"7003","251330 SANTA HELENA",0,1,4,69,0,74,"2011"
"7004","251335 SANTA INES",0,1,2,56,1,60,"2011"
"7005","251340 SANTA LUZIA",1,2,5,197,3,208,"2011"
"7006","251350 SANTANA DE MANGUEIRA",0,0,0,63,4,67,"2011"
"7007","251360 SANTANA DOS GARROTES",0,0,1,63,3,67,"2011"
"7008","251365 JOCA CLAUDINO",0,0,0,30,0,30,"2011"
"7009","251370 SANTA RITA",5,16,37,2320,5,2383,"2011"
"7010","251380 SANTA TERESINHA",0,1,1,66,0,68,"2011"
"7011","251385 SANTO ANDRE",0,0,0,29,1,30,"2011"
"7012","251390 SAO BENTO",0,1,2,450,7,460,"2011"
"7013","251392 SAO BENTINHO",0,0,0,7,55,62,"2011"
"7014","251394 SAO DOMINGOS DO CARIRI",0,0,0,40,0,40,"2011"
"7015","251396 SAO DOMINGOS",0,0,0,10,36,46,"2011"
"7016","251398 SAO FRANCISCO",0,0,0,46,1,47,"2011"
"7017","251400 SAO JOAO DO CARIRI",0,0,2,39,0,41,"2011"
"7018","251410 SAO JOAO DO TIGRE",0,0,2,58,3,63,"2011"
"7019","251420 SAO JOSE DA LAGOA TAPADA",0,1,1,112,0,114,"2011"
"7020","251430 SAO JOSE DE CAIANA",0,1,1,86,7,95,"2011"
"7021","251440 SAO JOSE DE ESPINHARAS",0,0,1,62,0,63,"2011"
"7022","251445 SAO JOSE DOS RAMOS",1,0,4,81,0,86,"2011"
"7023","251450 SAO JOSE DE PIRANHAS",1,2,10,243,9,265,"2011"
"7024","251455 SAO JOSE DE PRINCESA",0,0,2,44,2,48,"2011"
"7025","251460 SAO JOSE DO BONFIM",0,0,3,52,1,56,"2011"
"7026","251465 SAO JOSE DO BREJO DO CRUZ",0,0,1,23,0,24,"2011"
"7027","251470 SAO JOSE DO SABUGI",1,0,0,45,0,46,"2011"
"7028","251480 SAO JOSE DOS CORDEIROS",2,1,1,57,0,61,"2011"
"7029","251490 SAO MAMEDE",1,2,2,114,1,120,"2011"
"7030","251500 SAO MIGUEL DE TAIPU",0,0,3,101,0,104,"2011"
"7031","251510 SAO SEBASTIAO DE LAGOA DE ROCA",0,1,1,156,3,161,"2011"
"7032","251520 SAO SEBASTIAO DO UMBUZEIRO",0,0,0,49,0,49,"2011"
"7033","251530 SAPE",0,6,13,758,2,779,"2011"
"7034","251540 SAO VICENTE DO SERIDO",0,1,4,165,4,174,"2011"
"7035","251550 SERRA BRANCA",0,0,1,153,0,154,"2011"
"7036","251560 SERRA DA RAIZ",0,2,0,31,1,34,"2011"
"7037","251570 SERRA GRANDE",0,0,0,36,5,41,"2011"
"7038","251580 SERRA REDONDA",0,0,1,98,2,101,"2011"
"7039","251590 SERRARIA",1,0,2,93,4,100,"2011"
"7040","251593 SERTAOZINHO",0,0,2,55,1,58,"2011"
"7041","251597 SOBRADO",0,1,1,114,1,117,"2011"
"7042","251600 SOLANEA",0,1,15,395,3,414,"2011"
"7043","251610 SOLEDADE",0,1,4,220,3,228,"2011"
"7044","251615 SOSSEGO",0,0,3,49,0,52,"2011"
"7045","251620 SOUSA",4,3,17,995,10,1029,"2011"
"7046","251630 SUME",2,0,5,227,0,234,"2011"
"7047","251640 TACIMA",0,1,7,90,1,99,"2011"
"7048","251650 TAPEROA",0,3,2,211,7,223,"2011"
"7049","251660 TAVARES",4,4,7,201,10,226,"2011"
"7050","251670 TEIXEIRA",0,2,5,226,1,234,"2011"
"7051","251675 TENORIO",0,0,0,52,0,52,"2011"
"7052","251680 TRIUNFO",0,1,3,96,4,104,"2011"
"7053","251690 UIRAUNA",0,1,5,198,0,204,"2011"
"7054","251700 UMBUZEIRO",1,0,2,123,1,127,"2011"
"7055","251710 VARZEA",0,0,0,31,2,33,"2011"
"7056","251720 VIEIROPOLIS",0,0,2,46,0,48,"2011"
"7057","251740 ZABELE",0,1,0,29,1,31,"2011"
"7058","260005 ABREU E LIMA",7,11,15,1420,8,1461,"2011"
"7059","260010 AFOGADOS DA INGAZEIRA",10,1,6,554,89,660,"2011"
"7060","260020 AFRANIO",0,2,5,163,166,336,"2011"
"7061","260030 AGRESTINA",0,1,5,326,0,332,"2011"
"7062","260040 AGUA PRETA",3,4,13,491,4,515,"2011"
"7063","260050 AGUAS BELAS",2,5,12,786,5,810,"2011"
"7064","260060 ALAGOINHA",1,1,1,179,4,186,"2011"
"7065","260070 ALIANCA",1,3,6,590,2,602,"2011"
"7066","260080 ALTINHO",2,0,4,232,0,238,"2011"
"7067","260090 AMARAJI",0,2,4,302,2,310,"2011"
"7068","260100 ANGELIM",0,0,1,169,0,170,"2011"
"7069","260105 ARACOIABA",2,1,1,305,9,318,"2011"
"7070","260110 ARARIPINA",25,11,41,1682,8,1767,"2011"
"7071","260120 ARCOVERDE",2,5,18,1074,7,1106,"2011"
"7072","260130 BARRA DE GUABIRABA",0,1,2,166,2,171,"2011"
"7073","260140 BARREIROS",3,3,13,750,4,773,"2011"
"7074","260150 BELEM DE MARIA",0,0,0,145,0,145,"2011"
"7075","260160 BELEM DE SAO FRANCISCO",10,1,1,383,5,400,"2011"
"7076","260170 BELO JARDIM",7,14,28,1132,4,1185,"2011"
"7077","260180 BETANIA",2,2,16,203,8,231,"2011"
"7078","260190 BEZERROS",12,5,11,822,1,851,"2011"
"7079","260200 BODOCO",2,2,9,531,13,557,"2011"
"7080","260210 BOM CONSELHO",1,3,13,631,7,655,"2011"
"7081","260220 BOM JARDIM",0,1,11,506,0,518,"2011"
"7082","260230 BONITO",1,3,10,600,1,615,"2011"
"7083","260240 BREJAO",2,0,3,160,2,167,"2011"
"7084","260250 BREJINHO",0,0,1,127,1,129,"2011"
"7085","260260 BREJO DA MADRE DE DEUS",5,1,23,708,6,743,"2011"
"7086","260270 BUENOS AIRES",2,1,4,175,3,185,"2011"
"7087","260280 BUIQUE",4,7,27,990,7,1035,"2011"
"7088","260290 CABO DE SANTO AGOSTINHO",10,23,64,3328,21,3446,"2011"
"7089","260300 CABROBO",3,3,8,542,3,559,"2011"
"7090","260310 CACHOEIRINHA",0,1,5,286,4,296,"2011"
"7091","260320 CAETES",3,2,5,478,5,493,"2011"
"7092","260330 CALCADO",1,1,1,148,1,152,"2011"
"7093","260340 CALUMBI",0,2,12,86,13,113,"2011"
"7094","260345 CAMARAGIBE",4,10,34,2255,12,2315,"2011"
"7095","260350 CAMOCIM DE SAO FELIX",2,0,5,213,1,221,"2011"
"7096","260360 CAMUTANGA",0,1,2,120,0,123,"2011"
"7097","260370 CANHOTINHO",0,4,12,366,0,382,"2011"
"7098","260380 CAPOEIRAS",1,2,5,311,0,319,"2011"
"7099","260390 CARNAIBA",3,1,1,208,37,250,"2011"
"7100","260392 CARNAUBEIRA DA PENHA",0,3,15,352,8,378,"2011"
"7101","260400 CARPINA",3,0,5,1045,7,1060,"2011"
"7102","260410 CARUARU",19,21,57,5330,31,5458,"2011"
"7103","260415 CASINHAS",0,5,2,211,0,218,"2011"
"7104","260420 CATENDE",4,4,13,613,1,635,"2011"
"7105","260430 CEDRO",1,2,2,190,1,196,"2011"
"7106","260440 CHA DE ALEGRIA",2,3,5,176,4,190,"2011"
"7107","260450 CHA GRANDE",0,0,2,265,2,269,"2011"
"7108","260460 CONDADO",1,2,9,341,3,356,"2011"
"7109","260470 CORRENTES",0,0,4,236,1,241,"2011"
"7110","260480 CORTES",1,0,5,204,1,211,"2011"
"7111","260490 CUMARU",0,0,5,214,1,220,"2011"
"7112","260500 CUPIRA",2,2,5,391,1,401,"2011"
"7113","260510 CUSTODIA",1,6,12,595,6,620,"2011"
"7114","260515 DORMENTES",2,3,3,169,90,267,"2011"
"7115","260520 ESCADA",2,5,12,1037,5,1061,"2011"
"7116","260530 EXU",2,3,6,516,8,535,"2011"
"7117","260540 FEIRA NOVA",0,6,6,275,12,299,"2011"
"7118","260545 FERNANDO DE NORONHA",0,0,2,23,0,25,"2011"
"7119","260550 FERREIROS",1,0,3,138,3,145,"2011"
"7120","260560 FLORES",4,1,9,286,26,326,"2011"
"7121","260570 FLORESTA",1,5,27,529,5,567,"2011"
"7122","260580 FREI MIGUELINHO",0,0,1,170,0,171,"2011"
"7123","260590 GAMELEIRA",1,6,7,395,3,412,"2011"
"7124","260600 GARANHUNS",5,8,25,2349,7,2394,"2011"
"7125","260610 GLORIA DO GOITA",3,1,7,340,3,354,"2011"
"7126","260620 GOIANA",3,6,17,1218,13,1257,"2011"
"7127","260630 GRANITO",0,1,1,68,42,112,"2011"
"7128","260640 GRAVATA",2,4,14,989,8,1017,"2011"
"7129","260650 IATI",4,2,2,349,1,358,"2011"
"7130","260660 IBIMIRIM",0,3,6,504,7,520,"2011"
"7131","260670 IBIRAJUBA",0,0,3,95,6,104,"2011"
"7132","260680 IGARASSU",3,8,15,1423,23,1472,"2011"
"7133","260690 IGUARACY",0,2,1,148,7,158,"2011"
"7134","260700 INAJA",2,2,4,313,32,353,"2011"
"7135","260710 INGAZEIRA",0,0,0,50,7,57,"2011"
"7136","260720 IPOJUCA",8,7,42,1527,14,1598,"2011"
"7137","260730 IPUBI",1,0,8,600,0,609,"2011"
"7138","260740 ITACURUBA",1,1,3,73,0,78,"2011"
"7139","260750 ITAIBA",2,1,11,392,47,453,"2011"
"7140","260760 ILHA DE ITAMARACA",1,3,7,286,6,303,"2011"
"7141","260765 ITAMBE",1,0,6,527,1,535,"2011"
"7142","260770 ITAPETIM",0,0,0,212,0,212,"2011"
"7143","260775 ITAPISSUMA",1,1,4,291,9,306,"2011"
"7144","260780 ITAQUITINGA",0,1,3,263,4,271,"2011"
"7145","260790 JABOATAO DOS GUARARAPES",58,42,133,8757,34,9024,"2011"
"7146","260795 JAQUEIRA",1,4,1,168,0,174,"2011"
"7147","260800 JATAUBA",1,5,10,266,2,284,"2011"
"7148","260805 JATOBA",1,2,3,211,6,223,"2011"
"7149","260810 JOAO ALFREDO",0,1,3,390,1,395,"2011"
"7150","260820 JOAQUIM NABUCO",0,3,1,286,0,290,"2011"
"7151","260825 JUCATI",0,1,2,184,0,187,"2011"
"7152","260830 JUPI",0,2,3,267,0,272,"2011"
"7153","260840 JUREMA",0,0,6,182,0,188,"2011"
"7154","260845 LAGOA DO CARRO",1,1,5,223,0,230,"2011"
"7155","260850 LAGOA DE ITAENGA",1,1,3,334,2,341,"2011"
"7156","260860 LAGOA DO OURO",3,3,1,211,1,219,"2011"
"7157","260870 LAGOA DOS GATOS",0,1,5,208,0,214,"2011"
"7158","260875 LAGOA GRANDE",3,6,7,415,2,433,"2011"
"7159","260880 LAJEDO",2,1,14,649,8,674,"2011"
"7160","260890 LIMOEIRO",5,4,8,792,4,813,"2011"
"7161","260900 MACAPARANA",1,2,2,375,0,380,"2011"
"7162","260910 MACHADOS",1,1,4,175,2,183,"2011"
"7163","260915 MANARI",1,2,6,293,37,339,"2011"
"7164","260920 MARAIAL",1,1,3,208,1,214,"2011"
"7165","260930 MIRANDIBA",0,1,12,275,4,292,"2011"
"7166","260940 MORENO",1,4,10,698,8,721,"2011"
"7167","260950 NAZARE DA MATA",0,1,5,423,6,435,"2011"
"7168","260960 OLINDA",31,20,97,5808,26,5982,"2011"
"7169","260970 OROBO",1,0,6,281,4,292,"2011"
"7170","260980 OROCO",4,0,4,225,7,240,"2011"
"7171","260990 OURICURI",3,5,20,1116,29,1173,"2011"
"7172","261000 PALMARES",3,8,17,1094,2,1124,"2011"
"7173","261010 PALMEIRINA",0,3,1,142,0,146,"2011"
"7174","261020 PANELAS",0,4,7,385,0,396,"2011"
"7175","261030 PARANATAMA",0,1,4,224,9,238,"2011"
"7176","261040 PARNAMIRIM",1,2,3,392,4,402,"2011"
"7177","261050 PASSIRA",1,3,10,421,1,436,"2011"
"7178","261060 PAUDALHO",2,4,8,898,6,918,"2011"
"7179","261070 PAULISTA",9,19,55,3777,24,3884,"2011"
"7180","261080 PEDRA",2,0,3,368,1,374,"2011"
"7181","261090 PESQUEIRA",1,6,15,1028,9,1059,"2011"
"7182","261100 PETROLANDIA",4,4,5,751,8,772,"2011"
"7183","261110 PETROLINA",84,43,128,5350,95,5700,"2011"
"7184","261120 POCAO",1,1,2,182,1,187,"2011"
"7185","261130 POMBOS",0,0,3,331,2,336,"2011"
"7186","261140 PRIMAVERA",1,2,2,172,0,177,"2011"
"7187","261150 QUIPAPA",3,3,5,332,1,344,"2011"
"7188","261153 QUIXABA",1,0,3,100,6,110,"2011"
"7189","261160 RECIFE",77,117,320,21605,99,22218,"2011"
"7190","261170 RIACHO DAS ALMAS",2,2,6,251,2,263,"2011"
"7191","261180 RIBEIRAO",1,2,12,606,1,622,"2011"
"7192","261190 RIO FORMOSO",2,0,13,406,0,421,"2011"
"7193","261200 SAIRE",0,1,1,129,0,131,"2011"
"7194","261210 SALGADINHO",0,0,4,83,2,89,"2011"
"7195","261220 SALGUEIRO",8,7,35,1074,0,1124,"2011"
"7196","261230 SALOA",1,2,5,278,1,287,"2011"
"7197","261240 SANHARO",0,3,7,278,1,289,"2011"
"7198","261245 SANTA CRUZ",1,2,8,274,4,289,"2011"
"7199","261247 SANTA CRUZ DA BAIXA VERDE",1,5,15,197,12,230,"2011"
"7200","261250 SANTA CRUZ DO CAPIBARIBE",9,3,19,1271,6,1308,"2011"
"7201","261255 SANTA FILOMENA",0,1,2,121,119,243,"2011"
"7202","261260 SANTA MARIA DA BOA VISTA",1,7,14,662,132,816,"2011"
"7203","261270 SANTA MARIA DO CAMBUCA",0,1,3,223,0,227,"2011"
"7204","261280 SANTA TEREZINHA",2,0,4,132,9,147,"2011"
"7205","261290 SAO BENEDITO DO SUL",0,0,0,172,0,172,"2011"
"7206","261300 SAO BENTO DO UNA",0,3,8,771,4,786,"2011"
"7207","261310 SAO CAITANO",2,2,7,535,5,551,"2011"
"7208","261320 SAO JOAO",3,2,9,349,0,363,"2011"
"7209","261330 SAO JOAQUIM DO MONTE",1,0,4,303,2,310,"2011"
"7210","261340 SAO JOSE DA COROA GRANDE",2,3,8,305,1,319,"2011"
"7211","261350 SAO JOSE DO BELMONTE",3,2,10,543,13,571,"2011"
"7212","261360 SAO JOSE DO EGITO",0,3,6,439,9,457,"2011"
"7213","261370 SAO LOURENCO DA MATA",2,10,26,1419,12,1469,"2011"
"7214","261380 SAO VICENTE FERRER",1,1,4,267,0,273,"2011"
"7215","261390 SERRA TALHADA",5,17,101,1285,87,1495,"2011"
"7216","261400 SERRITA",1,1,7,300,0,309,"2011"
"7217","261410 SERTANIA",2,3,14,496,5,520,"2011"
"7218","261420 SIRINHAEM",1,7,25,713,3,749,"2011"
"7219","261430 MOREILANDIA",1,0,4,169,2,176,"2011"
"7220","261440 SOLIDAO",0,2,0,85,10,97,"2011"
"7221","261450 SURUBIM",2,1,11,835,0,849,"2011"
"7222","261460 TABIRA",2,4,3,428,48,485,"2011"
"7223","261470 TACAIMBO",0,0,2,157,0,159,"2011"
"7224","261480 TACARATU",1,1,8,321,8,339,"2011"
"7225","261485 TAMANDARE",2,3,8,371,0,384,"2011"
"7226","261500 TAQUARITINGA DO NORTE",1,2,21,346,4,374,"2011"
"7227","261510 TEREZINHA",0,0,1,121,0,122,"2011"
"7228","261520 TERRA NOVA",2,1,5,132,0,140,"2011"
"7229","261530 TIMBAUBA",3,1,8,807,5,824,"2011"
"7230","261540 TORITAMA",2,3,4,581,5,595,"2011"
"7231","261550 TRACUNHAEM",0,0,3,207,5,215,"2011"
"7232","261560 TRINDADE",1,2,9,622,3,637,"2011"
"7233","261570 TRIUNFO",0,1,11,179,21,212,"2011"
"7234","261580 TUPANATINGA",0,4,13,390,15,422,"2011"
"7235","261590 TUPARETAMA",2,0,5,135,2,144,"2011"
"7236","261600 VENTUROSA",3,4,4,270,0,281,"2011"
"7237","261610 VERDEJANTE",0,0,4,172,0,176,"2011"
"7238","261618 VERTENTE DO LERIO",1,0,2,126,1,130,"2011"
"7239","261620 VERTENTES",2,1,1,354,0,358,"2011"
"7240","261630 VICENCIA",3,3,6,418,0,430,"2011"
"7241","261640 VITORIA DE SANTO ANTAO",9,6,24,1677,25,1741,"2011"
"7242","261650 XEXEU",4,2,2,294,2,304,"2011"
"7243","270010 AGUA BRANCA",0,1,9,135,178,323,"2011"
"7244","270020 ANADIA",1,1,7,217,31,257,"2011"
"7245","270030 ARAPIRACA",17,15,66,3701,37,3836,"2011"
"7246","270040 ATALAIA",0,1,12,546,246,805,"2011"
"7247","270050 BARRA DE SANTO ANTONIO",1,1,5,303,11,321,"2011"
"7248","270060 BARRA DE SAO MIGUEL",0,1,4,148,2,155,"2011"
"7249","270070 BATALHA",2,7,3,273,1,286,"2011"
"7250","270080 BELEM",0,0,2,74,2,78,"2011"
"7251","270090 BELO MONTE",0,0,4,78,3,85,"2011"
"7252","270100 BOCA DA MATA",0,0,11,421,9,441,"2011"
"7253","270110 BRANQUINHA",0,0,1,196,13,210,"2011"
"7254","270120 CACIMBINHAS",0,1,3,196,4,204,"2011"
"7255","270130 CAJUEIRO",0,2,2,225,192,421,"2011"
"7256","270135 CAMPESTRE",1,1,0,120,12,134,"2011"
"7257","270140 CAMPO ALEGRE",2,2,13,523,21,561,"2011"
"7258","270150 CAMPO GRANDE",0,1,4,160,2,167,"2011"
"7259","270160 CANAPI",2,1,5,251,77,336,"2011"
"7260","270170 CAPELA",1,0,3,306,9,319,"2011"
"7261","270180 CARNEIROS",0,1,4,170,5,180,"2011"
"7262","270190 CHA PRETA",1,0,3,90,30,124,"2011"
"7263","270200 COITE DO NOIA",1,1,3,183,2,190,"2011"
"7264","270210 COLONIA LEOPOLDINA",1,1,4,385,21,412,"2011"
"7265","270220 COQUEIRO SECO",0,0,2,96,0,98,"2011"
"7266","270230 CORURIPE",9,2,3,524,437,975,"2011"
"7267","270235 CRAIBAS",1,2,6,345,50,404,"2011"
"7268","270240 DELMIRO GOUVEIA",1,2,16,318,493,830,"2011"
"7269","270250 DOIS RIACHOS",0,0,3,143,0,146,"2011"
"7270","270255 ESTRELA DE ALAGOAS",0,0,4,240,3,247,"2011"
"7271","270260 FEIRA GRANDE",2,1,7,337,4,351,"2011"
"7272","270270 FELIZ DESERTO",0,0,0,57,23,80,"2011"
"7273","270280 FLEXEIRAS",0,0,9,215,2,226,"2011"
"7274","270290 GIRAU DO PONCIANO",4,3,13,579,9,608,"2011"
"7275","270300 IBATEGUARA",0,1,2,262,12,277,"2011"
"7276","270310 IGACI",0,1,5,408,4,418,"2011"
"7277","270320 IGREJA NOVA",4,3,8,390,19,424,"2011"
"7278","270330 INHAPI",0,1,1,167,201,370,"2011"
"7279","270340 JACARE DOS HOMENS",0,1,2,112,1,116,"2011"
"7280","270350 JACUIPE",0,1,4,95,1,101,"2011"
"7281","270360 JAPARATINGA",1,0,3,151,4,159,"2011"
"7282","270370 JARAMATAIA",0,1,4,127,0,132,"2011"
"7283","270375 JEQUIA DA PRAIA",1,1,2,143,55,202,"2011"
"7284","270380 JOAQUIM GOMES",2,1,6,418,21,448,"2011"
"7285","270390 JUNDIA",0,0,1,53,2,56,"2011"
"7286","270400 JUNQUEIRO",2,0,5,357,8,372,"2011"
"7287","270410 LAGOA DA CANOA",0,0,10,339,2,351,"2011"
"7288","270420 LIMOEIRO DE ANADIA",2,0,6,352,2,362,"2011"
"7289","270430 MACEIO",30,42,191,15097,106,15466,"2011"
"7290","270440 MAJOR ISIDORO",0,5,7,195,97,304,"2011"
"7291","270450 MARAGOGI",2,3,2,535,2,544,"2011"
"7292","270460 MARAVILHA",0,0,2,178,0,180,"2011"
"7293","270470 MARECHAL DEODORO",1,3,9,820,13,846,"2011"
"7294","270480 MARIBONDO",0,1,4,192,2,199,"2011"
"7295","270490 MAR VERMELHO",0,0,0,33,6,39,"2011"
"7296","270500 MATA GRANDE",0,2,10,229,206,447,"2011"
"7297","270510 MATRIZ DE CAMARAGIBE",2,2,8,420,5,437,"2011"
"7298","270520 MESSIAS",2,0,1,326,3,332,"2011"
"7299","270530 MINADOR DO NEGRAO",0,0,0,113,1,114,"2011"
"7300","270540 MONTEIROPOLIS",1,1,3,120,3,128,"2011"
"7301","270550 MURICI",1,5,3,328,224,561,"2011"
"7302","270560 NOVO LINO",0,0,3,153,33,189,"2011"
"7303","270570 OLHO D'AGUA DAS FLORES",1,2,5,371,6,385,"2011"
"7304","270580 OLHO D'AGUA DO CASADO",0,0,3,108,29,140,"2011"
"7305","270590 OLHO D'AGUA GRANDE",1,0,0,73,2,76,"2011"
"7306","270600 OLIVENCA",0,2,5,166,5,178,"2011"
"7307","270610 OURO BRANCO",0,1,2,193,9,205,"2011"
"7308","270620 PALESTINA",0,0,1,71,6,78,"2011"
"7309","270630 PALMEIRA DOS INDIOS",1,3,16,1215,8,1243,"2011"
"7310","270640 PAO DE ACUCAR",0,2,10,375,66,453,"2011"
"7311","270642 PARICONHA",1,0,9,77,89,176,"2011"
"7312","270644 PARIPUEIRA",0,1,4,193,2,200,"2011"
"7313","270650 PASSO DE CAMARAGIBE",0,0,2,258,22,282,"2011"
"7314","270660 PAULO JACINTO",0,0,1,67,30,98,"2011"
"7315","270670 PENEDO",1,5,18,1048,74,1146,"2011"
"7316","270680 PIACABUCU",2,4,1,241,28,276,"2011"
"7317","270690 PILAR",0,1,2,406,178,587,"2011"
"7318","270700 PINDOBA",0,2,0,30,12,44,"2011"
"7319","270710 PIRANHAS",1,3,12,427,16,459,"2011"
"7320","270720 POCO DAS TRINCHEIRAS",0,1,2,244,7,254,"2011"
"7321","270730 PORTO CALVO",0,0,1,477,3,481,"2011"
"7322","270740 PORTO DE PEDRAS",1,0,0,115,6,122,"2011"
"7323","270750 PORTO REAL DO COLEGIO",0,2,5,314,9,330,"2011"
"7324","270760 QUEBRANGULO",0,1,0,148,45,194,"2011"
"7325","270770 RIO LARGO",2,4,7,995,25,1033,"2011"
"7326","270780 ROTEIRO",1,0,2,117,1,121,"2011"
"7327","270790 SANTA LUZIA DO NORTE",0,1,1,117,4,123,"2011"
"7328","270800 SANTANA DO IPANEMA",1,2,15,899,1,918,"2011"
"7329","270810 SANTANA DO MUNDAU",1,0,1,174,5,181,"2011"
"7330","270820 SAO BRAS",0,0,3,97,4,104,"2011"
"7331","270830 SAO JOSE DA LAJE",1,0,12,351,24,388,"2011"
"7332","270840 SAO JOSE DA TAPERA",1,4,14,579,26,624,"2011"
"7333","270850 SAO LUIS DO QUITUNDE",2,1,11,636,19,669,"2011"
"7334","270860 SAO MIGUEL DOS CAMPOS",4,2,12,897,8,923,"2011"
"7335","270870 SAO MIGUEL DOS MILAGRES",0,0,2,89,4,95,"2011"
"7336","270880 SAO SEBASTIAO",0,3,12,539,3,557,"2011"
"7337","270890 SATUBA",0,1,2,160,3,166,"2011"
"7338","270895 SENADOR RUI PALMEIRA",1,0,4,235,26,266,"2011"
"7339","270900 TANQUE D'ARCA",0,1,2,82,3,88,"2011"
"7340","270910 TAQUARANA",2,1,7,303,12,325,"2011"
"7341","270915 TEOTONIO VILELA",3,2,10,418,321,754,"2011"
"7342","270920 TRAIPU",2,2,9,398,8,419,"2011"
"7343","270930 UNIAO DOS PALMARES",2,5,13,1199,37,1256,"2011"
"7344","270940 VICOSA",1,3,2,273,201,480,"2011"
"7345","280010 AMPARO DE SAO FRANCISCO",0,0,3,37,2,42,"2011"
"7346","280020 AQUIDABA",1,2,9,254,27,293,"2011"
"7347","280030 ARACAJU",39,47,246,9352,58,9742,"2011"
"7348","280040 ARAUA",0,1,3,166,1,171,"2011"
"7349","280050 AREIA BRANCA",3,1,2,288,7,301,"2011"
"7350","280060 BARRA DOS COQUEIROS",4,0,12,417,5,438,"2011"
"7351","280067 BOQUIM",1,0,7,392,1,401,"2011"
"7352","280070 BREJO GRANDE",0,1,4,129,9,143,"2011"
"7353","280100 CAMPO DO BRITO",2,1,5,262,0,270,"2011"
"7354","280110 CANHOBA",0,0,2,56,11,69,"2011"
"7355","280120 CANINDE DE SAO FRANCISCO",2,1,4,392,245,644,"2011"
"7356","280130 CAPELA",3,3,10,542,18,576,"2011"
"7357","280140 CARIRA",3,2,5,327,30,367,"2011"
"7358","280150 CARMOPOLIS",0,0,7,286,5,298,"2011"
"7359","280160 CEDRO DE SAO JOAO",1,0,0,63,1,65,"2011"
"7360","280170 CRISTINAPOLIS",3,2,3,335,9,352,"2011"
"7361","280190 CUMBE",0,0,3,35,6,44,"2011"
"7362","280200 DIVINA PASTORA",0,0,4,74,0,78,"2011"
"7363","280210 ESTANCIA",1,3,19,1130,12,1165,"2011"
"7364","280220 FEIRA NOVA",0,0,1,30,56,87,"2011"
"7365","280230 FREI PAULO",1,1,4,227,6,239,"2011"
"7366","280240 GARARU",1,0,5,61,93,160,"2011"
"7367","280250 GENERAL MAYNARD",0,0,3,34,0,37,"2011"
"7368","280260 GRACHO CARDOSO",0,0,2,18,49,69,"2011"
"7369","280270 ILHA DAS FLORES",0,1,5,131,4,141,"2011"
"7370","280280 INDIAROBA",0,3,4,302,11,320,"2011"
"7371","280290 ITABAIANA",7,5,17,1356,9,1394,"2011"
"7372","280300 ITABAIANINHA",1,1,17,684,3,706,"2011"
"7373","280310 ITABI",0,0,0,23,38,61,"2011"
"7374","280320 ITAPORANGA D'AJUDA",1,2,16,541,5,565,"2011"
"7375","280330 JAPARATUBA",0,3,10,296,10,319,"2011"
"7376","280340 JAPOATA",1,1,9,227,15,253,"2011"
"7377","280350 LAGARTO",4,9,39,1355,14,1421,"2011"
"7378","280360 LARANJEIRAS",4,2,19,415,24,464,"2011"
"7379","280370 MACAMBIRA",0,0,0,83,3,86,"2011"
"7380","280380 MALHADA DOS BOIS",1,1,2,60,4,68,"2011"
"7381","280390 MALHADOR",0,0,4,162,3,169,"2011"
"7382","280400 MARUIM",1,4,14,316,8,343,"2011"
"7383","280410 MOITA BONITA",1,0,1,132,1,135,"2011"
"7384","280420 MONTE ALEGRE DE SERGIPE",1,0,1,65,178,245,"2011"
"7385","280430 MURIBECA",0,1,3,111,1,116,"2011"
"7386","280440 NEOPOLIS",1,0,6,235,8,250,"2011"
"7387","280445 NOSSA SENHORA APARECIDA",0,0,2,107,11,120,"2011"
"7388","280450 NOSSA SENHORA DA GLORIA",0,1,1,148,344,494,"2011"
"7389","280460 NOSSA SENHORA DAS DORES",2,4,13,327,41,387,"2011"
"7390","280470 NOSSA SENHORA DE LOURDES",0,0,1,52,37,90,"2011"
"7391","280480 NOSSA SENHORA DO SOCORRO",17,12,75,2674,28,2806,"2011"
"7392","280490 PACATUBA",2,0,5,180,17,204,"2011"
"7393","280500 PEDRA MOLE",0,0,1,53,0,54,"2011"
"7394","280510 PEDRINHAS",1,0,2,102,1,106,"2011"
"7395","280520 PINHAO",0,0,0,91,0,91,"2011"
"7396","280530 PIRAMBU",1,1,7,145,4,158,"2011"
"7397","280540 POCO REDONDO",2,1,6,181,338,528,"2011"
"7398","280550 POCO VERDE",0,1,7,309,5,322,"2011"
"7399","280560 PORTO DA FOLHA",0,1,9,228,204,442,"2011"
"7400","280570 PROPRIA",4,1,13,417,19,454,"2011"
"7401","280580 RIACHAO DO DANTAS",2,2,6,305,3,318,"2011"
"7402","280590 RIACHUELO",3,0,10,171,2,186,"2011"
"7403","280600 RIBEIROPOLIS",0,2,2,208,6,218,"2011"
"7404","280610 ROSARIO DO CATETE",1,0,3,178,2,184,"2011"
"7405","280620 SALGADO",0,0,5,264,7,276,"2011"
"7406","280630 SANTA LUZIA DO ITANHY",0,0,7,265,1,273,"2011"
"7407","280640 SANTANA DO SAO FRANCISCO",0,1,4,106,5,116,"2011"
"7408","280650 SANTA ROSA DE LIMA",0,0,0,70,0,70,"2011"
"7409","280660 SANTO AMARO DAS BROTAS",2,0,2,185,2,191,"2011"
"7410","280670 SAO CRISTOVAO",10,8,39,1299,18,1374,"2011"
"7411","280680 SAO DOMINGOS",0,1,0,150,3,154,"2011"
"7412","280690 SAO FRANCISCO",0,0,0,44,2,46,"2011"
"7413","280700 SAO MIGUEL DO ALEIXO",0,1,1,61,4,67,"2011"
"7414","280710 SIMAO DIAS",2,2,19,561,8,592,"2011"
"7415","280720 SIRIRI",0,1,2,136,7,146,"2011"
"7416","280730 TELHA",1,0,0,43,2,46,"2011"
"7417","280740 TOBIAS BARRETO",3,2,20,672,17,714,"2011"
"7418","280750 TOMAR DO GERU",2,0,2,199,3,206,"2011"
"7419","280760 UMBAUBA",3,2,7,371,2,385,"2011"
"7420","MUNICIPIO IGNORADO - BA",0,0,0,11,1,12,"2011"
"7421","290010 ABAIRA",0,0,0,48,9,57,"2011"
"7422","290020 ABARE",2,2,11,272,2,289,"2011"
"7423","290030 ACAJUTIBA",0,2,5,205,2,214,"2011"
"7424","290035 ADUSTINA",2,1,4,202,7,216,"2011"
"7425","290040 AGUA FRIA",0,0,1,154,31,186,"2011"
"7426","290050 ERICO CARDOSO",0,1,1,84,53,139,"2011"
"7427","290060 AIQUARA",0,0,2,57,2,61,"2011"
"7428","290070 ALAGOINHAS",2,26,48,1979,256,2311,"2011"
"7429","290080 ALCOBACA",0,3,2,320,15,340,"2011"
"7430","290090 ALMADINA",1,0,3,78,0,82,"2011"
"7431","290100 AMARGOSA",4,3,11,479,10,507,"2011"
"7432","290110 AMELIA RODRIGUES",0,0,0,227,82,309,"2011"
"7433","290115 AMERICA DOURADA",0,2,6,247,0,255,"2011"
"7434","290120 ANAGE",4,1,11,193,21,230,"2011"
"7435","290130 ANDARAI",0,2,1,154,10,167,"2011"
"7436","290135 ANDORINHA",1,2,3,167,8,181,"2011"
"7437","290140 ANGICAL",0,4,5,212,2,223,"2011"
"7438","290150 ANGUERA",0,0,0,46,68,114,"2011"
"7439","290160 ANTAS",0,1,0,143,4,148,"2011"
"7440","290170 ANTONIO CARDOSO",0,0,1,152,76,229,"2011"
"7441","290180 ANTONIO GONCALVES",0,1,2,34,100,137,"2011"
"7442","290190 APORA",0,2,4,208,12,226,"2011"
"7443","290195 APUAREMA",0,1,1,93,3,98,"2011"
"7444","290200 ARACATU",1,0,1,173,14,189,"2011"
"7445","290205 ARACAS",2,0,2,141,11,156,"2011"
"7446","290210 ARACI",1,4,10,712,54,781,"2011"
"7447","290220 ARAMARI",0,1,3,98,16,118,"2011"
"7448","290225 ARATACA",0,2,3,161,1,167,"2011"
"7449","290230 ARATUIPE",0,0,6,91,6,103,"2011"
"7450","290240 AURELINO LEAL",0,1,5,167,48,221,"2011"
"7451","290250 BAIANOPOLIS",0,0,7,210,9,226,"2011"
"7452","290260 BAIXA GRANDE",0,1,7,252,14,274,"2011"
"7453","290265 BANZAE",1,0,0,14,231,246,"2011"
"7454","290270 BARRA",1,3,13,818,2,837,"2011"
"7455","290280 BARRA DA ESTIVA",1,2,8,348,17,376,"2011"
"7456","290290 BARRA DO CHOCA",0,4,15,506,42,567,"2011"
"7457","290300 BARRA DO MENDES",1,4,7,162,0,174,"2011"
"7458","290310 BARRA DO ROCHA",1,0,4,74,1,80,"2011"
"7459","290320 BARREIRAS",3,10,46,2678,19,2756,"2011"
"7460","290323 BARRO ALTO",0,3,3,179,0,185,"2011"
"7461","290327 BARROCAS",0,1,1,231,14,247,"2011"
"7462","290330 BARRO PRETO",0,1,3,77,6,87,"2011"
"7463","290340 BELMONTE",0,0,3,381,6,390,"2011"
"7464","290350 BELO CAMPO",0,2,5,200,2,209,"2011"
"7465","290360 BIRITINGA",0,2,3,227,39,271,"2011"
"7466","290370 BOA NOVA",0,1,9,174,13,197,"2011"
"7467","290380 BOA VISTA DO TUPIM",1,3,5,279,19,307,"2011"
"7468","290390 BOM JESUS DA LAPA",4,2,16,1066,17,1105,"2011"
"7469","290395 BOM JESUS DA SERRA",0,0,12,152,5,169,"2011"
"7470","290400 BONINAL",0,1,3,141,0,145,"2011"
"7471","290405 BONITO",0,0,3,239,5,247,"2011"
"7472","290410 BOQUIRA",0,0,6,255,14,275,"2011"
"7473","290420 BOTUPORA",2,0,4,119,39,164,"2011"
"7474","290430 BREJOES",1,1,3,196,7,208,"2011"
"7475","290440 BREJOLANDIA",1,2,10,117,5,135,"2011"
"7476","290450 BROTAS DE MACAUBAS",0,0,3,123,9,135,"2011"
"7477","290460 BRUMADO",0,4,12,868,83,967,"2011"
"7478","290470 BUERAREMA",2,2,10,325,0,339,"2011"
"7479","290475 BURITIRAMA",1,7,7,290,3,308,"2011"
"7480","290480 CAATIBA",0,0,0,60,29,89,"2011"
"7481","290485 CABACEIRAS DO PARAGUACU",1,2,2,191,53,249,"2011"
"7482","290490 CACHOEIRA",1,1,1,148,269,420,"2011"
"7483","290500 CACULE",0,0,8,228,6,242,"2011"
"7484","290510 CAEM",3,2,0,170,21,196,"2011"
"7485","290515 CAETANOS",1,0,6,148,7,162,"2011"
"7486","290520 CAETITE",6,2,5,686,7,706,"2011"
"7487","290530 CAFARNAUM",0,5,18,334,1,358,"2011"
"7488","290540 CAIRU",0,1,37,170,1,209,"2011"
"7489","290550 CALDEIRAO GRANDE",0,0,3,172,10,185,"2011"
"7490","290560 CAMACAN",2,0,11,477,10,500,"2011"
"7491","290570 CAMACARI",14,24,56,4088,60,4242,"2011"
"7492","290580 CAMAMU",1,5,40,413,27,486,"2011"
"7493","290590 CAMPO ALEGRE DE LOURDES",3,3,3,461,14,484,"2011"
"7494","290600 CAMPO FORMOSO",0,1,1,55,1003,1060,"2011"
"7495","290610 CANAPOLIS",1,3,3,170,0,177,"2011"
"7496","290620 CANARANA",4,0,16,389,3,412,"2011"
"7497","290630 CANAVIEIRAS",0,3,12,396,105,516,"2011"
"7498","290640 CANDEAL",1,0,1,43,78,123,"2011"
"7499","290650 CANDEIAS",6,7,15,999,128,1155,"2011"
"7500","290660 CANDIBA",0,1,3,142,2,148,"2011"
"7501","290670 CANDIDO SALES",5,4,16,364,7,396,"2011"
"7502","290680 CANSANCAO",4,4,15,385,30,438,"2011"
"7503","290682 CANUDOS",2,1,1,189,43,236,"2011"
"7504","290685 CAPELA DO ALTO ALEGRE",2,0,1,97,15,115,"2011"
"7505","290687 CAPIM GROSSO",1,6,5,417,37,466,"2011"
"7506","290689 CARAIBAS",0,1,4,108,4,117,"2011"
"7507","290690 CARAVELAS",1,3,3,322,3,332,"2011"
"7508","290700 CARDEAL DA SILVA",0,1,2,111,5,119,"2011"
"7509","290710 CARINHANHA",4,4,9,468,12,497,"2011"
"7510","290720 CASA NOVA",5,7,21,1086,34,1153,"2011"
"7511","290730 CASTRO ALVES",0,0,4,295,45,344,"2011"
"7512","290740 CATOLANDIA",0,0,0,56,1,57,"2011"
"7513","290750 CATU",1,4,14,613,19,651,"2011"
"7514","290755 CATURAMA",0,0,0,38,58,96,"2011"
"7515","290760 CENTRAL",0,1,13,257,2,273,"2011"
"7516","290770 CHORROCHO",0,1,8,161,4,174,"2011"
"7517","290780 CICERO DANTAS",0,1,8,299,65,373,"2011"
"7518","290790 CIPO",2,0,1,193,121,317,"2011"
"7519","290800 COARACI",6,2,7,293,5,313,"2011"
"7520","290810 COCOS",0,0,3,186,50,239,"2011"
"7521","290820 CONCEICAO DA FEIRA",2,1,0,152,137,292,"2011"
"7522","290830 CONCEICAO DO ALMEIDA",1,1,0,183,7,192,"2011"
"7523","290840 CONCEICAO DO COITE",3,2,10,921,108,1044,"2011"
"7524","290850 CONCEICAO DO JACUIPE",0,3,2,249,181,435,"2011"
"7525","290860 CONDE",0,1,7,314,15,337,"2011"
"7526","290870 CONDEUBA",0,1,5,179,5,190,"2011"
"7527","290880 CONTENDAS DO SINCORA",0,1,3,39,9,52,"2011"
"7528","290890 CORACAO DE MARIA",2,0,5,206,110,323,"2011"
"7529","290900 CORDEIROS",0,1,2,75,0,78,"2011"
"7530","290910 CORIBE",0,1,5,171,26,203,"2011"
"7531","290920 CORONEL JOAO SA",1,1,6,286,2,296,"2011"
"7532","290930 CORRENTINA",0,7,28,250,192,477,"2011"
"7533","290940 COTEGIPE",0,2,1,170,13,186,"2011"
"7534","290950 CRAVOLANDIA",0,2,0,71,1,74,"2011"
"7535","290960 CRISOPOLIS",0,4,6,260,11,281,"2011"
"7536","290970 CRISTOPOLIS",1,0,5,159,2,167,"2011"
"7537","290980 CRUZ DAS ALMAS",12,7,8,839,32,898,"2011"
"7538","290990 CURACA",0,5,19,511,9,544,"2011"
"7539","291000 DARIO MEIRA",0,2,4,131,19,156,"2011"
"7540","291005 DIAS D'AVILA",5,3,14,1031,23,1076,"2011"
"7541","291010 DOM BASILIO",0,0,1,142,2,145,"2011"
"7542","291020 DOM MACEDO COSTA",0,0,3,55,1,59,"2011"
"7543","291030 ELISIO MEDRADO",0,0,2,107,2,111,"2011"
"7544","291040 ENCRUZILHADA",4,1,9,334,15,363,"2011"
"7545","291050 ENTRE RIOS",0,1,12,528,17,558,"2011"
"7546","291060 ESPLANADA",1,0,12,477,10,500,"2011"
"7547","291070 EUCLIDES DA CUNHA",5,3,11,494,323,836,"2011"
"7548","291072 EUNAPOLIS",7,5,18,439,1412,1881,"2011"
"7549","291075 FATIMA",0,1,8,195,12,216,"2011"
"7550","291077 FEIRA DA MATA",0,0,0,43,5,48,"2011"
"7551","291080 FEIRA DE SANTANA",21,12,65,6095,3269,9462,"2011"
"7552","291085 FILADELFIA",0,6,10,238,8,262,"2011"
"7553","291090 FIRMINO ALVES",0,0,1,85,7,93,"2011"
"7554","291100 FLORESTA AZUL",1,0,2,143,2,148,"2011"
"7555","291110 FORMOSA DO RIO PRETO",0,2,11,419,3,435,"2011"
"7556","291120 GANDU",1,1,28,506,6,542,"2011"
"7557","291125 GAVIAO",1,0,2,58,4,65,"2011"
"7558","291130 GENTIO DO OURO",0,0,3,141,2,146,"2011"
"7559","291140 GLORIA",3,4,5,250,10,272,"2011"
"7560","291150 GONGOGI",0,1,3,76,0,80,"2011"
"7561","291160 GOVERNADOR MANGABEIRA",0,0,1,189,114,304,"2011"
"7562","291165 GUAJERU",1,1,1,94,4,101,"2011"
"7563","291170 GUANAMBI",5,7,14,1019,37,1082,"2011"
"7564","291180 GUARATINGA",5,4,1,266,33,309,"2011"
"7565","291185 HELIOPOLIS",0,1,4,101,38,144,"2011"
"7566","291190 IACU",5,1,13,388,15,422,"2011"
"7567","291200 IBIASSUCE",0,0,6,120,2,128,"2011"
"7568","291210 IBICARAI",1,4,6,392,2,405,"2011"
"7569","291220 IBICOARA",0,0,7,305,11,323,"2011"
"7570","291230 IBICUI",0,1,4,194,1,200,"2011"
"7571","291240 IBIPEBA",1,2,7,250,4,264,"2011"
"7572","291250 IBIPITANGA",0,1,0,74,65,140,"2011"
"7573","291260 IBIQUERA",1,0,1,55,2,59,"2011"
"7574","291270 IBIRAPITANGA",1,5,14,319,138,477,"2011"
"7575","291280 IBIRAPUA",0,1,1,86,1,89,"2011"
"7576","291290 IBIRATAIA",1,1,9,324,1,336,"2011"
"7577","291300 IBITIARA",0,3,7,159,5,174,"2011"
"7578","291310 IBITITA",0,1,3,237,0,241,"2011"
"7579","291320 IBOTIRAMA",2,3,12,404,30,451,"2011"
"7580","291330 ICHU",0,0,1,49,17,67,"2011"
"7581","291340 IGAPORA",1,0,9,167,4,181,"2011"
"7582","291345 IGRAPIUNA",3,0,20,139,12,174,"2011"
"7583","291350 IGUAI",1,1,7,333,7,349,"2011"
"7584","291360 ILHEUS",10,4,23,878,1946,2861,"2011"
"7585","291370 INHAMBUPE",1,2,14,492,25,534,"2011"
"7586","291380 IPECAETA",1,0,2,159,62,224,"2011"
"7587","291390 IPIAU",3,4,20,698,5,730,"2011"
"7588","291400 IPIRA",4,3,11,827,30,875,"2011"
"7589","291410 IPUPIARA",0,0,0,115,0,115,"2011"
"7590","291420 IRAJUBA",0,1,7,104,1,113,"2011"
"7591","291430 IRAMAIA",0,0,3,113,4,120,"2011"
"7592","291440 IRAQUARA",1,3,9,355,2,370,"2011"
"7593","291450 IRARA",3,2,3,211,147,366,"2011"
"7594","291460 IRECE",4,5,29,1153,1,1192,"2011"
"7595","291465 ITABELA",2,4,9,464,108,587,"2011"
"7596","291470 ITABERABA",1,0,11,1018,8,1038,"2011"
"7597","291480 ITABUNA",11,10,79,3319,12,3431,"2011"
"7598","291490 ITACARE",0,0,6,194,124,324,"2011"
"7599","291500 ITAETE",0,1,3,245,9,258,"2011"
"7600","291510 ITAGI",0,0,4,215,2,221,"2011"
"7601","291520 ITAGIBA",2,2,4,185,1,194,"2011"
"7602","291530 ITAGIMIRIM",1,0,1,53,52,107,"2011"
"7603","291535 ITAGUACU DA BAHIA",0,0,6,163,1,170,"2011"
"7604","291540 ITAJU DO COLONIA",2,0,1,70,4,77,"2011"
"7605","291550 ITAJUIPE",1,2,13,286,3,305,"2011"
"7606","291560 ITAMARAJU",1,2,22,1152,38,1215,"2011"
"7607","291570 ITAMARI",1,1,7,145,3,157,"2011"
"7608","291580 ITAMBE",5,6,11,408,10,440,"2011"
"7609","291590 ITANAGRA",1,1,1,99,10,112,"2011"
"7610","291600 ITANHEM",0,1,8,215,1,225,"2011"
"7611","291610 ITAPARICA",0,0,5,203,37,245,"2011"
"7612","291620 ITAPE",1,0,6,132,3,142,"2011"
"7613","291630 ITAPEBI",0,0,1,71,109,181,"2011"
"7614","291640 ITAPETINGA",4,3,3,475,671,1156,"2011"
"7615","291650 ITAPICURU",0,2,6,394,23,425,"2011"
"7616","291660 ITAPITANGA",1,0,1,84,5,91,"2011"
"7617","291670 ITAQUARA",2,0,5,141,1,149,"2011"
"7618","291680 ITARANTIM",0,2,1,237,25,265,"2011"
"7619","291685 ITATIM",0,0,0,149,49,198,"2011"
"7620","291690 ITIRUCU",0,2,5,137,1,145,"2011"
"7621","291700 ITIUBA",2,5,8,454,176,645,"2011"
"7622","291710 ITORORO",0,1,4,211,62,278,"2011"
"7623","291720 ITUACU",1,1,4,209,17,232,"2011"
"7624","291730 ITUBERA",2,1,32,444,9,488,"2011"
"7625","291733 IUIU",1,0,0,115,23,139,"2011"
"7626","291735 JABORANDI",1,2,3,114,0,120,"2011"
"7627","291740 JACARACI",0,1,9,122,1,133,"2011"
"7628","291750 JACOBINA",4,6,17,884,306,1217,"2011"
"7629","291760 JAGUAQUARA",1,2,20,777,8,808,"2011"
"7630","291770 JAGUARARI",4,5,12,324,108,453,"2011"
"7631","291780 JAGUARIPE",2,2,19,186,10,219,"2011"
"7632","291790 JANDAIRA",1,2,1,170,4,178,"2011"
"7633","291800 JEQUIE",10,16,68,2331,61,2486,"2011"
"7634","291810 JEREMOABO",0,1,11,471,92,575,"2011"
"7635","291820 JIQUIRICA",0,0,3,161,0,164,"2011"
"7636","291830 JITAUNA",2,2,5,149,4,162,"2011"
"7637","291835 JOAO DOURADO",1,5,16,425,0,447,"2011"
"7638","291840 JUAZEIRO",15,27,73,3600,59,3774,"2011"
"7639","291845 JUCURUCU",0,0,1,77,4,82,"2011"
"7640","291850 JUSSARA",0,0,17,245,5,267,"2011"
"7641","291855 JUSSARI",1,0,2,86,1,90,"2011"
"7642","291860 JUSSIAPE",0,0,1,58,0,59,"2011"
"7643","291870 LAFAIETE COUTINHO",0,0,0,41,2,43,"2011"
"7644","291875 LAGOA REAL",0,0,2,150,1,153,"2011"
"7645","291880 LAJE",1,0,5,316,8,330,"2011"
"7646","291890 LAJEDAO",0,1,2,48,0,51,"2011"
"7647","291900 LAJEDINHO",0,0,0,47,3,50,"2011"
"7648","291905 LAJEDO DO TABOCAL",2,0,5,86,4,97,"2011"
"7649","291910 LAMARAO",0,2,2,71,24,99,"2011"
"7650","291915 LAPAO",1,3,15,443,0,462,"2011"
"7651","291920 LAURO DE FREITAS",16,18,58,2828,23,2943,"2011"
"7652","291930 LENCOIS",0,1,3,157,7,168,"2011"
"7653","291940 LICINIO DE ALMEIDA",0,0,5,133,1,139,"2011"
"7654","291950 LIVRAMENTO DE NOSSA SENHORA",2,1,9,520,5,537,"2011"
"7655","291955 LUIS EDUARDO MAGALHAES",0,8,9,1390,40,1447,"2011"
"7656","291960 MACAJUBA",0,1,3,176,15,195,"2011"
"7657","291970 MACARANI",1,3,4,249,34,291,"2011"
"7658","291980 MACAUBAS",1,2,6,573,18,600,"2011"
"7659","291990 MACURURE",0,0,4,92,7,103,"2011"
"7660","291992 MADRE DE DEUS",2,0,3,272,22,299,"2011"
"7661","291995 MAETINGA",1,0,1,82,1,85,"2011"
"7662","292000 MAIQUINIQUE",0,2,4,117,25,148,"2011"
"7663","292010 MAIRI",1,3,6,219,15,244,"2011"
"7664","292020 MALHADA",3,0,6,235,3,247,"2011"
"7665","292030 MALHADA DE PEDRAS",2,0,2,97,11,112,"2011"
"7666","292040 MANOEL VITORINO",0,2,10,203,8,223,"2011"
"7667","292045 MANSIDAO",1,1,0,78,0,80,"2011"
"7668","292050 MARACAS",1,2,6,350,3,362,"2011"
"7669","292060 MARAGOGIPE",0,1,7,355,187,550,"2011"
"7670","292070 MARAU",0,0,8,118,84,210,"2011"
"7671","292080 MARCIONILIO SOUZA",0,1,5,160,7,173,"2011"
"7672","292090 MASCOTE",0,1,8,242,15,266,"2011"
"7673","292100 MATA DE SAO JOAO",0,9,26,715,19,769,"2011"
"7674","292105 MATINA",1,0,3,186,6,196,"2011"
"7675","292110 MEDEIROS NETO",0,2,14,317,2,335,"2011"
"7676","292120 MIGUEL CALMON",0,1,8,422,22,453,"2011"
"7677","292130 MILAGRES",0,0,8,156,11,175,"2011"
"7678","292140 MIRANGABA",1,1,4,185,39,230,"2011"
"7679","292145 MIRANTE",1,1,5,98,4,109,"2011"
"7680","292150 MONTE SANTO",0,2,22,711,86,821,"2011"
"7681","292160 MORPARA",0,1,1,114,4,120,"2011"
"7682","292170 MORRO DO CHAPEU",2,5,13,488,77,585,"2011"
"7683","292180 MORTUGABA",2,0,2,139,0,143,"2011"
"7684","292190 MUCUGE",0,0,1,165,32,198,"2011"
"7685","292200 MUCURI",4,8,14,698,2,726,"2011"
"7686","292205 MULUNGU DO MORRO",0,2,18,218,1,239,"2011"
"7687","292210 MUNDO NOVO",0,1,16,293,11,321,"2011"
"7688","292220 MUNIZ FERREIRA",1,0,3,85,2,91,"2011"
"7689","292225 MUQUEM DE SAO FRANCISCO",0,1,4,161,9,175,"2011"
"7690","292230 MURITIBA",3,0,3,257,81,344,"2011"
"7691","292240 MUTUIPE",5,1,17,255,14,292,"2011"
"7692","292250 NAZARE",5,2,18,384,8,417,"2011"
"7693","292260 NILO PECANHA",0,0,26,157,3,186,"2011"
"7694","292265 NORDESTINA",0,3,3,158,8,172,"2011"
"7695","292270 NOVA CANAA",0,3,11,169,0,183,"2011"
"7696","292273 NOVA FATIMA",0,2,2,70,10,84,"2011"
"7697","292275 NOVA IBIA",0,0,5,77,1,83,"2011"
"7698","292280 NOVA ITARANA",0,0,5,128,1,134,"2011"
"7699","292285 NOVA REDENCAO",0,0,0,111,7,118,"2011"
"7700","292290 NOVA SOURE",0,0,7,286,84,377,"2011"
"7701","292300 NOVA VICOSA",3,5,18,636,5,667,"2011"
"7702","292303 NOVO HORIZONTE",0,2,5,91,1,99,"2011"
"7703","292305 NOVO TRIUNFO",1,0,5,123,8,137,"2011"
"7704","292310 OLINDINA",1,1,12,284,47,345,"2011"
"7705","292320 OLIVEIRA DOS BREJINHOS",1,0,5,243,6,255,"2011"
"7706","292330 OURICANGAS",0,2,5,94,10,111,"2011"
"7707","292335 OUROLANDIA",0,0,5,251,60,316,"2011"
"7708","292340 PALMAS DE MONTE ALTO",1,3,6,282,1,293,"2011"
"7709","292350 PALMEIRAS",0,2,6,115,11,134,"2011"
"7710","292360 PARAMIRIM",0,1,0,70,186,257,"2011"
"7711","292370 PARATINGA",2,1,21,480,7,511,"2011"
"7712","292380 PARIPIRANGA",1,2,2,370,2,377,"2011"
"7713","292390 PAU BRASIL",0,1,5,185,19,210,"2011"
"7714","292400 PAULO AFONSO",9,9,54,1810,63,1945,"2011"
"7715","292405 PE DE SERRA",0,1,4,129,27,161,"2011"
"7716","292410 PEDRAO",0,0,3,56,8,67,"2011"
"7717","292420 PEDRO ALEXANDRE",0,2,6,215,11,234,"2011"
"7718","292430 PIATA",1,0,3,282,6,292,"2011"
"7719","292440 PILAO ARCADO",0,2,7,559,61,629,"2011"
"7720","292450 PINDAI",0,1,2,186,2,191,"2011"
"7721","292460 PINDOBACU",1,2,3,322,9,337,"2011"
"7722","292465 PINTADAS",2,0,3,97,15,117,"2011"
"7723","292467 PIRAI DO NORTE",0,2,14,111,10,137,"2011"
"7724","292470 PIRIPA",0,0,2,110,0,112,"2011"
"7725","292480 PIRITIBA",0,4,9,265,18,296,"2011"
"7726","292490 PLANALTINO",1,1,1,106,2,111,"2011"
"7727","292500 PLANALTO",3,2,11,364,8,388,"2011"
"7728","292510 POCOES",5,6,48,541,25,625,"2011"
"7729","292520 POJUCA",2,1,4,586,1,594,"2011"
"7730","292525 PONTO NOVO",1,8,8,218,15,250,"2011"
"7731","292530 PORTO SEGURO",4,11,58,2109,149,2331,"2011"
"7732","292540 POTIRAGUA",0,1,3,152,8,164,"2011"
"7733","292550 PRADO",1,1,4,408,8,422,"2011"
"7734","292560 PRESIDENTE DUTRA",0,1,10,206,0,217,"2011"
"7735","292570 PRESIDENTE JANIO QUADROS",1,2,3,132,4,142,"2011"
"7736","292575 PRESIDENTE TANCREDO NEVES",3,2,28,344,41,418,"2011"
"7737","292580 QUEIMADAS",1,1,7,350,8,367,"2011"
"7738","292590 QUIJINGUE",2,3,1,239,104,349,"2011"
"7739","292593 QUIXABEIRA",0,0,3,108,13,124,"2011"
"7740","292595 RAFAEL JAMBEIRO",0,1,4,245,33,283,"2011"
"7741","292600 REMANSO",3,2,5,775,14,799,"2011"
"7742","292610 RETIROLANDIA",1,1,6,199,11,218,"2011"
"7743","292620 RIACHAO DAS NEVES",0,2,6,332,5,345,"2011"
"7744","292630 RIACHAO DO JACUIPE",4,2,5,392,16,419,"2011"
"7745","292640 RIACHO DE SANTANA",1,1,7,325,95,429,"2011"
"7746","292650 RIBEIRA DO AMPARO",0,0,1,30,198,229,"2011"
"7747","292660 RIBEIRA DO POMBAL",1,0,1,87,695,784,"2011"
"7748","292665 RIBEIRAO DO LARGO",0,2,6,60,9,77,"2011"
"7749","292670 RIO DE CONTAS",0,0,2,137,5,144,"2011"
"7750","292680 RIO DO ANTONIO",0,0,0,128,6,134,"2011"
"7751","292690 RIO DO PIRES",1,0,0,55,57,113,"2011"
"7752","292700 RIO REAL",4,4,12,645,4,669,"2011"
"7753","292710 RODELAS",1,1,7,195,1,205,"2011"
"7754","292720 RUY BARBOSA",1,6,13,440,11,471,"2011"
"7755","292730 SALINAS DA MARGARIDA",0,0,6,163,5,174,"2011"
"7756","292740 SALVADOR",197,198,772,35830,396,37393,"2011"
"7757","292750 SANTA BARBARA",1,2,1,161,171,336,"2011"
"7758","292760 SANTA BRIGIDA",1,0,7,227,7,242,"2011"
"7759","292770 SANTA CRUZ CABRALIA",1,1,13,398,10,423,"2011"
"7760","292780 SANTA CRUZ DA VITORIA",0,1,1,73,5,80,"2011"
"7761","292790 SANTA INES",0,1,3,147,0,151,"2011"
"7762","292800 SANTALUZ",2,6,20,477,23,528,"2011"
"7763","292805 SANTA LUZIA",0,3,5,183,24,215,"2011"
"7764","292810 SANTA MARIA DA VITORIA",2,3,30,505,19,559,"2011"
"7765","292820 SANTANA",0,1,0,332,2,335,"2011"
"7766","292830 SANTANOPOLIS",0,0,0,81,37,118,"2011"
"7767","292840 SANTA RITA DE CASSIA",1,1,8,453,1,464,"2011"
"7768","292850 SANTA TERESINHA",1,0,2,155,10,168,"2011"
"7769","292860 SANTO AMARO",5,8,28,674,30,745,"2011"
"7770","292870 SANTO ANTONIO DE JESUS",1,1,25,1405,35,1467,"2011"
"7771","292880 SANTO ESTEVAO",2,3,2,546,171,724,"2011"
"7772","292890 SAO DESIDERIO",0,2,13,451,14,480,"2011"
"7773","292895 SAO DOMINGOS",0,0,1,102,12,115,"2011"
"7774","292900 SAO FELIX",0,0,3,118,77,198,"2011"
"7775","292905 SAO FELIX DO CORIBE",0,2,12,251,2,267,"2011"
"7776","292910 SAO FELIPE",2,1,3,207,9,222,"2011"
"7777","292920 SAO FRANCISCO DO CONDE",2,3,9,646,23,683,"2011"
"7778","292925 SAO GABRIEL",0,1,8,312,3,324,"2011"
"7779","292930 SAO GONCALO DOS CAMPOS",0,1,3,331,178,513,"2011"
"7780","292935 SAO JOSE DA VITORIA",0,2,3,99,0,104,"2011"
"7781","292937 SAO JOSE DO JACUIPE",1,0,2,88,23,114,"2011"
"7782","292940 SAO MIGUEL DAS MATAS",0,1,7,123,5,136,"2011"
"7783","292950 SAO SEBASTIAO DO PASSE",2,6,9,557,27,601,"2011"
"7784","292960 SAPEACU",1,0,13,258,2,274,"2011"
"7785","292970 SATIRO DIAS",1,2,3,257,8,271,"2011"
"7786","292975 SAUBARA",0,1,3,140,2,146,"2011"
"7787","292980 SAUDE",1,4,4,169,9,187,"2011"
"7788","292990 SEABRA",3,2,20,643,20,688,"2011"
"7789","293000 SEBASTIAO LARANJEIRAS",0,1,1,112,0,114,"2011"
"7790","293010 SENHOR DO BONFIM",6,10,31,1072,27,1146,"2011"
"7791","293015 SERRA DO RAMALHO",1,1,11,435,2,450,"2011"
"7792","293020 SENTO SE",1,5,18,509,9,542,"2011"
"7793","293030 SERRA DOURADA",0,2,4,237,2,245,"2011"
"7794","293040 SERRA PRETA",1,0,1,87,108,197,"2011"
"7795","293050 SERRINHA",1,6,11,1265,58,1341,"2011"
"7796","293060 SERROLANDIA",0,1,11,134,23,169,"2011"
"7797","293070 SIMOES FILHO",12,8,43,1752,151,1966,"2011"
"7798","293075 SITIO DO MATO",1,0,4,182,1,188,"2011"
"7799","293076 SITIO DO QUINTO",0,0,6,154,5,165,"2011"
"7800","293077 SOBRADINHO",1,3,11,393,5,413,"2011"
"7801","293080 SOUTO SOARES",0,0,12,254,1,267,"2011"
"7802","293090 TABOCAS DO BREJO VELHO",0,2,2,159,1,164,"2011"
"7803","293100 TANHACU",1,1,8,252,16,278,"2011"
"7804","293105 TANQUE NOVO",3,2,7,165,33,210,"2011"
"7805","293110 TANQUINHO",1,0,1,57,28,87,"2011"
"7806","293120 TAPEROA",1,2,58,228,15,304,"2011"
"7807","293130 TAPIRAMUTA",1,2,19,219,12,253,"2011"
"7808","293135 TEIXEIRA DE FREITAS",9,12,43,2575,24,2663,"2011"
"7809","293140 TEODORO SAMPAIO",0,0,1,68,19,88,"2011"
"7810","293150 TEOFILANDIA",1,1,6,305,34,347,"2011"
"7811","293160 TEOLANDIA",0,0,12,191,11,214,"2011"
"7812","293170 TERRA NOVA",1,0,4,139,30,174,"2011"
"7813","293180 TREMEDAL",2,2,4,200,11,219,"2011"
"7814","293190 TUCANO",0,5,5,572,108,690,"2011"
"7815","293200 UAUA",1,1,5,318,13,338,"2011"
"7816","293210 UBAIRA",1,0,7,255,3,266,"2011"
"7817","293220 UBAITABA",2,3,5,220,123,353,"2011"
"7818","293230 UBATA",0,2,5,298,8,313,"2011"
"7819","293240 UIBAI",0,2,4,150,1,157,"2011"
"7820","293245 UMBURANAS",8,22,23,104,41,198,"2011"
"7821","293250 UNA",0,3,7,173,139,322,"2011"
"7822","293260 URANDI",2,1,4,194,1,202,"2011"
"7823","293270 URUCUCA",0,1,10,294,75,380,"2011"
"7824","293280 UTINGA",0,0,6,254,16,276,"2011"
"7825","293290 VALENCA",7,2,240,964,5,1218,"2011"
"7826","293300 VALENTE",2,0,4,311,33,350,"2011"
"7827","293305 VARZEA DA ROCA",0,1,6,136,13,156,"2011"
"7828","293310 VARZEA DO POCO",0,2,12,108,6,128,"2011"
"7829","293315 VARZEA NOVA",0,2,7,152,51,212,"2011"
"7830","293317 VARZEDO",0,2,1,129,2,134,"2011"
"7831","293320 VERA CRUZ",0,3,8,414,87,512,"2011"
"7832","293325 VEREDA",0,0,4,72,0,76,"2011"
"7833","293330 VITORIA DA CONQUISTA",31,31,152,5157,31,5402,"2011"
"7834","293340 WAGNER",0,0,0,156,9,165,"2011"
"7835","293345 WANDERLEY",0,1,4,175,13,193,"2011"
"7836","293350 WENCESLAU GUIMARAES",1,4,20,345,28,398,"2011"
"7837","293360 XIQUE-XIQUE",0,2,32,823,19,876,"2011"
"7838","MUNICIPIO IGNORADO - MG",0,0,0,7,1,8,"2011"
"7839","310010 ABADIA DOS DOURADOS",0,1,0,76,0,77,"2011"
"7840","310020 ABAETE",0,1,9,213,1,224,"2011"
"7841","310030 ABRE CAMPO",1,1,0,135,12,149,"2011"
"7842","310040 ACAIACA",0,0,0,55,0,55,"2011"
"7843","310050 ACUCENA",0,0,2,108,3,113,"2011"
"7844","310060 AGUA BOA",0,0,2,181,11,194,"2011"
"7845","310070 AGUA COMPRIDA",0,0,0,26,0,26,"2011"
"7846","310080 AGUANIL",0,0,1,36,0,37,"2011"
"7847","310090 AGUAS FORMOSAS",1,0,4,270,3,278,"2011"
"7848","310100 AGUAS VERMELHAS",1,1,3,212,3,220,"2011"
"7849","310110 AIMORES",0,0,8,261,20,289,"2011"
"7850","310120 AIURUOCA",0,0,1,54,0,55,"2011"
"7851","310130 ALAGOA",0,0,0,18,1,19,"2011"
"7852","310140 ALBERTINA",0,0,0,22,0,22,"2011"
"7853","310150 ALEM PARAIBA",2,4,5,440,0,451,"2011"
"7854","310160 ALFENAS",0,4,7,918,2,931,"2011"
"7855","310163 ALFREDO VASCONCELOS",0,0,2,72,0,74,"2011"
"7856","310170 ALMENARA",16,2,11,552,21,602,"2011"
"7857","310180 ALPERCATA",0,0,1,89,4,94,"2011"
"7858","310190 ALPINOPOLIS",0,1,2,230,0,233,"2011"
"7859","310200 ALTEROSA",0,1,7,161,1,170,"2011"
"7860","310205 ALTO CAPARAO",1,0,0,68,22,91,"2011"
"7861","310210 ALTO RIO DOCE",1,2,2,114,0,119,"2011"
"7862","310220 ALVARENGA",0,0,2,47,1,50,"2011"
"7863","310230 ALVINOPOLIS",0,0,7,157,2,166,"2011"
"7864","310240 ALVORADA DE MINAS",0,0,1,52,1,54,"2011"
"7865","310250 AMPARO DO SERRA",0,2,1,64,1,68,"2011"
"7866","310260 ANDRADAS",0,0,4,440,0,444,"2011"
"7867","310270 CACHOEIRA DE PAJEU",0,0,6,91,5,102,"2011"
"7868","310280 ANDRELANDIA",1,1,0,139,0,141,"2011"
"7869","310285 ANGELANDIA",0,1,2,123,2,128,"2011"
"7870","310290 ANTONIO CARLOS",0,0,1,103,0,104,"2011"
"7871","310300 ANTONIO DIAS",0,2,1,101,2,106,"2011"
"7872","310310 ANTONIO PRADO DE MINAS",0,0,0,16,0,16,"2011"
"7873","310320 ARACAI",2,0,1,12,1,16,"2011"
"7874","310330 ARACITABA",0,0,0,13,0,13,"2011"
"7875","310340 ARACUAI",0,3,6,524,16,549,"2011"
"7876","310350 ARAGUARI",4,3,18,1322,7,1354,"2011"
"7877","310360 ARANTINA",0,0,0,23,1,24,"2011"
"7878","310370 ARAPONGA",0,1,1,70,4,76,"2011"
"7879","310375 ARAPORA",0,2,0,104,1,107,"2011"
"7880","310380 ARAPUA",0,0,0,16,0,16,"2011"
"7881","310390 ARAUJOS",0,2,4,92,0,98,"2011"
"7882","310400 ARAXA",6,3,6,1199,8,1222,"2011"
"7883","310410 ARCEBURGO",0,1,0,102,1,104,"2011"
"7884","310420 ARCOS",2,1,6,437,1,447,"2011"
"7885","310430 AREADO",0,1,2,173,0,176,"2011"
"7886","310440 ARGIRITA",0,0,0,32,0,32,"2011"
"7887","310445 ARICANDUVA",0,1,4,55,0,60,"2011"
"7888","310450 ARINOS",3,0,2,201,6,212,"2011"
"7889","310460 ASTOLFO DUTRA",0,0,3,149,5,157,"2011"
"7890","310470 ATALEIA",0,1,2,161,1,165,"2011"
"7891","310480 AUGUSTO DE LIMA",0,1,1,48,0,50,"2011"
"7892","310490 BAEPENDI",0,1,1,186,2,190,"2011"
"7893","310500 BALDIM",0,1,2,75,3,81,"2011"
"7894","310510 BAMBUI",2,3,0,227,0,232,"2011"
"7895","310520 BANDEIRA",0,1,0,30,3,34,"2011"
"7896","310530 BANDEIRA DO SUL",0,1,0,59,1,61,"2011"
"7897","310540 BARAO DE COCAIS",1,1,11,366,10,389,"2011"
"7898","310550 BARAO DE MONTE ALTO",0,0,3,55,0,58,"2011"
"7899","310560 BARBACENA",4,7,40,1403,2,1456,"2011"
"7900","310570 BARRA LONGA",0,0,1,55,2,58,"2011"
"7901","310590 BARROSO",1,0,4,255,0,260,"2011"
"7902","310600 BELA VISTA DE MINAS",0,0,0,118,2,120,"2011"
"7903","310610 BELMIRO BRAGA",0,1,0,31,0,32,"2011"
"7904","310620 BELO HORIZONTE",70,122,407,30802,124,31525,"2011"
"7905","310630 BELO ORIENTE",0,0,6,365,3,374,"2011"
"7906","310640 BELO VALE",0,0,1,72,1,74,"2011"
"7907","310650 BERILO",1,0,1,131,4,137,"2011"
"7908","310660 BERTOPOLIS",0,0,1,68,11,80,"2011"
"7909","310665 BERIZAL",0,0,0,75,2,77,"2011"
"7910","310670 BETIM",12,17,112,5950,40,6131,"2011"
"7911","310680 BIAS FORTES",0,0,0,35,0,35,"2011"
"7912","310690 BICAS",1,0,1,192,0,194,"2011"
"7913","310700 BIQUINHAS",0,0,1,20,0,21,"2011"
"7914","310710 BOA ESPERANCA",0,2,4,527,3,536,"2011"
"7915","310720 BOCAINA DE MINAS",0,0,1,25,0,26,"2011"
"7916","310730 BOCAIUVA",4,2,17,656,4,683,"2011"
"7917","310740 BOM DESPACHO",2,1,11,583,0,597,"2011"
"7918","310750 BOM JARDIM DE MINAS",0,0,2,65,8,75,"2011"
"7919","310760 BOM JESUS DA PENHA",0,0,2,47,1,50,"2011"
"7920","310770 BOM JESUS DO AMPARO",0,0,0,78,5,83,"2011"
"7921","310780 BOM JESUS DO GALHO",0,0,22,132,2,156,"2011"
"7922","310790 BOM REPOUSO",0,0,1,116,0,117,"2011"
"7923","310800 BOM SUCESSO",1,1,0,190,0,192,"2011"
"7924","310810 BONFIM",0,0,0,46,0,46,"2011"
"7925","310820 BONFINOPOLIS DE MINAS",0,1,5,69,5,80,"2011"
"7926","310825 BONITO DE MINAS",0,0,1,124,4,129,"2011"
"7927","310830 BORDA DA MATA",0,0,5,208,1,214,"2011"
"7928","310840 BOTELHOS",0,0,5,105,8,118,"2011"
"7929","310850 BOTUMIRIM",0,1,2,74,0,77,"2011"
"7930","310855 BRASILANDIA DE MINAS",1,2,1,249,3,256,"2011"
"7931","310860 BRASILIA DE MINAS",0,2,12,472,0,486,"2011"
"7932","310870 BRAS PIRES",0,0,0,40,0,40,"2011"
"7933","310880 BRAUNAS",0,1,3,47,2,53,"2011"
"7934","310890 BRAZOPOLIS",2,1,1,144,3,151,"2011"
"7935","310900 BRUMADINHO",0,2,2,451,7,462,"2011"
"7936","310910 BUENO BRANDAO",1,0,1,86,0,88,"2011"
"7937","310920 BUENOPOLIS",1,0,2,104,0,107,"2011"
"7938","310925 BUGRE",0,0,1,49,0,50,"2011"
"7939","310930 BURITIS",1,5,5,344,8,363,"2011"
"7940","310940 BURITIZEIRO",0,0,13,394,8,415,"2011"
"7941","310945 CABECEIRA GRANDE",0,0,0,91,1,92,"2011"
"7942","310950 CABO VERDE",0,0,3,156,0,159,"2011"
"7943","310960 CACHOEIRA DA PRATA",0,0,0,34,0,34,"2011"
"7944","310970 CACHOEIRA DE MINAS",0,1,1,124,0,126,"2011"
"7945","310980 CACHOEIRA DOURADA",1,0,0,26,0,27,"2011"
"7946","310990 CAETANOPOLIS",0,1,1,106,0,108,"2011"
"7947","311000 CAETE",1,3,11,433,8,456,"2011"
"7948","311010 CAIANA",0,0,0,55,0,55,"2011"
"7949","311020 CAJURI",1,0,0,46,2,49,"2011"
"7950","311030 CALDAS",1,0,5,118,0,124,"2011"
"7951","311040 CAMACHO",0,0,0,25,0,25,"2011"
"7952","311050 CAMANDUCAIA",0,2,4,233,11,250,"2011"
"7953","311060 CAMBUI",0,2,2,296,1,301,"2011"
"7954","311070 CAMBUQUIRA",2,1,0,141,2,146,"2011"
"7955","311080 CAMPANARIO",0,0,1,48,0,49,"2011"
"7956","311090 CAMPANHA",0,1,4,197,0,202,"2011"
"7957","311100 CAMPESTRE",0,0,3,208,0,211,"2011"
"7958","311110 CAMPINA VERDE",0,0,1,215,1,217,"2011"
"7959","311115 CAMPO AZUL",0,0,0,46,1,47,"2011"
"7960","311120 CAMPO BELO",1,1,13,660,1,676,"2011"
"7961","311130 CAMPO DO MEIO",0,0,1,124,1,126,"2011"
"7962","311140 CAMPO FLORIDO",0,0,0,72,0,72,"2011"
"7963","311150 CAMPOS ALTOS",2,4,5,185,0,196,"2011"
"7964","311160 CAMPOS GERAIS",0,1,6,321,1,329,"2011"
"7965","311170 CANAA",0,0,1,50,3,54,"2011"
"7966","311180 CANAPOLIS",0,0,3,112,21,136,"2011"
"7967","311190 CANA VERDE",0,0,0,56,0,56,"2011"
"7968","311200 CANDEIAS",0,0,7,122,0,129,"2011"
"7969","311205 CANTAGALO",0,1,0,67,0,68,"2011"
"7970","311210 CAPARAO",0,0,0,61,1,62,"2011"
"7971","311220 CAPELA NOVA",0,0,0,42,0,42,"2011"
"7972","311230 CAPELINHA",2,1,11,531,3,548,"2011"
"7973","311240 CAPETINGA",1,1,11,61,1,75,"2011"
"7974","311250 CAPIM BRANCO",0,0,3,102,14,119,"2011"
"7975","311260 CAPINOPOLIS",1,0,2,179,2,184,"2011"
"7976","311265 CAPITAO ANDRADE",0,0,2,68,1,71,"2011"
"7977","311270 CAPITAO ENEAS",0,0,4,191,1,196,"2011"
"7978","311280 CAPITOLIO",0,0,2,70,5,77,"2011"
"7979","311290 CAPUTIRA",0,0,0,5,109,114,"2011"
"7980","311300 CARAI",0,0,4,302,4,310,"2011"
"7981","311310 CARANAIBA",0,0,1,37,0,38,"2011"
"7982","311320 CARANDAI",0,1,4,301,0,306,"2011"
"7983","311330 CARANGOLA",0,3,0,426,8,437,"2011"
"7984","311340 CARATINGA",6,12,33,1088,11,1150,"2011"
"7985","311350 CARBONITA",0,0,2,86,0,88,"2011"
"7986","311360 CAREACU",0,0,3,54,1,58,"2011"
"7987","311370 CARLOS CHAGAS",3,1,3,248,1,256,"2011"
"7988","311380 CARMESIA",1,1,0,36,3,41,"2011"
"7989","311390 CARMO DA CACHOEIRA",3,1,0,134,7,145,"2011"
"7990","311400 CARMO DA MATA",0,0,1,98,1,100,"2011"
"7991","311410 CARMO DE MINAS",0,1,1,167,0,169,"2011"
"7992","311420 CARMO DO CAJURU",2,0,9,243,1,255,"2011"
"7993","311430 CARMO DO PARANAIBA",0,3,1,325,0,329,"2011"
"7994","311440 CARMO DO RIO CLARO",0,0,4,198,0,202,"2011"
"7995","311450 CARMOPOLIS DE MINAS",0,0,2,176,3,181,"2011"
"7996","311455 CARNEIRINHO",0,1,0,108,0,109,"2011"
"7997","311460 CARRANCAS",0,0,1,36,0,37,"2011"
"7998","311470 CARVALHOPOLIS",0,0,0,40,0,40,"2011"
"7999","311480 CARVALHOS",0,1,0,45,0,46,"2011"
"8000","311490 CASA GRANDE",0,0,0,17,0,17,"2011"
"8001","311500 CASCALHO RICO",0,0,0,18,0,18,"2011"
"8002","311510 CASSIA",1,2,27,172,0,202,"2011"
"8003","311520 CONCEICAO DA BARRA DE MINAS",0,0,1,39,2,42,"2011"
"8004","311530 CATAGUASES",4,12,43,738,1,798,"2011"
"8005","311535 CATAS ALTAS",0,0,3,46,3,52,"2011"
"8006","311540 CATAS ALTAS DA NORUEGA",0,0,0,56,1,57,"2011"
"8007","311545 CATUJI",0,1,1,151,3,156,"2011"
"8008","311547 CATUTI",0,0,0,53,19,72,"2011"
"8009","311550 CAXAMBU",0,0,0,219,50,269,"2011"
"8010","311560 CEDRO DO ABAETE",0,0,1,15,0,16,"2011"
"8011","311570 CENTRAL DE MINAS",0,2,5,89,1,97,"2011"
"8012","311580 CENTRALINA",0,0,1,45,24,70,"2011"
"8013","311590 CHACARA",0,0,0,18,0,18,"2011"
"8014","311600 CHALE",0,0,0,49,41,90,"2011"
"8015","311610 CHAPADA DO NORTE",0,0,2,149,1,152,"2011"
"8016","311615 CHAPADA GAUCHA",0,1,3,153,4,161,"2011"
"8017","311620 CHIADOR",0,0,0,23,2,25,"2011"
"8018","311630 CIPOTANEA",0,0,4,53,0,57,"2011"
"8019","311640 CLARAVAL",0,0,0,12,0,12,"2011"
"8020","311650 CLARO DOS POCOES",0,0,0,82,1,83,"2011"
"8021","311660 CLAUDIO",0,3,3,326,3,335,"2011"
"8022","311670 COIMBRA",0,1,0,73,1,75,"2011"
"8023","311680 COLUNA",2,0,4,113,1,120,"2011"
"8024","311690 COMENDADOR GOMES",0,0,1,23,2,26,"2011"
"8025","311700 COMERCINHO",1,1,4,71,2,79,"2011"
"8026","311710 CONCEICAO DA APARECIDA",0,1,4,105,1,111,"2011"
"8027","311720 CONCEICAO DAS PEDRAS",0,0,0,33,0,33,"2011"
"8028","311730 CONCEICAO DAS ALAGOAS",0,1,1,379,3,384,"2011"
"8029","311740 CONCEICAO DE IPANEMA",0,0,2,60,8,70,"2011"
"8030","311750 CONCEICAO DO MATO DENTRO",1,2,4,201,3,211,"2011"
"8031","311760 CONCEICAO DO PARA",0,0,0,37,8,45,"2011"
"8032","311770 CONCEICAO DO RIO VERDE",1,3,6,177,5,192,"2011"
"8033","311780 CONCEICAO DOS OUROS",0,1,0,118,1,120,"2011"
"8034","311783 CONEGO MARINHO",0,0,0,88,3,91,"2011"
"8035","311787 CONFINS",0,0,1,83,3,87,"2011"
"8036","311790 CONGONHAL",0,0,0,93,2,95,"2011"
"8037","311800 CONGONHAS",2,2,14,717,1,736,"2011"
"8038","311810 CONGONHAS DO NORTE",0,0,3,52,0,55,"2011"
"8039","311820 CONQUISTA",0,1,2,59,1,63,"2011"
"8040","311830 CONSELHEIRO LAFAIETE",2,9,19,1655,2,1687,"2011"
"8041","311840 CONSELHEIRO PENA",1,1,4,263,1,270,"2011"
"8042","311850 CONSOLACAO",0,0,0,24,0,24,"2011"
"8043","311860 CONTAGEM",24,31,125,8199,32,8411,"2011"
"8044","311870 COQUEIRAL",0,2,0,23,73,98,"2011"
"8045","311880 CORACAO DE JESUS",0,2,4,292,4,302,"2011"
"8046","311890 CORDISBURGO",0,0,0,68,1,69,"2011"
"8047","311900 CORDISLANDIA",1,0,1,29,0,31,"2011"
"8048","311910 CORINTO",3,1,4,281,0,289,"2011"
"8049","311920 COROACI",0,1,2,88,3,94,"2011"
"8050","311930 COROMANDEL",0,0,2,240,0,242,"2011"
"8051","311940 CORONEL FABRICIANO",7,6,26,1474,34,1547,"2011"
"8052","311950 CORONEL MURTA",0,0,2,94,27,123,"2011"
"8053","311960 CORONEL PACHECO",0,1,0,23,0,24,"2011"
"8054","311970 CORONEL XAVIER CHAVES",1,0,1,33,1,36,"2011"
"8055","311980 CORREGO DANTA",0,0,1,17,1,19,"2011"
"8056","311990 CORREGO DO BOM JESUS",0,0,0,17,0,17,"2011"
"8057","311995 CORREGO FUNDO",1,0,0,61,0,62,"2011"
"8058","312000 CORREGO NOVO",0,1,0,27,0,28,"2011"
"8059","312010 COUTO DE MAGALHAES DE MINAS",0,1,2,53,0,56,"2011"
"8060","312015 CRISOLITA",0,0,1,70,0,71,"2011"
"8061","312020 CRISTAIS",0,1,5,112,0,118,"2011"
"8062","312030 CRISTALIA",0,1,2,94,6,103,"2011"
"8063","312040 CRISTIANO OTONI",0,1,1,61,0,63,"2011"
"8064","312050 CRISTINA",0,1,1,94,0,96,"2011"
"8065","312060 CRUCILANDIA",0,0,1,63,0,64,"2011"
"8066","312070 CRUZEIRO DA FORTALEZA",0,0,1,45,0,46,"2011"
"8067","312080 CRUZILIA",0,1,2,177,0,180,"2011"
"8068","312083 CUPARAQUE",0,0,0,71,1,72,"2011"
"8069","312087 CURRAL DE DENTRO",1,0,1,58,54,114,"2011"
"8070","312090 CURVELO",14,4,16,887,2,923,"2011"
"8071","312100 DATAS",0,0,0,69,0,69,"2011"
"8072","312110 DELFIM MOREIRA",0,1,2,88,0,91,"2011"
"8073","312120 DELFINOPOLIS",0,3,5,66,0,74,"2011"
"8074","312125 DELTA",1,0,1,143,2,147,"2011"
"8075","312130 DESCOBERTO",0,0,0,36,0,36,"2011"
"8076","312140 DESTERRO DE ENTRE RIOS",0,1,0,66,0,67,"2011"
"8077","312150 DESTERRO DO MELO",0,0,0,32,0,32,"2011"
"8078","312160 DIAMANTINA",4,6,10,643,1,664,"2011"
"8079","312170 DIOGO DE VASCONCELOS",0,0,1,28,0,29,"2011"
"8080","312180 DIONISIO",0,0,0,58,4,62,"2011"
"8081","312190 DIVINESIA",0,0,2,50,0,52,"2011"
"8082","312200 DIVINO",1,0,3,260,3,267,"2011"
"8083","312210 DIVINO DAS LARANJEIRAS",0,0,1,48,3,52,"2011"
"8084","312220 DIVINOLANDIA DE MINAS",0,0,2,102,1,105,"2011"
"8085","312230 DIVINOPOLIS",8,6,57,2508,10,2589,"2011"
"8086","312235 DIVISA ALEGRE",0,2,4,88,3,97,"2011"
"8087","312240 DIVISA NOVA",0,0,1,67,0,68,"2011"
"8088","312245 DIVISOPOLIS",0,0,3,100,0,103,"2011"
"8089","312247 DOM BOSCO",0,0,0,43,1,44,"2011"
"8090","312250 DOM CAVATI",1,0,0,68,0,69,"2011"
"8091","312260 DOM JOAQUIM",1,2,0,54,1,58,"2011"
"8092","312270 DOM SILVERIO",0,0,1,40,0,41,"2011"
"8093","312280 DOM VICOSO",0,0,0,33,0,33,"2011"
"8094","312290 DONA EUSEBIA",0,0,2,57,0,59,"2011"
"8095","312300 DORES DE CAMPOS",1,0,0,92,0,93,"2011"
"8096","312310 DORES DE GUANHAES",0,0,0,43,0,43,"2011"
"8097","312320 DORES DO INDAIA",1,1,2,110,0,114,"2011"
"8098","312330 DORES DO TURVO",0,0,0,50,0,50,"2011"
"8099","312340 DORESOPOLIS",0,0,0,15,0,15,"2011"
"8100","312350 DOURADOQUARA",0,0,0,13,0,13,"2011"
"8101","312352 DURANDE",1,0,0,14,105,120,"2011"
"8102","312360 ELOI MENDES",1,0,0,240,12,253,"2011"
"8103","312370 ENGENHEIRO CALDAS",0,0,4,134,4,142,"2011"
"8104","312380 ENGENHEIRO NAVARRO",0,0,0,97,2,99,"2011"
"8105","312385 ENTRE FOLHAS",0,0,3,63,0,66,"2011"
"8106","312390 ENTRE RIOS DE MINAS",0,1,2,139,0,142,"2011"
"8107","312400 ERVALIA",0,2,5,231,6,244,"2011"
"8108","312410 ESMERALDAS",1,4,15,796,13,829,"2011"
"8109","312420 ESPERA FELIZ",0,1,7,306,8,322,"2011"
"8110","312430 ESPINOSA",1,1,7,415,21,445,"2011"
"8111","312440 ESPIRITO SANTO DO DOURADO",0,0,1,48,0,49,"2011"
"8112","312450 ESTIVA",0,0,1,138,1,140,"2011"
"8113","312460 ESTRELA DALVA",0,0,0,32,0,32,"2011"
"8114","312470 ESTRELA DO INDAIA",0,0,0,19,0,19,"2011"
"8115","312480 ESTRELA DO SUL",0,0,0,91,0,91,"2011"
"8116","312490 EUGENOPOLIS",0,0,3,118,0,121,"2011"
"8117","312500 EWBANK DA CAMARA",1,0,0,51,1,53,"2011"
"8118","312510 EXTREMA",2,2,7,475,1,487,"2011"
"8119","312520 FAMA",0,0,0,23,0,23,"2011"
"8120","312530 FARIA LEMOS",0,0,0,46,1,47,"2011"
"8121","312540 FELICIO DOS SANTOS",1,1,2,70,1,75,"2011"
"8122","312550 SAO GONCALO DO RIO PRETO",0,0,0,33,0,33,"2011"
"8123","312560 FELISBURGO",0,0,4,97,2,103,"2011"
"8124","312570 FELIXLANDIA",2,1,1,135,0,139,"2011"
"8125","312580 FERNANDES TOURINHO",0,0,0,37,1,38,"2011"
"8126","312590 FERROS",1,0,0,87,3,91,"2011"
"8127","312595 FERVEDOURO",0,0,1,162,2,165,"2011"
"8128","312600 FLORESTAL",2,0,1,86,3,92,"2011"
"8129","312610 FORMIGA",1,0,6,742,0,749,"2011"
"8130","312620 FORMOSO",0,2,3,85,1,91,"2011"
"8131","312630 FORTALEZA DE MINAS",0,0,0,41,0,41,"2011"
"8132","312640 FORTUNA DE MINAS",0,0,1,33,2,36,"2011"
"8133","312650 FRANCISCO BADARO",0,0,1,68,0,69,"2011"
"8134","312660 FRANCISCO DUMONT",0,0,2,67,0,69,"2011"
"8135","312670 FRANCISCO SA",2,2,5,326,7,342,"2011"
"8136","312675 FRANCISCOPOLIS",0,2,0,67,1,70,"2011"
"8137","312680 FREI GASPAR",0,0,2,72,1,75,"2011"
"8138","312690 FREI INOCENCIO",1,0,8,135,1,145,"2011"
"8139","312695 FREI LAGONEGRO",0,0,0,37,0,37,"2011"
"8140","312700 FRONTEIRA",0,2,6,184,1,193,"2011"
"8141","312705 FRONTEIRA DOS VALES",0,0,1,61,1,63,"2011"
"8142","312707 FRUTA DE LEITE",0,0,0,10,87,97,"2011"
"8143","312710 FRUTAL",0,3,10,633,10,656,"2011"
"8144","312720 FUNILANDIA",0,0,1,56,2,59,"2011"
"8145","312730 GALILEIA",0,1,0,90,1,92,"2011"
"8146","312733 GAMELEIRAS",0,1,0,31,42,74,"2011"
"8147","312735 GLAUCILANDIA",0,0,1,31,0,32,"2011"
"8148","312737 GOIABEIRA",0,0,2,44,0,46,"2011"
"8149","312738 GOIANA",0,0,0,27,1,28,"2011"
"8150","312740 GONCALVES",0,1,0,37,1,39,"2011"
"8151","312750 GONZAGA",0,0,2,69,0,71,"2011"
"8152","312760 GOUVEIA",0,1,0,144,0,145,"2011"
"8153","312770 GOVERNADOR VALADARES",8,8,100,3674,98,3888,"2011"
"8154","312780 GRAO MOGOL",1,1,6,183,18,209,"2011"
"8155","312790 GRUPIARA",0,0,0,13,0,13,"2011"
"8156","312800 GUANHAES",0,4,8,439,10,461,"2011"
"8157","312810 GUAPE",0,0,8,137,0,145,"2011"
"8158","312820 GUARACIABA",0,1,1,102,0,104,"2011"
"8159","312825 GUARACIAMA",0,1,0,65,0,66,"2011"
"8160","312830 GUARANESIA",0,1,2,209,36,248,"2011"
"8161","312840 GUARANI",0,0,5,107,0,112,"2011"
"8162","312850 GUARARA",0,0,2,35,0,37,"2011"
"8163","312860 GUARDA-MOR",0,0,0,85,0,85,"2011"
"8164","312870 GUAXUPE",2,11,15,581,2,611,"2011"
"8165","312880 GUIDOVAL",0,1,1,72,0,74,"2011"
"8166","312890 GUIMARANIA",1,0,0,94,1,96,"2011"
"8167","312900 GUIRICEMA",0,0,0,75,0,75,"2011"
"8168","312910 GURINHATA",1,0,0,43,0,44,"2011"
"8169","312920 HELIODORA",0,1,1,57,1,60,"2011"
"8170","312930 IAPU",0,0,5,139,0,144,"2011"
"8171","312940 IBERTIOGA",0,0,3,51,0,54,"2011"
"8172","312950 IBIA",1,0,2,276,0,279,"2011"
"8173","312960 IBIAI",0,1,1,99,6,107,"2011"
"8174","312965 IBIRACATU",0,1,1,77,1,80,"2011"
"8175","312970 IBIRACI",0,2,6,152,0,160,"2011"
"8176","312980 IBIRITE",9,18,55,2538,18,2638,"2011"
"8177","312990 IBITIURA DE MINAS",0,0,0,35,0,35,"2011"
"8178","313000 IBITURUNA",0,0,0,22,0,22,"2011"
"8179","313005 ICARAI DE MINAS",2,2,3,124,1,132,"2011"
"8180","313010 IGARAPE",2,0,8,530,14,554,"2011"
"8181","313020 IGARATINGA",0,0,1,95,1,97,"2011"
"8182","313030 IGUATAMA",0,0,0,69,0,69,"2011"
"8183","313040 IJACI",0,1,0,79,1,81,"2011"
"8184","313050 ILICINEA",0,0,0,132,3,135,"2011"
"8185","313055 IMBE DE MINAS",0,0,0,94,0,94,"2011"
"8186","313060 INCONFIDENTES",0,0,1,88,0,89,"2011"
"8187","313065 INDAIABIRA",1,0,2,87,2,92,"2011"
"8188","313070 INDIANOPOLIS",0,0,0,82,0,82,"2011"
"8189","313080 INGAI",0,0,2,35,0,37,"2011"
"8190","313090 INHAPIM",3,1,7,278,0,289,"2011"
"8191","313100 INHAUMA",2,0,2,68,0,72,"2011"
"8192","313110 INIMUTABA",0,1,1,53,0,55,"2011"
"8193","313115 IPABA",0,0,2,272,1,275,"2011"
"8194","313120 IPANEMA",3,3,5,218,16,245,"2011"
"8195","313130 IPATINGA",2,14,35,3427,32,3510,"2011"
"8196","313140 IPIACU",0,0,0,43,0,43,"2011"
"8197","313150 IPUIUNA",0,2,3,117,0,122,"2011"
"8198","313160 IRAI DE MINAS",0,1,3,93,0,97,"2011"
"8199","313170 ITABIRA",3,8,13,1455,31,1510,"2011"
"8200","313180 ITABIRINHA",2,1,1,153,0,157,"2011"
"8201","313190 ITABIRITO",3,3,16,657,0,679,"2011"
"8202","313200 ITACAMBIRA",0,0,1,57,1,59,"2011"
"8203","313210 ITACARAMBI",0,0,9,309,0,318,"2011"
"8204","313220 ITAGUARA",1,0,0,146,0,147,"2011"
"8205","313230 ITAIPE",0,1,3,191,1,196,"2011"
"8206","313240 ITAJUBA",2,3,9,1221,0,1235,"2011"
"8207","313250 ITAMARANDIBA",3,1,9,460,2,475,"2011"
"8208","313260 ITAMARATI DE MINAS",0,0,4,58,0,62,"2011"
"8209","313270 ITAMBACURI",1,0,4,359,5,369,"2011"
"8210","313280 ITAMBE DO MATO DENTRO",0,0,0,23,0,23,"2011"
"8211","313290 ITAMOGI",0,0,4,122,0,126,"2011"
"8212","313300 ITAMONTE",0,1,0,167,0,168,"2011"
"8213","313310 ITANHANDU",0,0,1,175,2,178,"2011"
"8214","313320 ITANHOMI",2,0,0,204,1,207,"2011"
"8215","313330 ITAOBIM",1,1,4,336,0,342,"2011"
"8216","313340 ITAPAGIPE",0,1,0,121,0,122,"2011"
"8217","313350 ITAPECERICA",0,0,5,193,0,198,"2011"
"8218","313360 ITAPEVA",0,0,1,116,0,117,"2011"
"8219","313370 ITATIAIUCU",0,2,0,116,0,118,"2011"
"8220","313375 ITAU DE MINAS",1,0,5,167,0,173,"2011"
"8221","313380 ITAUNA",3,3,7,966,4,983,"2011"
"8222","313390 ITAVERAVA",0,1,0,62,0,63,"2011"
"8223","313400 ITINGA",0,1,3,174,3,181,"2011"
"8224","313410 ITUETA",0,1,3,67,9,80,"2011"
"8225","313420 ITUIUTABA",15,3,4,1153,10,1185,"2011"
"8226","313430 ITUMIRIM",1,0,1,65,0,67,"2011"
"8227","313440 ITURAMA",1,1,11,470,0,483,"2011"
"8228","313450 ITUTINGA",0,0,0,42,0,42,"2011"
"8229","313460 JABOTICATUBAS",1,0,2,177,2,182,"2011"
"8230","313470 JACINTO",2,0,8,146,1,157,"2011"
"8231","313480 JACUI",0,0,0,76,0,76,"2011"
"8232","313490 JACUTINGA",1,0,3,307,1,312,"2011"
"8233","313500 JAGUARACU",0,0,0,26,3,29,"2011"
"8234","313505 JAIBA",2,3,13,557,8,583,"2011"
"8235","313507 JAMPRUCA",0,1,2,69,4,76,"2011"
"8236","313510 JANAUBA",1,5,40,1058,3,1107,"2011"
"8237","313520 JANUARIA",1,3,9,1071,5,1089,"2011"
"8238","313530 JAPARAIBA",0,0,2,44,0,46,"2011"
"8239","313535 JAPONVAR",0,1,2,94,0,97,"2011"
"8240","313540 JECEABA",0,1,0,62,0,63,"2011"
"8241","313545 JENIPAPO DE MINAS",0,1,0,84,1,86,"2011"
"8242","313550 JEQUERI",0,0,3,118,2,123,"2011"
"8243","313560 JEQUITAI",0,0,1,83,3,87,"2011"
"8244","313570 JEQUITIBA",1,0,1,74,2,78,"2011"
"8245","313580 JEQUITINHONHA",0,0,3,36,218,257,"2011"
"8246","313590 JESUANIA",0,1,3,42,0,46,"2011"
"8247","313600 JOAIMA",0,0,0,13,211,224,"2011"
"8248","313610 JOANESIA",0,0,0,32,1,33,"2011"
"8249","313620 JOAO MONLEVADE",4,3,7,901,7,922,"2011"
"8250","313630 JOAO PINHEIRO",0,5,9,640,9,663,"2011"
"8251","313640 JOAQUIM FELICIO",0,2,2,43,0,47,"2011"
"8252","313650 JORDANIA",0,1,2,105,7,115,"2011"
"8253","313652 JOSE GONCALVES DE MINAS",1,0,1,62,2,66,"2011"
"8254","313655 JOSE RAYDAN",0,0,1,62,0,63,"2011"
"8255","313657 JOSENOPOLIS",0,0,0,62,6,68,"2011"
"8256","313660 NOVA UNIAO",0,1,0,57,1,59,"2011"
"8257","313665 JUATUBA",0,0,5,334,4,343,"2011"
"8258","313670 JUIZ DE FORA",28,23,90,6332,60,6533,"2011"
"8259","313680 JURAMENTO",0,0,4,43,1,48,"2011"
"8260","313690 JURUAIA",0,0,3,103,1,107,"2011"
"8261","313695 JUVENILIA",0,0,0,17,55,72,"2011"
"8262","313700 LADAINHA",0,2,3,244,11,260,"2011"
"8263","313710 LAGAMAR",0,0,0,68,0,68,"2011"
"8264","313720 LAGOA DA PRATA",1,2,4,535,3,545,"2011"
"8265","313730 LAGOA DOS PATOS",0,0,1,53,3,57,"2011"
"8266","313740 LAGOA DOURADA",0,0,2,141,5,148,"2011"
"8267","313750 LAGOA FORMOSA",0,1,5,168,1,175,"2011"
"8268","313753 LAGOA GRANDE",0,0,2,98,0,100,"2011"
"8269","313760 LAGOA SANTA",2,3,13,693,10,721,"2011"
"8270","313770 LAJINHA",2,1,1,133,137,274,"2011"
"8271","313780 LAMBARI",0,0,8,228,1,237,"2011"
"8272","313790 LAMIM",0,0,0,47,0,47,"2011"
"8273","313800 LARANJAL",0,0,1,62,0,63,"2011"
"8274","313810 LASSANCE",0,0,1,93,1,95,"2011"
"8275","313820 LAVRAS",1,5,10,1159,1,1176,"2011"
"8276","313830 LEANDRO FERREIRA",0,0,0,27,7,34,"2011"
"8277","313835 LEME DO PRADO",0,0,0,61,0,61,"2011"
"8278","313840 LEOPOLDINA",1,3,8,637,0,649,"2011"
"8279","313850 LIBERDADE",0,0,1,30,0,31,"2011"
"8280","313860 LIMA DUARTE",1,2,7,177,0,187,"2011"
"8281","313862 LIMEIRA DO OESTE",0,0,0,73,0,73,"2011"
"8282","313865 LONTRA",0,0,1,118,0,119,"2011"
"8283","313867 LUISBURGO",0,0,0,5,78,83,"2011"
"8284","313868 LUISLANDIA",0,1,2,97,1,101,"2011"
"8285","313870 LUMINARIAS",0,0,0,52,0,52,"2011"
"8286","313880 LUZ",1,1,4,204,0,210,"2011"
"8287","313890 MACHACALIS",0,0,2,91,1,94,"2011"
"8288","313900 MACHADO",1,6,6,493,0,506,"2011"
"8289","313910 MADRE DE DEUS DE MINAS",0,0,0,47,5,52,"2011"
"8290","313920 MALACACHETA",2,2,6,231,6,247,"2011"
"8291","313925 MAMONAS",0,1,1,17,45,64,"2011"
"8292","313930 MANGA",0,1,3,333,10,347,"2011"
"8293","313940 MANHUACU",1,2,0,34,1307,1344,"2011"
"8294","313950 MANHUMIRIM",2,0,1,182,99,284,"2011"
"8295","313960 MANTENA",2,2,16,308,1,329,"2011"
"8296","313970 MARAVILHAS",0,0,2,85,1,88,"2011"
"8297","313980 MAR DE ESPANHA",0,1,11,120,3,135,"2011"
"8298","313990 MARIA DA FE",1,1,0,165,0,167,"2011"
"8299","314000 MARIANA",2,5,16,802,20,845,"2011"
"8300","314010 MARILAC",0,0,1,52,5,58,"2011"
"8301","314015 MARIO CAMPOS",0,4,3,189,3,199,"2011"
"8302","314020 MARIPA DE MINAS",0,0,0,35,0,35,"2011"
"8303","314030 MARLIERIA",0,0,0,48,1,49,"2011"
"8304","314040 MARMELOPOLIS",0,0,0,35,1,36,"2011"
"8305","314050 MARTINHO CAMPOS",0,0,1,128,16,145,"2011"
"8306","314053 MARTINS SOARES",0,0,0,24,79,103,"2011"
"8307","314055 MATA VERDE",3,3,1,82,0,89,"2011"
"8308","314060 MATERLANDIA",0,0,2,55,2,59,"2011"
"8309","314070 MATEUS LEME",2,3,5,407,3,420,"2011"
"8310","314080 MATIAS BARBOSA",0,0,2,156,1,159,"2011"
"8311","314085 MATIAS CARDOSO",0,0,2,118,7,127,"2011"
"8312","314090 MATIPO",0,1,1,122,128,252,"2011"
"8313","314100 MATO VERDE",0,2,1,145,3,151,"2011"
"8314","314110 MATOZINHOS",0,4,6,398,122,530,"2011"
"8315","314120 MATUTINA",0,1,0,34,0,35,"2011"
"8316","314130 MEDEIROS",0,0,0,32,0,32,"2011"
"8317","314140 MEDINA",0,3,9,252,0,264,"2011"
"8318","314150 MENDES PIMENTEL",0,0,1,58,1,60,"2011"
"8319","314160 MERCES",0,0,0,106,1,107,"2011"
"8320","314170 MESQUITA",0,1,2,54,2,59,"2011"
"8321","314180 MINAS NOVAS",0,6,2,347,6,361,"2011"
"8322","314190 MINDURI",0,0,2,48,1,51,"2011"
"8323","314200 MIRABELA",0,1,1,168,0,170,"2011"
"8324","314210 MIRADOURO",0,1,4,105,0,110,"2011"
"8325","314220 MIRAI",0,1,1,116,4,122,"2011"
"8326","314225 MIRAVANIA",0,0,1,48,9,58,"2011"
"8327","314230 MOEDA",0,0,1,47,0,48,"2011"
"8328","314240 MOEMA",0,0,1,64,0,65,"2011"
"8329","314250 MONJOLOS",0,0,0,19,0,19,"2011"
"8330","314260 MONSENHOR PAULO",0,1,3,86,0,90,"2011"
"8331","314270 MONTALVANIA",0,1,1,25,182,209,"2011"
"8332","314280 MONTE ALEGRE DE MINAS",0,0,3,160,86,249,"2011"
"8333","314290 MONTE AZUL",0,0,2,66,215,283,"2011"
"8334","314300 MONTE BELO",0,1,3,132,1,137,"2011"
"8335","314310 MONTE CARMELO",0,1,6,547,0,554,"2011"
"8336","314315 MONTE FORMOSO",0,0,2,38,18,58,"2011"
"8337","314320 MONTE SANTO DE MINAS",0,0,4,184,7,195,"2011"
"8338","314330 MONTES CLAROS",13,18,126,5462,18,5637,"2011"
"8339","314340 MONTE SIAO",3,2,2,210,1,218,"2011"
"8340","314345 MONTEZUMA",0,1,2,90,1,94,"2011"
"8341","314350 MORADA NOVA DE MINAS",1,0,0,85,0,86,"2011"
"8342","314360 MORRO DA GARCA",1,0,1,25,0,27,"2011"
"8343","314370 MORRO DO PILAR",0,0,0,44,0,44,"2011"
"8344","314380 MUNHOZ",0,1,0,46,0,47,"2011"
"8345","314390 MURIAE",2,12,33,1264,5,1316,"2011"
"8346","314400 MUTUM",0,0,0,367,24,391,"2011"
"8347","314410 MUZAMBINHO",0,0,2,233,0,235,"2011"
"8348","314420 NACIP RAYDAN",0,0,0,35,3,38,"2011"
"8349","314430 NANUQUE",0,2,22,592,2,618,"2011"
"8350","314435 NAQUE",0,1,1,99,2,103,"2011"
"8351","314437 NATALANDIA",0,1,0,44,1,46,"2011"
"8352","314440 NATERCIA",0,0,1,32,1,34,"2011"
"8353","314450 NAZARENO",0,0,1,92,0,93,"2011"
"8354","314460 NEPOMUCENO",2,2,5,255,0,264,"2011"
"8355","314465 NINHEIRA",0,1,1,104,4,110,"2011"
"8356","314467 NOVA BELEM",0,0,0,55,0,55,"2011"
"8357","314470 NOVA ERA",2,1,4,198,2,207,"2011"
"8358","314480 NOVA LIMA",3,2,13,1109,3,1130,"2011"
"8359","314490 NOVA MODICA",0,0,0,40,1,41,"2011"
"8360","314500 NOVA PONTE",1,0,3,162,0,166,"2011"
"8361","314505 NOVA PORTEIRINHA",1,0,5,99,0,105,"2011"
"8362","314510 NOVA RESENDE",0,4,8,180,0,192,"2011"
"8363","314520 NOVA SERRANA",6,7,8,1259,29,1309,"2011"
"8364","314530 NOVO CRUZEIRO",0,2,11,472,24,509,"2011"
"8365","314535 NOVO ORIENTE DE MINAS",0,1,1,131,11,144,"2011"
"8366","314537 NOVORIZONTE",0,1,0,27,40,68,"2011"
"8367","314540 OLARIA",0,0,1,20,0,21,"2011"
"8368","314545 OLHOS-D'AGUA",0,0,2,86,2,90,"2011"
"8369","314550 OLIMPIO NORONHA",0,0,0,33,1,34,"2011"
"8370","314560 OLIVEIRA",1,1,4,394,1,401,"2011"
"8371","314570 OLIVEIRA FORTES",0,0,0,20,0,20,"2011"
"8372","314580 ONCA DE PITANGUI",0,0,0,16,2,18,"2011"
"8373","314585 ORATORIOS",0,0,0,63,0,63,"2011"
"8374","314587 ORIZANIA",0,0,0,105,3,108,"2011"
"8375","314590 OURO BRANCO",3,1,3,519,1,527,"2011"
"8376","314600 OURO FINO",1,1,6,323,0,331,"2011"
"8377","314610 OURO PRETO",2,2,20,830,13,867,"2011"
"8378","314620 OURO VERDE DE MINAS",0,1,0,85,2,88,"2011"
"8379","314625 PADRE CARVALHO",0,0,1,5,88,94,"2011"
"8380","314630 PADRE PARAISO",2,1,2,280,2,287,"2011"
"8381","314640 PAINEIRAS",0,1,2,41,0,44,"2011"
"8382","314650 PAINS",0,0,1,74,0,75,"2011"
"8383","314655 PAI PEDRO",0,0,1,74,5,80,"2011"
"8384","314660 PAIVA",0,0,0,12,0,12,"2011"
"8385","314670 PALMA",0,0,1,38,2,41,"2011"
"8386","314675 PALMOPOLIS",1,0,3,77,0,81,"2011"
"8387","314690 PAPAGAIOS",0,1,3,187,7,198,"2011"
"8388","314700 PARACATU",4,4,25,954,43,1030,"2011"
"8389","314710 PARA DE MINAS",2,4,13,1063,27,1109,"2011"
"8390","314720 PARAGUACU",0,3,4,239,3,249,"2011"
"8391","314730 PARAISOPOLIS",0,0,3,228,2,233,"2011"
"8392","314740 PARAOPEBA",0,3,5,267,1,276,"2011"
"8393","314750 PASSABEM",0,0,0,9,2,11,"2011"
"8394","314760 PASSA QUATRO",0,2,2,177,3,184,"2011"
"8395","314770 PASSA TEMPO",0,0,1,69,0,70,"2011"
"8396","314780 PASSA-VINTE",0,0,0,14,0,14,"2011"
"8397","314790 PASSOS",5,4,29,1425,1,1464,"2011"
"8398","314795 PATIS",0,1,1,81,0,83,"2011"
"8399","314800 PATOS DE MINAS",7,10,24,1632,5,1678,"2011"
"8400","314810 PATROCINIO",2,2,16,1127,3,1150,"2011"
"8401","314820 PATROCINIO DO MURIAE",1,0,1,52,0,54,"2011"
"8402","314830 PAULA CANDIDO",0,1,3,88,1,93,"2011"
"8403","314840 PAULISTAS",0,0,1,51,0,52,"2011"
"8404","314850 PAVAO",1,1,0,92,1,95,"2011"
"8405","314860 PECANHA",1,2,4,230,2,239,"2011"
"8406","314870 PEDRA AZUL",3,3,19,392,9,426,"2011"
"8407","314875 PEDRA BONITA",0,0,0,71,16,87,"2011"
"8408","314880 PEDRA DO ANTA",0,0,0,38,1,39,"2011"
"8409","314890 PEDRA DO INDAIA",0,2,0,40,1,43,"2011"
"8410","314900 PEDRA DOURADA",0,1,0,23,0,24,"2011"
"8411","314910 PEDRALVA",0,0,2,123,0,125,"2011"
"8412","314915 PEDRAS DE MARIA DA CRUZ",1,1,0,116,0,118,"2011"
"8413","314920 PEDRINOPOLIS",0,0,0,27,1,28,"2011"
"8414","314930 PEDRO LEOPOLDO",0,1,9,765,8,783,"2011"
"8415","314940 PEDRO TEIXEIRA",0,1,1,15,0,17,"2011"
"8416","314950 PEQUERI",0,0,1,43,0,44,"2011"
"8417","314960 PEQUI",0,0,1,49,3,53,"2011"
"8418","314970 PERDIGAO",0,1,3,129,6,139,"2011"
"8419","314980 PERDIZES",0,0,1,178,2,181,"2011"
"8420","314990 PERDOES",0,1,5,199,0,205,"2011"
"8421","314995 PERIQUITO",0,0,0,107,2,109,"2011"
"8422","315000 PESCADOR",0,0,0,59,4,63,"2011"
"8423","315010 PIAU",0,1,0,27,1,29,"2011"
"8424","315015 PIEDADE DE CARATINGA",0,0,1,121,1,123,"2011"
"8425","315020 PIEDADE DE PONTE NOVA",0,0,1,58,0,59,"2011"
"8426","315030 PIEDADE DO RIO GRANDE",0,0,2,37,0,39,"2011"
"8427","315040 PIEDADE DOS GERAIS",1,1,2,45,0,49,"2011"
"8428","315050 PIMENTA",0,0,1,91,0,92,"2011"
"8429","315053 PINGO-D'AGUA",0,1,2,53,0,56,"2011"
"8430","315057 PINTOPOLIS",0,1,2,95,5,103,"2011"
"8431","315060 PIRACEMA",0,0,0,57,0,57,"2011"
"8432","315070 PIRAJUBA",0,1,1,56,1,59,"2011"
"8433","315080 PIRANGA",0,2,4,160,1,167,"2011"
"8434","315090 PIRANGUCU",0,0,1,73,0,74,"2011"
"8435","315100 PIRANGUINHO",0,1,2,102,0,105,"2011"
"8436","315110 PIRAPETINGA",1,1,0,142,0,144,"2011"
"8437","315120 PIRAPORA",3,6,17,864,38,928,"2011"
"8438","315130 PIRAUBA",0,0,1,119,0,120,"2011"
"8439","315140 PITANGUI",0,1,2,183,155,341,"2011"
"8440","315150 PIUMHI",3,1,8,361,0,373,"2011"
"8441","315160 PLANURA",1,0,3,143,2,149,"2011"
"8442","315170 POCO FUNDO",0,1,0,164,0,165,"2011"
"8443","315180 POCOS DE CALDAS",2,7,69,1893,6,1977,"2011"
"8444","315190 POCRANE",0,2,0,95,12,109,"2011"
"8445","315200 POMPEU",0,2,3,399,0,404,"2011"
"8446","315210 PONTE NOVA",1,0,4,618,4,627,"2011"
"8447","315213 PONTO CHIQUE",0,0,2,48,3,53,"2011"
"8448","315217 PONTO DOS VOLANTES",0,3,3,166,5,177,"2011"
"8449","315220 PORTEIRINHA",1,1,9,461,1,473,"2011"
"8450","315230 PORTO FIRME",0,1,2,83,2,88,"2011"
"8451","315240 POTE",0,0,4,196,1,201,"2011"
"8452","315250 POUSO ALEGRE",5,3,23,1690,3,1724,"2011"
"8453","315260 POUSO ALTO",0,0,0,68,0,68,"2011"
"8454","315270 PRADOS",0,1,3,98,8,110,"2011"
"8455","315280 PRATA",0,1,2,357,2,362,"2011"
"8456","315290 PRATAPOLIS",0,0,0,77,0,77,"2011"
"8457","315300 PRATINHA",0,0,0,21,1,22,"2011"
"8458","315310 PRESIDENTE BERNARDES",0,0,1,52,1,54,"2011"
"8459","315320 PRESIDENTE JUSCELINO",1,0,2,29,0,32,"2011"
"8460","315330 PRESIDENTE KUBITSCHEK",0,0,2,49,0,51,"2011"
"8461","315340 PRESIDENTE OLEGARIO",2,0,4,202,4,212,"2011"
"8462","315350 ALTO JEQUITIBA",0,0,1,91,33,125,"2011"
"8463","315360 PRUDENTE DE MORAIS",0,0,1,135,11,147,"2011"
"8464","315370 QUARTEL GERAL",0,0,1,23,0,24,"2011"
"8465","315380 QUELUZITO",0,0,0,19,0,19,"2011"
"8466","315390 RAPOSOS",0,2,2,175,1,180,"2011"
"8467","315400 RAUL SOARES",0,1,3,232,5,241,"2011"
"8468","315410 RECREIO",0,0,0,88,0,88,"2011"
"8469","315415 REDUTO",0,0,0,4,85,89,"2011"
"8470","315420 RESENDE COSTA",0,0,3,126,0,129,"2011"
"8471","315430 RESPLENDOR",4,2,3,208,2,219,"2011"
"8472","315440 RESSAQUINHA",1,0,3,57,0,61,"2011"
"8473","315445 RIACHINHO",0,0,2,76,3,81,"2011"
"8474","315450 RIACHO DOS MACHADOS",0,0,2,144,3,149,"2011"
"8475","315460 RIBEIRAO DAS NEVES",7,15,76,4391,80,4569,"2011"
"8476","315470 RIBEIRAO VERMELHO",0,0,1,35,0,36,"2011"
"8477","315480 RIO ACIMA",0,0,3,93,0,96,"2011"
"8478","315490 RIO CASCA",0,2,2,180,1,185,"2011"
"8479","315500 RIO DOCE",0,0,0,27,0,27,"2011"
"8480","315510 RIO DO PRADO",0,0,0,69,3,72,"2011"
"8481","315520 RIO ESPERA",1,0,1,52,0,54,"2011"
"8482","315530 RIO MANSO",0,0,0,35,0,35,"2011"
"8483","315540 RIO NOVO",1,0,3,90,2,96,"2011"
"8484","315550 RIO PARANAIBA",0,1,4,129,2,136,"2011"
"8485","315560 RIO PARDO DE MINAS",1,9,17,384,4,415,"2011"
"8486","315570 RIO PIRACICABA",1,1,4,145,0,151,"2011"
"8487","315580 RIO POMBA",1,0,4,177,0,182,"2011"
"8488","315590 RIO PRETO",0,0,2,56,0,58,"2011"
"8489","315600 RIO VERMELHO",0,1,5,189,2,197,"2011"
"8490","315610 RITAPOLIS",0,0,0,46,1,47,"2011"
"8491","315620 ROCHEDO DE MINAS",0,0,0,35,0,35,"2011"
"8492","315630 RODEIRO",0,0,0,98,0,98,"2011"
"8493","315640 ROMARIA",0,1,1,33,0,35,"2011"
"8494","315645 ROSARIO DA LIMEIRA",0,0,1,41,0,42,"2011"
"8495","315650 RUBELITA",0,0,0,13,75,88,"2011"
"8496","315660 RUBIM",1,0,3,108,3,115,"2011"
"8497","315670 SABARA",4,6,17,1677,11,1715,"2011"
"8498","315680 SABINOPOLIS",0,1,7,222,1,231,"2011"
"8499","315690 SACRAMENTO",0,0,4,287,2,293,"2011"
"8500","315700 SALINAS",0,1,2,76,464,543,"2011"
"8501","315710 SALTO DA DIVISA",1,0,6,91,7,105,"2011"
"8502","315720 SANTA BARBARA",1,0,21,345,25,392,"2011"
"8503","315725 SANTA BARBARA DO LESTE",0,1,6,81,1,89,"2011"
"8504","315727 SANTA BARBARA DO MONTE VERDE",0,0,0,32,0,32,"2011"
"8505","315730 SANTA BARBARA DO TUGURIO",0,1,1,45,1,48,"2011"
"8506","315733 SANTA CRUZ DE MINAS",0,0,1,70,8,79,"2011"
"8507","315737 SANTA CRUZ DE SALINAS",0,0,0,19,30,49,"2011"
"8508","315740 SANTA CRUZ DO ESCALVADO",0,0,0,44,2,46,"2011"
"8509","315750 SANTA EFIGENIA DE MINAS",0,0,0,75,2,77,"2011"
"8510","315760 SANTA FE DE MINAS",0,1,0,52,5,58,"2011"
"8511","315765 SANTA HELENA DE MINAS",0,0,3,95,16,114,"2011"
"8512","315770 SANTA JULIANA",0,0,1,161,1,163,"2011"
"8513","315780 SANTA LUZIA",11,11,49,3152,9,3232,"2011"
"8514","315790 SANTA MARGARIDA",0,0,4,189,36,229,"2011"
"8515","315800 SANTA MARIA DE ITABIRA",1,0,0,123,3,127,"2011"
"8516","315810 SANTA MARIA DO SALTO",1,2,2,48,6,59,"2011"
"8517","315820 SANTA MARIA DO SUACUI",0,1,5,196,1,203,"2011"
"8518","315830 SANTANA DA VARGEM",0,0,0,20,57,77,"2011"
"8519","315840 SANTANA DE CATAGUASES",0,1,3,42,0,46,"2011"
"8520","315850 SANTANA DE PIRAPAMA",0,1,2,63,2,68,"2011"
"8521","315860 SANTANA DO DESERTO",0,0,0,42,1,43,"2011"
"8522","315870 SANTANA DO GARAMBEU",1,0,0,30,0,31,"2011"
"8523","315880 SANTANA DO JACARE",0,0,0,30,0,30,"2011"
"8524","315890 SANTANA DO MANHUACU",0,0,0,5,97,102,"2011"
"8525","315895 SANTANA DO PARAISO",0,1,6,439,4,450,"2011"
"8526","315900 SANTANA DO RIACHO",0,0,0,27,1,28,"2011"
"8527","315910 SANTANA DOS MONTES",0,0,2,46,2,50,"2011"
"8528","315920 SANTA RITA DE CALDAS",0,0,3,72,0,75,"2011"
"8529","315930 SANTA RITA DE JACUTINGA",0,0,1,48,1,50,"2011"
"8530","315935 SANTA RITA DE MINAS",0,0,3,104,1,108,"2011"
"8531","315940 SANTA RITA DE IBITIPOCA",0,0,2,34,0,36,"2011"
"8532","315950 SANTA RITA DO ITUETO",1,1,2,83,1,88,"2011"
"8533","315960 SANTA RITA DO SAPUCAI",1,1,6,486,2,496,"2011"
"8534","315970 SANTA ROSA DA SERRA",0,0,0,21,1,22,"2011"
"8535","315980 SANTA VITORIA",0,0,1,194,2,197,"2011"
"8536","315990 SANTO ANTONIO DO AMPARO",1,3,8,213,1,226,"2011"
"8537","316000 SANTO ANTONIO DO AVENTUREIRO",0,0,0,27,1,28,"2011"
"8538","316010 SANTO ANTONIO DO GRAMA",0,0,0,50,0,50,"2011"
"8539","316020 SANTO ANTONIO DO ITAMBE",1,0,1,45,0,47,"2011"
"8540","316030 SANTO ANTONIO DO JACINTO",2,1,6,131,3,143,"2011"
"8541","316040 SANTO ANTONIO DO MONTE",1,2,13,328,0,344,"2011"
"8542","316045 SANTO ANTONIO DO RETIRO",0,2,0,25,67,94,"2011"
"8543","316050 SANTO ANTONIO DO RIO ABAIXO",0,0,0,24,1,25,"2011"
"8544","316060 SANTO HIPOLITO",1,1,0,39,0,41,"2011"
"8545","316070 SANTOS DUMONT",1,2,7,512,2,524,"2011"
"8546","316080 SAO BENTO ABADE",1,0,1,50,14,66,"2011"
"8547","316090 SAO BRAS DO SUACUI",0,0,0,40,0,40,"2011"
"8548","316095 SAO DOMINGOS DAS DORES",1,2,3,72,0,78,"2011"
"8549","316100 SAO DOMINGOS DO PRATA",1,1,1,187,3,193,"2011"
"8550","316105 SAO FELIX DE MINAS",0,0,1,46,0,47,"2011"
"8551","316110 SAO FRANCISCO",1,8,18,752,5,784,"2011"
"8552","316120 SAO FRANCISCO DE PAULA",0,0,1,49,0,50,"2011"
"8553","316130 SAO FRANCISCO DE SALES",0,0,1,54,1,56,"2011"
"8554","316140 SAO FRANCISCO DO GLORIA",0,0,0,67,1,68,"2011"
"8555","316150 SAO GERALDO",0,1,0,89,0,90,"2011"
"8556","316160 SAO GERALDO DA PIEDADE",0,1,1,56,2,60,"2011"
"8557","316165 SAO GERALDO DO BAIXIO",0,1,1,44,1,47,"2011"
"8558","316170 SAO GONCALO DO ABAETE",0,0,0,63,0,63,"2011"
"8559","316180 SAO GONCALO DO PARA",1,2,4,127,1,135,"2011"
"8560","316190 SAO GONCALO DO RIO ABAIXO",1,0,1,152,6,160,"2011"
"8561","316200 SAO GONCALO DO SAPUCAI",0,3,12,345,0,360,"2011"
"8562","316210 SAO GOTARDO",0,0,2,515,5,522,"2011"
"8563","316220 SAO JOAO BATISTA DO GLORIA",0,0,3,81,0,84,"2011"
"8564","316225 SAO JOAO DA LAGOA",0,0,0,58,2,60,"2011"
"8565","316230 SAO JOAO DA MATA",0,0,0,22,0,22,"2011"
"8566","316240 SAO JOAO DA PONTE",0,4,8,339,0,351,"2011"
"8567","316245 SAO JOAO DAS MISSOES",0,1,1,218,44,264,"2011"
"8568","316250 SAO JOAO DEL REI",3,4,14,973,17,1011,"2011"
"8569","316255 SAO JOAO DO MANHUACU",0,0,0,30,124,154,"2011"
"8570","316257 SAO JOAO DO MANTENINHA",0,0,1,57,0,58,"2011"
"8571","316260 SAO JOAO DO ORIENTE",0,0,1,78,2,81,"2011"
"8572","316265 SAO JOAO DO PACUI",0,1,1,53,5,60,"2011"
"8573","316270 SAO JOAO DO PARAISO",0,3,3,261,0,267,"2011"
"8574","316280 SAO JOAO EVANGELISTA",1,1,2,193,2,199,"2011"
"8575","316290 SAO JOAO NEPOMUCENO",1,1,2,300,0,304,"2011"
"8576","316292 SAO JOAQUIM DE BICAS",1,0,5,360,7,373,"2011"
"8577","316294 SAO JOSE DA BARRA",0,0,0,87,0,87,"2011"
"8578","316295 SAO JOSE DA LAPA",1,0,3,281,5,290,"2011"
"8579","316300 SAO JOSE DA SAFIRA",0,1,3,64,5,73,"2011"
"8580","316310 SAO JOSE DA VARGINHA",0,0,2,38,5,45,"2011"
"8581","316320 SAO JOSE DO ALEGRE",0,1,1,51,0,53,"2011"
"8582","316330 SAO JOSE DO DIVINO",0,2,1,62,1,66,"2011"
"8583","316340 SAO JOSE DO GOIABAL",0,0,0,64,2,66,"2011"
"8584","316350 SAO JOSE DO JACURI",0,1,2,65,0,68,"2011"
"8585","316360 SAO JOSE DO MANTIMENTO",0,0,0,19,16,35,"2011"
"8586","316370 SAO LOURENCO",1,0,9,506,1,517,"2011"
"8587","316380 SAO MIGUEL DO ANTA",0,0,0,79,5,84,"2011"
"8588","316390 SAO PEDRO DA UNIAO",0,0,0,40,0,40,"2011"
"8589","316400 SAO PEDRO DOS FERROS",0,0,1,63,1,65,"2011"
"8590","316410 SAO PEDRO DO SUACUI",0,1,1,53,0,55,"2011"
"8591","316420 SAO ROMAO",0,0,3,122,2,127,"2011"
"8592","316430 SAO ROQUE DE MINAS",1,0,1,72,0,74,"2011"
"8593","316440 SAO SEBASTIAO DA BELA VISTA",0,0,0,66,0,66,"2011"
"8594","316443 SAO SEBASTIAO DA VARGEM ALEGRE",0,0,0,42,2,44,"2011"
"8595","316447 SAO SEBASTIAO DO ANTA",0,0,7,81,0,88,"2011"
"8596","316450 SAO SEBASTIAO DO MARANHAO",0,0,1,95,1,97,"2011"
"8597","316460 SAO SEBASTIAO DO OESTE",1,0,2,84,0,87,"2011"
"8598","316470 SAO SEBASTIAO DO PARAISO",0,6,15,900,3,924,"2011"
"8599","316480 SAO SEBASTIAO DO RIO PRETO",0,0,0,13,2,15,"2011"
"8600","316490 SAO SEBASTIAO DO RIO VERDE",0,1,0,22,0,23,"2011"
"8601","316500 SAO TIAGO",0,0,1,131,0,132,"2011"
"8602","316510 SAO TOMAS DE AQUINO",0,0,0,92,0,92,"2011"
"8603","316520 SAO THOME DAS LETRAS",0,0,2,45,6,53,"2011"
"8604","316530 SAO VICENTE DE MINAS",0,1,0,79,0,80,"2011"
"8605","316540 SAPUCAI-MIRIM",1,0,1,90,1,93,"2011"
"8606","316550 SARDOA",0,1,3,86,4,94,"2011"
"8607","316553 SARZEDO",1,3,9,379,6,398,"2011"
"8608","316555 SETUBINHA",0,1,5,157,26,189,"2011"
"8609","316556 SEM-PEIXE",1,0,0,17,0,18,"2011"
"8610","316557 SENADOR AMARAL",0,0,0,94,0,94,"2011"
"8611","316560 SENADOR CORTES",0,0,1,31,0,32,"2011"
"8612","316570 SENADOR FIRMINO",1,0,3,87,0,91,"2011"
"8613","316580 SENADOR JOSE BENTO",0,0,0,13,0,13,"2011"
"8614","316590 SENADOR MODESTINO GONCALVES",0,1,0,52,2,55,"2011"
"8615","316600 SENHORA DE OLIVEIRA",0,1,1,56,2,60,"2011"
"8616","316610 SENHORA DO PORTO",1,0,0,49,0,50,"2011"
"8617","316620 SENHORA DOS REMEDIOS",1,0,7,78,3,89,"2011"
"8618","316630 SERICITA",0,0,2,111,8,121,"2011"
"8619","316640 SERITINGA",0,0,0,16,0,16,"2011"
"8620","316650 SERRA AZUL DE MINAS",0,2,2,48,2,54,"2011"
"8621","316660 SERRA DA SAUDADE",0,0,0,3,0,3,"2011"
"8622","316670 SERRA DOS AIMORES",0,1,2,104,0,107,"2011"
"8623","316680 SERRA DO SALITRE",0,0,3,125,1,129,"2011"
"8624","316690 SERRANIA",0,0,1,99,2,102,"2011"
"8625","316695 SERRANOPOLIS DE MINAS",0,0,2,52,0,54,"2011"
"8626","316700 SERRANOS",1,0,0,27,0,28,"2011"
"8627","316710 SERRO",2,2,4,257,3,268,"2011"
"8628","316720 SETE LAGOAS",16,6,31,2677,20,2750,"2011"
"8629","316730 SILVEIRANIA",0,0,0,25,0,25,"2011"
"8630","316740 SILVIANOPOLIS",0,0,0,62,0,62,"2011"
"8631","316750 SIMAO PEREIRA",0,0,1,31,0,32,"2011"
"8632","316760 SIMONESIA",0,0,0,24,240,264,"2011"
"8633","316770 SOBRALIA",0,0,3,61,1,65,"2011"
"8634","316780 SOLEDADE DE MINAS",0,0,3,76,1,80,"2011"
"8635","316790 TABULEIRO",1,0,0,41,1,43,"2011"
"8636","316800 TAIOBEIRAS",0,1,6,436,6,449,"2011"
"8637","316805 TAPARUBA",0,0,0,36,0,36,"2011"
"8638","316810 TAPIRA",0,0,0,50,0,50,"2011"
"8639","316820 TAPIRAI",0,0,0,12,0,12,"2011"
"8640","316830 TAQUARACU DE MINAS",0,0,2,37,2,41,"2011"
"8641","316840 TARUMIRIM",0,0,8,154,3,165,"2011"
"8642","316850 TEIXEIRAS",0,0,0,123,10,133,"2011"
"8643","316860 TEOFILO OTONI",6,12,27,1968,12,2025,"2011"
"8644","316870 TIMOTEO",2,2,10,1024,33,1071,"2011"
"8645","316880 TIRADENTES",0,0,2,73,2,77,"2011"
"8646","316890 TIROS",0,0,2,57,2,61,"2011"
"8647","316900 TOCANTINS",0,0,0,189,0,189,"2011"
"8648","316905 TOCOS DO MOJI",0,0,0,28,0,28,"2011"
"8649","316910 TOLEDO",0,0,2,50,1,53,"2011"
"8650","316920 TOMBOS",0,0,1,105,4,110,"2011"
"8651","316930 TRES CORACOES",2,5,12,816,161,996,"2011"
"8652","316935 TRES MARIAS",0,0,2,408,1,411,"2011"
"8653","316940 TRES PONTAS",1,1,4,178,534,718,"2011"
"8654","316950 TUMIRITINGA",0,0,2,100,2,104,"2011"
"8655","316960 TUPACIGUARA",2,0,5,203,0,210,"2011"
"8656","316970 TURMALINA",1,1,2,250,2,256,"2011"
"8657","316980 TURVOLANDIA",0,1,0,53,0,54,"2011"
"8658","316990 UBA",6,7,29,1377,2,1421,"2011"
"8659","317000 UBAI",0,1,5,142,1,149,"2011"
"8660","317005 UBAPORANGA",0,0,7,147,1,155,"2011"
"8661","317010 UBERABA",41,12,42,3857,22,3974,"2011"
"8662","317020 UBERLANDIA",27,22,76,8429,39,8593,"2011"
"8663","317030 UMBURATIBA",0,0,0,38,0,38,"2011"
"8664","317040 UNAI",4,1,11,1034,24,1074,"2011"
"8665","317043 UNIAO DE MINAS",0,1,2,50,0,53,"2011"
"8666","317047 URUANA DE MINAS",0,0,1,34,2,37,"2011"
"8667","317050 URUCANIA",1,0,0,117,1,119,"2011"
"8668","317052 URUCUIA",0,1,3,143,1,148,"2011"
"8669","317057 VARGEM ALEGRE",0,2,2,78,0,82,"2011"
"8670","317060 VARGEM BONITA",0,0,0,22,0,22,"2011"
"8671","317065 VARGEM GRANDE DO RIO PARDO",0,0,0,62,2,64,"2011"
"8672","317070 VARGINHA",3,1,19,1637,5,1665,"2011"
"8673","317075 VARJAO DE MINAS",0,1,5,98,2,106,"2011"
"8674","317080 VARZEA DA PALMA",0,1,6,474,6,487,"2011"
"8675","317090 VARZELANDIA",1,1,6,270,1,279,"2011"
"8676","317100 VAZANTE",1,2,1,226,1,231,"2011"
"8677","317103 VERDELANDIA",0,2,6,165,3,176,"2011"
"8678","317107 VEREDINHA",1,0,0,49,0,50,"2011"
"8679","317110 VERISSIMO",0,0,0,29,0,29,"2011"
"8680","317115 VERMELHO NOVO",0,1,1,52,5,59,"2011"
"8681","317120 VESPASIANO",1,9,22,1569,5,1606,"2011"
"8682","317130 VICOSA",0,3,16,829,40,888,"2011"
"8683","317140 VIEIRAS",0,0,0,42,0,42,"2011"
"8684","317150 MATHIAS LOBATO",0,0,0,61,3,64,"2011"
"8685","317160 VIRGEM DA LAPA",2,2,2,138,10,154,"2011"
"8686","317170 VIRGINIA",0,0,0,91,2,93,"2011"
"8687","317180 VIRGINOPOLIS",0,0,2,133,0,135,"2011"
"8688","317190 VIRGOLANDIA",0,0,1,60,0,61,"2011"
"8689","317200 VISCONDE DO RIO BRANCO",0,1,5,488,4,498,"2011"
"8690","317210 VOLTA GRANDE",0,0,2,53,0,55,"2011"
"8691","317220 WENCESLAU BRAZ",0,0,0,22,0,22,"2011"
"8692","MUNICIPIO IGNORADO - ES",0,0,0,10,0,10,"2011"
"8693","320010 AFONSO CLAUDIO",0,2,5,411,0,418,"2011"
"8694","320013 AGUIA BRANCA",0,0,2,82,1,85,"2011"
"8695","320016 AGUA DOCE DO NORTE",2,2,4,154,10,172,"2011"
"8696","320020 ALEGRE",1,0,9,383,2,395,"2011"
"8697","320030 ALFREDO CHAVES",5,0,1,148,0,154,"2011"
"8698","320035 ALTO RIO NOVO",0,0,1,104,5,110,"2011"
"8699","320040 ANCHIETA",2,2,8,365,4,381,"2011"
"8700","320050 APIACA",0,0,1,63,1,65,"2011"
"8701","320060 ARACRUZ",0,2,15,1338,39,1394,"2011"
"8702","320070 ATILIO VIVACQUA",0,0,2,121,1,124,"2011"
"8703","320080 BAIXO GUANDU",0,1,1,255,131,388,"2011"
"8704","320090 BARRA DE SAO FRANCISCO",2,4,8,579,24,617,"2011"
"8705","320100 BOA ESPERANCA",1,1,1,139,26,168,"2011"
"8706","320110 BOM JESUS DO NORTE",1,0,4,91,1,97,"2011"
"8707","320115 BREJETUBA",0,2,1,169,0,172,"2011"
"8708","320120 CACHOEIRO DE ITAPEMIRIM",4,15,60,2682,6,2767,"2011"
"8709","320130 CARIACICA",118,21,118,5707,52,6016,"2011"
"8710","320140 CASTELO",1,2,4,393,21,421,"2011"
"8711","320150 COLATINA",5,7,20,1465,27,1524,"2011"
"8712","320160 CONCEICAO DA BARRA",2,1,2,422,22,449,"2011"
"8713","320170 CONCEICAO DO CASTELO",1,1,6,138,0,146,"2011"
"8714","320180 DIVINO DE SAO LOURENCO",1,0,1,54,2,58,"2011"
"8715","320190 DOMINGOS MARTINS",0,1,3,404,3,411,"2011"
"8716","320200 DORES DO RIO PRETO",0,1,2,85,3,91,"2011"
"8717","320210 ECOPORANGA",0,1,3,298,0,302,"2011"
"8718","320220 FUNDAO",1,0,2,251,0,254,"2011"
"8719","320225 GOVERNADOR LINDENBERG",0,1,0,125,2,128,"2011"
"8720","320230 GUACUI",3,2,11,400,3,419,"2011"
"8721","320240 GUARAPARI",21,1,16,1594,13,1645,"2011"
"8722","320245 IBATIBA",0,4,6,310,12,332,"2011"
"8723","320250 IBIRACU",1,2,3,142,0,148,"2011"
"8724","320255 IBITIRAMA",0,0,6,151,2,159,"2011"
"8725","320260 ICONHA",0,0,1,126,0,127,"2011"
"8726","320265 IRUPI",0,0,3,157,15,175,"2011"
"8727","320270 ITAGUACU",0,0,3,112,21,136,"2011"
"8728","320280 ITAPEMIRIM",0,2,8,461,17,488,"2011"
"8729","320290 ITARANA",0,0,2,83,9,94,"2011"
"8730","320300 IUNA",1,0,4,337,14,356,"2011"
"8731","320305 JAGUARE",1,7,3,376,19,406,"2011"
"8732","320310 JERONIMO MONTEIRO",1,0,1,143,2,147,"2011"
"8733","320313 JOAO NEIVA",0,0,6,191,1,198,"2011"
"8734","320316 LARANJA DA TERRA",0,0,2,88,27,117,"2011"
"8735","320320 LINHARES",3,1,5,729,1661,2399,"2011"
"8736","320330 MANTENOPOLIS",0,0,2,153,31,186,"2011"
"8737","320332 MARATAIZES",2,0,4,458,19,483,"2011"
"8738","320334 MARECHAL FLORIANO",0,0,1,202,2,205,"2011"
"8739","320335 MARILANDIA",0,0,0,104,2,106,"2011"
"8740","320340 MIMOSO DO SUL",0,2,3,265,1,271,"2011"
"8741","320350 MONTANHA",1,1,6,265,4,277,"2011"
"8742","320360 MUCURICI",0,0,2,60,1,63,"2011"
"8743","320370 MUNIZ FREIRE",1,1,3,191,3,199,"2011"
"8744","320380 MUQUI",0,0,5,150,0,155,"2011"
"8745","320390 NOVA VENECIA",1,0,8,589,7,605,"2011"
"8746","320400 PANCAS",1,0,2,218,8,229,"2011"
"8747","320405 PEDRO CANARIO",0,3,1,361,27,392,"2011"
"8748","320410 PINHEIROS",0,0,2,44,378,424,"2011"
"8749","320420 PIUMA",1,1,3,256,3,264,"2011"
"8750","320425 PONTO BELO",0,0,4,103,4,111,"2011"
"8751","320430 PRESIDENTE KENNEDY",0,0,1,136,1,138,"2011"
"8752","320435 RIO BANANAL",0,1,1,93,145,240,"2011"
"8753","320440 RIO NOVO DO SUL",0,1,3,124,1,129,"2011"
"8754","320450 SANTA LEOPOLDINA",1,2,1,134,0,138,"2011"
"8755","320455 SANTA MARIA DE JETIBA",1,1,8,526,0,536,"2011"
"8756","320460 SANTA TERESA",0,1,2,247,7,257,"2011"
"8757","320465 SAO DOMINGOS DO NORTE",0,0,0,96,2,98,"2011"
"8758","320470 SAO GABRIEL DA PALHA",1,3,6,385,5,400,"2011"
"8759","320480 SAO JOSE DO CALCADO",0,0,7,145,0,152,"2011"
"8760","320490 SAO MATEUS",5,9,18,1670,33,1735,"2011"
"8761","320495 SAO ROQUE DO CANAA",0,0,0,118,5,123,"2011"
"8762","320500 SERRA",30,19,87,7204,98,7438,"2011"
"8763","320501 SOORETAMA",1,0,1,107,315,424,"2011"
"8764","320503 VARGEM ALTA",0,0,2,240,12,254,"2011"
"8765","320506 VENDA NOVA DO IMIGRANTE",0,1,5,250,0,256,"2011"
"8766","320510 VIANA",14,3,17,1015,13,1062,"2011"
"8767","320515 VILA PAVAO",0,0,1,113,0,114,"2011"
"8768","320517 VILA VALERIO",0,2,0,153,10,165,"2011"
"8769","320520 VILA VELHA",803,15,89,5212,50,6169,"2011"
"8770","320530 VITORIA",30,12,72,4441,37,4592,"2011"
"8771","MUNICIPIO IGNORADO - RJ",0,2,1,27,4,34,"2011"
"8772","330010 ANGRA DOS REIS",8,15,53,2427,20,2523,"2011"
"8773","330015 APERIBE",0,2,2,117,1,122,"2011"
"8774","330020 ARARUAMA",1,6,81,1446,6,1540,"2011"
"8775","330022 AREAL",1,0,2,144,1,148,"2011"
"8776","330023 ARMACAO DOS BUZIOS",1,4,17,522,6,550,"2011"
"8777","330025 ARRAIAL DO CABO",1,2,4,229,95,331,"2011"
"8778","330030 BARRA DO PIRAI",2,8,35,967,1,1013,"2011"
"8779","330040 BARRA MANSA",6,13,83,2265,10,2377,"2011"
"8780","330045 BELFORD ROXO",9,39,158,7116,48,7370,"2011"
"8781","330050 BOM JARDIM",7,1,2,335,2,347,"2011"
"8782","330060 BOM JESUS DO ITABAPOANA",3,2,4,456,2,467,"2011"
"8783","330070 CABO FRIO",6,12,58,2896,30,3002,"2011"
"8784","330080 CACHOEIRAS DE MACACU",2,6,16,712,15,751,"2011"
"8785","330090 CAMBUCI",3,2,6,123,0,134,"2011"
"8786","330093 CARAPEBUS",1,0,1,123,0,125,"2011"
"8787","330095 COMENDADOR LEVY GASPARIAN",0,1,0,89,0,90,"2011"
"8788","330100 CAMPOS DOS GOYTACAZES",9,26,98,4932,956,6021,"2011"
"8789","330110 CANTAGALO",0,2,1,201,0,204,"2011"
"8790","330115 CARDOSO MOREIRA",0,0,5,109,15,129,"2011"
"8791","330120 CARMO",1,1,6,223,0,231,"2011"
"8792","330130 CASIMIRO DE ABREU",1,4,14,431,4,454,"2011"
"8793","330140 CONCEICAO DE MACABU",1,3,3,187,11,205,"2011"
"8794","330150 CORDEIRO",0,1,6,228,0,235,"2011"
"8795","330160 DUAS BARRAS",1,1,2,117,6,127,"2011"
"8796","330170 DUQUE DE CAXIAS",25,75,291,12603,100,13094,"2011"
"8797","330180 ENGENHEIRO PAULO DE FRONTIN",1,0,4,103,1,109,"2011"
"8798","330185 GUAPIMIRIM",0,2,17,675,6,700,"2011"
"8799","330187 IGUABA GRANDE",2,0,5,254,43,304,"2011"
"8800","330190 ITABORAI",5,11,61,3278,28,3383,"2011"
"8801","330200 ITAGUAI",3,11,41,1821,19,1895,"2011"
"8802","330205 ITALVA",0,4,10,151,1,166,"2011"
"8803","330210 ITAOCARA",0,0,7,242,1,250,"2011"
"8804","330220 ITAPERUNA",6,6,21,1137,1,1171,"2011"
"8805","330225 ITATIAIA",2,2,9,368,1,382,"2011"
"8806","330227 JAPERI",3,8,38,1392,11,1452,"2011"
"8807","330230 LAJE DO MURIAE",0,0,2,87,0,89,"2011"
"8808","330240 MACAE",7,18,69,3434,14,3542,"2011"
"8809","330245 MACUCO",2,1,2,104,0,109,"2011"
"8810","330250 MAGE",8,9,38,3374,5,3434,"2011"
"8811","330260 MANGARATIBA",0,2,14,534,2,552,"2011"
"8812","330270 MARICA",4,4,21,1022,392,1443,"2011"
"8813","330280 MENDES",0,3,4,156,2,165,"2011"
"8814","330285 MESQUITA",9,11,68,2186,7,2281,"2011"
"8815","330290 MIGUEL PEREIRA",0,3,8,278,8,297,"2011"
"8816","330300 MIRACEMA",0,1,4,374,0,379,"2011"
"8817","330310 NATIVIDADE",1,4,7,149,0,161,"2011"
"8818","330320 NILOPOLIS",4,8,50,2047,9,2118,"2011"
"8819","330330 NITEROI",20,26,106,5958,21,6131,"2011"
"8820","330340 NOVA FRIBURGO",7,13,64,2164,14,2262,"2011"
"8821","330350 NOVA IGUACU",46,68,272,11502,64,11952,"2011"
"8822","330360 PARACAMBI",2,1,4,501,1,509,"2011"
"8823","330370 PARAIBA DO SUL",1,0,11,562,1,575,"2011"
"8824","330380 PARATY",5,6,16,525,1,553,"2011"
"8825","330385 PATY DO ALFERES",1,5,11,310,11,338,"2011"
"8826","330390 PETROPOLIS",20,35,103,3729,20,3907,"2011"
"8827","330395 PINHEIRAL",1,2,2,313,0,318,"2011"
"8828","330400 PIRAI",1,2,9,338,0,350,"2011"
"8829","330410 PORCIUNCULA",1,2,10,242,0,255,"2011"
"8830","330411 PORTO REAL",2,0,10,259,1,272,"2011"
"8831","330412 QUATIS",2,1,15,162,1,181,"2011"
"8832","330414 QUEIMADOS",7,11,48,2347,8,2421,"2011"
"8833","330415 QUISSAMA",0,6,8,290,4,308,"2011"
"8834","330420 RESENDE",7,7,58,1614,5,1691,"2011"
"8835","330430 RIO BONITO",2,0,6,690,11,709,"2011"
"8836","330440 RIO CLARO",0,3,7,190,2,202,"2011"
"8837","330450 RIO DAS FLORES",0,0,1,107,1,109,"2011"
"8838","330452 RIO DAS OSTRAS",2,14,61,1824,5,1906,"2011"
"8839","330455 RIO DE JANEIRO",171,462,1777,83160,562,86132,"2011"
"8840","330460 SANTA MARIA MADALENA",3,3,2,97,0,105,"2011"
"8841","330470 SANTO ANTONIO DE PADUA",0,2,6,391,45,444,"2011"
"8842","330475 SAO FRANCISCO DE ITABAPOANA",1,0,5,434,66,506,"2011"
"8843","330480 SAO FIDELIS",0,0,10,341,52,403,"2011"
"8844","330490 SAO GONCALO",62,53,224,11276,54,11669,"2011"
"8845","330500 SAO JOAO DA BARRA",1,4,5,239,150,399,"2011"
"8846","330510 SAO JOAO DE MERITI",13,38,143,6694,22,6910,"2011"
"8847","330513 SAO JOSE DE UBA",0,0,2,94,0,96,"2011"
"8848","330515 SAO JOSE DO VALE DO RIO PRETO",0,0,3,220,2,225,"2011"
"8849","330520 SAO PEDRO DA ALDEIA",3,4,10,1023,150,1190,"2011"
"8850","330530 SAO SEBASTIAO DO ALTO",1,1,3,108,0,113,"2011"
"8851","330540 SAPUCAIA",0,1,2,214,0,217,"2011"
"8852","330550 SAQUAREMA",0,5,11,572,311,899,"2011"
"8853","330555 SEROPEDICA",2,5,17,1050,9,1083,"2011"
"8854","330560 SILVA JARDIM",2,4,5,290,4,305,"2011"
"8855","330570 SUMIDOURO",0,0,5,162,2,169,"2011"
"8856","330575 TANGUA",2,1,4,425,2,434,"2011"
"8857","330580 TERESOPOLIS",4,8,41,2173,4,2230,"2011"
"8858","330590 TRAJANO DE MORAES",0,0,0,67,0,67,"2011"
"8859","330600 TRES RIOS",6,8,15,1095,2,1126,"2011"
"8860","330610 VALENCA",1,3,12,868,4,888,"2011"
"8861","330615 VARRE-SAI",1,0,3,156,0,160,"2011"
"8862","330620 VASSOURAS",4,1,19,513,4,541,"2011"
"8863","330630 VOLTA REDONDA",6,11,47,3269,4,3337,"2011"
"8864","MUNICIPIO IGNORADO - SP",0,0,0,9,3,12,"2011"
"8865","350010 ADAMANTINA",2,1,6,362,0,371,"2011"
"8866","350020 ADOLFO",0,0,0,24,0,24,"2011"
"8867","350030 AGUAI",2,1,6,407,4,420,"2011"
"8868","350040 AGUAS DA PRATA",0,0,1,68,1,70,"2011"
"8869","350050 AGUAS DE LINDOIA",0,0,2,236,0,238,"2011"
"8870","350055 AGUAS DE SANTA BARBARA",0,0,1,85,0,86,"2011"
"8871","350060 AGUAS DE SAO PEDRO",0,0,0,21,0,21,"2011"
"8872","350070 AGUDOS",0,1,6,511,21,539,"2011"
"8873","350075 ALAMBARI",0,1,2,67,1,71,"2011"
"8874","350080 ALFREDO MARCONDES",0,0,1,44,0,45,"2011"
"8875","350090 ALTAIR",0,0,2,39,0,41,"2011"
"8876","350100 ALTINOPOLIS",1,0,3,184,0,188,"2011"
"8877","350110 ALTO ALEGRE",0,0,1,43,0,44,"2011"
"8878","350115 ALUMINIO",2,3,4,258,0,267,"2011"
"8879","350120 ALVARES FLORENCE",0,0,0,39,0,39,"2011"
"8880","350130 ALVARES MACHADO",2,0,3,390,0,395,"2011"
"8881","350140 ALVARO DE CARVALHO",0,1,3,46,0,50,"2011"
"8882","350150 ALVINLANDIA",1,1,2,37,1,42,"2011"
"8883","350160 AMERICANA",5,5,19,2518,0,2547,"2011"
"8884","350170 AMERICO BRASILIENSE",0,4,1,476,0,481,"2011"
"8885","350180 AMERICO DE CAMPOS",0,0,0,59,0,59,"2011"
"8886","350190 AMPARO",0,2,8,789,2,801,"2011"
"8887","350200 ANALANDIA",0,0,1,47,0,48,"2011"
"8888","350210 ANDRADINA",1,5,32,645,3,686,"2011"
"8889","350220 ANGATUBA",2,1,5,320,0,328,"2011"
"8890","350230 ANHEMBI",1,1,2,80,1,85,"2011"
"8891","350240 ANHUMAS",0,0,1,42,1,44,"2011"
"8892","350250 APARECIDA",1,1,12,449,1,464,"2011"
"8893","350260 APARECIDA D'OESTE",0,0,0,41,0,41,"2011"
"8894","350270 APIAI",1,6,11,381,7,406,"2011"
"8895","350275 ARACARIGUAMA",0,0,4,302,3,309,"2011"
"8896","350280 ARACATUBA",0,9,34,2213,67,2323,"2011"
"8897","350290 ARACOIABA DA SERRA",4,6,3,362,4,379,"2011"
"8898","350300 ARAMINA",1,0,1,61,1,64,"2011"
"8899","350310 ARANDU",0,1,3,66,0,70,"2011"
"8900","350315 ARAPEI",0,0,0,24,0,24,"2011"
"8901","350320 ARARAQUARA",8,7,24,2527,3,2569,"2011"
"8902","350330 ARARAS",6,3,16,1498,4,1527,"2011"
"8903","350335 ARCO-IRIS",0,0,0,18,0,18,"2011"
"8904","350340 AREALVA",1,0,1,76,1,79,"2011"
"8905","350350 AREIAS",0,0,0,45,1,46,"2011"
"8906","350360 AREIOPOLIS",3,2,3,158,0,166,"2011"
"8907","350370 ARIRANHA",0,2,0,108,1,111,"2011"
"8908","350380 ARTUR NOGUEIRA",0,2,3,582,9,596,"2011"
"8909","350390 ARUJA",3,5,26,1301,3,1338,"2011"
"8910","350395 ASPASIA",0,0,1,18,0,19,"2011"
"8911","350400 ASSIS",0,4,10,1201,3,1218,"2011"
"8912","350410 ATIBAIA",1,7,32,1794,4,1838,"2011"
"8913","350420 AURIFLAMA",0,1,1,155,0,157,"2011"
"8914","350430 AVAI",0,0,3,61,0,64,"2011"
"8915","350440 AVANHANDAVA",0,1,7,166,1,175,"2011"
"8916","350450 AVARE",3,7,15,1214,1,1240,"2011"
"8917","350460 BADY BASSITT",1,0,0,195,0,196,"2011"
"8918","350470 BALBINOS",0,0,0,19,0,19,"2011"
"8919","350480 BALSAMO",0,0,0,93,0,93,"2011"
"8920","350490 BANANAL",0,1,4,101,0,106,"2011"
"8921","350500 BARAO DE ANTONINA",1,0,0,39,0,40,"2011"
"8922","350510 BARBOSA",0,0,2,83,0,85,"2011"
"8923","350520 BARIRI",0,2,5,369,13,389,"2011"
"8924","350530 BARRA BONITA",1,2,4,377,3,387,"2011"
"8925","350535 BARRA DO CHAPEU",0,0,1,87,2,90,"2011"
"8926","350540 BARRA DO TURVO",1,0,1,102,2,106,"2011"
"8927","350550 BARRETOS",1,11,23,1447,2,1484,"2011"
"8928","350560 BARRINHA",1,1,8,466,1,477,"2011"
"8929","350570 BARUERI",11,19,50,5377,18,5475,"2011"
"8930","350580 BASTOS",1,1,10,260,0,272,"2011"
"8931","350590 BATATAIS",3,2,2,673,4,684,"2011"
"8932","350600 BAURU",11,13,60,4575,31,4690,"2011"
"8933","350610 BEBEDOURO",1,4,7,897,2,911,"2011"
"8934","350620 BENTO DE ABREU",1,0,0,30,1,32,"2011"
"8935","350630 BERNARDINO DE CAMPOS",1,0,0,105,1,107,"2011"
"8936","350635 BERTIOGA",1,7,13,919,11,951,"2011"
"8937","350640 BILAC",0,0,0,87,2,89,"2011"
"8938","350650 BIRIGUI",3,3,13,1394,5,1418,"2011"
"8939","350660 BIRITIBA-MIRIM",0,1,4,366,5,376,"2011"
"8940","350670 BOA ESPERANCA DO SUL",0,0,4,210,0,214,"2011"
"8941","350680 BOCAINA",0,0,0,137,1,138,"2011"
"8942","350690 BOFETE",0,1,2,96,1,100,"2011"
"8943","350700 BOITUVA",3,2,6,755,1,767,"2011"
"8944","350710 BOM JESUS DOS PERDOES",0,1,0,277,0,278,"2011"
"8945","350715 BOM SUCESSO DE ITARARE",0,0,2,62,0,64,"2011"
"8946","350720 BORA",0,0,0,3,1,4,"2011"
"8947","350730 BORACEIA",0,0,1,40,11,52,"2011"
"8948","350740 BORBOREMA",0,0,3,130,0,133,"2011"
"8949","350745 BOREBI",0,0,0,30,0,30,"2011"
"8950","350750 BOTUCATU",3,13,32,1645,9,1702,"2011"
"8951","350760 BRAGANCA PAULISTA",1,8,25,2057,2,2093,"2011"
"8952","350770 BRAUNA",0,0,3,54,1,58,"2011"
"8953","350775 BREJO ALEGRE",0,1,0,39,1,41,"2011"
"8954","350780 BRODOWSKI",1,3,2,282,5,293,"2011"
"8955","350790 BROTAS",0,2,5,284,0,291,"2011"
"8956","350800 BURI",0,4,17,304,0,325,"2011"
"8957","350810 BURITAMA",2,3,4,190,0,199,"2011"
"8958","350820 BURITIZAL",0,0,0,40,0,40,"2011"
"8959","350830 CABRALIA PAULISTA",0,1,1,55,0,57,"2011"
"8960","350840 CABREUVA",1,3,11,682,3,700,"2011"
"8961","350850 CACAPAVA",2,2,15,1233,1,1253,"2011"
"8962","350860 CACHOEIRA PAULISTA",2,0,6,417,4,429,"2011"
"8963","350870 CACONDE",1,2,5,203,0,211,"2011"
"8964","350880 CAFELANDIA",2,1,8,259,0,270,"2011"
"8965","350890 CAIABU",0,1,1,55,0,57,"2011"
"8966","350900 CAIEIRAS",1,6,23,1402,5,1437,"2011"
"8967","350910 CAIUA",0,0,1,39,0,40,"2011"
"8968","350920 CAJAMAR",3,7,17,1168,0,1195,"2011"
"8969","350925 CAJATI",2,3,5,519,8,537,"2011"
"8970","350930 CAJOBI",0,0,1,115,0,116,"2011"
"8971","350940 CAJURU",1,0,2,344,2,349,"2011"
"8972","350945 CAMPINA DO MONTE ALEGRE",0,0,2,59,0,61,"2011"
"8973","350950 CAMPINAS",41,49,181,14439,58,14768,"2011"
"8974","350960 CAMPO LIMPO PAULISTA",0,7,24,1124,3,1158,"2011"
"8975","350970 CAMPOS DO JORDAO",0,1,17,764,0,782,"2011"
"8976","350980 CAMPOS NOVOS PAULISTA",0,1,2,45,0,48,"2011"
"8977","350990 CANANEIA",0,0,2,176,3,181,"2011"
"8978","350995 CANAS",0,0,0,48,14,62,"2011"
"8979","351000 CANDIDO MOTA",1,3,5,374,2,385,"2011"
"8980","351010 CANDIDO RODRIGUES",0,0,0,21,0,21,"2011"
"8981","351015 CANITAR",0,0,1,75,2,78,"2011"
"8982","351020 CAPAO BONITO",3,4,5,687,0,699,"2011"
"8983","351030 CAPELA DO ALTO",0,0,0,232,0,232,"2011"
"8984","351040 CAPIVARI",4,2,4,674,7,691,"2011"
"8985","351050 CARAGUATATUBA",4,4,21,1565,0,1594,"2011"
"8986","351060 CARAPICUIBA",8,34,73,6615,52,6782,"2011"
"8987","351070 CARDOSO",0,1,2,145,1,149,"2011"
"8988","351080 CASA BRANCA",1,2,5,334,4,346,"2011"
"8989","351090 CASSIA DOS COQUEIROS",0,0,1,20,0,21,"2011"
"8990","351100 CASTILHO",0,1,12,256,2,271,"2011"
"8991","351110 CATANDUVA",2,4,10,1419,3,1438,"2011"
"8992","351120 CATIGUA",0,0,1,78,0,79,"2011"
"8993","351130 CEDRAL",1,0,2,68,0,71,"2011"
"8994","351140 CERQUEIRA CESAR",2,0,0,240,0,242,"2011"
"8995","351150 CERQUILHO",0,1,3,510,1,515,"2011"
"8996","351160 CESARIO LANGE",0,1,2,215,0,218,"2011"
"8997","351170 CHARQUEADA",1,1,1,195,0,198,"2011"
"8998","351190 CLEMENTINA",0,0,2,108,4,114,"2011"
"8999","351200 COLINA",1,1,2,229,2,235,"2011"
"9000","351210 COLOMBIA",0,0,0,98,11,109,"2011"
"9001","351220 CONCHAL",2,2,1,388,0,393,"2011"
"9002","351230 CONCHAS",0,0,6,243,1,250,"2011"
"9003","351240 CORDEIROPOLIS",1,2,6,239,1,249,"2011"
"9004","351250 COROADOS",2,0,0,71,1,74,"2011"
"9005","351260 CORONEL MACEDO",0,0,1,64,0,65,"2011"
"9006","351270 CORUMBATAI",0,1,0,49,1,51,"2011"
"9007","351280 COSMOPOLIS",1,2,17,839,3,862,"2011"
"9008","351290 COSMORAMA",0,0,0,75,0,75,"2011"
"9009","351300 COTIA",2,16,46,3675,28,3767,"2011"
"9010","351310 CRAVINHOS",0,2,2,398,1,403,"2011"
"9011","351320 CRISTAIS PAULISTA",0,0,1,87,0,88,"2011"
"9012","351330 CRUZALIA",0,0,0,20,0,20,"2011"
"9013","351340 CRUZEIRO",3,3,13,1102,6,1127,"2011"
"9014","351350 CUBATAO",1,9,36,1860,3,1909,"2011"
"9015","351360 CUNHA",0,1,2,229,0,232,"2011"
"9016","351370 DESCALVADO",1,0,1,348,0,350,"2011"
"9017","351380 DIADEMA",12,32,96,6314,13,6467,"2011"
"9018","351385 DIRCE REIS",0,0,0,18,0,18,"2011"
"9019","351390 DIVINOLANDIA",1,0,3,154,0,158,"2011"
"9020","351400 DOBRADA",1,1,2,120,0,124,"2011"
"9021","351410 DOIS CORREGOS",1,2,5,357,0,365,"2011"
"9022","351420 DOLCINOPOLIS",0,0,0,16,0,16,"2011"
"9023","351430 DOURADO",0,0,1,51,0,52,"2011"
"9024","351440 DRACENA",2,0,8,525,3,538,"2011"
"9025","351450 DUARTINA",1,2,0,131,0,134,"2011"
"9026","351460 DUMONT",1,0,3,77,0,81,"2011"
"9027","351470 ECHAPORA",1,0,3,86,0,90,"2011"
"9028","351480 ELDORADO",0,0,0,215,2,217,"2011"
"9029","351490 ELIAS FAUSTO",0,0,1,211,3,215,"2011"
"9030","351492 ELISIARIO",0,1,1,34,0,36,"2011"
"9031","351495 EMBAUBA",0,0,0,23,0,23,"2011"
"9032","351500 EMBU DAS ARTES",16,28,50,4467,14,4575,"2011"
"9033","351510 EMBU-GUACU",4,2,23,877,7,913,"2011"
"9034","351512 EMILIANOPOLIS",0,0,1,34,0,35,"2011"
"9035","351515 ENGENHEIRO COELHO",0,2,1,249,1,253,"2011"
"9036","351518 ESPIRITO SANTO DO PINHAL",1,3,7,490,2,503,"2011"
"9037","351519 ESPIRITO SANTO DO TURVO",0,0,0,64,0,64,"2011"
"9038","351520 ESTRELA D'OESTE",0,0,0,64,0,64,"2011"
"9039","351530 ESTRELA DO NORTE",0,0,0,35,0,35,"2011"
"9040","351535 EUCLIDES DA CUNHA PAULISTA",1,0,4,122,1,128,"2011"
"9041","351540 FARTURA",0,0,0,186,0,186,"2011"
"9042","351550 FERNANDOPOLIS",1,2,10,708,0,721,"2011"
"9043","351560 FERNANDO PRESTES",0,0,0,44,0,44,"2011"
"9044","351565 FERNAO",0,0,0,26,0,26,"2011"
"9045","351570 FERRAZ DE VASCONCELOS",6,12,36,2875,19,2948,"2011"
"9046","351580 FLORA RICA",0,0,0,19,0,19,"2011"
"9047","351590 FLOREAL",0,1,0,24,0,25,"2011"
"9048","351600 FLORIDA PAULISTA",0,0,2,129,0,131,"2011"
"9049","351610 FLORINIA",0,0,0,23,0,23,"2011"
"9050","351620 FRANCA",14,18,45,4260,12,4349,"2011"
"9051","351630 FRANCISCO MORATO",2,17,44,2731,8,2802,"2011"
"9052","351640 FRANCO DA ROCHA",4,11,37,2026,12,2090,"2011"
"9053","351650 GABRIEL MONTEIRO",0,0,1,19,0,20,"2011"
"9054","351660 GALIA",0,0,1,86,0,87,"2011"
"9055","351670 GARCA",0,4,14,553,0,571,"2011"
"9056","351680 GASTAO VIDIGAL",0,0,1,63,0,64,"2011"
"9057","351685 GAVIAO PEIXOTO",0,0,1,63,0,64,"2011"
"9058","351690 GENERAL SALGADO",0,0,1,120,0,121,"2011"
"9059","351700 GETULINA",0,0,3,101,0,104,"2011"
"9060","351710 GLICERIO",0,1,1,56,0,58,"2011"
"9061","351720 GUAICARA",3,2,1,165,0,171,"2011"
"9062","351730 GUAIMBE",0,0,1,58,1,60,"2011"
"9063","351740 GUAIRA",1,2,6,487,0,496,"2011"
"9064","351750 GUAPIACU",0,1,2,206,1,210,"2011"
"9065","351760 GUAPIARA",0,1,4,238,1,244,"2011"
"9066","351770 GUARA",0,1,4,247,0,252,"2011"
"9067","351780 GUARACAI",0,1,3,84,1,89,"2011"
"9068","351790 GUARACI",0,0,4,145,0,149,"2011"
"9069","351800 GUARANI D'OESTE",0,0,0,26,0,26,"2011"
"9070","351810 GUARANTA",0,0,2,83,0,85,"2011"
"9071","351820 GUARARAPES",0,0,17,361,4,382,"2011"
"9072","351830 GUARAREMA",0,3,13,385,1,402,"2011"
"9073","351840 GUARATINGUETA",5,9,14,1399,5,1432,"2011"
"9074","351850 GUAREI",0,1,6,177,1,185,"2011"
"9075","351860 GUARIBA",2,1,14,575,0,592,"2011"
"9076","351870 GUARUJA",14,41,205,4329,180,4769,"2011"
"9077","351880 GUARULHOS",29,89,281,20379,97,20875,"2011"
"9078","351885 GUATAPARA",1,0,0,97,1,99,"2011"
"9079","351890 GUZOLANDIA",0,2,1,68,0,71,"2011"
"9080","351900 HERCULANDIA",1,0,0,93,0,94,"2011"
"9081","351905 HOLAMBRA",0,1,1,149,0,151,"2011"
"9082","351907 HORTOLANDIA",5,10,26,2765,5,2811,"2011"
"9083","351910 IACANGA",0,1,3,124,0,128,"2011"
"9084","351920 IACRI",0,2,2,60,0,64,"2011"
"9085","351925 IARAS",0,0,0,56,0,56,"2011"
"9086","351930 IBATE",0,2,2,489,1,494,"2011"
"9087","351940 IBIRA",1,0,1,126,1,129,"2011"
"9088","351950 IBIRAREMA",0,0,0,75,0,75,"2011"
"9089","351960 IBITINGA",1,1,11,611,3,627,"2011"
"9090","351970 IBIUNA",2,9,20,1045,6,1082,"2011"
"9091","351980 ICEM",0,1,0,93,0,94,"2011"
"9092","351990 IEPE",1,0,0,94,0,95,"2011"
"9093","352000 IGARACU DO TIETE",0,1,9,293,2,305,"2011"
"9094","352010 IGARAPAVA",4,0,2,330,1,337,"2011"
"9095","352020 IGARATA",0,2,1,131,2,136,"2011"
"9096","352030 IGUAPE",3,1,8,351,2,365,"2011"
"9097","352040 ILHABELA",0,0,3,471,1,475,"2011"
"9098","352042 ILHA COMPRIDA",0,0,0,95,1,96,"2011"
"9099","352044 ILHA SOLTEIRA",0,1,3,276,1,281,"2011"
"9100","352050 INDAIATUBA",9,7,27,2740,4,2787,"2011"
"9101","352060 INDIANA",0,0,0,58,0,58,"2011"
"9102","352070 INDIAPORA",0,0,0,41,0,41,"2011"
"9103","352080 INUBIA PAULISTA",0,0,0,35,0,35,"2011"
"9104","352090 IPAUSSU",0,1,1,180,3,185,"2011"
"9105","352100 IPERO",2,0,4,326,2,334,"2011"
"9106","352110 IPEUNA",0,0,1,85,1,87,"2011"
"9107","352115 IPIGUA",0,0,1,41,0,42,"2011"
"9108","352120 IPORANGA",0,1,1,69,2,73,"2011"
"9109","352130 IPUA",1,2,4,174,0,181,"2011"
"9110","352140 IRACEMAPOLIS",0,0,2,266,1,269,"2011"
"9111","352150 IRAPUA",0,1,1,84,1,87,"2011"
"9112","352160 IRAPURU",0,0,0,75,0,75,"2011"
"9113","352170 ITABERA",2,3,6,208,0,219,"2011"
"9114","352180 ITAI",1,2,5,313,0,321,"2011"
"9115","352190 ITAJOBI",0,0,1,170,0,171,"2011"
"9116","352200 ITAJU",0,0,1,20,3,24,"2011"
"9117","352210 ITANHAEM",4,5,21,1310,12,1352,"2011"
"9118","352215 ITAOCA",0,0,1,25,0,26,"2011"
"9119","352220 ITAPECERICA DA SERRA",7,15,72,2744,24,2862,"2011"
"9120","352230 ITAPETININGA",6,8,45,2077,4,2140,"2011"
"9121","352240 ITAPEVA",4,12,62,1325,6,1409,"2011"
"9122","352250 ITAPEVI",4,13,54,3933,20,4024,"2011"
"9123","352260 ITAPIRA",1,3,10,753,0,767,"2011"
"9124","352265 ITAPIRAPUA PAULISTA",1,0,3,44,2,50,"2011"
"9125","352270 ITAPOLIS",0,2,7,518,0,527,"2011"
"9126","352280 ITAPORANGA",2,0,1,201,0,204,"2011"
"9127","352290 ITAPUI",0,0,0,189,5,194,"2011"
"9128","352300 ITAPURA",0,0,3,76,0,79,"2011"
"9129","352310 ITAQUAQUECETUBA",10,26,95,5359,35,5525,"2011"
"9130","352320 ITARARE",3,1,10,641,1,656,"2011"
"9131","352330 ITARIRI",0,0,3,162,5,170,"2011"
"9132","352340 ITATIBA",4,3,12,1465,0,1484,"2011"
"9133","352350 ITATINGA",0,0,6,293,2,301,"2011"
"9134","352360 ITIRAPINA",0,0,0,154,0,154,"2011"
"9135","352370 ITIRAPUA",0,0,1,66,4,71,"2011"
"9136","352380 ITOBI",0,1,2,70,0,73,"2011"
"9137","352390 ITU",6,7,32,2321,5,2371,"2011"
"9138","352400 ITUPEVA",2,5,21,773,2,803,"2011"
"9139","352410 ITUVERAVA",3,0,4,447,0,454,"2011"
"9140","352420 JABORANDI",1,0,2,77,1,81,"2011"
"9141","352430 JABOTICABAL",3,3,2,795,1,804,"2011"
"9142","352440 JACAREI",5,14,51,3156,7,3233,"2011"
"9143","352450 JACI",0,0,0,67,0,67,"2011"
"9144","352460 JACUPIRANGA",2,2,2,238,4,248,"2011"
"9145","352470 JAGUARIUNA",0,2,6,648,0,656,"2011"
"9146","352480 JALES",1,0,5,512,0,518,"2011"
"9147","352490 JAMBEIRO",0,0,1,57,0,58,"2011"
"9148","352500 JANDIRA",0,6,20,1666,5,1697,"2011"
"9149","352510 JARDINOPOLIS",2,5,9,479,1,496,"2011"
"9150","352520 JARINU",2,3,6,358,1,370,"2011"
"9151","352530 JAU",3,2,9,1668,5,1687,"2011"
"9152","352540 JERIQUARA",1,0,0,38,0,39,"2011"
"9153","352550 JOANOPOLIS",0,0,0,126,1,127,"2011"
"9154","352560 JOAO RAMALHO",0,0,3,64,0,67,"2011"
"9155","352570 JOSE BONIFACIO",2,4,1,436,1,444,"2011"
"9156","352580 JULIO MESQUITA",0,0,0,61,0,61,"2011"
"9157","352585 JUMIRIM",0,0,0,32,0,32,"2011"
"9158","352590 JUNDIAI",12,27,87,5226,9,5361,"2011"
"9159","352600 JUNQUEIROPOLIS",2,2,4,229,0,237,"2011"
"9160","352610 JUQUIA",0,1,5,282,9,297,"2011"
"9161","352620 JUQUITIBA",1,6,11,438,6,462,"2011"
"9162","352630 LAGOINHA",2,0,0,36,0,38,"2011"
"9163","352640 LARANJAL PAULISTA",2,3,4,355,0,364,"2011"
"9164","352650 LAVINIA",0,0,1,53,0,54,"2011"
"9165","352660 LAVRINHAS",0,2,3,110,0,115,"2011"
"9166","352670 LEME",3,4,15,1293,1,1316,"2011"
"9167","352680 LENCOIS PAULISTA",1,5,22,809,34,871,"2011"
"9168","352690 LIMEIRA",10,12,35,3424,19,3500,"2011"
"9169","352700 LINDOIA",0,0,1,77,0,78,"2011"
"9170","352710 LINS",6,0,5,946,2,959,"2011"
"9171","352720 LORENA",1,3,9,1065,146,1224,"2011"
"9172","352725 LOURDES",1,1,0,22,1,25,"2011"
"9173","352730 LOUVEIRA",3,1,11,617,0,632,"2011"
"9174","352740 LUCELIA",0,1,3,199,0,203,"2011"
"9175","352750 LUCIANOPOLIS",0,0,0,25,0,25,"2011"
"9176","352760 LUIS ANTONIO",0,1,2,156,1,160,"2011"
"9177","352770 LUIZIANIA",0,0,1,73,0,74,"2011"
"9178","352780 LUPERCIO",0,1,2,62,0,65,"2011"
"9179","352790 LUTECIA",0,0,0,41,0,41,"2011"
"9180","352800 MACATUBA",0,0,3,227,1,231,"2011"
"9181","352810 MACAUBAL",0,1,0,63,0,64,"2011"
"9182","352820 MACEDONIA",0,1,0,35,0,36,"2011"
"9183","352830 MAGDA",0,0,0,33,0,33,"2011"
"9184","352840 MAIRINQUE",2,4,4,613,6,629,"2011"
"9185","352850 MAIRIPORA",4,4,17,1140,1,1166,"2011"
"9186","352860 MANDURI",0,0,1,91,0,92,"2011"
"9187","352870 MARABA PAULISTA",0,0,0,32,0,32,"2011"
"9188","352880 MARACAI",0,1,1,184,0,186,"2011"
"9189","352885 MARAPOAMA",0,1,1,23,0,25,"2011"
"9190","352890 MARIAPOLIS",1,0,0,40,0,41,"2011"
"9191","352900 MARILIA",12,11,39,2826,2,2890,"2011"
"9192","352910 MARINOPOLIS",0,0,0,22,0,22,"2011"
"9193","352920 MARTINOPOLIS",0,0,8,270,0,278,"2011"
"9194","352930 MATAO",3,2,17,980,1,1003,"2011"
"9195","352940 MAUA",11,14,67,5869,26,5987,"2011"
"9196","352950 MENDONCA",0,0,2,45,0,47,"2011"
"9197","352960 MERIDIANO",0,0,0,39,0,39,"2011"
"9198","352965 MESOPOLIS",0,0,1,18,0,19,"2011"
"9199","352970 MIGUELOPOLIS",0,0,3,252,0,255,"2011"
"9200","352980 MINEIROS DO TIETE",0,0,1,150,2,153,"2011"
"9201","352990 MIRACATU",1,0,4,287,12,304,"2011"
"9202","353000 MIRA ESTRELA",0,0,0,26,0,26,"2011"
"9203","353010 MIRANDOPOLIS",1,0,7,296,2,306,"2011"
"9204","353020 MIRANTE DO PARANAPANEMA",4,2,3,194,1,204,"2011"
"9205","353030 MIRASSOL",1,1,13,633,0,648,"2011"
"9206","353040 MIRASSOLANDIA",1,0,0,50,0,51,"2011"
"9207","353050 MOCOCA",0,2,14,797,2,815,"2011"
"9208","353060 MOGI DAS CRUZES",9,30,62,5965,71,6137,"2011"
"9209","353070 MOGI GUACU",8,11,26,1896,3,1944,"2011"
"9210","353080 MOGI MIRIM",3,4,19,1132,8,1166,"2011"
"9211","353090 MOMBUCA",0,1,0,49,0,50,"2011"
"9212","353100 MONCOES",0,0,0,15,0,15,"2011"
"9213","353110 MONGAGUA",3,6,22,665,1,697,"2011"
"9214","353120 MONTE ALEGRE DO SUL",0,0,0,74,0,74,"2011"
"9215","353130 MONTE ALTO",0,4,4,545,2,555,"2011"
"9216","353140 MONTE APRAZIVEL",0,1,1,242,0,244,"2011"
"9217","353150 MONTE AZUL PAULISTA",1,2,3,218,0,224,"2011"
"9218","353160 MONTE CASTELO",0,0,0,43,0,43,"2011"
"9219","353170 MONTEIRO LOBATO",0,0,0,40,0,40,"2011"
"9220","353180 MONTE MOR",3,3,10,771,11,798,"2011"
"9221","353190 MORRO AGUDO",0,0,5,465,0,470,"2011"
"9222","353200 MORUNGABA",0,0,2,149,1,152,"2011"
"9223","353205 MOTUCA",0,0,1,43,0,44,"2011"
"9224","353210 MURUTINGA DO SUL",0,0,2,34,0,36,"2011"
"9225","353215 NANTES",0,0,0,46,0,46,"2011"
"9226","353220 NARANDIBA",0,1,1,74,0,76,"2011"
"9227","353230 NATIVIDADE DA SERRA",0,0,1,72,1,74,"2011"
"9228","353240 NAZARE PAULISTA",1,1,10,235,0,247,"2011"
"9229","353250 NEVES PAULISTA",1,0,0,62,0,63,"2011"
"9230","353260 NHANDEARA",0,0,1,120,0,121,"2011"
"9231","353270 NIPOA",0,0,0,53,0,53,"2011"
"9232","353280 NOVA ALIANCA",0,0,1,46,0,47,"2011"
"9233","353282 NOVA CAMPINA",0,1,5,122,0,128,"2011"
"9234","353284 NOVA CANAA PAULISTA",0,0,0,19,0,19,"2011"
"9235","353286 NOVA CASTILHO",0,0,0,21,0,21,"2011"
"9236","353290 NOVA EUROPA",1,0,2,144,0,147,"2011"
"9237","353300 NOVA GRANADA",0,0,2,274,0,276,"2011"
"9238","353310 NOVA GUATAPORANGA",0,0,1,19,0,20,"2011"
"9239","353320 NOVA INDEPENDENCIA",0,1,3,37,0,41,"2011"
"9240","353325 NOVAIS",0,0,3,72,0,75,"2011"
"9241","353330 NOVA LUZITANIA",0,0,0,49,0,49,"2011"
"9242","353340 NOVA ODESSA",2,1,2,628,0,633,"2011"
"9243","353350 NOVO HORIZONTE",0,0,1,468,0,469,"2011"
"9244","353360 NUPORANGA",0,0,2,74,0,76,"2011"
"9245","353370 OCAUCU",0,0,1,57,0,58,"2011"
"9246","353380 OLEO",0,1,0,18,0,19,"2011"
"9247","353390 OLIMPIA",1,2,10,622,1,636,"2011"
"9248","353400 ONDA VERDE",1,0,0,45,0,46,"2011"
"9249","353410 ORIENTE",0,0,2,72,0,74,"2011"
"9250","353420 ORINDIUVA",0,1,0,87,0,88,"2011"
"9251","353430 ORLANDIA",2,1,8,551,0,562,"2011"
"9252","353440 OSASCO",33,33,156,10290,31,10543,"2011"
"9253","353450 OSCAR BRESSANE",0,0,0,30,0,30,"2011"
"9254","353460 OSVALDO CRUZ",1,2,3,312,0,318,"2011"
"9255","353470 OURINHOS",1,4,16,1419,9,1449,"2011"
"9256","353475 OUROESTE",0,1,2,114,0,117,"2011"
"9257","353480 OURO VERDE",0,0,1,130,0,131,"2011"
"9258","353490 PACAEMBU",0,0,0,116,1,117,"2011"
"9259","353500 PALESTINA",0,0,1,116,0,117,"2011"
"9260","353510 PALMARES PAULISTA",2,0,0,155,0,157,"2011"
"9261","353520 PALMEIRA D'OESTE",0,0,0,92,0,92,"2011"
"9262","353530 PALMITAL",0,0,0,268,0,268,"2011"
"9263","353540 PANORAMA",2,2,9,238,0,251,"2011"
"9264","353550 PARAGUACU PAULISTA",1,1,7,600,0,609,"2011"
"9265","353560 PARAIBUNA",1,0,4,242,0,247,"2011"
"9266","353570 PARAISO",0,0,1,53,0,54,"2011"
"9267","353580 PARANAPANEMA",0,0,5,290,2,297,"2011"
"9268","353590 PARANAPUA",1,0,1,37,0,39,"2011"
"9269","353600 PARAPUA",0,0,3,110,0,113,"2011"
"9270","353610 PARDINHO",0,0,2,84,1,87,"2011"
"9271","353620 PARIQUERA-ACU",0,0,2,288,3,293,"2011"
"9272","353625 PARISI",1,0,0,18,0,19,"2011"
"9273","353630 PATROCINIO PAULISTA",0,1,6,165,19,191,"2011"
"9274","353640 PAULICEIA",1,0,8,93,0,102,"2011"
"9275","353650 PAULINIA",5,5,15,1279,2,1306,"2011"
"9276","353657 PAULISTANIA",0,0,0,12,0,12,"2011"
"9277","353660 PAULO DE FARIA",0,1,2,106,0,109,"2011"
"9278","353670 PEDERNEIRAS",2,1,11,561,6,581,"2011"
"9279","353680 PEDRA BELA",0,0,0,71,0,71,"2011"
"9280","353690 PEDRANOPOLIS",0,0,0,16,0,16,"2011"
"9281","353700 PEDREGULHO",0,0,4,192,2,198,"2011"
"9282","353710 PEDREIRA",0,0,3,514,10,527,"2011"
"9283","353715 PEDRINHAS PAULISTA",0,0,1,16,0,17,"2011"
"9284","353720 PEDRO DE TOLEDO",0,1,1,131,5,138,"2011"
"9285","353730 PENAPOLIS",3,6,25,711,5,750,"2011"
"9286","353740 PEREIRA BARRETO",1,2,7,316,3,329,"2011"
"9287","353750 PEREIRAS",0,0,0,91,0,91,"2011"
"9288","353760 PERUIBE",4,5,14,882,102,1007,"2011"
"9289","353770 PIACATU",0,0,0,63,0,63,"2011"
"9290","353780 PIEDADE",3,5,9,581,1,599,"2011"
"9291","353790 PILAR DO SUL",1,1,7,389,0,398,"2011"
"9292","353800 PINDAMONHANGABA",3,4,34,2209,28,2278,"2011"
"9293","353810 PINDORAMA",0,0,2,168,0,170,"2011"
"9294","353820 PINHALZINHO",0,0,2,135,1,138,"2011"
"9295","353830 PIQUEROBI",0,0,1,30,0,31,"2011"
"9296","353850 PIQUETE",0,0,2,132,19,153,"2011"
"9297","353860 PIRACAIA",0,0,3,321,1,325,"2011"
"9298","353870 PIRACICABA",13,13,45,4740,9,4820,"2011"
"9299","353880 PIRAJU",0,1,6,388,4,399,"2011"
"9300","353890 PIRAJUI",1,1,3,252,0,257,"2011"
"9301","353900 PIRANGI",0,0,1,122,1,124,"2011"
"9302","353910 PIRAPORA DO BOM JESUS",1,0,4,217,0,222,"2011"
"9303","353920 PIRAPOZINHO",1,1,7,274,0,283,"2011"
"9304","353930 PIRASSUNUNGA",2,3,9,901,3,918,"2011"
"9305","353940 PIRATININGA",1,0,2,153,3,159,"2011"
"9306","353950 PITANGUEIRAS",1,0,3,517,1,522,"2011"
"9307","353960 PLANALTO",0,0,0,56,0,56,"2011"
"9308","353970 PLATINA",0,0,3,48,1,52,"2011"
"9309","353980 POA",4,4,28,1622,8,1666,"2011"
"9310","353990 POLONI",0,0,1,61,0,62,"2011"
"9311","354000 POMPEIA",0,1,3,251,0,255,"2011"
"9312","354010 PONGAI",0,0,0,24,0,24,"2011"
"9313","354020 PONTAL",1,1,4,612,2,620,"2011"
"9314","354025 PONTALINDA",1,0,2,43,1,47,"2011"
"9315","354030 PONTES GESTAL",0,0,0,42,0,42,"2011"
"9316","354040 POPULINA",0,0,1,57,0,58,"2011"
"9317","354050 PORANGABA",0,1,1,81,2,85,"2011"
"9318","354060 PORTO FELIZ",1,5,3,646,0,655,"2011"
"9319","354070 PORTO FERREIRA",2,2,3,676,0,683,"2011"
"9320","354075 POTIM",0,1,2,260,0,263,"2011"
"9321","354080 POTIRENDABA",0,1,2,182,1,186,"2011"
"9322","354085 PRACINHA",0,0,0,23,0,23,"2011"
"9323","354090 PRADOPOLIS",0,0,4,222,0,226,"2011"
"9324","354100 PRAIA GRANDE",10,27,107,4171,20,4335,"2011"
"9325","354105 PRATANIA",0,0,2,59,0,61,"2011"
"9326","354110 PRESIDENTE ALVES",0,0,0,51,0,51,"2011"
"9327","354120 PRESIDENTE BERNARDES",1,1,1,124,0,127,"2011"
"9328","354130 PRESIDENTE EPITACIO",0,1,10,584,1,596,"2011"
"9329","354140 PRESIDENTE PRUDENTE",4,5,31,2541,5,2586,"2011"
"9330","354150 PRESIDENTE VENCESLAU",0,1,6,414,0,421,"2011"
"9331","354160 PROMISSAO",2,2,5,520,3,532,"2011"
"9332","354165 QUADRA",0,0,0,46,0,46,"2011"
"9333","354170 QUATA",0,1,3,152,2,158,"2011"
"9334","354180 QUEIROZ",0,0,0,38,0,38,"2011"
"9335","354190 QUELUZ",1,0,2,119,0,122,"2011"
"9336","354200 QUINTANA",1,0,1,73,0,75,"2011"
"9337","354210 RAFARD",0,0,2,109,0,111,"2011"
"9338","354220 RANCHARIA",0,1,5,384,0,390,"2011"
"9339","354230 REDENCAO DA SERRA",2,0,0,53,1,56,"2011"
"9340","354240 REGENTE FEIJO",0,1,3,228,0,232,"2011"
"9341","354250 REGINOPOLIS",0,0,0,64,0,64,"2011"
"9342","354260 REGISTRO",1,4,8,874,32,919,"2011"
"9343","354270 RESTINGA",0,0,1,83,0,84,"2011"
"9344","354280 RIBEIRA",0,0,1,50,1,52,"2011"
"9345","354290 RIBEIRAO BONITO",0,0,2,193,1,196,"2011"
"9346","354300 RIBEIRAO BRANCO",0,3,17,255,5,280,"2011"
"9347","354310 RIBEIRAO CORRENTE",0,0,0,57,0,57,"2011"
"9348","354320 RIBEIRAO DO SUL",0,0,1,40,0,41,"2011"
"9349","354323 RIBEIRAO DOS INDIOS",0,0,1,20,0,21,"2011"
"9350","354325 RIBEIRAO GRANDE",0,0,0,102,0,102,"2011"
"9351","354330 RIBEIRAO PIRES",2,4,18,1452,6,1482,"2011"
"9352","354340 RIBEIRAO PRETO",23,25,119,8139,47,8353,"2011"
"9353","354350 RIVERSUL",1,0,3,71,0,75,"2011"
"9354","354360 RIFAINA",0,0,0,21,0,21,"2011"
"9355","354370 RINCAO",0,0,0,138,2,140,"2011"
"9356","354380 RINOPOLIS",0,1,1,113,0,115,"2011"
"9357","354390 RIO CLARO",7,4,21,2398,2,2432,"2011"
"9358","354400 RIO DAS PEDRAS",0,0,3,395,0,398,"2011"
"9359","354410 RIO GRANDE DA SERRA",1,2,8,647,6,664,"2011"
"9360","354420 RIOLANDIA",0,0,1,114,0,115,"2011"
"9361","354425 ROSANA",0,0,1,242,0,243,"2011"
"9362","354430 ROSEIRA",0,0,0,146,1,147,"2011"
"9363","354440 RUBIACEA",0,0,0,31,0,31,"2011"
"9364","354450 RUBINEIA",0,0,0,29,0,29,"2011"
"9365","354460 SABINO",0,0,0,70,0,70,"2011"
"9366","354470 SAGRES",0,0,0,26,0,26,"2011"
"9367","354480 SALES",0,0,0,58,0,58,"2011"
"9368","354490 SALES OLIVEIRA",3,0,2,105,0,110,"2011"
"9369","354500 SALESOPOLIS",0,1,1,253,2,257,"2011"
"9370","354510 SALMOURAO",0,1,0,53,0,54,"2011"
"9371","354515 SALTINHO",0,0,0,74,1,75,"2011"
"9372","354520 SALTO",1,3,16,1337,1,1358,"2011"
"9373","354530 SALTO DE PIRAPORA",3,1,9,503,2,518,"2011"
"9374","354540 SALTO GRANDE",0,0,2,115,1,118,"2011"
"9375","354550 SANDOVALINA",0,0,0,63,0,63,"2011"
"9376","354560 SANTA ADELIA",0,0,2,153,1,156,"2011"
"9377","354570 SANTA ALBERTINA",0,0,2,62,0,64,"2011"
"9378","354580 SANTA BARBARA D'OESTE",3,14,29,2235,9,2290,"2011"
"9379","354600 SANTA BRANCA",0,2,4,153,3,162,"2011"
"9380","354610 SANTA CLARA D'OESTE",1,0,0,22,1,24,"2011"
"9381","354620 SANTA CRUZ DA CONCEICAO",0,0,0,39,0,39,"2011"
"9382","354625 SANTA CRUZ DA ESPERANCA",0,0,0,30,0,30,"2011"
"9383","354630 SANTA CRUZ DAS PALMEIRAS",1,3,4,404,0,412,"2011"
"9384","354640 SANTA CRUZ DO RIO PARDO",1,0,2,580,1,584,"2011"
"9385","354650 SANTA ERNESTINA",0,1,1,68,0,70,"2011"
"9386","354660 SANTA FE DO SUL",1,1,5,336,1,344,"2011"
"9387","354670 SANTA GERTRUDES",1,2,4,365,0,372,"2011"
"9388","354680 SANTA ISABEL",1,1,19,747,2,770,"2011"
"9389","354690 SANTA LUCIA",0,0,1,142,1,144,"2011"
"9390","354700 SANTA MARIA DA SERRA",0,0,3,76,0,79,"2011"
"9391","354710 SANTA MERCEDES",0,0,1,40,0,41,"2011"
"9392","354720 SANTANA DA PONTE PENSA",0,0,0,10,0,10,"2011"
"9393","354730 SANTANA DE PARNAIBA",4,6,14,1820,9,1853,"2011"
"9394","354740 SANTA RITA D'OESTE",0,1,0,23,0,24,"2011"
"9395","354750 SANTA RITA DO PASSA QUATRO",1,7,4,245,1,258,"2011"
"9396","354760 SANTA ROSA DE VITERBO",0,2,3,290,3,298,"2011"
"9397","354765 SANTA SALETE",0,0,0,12,0,12,"2011"
"9398","354770 SANTO ANASTACIO",0,0,1,209,0,210,"2011"
"9399","354780 SANTO ANDRE",22,30,114,8738,30,8934,"2011"
"9400","354790 SANTO ANTONIO DA ALEGRIA",0,0,0,71,1,72,"2011"
"9401","354800 SANTO ANTONIO DE POSSE",0,1,3,271,4,279,"2011"
"9402","354805 SANTO ANTONIO DO ARACANGUA",0,0,1,103,0,104,"2011"
"9403","354810 SANTO ANTONIO DO JARDIM",0,1,1,56,0,58,"2011"
"9404","354820 SANTO ANTONIO DO PINHAL",0,1,0,92,1,94,"2011"
"9405","354830 SANTO EXPEDITO",0,0,1,18,1,20,"2011"
"9406","354840 SANTOPOLIS DO AGUAPEI",0,0,0,47,0,47,"2011"
"9407","354850 SANTOS",12,20,105,4785,12,4934,"2011"
"9408","354860 SAO BENTO DO SAPUCAI",0,2,3,117,0,122,"2011"
"9409","354870 SAO BERNARDO DO CAMPO",20,35,137,10760,42,10994,"2011"
"9410","354880 SAO CAETANO DO SUL",3,4,23,1669,0,1699,"2011"
"9411","354890 SAO CARLOS",4,9,30,2867,5,2915,"2011"
"9412","354900 SAO FRANCISCO",0,0,0,31,0,31,"2011"
"9413","354910 SAO JOAO DA BOA VISTA",1,3,8,908,18,938,"2011"
"9414","354920 SAO JOAO DAS DUAS PONTES",0,0,0,33,0,33,"2011"
"9415","354925 SAO JOAO DE IRACEMA",0,0,0,13,0,13,"2011"
"9416","354930 SAO JOAO DO PAU D'ALHO",0,0,0,26,0,26,"2011"
"9417","354940 SAO JOAQUIM DA BARRA",5,1,10,614,1,631,"2011"
"9418","354950 SAO JOSE DA BELA VISTA",0,1,7,104,1,113,"2011"
"9419","354960 SAO JOSE DO BARREIRO",0,0,1,49,1,51,"2011"
"9420","354970 SAO JOSE DO RIO PARDO",4,1,11,683,0,699,"2011"
"9421","354980 SAO JOSE DO RIO PRETO",8,11,27,5173,5,5224,"2011"
"9422","354990 SAO JOSE DOS CAMPOS",15,29,104,9453,31,9632,"2011"
"9423","354995 SAO LOURENCO DA SERRA",0,1,2,176,3,182,"2011"
"9424","355000 SAO LUIS DO PARAITINGA",0,0,0,102,0,102,"2011"
"9425","355010 SAO MANUEL",2,2,12,504,0,520,"2011"
"9426","355020 SAO MIGUEL ARCANJO",3,2,11,430,1,447,"2011"
"9427","355030 SAO PAULO",530,668,2376,172270,643,176487,"2011"
"9428","355040 SAO PEDRO",0,2,3,369,1,375,"2011"
"9429","355050 SAO PEDRO DO TURVO",0,0,0,80,0,80,"2011"
"9430","355060 SAO ROQUE",2,3,16,1067,2,1090,"2011"
"9431","355070 SAO SEBASTIAO",1,4,9,1265,1,1280,"2011"
"9432","355080 SAO SEBASTIAO DA GRAMA",0,1,0,112,0,113,"2011"
"9433","355090 SAO SIMAO",2,0,0,189,2,193,"2011"
"9434","355100 SAO VICENTE",10,30,159,4982,24,5205,"2011"
"9435","355110 SARAPUI",0,0,2,125,0,127,"2011"
"9436","355120 SARUTAIA",1,0,0,49,0,50,"2011"
"9437","355130 SEBASTIANOPOLIS DO SUL",0,0,0,35,0,35,"2011"
"9438","355140 SERRA AZUL",0,1,1,120,1,123,"2011"
"9439","355150 SERRANA",1,2,8,640,1,652,"2011"
"9440","355160 SERRA NEGRA",0,0,0,319,1,320,"2011"
"9441","355170 SERTAOZINHO",2,5,10,1656,3,1676,"2011"
"9442","355180 SETE BARRAS",2,0,3,187,9,201,"2011"
"9443","355190 SEVERINIA",2,1,5,186,0,194,"2011"
"9444","355200 SILVEIRAS",1,1,2,58,2,64,"2011"
"9445","355210 SOCORRO",1,1,3,415,0,420,"2011"
"9446","355220 SOROCABA",25,41,166,8299,17,8548,"2011"
"9447","355230 SUD MENNUCCI",0,1,1,89,0,91,"2011"
"9448","355240 SUMARE",8,13,24,3705,12,3762,"2011"
"9449","355250 SUZANO",14,20,98,4193,23,4348,"2011"
"9450","355255 SUZANAPOLIS",0,0,2,36,0,38,"2011"
"9451","355260 TABAPUA",0,0,0,112,0,112,"2011"
"9452","355270 TABATINGA",0,0,2,205,0,207,"2011"
"9453","355280 TABOAO DA SERRA",14,9,63,4378,9,4473,"2011"
"9454","355290 TACIBA",0,1,3,85,1,90,"2011"
"9455","355300 TAGUAI",1,1,1,162,1,166,"2011"
"9456","355310 TAIACU",0,0,0,62,1,63,"2011"
"9457","355320 TAIUVA",1,0,0,63,0,64,"2011"
"9458","355330 TAMBAU",1,1,2,296,1,301,"2011"
"9459","355340 TANABI",0,5,9,280,0,294,"2011"
"9460","355350 TAPIRAI",1,2,3,94,1,101,"2011"
"9461","355360 TAPIRATIBA",0,2,1,142,0,145,"2011"
"9462","355365 TAQUARAL",0,0,0,44,0,44,"2011"
"9463","355370 TAQUARITINGA",0,3,12,592,5,612,"2011"
"9464","355380 TAQUARITUBA",0,0,5,341,0,346,"2011"
"9465","355385 TAQUARIVAI",1,0,4,79,0,84,"2011"
"9466","355390 TARABAI",0,1,1,96,0,98,"2011"
"9467","355395 TARUMA",0,1,3,212,0,216,"2011"
"9468","355400 TATUI",8,4,17,1670,1,1700,"2011"
"9469","355410 TAUBATE",5,10,31,3864,32,3942,"2011"
"9470","355420 TEJUPA",0,0,2,83,0,85,"2011"
"9471","355430 TEODORO SAMPAIO",0,1,6,313,0,320,"2011"
"9472","355440 TERRA ROXA",0,1,0,66,47,114,"2011"
"9473","355450 TIETE",0,6,5,470,2,483,"2011"
"9474","355460 TIMBURI",0,0,1,24,0,25,"2011"
"9475","355465 TORRE DE PEDRA",0,0,2,21,0,23,"2011"
"9476","355470 TORRINHA",0,1,2,84,0,87,"2011"
"9477","355475 TRABIJU",0,0,0,20,0,20,"2011"
"9478","355480 TREMEMBE",1,2,5,540,4,552,"2011"
"9479","355490 TRES FRONTEIRAS",1,1,1,66,0,69,"2011"
"9480","355495 TUIUTI",0,0,0,65,0,65,"2011"
"9481","355500 TUPA",2,1,14,667,0,684,"2011"
"9482","355510 TUPI PAULISTA",0,0,3,122,0,125,"2011"
"9483","355520 TURIUBA",0,0,0,19,0,19,"2011"
"9484","355530 TURMALINA",0,0,0,13,0,13,"2011"
"9485","355535 UBARANA",0,1,1,85,0,87,"2011"
"9486","355540 UBATUBA",2,4,20,1091,3,1120,"2011"
"9487","355550 UBIRAJARA",0,0,1,64,0,65,"2011"
"9488","355560 UCHOA",0,1,0,107,0,108,"2011"
"9489","355570 UNIAO PAULISTA",0,0,1,30,0,31,"2011"
"9490","355580 URANIA",0,0,1,91,0,92,"2011"
"9491","355590 URU",0,0,0,15,0,15,"2011"
"9492","355600 URUPES",0,0,0,139,0,139,"2011"
"9493","355610 VALENTIM GENTIL",1,0,3,132,0,136,"2011"
"9494","355620 VALINHOS",2,6,10,1289,1,1308,"2011"
"9495","355630 VALPARAISO",0,1,3,318,3,325,"2011"
"9496","355635 VARGEM",0,0,1,85,0,86,"2011"
"9497","355640 VARGEM GRANDE DO SUL",1,3,1,495,1,501,"2011"
"9498","355645 VARGEM GRANDE PAULISTA",1,1,8,672,2,684,"2011"
"9499","355650 VARZEA PAULISTA",3,7,37,1634,2,1683,"2011"
"9500","355660 VERA CRUZ",0,0,1,108,0,109,"2011"
"9501","355670 VINHEDO",2,2,5,896,2,907,"2011"
"9502","355680 VIRADOURO",0,0,2,253,1,256,"2011"
"9503","355690 VISTA ALEGRE DO ALTO",0,0,0,77,0,77,"2011"
"9504","355695 VITORIA BRASIL",0,0,1,31,0,32,"2011"
"9505","355700 VOTORANTIM",14,7,26,1611,6,1664,"2011"
"9506","355710 VOTUPORANGA",2,5,9,1029,0,1045,"2011"
"9507","355715 ZACARIAS",0,1,0,30,0,31,"2011"
"9508","355720 CHAVANTES",3,0,2,199,2,206,"2011"
"9509","355730 ESTIVA GERBI",1,1,2,132,2,138,"2011"
"9510","MUNICIPIO IGNORADO - PR",0,0,0,0,1,1,"2011"
"9511","410010 ABATIA",2,1,3,96,0,102,"2011"
"9512","410020 ADRIANOPOLIS",0,1,1,67,2,71,"2011"
"9513","410030 AGUDOS DO SUL",1,1,1,100,0,103,"2011"
"9514","410040 ALMIRANTE TAMANDARE",2,3,23,1841,2,1871,"2011"
"9515","410045 ALTAMIRA DO PARANA",0,0,0,59,0,59,"2011"
"9516","410050 ALTONIA",1,1,11,249,0,262,"2011"
"9517","410060 ALTO PARANA",1,2,1,184,0,188,"2011"
"9518","410070 ALTO PIQUIRI",0,2,2,129,0,133,"2011"
"9519","410080 ALVORADA DO SUL",0,0,1,90,1,92,"2011"
"9520","410090 AMAPORA",1,0,4,80,0,85,"2011"
"9521","410100 AMPERE",0,0,4,216,1,221,"2011"
"9522","410105 ANAHY",0,0,0,28,0,28,"2011"
"9523","410110 ANDIRA",0,0,4,241,1,246,"2011"
"9524","410115 ANGULO",0,0,0,37,0,37,"2011"
"9525","410120 ANTONINA",3,0,0,222,0,225,"2011"
"9526","410130 ANTONIO OLINTO",0,1,3,73,0,77,"2011"
"9527","410140 APUCARANA",5,9,19,1636,2,1671,"2011"
"9528","410150 ARAPONGAS",0,7,23,1456,0,1486,"2011"
"9529","410160 ARAPOTI",1,3,9,367,0,380,"2011"
"9530","410165 ARAPUA",0,0,1,46,0,47,"2011"
"9531","410170 ARARUNA",0,0,0,163,0,163,"2011"
"9532","410180 ARAUCARIA",6,13,27,2198,5,2249,"2011"
"9533","410185 ARIRANHA DO IVAI",0,0,0,31,0,31,"2011"
"9534","410190 ASSAI",1,1,3,216,0,221,"2011"
"9535","410200 ASSIS CHATEAUBRIAND",1,2,5,410,0,418,"2011"
"9536","410210 ASTORGA",0,1,11,337,0,349,"2011"
"9537","410220 ATALAIA",0,0,0,46,0,46,"2011"
"9538","410230 BALSA NOVA",0,4,3,169,5,181,"2011"
"9539","410240 BANDEIRANTES",1,3,4,428,0,436,"2011"
"9540","410250 BARBOSA FERRAZ",0,0,3,107,1,111,"2011"
"9541","410260 BARRACAO",0,1,1,140,0,142,"2011"
"9542","410270 BARRA DO JACARE",0,0,1,26,0,27,"2011"
"9543","410275 BELA VISTA DA CAROBA",0,0,1,52,0,53,"2011"
"9544","410280 BELA VISTA DO PARAISO",1,1,1,225,0,228,"2011"
"9545","410290 BITURUNA",0,0,1,233,0,234,"2011"
"9546","410300 BOA ESPERANCA",0,0,0,40,0,40,"2011"
"9547","410302 BOA ESPERANCA DO IGUACU",0,0,0,42,1,43,"2011"
"9548","410304 BOA VENTURA DE SAO ROQUE",0,0,0,91,1,92,"2011"
"9549","410305 BOA VISTA DA APARECIDA",0,0,1,95,1,97,"2011"
"9550","410310 BOCAIUVA DO SUL",0,1,3,136,0,140,"2011"
"9551","410315 BOM JESUS DO SUL",0,0,0,48,1,49,"2011"
"9552","410320 BOM SUCESSO",0,0,8,99,0,107,"2011"
"9553","410322 BOM SUCESSO DO SUL",0,0,0,43,0,43,"2011"
"9554","410330 BORRAZOPOLIS",1,1,1,82,0,85,"2011"
"9555","410335 BRAGANEY",0,0,1,53,1,55,"2011"
"9556","410337 BRASILANDIA DO SUL",0,0,0,38,0,38,"2011"
"9557","410340 CAFEARA",0,0,1,27,0,28,"2011"
"9558","410345 CAFELANDIA",0,1,2,217,0,220,"2011"
"9559","410347 CAFEZAL DO SUL",0,1,3,40,0,44,"2011"
"9560","410350 CALIFORNIA",0,0,0,86,0,86,"2011"
"9561","410360 CAMBARA",0,1,6,283,0,290,"2011"
"9562","410370 CAMBE",5,5,17,1244,0,1271,"2011"
"9563","410380 CAMBIRA",0,1,3,101,0,105,"2011"
"9564","410390 CAMPINA DA LAGOA",1,0,0,205,0,206,"2011"
"9565","410395 CAMPINA DO SIMAO",0,0,1,52,1,54,"2011"
"9566","410400 CAMPINA GRANDE DO SUL",1,1,9,705,1,717,"2011"
"9567","410405 CAMPO BONITO",0,0,0,50,0,50,"2011"
"9568","410410 CAMPO DO TENENTE",1,0,0,121,1,123,"2011"
"9569","410420 CAMPO LARGO",7,9,37,1632,26,1711,"2011"
"9570","410425 CAMPO MAGRO",0,5,12,446,1,464,"2011"
"9571","410430 CAMPO MOURAO",0,3,12,1203,1,1219,"2011"
"9572","410440 CANDIDO DE ABREU",0,2,4,210,0,216,"2011"
"9573","410442 CANDOI",0,0,5,224,0,229,"2011"
"9574","410445 CANTAGALO",1,0,1,182,0,184,"2011"
"9575","410450 CAPANEMA",1,2,0,214,0,217,"2011"
"9576","410460 CAPITAO LEONIDAS MARQUES",0,1,5,198,0,204,"2011"
"9577","410465 CARAMBEI",1,3,9,362,0,375,"2011"
"9578","410470 CARLOPOLIS",1,0,0,187,0,188,"2011"
"9579","410480 CASCAVEL",4,22,98,4237,11,4372,"2011"
"9580","410490 CASTRO",3,10,6,1157,4,1180,"2011"
"9581","410500 CATANDUVAS",0,0,0,131,0,131,"2011"
"9582","410510 CENTENARIO DO SUL",0,1,4,130,1,136,"2011"
"9583","410520 CERRO AZUL",1,1,3,189,2,196,"2011"
"9584","410530 CEU AZUL",0,0,2,114,0,116,"2011"
"9585","410540 CHOPINZINHO",0,1,7,261,0,269,"2011"
"9586","410550 CIANORTE",2,3,4,988,0,997,"2011"
"9587","410560 CIDADE GAUCHA",0,1,1,155,0,157,"2011"
"9588","410570 CLEVELANDIA",0,2,7,257,0,266,"2011"
"9589","410580 COLOMBO",9,10,50,3656,10,3735,"2011"
"9590","410590 COLORADO",1,0,3,291,0,295,"2011"
"9591","410600 CONGONHINHAS",2,0,0,112,0,114,"2011"
"9592","410610 CONSELHEIRO MAIRINCK",0,0,0,44,0,44,"2011"
"9593","410620 CONTENDA",0,1,5,187,1,194,"2011"
"9594","410630 CORBELIA",0,2,7,198,0,207,"2011"
"9595","410640 CORNELIO PROCOPIO",0,2,8,541,1,552,"2011"
"9596","410645 CORONEL DOMINGOS SOARES",0,0,3,111,0,114,"2011"
"9597","410650 CORONEL VIVIDA",0,3,0,257,0,260,"2011"
"9598","410655 CORUMBATAI DO SUL",0,0,2,43,0,45,"2011"
"9599","410657 CRUZEIRO DO IGUACU",0,0,0,56,0,56,"2011"
"9600","410660 CRUZEIRO DO OESTE",0,0,3,265,0,268,"2011"
"9601","410670 CRUZEIRO DO SUL",1,0,1,88,0,90,"2011"
"9602","410680 CRUZ MACHADO",1,1,0,210,1,213,"2011"
"9603","410685 CRUZMALTINA",0,0,2,36,1,39,"2011"
"9604","410690 CURITIBA",42,91,341,24730,45,25249,"2011"
"9605","410700 CURIUVA",0,0,0,180,0,180,"2011"
"9606","410710 DIAMANTE DO NORTE",0,0,0,54,0,54,"2011"
"9607","410712 DIAMANTE DO SUL",0,1,2,42,0,45,"2011"
"9608","410715 DIAMANTE D'OESTE",1,1,1,66,3,72,"2011"
"9609","410720 DOIS VIZINHOS",1,2,1,526,1,531,"2011"
"9610","410725 DOURADINA",1,0,1,111,0,113,"2011"
"9611","410730 DOUTOR CAMARGO",0,0,0,59,0,59,"2011"
"9612","410740 ENEAS MARQUES",0,0,1,61,0,62,"2011"
"9613","410750 ENGENHEIRO BELTRAO",0,1,5,152,0,158,"2011"
"9614","410752 ESPERANCA NOVA",0,0,0,18,0,18,"2011"
"9615","410753 ENTRE RIOS DO OESTE",1,0,1,45,0,47,"2011"
"9616","410754 ESPIGAO ALTO DO IGUACU",0,0,3,70,0,73,"2011"
"9617","410755 FAROL",0,0,0,57,0,57,"2011"
"9618","410760 FAXINAL",1,1,14,251,1,268,"2011"
"9619","410765 FAZENDA RIO GRANDE",5,10,22,1554,4,1595,"2011"
"9620","410770 FENIX",0,1,0,47,0,48,"2011"
"9621","410773 FERNANDES PINHEIRO",0,0,0,110,0,110,"2011"
"9622","410775 FIGUEIRA",0,1,3,110,0,114,"2011"
"9623","410780 FLORAI",0,0,0,55,1,56,"2011"
"9624","410785 FLOR DA SERRA DO SUL",0,0,0,59,0,59,"2011"
"9625","410790 FLORESTA",1,1,1,81,0,84,"2011"
"9626","410800 FLORESTOPOLIS",0,0,2,176,0,178,"2011"
"9627","410810 FLORIDA",0,0,1,26,0,27,"2011"
"9628","410820 FORMOSA DO OESTE",0,0,0,69,0,69,"2011"
"9629","410830 FOZ DO IGUACU",7,6,35,4253,11,4312,"2011"
"9630","410832 FRANCISCO ALVES",0,1,1,76,0,78,"2011"
"9631","410840 FRANCISCO BELTRAO",5,5,11,1168,0,1189,"2011"
"9632","410845 FOZ DO JORDAO",0,2,0,98,0,100,"2011"
"9633","410850 GENERAL CARNEIRO",0,0,6,179,1,186,"2011"
"9634","410855 GODOY MOREIRA",0,0,1,32,0,33,"2011"
"9635","410860 GOIOERE",2,2,3,334,0,341,"2011"
"9636","410865 GOIOXIM",0,0,1,107,0,108,"2011"
"9637","410870 GRANDES RIOS",0,0,4,71,0,75,"2011"
"9638","410880 GUAIRA",0,3,9,522,0,534,"2011"
"9639","410890 GUAIRACA",2,0,2,93,0,97,"2011"
"9640","410895 GUAMIRANGA",2,0,2,131,1,136,"2011"
"9641","410900 GUAPIRAMA",0,0,0,50,0,50,"2011"
"9642","410910 GUAPOREMA",0,0,0,22,0,22,"2011"
"9643","410920 GUARACI",0,0,1,61,0,62,"2011"
"9644","410930 GUARANIACU",0,0,3,195,0,198,"2011"
"9645","410940 GUARAPUAVA",13,14,25,2776,5,2833,"2011"
"9646","410950 GUARAQUECABA",0,1,3,99,0,103,"2011"
"9647","410960 GUARATUBA",1,4,10,389,2,406,"2011"
"9648","410965 HONORIO SERPA",1,0,0,69,0,70,"2011"
"9649","410970 IBAITI",0,3,19,387,0,409,"2011"
"9650","410975 IBEMA",0,0,4,97,0,101,"2011"
"9651","410980 IBIPORA",1,0,3,655,1,660,"2011"
"9652","410990 ICARAIMA",0,0,3,113,0,116,"2011"
"9653","411000 IGUARACU",1,1,0,49,0,51,"2011"
"9654","411005 IGUATU",0,0,0,27,0,27,"2011"
"9655","411007 IMBAU",0,0,2,154,2,158,"2011"
"9656","411010 IMBITUVA",0,0,4,432,0,436,"2011"
"9657","411020 INACIO MARTINS",2,0,2,136,0,140,"2011"
"9658","411030 INAJA",0,1,0,38,0,39,"2011"
"9659","411040 INDIANOPOLIS",0,0,1,61,0,62,"2011"
"9660","411050 IPIRANGA",0,0,11,175,0,186,"2011"
"9661","411060 IPORA",0,1,7,177,0,185,"2011"
"9662","411065 IRACEMA DO OESTE",1,1,1,22,0,25,"2011"
"9663","411070 IRATI",0,3,2,809,0,814,"2011"
"9664","411080 IRETAMA",0,0,1,158,0,159,"2011"
"9665","411090 ITAGUAJE",0,0,2,52,0,54,"2011"
"9666","411095 ITAIPULANDIA",0,1,3,133,0,137,"2011"
"9667","411100 ITAMBARACA",0,1,2,72,0,75,"2011"
"9668","411110 ITAMBE",0,1,2,75,0,78,"2011"
"9669","411120 ITAPEJARA D'OESTE",0,0,3,115,1,119,"2011"
"9670","411125 ITAPERUCU",0,2,3,492,0,497,"2011"
"9671","411130 ITAUNA DO SUL",1,1,0,58,0,60,"2011"
"9672","411140 IVAI",0,1,0,197,0,198,"2011"
"9673","411150 IVAIPORA",0,1,2,379,0,382,"2011"
"9674","411155 IVATE",0,0,6,104,0,110,"2011"
"9675","411160 IVATUBA",0,0,0,26,0,26,"2011"
"9676","411170 JABOTI",0,0,0,70,0,70,"2011"
"9677","411180 JACAREZINHO",3,2,2,555,2,564,"2011"
"9678","411190 JAGUAPITA",2,0,0,172,0,174,"2011"
"9679","411200 JAGUARIAIVA",4,5,9,486,1,505,"2011"
"9680","411210 JANDAIA DO SUL",1,1,1,254,0,257,"2011"
"9681","411220 JANIOPOLIS",0,0,2,67,0,69,"2011"
"9682","411230 JAPIRA",1,0,2,53,0,56,"2011"
"9683","411240 JAPURA",0,0,1,101,0,102,"2011"
"9684","411250 JARDIM ALEGRE",0,1,4,140,0,145,"2011"
"9685","411260 JARDIM OLINDA",0,0,1,29,0,30,"2011"
"9686","411270 JATAIZINHO",0,0,3,175,0,178,"2011"
"9687","411275 JESUITAS",0,1,2,81,0,84,"2011"
"9688","411280 JOAQUIM TAVORA",0,0,1,130,0,131,"2011"
"9689","411290 JUNDIAI DO SUL",0,0,0,33,0,33,"2011"
"9690","411295 JURANDA",1,0,0,101,0,102,"2011"
"9691","411300 JUSSARA",0,0,1,89,0,90,"2011"
"9692","411310 KALORE",1,2,1,39,0,43,"2011"
"9693","411320 LAPA",1,4,11,607,0,623,"2011"
"9694","411325 LARANJAL",0,2,0,96,1,99,"2011"
"9695","411330 LARANJEIRAS DO SUL",1,3,10,477,0,491,"2011"
"9696","411340 LEOPOLIS",2,0,1,54,0,57,"2011"
"9697","411342 LIDIANOPOLIS",0,0,0,53,0,53,"2011"
"9698","411345 LINDOESTE",0,0,2,69,0,71,"2011"
"9699","411350 LOANDA",3,2,1,308,0,314,"2011"
"9700","411360 LOBATO",0,0,0,58,0,58,"2011"
"9701","411370 LONDRINA",30,33,82,6855,22,7022,"2011"
"9702","411373 LUIZIANA",0,0,2,120,0,122,"2011"
"9703","411375 LUNARDELLI",0,1,3,59,0,63,"2011"
"9704","411380 LUPIONOPOLIS",1,0,2,60,0,63,"2011"
"9705","411390 MALLET",0,1,3,144,0,148,"2011"
"9706","411400 MAMBORE",0,1,4,166,0,171,"2011"
"9707","411410 MANDAGUACU",1,2,0,270,0,273,"2011"
"9708","411420 MANDAGUARI",1,1,3,443,0,448,"2011"
"9709","411430 MANDIRITUBA",1,5,6,403,4,419,"2011"
"9710","411435 MANFRINOPOLIS",0,0,0,33,0,33,"2011"
"9711","411440 MANGUEIRINHA",3,2,9,248,0,262,"2011"
"9712","411450 MANOEL RIBAS",2,1,2,224,0,229,"2011"
"9713","411460 MARECHAL CANDIDO RONDON",2,1,11,616,0,630,"2011"
"9714","411470 MARIA HELENA",0,1,2,79,0,82,"2011"
"9715","411480 MARIALVA",2,1,4,420,0,427,"2011"
"9716","411490 MARILANDIA DO SUL",0,0,0,120,1,121,"2011"
"9717","411500 MARILENA",0,0,2,89,0,91,"2011"
"9718","411510 MARILUZ",0,2,4,160,0,166,"2011"
"9719","411520 MARINGA",5,22,108,4646,2,4783,"2011"
"9720","411530 MARIOPOLIS",1,0,0,90,0,91,"2011"
"9721","411535 MARIPA",0,0,0,64,0,64,"2011"
"9722","411540 MARMELEIRO",4,0,0,156,1,161,"2011"
"9723","411545 MARQUINHO",0,1,4,71,1,77,"2011"
"9724","411550 MARUMBI",0,0,1,61,0,62,"2011"
"9725","411560 MATELANDIA",1,2,5,222,0,230,"2011"
"9726","411570 MATINHOS",1,5,9,451,0,466,"2011"
"9727","411573 MATO RICO",0,0,2,44,0,46,"2011"
"9728","411575 MAUA DA SERRA",0,1,3,149,1,154,"2011"
"9729","411580 MEDIANEIRA",0,0,24,567,0,591,"2011"
"9730","411585 MERCEDES",0,0,3,62,0,65,"2011"
"9731","411590 MIRADOR",0,0,0,26,0,26,"2011"
"9732","411600 MIRASELVA",0,0,0,28,0,28,"2011"
"9733","411605 MISSAL",0,2,1,132,0,135,"2011"
"9734","411610 MOREIRA SALES",2,0,0,145,0,147,"2011"
"9735","411620 MORRETES",1,1,3,201,1,207,"2011"
"9736","411630 MUNHOZ DE MELO",0,1,1,37,0,39,"2011"
"9737","411640 NOSSA SENHORA DAS GRACAS",0,0,0,44,0,44,"2011"
"9738","411650 NOVA ALIANCA DO IVAI",0,0,0,24,0,24,"2011"
"9739","411660 NOVA AMERICA DA COLINA",0,0,1,47,0,48,"2011"
"9740","411670 NOVA AURORA",0,0,1,121,0,122,"2011"
"9741","411680 NOVA CANTU",0,1,2,96,0,99,"2011"
"9742","411690 NOVA ESPERANCA",2,3,5,316,0,326,"2011"
"9743","411695 NOVA ESPERANCA DO SUDOESTE",0,0,2,70,0,72,"2011"
"9744","411700 NOVA FATIMA",0,1,5,85,0,91,"2011"
"9745","411705 NOVA LARANJEIRAS",1,0,1,192,2,196,"2011"
"9746","411710 NOVA LONDRINA",0,2,2,165,0,169,"2011"
"9747","411720 NOVA OLIMPIA",0,3,1,57,0,61,"2011"
"9748","411721 NOVA SANTA BARBARA",0,0,1,47,0,48,"2011"
"9749","411722 NOVA SANTA ROSA",0,0,2,111,1,114,"2011"
"9750","411725 NOVA PRATA DO IGUACU",1,0,1,115,0,117,"2011"
"9751","411727 NOVA TEBAS",0,1,3,94,0,98,"2011"
"9752","411729 NOVO ITACOLOMI",0,0,1,29,0,30,"2011"
"9753","411730 ORTIGUEIRA",1,3,2,306,1,313,"2011"
"9754","411740 OURIZONA",0,0,0,41,0,41,"2011"
"9755","411745 OURO VERDE DO OESTE",0,1,1,71,0,73,"2011"
"9756","411750 PAICANDU",1,1,3,467,0,472,"2011"
"9757","411760 PALMAS",3,4,3,785,9,804,"2011"
"9758","411770 PALMEIRA",0,2,7,450,1,460,"2011"
"9759","411780 PALMITAL",0,0,4,191,0,195,"2011"
"9760","411790 PALOTINA",3,4,4,428,0,439,"2011"
"9761","411800 PARAISO DO NORTE",0,0,0,159,0,159,"2011"
"9762","411810 PARANACITY",0,0,3,119,0,122,"2011"
"9763","411820 PARANAGUA",8,12,39,2326,11,2396,"2011"
"9764","411830 PARANAPOEMA",0,1,0,46,0,47,"2011"
"9765","411840 PARANAVAI",2,2,4,1197,1,1206,"2011"
"9766","411845 PATO BRAGADO",0,1,3,45,0,49,"2011"
"9767","411850 PATO BRANCO",2,7,3,1095,0,1107,"2011"
"9768","411860 PAULA FREITAS",0,0,0,59,0,59,"2011"
"9769","411870 PAULO FRONTIN",0,0,1,78,0,79,"2011"
"9770","411880 PEABIRU",1,2,0,187,0,190,"2011"
"9771","411885 PEROBAL",0,1,1,75,0,77,"2011"
"9772","411890 PEROLA",0,0,5,121,0,126,"2011"
"9773","411900 PEROLA D'OESTE",0,1,0,77,0,78,"2011"
"9774","411910 PIEN",0,3,2,149,2,156,"2011"
"9775","411915 PINHAIS",4,7,22,1878,1,1912,"2011"
"9776","411920 PINHALAO",0,0,1,83,0,84,"2011"
"9777","411925 PINHAL DE SAO BENTO",0,0,0,46,0,46,"2011"
"9778","411930 PINHAO",1,2,7,498,10,518,"2011"
"9779","411940 PIRAI DO SUL",0,2,5,374,0,381,"2011"
"9780","411950 PIRAQUARA",3,12,18,1453,4,1490,"2011"
"9781","411960 PITANGA",0,7,18,479,0,504,"2011"
"9782","411965 PITANGUEIRAS",0,1,1,40,0,42,"2011"
"9783","411970 PLANALTINA DO PARANA",0,0,0,60,0,60,"2011"
"9784","411980 PLANALTO",0,0,1,118,0,119,"2011"
"9785","411990 PONTA GROSSA",12,25,131,4982,4,5154,"2011"
"9786","411995 PONTAL DO PARANA",2,2,8,276,2,290,"2011"
"9787","412000 PORECATU",0,0,2,153,0,155,"2011"
"9788","412010 PORTO AMAZONAS",0,0,0,68,0,68,"2011"
"9789","412015 PORTO BARREIRO",0,0,0,39,0,39,"2011"
"9790","412020 PORTO RICO",0,0,0,27,0,27,"2011"
"9791","412030 PORTO VITORIA",0,0,1,53,0,54,"2011"
"9792","412033 PRADO FERREIRA",0,1,1,39,0,41,"2011"
"9793","412035 PRANCHITA",0,0,0,73,0,73,"2011"
"9794","412040 PRESIDENTE CASTELO BRANCO",0,0,1,66,0,67,"2011"
"9795","412050 PRIMEIRO DE MAIO",0,0,3,110,0,113,"2011"
"9796","412060 PRUDENTOPOLIS",1,5,13,653,1,673,"2011"
"9797","412065 QUARTO CENTENARIO",1,0,1,65,0,67,"2011"
"9798","412070 QUATIGUA",0,0,1,98,0,99,"2011"
"9799","412080 QUATRO BARRAS",0,2,2,306,1,311,"2011"
"9800","412085 QUATRO PONTES",0,0,1,34,0,35,"2011"
"9801","412090 QUEDAS DO IGUACU",0,4,6,491,1,502,"2011"
"9802","412100 QUERENCIA DO NORTE",1,1,6,200,0,208,"2011"
"9803","412110 QUINTA DO SOL",0,0,2,66,0,68,"2011"
"9804","412120 QUITANDINHA",1,1,3,213,1,219,"2011"
"9805","412125 RAMILANDIA",0,1,1,48,0,50,"2011"
"9806","412130 RANCHO ALEGRE",0,0,1,41,0,42,"2011"
"9807","412135 RANCHO ALEGRE D'OESTE",0,0,0,35,0,35,"2011"
"9808","412140 REALEZA",0,1,0,232,0,233,"2011"
"9809","412150 REBOUCAS",0,1,0,187,1,189,"2011"
"9810","412160 RENASCENCA",1,0,0,84,1,86,"2011"
"9811","412170 RESERVA",1,0,3,410,2,416,"2011"
"9812","412175 RESERVA DO IGUACU",0,2,5,102,1,110,"2011"
"9813","412180 RIBEIRAO CLARO",0,0,2,130,0,132,"2011"
"9814","412190 RIBEIRAO DO PINHAL",3,0,4,174,0,181,"2011"
"9815","412200 RIO AZUL",0,0,1,186,1,188,"2011"
"9816","412210 RIO BOM",0,0,1,34,0,35,"2011"
"9817","412215 RIO BONITO DO IGUACU",1,1,5,191,0,198,"2011"
"9818","412217 RIO BRANCO DO IVAI",0,0,3,61,0,64,"2011"
"9819","412220 RIO BRANCO DO SUL",4,5,6,550,4,569,"2011"
"9820","412230 RIO NEGRO",1,0,2,363,0,366,"2011"
"9821","412240 ROLANDIA",1,5,14,819,0,839,"2011"
"9822","412250 RONCADOR",0,0,1,134,0,135,"2011"
"9823","412260 RONDON",1,0,1,126,0,128,"2011"
"9824","412265 ROSARIO DO IVAI",0,0,1,73,0,74,"2011"
"9825","412270 SABAUDIA",0,0,0,69,0,69,"2011"
"9826","412280 SALGADO FILHO",0,1,0,52,0,53,"2011"
"9827","412290 SALTO DO ITARARE",0,0,1,56,0,57,"2011"
"9828","412300 SALTO DO LONTRA",0,1,2,175,0,178,"2011"
"9829","412310 SANTA AMELIA",0,1,0,59,0,60,"2011"
"9830","412320 SANTA CECILIA DO PAVAO",0,1,2,38,0,41,"2011"
"9831","412330 SANTA CRUZ DE MONTE CASTELO",0,0,0,93,0,93,"2011"
"9832","412340 SANTA FE",0,0,2,131,0,133,"2011"
"9833","412350 SANTA HELENA",0,0,4,309,0,313,"2011"
"9834","412360 SANTA INES",0,0,0,20,0,20,"2011"
"9835","412370 SANTA ISABEL DO IVAI",1,1,1,107,0,110,"2011"
"9836","412380 SANTA IZABEL DO OESTE",0,0,1,142,0,143,"2011"
"9837","412382 SANTA LUCIA",0,0,2,52,0,54,"2011"
"9838","412385 SANTA MARIA DO OESTE",1,2,4,145,0,152,"2011"
"9839","412390 SANTA MARIANA",0,2,1,132,0,135,"2011"
"9840","412395 SANTA MONICA",0,0,0,44,0,44,"2011"
"9841","412400 SANTANA DO ITARARE",0,0,0,65,0,65,"2011"
"9842","412402 SANTA TEREZA DO OESTE",0,1,1,177,0,179,"2011"
"9843","412405 SANTA TEREZINHA DE ITAIPU",1,0,2,267,0,270,"2011"
"9844","412410 SANTO ANTONIO DA PLATINA",2,1,6,611,0,620,"2011"
"9845","412420 SANTO ANTONIO DO CAIUA",0,0,0,24,0,24,"2011"
"9846","412430 SANTO ANTONIO DO PARAISO",0,0,0,32,0,32,"2011"
"9847","412440 SANTO ANTONIO DO SUDOESTE",1,0,1,294,1,297,"2011"
"9848","412450 SANTO INACIO",0,1,0,76,0,77,"2011"
"9849","412460 SAO CARLOS DO IVAI",0,0,0,71,0,71,"2011"
"9850","412470 SAO JERONIMO DA SERRA",0,1,4,155,0,160,"2011"
"9851","412480 SAO JOAO",0,0,3,102,0,105,"2011"
"9852","412490 SAO JOAO DO CAIUA",0,0,0,84,1,85,"2011"
"9853","412500 SAO JOAO DO IVAI",1,0,3,137,0,141,"2011"
"9854","412510 SAO JOAO DO TRIUNFO",1,1,2,172,1,177,"2011"
"9855","412520 SAO JORGE D'OESTE",1,1,0,119,0,121,"2011"
"9856","412530 SAO JORGE DO IVAI",0,1,0,51,0,52,"2011"
"9857","412535 SAO JORGE DO PATROCINIO",0,0,1,75,0,76,"2011"
"9858","412540 SAO JOSE DA BOA VISTA",0,0,0,63,0,63,"2011"
"9859","412545 SAO JOSE DAS PALMEIRAS",0,0,1,54,0,55,"2011"
"9860","412550 SAO JOSE DOS PINHAIS",10,22,84,4378,12,4506,"2011"
"9861","412555 SAO MANOEL DO PARANA",0,0,1,25,0,26,"2011"
"9862","412560 SAO MATEUS DO SUL",3,0,6,629,1,639,"2011"
"9863","412570 SAO MIGUEL DO IGUACU",1,0,8,307,1,317,"2011"
"9864","412575 SAO PEDRO DO IGUACU",0,0,0,80,0,80,"2011"
"9865","412580 SAO PEDRO DO IVAI",0,0,5,127,0,132,"2011"
"9866","412590 SAO PEDRO DO PARANA",0,2,0,38,0,40,"2011"
"9867","412600 SAO SEBASTIAO DA AMOREIRA",0,1,2,124,0,127,"2011"
"9868","412610 SAO TOME",0,1,1,77,0,79,"2011"
"9869","412620 SAPOPEMA",0,2,3,80,0,85,"2011"
"9870","412625 SARANDI",2,4,19,1288,0,1313,"2011"
"9871","412627 SAUDADE DO IGUACU",0,0,0,84,0,84,"2011"
"9872","412630 SENGES",1,2,6,260,1,270,"2011"
"9873","412635 SERRANOPOLIS DO IGUACU",0,0,2,54,0,56,"2011"
"9874","412640 SERTANEJA",1,0,1,75,0,77,"2011"
"9875","412650 SERTANOPOLIS",0,0,4,190,0,194,"2011"
"9876","412660 SIQUEIRA CAMPOS",0,1,1,264,0,266,"2011"
"9877","412665 SULINA",0,0,1,38,0,39,"2011"
"9878","412667 TAMARANA",0,0,4,156,0,160,"2011"
"9879","412670 TAMBOARA",2,2,1,63,0,68,"2011"
"9880","412680 TAPEJARA",0,0,1,228,0,229,"2011"
"9881","412690 TAPIRA",0,1,2,51,0,54,"2011"
"9882","412700 TEIXEIRA SOARES",0,2,0,134,0,136,"2011"
"9883","412710 TELEMACO BORBA",1,1,8,1092,3,1105,"2011"
"9884","412720 TERRA BOA",0,0,5,194,0,199,"2011"
"9885","412730 TERRA RICA",0,1,2,214,0,217,"2011"
"9886","412740 TERRA ROXA",1,1,2,199,0,203,"2011"
"9887","412750 TIBAGI",1,0,6,277,4,288,"2011"
"9888","412760 TIJUCAS DO SUL",0,0,4,204,0,208,"2011"
"9889","412770 TOLEDO",8,5,15,1727,0,1755,"2011"
"9890","412780 TOMAZINA",0,1,1,84,0,86,"2011"
"9891","412785 TRES BARRAS DO PARANA",1,1,7,174,2,185,"2011"
"9892","412788 TUNAS DO PARANA",1,1,1,144,3,150,"2011"
"9893","412790 TUNEIRAS DO OESTE",1,0,1,117,0,119,"2011"
"9894","412795 TUPASSI",0,0,2,88,0,90,"2011"
"9895","412796 TURVO",1,1,3,253,2,260,"2011"
"9896","412800 UBIRATA",0,0,1,276,0,277,"2011"
"9897","412810 UMUARAMA",4,4,33,1390,1,1432,"2011"
"9898","412820 UNIAO DA VITORIA",3,1,5,745,4,758,"2011"
"9899","412830 UNIFLOR",0,0,0,34,0,34,"2011"
"9900","412840 URAI",1,0,2,134,0,137,"2011"
"9901","412850 WENCESLAU BRAZ",0,0,3,259,0,262,"2011"
"9902","412853 VENTANIA",1,0,0,134,2,137,"2011"
"9903","412855 VERA CRUZ DO OESTE",0,0,6,88,0,94,"2011"
"9904","412860 VERE",1,0,0,88,0,89,"2011"
"9905","412862 ALTO PARAISO",0,0,0,37,0,37,"2011"
"9906","412863 DOUTOR ULYSSES",0,0,1,64,0,65,"2011"
"9907","412865 VIRMOND",1,1,1,44,0,47,"2011"
"9908","412870 VITORINO",1,0,1,82,1,85,"2011"
"9909","412880 XAMBRE",0,0,0,71,0,71,"2011"
"9910","MUNICIPIO IGNORADO - SC",0,0,0,1,0,1,"2011"
"9911","420005 ABDON BATISTA",0,0,0,32,0,32,"2011"
"9912","420010 ABELARDO LUZ",2,2,1,242,2,249,"2011"
"9913","420020 AGROLANDIA",0,0,2,127,0,129,"2011"
"9914","420030 AGRONOMICA",0,1,1,61,0,63,"2011"
"9915","420040 AGUA DOCE",0,0,1,88,0,89,"2011"
"9916","420050 AGUAS DE CHAPECO",0,0,2,57,0,59,"2011"
"9917","420055 AGUAS FRIAS",0,0,0,36,0,36,"2011"
"9918","420060 AGUAS MORNAS",1,0,0,62,0,63,"2011"
"9919","420070 ALFREDO WAGNER",1,0,0,116,0,117,"2011"
"9920","420075 ALTO BELA VISTA",0,0,0,17,0,17,"2011"
"9921","420080 ANCHIETA",0,0,0,59,0,59,"2011"
"9922","420090 ANGELINA",0,0,2,56,0,58,"2011"
"9923","420100 ANITA GARIBALDI",0,2,6,90,0,98,"2011"
"9924","420110 ANITAPOLIS",0,0,0,31,0,31,"2011"
"9925","420120 ANTONIO CARLOS",0,1,1,100,0,102,"2011"
"9926","420125 APIUNA",0,1,3,121,1,126,"2011"
"9927","420127 ARABUTA",0,0,0,39,0,39,"2011"
"9928","420130 ARAQUARI",0,1,6,431,3,441,"2011"
"9929","420140 ARARANGUA",2,4,12,854,2,874,"2011"
"9930","420150 ARMAZEM",0,0,2,102,0,104,"2011"
"9931","420160 ARROIO TRINTA",0,0,1,24,0,25,"2011"
"9932","420165 ARVOREDO",0,0,0,19,0,19,"2011"
"9933","420170 ASCURRA",0,0,0,80,0,80,"2011"
"9934","420180 ATALANTA",1,1,2,34,1,39,"2011"
"9935","420190 AURORA",0,0,1,66,0,67,"2011"
"9936","420195 BALNEARIO ARROIO DO SILVA",0,0,2,146,0,148,"2011"
"9937","420200 BALNEARIO CAMBORIU",6,5,13,1289,1,1314,"2011"
"9938","420205 BALNEARIO BARRA DO SUL",0,1,2,102,0,105,"2011"
"9939","420207 BALNEARIO GAIVOTA",1,0,1,101,0,103,"2011"
"9940","420208 BANDEIRANTE",0,0,2,21,0,23,"2011"
"9941","420209 BARRA BONITA",0,1,1,26,0,28,"2011"
"9942","420210 BARRA VELHA",2,2,7,360,5,376,"2011"
"9943","420213 BELA VISTA DO TOLDO",3,0,2,79,1,85,"2011"
"9944","420215 BELMONTE",0,0,0,26,0,26,"2011"
"9945","420220 BENEDITO NOVO",0,0,0,123,0,123,"2011"
"9946","420230 BIGUACU",2,3,17,826,3,851,"2011"
"9947","420240 BLUMENAU",3,10,46,4161,0,4220,"2011"
"9948","420243 BOCAINA DO SUL",2,1,1,37,0,41,"2011"
"9949","420245 BOMBINHAS",0,1,2,232,0,235,"2011"
"9950","420250 BOM JARDIM DA SERRA",0,0,2,42,0,44,"2011"
"9951","420253 BOM JESUS",0,0,1,37,1,39,"2011"
"9952","420257 BOM JESUS DO OESTE",0,0,0,25,0,25,"2011"
"9953","420260 BOM RETIRO",0,0,2,117,0,119,"2011"
"9954","420270 BOTUVERA",0,0,1,53,0,54,"2011"
"9955","420280 BRACO DO NORTE",2,1,2,444,2,451,"2011"
"9956","420285 BRACO DO TROMBUDO",0,0,0,43,0,43,"2011"
"9957","420287 BRUNOPOLIS",0,0,0,37,0,37,"2011"
"9958","420290 BRUSQUE",1,6,22,1489,0,1518,"2011"
"9959","420300 CACADOR",7,9,46,1113,0,1175,"2011"
"9960","420310 CAIBI",1,0,1,63,0,65,"2011"
"9961","420315 CALMON",0,0,3,49,0,52,"2011"
"9962","420320 CAMBORIU",3,3,12,960,0,978,"2011"
"9963","420325 CAPAO ALTO",0,0,2,29,0,31,"2011"
"9964","420330 CAMPO ALEGRE",0,0,3,152,3,158,"2011"
"9965","420340 CAMPO BELO DO SUL",1,0,6,85,0,92,"2011"
"9966","420350 CAMPO ERE",0,0,1,122,0,123,"2011"
"9967","420360 CAMPOS NOVOS",1,1,3,482,2,489,"2011"
"9968","420370 CANELINHA",0,1,5,118,0,124,"2011"
"9969","420380 CANOINHAS",1,8,27,779,0,815,"2011"
"9970","420390 CAPINZAL",0,0,2,282,0,284,"2011"
"9971","420395 CAPIVARI DE BAIXO",0,1,2,323,1,327,"2011"
"9972","420400 CATANDUVAS",0,0,0,152,0,152,"2011"
"9973","420410 CAXAMBU DO SUL",0,0,0,42,0,42,"2011"
"9974","420415 CELSO RAMOS",0,0,0,42,0,42,"2011"
"9975","420417 CERRO NEGRO",0,1,1,37,1,40,"2011"
"9976","420419 CHAPADAO DO LAGEADO",0,0,5,38,0,43,"2011"
"9977","420420 CHAPECO",11,13,47,2765,7,2843,"2011"
"9978","420425 COCAL DO SUL",0,0,2,178,0,180,"2011"
"9979","420430 CONCORDIA",0,1,12,942,3,958,"2011"
"9980","420435 CORDILHEIRA ALTA",0,1,1,33,0,35,"2011"
"9981","420440 CORONEL FREITAS",0,0,0,105,0,105,"2011"
"9982","420445 CORONEL MARTINS",0,0,0,35,0,35,"2011"
"9983","420450 CORUPA",0,0,4,201,0,205,"2011"
"9984","420455 CORREIA PINTO",0,1,11,184,3,199,"2011"
"9985","420460 CRICIUMA",3,5,33,2693,2,2736,"2011"
"9986","420470 CUNHA PORA",0,0,1,92,0,93,"2011"
"9987","420475 CUNHATAI",0,0,0,10,0,10,"2011"
"9988","420480 CURITIBANOS",1,1,6,584,2,594,"2011"
"9989","420490 DESCANSO",0,0,1,67,0,68,"2011"
"9990","420500 DIONISIO CERQUEIRA",1,1,6,225,1,234,"2011"
"9991","420510 DONA EMMA",1,1,0,50,0,52,"2011"
"9992","420515 DOUTOR PEDRINHO",0,0,0,33,0,33,"2011"
"9993","420517 ENTRE RIOS",1,0,1,31,0,33,"2011"
"9994","420519 ERMO",0,0,0,28,0,28,"2011"
"9995","420520 ERVAL VELHO",0,0,1,41,0,42,"2011"
"9996","420530 FAXINAL DOS GUEDES",1,0,0,160,0,161,"2011"
"9997","420535 FLOR DO SERTAO",0,0,0,14,0,14,"2011"
"9998","420540 FLORIANOPOLIS",7,14,65,5349,15,5450,"2011"
"9999","420543 FORMOSA DO SUL",0,1,0,24,0,25,"2011"
"10000","420545 FORQUILHINHA",2,0,1,322,0,325,"2011"
"10001","420550 FRAIBURGO",1,1,12,538,0,552,"2011"
"10002","420555 FREI ROGERIO",0,0,0,35,0,35,"2011"
"10003","420560 GALVAO",0,0,0,50,0,50,"2011"
"10004","420570 GAROPABA",1,1,2,228,0,232,"2011"
"10005","420580 GARUVA",1,3,1,265,2,272,"2011"
"10006","420590 GASPAR",2,5,7,746,0,760,"2011"
"10007","420600 GOVERNADOR CELSO RAMOS",0,0,0,140,0,140,"2011"
"10008","420610 GRAO PARA",0,0,1,80,0,81,"2011"
"10009","420620 GRAVATAL",0,0,0,143,0,143,"2011"
"10010","420630 GUABIRUBA",2,0,2,240,1,245,"2011"
"10011","420640 GUARACIABA",3,3,3,102,0,111,"2011"
"10012","420650 GUARAMIRIM",4,2,5,573,0,584,"2011"
"10013","420660 GUARUJA DO SUL",0,1,0,56,1,58,"2011"
"10014","420665 GUATAMBU",0,1,3,55,0,59,"2011"
"10015","420670 HERVAL D'OESTE",0,1,3,294,0,298,"2011"
"10016","420675 IBIAM",0,0,0,23,0,23,"2011"
"10017","420680 IBICARE",0,0,0,28,0,28,"2011"
"10018","420690 IBIRAMA",0,0,3,256,1,260,"2011"
"10019","420700 ICARA",0,2,2,817,0,821,"2011"
"10020","420710 ILHOTA",1,0,6,139,0,146,"2011"
"10021","420720 IMARUI",0,0,3,87,1,91,"2011"
"10022","420730 IMBITUBA",2,0,7,509,0,518,"2011"
"10023","420740 IMBUIA",0,0,3,69,0,72,"2011"
"10024","420750 INDAIAL",1,1,1,806,1,810,"2011"
"10025","420757 IOMERE",0,0,0,26,0,26,"2011"
"10026","420760 IPIRA",0,0,0,44,0,44,"2011"
"10027","420765 IPORA DO OESTE",0,0,0,91,0,91,"2011"
"10028","420768 IPUACU",1,1,1,140,4,147,"2011"
"10029","420770 IPUMIRIM",1,0,0,75,0,76,"2011"
"10030","420775 IRACEMINHA",0,0,0,38,0,38,"2011"
"10031","420780 IRANI",0,0,4,103,0,107,"2011"
"10032","420785 IRATI",0,0,0,18,0,18,"2011"
"10033","420790 IRINEOPOLIS",1,1,3,127,7,139,"2011"
"10034","420800 ITA",0,0,2,72,0,74,"2011"
"10035","420810 ITAIOPOLIS",1,0,5,322,2,330,"2011"
"10036","420820 ITAJAI",12,12,94,2758,2,2878,"2011"
"10037","420830 ITAPEMA",1,2,9,671,0,683,"2011"
"10038","420840 ITAPIRANGA",2,1,1,223,0,227,"2011"
"10039","420845 ITAPOA",0,1,4,175,1,181,"2011"
"10040","420850 ITUPORANGA",1,1,19,331,0,352,"2011"
"10041","420860 JABORA",0,0,0,43,0,43,"2011"
"10042","420870 JACINTO MACHADO",0,0,1,113,0,114,"2011"
"10043","420880 JAGUARUNA",0,0,3,184,2,189,"2011"
"10044","420890 JARAGUA DO SUL",6,7,31,2208,2,2254,"2011"
"10045","420895 JARDINOPOLIS",0,0,0,28,0,28,"2011"
"10046","420900 JOACABA",3,2,1,379,1,386,"2011"
"10047","420910 JOINVILLE",12,28,112,7645,8,7805,"2011"
"10048","420915 JOSE BOITEUX",0,1,1,90,0,92,"2011"
"10049","420917 JUPIA",0,0,1,20,1,22,"2011"
"10050","420920 LACERDOPOLIS",0,0,0,15,0,15,"2011"
"10051","420930 LAGES",6,12,70,2255,5,2348,"2011"
"10052","420940 LAGUNA",0,3,9,565,0,577,"2011"
"10053","420945 LAJEADO GRANDE",0,0,0,10,0,10,"2011"
"10054","420950 LAURENTINO",0,0,4,79,2,85,"2011"
"10055","420960 LAURO MULLER",1,0,3,193,0,197,"2011"
"10056","420970 LEBON REGIS",0,4,1,149,0,154,"2011"
"10057","420980 LEOBERTO LEAL",0,0,0,46,0,46,"2011"
"10058","420985 LINDOIA DO SUL",0,0,2,53,0,55,"2011"
"10059","420990 LONTRAS",0,0,1,150,1,152,"2011"
"10060","421000 LUIZ ALVES",0,0,1,140,0,141,"2011"
"10061","421003 LUZERNA",0,0,2,49,0,51,"2011"
"10062","421005 MACIEIRA",0,2,2,22,0,26,"2011"
"10063","421010 MAFRA",0,3,16,835,3,857,"2011"
"10064","421020 MAJOR GERCINO",0,0,0,34,0,34,"2011"
"10065","421030 MAJOR VIEIRA",0,1,2,83,0,86,"2011"
"10066","421040 MARACAJA",0,0,1,98,0,99,"2011"
"10067","421050 MARAVILHA",0,0,2,293,0,295,"2011"
"10068","421055 MAREMA",0,0,1,18,0,19,"2011"
"10069","421060 MASSARANDUBA",0,0,3,180,0,183,"2011"
"10070","421070 MATOS COSTA",0,0,0,30,1,31,"2011"
"10071","421080 MELEIRO",1,0,2,74,0,77,"2011"
"10072","421085 MIRIM DOCE",0,0,0,24,0,24,"2011"
"10073","421090 MODELO",0,0,1,42,0,43,"2011"
"10074","421100 MONDAI",0,0,2,99,0,101,"2011"
"10075","421105 MONTE CARLO",1,1,0,128,1,131,"2011"
"10076","421110 MONTE CASTELO",0,0,2,118,1,121,"2011"
"10077","421120 MORRO DA FUMACA",0,1,5,238,0,244,"2011"
"10078","421125 MORRO GRANDE",0,0,0,34,0,34,"2011"
"10079","421130 NAVEGANTES",1,6,23,1006,0,1036,"2011"
"10080","421140 NOVA ERECHIM",0,0,0,51,0,51,"2011"
"10081","421145 NOVA ITABERABA",0,0,0,52,1,53,"2011"
"10082","421150 NOVA TRENTO",0,1,1,129,0,131,"2011"
"10083","421160 NOVA VENEZA",0,0,1,154,1,156,"2011"
"10084","421165 NOVO HORIZONTE",0,1,0,23,0,24,"2011"
"10085","421170 ORLEANS",0,3,9,236,0,248,"2011"
"10086","421175 OTACILIO COSTA",1,0,7,235,1,244,"2011"
"10087","421180 OURO",0,0,0,90,0,90,"2011"
"10088","421185 OURO VERDE",0,0,0,28,0,28,"2011"
"10089","421187 PAIAL",0,0,1,12,0,13,"2011"
"10090","421189 PAINEL",0,0,1,20,0,21,"2011"
"10091","421190 PALHOCA",5,6,19,2108,4,2142,"2011"
"10092","421200 PALMA SOLA",1,1,0,106,0,108,"2011"
"10093","421205 PALMEIRA",0,0,2,28,0,30,"2011"
"10094","421210 PALMITOS",1,0,2,174,0,177,"2011"
"10095","421220 PAPANDUVA",0,1,4,254,1,260,"2011"
"10096","421223 PARAISO",0,1,0,45,0,46,"2011"
"10097","421225 PASSO DE TORRES",0,0,1,77,0,78,"2011"
"10098","421227 PASSOS MAIA",0,1,0,61,1,63,"2011"
"10099","421230 PAULO LOPES",2,0,2,84,0,88,"2011"
"10100","421240 PEDRAS GRANDES",0,0,0,23,0,23,"2011"
"10101","421250 PENHA",1,2,5,316,0,324,"2011"
"10102","421260 PERITIBA",0,0,0,21,0,21,"2011"
"10103","421270 PETROLANDIA",0,0,2,55,0,57,"2011"
"10104","421280 BALNEARIO PICARRAS",0,0,5,266,0,271,"2011"
"10105","421290 PINHALZINHO",1,0,1,214,0,216,"2011"
"10106","421300 PINHEIRO PRETO",0,0,0,28,0,28,"2011"
"10107","421310 PIRATUBA",0,0,2,53,0,55,"2011"
"10108","421315 PLANALTO ALEGRE",0,0,0,26,1,27,"2011"
"10109","421320 POMERODE",2,2,6,326,0,336,"2011"
"10110","421330 PONTE ALTA",0,0,0,72,0,72,"2011"
"10111","421335 PONTE ALTA DO NORTE",0,0,1,53,1,55,"2011"
"10112","421340 PONTE SERRADA",0,0,2,160,0,162,"2011"
"10113","421350 PORTO BELO",0,0,2,232,0,234,"2011"
"10114","421360 PORTO UNIAO",1,3,5,501,3,513,"2011"
"10115","421370 POUSO REDONDO",0,1,6,222,0,229,"2011"
"10116","421380 PRAIA GRANDE",1,0,2,69,0,72,"2011"
"10117","421390 PRESIDENTE CASTELLO BRANCO",0,0,0,23,0,23,"2011"
"10118","421400 PRESIDENTE GETULIO",1,1,3,174,1,180,"2011"
"10119","421410 PRESIDENTE NEREU",0,0,0,22,0,22,"2011"
"10120","421415 PRINCESA",0,0,0,39,0,39,"2011"
"10121","421420 QUILOMBO",0,0,2,122,0,124,"2011"
"10122","421430 RANCHO QUEIMADO",1,0,0,31,0,32,"2011"
"10123","421440 RIO DAS ANTAS",0,1,2,66,0,69,"2011"
"10124","421450 RIO DO CAMPO",0,1,0,75,0,76,"2011"
"10125","421460 RIO DO OESTE",0,1,2,81,1,85,"2011"
"10126","421470 RIO DOS CEDROS",0,0,1,99,0,100,"2011"
"10127","421480 RIO DO SUL",0,4,16,842,2,864,"2011"
"10128","421490 RIO FORTUNA",0,0,0,68,0,68,"2011"
"10129","421500 RIO NEGRINHO",3,2,9,552,0,566,"2011"
"10130","421505 RIO RUFINO",0,1,0,30,0,31,"2011"
"10131","421507 RIQUEZA",0,0,0,47,0,47,"2011"
"10132","421510 RODEIO",0,0,3,106,0,109,"2011"
"10133","421520 ROMELANDIA",0,0,2,39,1,42,"2011"
"10134","421530 SALETE",0,1,0,103,0,104,"2011"
"10135","421535 SALTINHO",0,0,3,47,0,50,"2011"
"10136","421540 SALTO VELOSO",0,1,0,49,0,50,"2011"
"10137","421545 SANGAO",0,0,3,171,1,175,"2011"
"10138","421550 SANTA CECILIA",1,1,6,264,1,273,"2011"
"10139","421555 SANTA HELENA",0,0,0,19,0,19,"2011"
"10140","421560 SANTA ROSA DE LIMA",0,0,0,21,0,21,"2011"
"10141","421565 SANTA ROSA DO SUL",0,0,2,93,0,95,"2011"
"10142","421567 SANTA TEREZINHA",1,1,0,109,0,111,"2011"
"10143","421568 SANTA TEREZINHA DO PROGRESSO",0,0,0,25,0,25,"2011"
"10144","421569 SANTIAGO DO SUL",0,0,0,14,0,14,"2011"
"10145","421570 SANTO AMARO DA IMPERATRIZ",2,0,3,206,0,211,"2011"
"10146","421575 SAO BERNARDINO",0,0,0,23,0,23,"2011"
"10147","421580 SAO BENTO DO SUL",7,4,13,1150,30,1204,"2011"
"10148","421590 SAO BONIFACIO",0,0,0,29,0,29,"2011"
"10149","421600 SAO CARLOS",1,0,0,133,0,134,"2011"
"10150","421605 SAO CRISTOVAO DO SUL",0,0,1,80,0,81,"2011"
"10151","421610 SAO DOMINGOS",0,0,1,109,0,110,"2011"
"10152","421620 SAO FRANCISCO DO SUL",0,1,10,624,1,636,"2011"
"10153","421625 SAO JOAO DO OESTE",0,0,1,46,0,47,"2011"
"10154","421630 SAO JOAO BATISTA",1,2,6,392,0,401,"2011"
"10155","421635 SAO JOAO DO ITAPERIU",0,1,0,45,0,46,"2011"
"10156","421640 SAO JOAO DO SUL",0,1,0,82,0,83,"2011"
"10157","421650 SAO JOAQUIM",1,2,14,349,0,366,"2011"
"10158","421660 SAO JOSE",9,9,38,2871,5,2932,"2011"
"10159","421670 SAO JOSE DO CEDRO",0,4,4,141,0,149,"2011"
"10160","421680 SAO JOSE DO CERRITO",0,0,4,82,1,87,"2011"
"10161","421690 SAO LOURENCO DO OESTE",1,3,8,304,0,316,"2011"
"10162","421700 SAO LUDGERO",1,1,1,153,0,156,"2011"
"10163","421710 SAO MARTINHO",0,0,0,29,0,29,"2011"
"10164","421715 SAO MIGUEL DA BOA VISTA",0,0,0,20,0,20,"2011"
"10165","421720 SAO MIGUEL DO OESTE",0,7,13,473,0,493,"2011"
"10166","421725 SAO PEDRO DE ALCANTARA",0,0,0,40,0,40,"2011"
"10167","421730 SAUDADES",1,0,0,98,0,99,"2011"
"10168","421740 SCHROEDER",1,3,4,248,0,256,"2011"
"10169","421750 SEARA",0,0,1,203,0,204,"2011"
"10170","421755 SERRA ALTA",0,0,1,38,0,39,"2011"
"10171","421760 SIDEROPOLIS",1,0,0,156,0,157,"2011"
"10172","421770 SOMBRIO",0,1,5,384,0,390,"2011"
"10173","421775 SUL BRASIL",0,1,0,38,0,39,"2011"
"10174","421780 TAIO",0,2,5,222,0,229,"2011"
"10175","421790 TANGARA",0,0,3,93,0,96,"2011"
"10176","421795 TIGRINHOS",0,0,1,28,0,29,"2011"
"10177","421800 TIJUCAS",1,1,6,466,0,474,"2011"
"10178","421810 TIMBE DO SUL",0,1,0,14,0,15,"2011"
"10179","421820 TIMBO",2,0,2,467,3,474,"2011"
"10180","421825 TIMBO GRANDE",1,0,1,118,2,122,"2011"
"10181","421830 TRES BARRAS",0,2,3,274,0,279,"2011"
"10182","421835 TREVISO",0,0,0,41,0,41,"2011"
"10183","421840 TREZE DE MAIO",0,0,0,71,0,71,"2011"
"10184","421850 TREZE TILIAS",0,0,0,86,0,86,"2011"
"10185","421860 TROMBUDO CENTRAL",0,0,1,77,0,78,"2011"
"10186","421870 TUBARAO",0,1,9,1201,2,1213,"2011"
"10187","421875 TUNAPOLIS",0,0,3,51,0,54,"2011"
"10188","421880 TURVO",0,1,3,157,0,161,"2011"
"10189","421885 UNIAO DO OESTE",0,0,2,22,0,24,"2011"
"10190","421890 URUBICI",0,3,1,153,0,157,"2011"
"10191","421895 URUPEMA",0,0,2,31,1,34,"2011"
"10192","421900 URUSSANGA",1,2,1,233,0,237,"2011"
"10193","421910 VARGEAO",1,0,0,44,0,45,"2011"
"10194","421915 VARGEM",0,0,0,37,0,37,"2011"
"10195","421917 VARGEM BONITA",0,0,1,68,0,69,"2011"
"10196","421920 VIDAL RAMOS",1,0,9,72,0,82,"2011"
"10197","421930 VIDEIRA",3,2,10,702,1,718,"2011"
"10198","421935 VITOR MEIRELES",0,0,1,61,0,62,"2011"
"10199","421940 WITMARSUM",0,0,0,59,0,59,"2011"
"10200","421950 XANXERE",1,1,5,609,1,617,"2011"
"10201","421960 XAVANTINA",0,1,0,38,0,39,"2011"
"10202","421970 XAXIM",1,0,1,378,1,381,"2011"
"10203","421985 ZORTEA",1,0,0,40,0,41,"2011"
"10204","430003 ACEGUA",0,0,1,56,0,57,"2011"
"10205","430005 AGUA SANTA",0,0,0,36,0,36,"2011"
"10206","430010 AGUDO",0,0,3,145,0,148,"2011"
"10207","430020 AJURICABA",0,0,1,84,0,85,"2011"
"10208","430030 ALECRIM",0,0,1,59,0,60,"2011"
"10209","430040 ALEGRETE",2,4,9,906,1,922,"2011"
"10210","430045 ALEGRIA",0,0,0,41,0,41,"2011"
"10211","430047 ALMIRANTE TAMANDARE DO SUL",0,0,0,11,0,11,"2011"
"10212","430050 ALPESTRE",0,1,0,66,0,67,"2011"
"10213","430055 ALTO ALEGRE",0,0,2,11,0,13,"2011"
"10214","430057 ALTO FELIZ",0,1,0,17,0,18,"2011"
"10215","430060 ALVORADA",7,24,76,3179,10,3296,"2011"
"10216","430063 AMARAL FERRADOR",1,0,0,65,0,66,"2011"
"10217","430064 AMETISTA DO SUL",0,1,1,69,0,71,"2011"
"10218","430066 ANDRE DA ROCHA",0,0,0,12,0,12,"2011"
"10219","430070 ANTA GORDA",0,1,0,39,0,40,"2011"
"10220","430080 ANTONIO PRADO",1,0,2,132,0,135,"2011"
"10221","430085 ARAMBARE",0,0,0,32,0,32,"2011"
"10222","430087 ARARICA",0,0,0,80,0,80,"2011"
"10223","430090 ARATIBA",0,0,0,71,0,71,"2011"
"10224","430100 ARROIO DO MEIO",1,2,3,190,1,197,"2011"
"10225","430105 ARROIO DO SAL",0,1,0,88,0,89,"2011"
"10226","430107 ARROIO DO PADRE",0,0,0,20,0,20,"2011"
"10227","430110 ARROIO DOS RATOS",0,0,1,177,3,181,"2011"
"10228","430120 ARROIO DO TIGRE",0,1,0,154,1,156,"2011"
"10229","430130 ARROIO GRANDE",0,3,6,194,2,205,"2011"
"10230","430140 ARVOREZINHA",0,0,4,115,1,120,"2011"
"10231","430150 AUGUSTO PESTANA",0,0,1,48,1,50,"2011"
"10232","430155 AUREA",0,0,0,33,0,33,"2011"
"10233","430160 BAGE",7,8,23,1559,9,1606,"2011"
"10234","430163 BALNEARIO PINHAL",0,0,3,111,4,118,"2011"
"10235","430165 BARAO",0,0,0,32,0,32,"2011"
"10236","430170 BARAO DE COTEGIPE",0,0,0,53,0,53,"2011"
"10237","430175 BARAO DO TRIUNFO",1,1,0,60,2,64,"2011"
"10238","430180 BARRACAO",0,3,1,52,0,56,"2011"
"10239","430185 BARRA DO GUARITA",0,0,0,36,0,36,"2011"
"10240","430187 BARRA DO QUARAI",0,0,0,22,10,32,"2011"
"10241","430190 BARRA DO RIBEIRO",0,1,0,126,8,135,"2011"
"10242","430192 BARRA DO RIO AZUL",0,0,0,14,0,14,"2011"
"10243","430195 BARRA FUNDA",0,0,0,27,0,27,"2011"
"10244","430200 BARROS CASSAL",0,0,1,108,1,110,"2011"
"10245","430205 BENJAMIN CONSTANT DO SUL",0,0,1,30,0,31,"2011"
"10246","430210 BENTO GONCALVES",2,2,24,1238,2,1268,"2011"
"10247","430215 BOA VISTA DAS MISSOES",0,0,0,16,1,17,"2011"
"10248","430220 BOA VISTA DO BURICA",0,1,2,60,0,63,"2011"
"10249","430222 BOA VISTA DO CADEADO",0,0,0,21,0,21,"2011"
"10250","430223 BOA VISTA DO INCRA",0,0,0,33,0,33,"2011"
"10251","430225 BOA VISTA DO SUL",2,0,0,26,0,28,"2011"
"10252","430230 BOM JESUS",1,1,4,148,3,157,"2011"
"10253","430235 BOM PRINCIPIO",0,1,3,155,0,159,"2011"
"10254","430237 BOM PROGRESSO",0,0,0,34,0,34,"2011"
"10255","430240 BOM RETIRO DO SUL",0,0,2,163,0,165,"2011"
"10256","430245 BOQUEIRAO DO LEAO",0,0,3,93,1,97,"2011"
"10257","430250 BOSSOROCA",0,1,0,73,1,75,"2011"
"10258","430258 BOZANO",0,0,0,21,0,21,"2011"
"10259","430260 BRAGA",0,0,1,44,0,45,"2011"
"10260","430265 BROCHIER",0,0,0,25,0,25,"2011"
"10261","430270 BUTIA",0,1,3,233,0,237,"2011"
"10262","430280 CACAPAVA DO SUL",3,0,6,334,0,343,"2011"
"10263","430290 CACEQUI",1,4,2,144,0,151,"2011"
"10264","430300 CACHOEIRA DO SUL",1,1,11,1020,2,1035,"2011"
"10265","430310 CACHOEIRINHA",2,5,15,1716,2,1740,"2011"
"10266","430320 CACIQUE DOBLE",0,2,0,53,0,55,"2011"
"10267","430330 CAIBATE",1,0,2,66,0,69,"2011"
"10268","430340 CAICARA",0,1,0,35,0,36,"2011"
"10269","430350 CAMAQUA",2,4,20,761,7,794,"2011"
"10270","430355 CAMARGO",0,0,0,13,0,13,"2011"
"10271","430360 CAMBARA DO SUL",0,0,0,38,0,38,"2011"
"10272","430367 CAMPESTRE DA SERRA",0,0,0,14,2,16,"2011"
"10273","430370 CAMPINA DAS MISSOES",0,0,1,51,0,52,"2011"
"10274","430380 CAMPINAS DO SUL",0,0,0,45,0,45,"2011"
"10275","430390 CAMPO BOM",1,3,11,767,0,782,"2011"
"10276","430400 CAMPO NOVO",0,0,0,58,0,58,"2011"
"10277","430410 CAMPOS BORGES",0,0,1,29,1,31,"2011"
"10278","430420 CANDELARIA",0,4,4,339,1,348,"2011"
"10279","430430 CANDIDO GODOI",0,0,0,57,0,57,"2011"
"10280","430435 CANDIOTA",1,1,3,113,1,119,"2011"
"10281","430440 CANELA",1,6,22,565,2,596,"2011"
"10282","430450 CANGUCU",2,2,5,564,0,573,"2011"
"10283","430460 CANOAS",14,19,66,4787,25,4911,"2011"
"10284","430461 CANUDOS DO VALE",0,0,0,15,0,15,"2011"
"10285","430462 CAPAO BONITO DO SUL",0,0,1,12,1,14,"2011"
"10286","430463 CAPAO DA CANOA",2,4,7,752,1,766,"2011"
"10287","430465 CAPAO DO CIPO",0,0,0,35,0,35,"2011"
"10288","430466 CAPAO DO LEAO",0,2,10,323,1,336,"2011"
"10289","430467 CAPIVARI DO SUL",0,0,0,55,0,55,"2011"
"10290","430468 CAPELA DE SANTANA",0,1,0,96,1,98,"2011"
"10291","430469 CAPITAO",0,0,3,23,0,26,"2011"
"10292","430470 CARAZINHO",0,4,11,782,7,804,"2011"
"10293","430471 CARAA",0,0,0,43,0,43,"2011"
"10294","430480 CARLOS BARBOSA",0,0,1,266,0,267,"2011"
"10295","430485 CARLOS GOMES",0,0,0,16,0,16,"2011"
"10296","430490 CASCA",0,0,2,61,0,63,"2011"
"10297","430495 CASEIROS",0,0,1,17,0,18,"2011"
"10298","430500 CATUIPE",0,1,1,88,0,90,"2011"
"10299","430510 CAXIAS DO SUL",20,25,104,6135,9,6293,"2011"
"10300","430511 CENTENARIO",0,0,1,26,0,27,"2011"
"10301","430512 CERRITO",0,0,2,64,0,66,"2011"
"10302","430513 CERRO BRANCO",0,1,0,29,0,30,"2011"
"10303","430515 CERRO GRANDE",0,0,0,30,0,30,"2011"
"10304","430517 CERRO GRANDE DO SUL",0,1,0,118,2,121,"2011"
"10305","430520 CERRO LARGO",1,0,2,134,0,137,"2011"
"10306","430530 CHAPADA",0,1,1,85,0,87,"2011"
"10307","430535 CHARQUEADAS",0,1,4,399,0,404,"2011"
"10308","430537 CHARRUA",0,0,0,35,0,35,"2011"
"10309","430540 CHIAPETTA",0,0,0,42,0,42,"2011"
"10310","430543 CHUI",0,0,1,51,1,53,"2011"
"10311","430544 CHUVISCA",0,0,1,52,0,53,"2011"
"10312","430545 CIDREIRA",0,2,4,149,1,156,"2011"
"10313","430550 CIRIACO",0,0,0,57,0,57,"2011"
"10314","430558 COLINAS",0,0,1,21,0,22,"2011"
"10315","430560 COLORADO",0,0,0,17,0,17,"2011"
"10316","430570 CONDOR",0,0,1,34,0,35,"2011"
"10317","430580 CONSTANTINA",0,1,1,133,2,137,"2011"
"10318","430583 COQUEIRO BAIXO",0,0,0,10,0,10,"2011"
"10319","430585 COQUEIROS DO SUL",0,0,1,18,0,19,"2011"
"10320","430587 CORONEL BARROS",0,1,0,36,0,37,"2011"
"10321","430590 CORONEL BICACO",0,0,2,117,0,119,"2011"
"10322","430593 CORONEL PILAR",0,0,0,10,0,10,"2011"
"10323","430595 COTIPORA",0,0,1,18,0,19,"2011"
"10324","430597 COXILHA",0,1,0,31,0,32,"2011"
"10325","430600 CRISSIUMAL",0,0,0,144,0,144,"2011"
"10326","430605 CRISTAL",1,1,3,92,0,97,"2011"
"10327","430607 CRISTAL DO SUL",0,0,1,38,0,39,"2011"
"10328","430610 CRUZ ALTA",2,1,19,893,2,917,"2011"
"10329","430613 CRUZALTENSE",0,0,1,17,0,18,"2011"
"10330","430620 CRUZEIRO DO SUL",0,0,2,117,0,119,"2011"
"10331","430630 DAVID CANABARRO",0,0,0,46,0,46,"2011"
"10332","430632 DERRUBADAS",0,0,0,40,0,40,"2011"
"10333","430635 DEZESSEIS DE NOVEMBRO",0,0,0,28,0,28,"2011"
"10334","430637 DILERMANDO DE AGUIAR",0,0,1,32,1,34,"2011"
"10335","430640 DOIS IRMAOS",1,3,6,344,0,354,"2011"
"10336","430642 DOIS IRMAOS DAS MISSOES",0,1,1,22,0,24,"2011"
"10337","430645 DOIS LAJEADOS",0,0,0,22,0,22,"2011"
"10338","430650 DOM FELICIANO",0,1,2,178,0,181,"2011"
"10339","430655 DOM PEDRO DE ALCANTARA",0,0,0,20,0,20,"2011"
"10340","430660 DOM PEDRITO",1,0,5,450,1,457,"2011"
"10341","430670 DONA FRANCISCA",0,0,1,44,1,46,"2011"
"10342","430673 DOUTOR MAURICIO CARDOSO",0,0,0,37,0,37,"2011"
"10343","430675 DOUTOR RICARDO",0,0,0,13,0,13,"2011"
"10344","430676 ELDORADO DO SUL",1,2,6,504,4,517,"2011"
"10345","430680 ENCANTADO",0,0,2,221,0,223,"2011"
"10346","430690 ENCRUZILHADA DO SUL",3,4,3,302,4,316,"2011"
"10347","430692 ENGENHO VELHO",0,0,0,26,0,26,"2011"
"10348","430693 ENTRE-IJUIS",0,0,0,82,0,82,"2011"
"10349","430695 ENTRE RIOS DO SUL",0,0,0,38,0,38,"2011"
"10350","430697 EREBANGO",2,0,0,44,0,46,"2011"
"10351","430700 ERECHIM",1,1,29,1263,0,1294,"2011"
"10352","430705 ERNESTINA",0,0,1,34,0,35,"2011"
"10353","430710 HERVAL",0,0,2,59,0,61,"2011"
"10354","430720 ERVAL GRANDE",0,0,0,48,0,48,"2011"
"10355","430730 ERVAL SECO",0,0,2,72,0,74,"2011"
"10356","430740 ESMERALDA",0,0,0,26,2,28,"2011"
"10357","430745 ESPERANCA DO SUL",0,1,1,36,0,38,"2011"
"10358","430750 ESPUMOSO",0,0,3,198,0,201,"2011"
"10359","430755 ESTACAO",0,0,1,56,0,57,"2011"
"10360","430760 ESTANCIA VELHA",0,2,12,594,0,608,"2011"
"10361","430770 ESTEIO",0,4,13,1171,6,1194,"2011"
"10362","430780 ESTRELA",2,6,13,348,1,370,"2011"
"10363","430781 ESTRELA VELHA",0,0,0,32,0,32,"2011"
"10364","430783 EUGENIO DE CASTRO",0,0,0,20,0,20,"2011"
"10365","430786 FAGUNDES VARELA",0,0,0,23,0,23,"2011"
"10366","430790 FARROUPILHA",2,3,14,794,0,813,"2011"
"10367","430800 FAXINAL DO SOTURNO",0,0,1,62,1,64,"2011"
"10368","430805 FAXINALZINHO",0,0,0,17,0,17,"2011"
"10369","430807 FAZENDA VILANOVA",0,1,3,49,0,53,"2011"
"10370","430810 FELIZ",0,1,0,137,0,138,"2011"
"10371","430820 FLORES DA CUNHA",2,2,4,313,0,321,"2011"
"10372","430825 FLORIANO PEIXOTO",1,0,0,10,0,11,"2011"
"10373","430830 FONTOURA XAVIER",0,0,1,130,0,131,"2011"
"10374","430840 FORMIGUEIRO",0,0,2,55,0,57,"2011"
"10375","430843 FORQUETINHA",0,0,0,21,0,21,"2011"
"10376","430845 FORTALEZA DOS VALOS",0,0,1,44,0,45,"2011"
"10377","430850 FREDERICO WESTPHALEN",0,3,6,335,0,344,"2011"
"10378","430860 GARIBALDI",0,2,2,290,0,294,"2011"
"10379","430865 GARRUCHOS",0,0,0,50,0,50,"2011"
"10380","430870 GAURAMA",0,0,1,40,0,41,"2011"
"10381","430880 GENERAL CAMARA",0,0,1,89,1,91,"2011"
"10382","430885 GENTIL",0,0,0,17,0,17,"2011"
"10383","430890 GETULIO VARGAS",1,1,7,163,0,172,"2011"
"10384","430900 GIRUA",0,0,0,180,0,180,"2011"
"10385","430905 GLORINHA",0,1,2,80,0,83,"2011"
"10386","430910 GRAMADO",0,3,12,474,0,489,"2011"
"10387","430912 GRAMADO DOS LOUREIROS",0,0,0,29,0,29,"2011"
"10388","430915 GRAMADO XAVIER",0,1,0,42,0,43,"2011"
"10389","430920 GRAVATAI",11,10,47,3464,1,3533,"2011"
"10390","430925 GUABIJU",0,0,1,9,0,10,"2011"
"10391","430930 GUAIBA",2,7,24,1260,7,1300,"2011"
"10392","430940 GUAPORE",1,0,2,237,1,241,"2011"
"10393","430950 GUARANI DAS MISSOES",1,0,0,82,0,83,"2011"
"10394","430955 HARMONIA",0,0,0,37,0,37,"2011"
"10395","430957 HERVEIRAS",0,0,3,48,0,51,"2011"
"10396","430960 HORIZONTINA",0,0,1,191,0,192,"2011"
"10397","430965 HULHA NEGRA",1,0,1,72,0,74,"2011"
"10398","430970 HUMAITA",0,0,0,46,0,46,"2011"
"10399","430975 IBARAMA",0,0,0,55,0,55,"2011"
"10400","430980 IBIACA",0,0,0,37,0,37,"2011"
"10401","430990 IBIRAIARAS",0,2,0,66,0,68,"2011"
"10402","430995 IBIRAPUITA",0,0,0,49,0,49,"2011"
"10403","431000 IBIRUBA",0,0,4,215,0,219,"2011"
"10404","431010 IGREJINHA",0,3,4,486,0,493,"2011"
"10405","431020 IJUI",2,2,15,990,0,1009,"2011"
"10406","431030 ILOPOLIS",0,0,0,40,0,40,"2011"
"10407","431033 IMBE",0,1,5,234,2,242,"2011"
"10408","431036 IMIGRANTE",1,0,2,28,0,31,"2011"
"10409","431040 INDEPENDENCIA",1,0,1,61,0,63,"2011"
"10410","431041 INHACORA",0,0,1,27,0,28,"2011"
"10411","431043 IPE",0,0,0,36,0,36,"2011"
"10412","431046 IPIRANGA DO SUL",0,0,0,16,0,16,"2011"
"10413","431050 IRAI",0,0,2,95,0,97,"2011"
"10414","431053 ITAARA",0,1,3,53,0,57,"2011"
"10415","431055 ITACURUBI",0,0,0,36,0,36,"2011"
"10416","431057 ITAPUCA",0,1,0,24,0,25,"2011"
"10417","431060 ITAQUI",2,1,6,277,314,600,"2011"
"10418","431065 ITATI",0,0,0,26,0,26,"2011"
"10419","431070 ITATIBA DO SUL",0,1,0,41,0,42,"2011"
"10420","431075 IVORA",0,0,0,16,0,16,"2011"
"10421","431080 IVOTI",0,0,0,261,0,261,"2011"
"10422","431085 JABOTICABA",0,0,0,27,0,27,"2011"
"10423","431087 JACUIZINHO",0,0,0,28,0,28,"2011"
"10424","431090 JACUTINGA",0,0,1,36,0,37,"2011"
"10425","431100 JAGUARAO",1,0,2,320,0,323,"2011"
"10426","431110 JAGUARI",0,0,0,106,1,107,"2011"
"10427","431112 JAQUIRANA",0,0,1,38,4,43,"2011"
"10428","431113 JARI",0,2,1,37,0,40,"2011"
"10429","431115 JOIA",0,1,3,92,0,96,"2011"
"10430","431120 JULIO DE CASTILHOS",1,0,3,257,0,261,"2011"
"10431","431123 LAGOA BONITA DO SUL",0,0,0,19,0,19,"2011"
"10432","431125 LAGOAO",0,2,0,58,0,60,"2011"
"10433","431127 LAGOA DOS TRES CANTOS",0,0,0,21,0,21,"2011"
"10434","431130 LAGOA VERMELHA",1,1,3,342,0,347,"2011"
"10435","431140 LAJEADO",1,5,13,983,0,1002,"2011"
"10436","431142 LAJEADO DO BUGRE",0,0,0,39,0,39,"2011"
"10437","431150 LAVRAS DO SUL",0,1,1,71,2,75,"2011"
"10438","431160 LIBERATO SALZANO",0,1,2,55,1,59,"2011"
"10439","431162 LINDOLFO COLLOR",1,3,1,78,0,83,"2011"
"10440","431164 LINHA NOVA",0,0,1,9,0,10,"2011"
"10441","431170 MACHADINHO",1,1,0,58,0,60,"2011"
"10442","431171 MACAMBARA",0,0,0,41,0,41,"2011"
"10443","431173 MAMPITUBA",0,2,1,28,0,31,"2011"
"10444","431175 MANOEL VIANA",0,0,1,80,1,82,"2011"
"10445","431177 MAQUINE",0,0,0,63,1,64,"2011"
"10446","431179 MARATA",0,0,0,17,0,17,"2011"
"10447","431180 MARAU",3,1,7,503,0,514,"2011"
"10448","431190 MARCELINO RAMOS",0,0,0,49,0,49,"2011"
"10449","431198 MARIANA PIMENTEL",0,0,1,34,0,35,"2011"
"10450","431200 MARIANO MORO",0,0,0,12,0,12,"2011"
"10451","431205 MARQUES DE SOUZA",0,0,2,48,0,50,"2011"
"10452","431210 MATA",0,0,1,46,0,47,"2011"
"10453","431213 MATO CASTELHANO",0,0,0,26,0,26,"2011"
"10454","431215 MATO LEITAO",0,0,1,34,0,35,"2011"
"10455","431217 MATO QUEIMADO",0,0,0,20,0,20,"2011"
"10456","431220 MAXIMILIANO DE ALMEIDA",0,0,0,44,0,44,"2011"
"10457","431225 MINAS DO LEAO",0,0,1,90,1,92,"2011"
"10458","431230 MIRAGUAI",0,0,0,49,0,49,"2011"
"10459","431235 MONTAURI",0,0,0,9,0,9,"2011"
"10460","431237 MONTE ALEGRE DOS CAMPOS",0,1,0,24,6,31,"2011"
"10461","431238 MONTE BELO DO SUL",0,0,0,23,0,23,"2011"
"10462","431240 MONTENEGRO",2,3,5,827,0,837,"2011"
"10463","431242 MORMACO",0,0,1,24,0,25,"2011"
"10464","431244 MORRINHOS DO SUL",0,0,1,13,0,14,"2011"
"10465","431245 MORRO REDONDO",0,0,0,49,0,49,"2011"
"10466","431247 MORRO REUTER",0,0,2,56,0,58,"2011"
"10467","431250 MOSTARDAS",0,0,3,124,0,127,"2011"
"10468","431260 MUCUM",0,0,0,37,0,37,"2011"
"10469","431261 MUITOS CAPOES",0,0,1,22,3,26,"2011"
"10470","431262 MULITERNO",0,0,0,22,0,22,"2011"
"10471","431265 NAO-ME-TOQUE",0,0,3,203,0,206,"2011"
"10472","431267 NICOLAU VERGUEIRO",1,0,0,15,0,16,"2011"
"10473","431270 NONOAI",0,1,4,158,0,163,"2011"
"10474","431275 NOVA ALVORADA",0,0,1,34,0,35,"2011"
"10475","431280 NOVA ARACA",0,0,0,46,0,46,"2011"
"10476","431290 NOVA BASSANO",0,0,1,94,0,95,"2011"
"10477","431295 NOVA BOA VISTA",0,0,1,17,0,18,"2011"
"10478","431300 NOVA BRESCIA",0,0,0,23,1,24,"2011"
"10479","431301 NOVA CANDELARIA",1,0,0,21,0,22,"2011"
"10480","431303 NOVA ESPERANCA DO SUL",0,1,0,49,0,50,"2011"
"10481","431306 NOVA HARTZ",1,1,5,266,1,274,"2011"
"10482","431308 NOVA PADUA",0,0,0,14,0,14,"2011"
"10483","431310 NOVA PALMA",0,0,0,53,0,53,"2011"
"10484","431320 NOVA PETROPOLIS",0,0,2,226,0,228,"2011"
"10485","431330 NOVA PRATA",0,1,3,281,0,285,"2011"
"10486","431333 NOVA RAMADA",0,0,0,12,0,12,"2011"
"10487","431335 NOVA ROMA DO SUL",0,0,0,26,0,26,"2011"
"10488","431337 NOVA SANTA RITA",0,1,3,294,0,298,"2011"
"10489","431339 NOVO CABRAIS",0,0,1,42,0,43,"2011"
"10490","431340 NOVO HAMBURGO",6,15,38,3155,4,3218,"2011"
"10491","431342 NOVO MACHADO",0,0,0,26,0,26,"2011"
"10492","431344 NOVO TIRADENTES",0,0,0,13,0,13,"2011"
"10493","431346 NOVO XINGU",1,0,0,14,0,15,"2011"
"10494","431349 NOVO BARREIRO",1,0,0,42,0,43,"2011"
"10495","431350 OSORIO",0,1,6,558,4,569,"2011"
"10496","431360 PAIM FILHO",0,0,0,34,0,34,"2011"
"10497","431365 PALMARES DO SUL",0,0,3,117,0,120,"2011"
"10498","431370 PALMEIRA DAS MISSOES",2,3,9,436,1,451,"2011"
"10499","431380 PALMITINHO",0,0,1,75,0,76,"2011"
"10500","431390 PANAMBI",0,0,3,559,0,562,"2011"
"10501","431395 PANTANO GRANDE",1,0,3,104,0,108,"2011"
"10502","431400 PARAI",0,0,1,62,0,63,"2011"
"10503","431402 PARAISO DO SUL",0,0,0,54,1,55,"2011"
"10504","431403 PARECI NOVO",0,0,1,36,0,37,"2011"
"10505","431405 PAROBE",2,3,11,750,0,766,"2011"
"10506","431406 PASSA SETE",0,0,0,40,0,40,"2011"
"10507","431407 PASSO DO SOBRADO",0,0,2,66,0,68,"2011"
"10508","431410 PASSO FUNDO",10,13,54,2806,4,2887,"2011"
"10509","431413 PAULO BENTO",0,1,0,22,0,23,"2011"
"10510","431415 PAVERAMA",0,0,2,85,0,87,"2011"
"10511","431417 PEDRAS ALTAS",0,0,1,12,0,13,"2011"
"10512","431420 PEDRO OSORIO",0,0,3,85,0,88,"2011"
"10513","431430 PEJUCARA",0,0,3,38,0,41,"2011"
"10514","431440 PELOTAS",11,37,118,4095,13,4274,"2011"
"10515","431442 PICADA CAFE",0,0,0,54,0,54,"2011"
"10516","431445 PINHAL",0,0,1,21,0,22,"2011"
"10517","431446 PINHAL DA SERRA",0,0,0,24,2,26,"2011"
"10518","431447 PINHAL GRANDE",1,0,0,37,0,38,"2011"
"10519","431449 PINHEIRINHO DO VALE",0,0,0,44,0,44,"2011"
"10520","431450 PINHEIRO MACHADO",3,3,5,133,1,145,"2011"
"10521","431455 PIRAPO",0,0,0,21,0,21,"2011"
"10522","431460 PIRATINI",0,0,4,181,3,188,"2011"
"10523","431470 PLANALTO",0,0,1,130,0,131,"2011"
"10524","431475 POCO DAS ANTAS",0,0,0,23,0,23,"2011"
"10525","431477 PONTAO",0,2,2,41,0,45,"2011"
"10526","431478 PONTE PRETA",0,0,0,16,0,16,"2011"
"10527","431480 PORTAO",1,2,3,352,0,358,"2011"
"10528","431490 PORTO ALEGRE",34,96,360,18338,91,18919,"2011"
"10529","431500 PORTO LUCENA",0,0,3,36,0,39,"2011"
"10530","431505 PORTO MAUA",0,0,0,22,0,22,"2011"
"10531","431507 PORTO VERA CRUZ",0,0,0,10,0,10,"2011"
"10532","431510 PORTO XAVIER",1,0,2,128,0,131,"2011"
"10533","431513 POUSO NOVO",0,0,2,13,0,15,"2011"
"10534","431514 PRESIDENTE LUCENA",0,0,1,30,0,31,"2011"
"10535","431515 PROGRESSO",0,0,2,39,1,42,"2011"
"10536","431517 PROTASIO ALVES",0,0,1,11,0,12,"2011"
"10537","431520 PUTINGA",0,0,2,27,0,29,"2011"
"10538","431530 QUARAI",0,2,29,233,1,265,"2011"
"10539","431531 QUATRO IRMAOS",0,0,0,13,0,13,"2011"
"10540","431532 QUEVEDOS",0,1,0,29,0,30,"2011"
"10541","431535 QUINZE DE NOVEMBRO",0,0,0,34,0,34,"2011"
"10542","431540 REDENTORA",0,0,1,192,2,195,"2011"
"10543","431545 RELVADO",0,0,0,15,0,15,"2011"
"10544","431550 RESTINGA SECA",0,1,3,138,1,143,"2011"
"10545","431555 RIO DOS INDIOS",0,0,0,25,0,25,"2011"
"10546","431560 RIO GRANDE",2,13,69,2456,118,2658,"2011"
"10547","431570 RIO PARDO",2,8,9,334,2,355,"2011"
"10548","431575 RIOZINHO",0,2,2,41,0,45,"2011"
"10549","431580 ROCA SALES",1,0,1,108,0,110,"2011"
"10550","431590 RODEIO BONITO",0,0,0,59,0,59,"2011"
"10551","431595 ROLADOR",0,0,0,23,0,23,"2011"
"10552","431600 ROLANTE",0,0,6,232,1,239,"2011"
"10553","431610 RONDA ALTA",1,1,4,115,0,121,"2011"
"10554","431620 RONDINHA",0,0,1,43,0,44,"2011"
"10555","431630 ROQUE GONZALES",0,0,0,71,0,71,"2011"
"10556","431640 ROSARIO DO SUL",2,4,3,431,1,441,"2011"
"10557","431642 SAGRADA FAMILIA",0,0,0,25,0,25,"2011"
"10558","431643 SALDANHA MARINHO",0,0,0,28,0,28,"2011"
"10559","431645 SALTO DO JACUI",0,0,1,131,1,133,"2011"
"10560","431647 SALVADOR DAS MISSOES",0,0,0,21,0,21,"2011"
"10561","431650 SALVADOR DO SUL",0,0,0,50,0,50,"2011"
"10562","431660 SANANDUVA",1,1,1,167,0,170,"2011"
"10563","431670 SANTA BARBARA DO SUL",0,1,0,89,0,90,"2011"
"10564","431673 SANTA CECILIA DO SUL",0,0,0,17,0,17,"2011"
"10565","431675 SANTA CLARA DO SUL",0,0,2,49,0,51,"2011"
"10566","431680 SANTA CRUZ DO SUL",2,8,20,1470,3,1503,"2011"
"10567","431690 SANTA MARIA",8,18,54,3442,18,3540,"2011"
"10568","431695 SANTA MARIA DO HERVAL",0,0,3,58,0,61,"2011"
"10569","431697 SANTA MARGARIDA DO SUL",0,0,0,24,0,24,"2011"
"10570","431700 SANTANA DA BOA VISTA",0,1,0,63,1,65,"2011"
"10571","431710 SANT'ANA DO LIVRAMENTO",1,5,13,1057,9,1085,"2011"
"10572","431720 SANTA ROSA",1,3,33,840,3,880,"2011"
"10573","431725 SANTA TEREZA",0,0,0,4,0,4,"2011"
"10574","431730 SANTA VITORIA DO PALMAR",0,4,7,348,0,359,"2011"
"10575","431740 SANTIAGO",2,1,2,550,1,556,"2011"
"10576","431750 SANTO ANGELO",3,5,4,987,0,999,"2011"
"10577","431755 SANTO ANTONIO DO PALMA",0,0,0,25,0,25,"2011"
"10578","431760 SANTO ANTONIO DA PATRULHA",2,2,6,428,2,440,"2011"
"10579","431770 SANTO ANTONIO DAS MISSOES",0,0,0,123,0,123,"2011"
"10580","431775 SANTO ANTONIO DO PLANALTO",0,0,0,27,0,27,"2011"
"10581","431780 SANTO AUGUSTO",0,1,0,165,0,166,"2011"
"10582","431790 SANTO CRISTO",0,2,6,135,0,143,"2011"
"10583","431795 SANTO EXPEDITO DO SUL",0,0,0,21,0,21,"2011"
"10584","431800 SAO BORJA",1,1,6,770,1,779,"2011"
"10585","431805 SAO DOMINGOS DO SUL",0,0,1,23,0,24,"2011"
"10586","431810 SAO FRANCISCO DE ASSIS",0,1,1,190,0,192,"2011"
"10587","431820 SAO FRANCISCO DE PAULA",2,0,5,272,1,280,"2011"
"10588","431830 SAO GABRIEL",5,2,7,747,4,765,"2011"
"10589","431840 SAO JERONIMO",0,1,4,282,0,287,"2011"
"10590","431842 SAO JOAO DA URTIGA",0,0,1,33,0,34,"2011"
"10591","431843 SAO JOAO DO POLESINE",0,0,0,27,0,27,"2011"
"10592","431844 SAO JORGE",0,0,0,19,0,19,"2011"
"10593","431845 SAO JOSE DAS MISSOES",0,0,0,26,0,26,"2011"
"10594","431846 SAO JOSE DO HERVAL",0,0,2,23,0,25,"2011"
"10595","431848 SAO JOSE DO HORTENCIO",0,0,0,29,0,29,"2011"
"10596","431849 SAO JOSE DO INHACORA",0,0,1,10,0,11,"2011"
"10597","431850 SAO JOSE DO NORTE",0,2,5,270,6,283,"2011"
"10598","431860 SAO JOSE DO OURO",0,0,0,77,0,77,"2011"
"10599","431861 SAO JOSE DO SUL",0,0,1,21,0,22,"2011"
"10600","431862 SAO JOSE DOS AUSENTES",0,0,0,29,5,34,"2011"
"10601","431870 SAO LEOPOLDO",1,15,49,2942,15,3022,"2011"
"10602","431880 SAO LOURENCO DO SUL",3,3,10,429,2,447,"2011"
"10603","431890 SAO LUIZ GONZAGA",0,1,0,423,2,426,"2011"
"10604","431900 SAO MARCOS",0,1,3,196,0,200,"2011"
"10605","431910 SAO MARTINHO",0,0,0,58,1,59,"2011"
"10606","431912 SAO MARTINHO DA SERRA",0,0,0,28,0,28,"2011"
"10607","431915 SAO MIGUEL DAS MISSOES",0,0,0,78,1,79,"2011"
"10608","431920 SAO NICOLAU",0,0,0,53,0,53,"2011"
"10609","431930 SAO PAULO DAS MISSOES",0,0,0,55,0,55,"2011"
"10610","431935 SAO PEDRO DA SERRA",0,0,0,27,0,27,"2011"
"10611","431936 SAO PEDRO DAS MISSOES",0,0,0,32,1,33,"2011"
"10612","431937 SAO PEDRO DO BUTIA",0,0,0,20,0,20,"2011"
"10613","431940 SAO PEDRO DO SUL",1,1,2,162,2,168,"2011"
"10614","431950 SAO SEBASTIAO DO CAI",0,1,2,266,0,269,"2011"
"10615","431960 SAO SEPE",0,0,1,224,0,225,"2011"
"10616","431970 SAO VALENTIM",0,1,1,33,0,35,"2011"
"10617","431971 SAO VALENTIM DO SUL",0,0,0,5,0,5,"2011"
"10618","431973 SAO VALERIO DO SUL",0,0,1,38,0,39,"2011"
"10619","431975 SAO VENDELINO",0,0,0,16,0,16,"2011"
"10620","431980 SAO VICENTE DO SUL",2,0,0,76,3,81,"2011"
"10621","431990 SAPIRANGA",3,4,18,1150,2,1177,"2011"
"10622","432000 SAPUCAIA DO SUL",3,7,41,1707,2,1760,"2011"
"10623","432010 SARANDI",1,0,7,259,1,268,"2011"
"10624","432020 SEBERI",2,1,4,140,0,147,"2011"
"10625","432023 SEDE NOVA",0,0,0,27,0,27,"2011"
"10626","432026 SEGREDO",1,1,1,78,0,81,"2011"
"10627","432030 SELBACH",0,0,1,51,0,52,"2011"
"10628","432032 SENADOR SALGADO FILHO",0,0,0,35,0,35,"2011"
"10629","432035 SENTINELA DO SUL",0,0,0,65,1,66,"2011"
"10630","432040 SERAFINA CORREA",0,0,3,222,0,225,"2011"
"10631","432045 SERIO",0,0,2,14,0,16,"2011"
"10632","432050 SERTAO",1,0,3,55,0,59,"2011"
"10633","432055 SERTAO SANTANA",0,0,1,50,2,53,"2011"
"10634","432057 SETE DE SETEMBRO",0,0,0,10,0,10,"2011"
"10635","432060 SEVERIANO DE ALMEIDA",0,1,1,40,0,42,"2011"
"10636","432065 SILVEIRA MARTINS",0,0,0,16,0,16,"2011"
"10637","432067 SINIMBU",0,0,1,74,0,75,"2011"
"10638","432070 SOBRADINHO",0,1,4,166,0,171,"2011"
"10639","432080 SOLEDADE",1,1,4,379,0,385,"2011"
"10640","432085 TABAI",0,1,0,50,1,52,"2011"
"10641","432090 TAPEJARA",1,1,1,230,0,233,"2011"
"10642","432100 TAPERA",1,0,2,122,0,125,"2011"
"10643","432110 TAPES",0,0,2,158,2,162,"2011"
"10644","432120 TAQUARA",3,2,2,609,1,617,"2011"
"10645","432130 TAQUARI",0,1,2,335,2,340,"2011"
"10646","432132 TAQUARUCU DO SUL",0,0,0,32,0,32,"2011"
"10647","432135 TAVARES",0,0,1,43,0,44,"2011"
"10648","432140 TENENTE PORTELA",1,0,1,220,0,222,"2011"
"10649","432143 TERRA DE AREIA",0,0,2,109,1,112,"2011"
"10650","432145 TEUTONIA",2,1,7,380,0,390,"2011"
"10651","432146 TIO HUGO",1,0,0,41,0,42,"2011"
"10652","432147 TIRADENTES DO SUL",0,0,0,64,0,64,"2011"
"10653","432149 TOROPI",0,0,0,22,0,22,"2011"
"10654","432150 TORRES",1,2,4,472,0,479,"2011"
"10655","432160 TRAMANDAI",0,4,22,627,7,660,"2011"
"10656","432162 TRAVESSEIRO",0,1,0,17,0,18,"2011"
"10657","432163 TRES ARROIOS",0,0,0,14,0,14,"2011"
"10658","432166 TRES CACHOEIRAS",0,0,2,112,0,114,"2011"
"10659","432170 TRES COROAS",0,2,8,325,0,335,"2011"
"10660","432180 TRES DE MAIO",1,1,2,276,0,280,"2011"
"10661","432183 TRES FORQUILHAS",0,0,1,30,0,31,"2011"
"10662","432185 TRES PALMEIRAS",0,0,0,41,0,41,"2011"
"10663","432190 TRES PASSOS",0,2,0,269,0,271,"2011"
"10664","432195 TRINDADE DO SUL",0,0,0,71,0,71,"2011"
"10665","432200 TRIUNFO",1,1,1,373,1,377,"2011"
"10666","432210 TUCUNDUVA",0,0,2,53,0,55,"2011"
"10667","432215 TUNAS",0,0,0,39,0,39,"2011"
"10668","432218 TUPANCI DO SUL",0,0,0,7,0,7,"2011"
"10669","432220 TUPANCIRETA",2,0,3,270,0,275,"2011"
"10670","432225 TUPANDI",0,0,0,62,0,62,"2011"
"10671","432230 TUPARENDI",0,0,0,66,0,66,"2011"
"10672","432232 TURUCU",0,0,0,27,1,28,"2011"
"10673","432234 UBIRETAMA",0,0,0,17,0,17,"2011"
"10674","432235 UNIAO DA SERRA",0,0,0,6,0,6,"2011"
"10675","432237 UNISTALDA",0,0,1,26,0,27,"2011"
"10676","432240 URUGUAIANA",3,10,25,1255,683,1976,"2011"
"10677","432250 VACARIA",0,6,7,761,198,972,"2011"
"10678","432252 VALE VERDE",0,0,1,26,1,28,"2011"
"10679","432253 VALE DO SOL",0,0,0,101,0,101,"2011"
"10680","432254 VALE REAL",0,0,1,57,0,58,"2011"
"10681","432255 VANINI",0,0,0,21,0,21,"2011"
"10682","432260 VENANCIO AIRES",1,1,11,717,1,731,"2011"
"10683","432270 VERA CRUZ",0,0,2,262,0,264,"2011"
"10684","432280 VERANOPOLIS",0,2,2,210,1,215,"2011"
"10685","432285 VESPASIANO CORREA",0,0,0,12,0,12,"2011"
"10686","432290 VIADUTOS",0,0,1,39,0,40,"2011"
"10687","432300 VIAMAO",8,18,60,3209,29,3324,"2011"
"10688","432310 VICENTE DUTRA",0,0,3,61,0,64,"2011"
"10689","432320 VICTOR GRAEFF",0,0,1,25,0,26,"2011"
"10690","432330 VILA FLORES",0,0,0,29,0,29,"2011"
"10691","432335 VILA LANGARO",0,0,0,13,0,13,"2011"
"10692","432340 VILA MARIA",0,0,0,51,0,51,"2011"
"10693","432345 VILA NOVA DO SUL",0,0,0,37,1,38,"2011"
"10694","432350 VISTA ALEGRE",0,0,0,25,0,25,"2011"
"10695","432360 VISTA ALEGRE DO PRATA",0,0,0,10,0,10,"2011"
"10696","432370 VISTA GAUCHA",0,0,0,33,0,33,"2011"
"10697","432375 VITORIA DAS MISSOES",0,0,0,18,0,18,"2011"
"10698","432377 WESTFALIA",0,0,0,26,0,26,"2011"
"10699","432380 XANGRI-LA",0,1,1,185,0,187,"2011"
"10700","500020 AGUA CLARA",0,1,0,282,0,283,"2011"
"10701","500025 ALCINOPOLIS",0,0,1,42,1,44,"2011"
"10702","500060 AMAMBAI",1,3,5,723,2,734,"2011"
"10703","500070 ANASTACIO",1,0,6,447,17,471,"2011"
"10704","500080 ANAURILANDIA",0,1,6,104,0,111,"2011"
"10705","500085 ANGELICA",0,0,2,135,0,137,"2011"
"10706","500090 ANTONIO JOAO",0,2,0,167,1,170,"2011"
"10707","500100 APARECIDA DO TABOADO",0,2,4,284,0,290,"2011"
"10708","500110 AQUIDAUANA",2,4,14,862,9,891,"2011"
"10709","500124 ARAL MOREIRA",0,48,2,96,4,150,"2011"
"10710","500150 BANDEIRANTES",0,0,2,67,0,69,"2011"
"10711","500190 BATAGUASSU",1,1,4,356,0,362,"2011"
"10712","500200 BATAYPORA",2,0,2,186,1,191,"2011"
"10713","500210 BELA VISTA",4,2,8,453,6,473,"2011"
"10714","500215 BODOQUENA",0,1,2,142,0,145,"2011"
"10715","500220 BONITO",2,0,1,335,0,338,"2011"
"10716","500230 BRASILANDIA",1,0,0,124,0,125,"2011"
"10717","500240 CAARAPO",13,1,1,521,0,536,"2011"
"10718","500260 CAMAPUA",0,1,1,170,2,174,"2011"
"10719","500270 CAMPO GRANDE",103,23,132,12561,226,13045,"2011"
"10720","500280 CARACOL",0,0,1,91,0,92,"2011"
"10721","500290 CASSILANDIA",1,2,1,261,0,265,"2011"
"10722","500295 CHAPADAO DO SUL",2,0,2,373,1,378,"2011"
"10723","500310 CORGUINHO",0,0,1,42,1,44,"2011"
"10724","500315 CORONEL SAPUCAIA",1,0,5,294,9,309,"2011"
"10725","500320 CORUMBA",3,9,24,1960,0,1996,"2011"
"10726","500325 COSTA RICA",3,1,3,330,1,338,"2011"
"10727","500330 COXIM",1,1,5,585,0,592,"2011"
"10728","500345 DEODAPOLIS",0,0,2,148,0,150,"2011"
"10729","500348 DOIS IRMAOS DO BURITI",2,0,1,68,55,126,"2011"
"10730","500350 DOURADINA",1,0,0,81,2,84,"2011"
"10731","500370 DOURADOS",15,18,64,3710,27,3834,"2011"
"10732","500375 ELDORADO",0,0,2,185,0,187,"2011"
"10733","500380 FATIMA DO SUL",1,2,7,233,0,243,"2011"
"10734","500390 FIGUEIRAO",1,0,3,32,0,36,"2011"
"10735","500400 GLORIA DE DOURADOS",0,0,0,126,0,126,"2011"
"10736","500410 GUIA LOPES DA LAGUNA",0,0,0,217,0,217,"2011"
"10737","500430 IGUATEMI",1,0,0,245,0,246,"2011"
"10738","500440 INOCENCIA",0,0,1,114,0,115,"2011"
"10739","500450 ITAPORA",0,0,7,221,0,228,"2011"
"10740","500460 ITAQUIRAI",0,1,3,238,0,242,"2011"
"10741","500470 IVINHEMA",0,0,3,333,0,336,"2011"
"10742","500480 JAPORA",0,0,3,181,14,198,"2011"
"10743","500490 JARAGUARI",0,1,0,35,0,36,"2011"
"10744","500500 JARDIM",0,2,2,447,3,454,"2011"
"10745","500510 JATEI",1,0,4,69,0,74,"2011"
"10746","500515 JUTI",0,1,1,88,0,90,"2011"
"10747","500520 LADARIO",0,6,8,400,1,415,"2011"
"10748","500525 LAGUNA CARAPA",1,0,0,95,10,106,"2011"
"10749","500540 MARACAJU",2,7,7,589,8,613,"2011"
"10750","500560 MIRANDA",4,1,9,495,3,512,"2011"
"10751","500568 MUNDO NOVO",0,2,12,262,0,276,"2011"
"10752","500570 NAVIRAI",2,5,9,823,0,839,"2011"
"10753","500580 NIOAQUE",0,1,0,147,5,153,"2011"
"10754","500600 NOVA ALVORADA DO SUL",0,2,5,304,0,311,"2011"
"10755","500620 NOVA ANDRADINA",6,2,9,701,3,721,"2011"
"10756","500625 NOVO HORIZONTE DO SUL",0,1,0,70,0,71,"2011"
"10757","500630 PARANAIBA",2,0,9,512,0,523,"2011"
"10758","500635 PARANHOS",2,1,1,314,34,352,"2011"
"10759","500640 PEDRO GOMES",1,0,2,97,0,100,"2011"
"10760","500660 PONTA PORA",9,8,23,1384,383,1807,"2011"
"10761","500690 PORTO MURTINHO",0,1,7,255,9,272,"2011"
"10762","500710 RIBAS DO RIO PARDO",2,0,4,318,6,330,"2011"
"10763","500720 RIO BRILHANTE",2,6,14,587,2,611,"2011"
"10764","500730 RIO NEGRO",1,0,1,66,2,70,"2011"
"10765","500740 RIO VERDE DE MATO GROSSO",0,2,0,286,0,288,"2011"
"10766","500750 ROCHEDO",0,0,0,58,0,58,"2011"
"10767","500755 SANTA RITA DO PARDO",0,0,3,94,0,97,"2011"
"10768","500769 SAO GABRIEL DO OESTE",1,1,2,368,2,374,"2011"
"10769","500770 SETE QUEDAS",1,5,4,165,8,183,"2011"
"10770","500780 SELVIRIA",0,0,1,60,0,61,"2011"
"10771","500790 SIDROLANDIA",2,1,5,675,3,686,"2011"
"10772","500793 SONORA",1,2,2,276,0,281,"2011"
"10773","500795 TACURU",0,1,2,222,0,225,"2011"
"10774","500797 TAQUARUSSU",0,0,0,51,0,51,"2011"
"10775","500800 TERENOS",0,1,1,150,3,155,"2011"
"10776","500830 TRES LAGOAS",6,5,7,1751,0,1769,"2011"
"10777","500840 VICENTINA",0,0,0,67,0,67,"2011"
"10778","MUNICIPIO IGNORADO - MT",0,0,0,1,0,1,"2011"
"10779","510010 ACORIZAL",0,0,1,63,2,66,"2011"
"10780","510020 AGUA BOA",0,1,5,323,12,341,"2011"
"10781","510025 ALTA FLORESTA",1,4,5,750,1,761,"2011"
"10782","510030 ALTO ARAGUAIA",3,2,1,228,1,235,"2011"
"10783","510035 ALTO BOA VISTA",0,0,0,55,0,55,"2011"
"10784","510040 ALTO GARCAS",0,1,2,110,0,113,"2011"
"10785","510050 ALTO PARAGUAI",0,1,0,115,1,117,"2011"
"10786","510060 ALTO TAQUARI",0,3,4,179,0,186,"2011"
"10787","510080 APIACAS",0,2,8,132,1,143,"2011"
"10788","510100 ARAGUAIANA",0,0,0,36,0,36,"2011"
"10789","510120 ARAGUAINHA",0,0,0,14,0,14,"2011"
"10790","510125 ARAPUTANGA",2,0,2,267,0,271,"2011"
"10791","510130 ARENAPOLIS",0,1,4,127,0,132,"2011"
"10792","510140 ARIPUANA",1,2,6,379,2,390,"2011"
"10793","510160 BARAO DE MELGACO",0,0,1,55,3,59,"2011"
"10794","510170 BARRA DO BUGRES",1,5,11,533,5,555,"2011"
"10795","510180 BARRA DO GARCAS",0,5,9,877,13,904,"2011"
"10796","510185 BOM JESUS DO ARAGUAIA",0,1,1,62,2,66,"2011"
"10797","510190 BRASNORTE",0,2,10,257,11,280,"2011"
"10798","510250 CACERES",1,4,9,1522,2,1538,"2011"
"10799","510260 CAMPINAPOLIS",1,2,6,149,75,233,"2011"
"10800","510263 CAMPO NOVO DO PARECIS",1,1,5,543,0,550,"2011"
"10801","510267 CAMPO VERDE",0,0,8,599,2,609,"2011"
"10802","510268 CAMPOS DE JULIO",1,0,0,113,0,114,"2011"
"10803","510269 CANABRAVA DO NORTE",0,0,1,57,0,58,"2011"
"10804","510270 CANARANA",1,2,4,339,20,366,"2011"
"10805","510279 CARLINDA",0,0,1,87,0,88,"2011"
"10806","510285 CASTANHEIRA",0,0,2,87,0,89,"2011"
"10807","510300 CHAPADA DOS GUIMARAES",3,0,3,227,0,233,"2011"
"10808","510305 CLAUDIA",0,0,1,154,0,155,"2011"
"10809","510310 COCALINHO",1,0,2,74,0,77,"2011"
"10810","510320 COLIDER",5,1,11,463,1,481,"2011"
"10811","510325 COLNIZA",1,2,7,431,2,443,"2011"
"10812","510330 COMODORO",0,2,13,314,21,350,"2011"
"10813","510335 CONFRESA",4,1,1,417,1,424,"2011"
"10814","510336 CONQUISTA D'OESTE",0,2,1,54,5,62,"2011"
"10815","510337 COTRIGUACU",1,1,2,222,0,226,"2011"
"10816","510340 CUIABA",28,39,120,9739,30,9956,"2011"
"10817","510343 CURVELANDIA",0,1,0,59,0,60,"2011"
"10818","510345 DENISE",0,1,1,133,0,135,"2011"
"10819","510350 DIAMANTINO",0,0,10,334,1,345,"2011"
"10820","510360 DOM AQUINO",0,0,1,126,3,130,"2011"
"10821","510370 FELIZ NATAL",0,2,3,162,11,178,"2011"
"10822","510380 FIGUEIROPOLIS D'OESTE",0,0,0,55,0,55,"2011"
"10823","510385 GAUCHA DO NORTE",1,2,4,75,25,107,"2011"
"10824","510390 GENERAL CARNEIRO",0,0,3,103,3,109,"2011"
"10825","510395 GLORIA D'OESTE",0,0,0,38,1,39,"2011"
"10826","510410 GUARANTA DO NORTE",1,1,10,420,1,433,"2011"
"10827","510420 GUIRATINGA",0,0,1,122,1,124,"2011"
"10828","510450 INDIAVAI",0,0,0,40,0,40,"2011"
"10829","510452 IPIRANGA DO NORTE",0,0,3,87,1,91,"2011"
"10830","510454 ITANHANGA",0,0,0,84,0,84,"2011"
"10831","510455 ITAUBA",0,0,1,65,1,67,"2011"
"10832","510460 ITIQUIRA",0,0,3,156,1,160,"2011"
"10833","510480 JACIARA",3,0,1,463,0,467,"2011"
"10834","510490 JANGADA",1,0,1,95,1,98,"2011"
"10835","510500 JAURU",0,1,5,150,0,156,"2011"
"10836","510510 JUARA",0,1,4,534,10,549,"2011"
"10837","510515 JUINA",1,2,7,554,40,604,"2011"
"10838","510517 JURUENA",0,0,5,169,0,174,"2011"
"10839","510520 JUSCIMEIRA",2,0,1,157,1,161,"2011"
"10840","510523 LAMBARI D'OESTE",0,0,2,63,0,65,"2011"
"10841","510525 LUCAS DO RIO VERDE",3,3,7,946,2,961,"2011"
"10842","510530 LUCIARA",0,0,0,38,0,38,"2011"
"10843","510550 VILA BELA DA SANTISSIMA TRINDADE",1,1,3,185,13,203,"2011"
"10844","510558 MARCELANDIA",0,3,32,148,6,189,"2011"
"10845","510560 MATUPA",0,2,15,242,0,259,"2011"
"10846","510562 MIRASSOL D'OESTE",3,2,2,396,0,403,"2011"
"10847","510590 NOBRES",1,3,8,295,1,308,"2011"
"10848","510600 NORTELANDIA",1,1,2,90,0,94,"2011"
"10849","510610 NOSSA SENHORA DO LIVRAMENTO",0,0,5,157,0,162,"2011"
"10850","510615 NOVA BANDEIRANTES",0,1,5,142,0,148,"2011"
"10851","510617 NOVA NAZARE",0,1,0,23,1,25,"2011"
"10852","510618 NOVA LACERDA",0,0,3,94,1,98,"2011"
"10853","510619 NOVA SANTA HELENA",0,0,0,37,0,37,"2011"
"10854","510620 NOVA BRASILANDIA",0,0,1,33,2,36,"2011"
"10855","510621 NOVA CANAA DO NORTE",0,2,2,176,0,180,"2011"
"10856","510622 NOVA MUTUM",2,0,3,616,2,623,"2011"
"10857","510623 NOVA OLIMPIA",0,0,3,295,0,298,"2011"
"10858","510624 NOVA UBIRATA",0,0,2,141,0,143,"2011"
"10859","510625 NOVA XAVANTINA",0,0,3,275,0,278,"2011"
"10860","510626 NOVO MUNDO",0,0,2,77,0,79,"2011"
"10861","510627 NOVO HORIZONTE DO NORTE",1,0,0,36,0,37,"2011"
"10862","510628 NOVO SAO JOAQUIM",0,0,0,85,0,85,"2011"
"10863","510629 PARANAITA",0,2,0,125,0,127,"2011"
"10864","510630 PARANATINGA",1,2,7,322,17,349,"2011"
"10865","510631 NOVO SANTO ANTONIO",0,0,0,15,0,15,"2011"
"10866","510637 PEDRA PRETA",0,0,3,203,0,206,"2011"
"10867","510642 PEIXOTO DE AZEVEDO",0,1,12,442,0,455,"2011"
"10868","510645 PLANALTO DA SERRA",0,0,0,23,0,23,"2011"
"10869","510650 POCONE",1,0,9,519,0,529,"2011"
"10870","510665 PONTAL DO ARAGUAIA",0,0,1,70,0,71,"2011"
"10871","510670 PONTE BRANCA",0,0,4,10,0,14,"2011"
"10872","510675 PONTES E LACERDA",2,5,3,719,1,730,"2011"
"10873","510677 PORTO ALEGRE DO NORTE",0,0,1,139,0,140,"2011"
"10874","510680 PORTO DOS GAUCHOS",0,1,3,61,0,65,"2011"
"10875","510682 PORTO ESPERIDIAO",0,1,2,166,2,171,"2011"
"10876","510685 PORTO ESTRELA",0,0,1,39,0,40,"2011"
"10877","510700 POXOREO",2,2,3,188,1,196,"2011"
"10878","510704 PRIMAVERA DO LESTE",2,0,9,1025,7,1043,"2011"
"10879","510706 QUERENCIA",0,0,1,249,20,270,"2011"
"10880","510710 SAO JOSE DOS QUATRO MARCOS",0,0,0,266,0,266,"2011"
"10881","510715 RESERVA DO CABACAL",0,0,0,39,0,39,"2011"
"10882","510718 RIBEIRAO CASCALHEIRA",0,0,3,121,1,125,"2011"
"10883","510719 RIBEIRAOZINHO",0,0,0,27,0,27,"2011"
"10884","510720 RIO BRANCO",0,1,0,60,0,61,"2011"
"10885","510724 SANTA CARMEM",0,0,1,58,1,60,"2011"
"10886","510726 SANTO AFONSO",0,1,3,26,0,30,"2011"
"10887","510729 SAO JOSE DO POVO",0,0,0,23,0,23,"2011"
"10888","510730 SAO JOSE DO RIO CLARO",1,0,2,237,0,240,"2011"
"10889","510735 SAO JOSE DO XINGU",0,0,1,91,0,92,"2011"
"10890","510740 SAO PEDRO DA CIPA",0,0,1,66,1,68,"2011"
"10891","510757 RONDOLANDIA",0,1,0,23,0,24,"2011"
"10892","510760 RONDONOPOLIS",7,7,41,3605,14,3674,"2011"
"10893","510770 ROSARIO OESTE",2,1,1,149,4,157,"2011"
"10894","510774 SANTA CRUZ DO XINGU",0,0,0,19,0,19,"2011"
"10895","510775 SALTO DO CEU",0,0,0,39,0,39,"2011"
"10896","510776 SANTA RITA DO TRIVELATO",0,0,1,37,0,38,"2011"
"10897","510777 SANTA TEREZINHA",0,0,0,86,2,88,"2011"
"10898","510779 SANTO ANTONIO DO LESTE",0,0,0,35,0,35,"2011"
"10899","510780 SANTO ANTONIO DO LEVERGER",0,1,2,229,3,235,"2011"
"10900","510785 SAO FELIX DO ARAGUAIA",0,2,0,120,2,124,"2011"
"10901","510787 SAPEZAL",3,4,7,351,1,366,"2011"
"10902","510788 SERRA NOVA DOURADA",0,0,0,10,0,10,"2011"
"10903","510790 SINOP",3,9,30,2154,3,2199,"2011"
"10904","510792 SORRISO",3,3,13,1322,1,1342,"2011"
"10905","510794 TABAPORA",0,1,2,133,0,136,"2011"
"10906","510795 TANGARA DA SERRA",2,2,35,1318,9,1366,"2011"
"10907","510800 TAPURAH",2,1,0,169,1,173,"2011"
"10908","510805 TERRA NOVA DO NORTE",1,2,3,127,0,133,"2011"
"10909","510810 TESOURO",0,0,2,32,0,34,"2011"
"10910","510820 TORIXOREU",0,0,1,32,0,33,"2011"
"10911","510830 UNIAO DO SUL",0,0,1,50,0,51,"2011"
"10912","510835 VALE DE SAO DOMINGOS",0,0,0,49,0,49,"2011"
"10913","510840 VARZEA GRANDE",13,18,42,4737,8,4818,"2011"
"10914","510850 VERA",0,1,1,110,1,113,"2011"
"10915","510860 VILA RICA",4,0,0,307,2,313,"2011"
"10916","510880 NOVA GUARITA",1,0,1,50,0,52,"2011"
"10917","510885 NOVA MARILANDIA",0,1,1,35,0,37,"2011"
"10918","510890 NOVA MARINGA",0,0,1,92,0,93,"2011"
"10919","510895 NOVA MONTE VERDE",0,0,1,98,1,100,"2011"
"10920","MUNICIPIO IGNORADO - GO",0,0,0,5,1,6,"2011"
"10921","520005 ABADIA DE GOIAS",0,1,1,90,0,92,"2011"
"10922","520010 ABADIANIA",1,2,5,130,0,138,"2011"
"10923","520013 ACREUNA",0,2,43,231,0,276,"2011"
"10924","520015 ADELANDIA",1,0,1,25,0,27,"2011"
"10925","520017 AGUA FRIA DE GOIAS",0,0,0,49,0,49,"2011"
"10926","520020 AGUA LIMPA",0,0,0,22,0,22,"2011"
"10927","520025 AGUAS LINDAS DE GOIAS",5,13,35,2434,216,2703,"2011"
"10928","520030 ALEXANIA",0,1,5,339,7,352,"2011"
"10929","520050 ALOANDIA",0,0,0,23,0,23,"2011"
"10930","520055 ALTO HORIZONTE",0,0,3,75,0,78,"2011"
"10931","520060 ALTO PARAISO DE GOIAS",1,2,1,85,0,89,"2011"
"10932","520080 ALVORADA DO NORTE",0,0,2,98,0,100,"2011"
"10933","520082 AMARALINA",0,0,0,29,0,29,"2011"
"10934","520085 AMERICANO DO BRASIL",1,0,1,67,1,70,"2011"
"10935","520090 AMORINOPOLIS",0,0,1,40,0,41,"2011"
"10936","520110 ANAPOLIS",9,16,118,4894,26,5063,"2011"
"10937","520120 ANHANGUERA",1,0,0,6,0,7,"2011"
"10938","520130 ANICUNS",6,0,5,202,1,214,"2011"
"10939","520140 APARECIDA DE GOIANIA",29,21,121,7591,56,7818,"2011"
"10940","520145 APARECIDA DO RIO DOCE",0,0,0,28,0,28,"2011"
"10941","520150 APORE",0,0,2,49,0,51,"2011"
"10942","520160 ARACU",0,0,1,24,0,25,"2011"
"10943","520170 ARAGARCAS",1,4,21,311,1,338,"2011"
"10944","520180 ARAGOIANIA",1,0,2,106,1,110,"2011"
"10945","520215 ARAGUAPAZ",0,2,3,79,2,86,"2011"
"10946","520235 ARENOPOLIS",0,0,0,31,0,31,"2011"
"10947","520250 ARUANA",0,2,1,72,0,75,"2011"
"10948","520260 AURILANDIA",0,0,0,42,0,42,"2011"
"10949","520280 AVELINOPOLIS",0,0,0,20,0,20,"2011"
"10950","520310 BALIZA",0,0,1,39,1,41,"2011"
"10951","520320 BARRO ALTO",0,1,1,122,1,125,"2011"
"10952","520330 BELA VISTA DE GOIAS",0,0,5,279,0,284,"2011"
"10953","520340 BOM JARDIM DE GOIAS",0,1,3,100,0,104,"2011"
"10954","520350 BOM JESUS DE GOIAS",0,1,3,260,0,264,"2011"
"10955","520355 BONFINOPOLIS",1,1,2,92,2,98,"2011"
"10956","520357 BONOPOLIS",0,0,2,36,0,38,"2011"
"10957","520360 BRAZABRANTES",0,0,2,33,0,35,"2011"
"10958","520380 BRITANIA",0,0,1,70,0,71,"2011"
"10959","520390 BURITI ALEGRE",0,1,0,97,0,98,"2011"
"10960","520393 BURITI DE GOIAS",0,0,2,23,0,25,"2011"
"10961","520396 BURITINOPOLIS",0,0,0,31,0,31,"2011"
"10962","520400 CABECEIRAS",0,0,0,105,0,105,"2011"
"10963","520410 CACHOEIRA ALTA",0,1,0,97,1,99,"2011"
"10964","520420 CACHOEIRA DE GOIAS",0,0,0,13,1,14,"2011"
"10965","520425 CACHOEIRA DOURADA",1,0,1,37,0,39,"2011"
"10966","520430 CACU",2,2,7,115,0,126,"2011"
"10967","520440 CAIAPONIA",0,0,3,166,0,169,"2011"
"10968","520450 CALDAS NOVAS",2,5,17,1097,2,1123,"2011"
"10969","520455 CALDAZINHA",0,0,0,36,0,36,"2011"
"10970","520460 CAMPESTRE DE GOIAS",0,1,1,30,1,33,"2011"
"10971","520465 CAMPINACU",1,0,0,43,0,44,"2011"
"10972","520470 CAMPINORTE",0,2,4,156,0,162,"2011"
"10973","520480 CAMPO ALEGRE DE GOIAS",0,0,0,72,1,73,"2011"
"10974","520485 CAMPO LIMPO DE GOIAS",0,0,0,47,0,47,"2011"
"10975","520490 CAMPOS BELOS",0,0,4,338,1,343,"2011"
"10976","520495 CAMPOS VERDES",0,2,3,67,0,72,"2011"
"10977","520500 CARMO DO RIO VERDE",0,0,1,81,0,82,"2011"
"10978","520505 CASTELANDIA",0,0,0,54,0,54,"2011"
"10979","520510 CATALAO",1,4,12,1259,5,1281,"2011"
"10980","520520 CATURAI",0,1,1,45,0,47,"2011"
"10981","520530 CAVALCANTE",0,0,2,136,1,139,"2011"
"10982","520540 CERES",0,0,3,224,0,227,"2011"
"10983","520545 CEZARINA",0,1,5,109,1,116,"2011"
"10984","520547 CHAPADAO DO CEU",0,0,1,117,0,118,"2011"
"10985","520549 CIDADE OCIDENTAL",1,6,16,920,11,954,"2011"
"10986","520551 COCALZINHO DE GOIAS",1,0,4,188,9,202,"2011"
"10987","520552 COLINAS DO SUL",0,1,2,36,1,40,"2011"
"10988","520570 CORREGO DO OURO",0,0,1,24,0,25,"2011"
"10989","520580 CORUMBA DE GOIAS",0,1,5,87,2,95,"2011"
"10990","520590 CORUMBAIBA",0,0,1,105,1,107,"2011"
"10991","520620 CRISTALINA",2,2,14,652,4,674,"2011"
"10992","520630 CRISTIANOPOLIS",0,0,0,31,0,31,"2011"
"10993","520640 CRIXAS",0,1,4,210,0,215,"2011"
"10994","520650 CROMINIA",0,0,0,34,0,34,"2011"
"10995","520660 CUMARI",0,1,1,20,1,23,"2011"
"10996","520670 DAMIANOPOLIS",0,0,0,32,0,32,"2011"
"10997","520680 DAMOLANDIA",0,0,1,36,0,37,"2011"
"10998","520690 DAVINOPOLIS",0,0,0,16,0,16,"2011"
"10999","520710 DIORAMA",0,0,2,18,0,20,"2011"
"11000","520725 DOVERLANDIA",0,1,3,63,1,68,"2011"
"11001","520735 EDEALINA",0,0,1,43,2,46,"2011"
"11002","520740 EDEIA",0,0,1,150,1,152,"2011"
"11003","520750 ESTRELA DO NORTE",0,0,0,30,0,30,"2011"
"11004","520753 FAINA",0,1,1,43,0,45,"2011"
"11005","520760 FAZENDA NOVA",0,0,1,48,0,49,"2011"
"11006","520780 FIRMINOPOLIS",0,0,0,112,1,113,"2011"
"11007","520790 FLORES DE GOIAS",0,1,1,93,2,97,"2011"
"11008","520800 FORMOSA",4,3,10,1748,2,1767,"2011"
"11009","520810 FORMOSO",0,0,2,49,0,51,"2011"
"11010","520815 GAMELEIRA DE GOIAS",0,0,0,25,0,25,"2011"
"11011","520830 DIVINOPOLIS DE GOIAS",0,0,1,64,3,68,"2011"
"11012","520840 GOIANAPOLIS",0,4,3,131,1,139,"2011"
"11013","520850 GOIANDIRA",0,1,0,39,0,40,"2011"
"11014","520860 GOIANESIA",4,2,22,872,3,903,"2011"
"11015","520870 GOIANIA",102,69,296,20126,115,20708,"2011"
"11016","520880 GOIANIRA",0,2,10,490,1,503,"2011"
"11017","520890 GOIAS",2,3,7,275,2,289,"2011"
"11018","520910 GOIATUBA",0,1,4,415,0,420,"2011"
"11019","520915 GOUVELANDIA",0,0,0,43,0,43,"2011"
"11020","520920 GUAPO",3,0,4,169,1,177,"2011"
"11021","520929 GUARAITA",1,0,0,31,1,33,"2011"
"11022","520940 GUARANI DE GOIAS",0,0,1,39,0,40,"2011"
"11023","520945 GUARINOS",0,0,0,18,0,18,"2011"
"11024","520960 HEITORAI",0,0,1,29,0,30,"2011"
"11025","520970 HIDROLANDIA",2,0,4,207,0,213,"2011"
"11026","520980 HIDROLINA",0,0,0,33,0,33,"2011"
"11027","520990 IACIARA",0,0,4,167,1,172,"2011"
"11028","520993 INACIOLANDIA",1,1,2,77,0,81,"2011"
"11029","520995 INDIARA",1,0,4,209,2,216,"2011"
"11030","521000 INHUMAS",1,5,16,708,0,730,"2011"
"11031","521010 IPAMERI",1,1,3,295,0,300,"2011"
"11032","521015 IPIRANGA DE GOIAS",0,0,0,25,0,25,"2011"
"11033","521020 IPORA",1,0,7,318,1,327,"2011"
"11034","521030 ISRAELANDIA",0,0,1,24,0,25,"2011"
"11035","521040 ITABERAI",0,0,10,527,1,538,"2011"
"11036","521056 ITAGUARI",0,0,0,54,0,54,"2011"
"11037","521060 ITAGUARU",0,0,0,36,0,36,"2011"
"11038","521080 ITAJA",0,0,2,77,0,79,"2011"
"11039","521090 ITAPACI",0,1,1,262,0,264,"2011"
"11040","521100 ITAPIRAPUA",0,1,1,98,1,101,"2011"
"11041","521120 ITAPURANGA",0,1,0,315,1,317,"2011"
"11042","521130 ITARUMA",0,0,1,64,0,65,"2011"
"11043","521140 ITAUCU",1,3,2,68,2,76,"2011"
"11044","521150 ITUMBIARA",3,1,9,1272,2,1287,"2011"
"11045","521160 IVOLANDIA",0,0,1,27,1,29,"2011"
"11046","521170 JANDAIA",0,0,2,65,0,67,"2011"
"11047","521180 JARAGUA",2,1,7,577,4,591,"2011"
"11048","521190 JATAI",7,7,20,1378,1,1413,"2011"
"11049","521200 JAUPACI",0,0,0,31,0,31,"2011"
"11050","521205 JESUPOLIS",0,0,0,33,0,33,"2011"
"11051","521210 JOVIANIA",0,0,0,97,0,97,"2011"
"11052","521220 JUSSARA",1,2,2,227,10,242,"2011"
"11053","521225 LAGOA SANTA",0,0,0,19,0,19,"2011"
"11054","521230 LEOPOLDO DE BULHOES",0,0,2,69,0,71,"2011"
"11055","521250 LUZIANIA",5,7,54,2933,20,3019,"2011"
"11056","521260 MAIRIPOTABA",0,0,0,13,0,13,"2011"
"11057","521270 MAMBAI",0,0,0,90,0,90,"2011"
"11058","521280 MARA ROSA",0,0,1,139,1,141,"2011"
"11059","521290 MARZAGAO",0,0,0,24,0,24,"2011"
"11060","521295 MATRINCHA",0,1,1,57,0,59,"2011"
"11061","521300 MAURILANDIA",0,2,1,173,3,179,"2011"
"11062","521305 MIMOSO DE GOIAS",1,0,1,14,2,18,"2011"
"11063","521308 MINACU",1,2,5,439,3,450,"2011"
"11064","521310 MINEIROS",3,6,8,905,0,922,"2011"
"11065","521340 MOIPORA",0,0,0,10,0,10,"2011"
"11066","521350 MONTE ALEGRE DE GOIAS",0,0,3,104,1,108,"2011"
"11067","521370 MONTES CLAROS DE GOIAS",0,1,3,107,1,112,"2011"
"11068","521375 MONTIVIDIU",0,3,5,141,0,149,"2011"
"11069","521377 MONTIVIDIU DO NORTE",0,0,3,38,0,41,"2011"
"11070","521380 MORRINHOS",1,2,4,520,1,528,"2011"
"11071","521385 MORRO AGUDO DE GOIAS",0,0,0,35,0,35,"2011"
"11072","521390 MOSSAMEDES",0,0,0,28,0,28,"2011"
"11073","521400 MOZARLANDIA",1,1,3,208,1,214,"2011"
"11074","521405 MUNDO NOVO",1,0,0,67,0,68,"2011"
"11075","521410 MUTUNOPOLIS",0,1,3,46,1,51,"2011"
"11076","521440 NAZARIO",2,0,0,69,0,71,"2011"
"11077","521450 NEROPOLIS",1,1,13,346,0,361,"2011"
"11078","521460 NIQUELANDIA",4,8,27,547,1,587,"2011"
"11079","521470 NOVA AMERICA",0,1,0,23,0,24,"2011"
"11080","521480 NOVA AURORA",0,0,0,24,0,24,"2011"
"11081","521483 NOVA CRIXAS",0,0,0,174,0,174,"2011"
"11082","521486 NOVA GLORIA",1,0,1,81,0,83,"2011"
"11083","521487 NOVA IGUACU DE GOIAS",0,0,1,31,0,32,"2011"
"11084","521490 NOVA ROMA",0,0,0,33,0,33,"2011"
"11085","521500 NOVA VENEZA",1,0,0,93,1,95,"2011"
"11086","521520 NOVO BRASIL",1,1,5,25,0,32,"2011"
"11087","521523 NOVO GAMA",3,7,26,1680,31,1747,"2011"
"11088","521525 NOVO PLANALTO",0,0,0,43,0,43,"2011"
"11089","521530 ORIZONA",1,1,2,137,0,141,"2011"
"11090","521540 OURO VERDE DE GOIAS",0,0,1,38,0,39,"2011"
"11091","521550 OUVIDOR",0,1,1,54,0,56,"2011"
"11092","521560 PADRE BERNARDO",1,0,5,307,52,365,"2011"
"11093","521565 PALESTINA DE GOIAS",0,0,1,53,0,54,"2011"
"11094","521570 PALMEIRAS DE GOIAS",0,2,5,234,0,241,"2011"
"11095","521580 PALMELO",0,0,0,24,0,24,"2011"
"11096","521590 PALMINOPOLIS",0,0,0,14,0,14,"2011"
"11097","521600 PANAMA",0,0,0,32,0,32,"2011"
"11098","521630 PARANAIGUARA",2,0,1,123,0,126,"2011"
"11099","521640 PARAUNA",0,0,2,152,0,154,"2011"
"11100","521645 PEROLANDIA",0,0,0,47,0,47,"2011"
"11101","521680 PETROLINA DE GOIAS",1,2,3,78,0,84,"2011"
"11102","521690 PILAR DE GOIAS",0,0,0,31,0,31,"2011"
"11103","521710 PIRACANJUBA",1,0,2,276,0,279,"2011"
"11104","521720 PIRANHAS",0,2,2,126,0,130,"2011"
"11105","521730 PIRENOPOLIS",4,1,7,273,2,287,"2011"
"11106","521740 PIRES DO RIO",1,2,1,343,1,348,"2011"
"11107","521760 PLANALTINA",12,4,22,1409,3,1450,"2011"
"11108","521770 PONTALINA",0,0,2,179,3,184,"2011"
"11109","521800 PORANGATU",2,1,18,563,1,585,"2011"
"11110","521805 PORTEIRAO",0,0,0,35,1,36,"2011"
"11111","521810 PORTELANDIA",0,1,0,60,0,61,"2011"
"11112","521830 POSSE",1,6,9,560,1,577,"2011"
"11113","521839 PROFESSOR JAMIL",0,0,0,30,0,30,"2011"
"11114","521850 QUIRINOPOLIS",1,1,1,469,0,472,"2011"
"11115","521860 RIALMA",1,0,1,143,0,145,"2011"
"11116","521870 RIANAPOLIS",0,0,1,71,0,72,"2011"
"11117","521878 RIO QUENTE",0,0,0,53,0,53,"2011"
"11118","521880 RIO VERDE",8,9,35,2972,0,3024,"2011"
"11119","521890 RUBIATABA",0,1,6,166,0,173,"2011"
"11120","521900 SANCLERLANDIA",0,1,1,81,5,88,"2011"
"11121","521910 SANTA BARBARA DE GOIAS",0,0,0,68,0,68,"2011"
"11122","521920 SANTA CRUZ DE GOIAS",0,0,1,25,0,26,"2011"
"11123","521925 SANTA FE DE GOIAS",0,0,0,65,1,66,"2011"
"11124","521930 SANTA HELENA DE GOIAS",3,1,3,464,0,471,"2011"
"11125","521935 SANTA ISABEL",0,0,0,35,0,35,"2011"
"11126","521940 SANTA RITA DO ARAGUAIA",1,0,1,95,0,97,"2011"
"11127","521945 SANTA RITA DO NOVO DESTINO",1,0,1,24,1,27,"2011"
"11128","521950 SANTA ROSA DE GOIAS",0,0,1,35,0,36,"2011"
"11129","521960 SANTA TEREZA DE GOIAS",0,1,3,51,0,55,"2011"
"11130","521970 SANTA TEREZINHA DE GOIAS",0,1,3,101,0,105,"2011"
"11131","521971 SANTO ANTONIO DA BARRA",0,0,2,51,0,53,"2011"
"11132","521973 SANTO ANTONIO DE GOIAS",0,0,2,87,0,89,"2011"
"11133","521975 SANTO ANTONIO DO DESCOBERTO",5,4,14,831,10,864,"2011"
"11134","521980 SAO DOMINGOS",0,0,2,145,2,149,"2011"
"11135","521990 SAO FRANCISCO DE GOIAS",0,0,1,54,0,55,"2011"
"11136","522000 SAO JOAO D'ALIANCA",0,0,2,103,1,106,"2011"
"11137","522005 SAO JOAO DA PARAUNA",0,0,0,20,0,20,"2011"
"11138","522010 SAO LUIS DE MONTES BELOS",1,0,4,326,1,332,"2011"
"11139","522015 SAO LUIZ DO NORTE",0,0,1,62,0,63,"2011"
"11140","522020 SAO MIGUEL DO ARAGUAIA",1,4,3,322,0,330,"2011"
"11141","522026 SAO MIGUEL DO PASSA QUATRO",0,0,0,36,0,36,"2011"
"11142","522028 SAO PATRICIO",0,0,0,23,0,23,"2011"
"11143","522040 SAO SIMAO",1,2,5,256,0,264,"2011"
"11144","522045 SENADOR CANEDO",4,7,24,1585,6,1626,"2011"
"11145","522050 SERRANOPOLIS",0,0,1,85,0,86,"2011"
"11146","522060 SILVANIA",0,0,4,254,1,259,"2011"
"11147","522068 SIMOLANDIA",0,0,2,106,0,108,"2011"
"11148","522070 SITIO D'ABADIA",0,0,0,7,0,7,"2011"
"11149","522100 TAQUARAL DE GOIAS",1,0,0,36,2,39,"2011"
"11150","522108 TERESINA DE GOIAS",0,0,0,38,2,40,"2011"
"11151","522119 TEREZOPOLIS DE GOIAS",2,0,4,99,0,105,"2011"
"11152","522130 TRES RANCHOS",0,0,0,26,0,26,"2011"
"11153","522140 TRINDADE",2,5,23,1532,15,1577,"2011"
"11154","522145 TROMBAS",0,0,0,24,0,24,"2011"
"11155","522150 TURVANIA",0,0,3,55,0,58,"2011"
"11156","522155 TURVELANDIA",0,0,2,67,0,69,"2011"
"11157","522157 UIRAPURU",0,0,0,27,0,27,"2011"
"11158","522160 URUACU",1,2,33,592,0,628,"2011"
"11159","522170 URUANA",0,1,1,129,1,132,"2011"
"11160","522180 URUTAI",0,0,1,30,0,31,"2011"
"11161","522185 VALPARAISO DE GOIAS",4,3,43,2374,15,2439,"2011"
"11162","522190 VARJAO",0,0,1,25,1,27,"2011"
"11163","522200 VIANOPOLIS",1,2,2,191,0,196,"2011"
"11164","522205 VICENTINOPOLIS",1,0,7,109,0,117,"2011"
"11165","522220 VILA BOA",0,0,3,62,0,65,"2011"
"11166","522230 VILA PROPICIO",0,2,1,59,0,62,"2011"
"11167","530010 BRASILIA",157,146,600,42079,483,43465,"2011"
"11168","TOTAL",9541,12805,49004,2742037,92402,2905789,"2012"
"11169","MUNICIPIO IGNORADO - RO",0,0,0,2,0,2,"2012"
"11170","110001 ALTA FLORESTA D'OESTE",0,1,4,381,0,386,"2012"
"11171","110002 ARIQUEMES",2,8,8,1313,8,1339,"2012"
"11172","110003 CABIXI",0,0,1,60,3,64,"2012"
"11173","110004 CACOAL",0,3,18,1177,3,1201,"2012"
"11174","110005 CEREJEIRAS",0,2,2,224,17,245,"2012"
"11175","110006 COLORADO DO OESTE",1,1,1,183,28,214,"2012"
"11176","110007 CORUMBIARA",2,0,3,104,7,116,"2012"
"11177","110008 COSTA MARQUES",0,3,3,226,2,234,"2012"
"11178","110009 ESPIGAO D'OESTE",0,3,7,462,4,476,"2012"
"11179","110010 GUAJARA-MIRIM",4,3,7,926,0,940,"2012"
"11180","110011 JARU",0,5,11,791,1,808,"2012"
"11181","110012 JI-PARANA",6,9,24,2030,6,2075,"2012"
"11182","110013 MACHADINHO D'OESTE",0,0,7,527,8,542,"2012"
"11183","110014 NOVA BRASILANDIA D'OESTE",0,1,8,262,0,271,"2012"
"11184","110015 OURO PRETO DO OESTE",0,7,14,626,0,647,"2012"
"11185","110018 PIMENTA BUENO",0,3,13,535,2,553,"2012"
"11186","110020 PORTO VELHO",10,21,92,8678,140,8941,"2012"
"11187","110025 PRESIDENTE MEDICI",0,0,7,235,1,243,"2012"
"11188","110026 RIO CRESPO",0,0,0,41,0,41,"2012"
"11189","110028 ROLIM DE MOURA",3,3,6,914,1,927,"2012"
"11190","110029 SANTA LUZIA D'OESTE",0,0,1,117,0,118,"2012"
"11191","110030 VILHENA",2,3,4,1024,236,1269,"2012"
"11192","110032 SAO MIGUEL DO GUAPORE",0,1,4,308,0,313,"2012"
"11193","110033 NOVA MAMORE",0,1,11,366,5,383,"2012"
"11194","110034 ALVORADA D'OESTE",0,0,6,183,0,189,"2012"
"11195","110037 ALTO ALEGRE DOS PARECIS",0,0,0,189,0,189,"2012"
"11196","110040 ALTO PARAISO",0,1,3,189,1,194,"2012"
"11197","110045 BURITIS",0,0,9,546,0,555,"2012"
"11198","110050 NOVO HORIZONTE DO OESTE",0,0,0,125,0,125,"2012"
"11199","110060 CACAULANDIA",1,0,1,59,0,61,"2012"
"11200","110070 CAMPO NOVO DE RONDONIA",1,1,2,160,0,164,"2012"
"11201","110080 CANDEIAS DO JAMARI",1,1,3,416,9,430,"2012"
"11202","110090 CASTANHEIRAS",0,0,0,53,0,53,"2012"
"11203","110092 CHUPINGUAIA",0,1,1,92,24,118,"2012"
"11204","110094 CUJUBIM",1,2,6,149,3,161,"2012"
"11205","110100 GOVERNADOR JORGE TEIXEIRA",0,1,3,128,1,133,"2012"
"11206","110110 ITAPUA DO OESTE",1,0,2,108,3,114,"2012"
"11207","110120 MINISTRO ANDREAZZA",1,2,1,96,0,100,"2012"
"11208","110130 MIRANTE DA SERRA",1,0,2,144,1,148,"2012"
"11209","110140 MONTE NEGRO",0,0,2,166,2,170,"2012"
"11210","110143 NOVA UNIAO",0,0,3,96,0,99,"2012"
"11211","110145 PARECIS",0,0,0,63,0,63,"2012"
"11212","110146 PIMENTEIRAS DO OESTE",0,0,3,48,0,51,"2012"
"11213","110147 PRIMAVERA DE RONDONIA",0,0,1,42,0,43,"2012"
"11214","110148 SAO FELIPE D'OESTE",0,0,2,62,0,64,"2012"
"11215","110149 SAO FRANCISCO DO GUAPORE",0,1,5,239,1,246,"2012"
"11216","110150 SERINGUEIRAS",3,2,2,183,0,190,"2012"
"11217","110155 TEIXEIROPOLIS",0,0,2,55,0,57,"2012"
"11218","110160 THEOBROMA",0,0,2,131,0,133,"2012"
"11219","110170 URUPA",0,1,1,144,0,146,"2012"
"11220","110175 VALE DO ANARI",0,0,1,84,1,86,"2012"
"11221","110180 VALE DO PARAISO",0,1,0,82,0,83,"2012"
"11222","MUNICIPIO IGNORADO - AC",0,0,0,1,0,1,"2012"
"11223","120001 ACRELANDIA",0,1,1,223,28,253,"2012"
"11224","120005 ASSIS BRASIL",0,1,3,168,47,219,"2012"
"11225","120010 BRASILEIA",0,2,9,460,34,505,"2012"
"11226","120013 BUJARI",0,0,1,167,30,198,"2012"
"11227","120017 CAPIXABA",0,0,1,174,26,201,"2012"
"11228","120020 CRUZEIRO DO SUL",3,3,25,1594,116,1741,"2012"
"11229","120025 EPITACIOLANDIA",0,2,4,256,20,282,"2012"
"11230","120030 FEIJO",1,1,2,734,166,904,"2012"
"11231","120032 JORDAO",1,0,0,79,189,269,"2012"
"11232","120033 MANCIO LIMA",0,1,8,352,25,386,"2012"
"11233","120034 MANOEL URBANO",0,0,6,241,9,256,"2012"
"11234","120035 MARECHAL THAUMATURGO",0,1,8,235,230,474,"2012"
"11235","120038 PLACIDO DE CASTRO",1,1,3,320,28,353,"2012"
"11236","120039 PORTO WALTER",2,3,3,259,71,338,"2012"
"11237","120040 RIO BRANCO",3,21,65,5597,845,6531,"2012"
"11238","120042 RODRIGUES ALVES",0,1,3,343,43,390,"2012"
"11239","120043 SANTA ROSA DO PURUS",0,0,0,78,181,259,"2012"
"11240","120045 SENADOR GUIOMARD",0,0,4,345,47,396,"2012"
"11241","120050 SENA MADUREIRA",0,3,5,843,78,929,"2012"
"11242","120060 TARAUACA",6,4,24,999,125,1158,"2012"
"11243","120070 XAPURI",0,1,12,275,23,311,"2012"
"11244","120080 PORTO ACRE",0,0,1,289,56,346,"2012"
"11245","MUNICIPIO IGNORADO - AM",0,0,0,8,0,8,"2012"
"11246","130002 ALVARAES",0,3,5,310,2,320,"2012"
"11247","130006 AMATURA",1,0,4,135,102,242,"2012"
"11248","130008 ANAMA",0,1,1,184,13,199,"2012"
"11249","130010 ANORI",0,0,1,28,218,247,"2012"
"11250","130014 APUI",2,3,3,185,2,195,"2012"
"11251","130020 ATALAIA DO NORTE",1,4,7,187,158,357,"2012"
"11252","130030 AUTAZES",5,4,6,709,153,877,"2012"
"11253","130040 BARCELOS",1,0,7,286,175,469,"2012"
"11254","130050 BARREIRINHA",0,4,2,539,162,707,"2012"
"11255","130060 BENJAMIN CONSTANT",2,7,11,1031,2,1053,"2012"
"11256","130063 BERURI",0,1,6,401,19,427,"2012"
"11257","130068 BOA VISTA DO RAMOS",0,1,5,247,7,260,"2012"
"11258","130070 BOCA DO ACRE",1,7,18,702,13,741,"2012"
"11259","130080 BORBA",4,5,12,551,118,690,"2012"
"11260","130083 CAAPIRANGA",0,0,0,99,39,138,"2012"
"11261","130090 CANUTAMA",1,1,2,207,2,213,"2012"
"11262","130100 CARAUARI",1,1,15,639,0,656,"2012"
"11263","130110 CAREIRO",0,4,8,366,36,414,"2012"
"11264","130115 CAREIRO DA VARZEA",1,0,0,144,26,171,"2012"
"11265","130120 COARI",12,2,11,1641,2,1668,"2012"
"11266","130130 CODAJAS",0,2,3,426,1,432,"2012"
"11267","130140 EIRUNEPE",2,4,29,666,132,833,"2012"
"11268","130150 ENVIRA",0,0,1,305,8,314,"2012"
"11269","130160 FONTE BOA",4,4,4,507,1,520,"2012"
"11270","130165 GUAJARA",0,0,5,325,30,360,"2012"
"11271","130170 HUMAITA",2,4,40,800,1,847,"2012"
"11272","130180 IPIXUNA",1,1,0,315,122,439,"2012"
"11273","130185 IRANDUBA",2,4,12,874,6,898,"2012"
"11274","130190 ITACOATIARA",1,5,12,1855,146,2019,"2012"
"11275","130195 ITAMARATI",7,2,5,151,32,197,"2012"
"11276","130200 ITAPIRANGA",0,1,2,191,5,199,"2012"
"11277","130210 JAPURA",1,0,10,131,0,142,"2012"
"11278","130220 JURUA",0,0,8,85,78,171,"2012"
"11279","130230 JUTAI",0,1,0,414,186,601,"2012"
"11280","130240 LABREA",6,2,32,639,3,682,"2012"
"11281","130250 MANACAPURU",10,10,14,1715,137,1886,"2012"
"11282","130255 MANAQUIRI",0,1,2,242,5,250,"2012"
"11283","130260 MANAUS",137,130,415,40194,293,41169,"2012"
"11284","130270 MANICORE",1,7,44,630,128,810,"2012"
"11285","130280 MARAA",1,1,3,308,0,313,"2012"
"11286","130290 MAUES",6,10,26,1025,244,1311,"2012"
"11287","130300 NHAMUNDA",3,2,17,310,12,344,"2012"
"11288","130310 NOVA OLINDA DO NORTE",1,1,13,471,105,591,"2012"
"11289","130320 NOVO AIRAO",0,0,2,254,1,257,"2012"
"11290","130330 NOVO ARIPUANA",1,0,2,290,28,321,"2012"
"11291","130340 PARINTINS",1,5,29,1842,144,2021,"2012"
"11292","130350 PAUINI",2,1,1,283,21,308,"2012"
"11293","130353 PRESIDENTE FIGUEIREDO",1,0,10,540,5,556,"2012"
"11294","130356 RIO PRETO DA EVA",2,0,3,346,10,361,"2012"
"11295","130360 SANTA ISABEL DO RIO NEGRO",0,5,28,160,151,344,"2012"
"11296","130370 SANTO ANTONIO DO ICA",1,2,2,459,139,603,"2012"
"11297","130380 SAO GABRIEL DA CACHOEIRA",1,7,13,550,548,1119,"2012"
"11298","130390 SAO PAULO DE OLIVENCA",0,6,7,384,562,959,"2012"
"11299","130395 SAO SEBASTIAO DO UATUMA",0,1,5,171,1,178,"2012"
"11300","130400 SILVES",1,1,1,161,17,181,"2012"
"11301","130406 TABATINGA",1,7,17,1140,467,1632,"2012"
"11302","130410 TAPAUA",12,1,0,362,26,401,"2012"
"11303","130420 TEFE",4,7,13,1474,60,1558,"2012"
"11304","130423 TONANTINS",0,1,2,321,24,348,"2012"
"11305","130426 UARINI",1,1,22,82,182,288,"2012"
"11306","130430 URUCARA",4,7,14,259,14,298,"2012"
"11307","130440 URUCURITUBA",0,1,2,252,66,321,"2012"
"11308","MUNICIPIO IGNORADO - RR",0,0,0,2,0,2,"2012"
"11309","140002 AMAJARI",4,0,2,146,156,308,"2012"
"11310","140005 ALTO ALEGRE",5,0,1,197,397,600,"2012"
"11311","140010 BOA VISTA",58,14,47,6208,31,6358,"2012"
"11312","140015 BONFIM",9,1,1,223,78,312,"2012"
"11313","140017 CANTA",8,0,2,282,23,315,"2012"
"11314","140020 CARACARAI",1,4,4,358,58,425,"2012"
"11315","140023 CAROEBE",0,0,4,127,7,138,"2012"
"11316","140028 IRACEMA",4,1,0,114,54,173,"2012"
"11317","140030 MUCAJAI",8,0,2,248,12,270,"2012"
"11318","140040 NORMANDIA",4,0,2,243,70,319,"2012"
"11319","140045 PACARAIMA",4,0,3,277,43,327,"2012"
"11320","140047 RORAINOPOLIS",3,4,7,390,18,422,"2012"
"11321","140050 SAO JOAO DA BALIZA",1,0,1,114,0,116,"2012"
"11322","140060 SAO LUIZ",1,0,1,80,2,84,"2012"
"11323","140070 UIRAMUTA",12,0,2,208,210,432,"2012"
"11324","MUNICIPIO IGNORADO - PA",0,0,1,3,0,4,"2012"
"11325","150010 ABAETETUBA",5,12,72,2418,23,2530,"2012"
"11326","150013 ABEL FIGUEIREDO",1,0,3,110,0,114,"2012"
"11327","150020 ACARA",3,9,8,939,7,966,"2012"
"11328","150030 AFUA",1,4,11,782,7,805,"2012"
"11329","150034 AGUA AZUL DO NORTE",1,0,4,158,1,164,"2012"
"11330","150040 ALENQUER",4,3,5,1086,40,1138,"2012"
"11331","150050 ALMEIRIM",4,10,17,658,4,693,"2012"
"11332","150060 ALTAMIRA",5,16,38,2017,29,2105,"2012"
"11333","150070 ANAJAS",4,5,33,584,125,751,"2012"
"11334","150080 ANANINDEUA",26,27,81,8041,20,8195,"2012"
"11335","150085 ANAPU",1,2,8,510,9,530,"2012"
"11336","150090 AUGUSTO CORREA",4,4,19,786,152,965,"2012"
"11337","150095 AURORA DO PARA",1,2,14,350,5,372,"2012"
"11338","150100 AVEIRO",0,1,12,155,38,206,"2012"
"11339","150110 BAGRE",5,6,25,218,211,465,"2012"
"11340","150120 BAIAO",2,3,7,474,52,538,"2012"
"11341","150125 BANNACH",0,0,0,41,1,42,"2012"
"11342","150130 BARCARENA",5,6,43,1988,11,2053,"2012"
"11343","150140 BELEM",51,50,171,21023,76,21371,"2012"
"11344","150145 BELTERRA",0,1,14,227,1,243,"2012"
"11345","150150 BENEVIDES",2,0,260,818,2,1082,"2012"
"11346","150157 BOM JESUS DO TOCANTINS",2,0,5,221,1,229,"2012"
"11347","150160 BONITO",4,0,0,213,0,217,"2012"
"11348","150170 BRAGANCA",10,8,28,1994,108,2148,"2012"
"11349","150172 BRASIL NOVO",0,0,11,268,0,279,"2012"
"11350","150175 BREJO GRANDE DO ARAGUAIA",0,0,0,93,4,97,"2012"
"11351","150178 BREU BRANCO",2,4,12,590,191,799,"2012"
"11352","150180 BREVES",12,36,194,2132,9,2383,"2012"
"11353","150190 BUJARU",1,4,27,417,59,508,"2012"
"11354","150195 CACHOEIRA DO PIRIA",1,1,8,276,70,356,"2012"
"11355","150200 CACHOEIRA DO ARARI",0,2,6,227,1,236,"2012"
"11356","150210 CAMETA",4,14,123,2039,298,2478,"2012"
"11357","150215 CANAA DOS CARAJAS",2,3,20,847,3,875,"2012"
"11358","150220 CAPANEMA",6,8,23,1035,15,1087,"2012"
"11359","150230 CAPITAO POCO",15,1,5,804,2,827,"2012"
"11360","150240 CASTANHAL",5,8,24,3128,4,3169,"2012"
"11361","150250 CHAVES",1,1,2,235,44,283,"2012"
"11362","150260 COLARES",0,1,1,124,25,151,"2012"
"11363","150270 CONCEICAO DO ARAGUAIA",1,6,11,733,5,756,"2012"
"11364","150275 CONCORDIA DO PARA",4,5,23,459,7,498,"2012"
"11365","150276 CUMARU DO NORTE",0,0,1,139,7,147,"2012"
"11366","150277 CURIONOPOLIS",0,3,12,427,1,443,"2012"
"11367","150280 CURRALINHO",5,4,7,512,103,631,"2012"
"11368","150285 CURUA",0,0,0,108,100,208,"2012"
"11369","150290 CURUCA",4,1,7,466,20,498,"2012"
"11370","150293 DOM ELISEU",1,9,36,651,3,700,"2012"
"11371","150295 ELDORADO DOS CARAJAS",2,4,13,492,2,513,"2012"
"11372","150300 FARO",0,2,7,133,5,147,"2012"
"11373","150304 FLORESTA DO ARAGUAIA",0,1,2,295,0,298,"2012"
"11374","150307 GARRAFAO DO NORTE",3,0,4,350,74,431,"2012"
"11375","150309 GOIANESIA DO PARA",2,0,12,696,11,721,"2012"
"11376","150310 GURUPA",3,6,11,504,123,647,"2012"
"11377","150320 IGARAPE-ACU",2,1,7,570,6,586,"2012"
"11378","150330 IGARAPE-MIRI",1,6,46,1018,85,1156,"2012"
"11379","150340 INHANGAPI",0,1,0,165,1,167,"2012"
"11380","150345 IPIXUNA DO PARA",0,3,35,485,46,569,"2012"
"11381","150350 IRITUIA",2,2,4,430,42,480,"2012"
"11382","150360 ITAITUBA",4,27,139,1911,14,2095,"2012"
"11383","150370 ITUPIRANGA",1,7,4,836,50,898,"2012"
"11384","150375 JACAREACANGA",2,2,8,253,256,521,"2012"
"11385","150380 JACUNDA",6,6,21,858,13,904,"2012"
"11386","150390 JURUTI",5,19,28,829,85,966,"2012"
"11387","150400 LIMOEIRO DO AJURU",0,5,22,462,5,494,"2012"
"11388","150405 MAE DO RIO",0,2,14,606,3,625,"2012"
"11389","150410 MAGALHAES BARATA",0,0,0,124,3,127,"2012"
"11390","150420 MARABA",4,17,79,4667,45,4812,"2012"
"11391","150430 MARACANA",1,1,4,355,31,392,"2012"
"11392","150440 MARAPANIM",1,1,3,308,20,333,"2012"
"11393","150442 MARITUBA",5,6,15,1636,3,1665,"2012"
"11394","150445 MEDICILANDIA",2,4,21,432,0,459,"2012"
"11395","150450 MELGACO",2,4,16,332,232,586,"2012"
"11396","150460 MOCAJUBA",1,0,12,448,8,469,"2012"
"11397","150470 MOJU",2,8,37,1095,32,1174,"2012"
"11398","150480 MONTE ALEGRE",1,12,68,963,0,1044,"2012"
"11399","150490 MUANA",2,8,12,503,0,525,"2012"
"11400","150495 NOVA ESPERANCA DO PIRIA",6,0,6,357,39,408,"2012"
"11401","150497 NOVA IPIXUNA",1,1,4,181,7,194,"2012"
"11402","150500 NOVA TIMBOTEUA",0,0,7,133,2,142,"2012"
"11403","150503 NOVO PROGRESSO",3,1,5,472,0,481,"2012"
"11404","150506 NOVO REPARTIMENTO",3,0,2,1233,21,1259,"2012"
"11405","150510 OBIDOS",4,3,15,808,171,1001,"2012"
"11406","150520 OEIRAS DO PARA",2,12,22,622,58,716,"2012"
"11407","150530 ORIXIMINA",9,16,45,1148,65,1283,"2012"
"11408","150540 OUREM",6,2,8,229,6,251,"2012"
"11409","150543 OURILANDIA DO NORTE",0,4,8,584,0,596,"2012"
"11410","150548 PACAJA",3,2,11,654,11,681,"2012"
"11411","150549 PALESTINA DO PARA",0,0,1,112,3,116,"2012"
"11412","150550 PARAGOMINAS",12,6,38,2023,14,2093,"2012"
"11413","150553 PARAUAPEBAS",13,16,104,4369,11,4513,"2012"
"11414","150555 PAU D'ARCO",0,3,3,118,3,127,"2012"
"11415","150560 PEIXE-BOI",0,0,2,107,0,109,"2012"
"11416","150563 PICARRA",0,1,1,171,1,174,"2012"
"11417","150565 PLACAS",2,1,10,233,0,246,"2012"
"11418","150570 PONTA DE PEDRAS",2,1,2,288,2,295,"2012"
"11419","150580 PORTEL",4,5,16,1067,78,1170,"2012"
"11420","150590 PORTO DE MOZ",2,4,9,649,6,670,"2012"
"11421","150600 PRAINHA",1,5,18,566,144,734,"2012"
"11422","150610 PRIMAVERA",0,0,3,134,39,176,"2012"
"11423","150611 QUATIPURU",3,1,1,174,6,185,"2012"
"11424","150613 REDENCAO",3,11,27,1565,3,1609,"2012"
"11425","150616 RIO MARIA",1,0,9,316,1,327,"2012"
"11426","150618 RONDON DO PARA",1,3,34,714,0,752,"2012"
"11427","150619 RUROPOLIS",0,0,12,377,1,390,"2012"
"11428","150620 SALINOPOLIS",0,2,2,660,1,665,"2012"
"11429","150630 SALVATERRA",2,2,4,358,0,366,"2012"
"11430","150635 SANTA BARBARA DO PARA",1,3,24,278,0,306,"2012"
"11431","150640 SANTA CRUZ DO ARARI",0,0,0,44,22,66,"2012"
"11432","150650 SANTA IZABEL DO PARA",2,1,12,943,3,961,"2012"
"11433","150655 SANTA LUZIA DO PARA",1,0,11,346,17,375,"2012"
"11434","150658 SANTA MARIA DAS BARREIRAS",0,1,0,181,0,182,"2012"
"11435","150660 SANTA MARIA DO PARA",1,0,8,367,0,376,"2012"
"11436","150670 SANTANA DO ARAGUAIA",1,1,3,582,0,587,"2012"
"11437","150680 SANTAREM",29,41,180,5772,467,6489,"2012"
"11438","150690 SANTAREM NOVO",0,0,1,100,1,102,"2012"
"11439","150700 SANTO ANTONIO DO TAUA",1,1,5,470,17,494,"2012"
"11440","150710 SAO CAETANO DE ODIVELAS",2,0,4,232,13,251,"2012"
"11441","150715 SAO DOMINGOS DO ARAGUAIA",0,2,8,359,2,371,"2012"
"11442","150720 SAO DOMINGOS DO CAPIM",2,1,9,601,30,643,"2012"
"11443","150730 SAO FELIX DO XINGU",0,2,13,954,24,993,"2012"
"11444","150740 SAO FRANCISCO DO PARA",1,1,0,205,2,209,"2012"
"11445","150745 SAO GERALDO DO ARAGUAIA",1,3,10,499,2,515,"2012"
"11446","150746 SAO JOAO DA PONTA",0,1,1,70,9,81,"2012"
"11447","150747 SAO JOAO DE PIRABAS",0,0,2,340,3,345,"2012"
"11448","150750 SAO JOAO DO ARAGUAIA",0,0,2,192,4,198,"2012"
"11449","150760 SAO MIGUEL DO GUAMA",3,7,9,945,16,980,"2012"
"11450","150770 SAO SEBASTIAO DA BOA VISTA",0,1,24,440,0,465,"2012"
"11451","150775 SAPUCAIA",0,0,0,70,0,70,"2012"
"11452","150780 SENADOR JOSE PORFIRIO",4,2,6,307,4,323,"2012"
"11453","150790 SOURE",3,0,0,457,0,460,"2012"
"11454","150795 TAILANDIA",1,9,30,1376,24,1440,"2012"
"11455","150796 TERRA ALTA",1,1,2,192,0,196,"2012"
"11456","150797 TERRA SANTA",3,5,14,232,1,255,"2012"
"11457","150800 TOME-ACU",3,11,44,1313,4,1375,"2012"
"11458","150803 TRACUATEUA",2,9,6,565,20,602,"2012"
"11459","150805 TRAIRAO",1,1,16,191,0,209,"2012"
"11460","150808 TUCUMA",2,1,19,723,0,745,"2012"
"11461","150810 TUCURUI",2,4,16,1183,842,2047,"2012"
"11462","150812 ULIANOPOLIS",3,5,16,443,2,469,"2012"
"11463","150815 URUARA",2,5,19,826,7,859,"2012"
"11464","150820 VIGIA",1,1,14,699,1,716,"2012"
"11465","150830 VISEU",4,2,8,797,404,1215,"2012"
"11466","150835 VITORIA DO XINGU",2,3,6,218,0,229,"2012"
"11467","150840 XINGUARA",2,4,15,745,4,770,"2012"
"11468","MUNICIPIO IGNORADO - AP",0,0,0,1,0,1,"2012"
"11469","160005 SERRA DO NAVIO",0,0,3,73,1,77,"2012"
"11470","160010 AMAPA",0,0,5,132,11,148,"2012"
"11471","160015 PEDRA BRANCA DO AMAPARI",2,0,3,253,21,279,"2012"
"11472","160020 CALCOENE",2,1,1,158,18,180,"2012"
"11473","160021 CUTIAS",1,0,0,52,15,68,"2012"
"11474","160023 FERREIRA GOMES",0,1,0,163,4,168,"2012"
"11475","160025 ITAUBAL",0,0,0,83,19,102,"2012"
"11476","160027 LARANJAL DO JARI",5,9,18,861,0,893,"2012"
"11477","160030 MACAPA",48,44,125,8678,98,8993,"2012"
"11478","160040 MAZAGAO",1,3,10,326,64,404,"2012"
"11479","160050 OIAPOQUE",3,6,11,447,17,484,"2012"
"11480","160053 PORTO GRANDE",2,0,3,299,1,305,"2012"
"11481","160055 PRACUUBA",0,0,1,32,43,76,"2012"
"11482","160060 SANTANA",12,11,39,2123,1,2186,"2012"
"11483","160070 TARTARUGALZINHO",1,1,5,268,13,288,"2012"
"11484","160080 VITORIA DO JARI",2,2,6,233,0,243,"2012"
"11485","MUNICIPIO IGNORADO - TO",0,0,0,4,0,4,"2012"
"11486","170025 ABREULANDIA",0,0,1,26,0,27,"2012"
"11487","170030 AGUIARNOPOLIS",1,0,0,82,1,84,"2012"
"11488","170035 ALIANCA DO TOCANTINS",0,0,1,86,0,87,"2012"
"11489","170040 ALMAS",0,0,1,131,3,135,"2012"
"11490","170070 ALVORADA",0,0,1,111,2,114,"2012"
"11491","170100 ANANAS",0,1,5,150,1,157,"2012"
"11492","170105 ANGICO",0,0,1,44,2,47,"2012"
"11493","170110 APARECIDA DO RIO NEGRO",0,0,1,80,0,81,"2012"
"11494","170130 ARAGOMINAS",0,0,0,87,2,89,"2012"
"11495","170190 ARAGUACEMA",0,0,1,101,1,103,"2012"
"11496","170200 ARAGUACU",0,0,4,94,2,100,"2012"
"11497","170210 ARAGUAINA",6,7,34,3027,48,3122,"2012"
"11498","170215 ARAGUANA",0,0,0,91,1,92,"2012"
"11499","170220 ARAGUATINS",0,3,5,360,190,558,"2012"
"11500","170230 ARAPOEMA",0,0,2,72,1,75,"2012"
"11501","170240 ARRAIAS",0,0,3,176,0,179,"2012"
"11502","170255 AUGUSTINOPOLIS",0,1,8,204,144,357,"2012"
"11503","170270 AURORA DO TOCANTINS",0,0,1,41,1,43,"2012"
"11504","170290 AXIXA DO TOCANTINS",0,2,5,109,97,213,"2012"
"11505","170300 BABACULANDIA",0,0,3,141,1,145,"2012"
"11506","170305 BANDEIRANTES DO TOCANTINS",0,0,0,45,1,46,"2012"
"11507","170307 BARRA DO OURO",0,0,0,57,2,59,"2012"
"11508","170310 BARROLANDIA",0,0,0,82,2,84,"2012"
"11509","170320 BERNARDO SAYAO",1,0,1,58,0,60,"2012"
"11510","170330 BOM JESUS DO TOCANTINS",0,1,3,79,0,83,"2012"
"11511","170360 BRASILANDIA DO TOCANTINS",0,0,1,37,0,38,"2012"
"11512","170370 BREJINHO DE NAZARE",0,1,0,85,1,87,"2012"
"11513","170380 BURITI DO TOCANTINS",0,1,4,90,71,166,"2012"
"11514","170382 CACHOEIRINHA",0,0,0,16,11,27,"2012"
"11515","170384 CAMPOS LINDOS",1,0,0,147,15,163,"2012"
"11516","170386 CARIRI DO TOCANTINS",0,0,0,52,0,52,"2012"
"11517","170388 CARMOLANDIA",0,0,0,32,0,32,"2012"
"11518","170389 CARRASCO BONITO",0,0,1,39,36,76,"2012"
"11519","170390 CASEARA",0,0,0,82,0,82,"2012"
"11520","170410 CENTENARIO",0,0,0,23,0,23,"2012"
"11521","170460 CHAPADA DE AREIA",0,0,0,21,0,21,"2012"
"11522","170510 CHAPADA DA NATIVIDADE",0,0,1,42,0,43,"2012"
"11523","170550 COLINAS DO TOCANTINS",2,2,7,519,12,542,"2012"
"11524","170555 COMBINADO",1,1,1,59,3,65,"2012"
"11525","170560 CONCEICAO DO TOCANTINS",0,0,2,45,15,62,"2012"
"11526","170600 COUTO MAGALHAES",0,1,0,79,1,81,"2012"
"11527","170610 CRISTALANDIA",0,0,4,90,1,95,"2012"
"11528","170625 CRIXAS DO TOCANTINS",0,0,0,25,0,25,"2012"
"11529","170650 DARCINOPOLIS",0,0,0,93,0,93,"2012"
"11530","170700 DIANOPOLIS",3,2,4,287,4,300,"2012"
"11531","170710 DIVINOPOLIS DO TOCANTINS",1,0,0,109,0,110,"2012"
"11532","170720 DOIS IRMAOS DO TOCANTINS",0,0,1,58,0,59,"2012"
"11533","170730 DUERE",0,0,0,73,0,73,"2012"
"11534","170740 ESPERANTINA",0,0,5,83,88,176,"2012"
"11535","170755 FATIMA",0,0,0,54,0,54,"2012"
"11536","170765 FIGUEIROPOLIS",2,0,2,51,0,55,"2012"
"11537","170770 FILADELFIA",0,0,1,130,4,135,"2012"
"11538","170820 FORMOSO DO ARAGUAIA",2,3,2,277,3,287,"2012"
"11539","170825 FORTALEZA DO TABOCAO",0,0,1,45,0,46,"2012"
"11540","170830 GOIANORTE",0,0,1,49,0,50,"2012"
"11541","170900 GOIATINS",0,3,7,231,24,265,"2012"
"11542","170930 GUARAI",0,0,5,361,4,370,"2012"
"11543","170950 GURUPI",7,4,11,1297,2,1321,"2012"
"11544","170980 IPUEIRAS",0,0,1,20,0,21,"2012"
"11545","171050 ITACAJA",0,1,3,117,7,128,"2012"
"11546","171070 ITAGUATINS",0,0,1,49,36,86,"2012"
"11547","171090 ITAPIRATINS",0,1,0,42,1,44,"2012"
"11548","171110 ITAPORA DO TOCANTINS",0,0,0,33,0,33,"2012"
"11549","171150 JAU DO TOCANTINS",0,0,0,31,0,31,"2012"
"11550","171180 JUARINA",0,1,0,34,0,35,"2012"
"11551","171190 LAGOA DA CONFUSAO",0,1,4,177,12,194,"2012"
"11552","171195 LAGOA DO TOCANTINS",0,0,2,59,3,64,"2012"
"11553","171200 LAJEADO",1,1,1,53,2,58,"2012"
"11554","171215 LAVANDEIRA",0,0,0,24,1,25,"2012"
"11555","171240 LIZARDA",0,0,4,35,0,39,"2012"
"11556","171245 LUZINOPOLIS",0,0,2,32,4,38,"2012"
"11557","171250 MARIANOPOLIS DO TOCANTINS",0,0,0,57,0,57,"2012"
"11558","171270 MATEIROS",0,1,0,39,0,40,"2012"
"11559","171280 MAURILANDIA DO TOCANTINS",0,0,0,42,8,50,"2012"
"11560","171320 MIRACEMA DO TOCANTINS",3,1,4,304,0,312,"2012"
"11561","171330 MIRANORTE",1,0,1,203,1,206,"2012"
"11562","171360 MONTE DO CARMO",0,0,5,117,3,125,"2012"
"11563","171370 MONTE SANTO DO TOCANTINS",0,0,0,23,1,24,"2012"
"11564","171380 PALMEIRAS DO TOCANTINS",0,0,1,90,1,92,"2012"
"11565","171395 MURICILANDIA",0,0,0,56,5,61,"2012"
"11566","171420 NATIVIDADE",0,1,3,126,2,132,"2012"
"11567","171430 NAZARE",0,0,0,57,7,64,"2012"
"11568","171488 NOVA OLINDA",0,0,3,179,3,185,"2012"
"11569","171500 NOVA ROSALANDIA",0,0,0,51,0,51,"2012"
"11570","171510 NOVO ACORDO",0,0,1,71,4,76,"2012"
"11571","171515 NOVO ALEGRE",0,0,0,20,0,20,"2012"
"11572","171525 NOVO JARDIM",0,0,0,30,1,31,"2012"
"11573","171550 OLIVEIRA DE FATIMA",0,0,1,14,0,15,"2012"
"11574","171570 PALMEIRANTE",0,0,2,64,2,68,"2012"
"11575","171575 PALMEIROPOLIS",0,0,0,89,0,89,"2012"
"11576","171610 PARAISO DO TOCANTINS",0,3,14,827,0,844,"2012"
"11577","171620 PARANA",0,0,4,155,2,161,"2012"
"11578","171630 PAU D'ARCO",0,0,1,72,1,74,"2012"
"11579","171650 PEDRO AFONSO",0,3,14,236,1,254,"2012"
"11580","171660 PEIXE",0,1,2,112,0,115,"2012"
"11581","171665 PEQUIZEIRO",1,0,0,67,1,69,"2012"
"11582","171670 COLMEIA",1,0,3,118,1,123,"2012"
"11583","171700 PINDORAMA DO TOCANTINS",0,0,2,67,2,71,"2012"
"11584","171720 PIRAQUE",0,0,0,40,0,40,"2012"
"11585","171750 PIUM",0,0,2,100,1,103,"2012"
"11586","171780 PONTE ALTA DO BOM JESUS",1,0,3,58,4,66,"2012"
"11587","171790 PONTE ALTA DO TOCANTINS",1,0,0,125,0,126,"2012"
"11588","171800 PORTO ALEGRE DO TOCANTINS",0,0,0,44,0,44,"2012"
"11589","171820 PORTO NACIONAL",3,2,21,903,3,932,"2012"
"11590","171830 PRAIA NORTE",0,0,1,79,62,142,"2012"
"11591","171840 PRESIDENTE KENNEDY",0,0,0,47,0,47,"2012"
"11592","171845 PUGMIL",0,0,0,40,0,40,"2012"
"11593","171850 RECURSOLANDIA",0,0,1,74,4,79,"2012"
"11594","171855 RIACHINHO",0,0,1,66,2,69,"2012"
"11595","171865 RIO DA CONCEICAO",1,0,1,34,1,37,"2012"
"11596","171870 RIO DOS BOIS",0,0,0,31,1,32,"2012"
"11597","171875 RIO SONO",0,0,0,65,4,69,"2012"
"11598","171880 SAMPAIO",0,1,0,37,44,82,"2012"
"11599","171884 SANDOLANDIA",0,0,6,38,0,44,"2012"
"11600","171886 SANTA FE DO ARAGUAIA",0,0,2,101,0,103,"2012"
"11601","171888 SANTA MARIA DO TOCANTINS",0,0,3,52,1,56,"2012"
"11602","171889 SANTA RITA DO TOCANTINS",0,0,1,31,0,32,"2012"
"11603","171890 SANTA ROSA DO TOCANTINS",0,0,0,74,2,76,"2012"
"11604","171900 SANTA TEREZA DO TOCANTINS",0,0,0,46,1,47,"2012"
"11605","172000 SANTA TEREZINHA DO TOCANTINS",0,0,1,40,0,41,"2012"
"11606","172010 SAO BENTO DO TOCANTINS",0,0,1,45,36,82,"2012"
"11607","172015 SAO FELIX DO TOCANTINS",0,0,0,22,4,26,"2012"
"11608","172020 SAO MIGUEL DO TOCANTINS",0,2,6,111,15,134,"2012"
"11609","172025 SAO SALVADOR DO TOCANTINS",0,0,1,28,0,29,"2012"
"11610","172030 SAO SEBASTIAO DO TOCANTINS",0,0,0,38,33,71,"2012"
"11611","172049 SAO VALERIO",0,1,1,50,0,52,"2012"
"11612","172065 SILVANOPOLIS",0,1,3,86,0,90,"2012"
"11613","172080 SITIO NOVO DO TOCANTINS",0,0,3,97,33,133,"2012"
"11614","172085 SUCUPIRA",0,0,0,23,0,23,"2012"
"11615","172090 TAGUATINGA",1,0,5,202,3,211,"2012"
"11616","172093 TAIPAS DO TOCANTINS",0,0,0,29,0,29,"2012"
"11617","172097 TALISMA",0,1,0,36,0,37,"2012"
"11618","172100 PALMAS",11,7,53,4611,31,4713,"2012"
"11619","172110 TOCANTINIA",3,0,2,175,3,183,"2012"
"11620","172120 TOCANTINOPOLIS",0,1,3,412,4,420,"2012"
"11621","172125 TUPIRAMA",0,0,0,19,0,19,"2012"
"11622","172130 TUPIRATINS",0,0,0,34,0,34,"2012"
"11623","172208 WANDERLANDIA",0,2,2,129,1,134,"2012"
"11624","172210 XAMBIOA",0,0,6,238,1,245,"2012"
"11625","MUNICIPIO IGNORADO - MA",0,0,0,3,0,3,"2012"
"11626","210005 ACAILANDIA",7,10,32,1876,9,1934,"2012"
"11627","210010 AFONSO CUNHA",0,2,1,105,5,113,"2012"
"11628","210015 AGUA DOCE DO MARANHAO",5,2,1,117,25,150,"2012"
"11629","210020 ALCANTARA",14,3,12,228,26,283,"2012"
"11630","210030 ALDEIAS ALTAS",0,2,2,463,1,468,"2012"
"11631","210040 ALTAMIRA DO MARANHAO",0,2,7,90,8,107,"2012"
"11632","210043 ALTO ALEGRE DO MARANHAO",1,1,14,378,34,428,"2012"
"11633","210047 ALTO ALEGRE DO PINDARE",2,3,7,383,116,511,"2012"
"11634","210050 ALTO PARNAIBA",0,3,4,185,9,201,"2012"
"11635","210055 AMAPA DO MARANHAO",0,0,0,90,13,103,"2012"
"11636","210060 AMARANTE DO MARANHAO",7,1,18,745,65,836,"2012"
"11637","210070 ANAJATUBA",0,1,26,247,53,327,"2012"
"11638","210080 ANAPURUS",0,2,6,332,2,342,"2012"
"11639","210083 APICUM-ACU",3,112,6,59,109,289,"2012"
"11640","210087 ARAGUANA",0,2,5,107,44,158,"2012"
"11641","210090 ARAIOSES",35,25,16,432,45,553,"2012"
"11642","210095 ARAME",4,2,14,641,18,679,"2012"
"11643","210100 ARARI",2,4,17,427,21,471,"2012"
"11644","210110 AXIXA",0,0,7,158,24,189,"2012"
"11645","210120 BACABAL",3,7,46,1597,41,1694,"2012"
"11646","210125 BACABEIRA",0,2,11,222,6,241,"2012"
"11647","210130 BACURI",0,0,1,35,242,278,"2012"
"11648","210135 BACURITUBA",0,0,0,42,1,43,"2012"
"11649","210140 BALSAS",0,0,6,57,1785,1848,"2012"
"11650","210150 BARAO DE GRAJAU",0,2,9,263,2,276,"2012"
"11651","210160 BARRA DO CORDA",4,11,15,1388,44,1462,"2012"
"11652","210170 BARREIRINHAS",4,6,12,991,126,1139,"2012"
"11653","210173 BELAGUA",2,1,4,34,166,207,"2012"
"11654","210177 BELA VISTA DO MARANHAO",1,3,4,175,1,184,"2012"
"11655","210180 BENEDITO LEITE",0,0,0,8,49,57,"2012"
"11656","210190 BEQUIMAO",0,2,8,138,117,265,"2012"
"11657","210193 BERNARDO DO MEARIM",0,0,0,75,1,76,"2012"
"11658","210197 BOA VISTA DO GURUPI",0,1,0,124,1,126,"2012"
"11659","210200 BOM JARDIM",1,2,24,166,439,632,"2012"
"11660","210203 BOM JESUS DAS SELVAS",2,4,11,540,11,568,"2012"
"11661","210207 BOM LUGAR",0,2,7,160,2,171,"2012"
"11662","210210 BREJO",1,3,5,462,6,477,"2012"
"11663","210215 BREJO DE AREIA",0,2,5,97,7,111,"2012"
"11664","210220 BURITI",1,4,47,551,15,618,"2012"
"11665","210230 BURITI BRAVO",1,7,9,380,34,431,"2012"
"11666","210232 BURITICUPU",3,4,59,1211,33,1310,"2012"
"11667","210235 BURITIRANA",0,2,8,157,15,182,"2012"
"11668","210237 CACHOEIRA GRANDE",0,3,3,130,28,164,"2012"
"11669","210240 CAJAPIO",0,1,0,37,93,131,"2012"
"11670","210250 CAJARI",1,1,8,155,162,327,"2012"
"11671","210255 CAMPESTRE DO MARANHAO",1,1,8,197,0,207,"2012"
"11672","210260 CANDIDO MENDES",0,1,0,245,55,301,"2012"
"11673","210270 CANTANHEDE",0,1,2,260,31,294,"2012"
"11674","210275 CAPINZAL DO NORTE",1,1,3,185,10,200,"2012"
"11675","210280 CAROLINA",0,0,20,390,5,415,"2012"
"11676","210290 CARUTAPERA",1,0,0,405,1,407,"2012"
"11677","210300 CAXIAS",6,11,22,2660,21,2720,"2012"
"11678","210310 CEDRAL",1,1,2,90,43,137,"2012"
"11679","210312 CENTRAL DO MARANHAO",1,0,0,38,135,174,"2012"
"11680","210315 CENTRO DO GUILHERME",2,0,3,216,16,237,"2012"
"11681","210317 CENTRO NOVO DO MARANHAO",0,1,1,233,46,281,"2012"
"11682","210320 CHAPADINHA",4,6,42,1519,45,1616,"2012"
"11683","210325 CIDELANDIA",1,0,3,142,13,159,"2012"
"11684","210330 CODO",7,26,106,2137,98,2374,"2012"
"11685","210340 COELHO NETO",0,9,25,925,8,967,"2012"
"11686","210350 COLINAS",1,5,22,702,7,737,"2012"
"11687","210355 CONCEICAO DO LAGO-ACU",3,3,11,238,49,304,"2012"
"11688","210360 COROATA",1,7,23,1072,62,1165,"2012"
"11689","210370 CURURUPU",1,0,1,151,323,476,"2012"
"11690","210375 DAVINOPOLIS",0,1,8,193,2,204,"2012"
"11691","210380 DOM PEDRO",7,0,12,237,73,329,"2012"
"11692","210390 DUQUE BACELAR",0,1,3,110,88,202,"2012"
"11693","210400 ESPERANTINOPOLIS",1,0,3,324,0,328,"2012"
"11694","210405 ESTREITO",0,1,19,579,1,600,"2012"
"11695","210407 FEIRA NOVA DO MARANHAO",0,0,1,10,91,102,"2012"
"11696","210408 FERNANDO FALCAO",0,1,2,102,53,158,"2012"
"11697","210409 FORMOSA DA SERRA NEGRA",1,0,0,78,177,256,"2012"
"11698","210410 FORTALEZA DOS NOGUEIRAS",0,0,0,166,29,195,"2012"
"11699","210420 FORTUNA",0,1,5,303,18,327,"2012"
"11700","210430 GODOFREDO VIANA",0,0,0,106,49,155,"2012"
"11701","210440 GONCALVES DIAS",0,1,0,38,247,286,"2012"
"11702","210450 GOVERNADOR ARCHER",0,1,3,147,7,158,"2012"
"11703","210455 GOVERNADOR EDISON LOBAO",1,4,9,255,7,276,"2012"
"11704","210460 GOVERNADOR EUGENIO BARROS",1,0,6,163,125,295,"2012"
"11705","210462 GOVERNADOR LUIZ ROCHA",0,2,0,95,2,99,"2012"
"11706","210465 GOVERNADOR NEWTON BELLO",0,0,5,131,43,179,"2012"
"11707","210467 GOVERNADOR NUNES FREIRE",0,0,7,524,22,553,"2012"
"11708","210470 GRACA ARANHA",0,1,1,81,7,90,"2012"
"11709","210480 GRAJAU",13,5,28,1508,92,1646,"2012"
"11710","210490 GUIMARAES",0,0,1,18,129,148,"2012"
"11711","210500 HUMBERTO DE CAMPOS",2,1,3,436,115,557,"2012"
"11712","210510 ICATU",0,2,4,373,51,430,"2012"
"11713","210515 IGARAPE DO MEIO",0,1,8,279,13,301,"2012"
"11714","210520 IGARAPE GRANDE",0,0,2,174,3,179,"2012"
"11715","210530 IMPERATRIZ",16,17,140,4572,29,4774,"2012"
"11716","210535 ITAIPAVA DO GRAJAU",3,0,9,196,15,223,"2012"
"11717","210540 ITAPECURU MIRIM",0,0,5,84,1184,1273,"2012"
"11718","210542 ITINGA DO MARANHAO",2,3,23,350,0,378,"2012"
"11719","210545 JATOBA",0,3,1,118,1,123,"2012"
"11720","210547 JENIPAPO DOS VIEIRAS",0,0,3,242,52,297,"2012"
"11721","210550 JOAO LISBOA",0,1,20,390,1,412,"2012"
"11722","210560 JOSELANDIA",0,0,3,232,5,240,"2012"
"11723","210565 JUNCO DO MARANHAO",0,1,0,108,4,113,"2012"
"11724","210570 LAGO DA PEDRA",1,6,27,797,0,831,"2012"
"11725","210580 LAGO DO JUNCO",0,0,5,128,2,135,"2012"
"11726","210590 LAGO VERDE",1,2,13,283,17,316,"2012"
"11727","210592 LAGOA DO MATO",1,0,0,126,6,133,"2012"
"11728","210594 LAGO DOS RODRIGUES",0,1,2,144,1,148,"2012"
"11729","210596 LAGOA GRANDE DO MARANHAO",0,1,6,153,27,187,"2012"
"11730","210598 LAJEADO NOVO",0,1,2,112,1,116,"2012"
"11731","210600 LIMA CAMPOS",4,0,5,172,32,213,"2012"
"11732","210610 LORETO",0,0,0,5,184,189,"2012"
"11733","210620 LUIS DOMINGUES",0,0,0,75,34,109,"2012"
"11734","210630 MAGALHAES DE ALMEIDA",0,0,0,234,0,234,"2012"
"11735","210632 MARACACUME",0,2,9,352,8,371,"2012"
"11736","210635 MARAJA DO SENA",2,1,3,85,19,110,"2012"
"11737","210637 MARANHAOZINHO",0,0,1,181,16,198,"2012"
"11738","210640 MATA ROMA",1,2,11,310,5,329,"2012"
"11739","210650 MATINHA",0,1,4,84,311,400,"2012"
"11740","210660 MATOES",2,1,4,419,108,534,"2012"
"11741","210663 MATOES DO NORTE",0,0,3,86,31,120,"2012"
"11742","210667 MILAGRES DO MARANHAO",0,0,1,96,4,101,"2012"
"11743","210670 MIRADOR",0,1,4,356,3,364,"2012"
"11744","210675 MIRANDA DO NORTE",0,0,7,264,42,313,"2012"
"11745","210680 MIRINZAL",1,0,3,47,155,206,"2012"
"11746","210690 MONCAO",4,2,18,382,119,525,"2012"
"11747","210700 MONTES ALTOS",0,1,6,119,6,132,"2012"
"11748","210710 MORROS",1,0,7,300,46,354,"2012"
"11749","210720 NINA RODRIGUES",0,2,5,125,55,187,"2012"
"11750","210725 NOVA COLINAS",1,2,1,49,12,65,"2012"
"11751","210730 NOVA IORQUE",0,1,1,21,35,58,"2012"
"11752","210735 NOVA OLINDA DO MARANHAO",0,1,21,339,14,375,"2012"
"11753","210740 OLHO D'AGUA DAS CUNHAS",0,7,8,203,14,232,"2012"
"11754","210745 OLINDA NOVA DO MARANHAO",0,1,0,20,161,182,"2012"
"11755","210750 PACO DO LUMIAR",5,6,31,1453,54,1549,"2012"
"11756","210760 PALMEIRANDIA",2,0,6,130,124,262,"2012"
"11757","210770 PARAIBANO",0,2,6,276,0,284,"2012"
"11758","210780 PARNARAMA",0,1,4,347,232,584,"2012"
"11759","210790 PASSAGEM FRANCA",1,1,2,335,1,340,"2012"
"11760","210800 PASTOS BONS",0,0,3,41,281,325,"2012"
"11761","210805 PAULINO NEVES",1,3,8,173,155,340,"2012"
"11762","210810 PAULO RAMOS",1,1,18,353,7,380,"2012"
"11763","210820 PEDREIRAS",1,2,6,667,4,680,"2012"
"11764","210825 PEDRO DO ROSARIO",12,30,71,158,101,372,"2012"
"11765","210830 PENALVA",3,3,17,493,121,637,"2012"
"11766","210840 PERI MIRIM",0,1,10,106,27,144,"2012"
"11767","210845 PERITORO",0,2,7,341,23,373,"2012"
"11768","210850 PINDARE-MIRIM",2,5,15,535,21,578,"2012"
"11769","210860 PINHEIRO",3,5,45,1241,136,1430,"2012"
"11770","210870 PIO XII",1,2,6,455,3,467,"2012"
"11771","210880 PIRAPEMAS",0,1,1,69,238,309,"2012"
"11772","210890 POCAO DE PEDRAS",0,0,1,258,0,259,"2012"
"11773","210900 PORTO FRANCO",0,2,10,429,0,441,"2012"
"11774","210905 PORTO RICO DO MARANHAO",0,0,0,17,48,65,"2012"
"11775","210910 PRESIDENTE DUTRA",0,2,5,696,14,717,"2012"
"11776","210920 PRESIDENTE JUSCELINO",1,0,4,147,45,197,"2012"
"11777","210923 PRESIDENTE MEDICI",2,2,1,110,4,119,"2012"
"11778","210927 PRESIDENTE SARNEY",0,2,4,250,65,321,"2012"
"11779","210930 PRESIDENTE VARGAS",1,1,10,43,138,193,"2012"
"11780","210940 PRIMEIRA CRUZ",0,1,4,134,63,202,"2012"
"11781","210945 RAPOSA",2,8,11,456,13,490,"2012"
"11782","210950 RIACHAO",0,3,13,291,29,336,"2012"
"11783","210955 RIBAMAR FIQUENE",1,1,4,136,1,143,"2012"
"11784","210960 ROSARIO",0,5,18,601,29,653,"2012"
"11785","210970 SAMBAIBA",0,3,2,11,13,29,"2012"
"11786","210975 SANTA FILOMENA DO MARANHAO",0,0,7,88,0,95,"2012"
"11787","210980 SANTA HELENA",0,0,6,141,459,606,"2012"
"11788","210990 SANTA INES",10,13,63,1507,13,1606,"2012"
"11789","211000 SANTA LUZIA",3,2,15,1041,265,1326,"2012"
"11790","211003 SANTA LUZIA DO PARUA",0,2,4,421,2,429,"2012"
"11791","211010 SANTA QUITERIA DO MARANHAO",0,1,11,434,23,469,"2012"
"11792","211020 SANTA RITA",1,10,77,489,25,602,"2012"
"11793","211023 SANTANA DO MARANHAO",1,0,6,89,27,123,"2012"
"11794","211027 SANTO AMARO DO MARANHAO",0,1,1,42,88,132,"2012"
"11795","211030 SANTO ANTONIO DOS LOPES",1,0,3,57,178,239,"2012"
"11796","211040 SAO BENEDITO DO RIO PRETO",1,2,3,65,312,383,"2012"
"11797","211050 SAO BENTO",2,0,0,385,36,423,"2012"
"11798","211060 SAO BERNARDO",1,4,50,436,8,499,"2012"
"11799","211065 SAO DOMINGOS DO AZEITAO",0,0,0,2,90,92,"2012"
"11800","211070 SAO DOMINGOS DO MARANHAO",1,1,4,574,13,593,"2012"
"11801","211080 SAO FELIX DE BALSAS",0,0,0,2,45,47,"2012"
"11802","211085 SAO FRANCISCO DO BREJAO",1,1,5,109,3,119,"2012"
"11803","211090 SAO FRANCISCO DO MARANHAO",0,0,2,150,11,163,"2012"
"11804","211100 SAO JOAO BATISTA",1,24,28,141,65,259,"2012"
"11805","211102 SAO JOAO DO CARU",2,2,7,96,24,131,"2012"
"11806","211105 SAO JOAO DO PARAISO",0,3,1,163,1,168,"2012"
"11807","211107 SAO JOAO DO SOTER",1,2,3,247,20,273,"2012"
"11808","211110 SAO JOAO DOS PATOS",1,0,6,391,6,404,"2012"
"11809","211120 SAO JOSE DE RIBAMAR",14,13,27,2630,73,2757,"2012"
"11810","211125 SAO JOSE DOS BASILIOS",1,0,3,111,4,119,"2012"
"11811","211130 SAO LUIS",75,84,298,17134,468,18059,"2012"
"11812","211140 SAO LUIS GONZAGA DO MARANHAO",0,0,6,410,4,420,"2012"
"11813","211150 SAO MATEUS DO MARANHAO",0,2,58,655,15,730,"2012"
"11814","211153 SAO PEDRO DA AGUA BRANCA",1,1,7,161,1,171,"2012"
"11815","211157 SAO PEDRO DOS CRENTES",0,0,0,55,7,62,"2012"
"11816","211160 SAO RAIMUNDO DAS MANGABEIRAS",0,0,3,10,292,305,"2012"
"11817","211163 SAO RAIMUNDO DO DOCA BEZERRA",0,0,4,74,3,81,"2012"
"11818","211167 SAO ROBERTO",0,0,2,80,3,85,"2012"
"11819","211170 SAO VICENTE FERRER",0,0,2,52,252,306,"2012"
"11820","211172 SATUBINHA",0,0,3,136,4,143,"2012"
"11821","211174 SENADOR ALEXANDRE COSTA",0,0,2,100,88,190,"2012"
"11822","211176 SENADOR LA ROCQUE",0,1,13,323,8,345,"2012"
"11823","211178 SERRANO DO MARANHAO",0,0,1,37,137,175,"2012"
"11824","211180 SITIO NOVO",1,2,6,273,6,288,"2012"
"11825","211190 SUCUPIRA DO NORTE",0,0,3,138,6,147,"2012"
"11826","211195 SUCUPIRA DO RIACHAO",0,0,4,75,1,80,"2012"
"11827","211200 TASSO FRAGOSO",0,1,4,81,52,138,"2012"
"11828","211210 TIMBIRAS",1,3,12,443,18,477,"2012"
"11829","211220 TIMON",6,3,27,2592,30,2658,"2012"
"11830","211223 TRIZIDELA DO VALE",0,2,3,285,0,290,"2012"
"11831","211227 TUFILANDIA",0,0,4,104,6,114,"2012"
"11832","211230 TUNTUM",0,1,7,629,5,642,"2012"
"11833","211240 TURIACU",0,0,1,21,781,803,"2012"
"11834","211245 TURILANDIA",0,1,4,144,196,345,"2012"
"11835","211250 TUTOIA",10,7,23,795,170,1005,"2012"
"11836","211260 URBANO SANTOS",0,3,5,184,557,749,"2012"
"11837","211270 VARGEM GRANDE",1,6,24,852,47,930,"2012"
"11838","211280 VIANA",6,6,34,664,271,981,"2012"
"11839","211285 VILA NOVA DOS MARTIRIOS",1,1,4,134,5,145,"2012"
"11840","211290 VITORIA DO MEARIM",1,2,3,174,392,572,"2012"
"11841","211300 VITORINO FREIRE",1,1,24,486,15,527,"2012"
"11842","211400 ZE DOCA",5,7,32,739,30,813,"2012"
"11843","220005 ACAUA",0,0,0,73,5,78,"2012"
"11844","220010 AGRICOLANDIA",2,0,1,64,5,72,"2012"
"11845","220020 AGUA BRANCA",1,2,2,250,19,274,"2012"
"11846","220025 ALAGOINHA DO PIAUI",1,1,3,82,3,90,"2012"
"11847","220027 ALEGRETE DO PIAUI",0,1,2,64,0,67,"2012"
"11848","220030 ALTO LONGA",0,0,2,125,3,130,"2012"
"11849","220040 ALTOS",2,0,5,461,91,559,"2012"
"11850","220045 ALVORADA DO GURGUEIA",0,1,0,29,54,84,"2012"
"11851","220050 AMARANTE",1,5,7,254,7,274,"2012"
"11852","220060 ANGICAL DO PIAUI",0,1,3,76,3,83,"2012"
"11853","220070 ANISIO DE ABREU",0,0,1,38,99,138,"2012"
"11854","220080 ANTONIO ALMEIDA",0,0,0,12,26,38,"2012"
"11855","220090 AROAZES",1,0,0,49,1,51,"2012"
"11856","220095 AROEIRAS DO ITAIM",0,0,4,25,0,29,"2012"
"11857","220100 ARRAIAL",0,0,1,63,0,64,"2012"
"11858","220105 ASSUNCAO DO PIAUI",0,0,2,106,13,121,"2012"
"11859","220110 AVELINO LOPES",1,1,9,137,42,190,"2012"
"11860","220115 BAIXA GRANDE DO RIBEIRO",0,0,0,4,168,172,"2012"
"11861","220117 BARRA D'ALCANTARA",0,0,0,54,1,55,"2012"
"11862","220120 BARRAS",1,2,4,735,15,757,"2012"
"11863","220130 BARREIRAS DO PIAUI",0,0,0,11,35,46,"2012"
"11864","220140 BARRO DURO",0,0,1,110,5,116,"2012"
"11865","220150 BATALHA",0,3,4,310,13,330,"2012"
"11866","220155 BELA VISTA DO PIAUI",0,0,0,56,1,57,"2012"
"11867","220157 BELEM DO PIAUI",0,0,7,24,0,31,"2012"
"11868","220160 BENEDITINOS",0,0,2,113,21,136,"2012"
"11869","220170 BERTOLINIA",2,1,4,74,9,90,"2012"
"11870","220173 BETANIA DO PIAUI",2,0,1,100,7,110,"2012"
"11871","220177 BOA HORA",0,1,2,48,52,103,"2012"
"11872","220180 BOCAINA",0,0,5,46,0,51,"2012"
"11873","220190 BOM JESUS",1,2,1,139,282,425,"2012"
"11874","220191 BOM PRINCIPIO DO PIAUI",0,1,4,80,2,87,"2012"
"11875","220192 BONFIM DO PIAUI",2,0,0,25,58,85,"2012"
"11876","220194 BOQUEIRAO DO PIAUI",0,0,0,26,91,117,"2012"
"11877","220196 BRASILEIRA",0,0,0,99,3,102,"2012"
"11878","220198 BREJO DO PIAUI",0,0,0,21,15,36,"2012"
"11879","220200 BURITI DOS LOPES",1,0,3,262,19,285,"2012"
"11880","220202 BURITI DOS MONTES",0,1,0,61,31,93,"2012"
"11881","220205 CABECEIRAS DO PIAUI",0,0,1,95,59,155,"2012"
"11882","220207 CAJAZEIRAS DO PIAUI",0,0,1,38,0,39,"2012"
"11883","220208 CAJUEIRO DA PRAIA",0,0,1,80,3,84,"2012"
"11884","220209 CALDEIRAO GRANDE DO PIAUI",0,0,11,60,2,73,"2012"
"11885","220210 CAMPINAS DO PIAUI",0,0,1,63,0,64,"2012"
"11886","220211 CAMPO ALEGRE DO FIDALGO",0,1,1,68,0,70,"2012"
"11887","220213 CAMPO GRANDE DO PIAUI",2,2,5,89,0,98,"2012"
"11888","220217 CAMPO LARGO DO PIAUI",0,0,1,96,8,105,"2012"
"11889","220220 CAMPO MAIOR",1,4,1,238,702,946,"2012"
"11890","220225 CANAVIEIRA",0,0,0,32,1,33,"2012"
"11891","220230 CANTO DO BURITI",1,2,5,208,12,228,"2012"
"11892","220240 CAPITAO DE CAMPOS",0,1,1,67,72,141,"2012"
"11893","220245 CAPITAO GERVASIO OLIVEIRA",0,0,1,41,2,44,"2012"
"11894","220250 CARACOL",2,0,1,56,135,194,"2012"
"11895","220253 CARAUBAS DO PIAUI",0,1,2,86,6,95,"2012"
"11896","220255 CARIDADE DO PIAUI",0,0,1,83,0,84,"2012"
"11897","220260 CASTELO DO PIAUI",0,0,1,159,131,291,"2012"
"11898","220265 CAXINGO",0,0,1,90,2,93,"2012"
"11899","220270 COCAL",1,3,7,363,30,404,"2012"
"11900","220271 COCAL DE TELHA",0,0,1,20,32,53,"2012"
"11901","220272 COCAL DOS ALVES",0,0,0,80,6,86,"2012"
"11902","220273 COIVARAS",0,0,0,35,13,48,"2012"
"11903","220275 COLONIA DO GURGUEIA",3,0,1,56,21,81,"2012"
"11904","220277 COLONIA DO PIAUI",0,0,4,73,4,81,"2012"
"11905","220280 CONCEICAO DO CANINDE",0,0,0,48,1,49,"2012"
"11906","220285 CORONEL JOSE DIAS",0,0,2,11,35,48,"2012"
"11907","220290 CORRENTE",1,0,2,89,330,422,"2012"
"11908","220300 CRISTALANDIA DO PIAUI",0,0,0,106,28,134,"2012"
"11909","220310 CRISTINO CASTRO",0,0,2,65,118,185,"2012"
"11910","220320 CURIMATA",0,1,1,142,38,182,"2012"
"11911","220323 CURRAIS",0,0,0,24,55,79,"2012"
"11912","220325 CURRALINHOS",0,0,1,70,3,74,"2012"
"11913","220327 CURRAL NOVO DO PIAUI",0,0,0,79,1,80,"2012"
"11914","220330 DEMERVAL LOBAO",0,1,2,172,10,185,"2012"
"11915","220335 DIRCEU ARCOVERDE",0,0,0,43,57,100,"2012"
"11916","220340 DOM EXPEDITO LOPES",0,1,1,72,0,74,"2012"
"11917","220342 DOMINGOS MOURAO",0,1,0,63,2,66,"2012"
"11918","220345 DOM INOCENCIO",4,0,0,34,62,100,"2012"
"11919","220350 ELESBAO VELOSO",0,0,4,166,7,177,"2012"
"11920","220360 ELISEU MARTINS",1,0,4,49,2,56,"2012"
"11921","220370 ESPERANTINA",1,4,10,573,6,594,"2012"
"11922","220375 FARTURA DO PIAUI",0,0,0,24,34,58,"2012"
"11923","220380 FLORES DO PIAUI",0,0,1,67,2,70,"2012"
"11924","220385 FLORESTA DO PIAUI",0,0,1,25,1,27,"2012"
"11925","220390 FLORIANO",1,4,34,874,3,916,"2012"
"11926","220400 FRANCINOPOLIS",0,1,0,62,4,67,"2012"
"11927","220410 FRANCISCO AYRES",0,2,3,51,0,56,"2012"
"11928","220415 FRANCISCO MACEDO",0,0,9,33,0,42,"2012"
"11929","220420 FRANCISCO SANTOS",0,1,16,88,0,105,"2012"
"11930","220430 FRONTEIRAS",0,3,10,159,0,172,"2012"
"11931","220435 GEMINIANO",0,0,4,78,0,82,"2012"
"11932","220440 GILBUES",1,1,0,121,59,182,"2012"
"11933","220450 GUADALUPE",0,0,4,149,26,179,"2012"
"11934","220455 GUARIBAS",0,0,0,27,43,70,"2012"
"11935","220460 HUGO NAPOLEAO",0,0,2,42,1,45,"2012"
"11936","220465 ILHA GRANDE",0,0,2,119,1,122,"2012"
"11937","220470 INHUMA",1,1,3,198,2,205,"2012"
"11938","220480 IPIRANGA DO PIAUI",0,1,2,111,0,114,"2012"
"11939","220490 ISAIAS COELHO",0,1,3,119,5,128,"2012"
"11940","220500 ITAINOPOLIS",1,1,4,86,3,95,"2012"
"11941","220510 ITAUEIRA",0,1,6,144,2,153,"2012"
"11942","220515 JACOBINA DO PIAUI",0,0,1,83,12,96,"2012"
"11943","220520 JAICOS",2,3,11,296,3,315,"2012"
"11944","220525 JARDIM DO MULATO",0,0,1,43,4,48,"2012"
"11945","220527 JATOBA DO PIAUI",0,1,0,28,37,66,"2012"
"11946","220530 JERUMENHA",0,0,4,50,2,56,"2012"
"11947","220535 JOAO COSTA",1,0,1,38,4,44,"2012"
"11948","220540 JOAQUIM PIRES",0,4,1,203,3,211,"2012"
"11949","220545 JOCA MARQUES",1,1,0,66,15,83,"2012"
"11950","220550 JOSE DE FREITAS",0,1,5,577,13,596,"2012"
"11951","220551 JUAZEIRO DO PIAUI",0,1,3,36,35,75,"2012"
"11952","220552 JULIO BORGES",0,0,0,43,17,60,"2012"
"11953","220553 JUREMA",0,1,0,29,41,71,"2012"
"11954","220554 LAGOINHA DO PIAUI",0,1,0,20,5,26,"2012"
"11955","220555 LAGOA ALEGRE",0,2,0,96,24,122,"2012"
"11956","220556 LAGOA DO BARRO DO PIAUI",0,0,0,53,17,70,"2012"
"11957","220557 LAGOA DE SAO FRANCISCO",0,0,0,60,1,61,"2012"
"11958","220558 LAGOA DO PIAUI",0,0,1,58,2,61,"2012"
"11959","220559 LAGOA DO SITIO",0,0,0,38,0,38,"2012"
"11960","220560 LANDRI SALES",1,0,3,56,1,61,"2012"
"11961","220570 LUIS CORREIA",1,3,2,372,34,412,"2012"
"11962","220580 LUZILANDIA",0,1,4,347,68,420,"2012"
"11963","220585 MADEIRO",0,0,3,112,12,127,"2012"
"11964","220590 MANOEL EMIDIO",11,2,2,44,0,59,"2012"
"11965","220595 MARCOLANDIA",0,1,12,119,0,132,"2012"
"11966","220600 MARCOS PARENTE",0,0,1,53,2,56,"2012"
"11967","220605 MASSAPE DO PIAUI",0,0,1,73,1,75,"2012"
"11968","220610 MATIAS OLIMPIO",0,2,1,167,12,182,"2012"
"11969","220620 MIGUEL ALVES",5,0,9,512,47,573,"2012"
"11970","220630 MIGUEL LEAO",0,0,0,18,0,18,"2012"
"11971","220635 MILTON BRANDAO",0,1,2,79,2,84,"2012"
"11972","220640 MONSENHOR GIL",1,0,1,138,2,142,"2012"
"11973","220650 MONSENHOR HIPOLITO",0,0,2,97,1,100,"2012"
"11974","220660 MONTE ALEGRE DO PIAUI",1,1,1,76,73,152,"2012"
"11975","220665 MORRO CABECA NO TEMPO",1,0,1,58,17,77,"2012"
"11976","220667 MORRO DO CHAPEU DO PIAUI",0,1,2,95,1,99,"2012"
"11977","220669 MURICI DOS PORTELAS",0,0,1,86,8,95,"2012"
"11978","220670 NAZARE DO PIAUI",0,0,3,92,0,95,"2012"
"11979","220672 NAZARIA",0,0,3,143,1,147,"2012"
"11980","220675 NOSSA SENHORA DE NAZARE",0,0,1,10,47,58,"2012"
"11981","220680 NOSSA SENHORA DOS REMEDIOS",0,1,1,129,15,146,"2012"
"11982","220690 NOVO ORIENTE DO PIAUI",0,0,0,64,3,67,"2012"
"11983","220695 NOVO SANTO ANTONIO",0,1,0,39,2,42,"2012"
"11984","220700 OEIRAS",3,2,12,399,3,419,"2012"
"11985","220710 OLHO D'AGUA DO PIAUI",0,1,0,39,3,43,"2012"
"11986","220720 PADRE MARCOS",3,2,9,63,3,80,"2012"
"11987","220730 PAES LANDIM",0,0,0,42,7,49,"2012"
"11988","220735 PAJEU DO PIAUI",0,0,0,19,0,19,"2012"
"11989","220740 PALMEIRA DO PIAUI",0,0,0,17,50,67,"2012"
"11990","220750 PALMEIRAIS",0,0,2,176,26,204,"2012"
"11991","220755 PAQUETA",0,0,5,29,0,34,"2012"
"11992","220760 PARNAGUA",0,0,2,27,130,159,"2012"
"11993","220770 PARNAIBA",4,13,19,2168,89,2293,"2012"
"11994","220775 PASSAGEM FRANCA DO PIAUI",0,0,0,65,6,71,"2012"
"11995","220777 PATOS DO PIAUI",0,2,0,66,4,72,"2012"
"11996","220779 PAU D'ARCO DO PIAUI",0,0,1,39,2,42,"2012"
"11997","220780 PAULISTANA",0,3,3,288,24,318,"2012"
"11998","220785 PAVUSSU",0,1,0,40,0,41,"2012"
"11999","220790 PEDRO II",1,4,15,522,7,549,"2012"
"12000","220793 PEDRO LAURENTINO",0,0,1,36,0,37,"2012"
"12001","220795 NOVA SANTA RITA",0,2,3,57,0,62,"2012"
"12002","220800 PICOS",4,9,34,991,4,1042,"2012"
"12003","220810 PIMENTEIRAS",0,1,5,155,4,165,"2012"
"12004","220820 PIO IX",2,1,9,242,1,255,"2012"
"12005","220830 PIRACURUCA",0,2,5,432,6,445,"2012"
"12006","220840 PIRIPIRI",2,3,14,807,21,847,"2012"
"12007","220850 PORTO",1,1,1,228,2,233,"2012"
"12008","220855 PORTO ALEGRE DO PIAUI",1,0,1,50,3,55,"2012"
"12009","220860 PRATA DO PIAUI",0,0,0,32,2,34,"2012"
"12010","220865 QUEIMADA NOVA",0,0,1,71,14,86,"2012"
"12011","220870 REDENCAO DO GURGUEIA",0,0,0,50,107,157,"2012"
"12012","220880 REGENERACAO",1,0,9,276,3,289,"2012"
"12013","220885 RIACHO FRIO",0,0,0,20,49,69,"2012"
"12014","220887 RIBEIRA DO PIAUI",0,0,2,40,4,46,"2012"
"12015","220890 RIBEIRO GONCALVES",0,0,0,10,108,118,"2012"
"12016","220900 RIO GRANDE DO PIAUI",0,0,1,73,0,74,"2012"
"12017","220910 SANTA CRUZ DO PIAUI",0,1,2,86,0,89,"2012"
"12018","220915 SANTA CRUZ DOS MILAGRES",0,0,0,35,0,35,"2012"
"12019","220920 SANTA FILOMENA",0,0,3,80,5,88,"2012"
"12020","220930 SANTA LUZ",0,0,0,25,47,72,"2012"
"12021","220935 SANTANA DO PIAUI",0,0,0,57,0,57,"2012"
"12022","220937 SANTA ROSA DO PIAUI",0,0,2,56,1,59,"2012"
"12023","220940 SANTO ANTONIO DE LISBOA",0,3,9,80,0,92,"2012"
"12024","220945 SANTO ANTONIO DOS MILAGRES",0,0,1,30,3,34,"2012"
"12025","220950 SANTO INACIO DO PIAUI",0,0,1,31,1,33,"2012"
"12026","220955 SAO BRAZ DO PIAUI",0,0,1,14,38,53,"2012"
"12027","220960 SAO FELIX DO PIAUI",0,0,0,31,1,32,"2012"
"12028","220965 SAO FRANCISCO DE ASSIS DO PIAUI",0,0,1,74,1,76,"2012"
"12029","220970 SAO FRANCISCO DO PIAUI",0,0,0,73,0,73,"2012"
"12030","220975 SAO GONCALO DO GURGUEIA",0,0,0,6,22,28,"2012"
"12031","220980 SAO GONCALO DO PIAUI",0,1,2,73,10,86,"2012"
"12032","220985 SAO JOAO DA CANABRAVA",0,0,4,47,1,52,"2012"
"12033","220987 SAO JOAO DA FRONTEIRA",0,0,0,86,1,87,"2012"
"12034","220990 SAO JOAO DA SERRA",0,0,1,65,25,91,"2012"
"12035","220995 SAO JOAO DA VARJOTA",0,0,3,68,0,71,"2012"
"12036","220997 SAO JOAO DO ARRAIAL",0,0,1,127,5,133,"2012"
"12037","221000 SAO JOAO DO PIAUI",3,3,6,259,3,274,"2012"
"12038","221005 SAO JOSE DO DIVINO",1,0,1,84,0,86,"2012"
"12039","221010 SAO JOSE DO PEIXE",0,1,2,43,0,46,"2012"
"12040","221020 SAO JOSE DO PIAUI",0,0,11,69,0,80,"2012"
"12041","221030 SAO JULIAO",0,0,0,72,1,73,"2012"
"12042","221035 SAO LOURENCO DO PIAUI",0,0,0,14,20,34,"2012"
"12043","221037 SAO LUIS DO PIAUI",0,1,2,27,1,31,"2012"
"12044","221038 SAO MIGUEL DA BAIXA GRANDE",0,0,0,21,1,22,"2012"
"12045","221039 SAO MIGUEL DO FIDALGO",0,0,0,32,0,32,"2012"
"12046","221040 SAO MIGUEL DO TAPUIO",2,0,1,221,35,259,"2012"
"12047","221050 SAO PEDRO DO PIAUI",0,0,0,178,17,195,"2012"
"12048","221060 SAO RAIMUNDO NONATO",2,0,3,180,376,561,"2012"
"12049","221062 SEBASTIAO BARROS",0,2,3,31,32,68,"2012"
"12050","221063 SEBASTIAO LEAL",0,0,2,38,18,58,"2012"
"12051","221065 SIGEFREDO PACHECO",0,0,0,38,66,104,"2012"
"12052","221070 SIMOES",1,1,0,245,1,248,"2012"
"12053","221080 SIMPLICIO MENDES",0,2,1,144,0,147,"2012"
"12054","221090 SOCORRO DO PIAUI",0,0,2,49,7,58,"2012"
"12055","221093 SUSSUAPARA",0,0,1,82,0,83,"2012"
"12056","221095 TAMBORIL DO PIAUI",0,0,0,20,14,34,"2012"
"12057","221097 TANQUE DO PIAUI",0,0,0,44,0,44,"2012"
"12058","221100 TERESINA",43,52,152,13367,199,13813,"2012"
"12059","221110 UNIAO",2,7,7,357,275,648,"2012"
"12060","221120 URUCUI",1,0,4,43,344,392,"2012"
"12061","221130 VALENCA DO PIAUI",1,1,3,264,4,273,"2012"
"12062","221135 VARZEA BRANCA",1,0,0,25,50,76,"2012"
"12063","221140 VARZEA GRANDE",0,1,0,54,4,59,"2012"
"12064","221150 VERA MENDES",0,0,1,34,1,36,"2012"
"12065","221160 VILA NOVA DO PIAUI",0,1,3,36,0,40,"2012"
"12066","221170 WALL FERRAZ",0,1,5,37,3,46,"2012"
"12067","MUNICIPIO IGNORADO - CE",0,0,0,2,0,2,"2012"
"12068","230010 ABAIARA",0,0,4,151,0,155,"2012"
"12069","230015 ACARAPE",1,1,0,240,0,242,"2012"
"12070","230020 ACARAU",0,2,14,942,3,961,"2012"
"12071","230030 ACOPIARA",2,10,41,600,5,658,"2012"
"12072","230040 AIUABA",0,3,9,197,2,211,"2012"
"12073","230050 ALCANTARAS",1,0,4,149,1,155,"2012"
"12074","230060 ALTANEIRA",0,0,1,116,3,120,"2012"
"12075","230070 ALTO SANTO",0,2,8,190,0,200,"2012"
"12076","230075 AMONTADA",1,3,14,673,13,704,"2012"
"12077","230080 ANTONINA DO NORTE",0,2,3,107,0,112,"2012"
"12078","230090 APUIARES",1,0,2,139,2,144,"2012"
"12079","230100 AQUIRAZ",3,2,19,959,3,986,"2012"
"12080","230110 ARACATI",5,5,19,937,6,972,"2012"
"12081","230120 ARACOIABA",1,2,9,342,4,358,"2012"
"12082","230125 ARARENDA",1,0,4,104,6,115,"2012"
"12083","230130 ARARIPE",0,1,18,344,6,369,"2012"
"12084","230140 ARATUBA",0,2,2,181,3,188,"2012"
"12085","230150 ARNEIROZ",0,1,3,106,2,112,"2012"
"12086","230160 ASSARE",2,3,7,309,10,331,"2012"
"12087","230170 AURORA",1,2,10,301,4,318,"2012"
"12088","230180 BAIXIO",0,0,4,74,0,78,"2012"
"12089","230185 BANABUIU",1,0,7,253,4,265,"2012"
"12090","230190 BARBALHA",0,3,23,969,54,1049,"2012"
"12091","230195 BARREIRA",0,1,10,305,1,317,"2012"
"12092","230200 BARRO",2,1,5,271,2,281,"2012"
"12093","230205 BARROQUINHA",0,0,2,207,3,212,"2012"
"12094","230210 BATURITE",1,1,8,454,1,465,"2012"
"12095","230220 BEBERIBE",1,2,9,551,4,567,"2012"
"12096","230230 BELA CRUZ",1,3,12,413,3,432,"2012"
"12097","230240 BOA VIAGEM",1,4,19,724,6,754,"2012"
"12098","230250 BREJO SANTO",1,1,17,633,1,653,"2012"
"12099","230260 CAMOCIM",2,5,13,937,7,964,"2012"
"12100","230270 CAMPOS SALES",0,6,12,400,2,420,"2012"
"12101","230280 CANINDE",3,4,29,1066,15,1117,"2012"
"12102","230290 CAPISTRANO",0,3,7,217,1,228,"2012"
"12103","230300 CARIDADE",1,0,1,228,1,231,"2012"
"12104","230310 CARIRE",0,1,7,184,1,193,"2012"
"12105","230320 CARIRIACU",5,10,23,372,1,411,"2012"
"12106","230330 CARIUS",0,9,12,199,2,222,"2012"
"12107","230340 CARNAUBAL",0,1,7,210,1,219,"2012"
"12108","230350 CASCAVEL",1,5,19,823,12,860,"2012"
"12109","230360 CATARINA",0,0,2,128,0,130,"2012"
"12110","230365 CATUNDA",0,0,0,126,1,127,"2012"
"12111","230370 CAUCAIA",13,19,77,4686,26,4821,"2012"
"12112","230380 CEDRO",0,2,7,233,0,242,"2012"
"12113","230390 CHAVAL",0,0,2,206,1,209,"2012"
"12114","230393 CHORO",0,3,6,178,6,193,"2012"
"12115","230395 CHOROZINHO",0,1,4,273,1,279,"2012"
"12116","230400 COREAU",0,2,5,281,1,289,"2012"
"12117","230410 CRATEUS",0,1,14,1005,27,1047,"2012"
"12118","230420 CRATO",8,9,77,2019,17,2130,"2012"
"12119","230423 CROATA",0,2,3,217,0,222,"2012"
"12120","230425 CRUZ",0,3,7,327,2,339,"2012"
"12121","230426 DEPUTADO IRAPUAN PINHEIRO",0,0,5,86,0,91,"2012"
"12122","230427 ERERE",0,0,4,44,0,48,"2012"
"12123","230428 EUSEBIO",2,2,19,860,1,884,"2012"
"12124","230430 FARIAS BRITO",1,0,5,263,2,271,"2012"
"12125","230435 FORQUILHA",1,3,5,298,0,307,"2012"
"12126","230440 FORTALEZA",88,134,573,36525,257,37577,"2012"
"12127","230445 FORTIM",1,1,4,158,0,164,"2012"
"12128","230450 FRECHEIRINHA",2,1,6,216,0,225,"2012"
"12129","230460 GENERAL SAMPAIO",0,0,2,93,2,97,"2012"
"12130","230465 GRACA",0,2,5,152,0,159,"2012"
"12131","230470 GRANJA",3,7,34,699,1,744,"2012"
"12132","230480 GRANJEIRO",1,1,4,55,1,62,"2012"
"12133","230490 GROAIRAS",1,2,6,143,0,152,"2012"
"12134","230495 GUAIUBA",0,2,6,352,3,363,"2012"
"12135","230500 GUARACIABA DO NORTE",4,7,21,579,3,614,"2012"
"12136","230510 GUARAMIRANGA",0,1,3,90,1,95,"2012"
"12137","230520 HIDROLANDIA",0,0,2,230,0,232,"2012"
"12138","230523 HORIZONTE",3,7,24,1009,5,1048,"2012"
"12139","230526 IBARETAMA",0,0,19,178,0,197,"2012"
"12140","230530 IBIAPINA",2,4,11,318,5,340,"2012"
"12141","230533 IBICUITINGA",0,1,4,143,0,148,"2012"
"12142","230535 ICAPUI",0,2,8,206,2,218,"2012"
"12143","230540 ICO",1,4,31,846,0,882,"2012"
"12144","230550 IGUATU",5,32,90,1257,8,1392,"2012"
"12145","230560 INDEPENDENCIA",0,2,4,303,3,312,"2012"
"12146","230565 IPAPORANGA",0,1,2,129,0,132,"2012"
"12147","230570 IPAUMIRIM",1,0,6,132,0,139,"2012"
"12148","230580 IPU",2,2,9,556,2,571,"2012"
"12149","230590 IPUEIRAS",1,1,13,474,7,496,"2012"
"12150","230600 IRACEMA",0,0,7,173,0,180,"2012"
"12151","230610 IRAUCUBA",1,1,6,374,1,383,"2012"
"12152","230620 ITAICABA",0,0,1,74,1,76,"2012"
"12153","230625 ITAITINGA",4,2,9,409,1,425,"2012"
"12154","230630 ITAPAGE",2,2,9,763,1,777,"2012"
"12155","230640 ITAPIPOCA",5,8,37,1965,17,2032,"2012"
"12156","230650 ITAPIUNA",0,1,4,241,5,251,"2012"
"12157","230655 ITAREMA",1,3,6,659,2,671,"2012"
"12158","230660 ITATIRA",0,0,10,296,4,310,"2012"
"12159","230670 JAGUARETAMA",0,0,4,234,0,238,"2012"
"12160","230680 JAGUARIBARA",0,2,7,122,0,131,"2012"
"12161","230690 JAGUARIBE",0,3,13,433,0,449,"2012"
"12162","230700 JAGUARUANA",0,3,16,419,1,439,"2012"
"12163","230710 JARDIM",0,2,6,411,12,431,"2012"
"12164","230720 JATI",0,0,3,111,0,114,"2012"
"12165","230725 JIJOCA DE JERICOACOARA",0,3,5,238,0,246,"2012"
"12166","230730 JUAZEIRO DO NORTE",34,24,132,3897,19,4106,"2012"
"12167","230740 JUCAS",1,6,13,314,3,337,"2012"
"12168","230750 LAVRAS DA MANGABEIRA",0,1,2,315,1,319,"2012"
"12169","230760 LIMOEIRO DO NORTE",2,5,21,736,2,766,"2012"
"12170","230763 MADALENA",0,1,5,237,5,248,"2012"
"12171","230765 MARACANAU",7,16,53,4163,17,4256,"2012"
"12172","230770 MARANGUAPE",3,7,19,1331,17,1377,"2012"
"12173","230780 MARCO",2,1,9,490,1,503,"2012"
"12174","230790 MARTINOPOLE",1,1,4,167,1,174,"2012"
"12175","230800 MASSAPE",1,2,15,554,2,574,"2012"
"12176","230810 MAURITI",1,4,9,654,3,671,"2012"
"12177","230820 MERUOCA",0,4,1,195,0,200,"2012"
"12178","230830 MILAGRES",2,1,10,399,3,415,"2012"
"12179","230835 MILHA",0,1,5,144,0,150,"2012"
"12180","230837 MIRAIMA",1,1,2,208,2,214,"2012"
"12181","230840 MISSAO VELHA",3,3,9,540,23,578,"2012"
"12182","230850 MOMBACA",1,4,24,430,3,462,"2012"
"12183","230860 MONSENHOR TABOSA",1,0,4,224,3,232,"2012"
"12184","230870 MORADA NOVA",1,2,7,681,2,693,"2012"
"12185","230880 MORAUJO",1,0,2,124,0,127,"2012"
"12186","230890 MORRINHOS",0,5,5,305,0,315,"2012"
"12187","230900 MUCAMBO",0,2,3,184,0,189,"2012"
"12188","230910 MULUNGU",0,2,5,138,1,146,"2012"
"12189","230920 NOVA OLINDA",0,3,10,226,3,242,"2012"
"12190","230930 NOVA RUSSAS",0,1,7,413,1,422,"2012"
"12191","230940 NOVO ORIENTE",0,2,8,381,13,404,"2012"
"12192","230945 OCARA",1,0,15,267,2,285,"2012"
"12193","230950 OROS",1,1,6,267,0,275,"2012"
"12194","230960 PACAJUS",2,4,20,870,6,902,"2012"
"12195","230970 PACATUBA",3,2,18,798,9,830,"2012"
"12196","230980 PACOTI",0,1,2,150,1,154,"2012"
"12197","230990 PACUJA",1,2,2,83,0,88,"2012"
"12198","231000 PALHANO",0,1,2,100,1,104,"2012"
"12199","231010 PALMACIA",0,2,3,124,4,133,"2012"
"12200","231020 PARACURU",2,1,8,518,3,532,"2012"
"12201","231025 PARAIPABA",2,3,6,423,1,435,"2012"
"12202","231030 PARAMBU",0,0,33,357,5,395,"2012"
"12203","231040 PARAMOTI",0,0,6,116,0,122,"2012"
"12204","231050 PEDRA BRANCA",2,1,22,564,3,592,"2012"
"12205","231060 PENAFORTE",0,0,4,173,1,178,"2012"
"12206","231070 PENTECOSTE",0,2,11,517,0,530,"2012"
"12207","231080 PEREIRO",0,0,8,206,2,216,"2012"
"12208","231085 PINDORETAMA",3,2,5,274,3,287,"2012"
"12209","231090 PIQUET CARNEIRO",1,2,9,159,0,171,"2012"
"12210","231095 PIRES FERREIRA",1,0,0,112,0,113,"2012"
"12211","231100 PORANGA",0,0,2,158,4,164,"2012"
"12212","231110 PORTEIRAS",0,0,3,258,1,262,"2012"
"12213","231120 POTENGI",0,1,3,134,3,141,"2012"
"12214","231123 POTIRETAMA",0,1,3,60,0,64,"2012"
"12215","231126 QUITERIANOPOLIS",0,0,7,207,6,220,"2012"
"12216","231130 QUIXADA",0,8,37,1262,7,1314,"2012"
"12217","231135 QUIXELO",1,3,15,185,0,204,"2012"
"12218","231140 QUIXERAMOBIM",1,8,43,1009,8,1069,"2012"
"12219","231150 QUIXERE",0,2,9,261,0,272,"2012"
"12220","231160 REDENCAO",1,1,5,457,2,466,"2012"
"12221","231170 RERIUTABA",0,2,1,245,0,248,"2012"
"12222","231180 RUSSAS",3,5,24,929,1,962,"2012"
"12223","231190 SABOEIRO",1,6,18,192,2,219,"2012"
"12224","231195 SALITRE",1,3,14,282,0,300,"2012"
"12225","231200 SANTANA DO ACARAU",2,2,15,457,7,483,"2012"
"12226","231210 SANTANA DO CARIRI",2,2,4,241,3,252,"2012"
"12227","231220 SANTA QUITERIA",1,1,5,568,1,576,"2012"
"12228","231230 SAO BENEDITO",3,4,27,745,4,783,"2012"
"12229","231240 SAO GONCALO DO AMARANTE",1,4,15,760,6,786,"2012"
"12230","231250 SAO JOAO DO JAGUARIBE",0,1,3,77,0,81,"2012"
"12231","231260 SAO LUIS DO CURU",0,0,1,156,0,157,"2012"
"12232","231270 SENADOR POMPEU",0,3,12,342,4,361,"2012"
"12233","231280 SENADOR SA",0,0,2,121,0,123,"2012"
"12234","231290 SOBRAL",3,30,64,3059,8,3164,"2012"
"12235","231300 SOLONOPOLE",1,1,5,162,1,170,"2012"
"12236","231310 TABULEIRO DO NORTE",0,2,18,364,0,384,"2012"
"12237","231320 TAMBORIL",3,0,3,308,10,324,"2012"
"12238","231325 TARRAFAS",0,0,3,88,0,91,"2012"
"12239","231330 TAUA",0,5,32,668,11,716,"2012"
"12240","231335 TEJUCUOCA",1,0,6,264,1,272,"2012"
"12241","231340 TIANGUA",4,9,19,1279,10,1321,"2012"
"12242","231350 TRAIRI",0,4,15,567,1,587,"2012"
"12243","231355 TURURU",1,4,3,248,2,258,"2012"
"12244","231360 UBAJARA",5,6,10,519,5,545,"2012"
"12245","231370 UMARI",0,1,3,76,0,80,"2012"
"12246","231375 UMIRIM",0,2,9,274,0,285,"2012"
"12247","231380 URUBURETAMA",0,3,6,325,0,334,"2012"
"12248","231390 URUOCA",0,1,4,171,0,176,"2012"
"12249","231395 VARJOTA",1,3,5,267,1,277,"2012"
"12250","231400 VARZEA ALEGRE",0,2,12,476,2,492,"2012"
"12251","231410 VICOSA DO CEARA",3,2,15,903,8,931,"2012"
"12252","MUNICIPIO IGNORADO - RN",0,0,0,4,0,4,"2012"
"12253","240010 ACARI",0,0,2,147,0,149,"2012"
"12254","240020 ACU",3,3,3,778,2,789,"2012"
"12255","240030 AFONSO BEZERRA",0,5,0,145,1,151,"2012"
"12256","240040 AGUA NOVA",1,0,0,50,0,51,"2012"
"12257","240050 ALEXANDRIA",0,0,2,162,0,164,"2012"
"12258","240060 ALMINO AFONSO",1,0,0,65,0,66,"2012"
"12259","240070 ALTO DO RODRIGUES",1,0,1,150,1,153,"2012"
"12260","240080 ANGICOS",0,1,5,148,1,155,"2012"
"12261","240090 ANTONIO MARTINS",0,0,0,112,0,112,"2012"
"12262","240100 APODI",0,1,2,409,0,412,"2012"
"12263","240110 AREIA BRANCA",0,0,10,355,1,366,"2012"
"12264","240120 ARES",0,0,3,232,1,236,"2012"
"12265","240130 AUGUSTO SEVERO",0,0,4,99,1,104,"2012"
"12266","240140 BAIA FORMOSA",0,0,1,107,2,110,"2012"
"12267","240145 BARAUNA",0,3,3,395,0,401,"2012"
"12268","240150 BARCELONA",0,0,1,27,0,28,"2012"
"12269","240160 BENTO FERNANDES",0,2,1,81,0,84,"2012"
"12270","240165 BODO",0,0,2,33,0,35,"2012"
"12271","240170 BOM JESUS",0,2,2,119,1,124,"2012"
"12272","240180 BREJINHO",1,0,3,170,0,174,"2012"
"12273","240185 CAICARA DO NORTE",1,2,2,78,6,89,"2012"
"12274","240190 CAICARA DO RIO DO VENTO",0,0,2,47,5,54,"2012"
"12275","240200 CAICO",3,4,46,729,0,782,"2012"
"12276","240210 CAMPO REDONDO",0,0,4,136,0,140,"2012"
"12277","240220 CANGUARETAMA",1,4,12,554,8,579,"2012"
"12278","240230 CARAUBAS",1,1,8,273,1,284,"2012"
"12279","240240 CARNAUBA DOS DANTAS",0,1,6,101,3,111,"2012"
"12280","240250 CARNAUBAIS",0,0,2,134,0,136,"2012"
"12281","240260 CEARA-MIRIM",2,6,27,1060,6,1101,"2012"
"12282","240270 CERRO CORA",0,1,12,128,0,141,"2012"
"12283","240280 CORONEL EZEQUIEL",0,0,2,63,1,66,"2012"
"12284","240290 CORONEL JOAO PESSOA",0,0,0,61,0,61,"2012"
"12285","240300 CRUZETA",1,3,6,92,0,102,"2012"
"12286","240310 CURRAIS NOVOS",1,3,40,503,1,548,"2012"
"12287","240320 DOUTOR SEVERIANO",0,0,0,109,0,109,"2012"
"12288","240325 PARNAMIRIM",11,13,58,3605,19,3706,"2012"
"12289","240330 ENCANTO",0,0,1,79,0,80,"2012"
"12290","240340 EQUADOR",0,0,2,60,0,62,"2012"
"12291","240350 ESPIRITO SANTO",0,1,2,127,2,132,"2012"
"12292","240360 EXTREMOZ",1,4,9,358,4,376,"2012"
"12293","240370 FELIPE GUERRA",0,0,1,66,0,67,"2012"
"12294","240375 FERNANDO PEDROZA",0,1,0,32,0,33,"2012"
"12295","240380 FLORANIA",0,2,8,124,1,135,"2012"
"12296","240390 FRANCISCO DANTAS",0,0,1,45,0,46,"2012"
"12297","240400 FRUTUOSO GOMES",0,0,0,59,0,59,"2012"
"12298","240410 GALINHOS",0,0,0,32,0,32,"2012"
"12299","240420 GOIANINHA",1,4,12,475,1,493,"2012"
"12300","240430 GOVERNADOR DIX-SEPT ROSADO",0,1,4,186,0,191,"2012"
"12301","240440 GROSSOS",0,0,4,98,1,103,"2012"
"12302","240450 GUAMARE",0,1,2,226,0,229,"2012"
"12303","240460 IELMO MARINHO",2,0,2,133,0,137,"2012"
"12304","240470 IPANGUACU",1,1,2,204,1,209,"2012"
"12305","240480 IPUEIRA",0,0,0,22,0,22,"2012"
"12306","240485 ITAJA",0,1,3,122,0,126,"2012"
"12307","240490 ITAU",1,0,0,74,0,75,"2012"
"12308","240500 JACANA",0,0,2,105,1,108,"2012"
"12309","240510 JANDAIRA",0,1,0,82,2,85,"2012"
"12310","240520 JANDUIS",0,0,2,74,0,76,"2012"
"12311","240530 JANUARIO CICCO",0,0,2,110,2,114,"2012"
"12312","240540 JAPI",0,0,1,100,0,101,"2012"
"12313","240550 JARDIM DE ANGICOS",0,0,0,34,0,34,"2012"
"12314","240560 JARDIM DE PIRANHAS",0,2,12,149,1,164,"2012"
"12315","240570 JARDIM DO SERIDO",0,1,3,112,0,116,"2012"
"12316","240580 JOAO CAMARA",0,3,12,476,0,491,"2012"
"12317","240590 JOAO DIAS",0,0,0,33,0,33,"2012"
"12318","240600 JOSE DA PENHA",0,2,2,72,0,76,"2012"
"12319","240610 JUCURUTU",1,1,11,231,2,246,"2012"
"12320","240615 JUNDIA",0,0,0,38,0,38,"2012"
"12321","240620 LAGOA D'ANTA",1,2,1,69,2,75,"2012"
"12322","240630 LAGOA DE PEDRAS",1,0,3,91,2,97,"2012"
"12323","240640 LAGOA DE VELHOS",0,0,0,38,1,39,"2012"
"12324","240650 LAGOA NOVA",0,3,13,193,0,209,"2012"
"12325","240660 LAGOA SALGADA",0,1,0,148,1,150,"2012"
"12326","240670 LAJES",2,1,3,109,2,117,"2012"
"12327","240680 LAJES PINTADAS",0,1,2,81,1,85,"2012"
"12328","240690 LUCRECIA",1,0,1,50,0,52,"2012"
"12329","240700 LUIS GOMES",0,2,2,155,0,159,"2012"
"12330","240710 MACAIBA",1,5,18,799,6,829,"2012"
"12331","240720 MACAU",0,0,3,252,0,255,"2012"
"12332","240725 MAJOR SALES",0,1,0,60,0,61,"2012"
"12333","240730 MARCELINO VIEIRA",0,0,1,88,0,89,"2012"
"12334","240740 MARTINS",3,1,1,66,0,71,"2012"
"12335","240750 MAXARANGUAPE",0,1,2,121,2,126,"2012"
"12336","240760 MESSIAS TARGINO",0,0,0,48,0,48,"2012"
"12337","240770 MONTANHAS",1,1,8,119,2,131,"2012"
"12338","240780 MONTE ALEGRE",2,0,4,259,1,266,"2012"
"12339","240790 MONTE DAS GAMELEIRAS",0,0,1,33,0,34,"2012"
"12340","240800 MOSSORO",6,19,85,3696,13,3819,"2012"
"12341","240810 NATAL",21,53,212,11868,57,12211,"2012"
"12342","240820 NISIA FLORESTA",4,2,6,345,0,357,"2012"
"12343","240830 NOVA CRUZ",2,1,9,475,7,494,"2012"
"12344","240840 OLHO-D'AGUA DO BORGES",0,0,0,48,0,48,"2012"
"12345","240850 OURO BRANCO",0,0,3,59,1,63,"2012"
"12346","240860 PARANA",0,1,1,46,0,48,"2012"
"12347","240870 PARAU",0,0,0,39,1,40,"2012"
"12348","240880 PARAZINHO",0,1,5,69,0,75,"2012"
"12349","240890 PARELHAS",2,0,8,337,0,347,"2012"
"12350","240895 RIO DO FOGO",0,1,5,174,1,181,"2012"
"12351","240910 PASSA E FICA",1,0,2,174,0,177,"2012"
"12352","240920 PASSAGEM",0,0,2,43,0,45,"2012"
"12353","240930 PATU",0,0,0,130,0,130,"2012"
"12354","240933 SANTA MARIA",1,0,2,40,1,44,"2012"
"12355","240940 PAU DOS FERROS",1,3,5,375,0,384,"2012"
"12356","240950 PEDRA GRANDE",0,0,2,53,1,56,"2012"
"12357","240960 PEDRA PRETA",0,0,0,35,1,36,"2012"
"12358","240970 PEDRO AVELINO",0,0,2,74,1,77,"2012"
"12359","240980 PEDRO VELHO",1,2,6,215,3,227,"2012"
"12360","240990 PENDENCIAS",0,0,1,129,0,130,"2012"
"12361","241000 PILOES",0,0,0,33,0,33,"2012"
"12362","241010 POCO BRANCO",0,0,7,209,1,217,"2012"
"12363","241020 PORTALEGRE",0,0,2,104,0,106,"2012"
"12364","241025 PORTO DO MANGUE",0,1,1,67,0,69,"2012"
"12365","241030 SERRA CAIADA",0,1,3,143,0,147,"2012"
"12366","241040 PUREZA",0,0,4,112,1,117,"2012"
"12367","241050 RAFAEL FERNANDES",0,0,0,59,0,59,"2012"
"12368","241060 RAFAEL GODEIRO",0,0,0,57,1,58,"2012"
"12369","241070 RIACHO DA CRUZ",0,0,0,45,0,45,"2012"
"12370","241080 RIACHO DE SANTANA",1,2,0,53,0,56,"2012"
"12371","241090 RIACHUELO",0,0,1,100,2,103,"2012"
"12372","241100 RODOLFO FERNANDES",0,0,1,57,0,58,"2012"
"12373","241105 TIBAU",1,0,1,53,0,55,"2012"
"12374","241110 RUY BARBOSA",0,2,3,40,0,45,"2012"
"12375","241120 SANTA CRUZ",1,3,10,566,4,584,"2012"
"12376","241140 SANTANA DO MATOS",3,2,3,143,0,151,"2012"
"12377","241142 SANTANA DO SERIDO",0,0,0,29,0,29,"2012"
"12378","241150 SANTO ANTONIO",4,2,7,306,10,329,"2012"
"12379","241160 SAO BENTO DO NORTE",0,1,4,43,0,48,"2012"
"12380","241170 SAO BENTO DO TRAIRI",0,1,1,55,2,59,"2012"
"12381","241180 SAO FERNANDO",0,1,4,43,1,49,"2012"
"12382","241190 SAO FRANCISCO DO OESTE",0,0,2,42,0,44,"2012"
"12383","241200 SAO GONCALO DO AMARANTE",5,7,26,1648,4,1690,"2012"
"12384","241210 SAO JOAO DO SABUGI",0,0,6,64,2,72,"2012"
"12385","241220 SAO JOSE DE MIPIBU",4,3,15,657,1,680,"2012"
"12386","241230 SAO JOSE DO CAMPESTRE",0,0,2,172,2,176,"2012"
"12387","241240 SAO JOSE DO SERIDO",0,0,6,43,0,49,"2012"
"12388","241250 SAO MIGUEL",1,0,2,383,0,386,"2012"
"12389","241255 SAO MIGUEL DO GOSTOSO",0,1,1,85,0,87,"2012"
"12390","241260 SAO PAULO DO POTENGI",0,1,2,187,2,192,"2012"
"12391","241270 SAO PEDRO",0,1,3,77,0,81,"2012"
"12392","241280 SAO RAFAEL",0,1,3,84,0,88,"2012"
"12393","241290 SAO TOME",1,2,1,98,1,103,"2012"
"12394","241300 SAO VICENTE",0,0,7,59,0,66,"2012"
"12395","241310 SENADOR ELOI DE SOUZA",0,0,1,75,0,76,"2012"
"12396","241320 SENADOR GEORGINO AVELINO",1,1,2,75,2,81,"2012"
"12397","241330 SERRA DE SAO BENTO",0,1,2,72,0,75,"2012"
"12398","241335 SERRA DO MEL",0,0,5,189,0,194,"2012"
"12399","241340 SERRA NEGRA DO NORTE",0,1,5,82,0,88,"2012"
"12400","241350 SERRINHA",1,0,0,105,2,108,"2012"
"12401","241355 SERRINHA DOS PINTOS",0,0,0,38,0,38,"2012"
"12402","241360 SEVERIANO MELO",0,0,0,77,1,78,"2012"
"12403","241370 SITIO NOVO",0,1,0,70,0,71,"2012"
"12404","241380 TABOLEIRO GRANDE",0,0,0,47,0,47,"2012"
"12405","241390 TAIPU",1,0,7,141,0,149,"2012"
"12406","241400 TANGARA",0,0,7,217,4,228,"2012"
"12407","241410 TENENTE ANANIAS",1,1,0,155,0,157,"2012"
"12408","241415 TENENTE LAURENTINO CRUZ",0,1,5,108,0,114,"2012"
"12409","241420 TIBAU DO SUL",2,3,6,174,2,187,"2012"
"12410","241430 TIMBAUBA DOS BATISTAS",0,2,1,18,0,21,"2012"
"12411","241440 TOUROS",2,0,8,392,3,405,"2012"
"12412","241445 TRIUNFO POTIGUAR",0,1,2,44,0,47,"2012"
"12413","241450 UMARIZAL",0,0,3,120,0,123,"2012"
"12414","241460 UPANEMA",2,0,5,189,0,196,"2012"
"12415","241470 VARZEA",0,0,1,62,1,64,"2012"
"12416","241475 VENHA-VER",0,0,1,52,0,53,"2012"
"12417","241480 VERA CRUZ",0,2,6,144,1,153,"2012"
"12418","241490 VICOSA",0,0,0,21,1,22,"2012"
"12419","241500 VILA FLOR",0,1,3,35,0,39,"2012"
"12420","MUNICIPIO IGNORADO - PB",0,0,1,5,0,6,"2012"
"12421","250010 AGUA BRANCA",0,2,2,102,0,106,"2012"
"12422","250020 AGUIAR",0,0,1,38,12,51,"2012"
"12423","250030 ALAGOA GRANDE",6,1,3,392,8,410,"2012"
"12424","250040 ALAGOA NOVA",0,4,3,273,1,281,"2012"
"12425","250050 ALAGOINHA",0,1,3,219,0,223,"2012"
"12426","250053 ALCANTIL",0,0,1,84,0,85,"2012"
"12427","250057 ALGODAO DE JANDAIRA",0,1,1,37,0,39,"2012"
"12428","250060 ALHANDRA",1,2,5,392,4,404,"2012"
"12429","250070 SAO JOAO DO RIO DO PEIXE",0,0,2,177,2,181,"2012"
"12430","250073 AMPARO",0,0,0,44,0,44,"2012"
"12431","250077 APARECIDA",0,0,0,100,0,100,"2012"
"12432","250080 ARACAGI",0,0,2,228,1,231,"2012"
"12433","250090 ARARA",0,2,5,151,0,158,"2012"
"12434","250100 ARARUNA",0,3,12,225,2,242,"2012"
"12435","250110 AREIA",1,3,13,337,1,355,"2012"
"12436","250115 AREIA DE BARAUNAS",0,0,0,23,2,25,"2012"
"12437","250120 AREIAL",2,1,2,107,0,112,"2012"
"12438","250130 AROEIRAS",1,1,13,255,6,276,"2012"
"12439","250135 ASSUNCAO",1,1,2,62,0,66,"2012"
"12440","250140 BAIA DA TRAICAO",0,1,4,165,1,171,"2012"
"12441","250150 BANANEIRAS",2,2,9,271,1,285,"2012"
"12442","250153 BARAUNA",0,0,0,71,1,72,"2012"
"12443","250157 BARRA DE SANTANA",0,0,0,108,1,109,"2012"
"12444","250160 BARRA DE SANTA ROSA",1,0,2,171,1,175,"2012"
"12445","250170 BARRA DE SAO MIGUEL",0,1,0,74,1,76,"2012"
"12446","250180 BAYEUX",3,9,18,1278,1,1309,"2012"
"12447","250190 BELEM",1,0,4,220,0,225,"2012"
"12448","250200 BELEM DO BREJO DO CRUZ",0,0,1,82,0,83,"2012"
"12449","250205 BERNARDINO BATISTA",0,0,3,49,1,53,"2012"
"12450","250210 BOA VENTURA",0,0,1,56,2,59,"2012"
"12451","250215 BOA VISTA",0,1,2,107,2,112,"2012"
"12452","250220 BOM JESUS",0,0,1,31,1,33,"2012"
"12453","250230 BOM SUCESSO",0,1,1,49,0,51,"2012"
"12454","250240 BONITO DE SANTA FE",1,0,5,158,1,165,"2012"
"12455","250250 BOQUEIRAO",0,1,4,255,7,267,"2012"
"12456","250260 IGARACY",0,0,1,50,7,58,"2012"
"12457","250270 BORBOREMA",0,0,2,75,0,77,"2012"
"12458","250280 BREJO DO CRUZ",0,0,0,139,24,163,"2012"
"12459","250290 BREJO DOS SANTOS",0,0,2,97,0,99,"2012"
"12460","250300 CAAPORA",2,1,4,375,5,387,"2012"
"12461","250310 CABACEIRAS",1,1,1,56,2,61,"2012"
"12462","250320 CABEDELO",0,5,8,889,4,906,"2012"
"12463","250330 CACHOEIRA DOS INDIOS",0,0,2,115,2,119,"2012"
"12464","250340 CACIMBA DE AREIA",0,0,0,31,0,31,"2012"
"12465","250350 CACIMBA DE DENTRO",1,0,2,228,0,231,"2012"
"12466","250355 CACIMBAS",0,0,4,114,16,134,"2012"
"12467","250360 CAICARA",0,1,3,99,0,103,"2012"
"12468","250370 CAJAZEIRAS",1,8,26,874,3,912,"2012"
"12469","250375 CAJAZEIRINHAS",0,0,1,32,21,54,"2012"
"12470","250380 CALDAS BRANDAO",0,0,1,65,3,69,"2012"
"12471","250390 CAMALAU",0,0,1,63,0,64,"2012"
"12472","250400 CAMPINA GRANDE",7,24,86,6034,48,6199,"2012"
"12473","250403 CAPIM",0,0,3,96,0,99,"2012"
"12474","250407 CARAUBAS",1,0,4,54,0,59,"2012"
"12475","250410 CARRAPATEIRA",0,0,0,27,0,27,"2012"
"12476","250415 CASSERENGUE",0,2,0,84,0,86,"2012"
"12477","250420 CATINGUEIRA",1,0,0,71,2,74,"2012"
"12478","250430 CATOLE DO ROCHA",1,2,5,391,2,401,"2012"
"12479","250435 CATURITE",0,1,0,80,2,83,"2012"
"12480","250440 CONCEICAO",1,3,2,203,11,220,"2012"
"12481","250450 CONDADO",0,0,2,94,9,105,"2012"
"12482","250460 CONDE",0,2,8,443,5,458,"2012"
"12483","250470 CONGO",0,0,2,101,1,104,"2012"
"12484","250480 COREMAS",0,3,6,176,37,222,"2012"
"12485","250485 COXIXOLA",0,0,0,22,0,22,"2012"
"12486","250490 CRUZ DO ESPIRITO SANTO",2,3,5,252,0,262,"2012"
"12487","250500 CUBATI",0,2,4,84,0,90,"2012"
"12488","250510 CUITE",1,0,3,244,2,250,"2012"
"12489","250520 CUITEGI",0,0,3,98,0,101,"2012"
"12490","250523 CUITE DE MAMANGUAPE",0,1,1,76,1,79,"2012"
"12491","250527 CURRAL DE CIMA",0,0,0,89,0,89,"2012"
"12492","250530 CURRAL VELHO",1,0,0,22,0,23,"2012"
"12493","250535 DAMIAO",0,1,1,62,1,65,"2012"
"12494","250540 DESTERRO",0,0,4,112,4,120,"2012"
"12495","250550 VISTA SERRANA",0,1,0,47,3,51,"2012"
"12496","250560 DIAMANTE",0,0,1,64,7,72,"2012"
"12497","250570 DONA INES",1,1,2,145,2,151,"2012"
"12498","250580 DUAS ESTRADAS",0,0,3,60,0,63,"2012"
"12499","250590 EMAS",0,0,0,33,0,33,"2012"
"12500","250600 ESPERANCA",1,3,5,509,3,521,"2012"
"12501","250610 FAGUNDES",1,0,4,178,3,186,"2012"
"12502","250620 FREI MARTINHO",0,0,1,29,0,30,"2012"
"12503","250625 GADO BRAVO",0,2,3,94,1,100,"2012"
"12504","250630 GUARABIRA",1,4,16,838,3,862,"2012"
"12505","250640 GURINHEM",0,1,2,163,7,173,"2012"
"12506","250650 GURJAO",0,0,0,46,0,46,"2012"
"12507","250660 IBIARA",0,0,0,88,1,89,"2012"
"12508","250670 IMACULADA",0,3,2,157,6,168,"2012"
"12509","250680 INGA",0,1,3,212,3,219,"2012"
"12510","250690 ITABAIANA",1,3,5,309,20,338,"2012"
"12511","250700 ITAPORANGA",0,1,3,271,21,296,"2012"
"12512","250710 ITAPOROROCA",1,2,2,250,4,259,"2012"
"12513","250720 ITATUBA",1,0,0,166,3,170,"2012"
"12514","250730 JACARAU",0,1,3,205,2,211,"2012"
"12515","250740 JERICO",0,1,0,89,14,104,"2012"
"12516","250750 JOAO PESSOA",30,42,127,11072,31,11302,"2012"
"12517","250760 JUAREZ TAVORA",0,1,1,121,1,124,"2012"
"12518","250770 JUAZEIRINHO",2,2,4,285,3,296,"2012"
"12519","250780 JUNCO DO SERIDO",0,0,2,98,2,102,"2012"
"12520","250790 JURIPIRANGA",0,1,7,160,7,175,"2012"
"12521","250800 JURU",0,0,6,108,1,115,"2012"
"12522","250810 LAGOA",0,0,2,48,12,62,"2012"
"12523","250820 LAGOA DE DENTRO",1,0,4,130,2,137,"2012"
"12524","250830 LAGOA SECA",1,4,4,418,7,434,"2012"
"12525","250840 LASTRO",0,0,0,43,0,43,"2012"
"12526","250850 LIVRAMENTO",0,1,1,79,3,84,"2012"
"12527","250855 LOGRADOURO",0,0,0,53,0,53,"2012"
"12528","250860 LUCENA",0,0,4,179,1,184,"2012"
"12529","250870 MAE D'AGUA",0,1,0,45,4,50,"2012"
"12530","250880 MALTA",0,2,1,70,4,77,"2012"
"12531","250890 MAMANGUAPE",0,2,16,711,3,732,"2012"
"12532","250900 MANAIRA",1,4,7,149,5,166,"2012"
"12533","250905 MARCACAO",1,0,2,147,2,152,"2012"
"12534","250910 MARI",0,2,4,273,0,279,"2012"
"12535","250915 MARIZOPOLIS",0,1,1,85,1,88,"2012"
"12536","250920 MASSARANDUBA",1,2,1,174,7,185,"2012"
"12537","250930 MATARACA",0,0,4,133,3,140,"2012"
"12538","250933 MATINHAS",0,0,2,64,1,67,"2012"
"12539","250937 MATO GROSSO",0,1,0,41,0,42,"2012"
"12540","250939 MATUREIA",0,1,2,62,2,67,"2012"
"12541","250940 MOGEIRO",1,1,3,186,10,201,"2012"
"12542","250950 MONTADAS",1,0,2,103,1,107,"2012"
"12543","250960 MONTE HOREBE",0,0,1,61,0,62,"2012"
"12544","250970 MONTEIRO",2,2,4,445,0,453,"2012"
"12545","250980 MULUNGU",0,0,2,134,1,137,"2012"
"12546","250990 NATUBA",0,3,0,95,2,100,"2012"
"12547","251000 NAZAREZINHO",0,2,2,104,1,109,"2012"
"12548","251010 NOVA FLORESTA",2,0,2,154,1,159,"2012"
"12549","251020 NOVA OLINDA",0,1,3,74,12,90,"2012"
"12550","251030 NOVA PALMEIRA",0,0,0,42,0,42,"2012"
"12551","251040 OLHO D'AGUA",0,0,6,103,5,114,"2012"
"12552","251050 OLIVEDOS",0,0,1,60,1,62,"2012"
"12553","251060 OURO VELHO",0,0,3,38,0,41,"2012"
"12554","251065 PARARI",0,0,0,26,0,26,"2012"
"12555","251070 PASSAGEM",0,0,2,19,0,21,"2012"
"12556","251080 PATOS",1,11,33,1460,30,1535,"2012"
"12557","251090 PAULISTA",0,0,3,91,45,139,"2012"
"12558","251100 PEDRA BRANCA",0,1,0,41,4,46,"2012"
"12559","251110 PEDRA LAVRADA",0,0,1,94,0,95,"2012"
"12560","251120 PEDRAS DE FOGO",1,2,10,438,5,456,"2012"
"12561","251130 PIANCO",0,0,4,150,28,182,"2012"
"12562","251140 PICUI",0,1,3,265,0,269,"2012"
"12563","251150 PILAR",1,2,8,191,1,203,"2012"
"12564","251160 PILOES",0,0,4,130,4,138,"2012"
"12565","251170 PILOEZINHOS",0,0,2,78,0,80,"2012"
"12566","251180 PIRPIRITUBA",0,0,4,157,1,162,"2012"
"12567","251190 PITIMBU",0,3,3,222,4,232,"2012"
"12568","251200 POCINHOS",2,1,5,239,0,247,"2012"
"12569","251203 POCO DANTAS",0,0,4,43,2,49,"2012"
"12570","251207 POCO DE JOSE DE MOURA",0,0,1,43,0,44,"2012"
"12571","251210 POMBAL",0,3,4,257,169,433,"2012"
"12572","251220 PRATA",0,0,0,46,0,46,"2012"
"12573","251230 PRINCESA ISABEL",1,4,14,317,1,337,"2012"
"12574","251240 PUXINANA",0,1,2,205,3,211,"2012"
"12575","251250 QUEIMADAS",0,5,17,640,10,672,"2012"
"12576","251260 QUIXABA",0,0,0,23,1,24,"2012"
"12577","251270 REMIGIO",1,4,6,271,3,285,"2012"
"12578","251272 PEDRO REGIS",0,0,1,68,0,69,"2012"
"12579","251274 RIACHAO",0,0,4,41,0,45,"2012"
"12580","251275 RIACHAO DO BACAMARTE",0,0,0,61,2,63,"2012"
"12581","251276 RIACHAO DO POCO",0,0,0,56,0,56,"2012"
"12582","251278 RIACHO DE SANTO ANTONIO",0,0,0,31,1,32,"2012"
"12583","251280 RIACHO DOS CAVALOS",1,1,4,108,1,115,"2012"
"12584","251290 RIO TINTO",4,1,4,305,2,316,"2012"
"12585","251300 SALGADINHO",0,1,0,45,1,47,"2012"
"12586","251310 SALGADO DE SAO FELIX",0,0,2,128,4,134,"2012"
"12587","251315 SANTA CECILIA",0,1,4,101,0,106,"2012"
"12588","251320 SANTA CRUZ",0,1,1,71,1,74,"2012"
"12589","251330 SANTA HELENA",0,0,1,64,0,65,"2012"
"12590","251335 SANTA INES",0,1,0,42,0,43,"2012"
"12591","251340 SANTA LUZIA",1,1,4,161,1,168,"2012"
"12592","251350 SANTANA DE MANGUEIRA",0,2,0,66,3,71,"2012"
"12593","251360 SANTANA DOS GARROTES",2,1,0,97,3,103,"2012"
"12594","251365 JOCA CLAUDINO",0,0,3,22,0,25,"2012"
"12595","251370 SANTA RITA",4,11,42,2198,2,2257,"2012"
"12596","251380 SANTA TERESINHA",0,0,2,52,0,54,"2012"
"12597","251385 SANTO ANDRE",0,0,0,38,0,38,"2012"
"12598","251390 SAO BENTO",1,3,3,451,2,460,"2012"
"12599","251392 SAO BENTINHO",0,0,0,47,18,65,"2012"
"12600","251394 SAO DOMINGOS DO CARIRI",0,0,1,34,0,35,"2012"
"12601","251396 SAO DOMINGOS",0,0,0,27,9,36,"2012"
"12602","251398 SAO FRANCISCO",0,0,1,45,1,47,"2012"
"12603","251400 SAO JOAO DO CARIRI",0,0,1,53,0,54,"2012"
"12604","251410 SAO JOAO DO TIGRE",0,1,1,64,3,69,"2012"
"12605","251420 SAO JOSE DA LAGOA TAPADA",0,0,1,116,0,117,"2012"
"12606","251430 SAO JOSE DE CAIANA",1,0,0,80,13,94,"2012"
"12607","251440 SAO JOSE DE ESPINHARAS",0,1,1,45,1,48,"2012"
"12608","251445 SAO JOSE DOS RAMOS",0,0,0,73,2,75,"2012"
"12609","251450 SAO JOSE DE PIRANHAS",0,0,6,231,11,248,"2012"
"12610","251455 SAO JOSE DE PRINCESA",1,1,1,28,1,32,"2012"
"12611","251460 SAO JOSE DO BONFIM",0,0,0,43,0,43,"2012"
"12612","251465 SAO JOSE DO BREJO DO CRUZ",0,0,1,20,0,21,"2012"
"12613","251470 SAO JOSE DO SABUGI",1,1,0,51,2,55,"2012"
"12614","251480 SAO JOSE DOS CORDEIROS",0,0,1,44,0,45,"2012"
"12615","251490 SAO MAMEDE",0,1,2,93,1,97,"2012"
"12616","251500 SAO MIGUEL DE TAIPU",0,1,5,120,0,126,"2012"
"12617","251510 SAO SEBASTIAO DE LAGOA DE ROCA",0,0,2,138,3,143,"2012"
"12618","251520 SAO SEBASTIAO DO UMBUZEIRO",0,0,1,36,0,37,"2012"
"12619","251530 SAPE",0,2,10,706,0,718,"2012"
"12620","251540 SAO VICENTE DO SERIDO",0,2,3,152,4,161,"2012"
"12621","251550 SERRA BRANCA",0,0,5,133,1,139,"2012"
"12622","251560 SERRA DA RAIZ",0,0,0,39,0,39,"2012"
"12623","251570 SERRA GRANDE",0,0,1,38,1,40,"2012"
"12624","251580 SERRA REDONDA",0,0,1,98,1,100,"2012"
"12625","251590 SERRARIA",0,1,6,74,0,81,"2012"
"12626","251593 SERTAOZINHO",0,0,3,74,1,78,"2012"
"12627","251597 SOBRADO",1,1,2,107,0,111,"2012"
"12628","251600 SOLANEA",2,1,16,361,0,380,"2012"
"12629","251610 SOLEDADE",1,0,2,203,3,209,"2012"
"12630","251615 SOSSEGO",0,0,0,65,0,65,"2012"
"12631","251620 SOUSA",2,3,18,976,7,1006,"2012"
"12632","251630 SUME",1,2,3,238,0,244,"2012"
"12633","251640 TACIMA",0,0,1,78,0,79,"2012"
"12634","251650 TAPEROA",1,0,5,213,4,223,"2012"
"12635","251660 TAVARES",2,0,5,159,2,168,"2012"
"12636","251670 TEIXEIRA",1,4,12,224,3,244,"2012"
"12637","251675 TENORIO",0,0,0,57,2,59,"2012"
"12638","251680 TRIUNFO",0,1,2,113,0,116,"2012"
"12639","251690 UIRAUNA",0,0,3,178,1,182,"2012"
"12640","251700 UMBUZEIRO",0,0,1,118,1,120,"2012"
"12641","251710 VARZEA",0,0,0,36,0,36,"2012"
"12642","251720 VIEIROPOLIS",1,0,0,43,2,46,"2012"
"12643","251740 ZABELE",0,0,0,45,0,45,"2012"
"12644","MUNICIPIO IGNORADO - PE",0,0,0,1,0,1,"2012"
"12645","260005 ABREU E LIMA",7,7,17,1352,10,1393,"2012"
"12646","260010 AFOGADOS DA INGAZEIRA",1,2,3,655,8,669,"2012"
"12647","260020 AFRANIO",4,1,7,146,137,295,"2012"
"12648","260030 AGRESTINA",1,2,7,325,2,337,"2012"
"12649","260040 AGUA PRETA",5,1,6,597,2,611,"2012"
"12650","260050 AGUAS BELAS",4,6,19,786,16,831,"2012"
"12651","260060 ALAGOINHA",2,2,2,171,0,177,"2012"
"12652","260070 ALIANCA",2,3,14,531,5,555,"2012"
"12653","260080 ALTINHO",0,0,3,224,3,230,"2012"
"12654","260090 AMARAJI",0,2,3,347,4,356,"2012"
"12655","260100 ANGELIM",0,1,0,159,0,160,"2012"
"12656","260105 ARACOIABA",1,2,2,316,8,329,"2012"
"12657","260110 ARARIPINA",10,15,26,1639,5,1695,"2012"
"12658","260120 ARCOVERDE",3,6,24,1013,5,1051,"2012"
"12659","260130 BARRA DE GUABIRABA",0,2,3,176,0,181,"2012"
"12660","260140 BARREIROS",4,8,13,735,5,765,"2012"
"12661","260150 BELEM DE MARIA",0,0,0,150,0,150,"2012"
"12662","260160 BELEM DE SAO FRANCISCO",11,2,5,364,1,383,"2012"
"12663","260170 BELO JARDIM",4,9,35,1181,5,1234,"2012"
"12664","260180 BETANIA",1,3,11,199,19,233,"2012"
"12665","260190 BEZERROS",7,1,8,708,9,733,"2012"
"12666","260200 BODOCO",1,4,13,561,7,586,"2012"
"12667","260210 BOM CONSELHO",1,1,11,633,2,648,"2012"
"12668","260220 BOM JARDIM",0,0,4,482,1,487,"2012"
"12669","260230 BONITO",2,2,2,571,3,580,"2012"
"12670","260240 BREJAO",0,0,2,188,0,190,"2012"
"12671","260250 BREJINHO",0,0,1,116,3,120,"2012"
"12672","260260 BREJO DA MADRE DE DEUS",2,4,20,757,6,789,"2012"
"12673","260270 BUENOS AIRES",3,1,4,171,3,182,"2012"
"12674","260280 BUIQUE",3,3,21,932,5,964,"2012"
"12675","260290 CABO DE SANTO AGOSTINHO",10,18,93,3509,21,3651,"2012"
"12676","260300 CABROBO",2,3,13,530,2,550,"2012"
"12677","260310 CACHOEIRINHA",0,0,7,234,1,242,"2012"
"12678","260320 CAETES",2,5,8,445,0,460,"2012"
"12679","260330 CALCADO",0,0,3,150,0,153,"2012"
"12680","260340 CALUMBI",1,1,3,81,36,122,"2012"
"12681","260345 CAMARAGIBE",7,13,35,2269,11,2335,"2012"
"12682","260350 CAMOCIM DE SAO FELIX",0,1,2,207,0,210,"2012"
"12683","260360 CAMUTANGA",0,1,2,119,0,122,"2012"
"12684","260370 CANHOTINHO",0,2,9,342,6,359,"2012"
"12685","260380 CAPOEIRAS",1,1,3,295,0,300,"2012"
"12686","260390 CARNAIBA",0,1,6,261,6,274,"2012"
"12687","260392 CARNAUBEIRA DA PENHA",3,2,11,280,5,301,"2012"
"12688","260400 CARPINA",5,4,15,1067,7,1098,"2012"
"12689","260410 CARUARU",16,14,46,5455,44,5575,"2012"
"12690","260415 CASINHAS",0,1,6,171,0,178,"2012"
"12691","260420 CATENDE",0,5,8,559,4,576,"2012"
"12692","260430 CEDRO",0,0,7,178,1,186,"2012"
"12693","260440 CHA DE ALEGRIA",3,2,5,196,1,207,"2012"
"12694","260450 CHA GRANDE",1,3,2,310,0,316,"2012"
"12695","260460 CONDADO",4,3,10,400,5,422,"2012"
"12696","260470 CORRENTES",3,2,1,223,1,230,"2012"
"12697","260480 CORTES",1,0,4,227,0,232,"2012"
"12698","260490 CUMARU",1,0,1,225,2,229,"2012"
"12699","260500 CUPIRA",1,4,13,391,6,415,"2012"
"12700","260510 CUSTODIA",1,2,11,572,8,594,"2012"
"12701","260515 DORMENTES",3,1,2,155,100,261,"2012"
"12702","260520 ESCADA",4,10,13,1173,4,1204,"2012"
"12703","260530 EXU",2,2,0,545,1,550,"2012"
"12704","260540 FEIRA NOVA",1,2,6,281,5,295,"2012"
"12705","260545 FERNANDO DE NORONHA",0,0,1,19,0,20,"2012"
"12706","260550 FERREIROS",0,2,5,182,2,191,"2012"
"12707","260560 FLORES",3,2,7,263,33,308,"2012"
"12708","260570 FLORESTA",7,4,30,461,4,506,"2012"
"12709","260580 FREI MIGUELINHO",1,2,3,170,1,177,"2012"
"12710","260590 GAMELEIRA",1,1,5,374,3,384,"2012"
"12711","260600 GARANHUNS",6,10,29,2293,6,2344,"2012"
"12712","260610 GLORIA DO GOITA",2,1,6,420,3,432,"2012"
"12713","260620 GOIANA",2,7,23,1196,10,1238,"2012"
"12714","260630 GRANITO",0,0,0,76,38,114,"2012"
"12715","260640 GRAVATA",3,3,16,1146,12,1180,"2012"
"12716","260650 IATI",1,1,1,290,3,296,"2012"
"12717","260660 IBIMIRIM",7,4,11,492,5,519,"2012"
"12718","260670 IBIRAJUBA",1,0,1,89,0,91,"2012"
"12719","260680 IGARASSU",2,11,27,1462,12,1514,"2012"
"12720","260690 IGUARACY",0,1,1,151,2,155,"2012"
"12721","260700 INAJA",5,2,5,304,26,342,"2012"
"12722","260710 INGAZEIRA",0,0,3,66,0,69,"2012"
"12723","260720 IPOJUCA",5,9,41,1567,10,1632,"2012"
"12724","260730 IPUBI",0,5,5,636,1,647,"2012"
"12725","260740 ITACURUBA",0,0,3,68,1,72,"2012"
"12726","260750 ITAIBA",3,1,8,375,22,409,"2012"
"12727","260760 ILHA DE ITAMARACA",0,2,3,303,6,314,"2012"
"12728","260765 ITAMBE",1,2,9,526,0,538,"2012"
"12729","260770 ITAPETIM",1,0,2,217,0,220,"2012"
"12730","260775 ITAPISSUMA",1,0,4,347,5,357,"2012"
"12731","260780 ITAQUITINGA",1,2,5,256,5,269,"2012"
"12732","260790 JABOATAO DOS GUARARAPES",59,50,147,9081,43,9380,"2012"
"12733","260795 JAQUEIRA",1,1,3,177,2,184,"2012"
"12734","260800 JATAUBA",1,3,11,275,2,292,"2012"
"12735","260805 JATOBA",0,1,13,237,8,259,"2012"
"12736","260810 JOAO ALFREDO",2,2,5,363,2,374,"2012"
"12737","260820 JOAQUIM NABUCO",1,1,7,273,0,282,"2012"
"12738","260825 JUCATI",0,2,0,161,1,164,"2012"
"12739","260830 JUPI",0,0,2,266,0,268,"2012"
"12740","260840 JUREMA",0,3,9,221,0,233,"2012"
"12741","260845 LAGOA DO CARRO",1,3,3,236,1,244,"2012"
"12742","260850 LAGOA DE ITAENGA",3,0,6,377,2,388,"2012"
"12743","260860 LAGOA DO OURO",1,1,0,182,2,186,"2012"
"12744","260870 LAGOA DOS GATOS",0,1,2,177,1,181,"2012"
"12745","260875 LAGOA GRANDE",4,2,10,394,0,410,"2012"
"12746","260880 LAJEDO",1,2,13,616,7,639,"2012"
"12747","260890 LIMOEIRO",5,3,13,821,5,847,"2012"
"12748","260900 MACAPARANA",0,1,5,367,1,374,"2012"
"12749","260910 MACHADOS",0,2,3,179,1,185,"2012"
"12750","260915 MANARI",1,5,5,289,21,321,"2012"
"12751","260920 MARAIAL",1,2,4,248,3,258,"2012"
"12752","260930 MIRANDIBA",3,1,10,281,0,295,"2012"
"12753","260940 MORENO",6,4,11,802,6,829,"2012"
"12754","260950 NAZARE DA MATA",0,2,10,436,6,454,"2012"
"12755","260960 OLINDA",26,20,94,5850,15,6005,"2012"
"12756","260970 OROBO",2,0,2,278,2,284,"2012"
"12757","260980 OROCO",0,1,5,245,4,255,"2012"
"12758","260990 OURICURI",5,8,10,1102,9,1134,"2012"
"12759","261000 PALMARES",5,6,21,1135,5,1172,"2012"
"12760","261010 PALMEIRINA",0,4,3,138,0,145,"2012"
"12761","261020 PANELAS",2,1,7,375,1,386,"2012"
"12762","261030 PARANATAMA",0,2,1,222,4,229,"2012"
"12763","261040 PARNAMIRIM",2,1,8,372,1,384,"2012"
"12764","261050 PASSIRA",3,0,2,442,5,452,"2012"
"12765","261060 PAUDALHO",4,6,16,844,7,877,"2012"
"12766","261070 PAULISTA",11,22,57,3913,18,4021,"2012"
"12767","261080 PEDRA",2,3,8,324,1,338,"2012"
"12768","261090 PESQUEIRA",4,5,14,1006,4,1033,"2012"
"12769","261100 PETROLANDIA",3,4,17,677,4,705,"2012"
"12770","261110 PETROLINA",69,39,115,5459,76,5758,"2012"
"12771","261120 POCAO",0,1,0,182,0,183,"2012"
"12772","261130 POMBOS",0,1,4,369,1,375,"2012"
"12773","261140 PRIMAVERA",0,0,0,195,0,195,"2012"
"12774","261150 QUIPAPA",1,0,4,290,1,296,"2012"
"12775","261153 QUIXABA",1,0,0,96,2,99,"2012"
"12776","261160 RECIFE",81,88,332,22036,96,22633,"2012"
"12777","261170 RIACHO DAS ALMAS",1,0,2,259,0,262,"2012"
"12778","261180 RIBEIRAO",2,3,12,612,1,630,"2012"
"12779","261190 RIO FORMOSO",2,2,8,366,0,378,"2012"
"12780","261200 SAIRE",0,0,0,117,1,118,"2012"
"12781","261210 SALGADINHO",0,0,2,95,0,97,"2012"
"12782","261220 SALGUEIRO",3,8,21,1077,1,1110,"2012"
"12783","261230 SALOA",0,1,9,240,1,251,"2012"
"12784","261240 SANHARO",2,2,8,282,0,294,"2012"
"12785","261245 SANTA CRUZ",5,2,4,252,7,270,"2012"
"12786","261247 SANTA CRUZ DA BAIXA VERDE",0,1,11,135,45,192,"2012"
"12787","261250 SANTA CRUZ DO CAPIBARIBE",8,8,13,1317,4,1350,"2012"
"12788","261255 SANTA FILOMENA",0,3,1,140,73,217,"2012"
"12789","261260 SANTA MARIA DA BOA VISTA",5,11,19,692,10,737,"2012"
"12790","261270 SANTA MARIA DO CAMBUCA",0,2,0,184,0,186,"2012"
"12791","261280 SANTA TEREZINHA",0,3,1,152,3,159,"2012"
"12792","261290 SAO BENEDITO DO SUL",1,3,2,155,1,162,"2012"
"12793","261300 SAO BENTO DO UNA",2,1,12,778,5,798,"2012"
"12794","261310 SAO CAITANO",8,3,8,531,4,554,"2012"
"12795","261320 SAO JOAO",1,2,2,337,0,342,"2012"
"12796","261330 SAO JOAQUIM DO MONTE",2,4,7,322,0,335,"2012"
"12797","261340 SAO JOSE DA COROA GRANDE",0,3,3,331,3,340,"2012"
"12798","261350 SAO JOSE DO BELMONTE",2,2,12,510,8,534,"2012"
"12799","261360 SAO JOSE DO EGITO",1,1,9,426,6,443,"2012"
"12800","261370 SAO LOURENCO DA MATA",10,10,26,1521,12,1579,"2012"
"12801","261380 SAO VICENTE FERRER",1,2,3,235,2,243,"2012"
"12802","261390 SERRA TALHADA",7,4,66,1062,311,1450,"2012"
"12803","261400 SERRITA",0,1,2,314,2,319,"2012"
"12804","261410 SERTANIA",4,0,9,452,1,466,"2012"
"12805","261420 SIRINHAEM",6,4,11,666,3,690,"2012"
"12806","261430 MOREILANDIA",1,0,2,142,0,145,"2012"
"12807","261440 SOLIDAO",0,0,0,110,1,111,"2012"
"12808","261450 SURUBIM",2,6,15,901,2,926,"2012"
"12809","261460 TABIRA",2,4,4,458,1,469,"2012"
"12810","261470 TACAIMBO",0,1,1,178,2,182,"2012"
"12811","261480 TACARATU",1,2,6,324,1,334,"2012"
"12812","261485 TAMANDARE",0,3,7,411,5,426,"2012"
"12813","261500 TAQUARITINGA DO NORTE",0,2,11,369,4,386,"2012"
"12814","261510 TEREZINHA",1,0,0,120,0,121,"2012"
"12815","261520 TERRA NOVA",0,0,5,123,0,128,"2012"
"12816","261530 TIMBAUBA",1,3,20,799,3,826,"2012"
"12817","261540 TORITAMA",0,0,9,576,2,587,"2012"
"12818","261550 TRACUNHAEM",1,0,2,208,5,216,"2012"
"12819","261560 TRINDADE",2,1,5,581,1,590,"2012"
"12820","261570 TRIUNFO",0,2,9,188,25,224,"2012"
"12821","261580 TUPANATINGA",2,1,9,337,4,353,"2012"
"12822","261590 TUPARETAMA",0,0,2,140,0,142,"2012"
"12823","261600 VENTUROSA",0,0,5,243,0,248,"2012"
"12824","261610 VERDEJANTE",1,1,7,167,0,176,"2012"
"12825","261618 VERTENTE DO LERIO",0,1,4,132,1,138,"2012"
"12826","261620 VERTENTES",1,5,4,385,1,396,"2012"
"12827","261630 VICENCIA",3,4,6,390,1,404,"2012"
"12828","261640 VITORIA DE SANTO ANTAO",4,4,34,2069,13,2124,"2012"
"12829","261650 XEXEU",1,0,2,314,1,318,"2012"
"12830","270010 AGUA BRANCA",1,2,12,136,183,334,"2012"
"12831","270020 ANADIA",1,0,4,268,5,278,"2012"
"12832","270030 ARAPIRACA",6,13,60,3707,24,3810,"2012"
"12833","270040 ATALAIA",0,4,4,593,167,768,"2012"
"12834","270050 BARRA DE SANTO ANTONIO",1,1,5,277,8,292,"2012"
"12835","270060 BARRA DE SAO MIGUEL",0,1,2,121,0,124,"2012"
"12836","270070 BATALHA",0,1,3,293,1,298,"2012"
"12837","270080 BELEM",0,0,1,84,1,86,"2012"
"12838","270090 BELO MONTE",0,0,0,97,3,100,"2012"
"12839","270100 BOCA DA MATA",2,1,4,407,7,421,"2012"
"12840","270110 BRANQUINHA",3,0,1,224,1,229,"2012"
"12841","270120 CACIMBINHAS",0,1,4,168,2,175,"2012"
"12842","270130 CAJUEIRO",0,0,4,230,162,396,"2012"
"12843","270135 CAMPESTRE",0,0,0,67,3,70,"2012"
"12844","270140 CAMPO ALEGRE",0,4,8,467,20,499,"2012"
"12845","270150 CAMPO GRANDE",0,0,1,160,3,164,"2012"
"12846","270160 CANAPI",2,0,4,249,43,298,"2012"
"12847","270170 CAPELA",1,2,6,286,13,308,"2012"
"12848","270180 CARNEIROS",0,2,4,169,3,178,"2012"
"12849","270190 CHA PRETA",0,1,2,88,29,120,"2012"
"12850","270200 COITE DO NOIA",0,1,1,160,0,162,"2012"
"12851","270210 COLONIA LEOPOLDINA",1,0,9,299,4,313,"2012"
"12852","270220 COQUEIRO SECO",0,0,0,100,0,100,"2012"
"12853","270230 CORURIPE",8,2,4,754,188,956,"2012"
"12854","270235 CRAIBAS",0,1,6,369,25,401,"2012"
"12855","270240 DELMIRO GOUVEIA",1,1,13,358,563,936,"2012"
"12856","270250 DOIS RIACHOS",0,0,1,147,3,151,"2012"
"12857","270255 ESTRELA DE ALAGOAS",1,2,4,217,2,226,"2012"
"12858","270260 FEIRA GRANDE",1,1,5,333,0,340,"2012"
"12859","270270 FELIZ DESERTO",0,0,0,82,18,100,"2012"
"12860","270280 FLEXEIRAS",1,1,3,198,9,212,"2012"
"12861","270290 GIRAU DO PONCIANO",0,0,5,544,4,553,"2012"
"12862","270300 IBATEGUARA",1,1,4,270,2,278,"2012"
"12863","270310 IGACI",1,1,3,326,4,335,"2012"
"12864","270320 IGREJA NOVA",0,2,3,375,14,394,"2012"
"12865","270330 INHAPI",0,0,4,206,97,307,"2012"
"12866","270340 JACARE DOS HOMENS",0,0,1,98,0,99,"2012"
"12867","270350 JACUIPE",1,1,0,69,2,73,"2012"
"12868","270360 JAPARATINGA",2,1,2,151,2,158,"2012"
"12869","270370 JARAMATAIA",0,0,0,113,0,113,"2012"
"12870","270375 JEQUIA DA PRAIA",1,1,3,151,15,171,"2012"
"12871","270380 JOAQUIM GOMES",3,1,9,404,19,436,"2012"
"12872","270390 JUNDIA",0,0,0,58,3,61,"2012"
"12873","270400 JUNQUEIRO",3,1,2,368,4,378,"2012"
"12874","270410 LAGOA DA CANOA",0,3,4,291,1,299,"2012"
"12875","270420 LIMOEIRO DE ANADIA",1,2,8,315,2,328,"2012"
"12876","270430 MACEIO",25,42,165,14536,105,14873,"2012"
"12877","270440 MAJOR ISIDORO",1,0,4,181,77,263,"2012"
"12878","270450 MARAGOGI",1,1,2,516,5,525,"2012"
"12879","270460 MARAVILHA",1,0,5,150,2,158,"2012"
"12880","270470 MARECHAL DEODORO",1,2,12,823,9,847,"2012"
"12881","270480 MARIBONDO",2,1,5,173,3,184,"2012"
"12882","270490 MAR VERMELHO",0,0,1,32,7,40,"2012"
"12883","270500 MATA GRANDE",0,1,3,286,118,408,"2012"
"12884","270510 MATRIZ DE CAMARAGIBE",1,1,8,478,5,493,"2012"
"12885","270520 MESSIAS",1,0,6,307,3,317,"2012"
"12886","270530 MINADOR DO NEGRAO",0,0,0,79,5,84,"2012"
"12887","270540 MONTEIROPOLIS",0,0,0,115,4,119,"2012"
"12888","270550 MURICI",2,2,3,274,242,523,"2012"
"12889","270560 NOVO LINO",0,3,4,166,28,201,"2012"
"12890","270570 OLHO D'AGUA DAS FLORES",2,3,11,403,6,425,"2012"
"12891","270580 OLHO D'AGUA DO CASADO",0,0,2,86,40,128,"2012"
"12892","270590 OLHO D'AGUA GRANDE",1,0,1,78,0,80,"2012"
"12893","270600 OLIVENCA",2,0,3,177,2,184,"2012"
"12894","270610 OURO BRANCO",0,1,0,173,6,180,"2012"
"12895","270620 PALESTINA",0,1,3,98,3,105,"2012"
"12896","270630 PALMEIRA DOS INDIOS",2,5,13,1273,18,1311,"2012"
"12897","270640 PAO DE ACUCAR",0,1,11,384,40,436,"2012"
"12898","270642 PARICONHA",2,0,2,84,77,165,"2012"
"12899","270644 PARIPUEIRA",0,0,3,201,5,209,"2012"
"12900","270650 PASSO DE CAMARAGIBE",0,2,4,250,8,264,"2012"
"12901","270660 PAULO JACINTO",0,1,0,68,29,98,"2012"
"12902","270670 PENEDO",4,4,16,1030,54,1108,"2012"
"12903","270680 PIACABUCU",2,0,6,272,17,297,"2012"
"12904","270690 PILAR",1,1,4,431,164,601,"2012"
"12905","270700 PINDOBA",0,1,0,36,11,48,"2012"
"12906","270710 PIRANHAS",2,3,5,439,18,467,"2012"
"12907","270720 POCO DAS TRINCHEIRAS",0,2,2,207,8,219,"2012"
"12908","270730 PORTO CALVO",0,2,4,452,8,466,"2012"
"12909","270740 PORTO DE PEDRAS",0,0,3,116,1,120,"2012"
"12910","270750 PORTO REAL DO COLEGIO",1,4,6,316,9,336,"2012"
"12911","270760 QUEBRANGULO",0,0,2,158,30,190,"2012"
"12912","270770 RIO LARGO",4,2,13,1100,31,1150,"2012"
"12913","270780 ROTEIRO",0,2,1,104,1,108,"2012"
"12914","270790 SANTA LUZIA DO NORTE",0,1,0,116,0,117,"2012"
"12915","270800 SANTANA DO IPANEMA",7,3,11,818,2,841,"2012"
"12916","270810 SANTANA DO MUNDAU",0,1,0,127,2,130,"2012"
"12917","270820 SAO BRAS",0,0,1,103,2,106,"2012"
"12918","270830 SAO JOSE DA LAJE",0,1,6,369,36,412,"2012"
"12919","270840 SAO JOSE DA TAPERA",0,4,9,558,20,591,"2012"
"12920","270850 SAO LUIS DO QUITUNDE",2,2,10,634,8,656,"2012"
"12921","270860 SAO MIGUEL DOS CAMPOS",3,6,12,968,4,993,"2012"
"12922","270870 SAO MIGUEL DOS MILAGRES",0,0,2,91,5,98,"2012"
"12923","270880 SAO SEBASTIAO",0,0,9,535,8,552,"2012"
"12924","270890 SATUBA",0,0,0,163,2,165,"2012"
"12925","270895 SENADOR RUI PALMEIRA",0,1,2,205,22,230,"2012"
"12926","270900 TANQUE D'ARCA",0,1,3,93,0,97,"2012"
"12927","270910 TAQUARANA",0,3,3,264,4,274,"2012"
"12928","270915 TEOTONIO VILELA",2,2,6,370,367,747,"2012"
"12929","270920 TRAIPU",2,1,7,339,2,351,"2012"
"12930","270930 UNIAO DOS PALMARES",0,1,10,1152,7,1170,"2012"
"12931","270940 VICOSA",1,3,2,264,152,422,"2012"
"12932","280010 AMPARO DE SAO FRANCISCO",1,0,2,35,0,38,"2012"
"12933","280020 AQUIDABA",0,2,12,229,41,284,"2012"
"12934","280030 ARACAJU",41,34,248,8980,72,9375,"2012"
"12935","280040 ARAUA",0,1,5,174,0,180,"2012"
"12936","280050 AREIA BRANCA",3,1,4,274,5,287,"2012"
"12937","280060 BARRA DOS COQUEIROS",1,1,11,441,3,457,"2012"
"12938","280067 BOQUIM",1,3,4,387,3,398,"2012"
"12939","280070 BREJO GRANDE",0,1,0,127,9,137,"2012"
"12940","280100 CAMPO DO BRITO",1,1,2,289,0,293,"2012"
"12941","280110 CANHOBA",1,0,2,59,9,71,"2012"
"12942","280120 CANINDE DE SAO FRANCISCO",4,5,14,401,162,586,"2012"
"12943","280130 CAPELA",7,4,28,558,22,619,"2012"
"12944","280140 CARIRA",0,1,2,276,31,310,"2012"
"12945","280150 CARMOPOLIS",3,0,12,280,5,300,"2012"
"12946","280160 CEDRO DE SAO JOAO",1,0,1,68,4,74,"2012"
"12947","280170 CRISTINAPOLIS",3,2,6,291,6,308,"2012"
"12948","280190 CUMBE",0,0,1,39,16,56,"2012"
"12949","280200 DIVINA PASTORA",0,1,2,78,0,81,"2012"
"12950","280210 ESTANCIA",3,1,10,1031,4,1049,"2012"
"12951","280220 FEIRA NOVA",0,1,2,34,41,78,"2012"
"12952","280230 FREI PAULO",0,1,3,234,4,242,"2012"
"12953","280240 GARARU",2,0,4,83,57,146,"2012"
"12954","280250 GENERAL MAYNARD",1,0,1,44,0,46,"2012"
"12955","280260 GRACHO CARDOSO",1,0,1,48,40,90,"2012"
"12956","280270 ILHA DAS FLORES",0,2,4,135,1,142,"2012"
"12957","280280 INDIAROBA",0,2,4,279,8,293,"2012"
"12958","280290 ITABAIANA",7,2,18,1375,10,1412,"2012"
"12959","280300 ITABAIANINHA",3,1,17,622,3,646,"2012"
"12960","280310 ITABI",0,0,1,30,29,60,"2012"
"12961","280320 ITAPORANGA D'AJUDA",2,3,23,527,4,559,"2012"
"12962","280330 JAPARATUBA",2,2,10,230,8,252,"2012"
"12963","280340 JAPOATA",1,1,6,210,7,225,"2012"
"12964","280350 LAGARTO",6,5,15,1331,5,1362,"2012"
"12965","280360 LARANJEIRAS",2,2,10,443,12,469,"2012"
"12966","280370 MACAMBIRA",0,0,2,114,0,116,"2012"
"12967","280380 MALHADA DOS BOIS",0,2,2,49,1,54,"2012"
"12968","280390 MALHADOR",0,0,3,169,2,174,"2012"
"12969","280400 MARUIM",2,0,8,307,6,323,"2012"
"12970","280410 MOITA BONITA",1,3,1,151,1,157,"2012"
"12971","280420 MONTE ALEGRE DE SERGIPE",0,1,3,89,134,227,"2012"
"12972","280430 MURIBECA",0,0,6,115,3,124,"2012"
"12973","280440 NEOPOLIS",0,1,5,255,7,268,"2012"
"12974","280445 NOSSA SENHORA APARECIDA",2,1,0,100,5,108,"2012"
"12975","280450 NOSSA SENHORA DA GLORIA",0,3,9,254,314,580,"2012"
"12976","280460 NOSSA SENHORA DAS DORES",1,1,10,303,45,360,"2012"
"12977","280470 NOSSA SENHORA DE LOURDES",0,0,1,54,9,64,"2012"
"12978","280480 NOSSA SENHORA DO SOCORRO",23,8,104,2681,24,2840,"2012"
"12979","280490 PACATUBA",0,2,7,180,14,203,"2012"
"12980","280500 PEDRA MOLE",0,1,1,52,0,54,"2012"
"12981","280510 PEDRINHAS",0,0,3,127,0,130,"2012"
"12982","280520 PINHAO",0,0,0,100,2,102,"2012"
"12983","280530 PIRAMBU",0,0,12,136,2,150,"2012"
"12984","280540 POCO REDONDO",2,0,4,301,223,530,"2012"
"12985","280550 POCO VERDE",1,2,9,287,5,304,"2012"
"12986","280560 PORTO DA FOLHA",3,4,12,273,161,453,"2012"
"12987","280570 PROPRIA",1,2,12,417,7,439,"2012"
"12988","280580 RIACHAO DO DANTAS",1,3,9,286,6,305,"2012"
"12989","280590 RIACHUELO",1,0,2,138,2,143,"2012"
"12990","280600 RIBEIROPOLIS",2,2,3,226,3,236,"2012"
"12991","280610 ROSARIO DO CATETE",1,0,5,162,3,171,"2012"
"12992","280620 SALGADO",0,0,6,246,4,256,"2012"
"12993","280630 SANTA LUZIA DO ITANHY",1,2,2,236,2,243,"2012"
"12994","280640 SANTANA DO SAO FRANCISCO",0,0,4,96,5,105,"2012"
"12995","280650 SANTA ROSA DE LIMA",0,0,1,60,1,62,"2012"
"12996","280660 SANTO AMARO DAS BROTAS",1,0,8,199,5,213,"2012"
"12997","280670 SAO CRISTOVAO",8,4,47,1268,16,1343,"2012"
"12998","280680 SAO DOMINGOS",1,1,1,154,2,159,"2012"
"12999","280690 SAO FRANCISCO",0,1,1,47,0,49,"2012"
"13000","280700 SAO MIGUEL DO ALEIXO",1,1,0,49,1,52,"2012"
"13001","280710 SIMAO DIAS",2,5,11,568,4,590,"2012"
"13002","280720 SIRIRI",0,1,4,96,7,108,"2012"
"13003","280730 TELHA",0,0,4,50,3,57,"2012"
"13004","280740 TOBIAS BARRETO",2,6,12,679,22,721,"2012"
"13005","280750 TOMAR DO GERU",1,0,4,198,2,205,"2012"
"13006","280760 UMBAUBA",2,3,4,393,3,405,"2012"
"13007","MUNICIPIO IGNORADO - BA",0,0,0,7,2,9,"2012"
"13008","290010 ABAIRA",1,1,1,38,12,53,"2012"
"13009","290020 ABARE",4,2,9,302,1,318,"2012"
"13010","290030 ACAJUTIBA",1,1,8,204,3,217,"2012"
"13011","290035 ADUSTINA",1,1,5,154,12,173,"2012"
"13012","290040 AGUA FRIA",4,1,1,91,53,150,"2012"
"13013","290050 ERICO CARDOSO",0,0,0,51,87,138,"2012"
"13014","290060 AIQUARA",0,1,1,57,0,59,"2012"
"13015","290070 ALAGOINHAS",104,14,45,1937,117,2217,"2012"
"13016","290080 ALCOBACA",0,1,7,275,7,290,"2012"
"13017","290090 ALMADINA",1,0,2,65,0,68,"2012"
"13018","290100 AMARGOSA",3,3,2,480,31,519,"2012"
"13019","290110 AMELIA RODRIGUES",1,2,2,189,84,278,"2012"
"13020","290115 AMERICA DOURADA",0,1,5,207,2,215,"2012"
"13021","290120 ANAGE",1,1,8,208,21,239,"2012"
"13022","290130 ANDARAI",1,3,5,149,38,196,"2012"
"13023","290135 ANDORINHA",2,0,7,181,7,197,"2012"
"13024","290140 ANGICAL",0,0,4,184,4,192,"2012"
"13025","290150 ANGUERA",0,1,0,43,57,101,"2012"
"13026","290160 ANTAS",0,0,4,139,10,153,"2012"
"13027","290170 ANTONIO CARDOSO",1,0,1,106,67,175,"2012"
"13028","290180 ANTONIO GONCALVES",0,1,2,48,68,119,"2012"
"13029","290190 APORA",3,3,2,196,9,213,"2012"
"13030","290195 APUAREMA",0,0,3,89,7,99,"2012"
"13031","290200 ARACATU",0,1,2,131,29,163,"2012"
"13032","290205 ARACAS",6,2,6,155,3,172,"2012"
"13033","290210 ARACI",0,5,16,603,128,752,"2012"
"13034","290220 ARAMARI",8,0,3,92,10,113,"2012"
"13035","290225 ARATACA",1,4,5,136,0,146,"2012"
"13036","290230 ARATUIPE",0,0,9,96,14,119,"2012"
"13037","290240 AURELINO LEAL",2,2,2,187,51,244,"2012"
"13038","290250 BAIANOPOLIS",1,2,4,210,4,221,"2012"
"13039","290260 BAIXA GRANDE",2,0,5,201,22,230,"2012"
"13040","290265 BANZAE",0,0,0,5,195,200,"2012"
"13041","290270 BARRA",1,9,6,846,1,863,"2012"
"13042","290280 BARRA DA ESTIVA",2,1,7,314,33,357,"2012"
"13043","290290 BARRA DO CHOCA",2,6,17,567,18,610,"2012"
"13044","290300 BARRA DO MENDES",0,1,3,171,0,175,"2012"
"13045","290310 BARRA DO ROCHA",0,2,0,77,0,79,"2012"
"13046","290320 BARREIRAS",8,13,45,2421,11,2498,"2012"
"13047","290323 BARRO ALTO",0,1,3,174,0,178,"2012"
"13048","290327 BARROCAS",0,2,1,178,18,199,"2012"
"13049","290330 BARRO PRETO",0,2,2,84,2,90,"2012"
"13050","290340 BELMONTE",0,1,3,375,14,393,"2012"
"13051","290350 BELO CAMPO",1,2,5,213,1,222,"2012"
"13052","290360 BIRITINGA",2,3,3,185,37,230,"2012"
"13053","290370 BOA NOVA",0,0,7,139,4,150,"2012"
"13054","290380 BOA VISTA DO TUPIM",0,0,6,247,17,270,"2012"
"13055","290390 BOM JESUS DA LAPA",8,9,11,990,7,1025,"2012"
"13056","290395 BOM JESUS DA SERRA",1,0,5,149,1,156,"2012"
"13057","290400 BONINAL",1,1,7,158,3,170,"2012"
"13058","290405 BONITO",1,3,5,239,7,255,"2012"
"13059","290410 BOQUIRA",0,1,4,211,38,254,"2012"
"13060","290420 BOTUPORA",1,2,4,83,47,137,"2012"
"13061","290430 BREJOES",0,0,10,181,7,198,"2012"
"13062","290440 BREJOLANDIA",0,0,7,103,4,114,"2012"
"13063","290450 BROTAS DE MACAUBAS",2,0,1,126,1,130,"2012"
"13064","290460 BRUMADO",4,6,6,766,157,939,"2012"
"13065","290470 BUERAREMA",0,1,5,254,4,264,"2012"
"13066","290475 BURITIRAMA",0,0,3,286,4,293,"2012"
"13067","290480 CAATIBA",0,0,2,46,40,88,"2012"
"13068","290485 CABACEIRAS DO PARAGUACU",0,1,1,156,68,226,"2012"
"13069","290490 CACHOEIRA",0,2,3,233,181,419,"2012"
"13070","290500 CACULE",0,4,3,261,9,277,"2012"
"13071","290510 CAEM",1,1,1,141,21,165,"2012"
"13072","290515 CAETANOS",0,0,8,132,5,145,"2012"
"13073","290520 CAETITE",2,4,10,749,17,782,"2012"
"13074","290530 CAFARNAUM",0,0,12,323,1,336,"2012"
"13075","290540 CAIRU",0,0,39,187,3,229,"2012"
"13076","290550 CALDEIRAO GRANDE",2,0,3,168,13,186,"2012"
"13077","290560 CAMACAN",4,3,10,478,14,509,"2012"
"13078","290570 CAMACARI",20,15,67,4012,46,4160,"2012"
"13079","290580 CAMAMU",3,5,32,532,56,628,"2012"
"13080","290590 CAMPO ALEGRE DE LOURDES",7,0,4,467,15,493,"2012"
"13081","290600 CAMPO FORMOSO",1,2,7,381,699,1090,"2012"
"13082","290610 CANAPOLIS",3,1,5,143,0,152,"2012"
"13083","290620 CANARANA",1,0,8,402,6,417,"2012"
"13084","290630 CANAVIEIRAS",1,1,8,369,119,498,"2012"
"13085","290640 CANDEAL",0,0,2,42,86,130,"2012"
"13086","290650 CANDEIAS",8,3,23,1017,90,1141,"2012"
"13087","290660 CANDIBA",2,3,2,158,5,170,"2012"
"13088","290670 CANDIDO SALES",3,4,15,308,2,332,"2012"
"13089","290680 CANSANCAO",4,0,20,430,26,480,"2012"
"13090","290682 CANUDOS",0,3,6,131,81,221,"2012"
"13091","290685 CAPELA DO ALTO ALEGRE",2,0,1,84,12,99,"2012"
"13092","290687 CAPIM GROSSO",0,3,6,416,23,448,"2012"
"13093","290689 CARAIBAS",0,0,5,109,9,123,"2012"
"13094","290690 CARAVELAS",1,2,7,239,5,254,"2012"
"13095","290700 CARDEAL DA SILVA",2,0,4,130,5,141,"2012"
"13096","290710 CARINHANHA",2,2,14,474,7,499,"2012"
"13097","290720 CASA NOVA",11,3,25,1065,16,1120,"2012"
"13098","290730 CASTRO ALVES",1,1,5,328,54,389,"2012"
"13099","290740 CATOLANDIA",1,0,3,45,0,49,"2012"
"13100","290750 CATU",4,4,9,653,9,679,"2012"
"13101","290755 CATURAMA",0,0,0,40,69,109,"2012"
"13102","290760 CENTRAL",0,2,9,250,2,263,"2012"
"13103","290770 CHORROCHO",4,2,5,163,6,180,"2012"
"13104","290780 CICERO DANTAS",0,1,13,283,56,353,"2012"
"13105","290790 CIPO",1,1,2,150,136,290,"2012"
"13106","290800 COARACI",9,3,8,280,2,302,"2012"
"13107","290810 COCOS",0,0,4,136,120,260,"2012"
"13108","290820 CONCEICAO DA FEIRA",2,2,4,137,151,296,"2012"
"13109","290830 CONCEICAO DO ALMEIDA",2,0,2,147,17,168,"2012"
"13110","290840 CONCEICAO DO COITE",2,2,27,826,184,1041,"2012"
"13111","290850 CONCEICAO DO JACUIPE",4,1,5,232,194,436,"2012"
"13112","290860 CONDE",0,0,6,311,14,331,"2012"
"13113","290870 CONDEUBA",0,1,8,174,3,186,"2012"
"13114","290880 CONTENDAS DO SINCORA",0,0,1,37,14,52,"2012"
"13115","290890 CORACAO DE MARIA",0,1,3,190,136,330,"2012"
"13116","290900 CORDEIROS",0,1,1,73,1,76,"2012"
"13117","290910 CORIBE",1,1,5,139,8,154,"2012"
"13118","290920 CORONEL JOAO SA",0,0,4,209,3,216,"2012"
"13119","290930 CORRENTINA",2,3,8,111,330,454,"2012"
"13120","290940 COTEGIPE",0,0,2,161,15,178,"2012"
"13121","290950 CRAVOLANDIA",1,0,5,43,2,51,"2012"
"13122","290960 CRISOPOLIS",3,2,4,262,7,278,"2012"
"13123","290970 CRISTOPOLIS",0,1,5,196,3,205,"2012"
"13124","290980 CRUZ DAS ALMAS",1,6,7,710,38,762,"2012"
"13125","290990 CURACA",4,2,15,494,10,525,"2012"
"13126","291000 DARIO MEIRA",0,2,6,162,13,183,"2012"
"13127","291005 DIAS D'AVILA",1,2,21,1080,12,1116,"2012"
"13128","291010 DOM BASILIO",1,0,3,120,3,127,"2012"
"13129","291020 DOM MACEDO COSTA",1,0,1,28,10,40,"2012"
"13130","291030 ELISIO MEDRADO",0,0,1,55,19,75,"2012"
"13131","291040 ENCRUZILHADA",0,2,4,287,7,300,"2012"
"13132","291050 ENTRE RIOS",5,5,11,566,16,603,"2012"
"13133","291060 ESPLANADA",4,4,7,499,7,521,"2012"
"13134","291070 EUCLIDES DA CUNHA",1,3,16,711,84,815,"2012"
"13135","291072 EUNAPOLIS",3,7,14,583,1230,1837,"2012"
"13136","291075 FATIMA",1,1,5,182,10,199,"2012"
"13137","291077 FEIRA DA MATA",0,0,0,40,12,52,"2012"
"13138","291080 FEIRA DE SANTANA",11,18,65,5709,3758,9561,"2012"
"13139","291085 FILADELFIA",1,6,12,234,8,261,"2012"
"13140","291090 FIRMINO ALVES",0,2,1,72,11,86,"2012"
"13141","291100 FLORESTA AZUL",0,1,1,118,0,120,"2012"
"13142","291110 FORMOSA DO RIO PRETO",0,0,8,381,12,401,"2012"
"13143","291120 GANDU",3,0,23,476,6,508,"2012"
"13144","291125 GAVIAO",0,1,2,49,3,55,"2012"
"13145","291130 GENTIO DO OURO",0,1,1,137,0,139,"2012"
"13146","291140 GLORIA",2,2,12,224,5,245,"2012"
"13147","291150 GONGOGI",0,0,3,75,1,79,"2012"
"13148","291160 GOVERNADOR MANGABEIRA",0,0,3,150,118,271,"2012"
"13149","291165 GUAJERU",0,0,0,79,6,85,"2012"
"13150","291170 GUANAMBI",7,5,22,990,103,1127,"2012"
"13151","291180 GUARATINGA",0,1,6,256,39,302,"2012"
"13152","291185 HELIOPOLIS",0,0,1,112,36,149,"2012"
"13153","291190 IACU",3,2,13,327,11,356,"2012"
"13154","291200 IBIASSUCE",1,1,0,108,2,112,"2012"
"13155","291210 IBICARAI",2,4,10,368,4,388,"2012"
"13156","291220 IBICOARA",2,6,14,265,64,351,"2012"
"13157","291230 IBICUI",0,1,6,176,7,190,"2012"
"13158","291240 IBIPEBA",1,0,4,228,1,234,"2012"
"13159","291250 IBIPITANGA",0,1,2,82,91,176,"2012"
"13160","291260 IBIQUERA",0,0,0,49,0,49,"2012"
"13161","291270 IBIRAPITANGA",4,2,8,297,133,444,"2012"
"13162","291280 IBIRAPUA",0,0,5,115,0,120,"2012"
"13163","291290 IBIRATAIA",0,2,7,290,0,299,"2012"
"13164","291300 IBITIARA",1,1,11,135,9,157,"2012"
"13165","291310 IBITITA",0,1,7,244,0,252,"2012"
"13166","291320 IBOTIRAMA",2,5,19,373,42,441,"2012"
"13167","291330 ICHU",0,1,0,55,17,73,"2012"
"13168","291340 IGAPORA",0,0,8,181,15,204,"2012"
"13169","291345 IGRAPIUNA",0,1,20,166,10,197,"2012"
"13170","291350 IGUAI",1,2,2,315,3,323,"2012"
"13171","291360 ILHEUS",13,12,32,1099,1484,2640,"2012"
"13172","291370 INHAMBUPE",10,4,14,437,30,495,"2012"
"13173","291380 IPECAETA",1,0,3,121,89,214,"2012"
"13174","291390 IPIAU",4,2,19,674,4,703,"2012"
"13175","291400 IPIRA",1,7,10,822,47,887,"2012"
"13176","291410 IPUPIARA",0,1,0,106,0,107,"2012"
"13177","291420 IRAJUBA",0,1,2,91,2,96,"2012"
"13178","291430 IRAMAIA",1,0,5,92,20,118,"2012"
"13179","291440 IRAQUARA",2,6,5,330,2,345,"2012"
"13180","291450 IRARA",0,1,7,204,180,392,"2012"
"13181","291460 IRECE",3,7,13,1172,0,1195,"2012"
"13182","291465 ITABELA",2,1,6,404,99,512,"2012"
"13183","291470 ITABERABA",3,7,19,890,9,928,"2012"
"13184","291480 ITABUNA",15,11,92,3082,12,3212,"2012"
"13185","291490 ITACARE",2,1,3,225,111,342,"2012"
"13186","291500 ITAETE",2,0,9,191,44,246,"2012"
"13187","291510 ITAGI",1,0,1,145,3,150,"2012"
"13188","291520 ITAGIBA",1,5,10,192,1,209,"2012"
"13189","291530 ITAGIMIRIM",0,1,2,66,43,112,"2012"
"13190","291535 ITAGUACU DA BAHIA",1,2,8,167,2,180,"2012"
"13191","291540 ITAJU DO COLONIA",0,0,2,62,1,65,"2012"
"13192","291550 ITAJUIPE",2,1,13,270,2,288,"2012"
"13193","291560 ITAMARAJU",8,5,18,1015,38,1084,"2012"
"13194","291570 ITAMARI",0,2,13,114,3,132,"2012"
"13195","291580 ITAMBE",1,3,11,331,12,358,"2012"
"13196","291590 ITANAGRA",0,0,1,89,4,94,"2012"
"13197","291600 ITANHEM",0,5,5,244,0,254,"2012"
"13198","291610 ITAPARICA",0,1,6,233,34,274,"2012"
"13199","291620 ITAPE",0,1,3,134,0,138,"2012"
"13200","291630 ITAPEBI",0,0,2,79,92,173,"2012"
"13201","291640 ITAPETINGA",0,0,5,275,835,1115,"2012"
"13202","291650 ITAPICURU",1,2,5,388,27,423,"2012"
"13203","291660 ITAPITANGA",3,1,5,89,4,102,"2012"
"13204","291670 ITAQUARA",1,1,6,126,0,134,"2012"
"13205","291680 ITARANTIM",0,1,5,198,50,254,"2012"
"13206","291685 ITATIM",0,1,4,167,64,236,"2012"
"13207","291690 ITIRUCU",0,1,5,126,3,135,"2012"
"13208","291700 ITIUBA",3,5,18,563,21,610,"2012"
"13209","291710 ITORORO",0,1,6,107,161,275,"2012"
"13210","291720 ITUACU",1,3,3,195,48,250,"2012"
"13211","291730 ITUBERA",2,5,33,421,5,466,"2012"
"13212","291733 IUIU",1,2,10,111,15,139,"2012"
"13213","291735 JABORANDI",0,2,2,133,0,137,"2012"
"13214","291740 JACARACI",1,0,1,113,0,115,"2012"
"13215","291750 JACOBINA",10,13,22,965,248,1258,"2012"
"13216","291760 JAGUAQUARA",0,4,21,729,9,763,"2012"
"13217","291770 JAGUARARI",1,3,9,345,86,444,"2012"
"13218","291780 JAGUARIPE",0,1,21,157,21,200,"2012"
"13219","291790 JANDAIRA",0,1,1,163,5,170,"2012"
"13220","291800 JEQUIE",14,15,61,2488,26,2604,"2012"
"13221","291810 JEREMOABO",0,2,11,400,86,499,"2012"
"13222","291820 JIQUIRICA",0,1,1,121,19,142,"2012"
"13223","291830 JITAUNA",2,0,4,154,1,161,"2012"
"13224","291835 JOAO DOURADO",0,5,11,365,1,382,"2012"
"13225","291840 JUAZEIRO",32,25,77,3714,59,3907,"2012"
"13226","291845 JUCURUCU",0,1,6,89,8,104,"2012"
"13227","291850 JUSSARA",0,0,5,218,2,225,"2012"
"13228","291855 JUSSARI",0,0,4,79,0,83,"2012"
"13229","291860 JUSSIAPE",0,1,0,48,1,50,"2012"
"13230","291870 LAFAIETE COUTINHO",0,0,1,34,1,36,"2012"
"13231","291875 LAGOA REAL",1,1,0,141,2,145,"2012"
"13232","291880 LAJE",2,2,5,262,54,325,"2012"
"13233","291890 LAJEDAO",0,1,1,36,0,38,"2012"
"13234","291900 LAJEDINHO",0,0,1,50,0,51,"2012"
"13235","291905 LAJEDO DO TABOCAL",0,0,3,68,0,71,"2012"
"13236","291910 LAMARAO",0,0,4,72,16,92,"2012"
"13237","291915 LAPAO",3,3,9,341,3,359,"2012"
"13238","291920 LAURO DE FREITAS",9,14,54,2983,23,3083,"2012"
"13239","291930 LENCOIS",0,0,6,113,5,124,"2012"
"13240","291940 LICINIO DE ALMEIDA",0,0,1,145,0,146,"2012"
"13241","291950 LIVRAMENTO DE NOSSA SENHORA",2,1,10,503,14,530,"2012"
"13242","291955 LUIS EDUARDO MAGALHAES",8,11,27,1393,15,1454,"2012"
"13243","291960 MACAJUBA",0,1,5,162,11,179,"2012"
"13244","291970 MACARANI",0,0,9,221,46,276,"2012"
"13245","291980 MACAUBAS",3,2,7,512,37,561,"2012"
"13246","291990 MACURURE",1,0,2,99,0,102,"2012"
"13247","291992 MADRE DE DEUS",2,2,4,287,9,304,"2012"
"13248","291995 MAETINGA",0,1,2,84,4,91,"2012"
"13249","292000 MAIQUINIQUE",0,0,4,94,37,135,"2012"
"13250","292010 MAIRI",0,0,5,197,19,221,"2012"
"13251","292020 MALHADA",1,1,8,244,12,266,"2012"
"13252","292030 MALHADA DE PEDRAS",0,0,2,78,15,95,"2012"
"13253","292040 MANOEL VITORINO",2,1,3,194,5,205,"2012"
"13254","292045 MANSIDAO",1,1,1,116,1,120,"2012"
"13255","292050 MARACAS",3,0,11,358,1,373,"2012"
"13256","292060 MARAGOGIPE",3,2,5,297,214,521,"2012"
"13257","292070 MARAU",0,0,12,127,78,217,"2012"
"13258","292080 MARCIONILIO SOUZA",0,1,4,130,6,141,"2012"
"13259","292090 MASCOTE",2,2,6,230,4,244,"2012"
"13260","292100 MATA DE SAO JOAO",2,4,12,715,11,744,"2012"
"13261","292105 MATINA",0,1,4,157,10,172,"2012"
"13262","292110 MEDEIROS NETO",0,4,10,304,0,318,"2012"
"13263","292120 MIGUEL CALMON",2,4,7,405,6,424,"2012"
"13264","292130 MILAGRES",0,1,4,172,17,194,"2012"
"13265","292140 MIRANGABA",2,3,2,152,36,195,"2012"
"13266","292145 MIRANTE",0,0,2,108,3,113,"2012"
"13267","292150 MONTE SANTO",3,5,29,617,31,685,"2012"
"13268","292160 MORPARA",0,0,3,122,2,127,"2012"
"13269","292170 MORRO DO CHAPEU",1,3,16,467,55,542,"2012"
"13270","292180 MORTUGABA",0,1,2,124,1,128,"2012"
"13271","292190 MUCUGE",0,0,0,55,168,223,"2012"
"13272","292200 MUCURI",3,7,27,660,3,700,"2012"
"13273","292205 MULUNGU DO MORRO",1,3,9,169,3,185,"2012"
"13274","292210 MUNDO NOVO",1,1,8,271,30,311,"2012"
"13275","292220 MUNIZ FERREIRA",0,0,0,62,20,82,"2012"
"13276","292225 MUQUEM DE SAO FRANCISCO",0,0,10,157,19,186,"2012"
"13277","292230 MURITIBA",1,0,4,251,110,366,"2012"
"13278","292240 MUTUIPE",3,2,14,219,39,277,"2012"
"13279","292250 NAZARE",4,0,13,315,54,386,"2012"
"13280","292260 NILO PECANHA",0,1,32,168,10,211,"2012"
"13281","292265 NORDESTINA",0,5,2,144,4,155,"2012"
"13282","292270 NOVA CANAA",0,4,12,169,1,186,"2012"
"13283","292273 NOVA FATIMA",0,0,3,42,14,59,"2012"
"13284","292275 NOVA IBIA",0,1,1,77,1,80,"2012"
"13285","292280 NOVA ITARANA",1,0,8,108,3,120,"2012"
"13286","292285 NOVA REDENCAO",0,0,1,98,6,105,"2012"
"13287","292290 NOVA SOURE",0,3,7,294,79,383,"2012"
"13288","292300 NOVA VICOSA",6,5,23,738,5,777,"2012"
"13289","292303 NOVO HORIZONTE",0,2,12,130,3,147,"2012"
"13290","292305 NOVO TRIUNFO",0,0,4,113,7,124,"2012"
"13291","292310 OLINDINA",0,1,5,276,61,343,"2012"
"13292","292320 OLIVEIRA DOS BREJINHOS",2,3,5,249,12,271,"2012"
"13293","292330 OURICANGAS",4,1,6,90,6,107,"2012"
"13294","292335 OUROLANDIA",1,5,4,237,50,297,"2012"
"13295","292340 PALMAS DE MONTE ALTO",0,3,5,268,5,281,"2012"
"13296","292350 PALMEIRAS",1,0,6,137,7,151,"2012"
"13297","292360 PARAMIRIM",1,0,0,69,163,233,"2012"
"13298","292370 PARATINGA",2,5,21,402,15,445,"2012"
"13299","292380 PARIPIRANGA",0,0,5,356,4,365,"2012"
"13300","292390 PAU BRASIL",0,1,3,180,5,189,"2012"
"13301","292400 PAULO AFONSO",5,19,99,1731,43,1897,"2012"
"13302","292405 PE DE SERRA",0,1,1,135,31,168,"2012"
"13303","292410 PEDRAO",2,1,1,67,11,82,"2012"
"13304","292420 PEDRO ALEXANDRE",2,1,4,200,5,212,"2012"
"13305","292430 PIATA",1,0,2,250,4,257,"2012"
"13306","292440 PILAO ARCADO",2,1,11,503,47,564,"2012"
"13307","292450 PINDAI",0,0,3,194,6,203,"2012"
"13308","292460 PINDOBACU",2,4,5,318,5,334,"2012"
"13309","292465 PINTADAS",0,0,1,72,25,98,"2012"
"13310","292467 PIRAI DO NORTE",0,0,9,93,4,106,"2012"
"13311","292470 PIRIPA",0,0,0,114,1,115,"2012"
"13312","292480 PIRITIBA",0,3,10,221,28,262,"2012"
"13313","292490 PLANALTINO",1,1,3,102,0,107,"2012"
"13314","292500 PLANALTO",0,1,15,340,4,360,"2012"
"13315","292510 POCOES",0,4,25,646,19,694,"2012"
"13316","292520 POJUCA",0,1,8,550,0,559,"2012"
"13317","292525 PONTO NOVO",3,5,11,226,12,257,"2012"
"13318","292530 PORTO SEGURO",4,15,44,2189,152,2404,"2012"
"13319","292540 POTIRAGUA",0,0,6,133,12,151,"2012"
"13320","292550 PRADO",0,1,6,402,7,416,"2012"
"13321","292560 PRESIDENTE DUTRA",1,0,4,195,0,200,"2012"
"13322","292570 PRESIDENTE JANIO QUADROS",2,0,2,93,7,104,"2012"
"13323","292575 PRESIDENTE TANCREDO NEVES",1,0,60,317,29,407,"2012"
"13324","292580 QUEIMADAS",0,1,6,307,6,320,"2012"
"13325","292590 QUIJINGUE",0,2,2,258,82,344,"2012"
"13326","292593 QUIXABEIRA",0,1,1,105,9,116,"2012"
"13327","292595 RAFAEL JAMBEIRO",0,2,2,231,61,296,"2012"
"13328","292600 REMANSO",1,7,4,669,7,688,"2012"
"13329","292610 RETIROLANDIA",0,1,9,225,24,259,"2012"
"13330","292620 RIACHAO DAS NEVES",1,2,7,342,2,354,"2012"
"13331","292630 RIACHAO DO JACUIPE",2,1,12,394,21,430,"2012"
"13332","292640 RIACHO DE SANTANA",2,2,11,389,49,453,"2012"
"13333","292650 RIBEIRA DO AMPARO",0,0,1,21,191,213,"2012"
"13334","292660 RIBEIRA DO POMBAL",4,0,3,51,799,857,"2012"
"13335","292665 RIBEIRAO DO LARGO",0,0,2,84,4,90,"2012"
"13336","292670 RIO DE CONTAS",0,0,2,115,6,123,"2012"
"13337","292680 RIO DO ANTONIO",0,2,2,114,16,134,"2012"
"13338","292690 RIO DO PIRES",0,0,1,55,79,135,"2012"
"13339","292700 RIO REAL",2,7,3,552,4,568,"2012"
"13340","292710 RODELAS",1,2,4,138,2,147,"2012"
"13341","292720 RUY BARBOSA",2,0,7,446,3,458,"2012"
"13342","292730 SALINAS DA MARGARIDA",0,0,3,163,13,179,"2012"
"13343","292740 SALVADOR",174,205,751,35708,325,37163,"2012"
"13344","292750 SANTA BARBARA",2,1,4,151,167,325,"2012"
"13345","292760 SANTA BRIGIDA",1,4,13,238,8,264,"2012"
"13346","292770 SANTA CRUZ CABRALIA",0,2,10,456,9,477,"2012"
"13347","292780 SANTA CRUZ DA VITORIA",0,0,1,51,22,74,"2012"
"13348","292790 SANTA INES",0,0,1,139,4,144,"2012"
"13349","292800 SANTALUZ",2,7,35,433,26,503,"2012"
"13350","292805 SANTA LUZIA",1,1,7,185,19,213,"2012"
"13351","292810 SANTA MARIA DA VITORIA",1,3,24,556,24,608,"2012"
"13352","292820 SANTANA",0,2,8,340,2,352,"2012"
"13353","292830 SANTANOPOLIS",0,0,0,80,48,128,"2012"
"13354","292840 SANTA RITA DE CASSIA",1,6,4,363,1,375,"2012"
"13355","292850 SANTA TERESINHA",1,1,3,146,5,156,"2012"
"13356","292860 SANTO AMARO",1,0,46,639,29,715,"2012"
"13357","292870 SANTO ANTONIO DE JESUS",5,5,14,1030,381,1435,"2012"
"13358","292880 SANTO ESTEVAO",3,8,7,489,242,749,"2012"
"13359","292890 SAO DESIDERIO",1,6,9,466,8,490,"2012"
"13360","292895 SAO DOMINGOS",0,0,2,80,19,101,"2012"
"13361","292900 SAO FELIX",0,0,0,77,103,180,"2012"
"13362","292905 SAO FELIX DO CORIBE",4,3,9,256,2,274,"2012"
"13363","292910 SAO FELIPE",1,3,3,181,30,218,"2012"
"13364","292920 SAO FRANCISCO DO CONDE",4,7,11,637,10,669,"2012"
"13365","292925 SAO GABRIEL",1,2,9,318,2,332,"2012"
"13366","292930 SAO GONCALO DOS CAMPOS",1,0,5,264,169,439,"2012"
"13367","292935 SAO JOSE DA VITORIA",0,1,1,73,0,75,"2012"
"13368","292937 SAO JOSE DO JACUIPE",2,2,3,84,20,111,"2012"
"13369","292940 SAO MIGUEL DAS MATAS",1,1,4,98,18,122,"2012"
"13370","292950 SAO SEBASTIAO DO PASSE",1,7,19,539,32,598,"2012"
"13371","292960 SAPEACU",0,0,7,225,9,241,"2012"
"13372","292970 SATIRO DIAS",3,1,4,237,4,249,"2012"
"13373","292975 SAUBARA",0,0,6,118,4,128,"2012"
"13374","292980 SAUDE",0,0,4,112,12,128,"2012"
"13375","292990 SEABRA",5,5,10,646,25,691,"2012"
"13376","293000 SEBASTIAO LARANJEIRAS",1,0,0,112,2,115,"2012"
"13377","293010 SENHOR DO BONFIM",4,21,37,959,15,1036,"2012"
"13378","293015 SERRA DO RAMALHO",2,9,10,516,2,539,"2012"
"13379","293020 SENTO SE",3,11,18,548,5,585,"2012"
"13380","293030 SERRA DOURADA",1,1,9,245,1,257,"2012"
"13381","293040 SERRA PRETA",3,0,1,90,118,212,"2012"
"13382","293050 SERRINHA",5,6,15,1174,56,1256,"2012"
"13383","293060 SERROLANDIA",1,1,10,147,10,169,"2012"
"13384","293070 SIMOES FILHO",9,12,39,1761,36,1857,"2012"
"13385","293075 SITIO DO MATO",0,2,3,157,2,164,"2012"
"13386","293076 SITIO DO QUINTO",0,1,3,136,5,145,"2012"
"13387","293077 SOBRADINHO",3,4,6,364,11,388,"2012"
"13388","293080 SOUTO SOARES",0,0,15,244,1,260,"2012"
"13389","293090 TABOCAS DO BREJO VELHO",0,1,2,126,2,131,"2012"
"13390","293100 TANHACU",0,0,3,189,45,237,"2012"
"13391","293105 TANQUE NOVO",2,1,2,164,48,217,"2012"
"13392","293110 TANQUINHO",0,0,0,56,51,107,"2012"
"13393","293120 TAPEROA",1,1,54,217,20,293,"2012"
"13394","293130 TAPIRAMUTA",0,4,5,185,41,235,"2012"
"13395","293135 TEIXEIRA DE FREITAS",2,11,56,2627,21,2717,"2012"
"13396","293140 TEODORO SAMPAIO",0,0,1,39,34,74,"2012"
"13397","293150 TEOFILANDIA",0,1,7,279,35,322,"2012"
"13398","293160 TEOLANDIA",0,0,19,121,7,147,"2012"
"13399","293170 TERRA NOVA",2,1,1,131,45,180,"2012"
"13400","293180 TREMEDAL",2,1,1,182,3,189,"2012"
"13401","293190 TUCANO",2,5,8,454,134,603,"2012"
"13402","293200 UAUA",1,1,2,268,1,273,"2012"
"13403","293210 UBAIRA",0,2,4,249,22,277,"2012"
"13404","293220 UBAITABA",0,1,7,259,83,350,"2012"
"13405","293230 UBATA",1,1,5,252,5,264,"2012"
"13406","293240 UIBAI",0,2,6,185,0,193,"2012"
"13407","293245 UMBURANAS",11,19,21,117,25,193,"2012"
"13408","293250 UNA",0,3,2,184,128,317,"2012"
"13409","293260 URANDI",1,0,0,191,2,194,"2012"
"13410","293270 URUCUCA",1,2,11,280,82,376,"2012"
"13411","293280 UTINGA",1,2,4,253,10,270,"2012"
"13412","293290 VALENCA",2,2,310,944,42,1300,"2012"
"13413","293300 VALENTE",1,1,12,286,29,329,"2012"
"13414","293305 VARZEA DA ROCA",0,1,0,110,11,122,"2012"
"13415","293310 VARZEA DO POCO",1,2,6,105,6,120,"2012"
"13416","293315 VARZEA NOVA",1,1,7,134,19,162,"2012"
"13417","293317 VARZEDO",2,0,2,103,33,140,"2012"
"13418","293320 VERA CRUZ",1,0,6,412,80,499,"2012"
"13419","293325 VEREDA",1,0,7,82,0,90,"2012"
"13420","293330 VITORIA DA CONQUISTA",19,26,152,5036,15,5248,"2012"
"13421","293340 WAGNER",0,0,2,115,8,125,"2012"
"13422","293345 WANDERLEY",1,0,3,181,6,191,"2012"
"13423","293350 WENCESLAU GUIMARAES",0,3,19,377,17,416,"2012"
"13424","293360 XIQUE-XIQUE",2,6,29,811,10,858,"2012"
"13425","MUNICIPIO IGNORADO - MG",0,0,0,10,1,11,"2012"
"13426","310010 ABADIA DOS DOURADOS",0,0,3,65,0,68,"2012"
"13427","310020 ABAETE",1,3,10,224,0,238,"2012"
"13428","310030 ABRE CAMPO",1,0,0,139,24,164,"2012"
"13429","310040 ACAIACA",0,1,1,44,1,47,"2012"
"13430","310050 ACUCENA",0,0,3,87,3,93,"2012"
"13431","310060 AGUA BOA",2,1,1,174,1,179,"2012"
"13432","310070 AGUA COMPRIDA",0,0,0,23,0,23,"2012"
"13433","310080 AGUANIL",0,0,4,46,0,50,"2012"
"13434","310090 AGUAS FORMOSAS",0,0,5,264,4,273,"2012"
"13435","310100 AGUAS VERMELHAS",1,0,3,156,8,168,"2012"
"13436","310110 AIMORES",2,5,4,294,11,316,"2012"
"13437","310120 AIURUOCA",0,0,0,54,0,54,"2012"
"13438","310130 ALAGOA",0,0,0,13,0,13,"2012"
"13439","310140 ALBERTINA",0,0,0,18,0,18,"2012"
"13440","310150 ALEM PARAIBA",3,7,7,438,1,456,"2012"
"13441","310160 ALFENAS",1,5,11,1029,4,1050,"2012"
"13442","310163 ALFREDO VASCONCELOS",0,0,0,79,0,79,"2012"
"13443","310170 ALMENARA",4,4,10,559,14,591,"2012"
"13444","310180 ALPERCATA",0,0,1,97,0,98,"2012"
"13445","310190 ALPINOPOLIS",0,0,6,253,0,259,"2012"
"13446","310200 ALTEROSA",0,0,1,164,0,165,"2012"
"13447","310205 ALTO CAPARAO",0,0,1,52,18,71,"2012"
"13448","310210 ALTO RIO DOCE",0,0,0,100,0,100,"2012"
"13449","310220 ALVARENGA",0,1,2,37,0,40,"2012"
"13450","310230 ALVINOPOLIS",0,0,6,150,2,158,"2012"
"13451","310240 ALVORADA DE MINAS",0,0,1,52,0,53,"2012"
"13452","310250 AMPARO DO SERRA",0,0,1,70,1,72,"2012"
"13453","310260 ANDRADAS",0,3,5,448,1,457,"2012"
"13454","310270 CACHOEIRA DE PAJEU",1,3,10,75,3,92,"2012"
"13455","310280 ANDRELANDIA",0,2,0,112,2,116,"2012"
"13456","310285 ANGELANDIA",1,0,1,103,2,107,"2012"
"13457","310290 ANTONIO CARLOS",0,0,1,117,1,119,"2012"
"13458","310300 ANTONIO DIAS",0,0,0,79,4,83,"2012"
"13459","310310 ANTONIO PRADO DE MINAS",0,0,0,11,0,11,"2012"
"13460","310320 ARACAI",1,1,0,22,0,24,"2012"
"13461","310330 ARACITABA",0,0,0,11,1,12,"2012"
"13462","310340 ARACUAI",0,1,1,279,81,362,"2012"
"13463","310350 ARAGUARI",4,5,19,1394,3,1425,"2012"
"13464","310360 ARANTINA",0,1,0,30,1,32,"2012"
"13465","310370 ARAPONGA",2,0,1,99,6,108,"2012"
"13466","310375 ARAPORA",0,0,2,106,1,109,"2012"
"13467","310380 ARAPUA",0,2,1,20,0,23,"2012"
"13468","310390 ARAUJOS",2,0,4,111,0,117,"2012"
"13469","310400 ARAXA",7,5,8,1321,4,1345,"2012"
"13470","310410 ARCEBURGO",0,0,2,91,0,93,"2012"
"13471","310420 ARCOS",1,3,4,437,0,445,"2012"
"13472","310430 AREADO",0,0,2,176,0,178,"2012"
"13473","310440 ARGIRITA",0,0,2,31,0,33,"2012"
"13474","310445 ARICANDUVA",0,0,1,68,0,69,"2012"
"13475","310450 ARINOS",2,0,4,214,6,226,"2012"
"13476","310460 ASTOLFO DUTRA",0,0,4,139,1,144,"2012"
"13477","310470 ATALEIA",3,1,4,154,5,167,"2012"
"13478","310480 AUGUSTO DE LIMA",1,0,2,54,1,58,"2012"
"13479","310490 BAEPENDI",0,1,3,165,1,170,"2012"
"13480","310500 BALDIM",0,0,0,80,6,86,"2012"
"13481","310510 BAMBUI",1,2,7,209,0,219,"2012"
"13482","310520 BANDEIRA",1,0,0,36,0,37,"2012"
"13483","310530 BANDEIRA DO SUL",0,0,1,71,0,72,"2012"
"13484","310540 BARAO DE COCAIS",0,0,5,363,4,372,"2012"
"13485","310550 BARAO DE MONTE ALTO",0,1,2,63,0,66,"2012"
"13486","310560 BARBACENA",3,4,29,1391,4,1431,"2012"
"13487","310570 BARRA LONGA",0,1,0,64,0,65,"2012"
"13488","310590 BARROSO",1,0,4,288,0,293,"2012"
"13489","310600 BELA VISTA DE MINAS",1,1,2,122,0,126,"2012"
"13490","310610 BELMIRO BRAGA",1,1,1,38,1,42,"2012"
"13491","310620 BELO HORIZONTE",84,126,392,31410,112,32124,"2012"
"13492","310630 BELO ORIENTE",0,1,6,348,2,357,"2012"
"13493","310640 BELO VALE",0,0,0,80,1,81,"2012"
"13494","310650 BERILO",0,0,0,92,10,102,"2012"
"13495","310660 BERTOPOLIS",0,0,1,62,35,98,"2012"
"13496","310665 BERIZAL",0,0,0,54,1,55,"2012"
"13497","310670 BETIM",17,23,80,5957,34,6111,"2012"
"13498","310680 BIAS FORTES",0,0,0,37,0,37,"2012"
"13499","310690 BICAS",1,0,3,149,0,153,"2012"
"13500","310700 BIQUINHAS",0,0,1,27,0,28,"2012"
"13501","310710 BOA ESPERANCA",0,0,2,504,2,508,"2012"
"13502","310720 BOCAINA DE MINAS",0,0,0,40,0,40,"2012"
"13503","310730 BOCAIUVA",7,4,15,677,8,711,"2012"
"13504","310740 BOM DESPACHO",0,1,10,580,5,596,"2012"
"13505","310750 BOM JARDIM DE MINAS",0,2,1,65,7,75,"2012"
"13506","310760 BOM JESUS DA PENHA",1,0,2,60,0,63,"2012"
"13507","310770 BOM JESUS DO AMPARO",1,0,2,63,1,67,"2012"
"13508","310780 BOM JESUS DO GALHO",1,0,9,172,2,184,"2012"
"13509","310790 BOM REPOUSO",1,0,3,112,0,116,"2012"
"13510","310800 BOM SUCESSO",0,0,4,194,1,199,"2012"
"13511","310810 BONFIM",0,0,0,39,2,41,"2012"
"13512","310820 BONFINOPOLIS DE MINAS",0,0,0,55,2,57,"2012"
"13513","310825 BONITO DE MINAS",0,1,1,96,4,102,"2012"
"13514","310830 BORDA DA MATA",1,0,2,199,1,203,"2012"
"13515","310840 BOTELHOS",0,0,4,119,4,127,"2012"
"13516","310850 BOTUMIRIM",1,0,0,73,2,76,"2012"
"13517","310855 BRASILANDIA DE MINAS",0,3,2,214,5,224,"2012"
"13518","310860 BRASILIA DE MINAS",0,2,7,449,4,462,"2012"
"13519","310870 BRAS PIRES",0,0,2,42,0,44,"2012"
"13520","310880 BRAUNAS",0,0,0,51,1,52,"2012"
"13521","310890 BRAZOPOLIS",0,1,0,142,0,143,"2012"
"13522","310900 BRUMADINHO",2,1,7,436,0,446,"2012"
"13523","310910 BUENO BRANDAO",0,1,0,74,2,77,"2012"
"13524","310920 BUENOPOLIS",1,0,1,115,2,119,"2012"
"13525","310925 BUGRE",0,0,1,53,0,54,"2012"
"13526","310930 BURITIS",0,1,6,299,11,317,"2012"
"13527","310940 BURITIZEIRO",1,1,8,326,2,338,"2012"
"13528","310945 CABECEIRA GRANDE",1,0,2,56,5,64,"2012"
"13529","310950 CABO VERDE",0,0,0,153,0,153,"2012"
"13530","310960 CACHOEIRA DA PRATA",0,1,1,29,0,31,"2012"
"13531","310970 CACHOEIRA DE MINAS",0,0,1,112,0,113,"2012"
"13532","310980 CACHOEIRA DOURADA",0,0,0,31,1,32,"2012"
"13533","310990 CAETANOPOLIS",0,0,4,101,3,108,"2012"
"13534","311000 CAETE",2,1,9,489,15,516,"2012"
"13535","311010 CAIANA",0,0,1,61,1,63,"2012"
"13536","311020 CAJURI",0,0,0,37,2,39,"2012"
"13537","311030 CALDAS",0,1,7,117,0,125,"2012"
"13538","311040 CAMACHO",0,0,0,28,0,28,"2012"
"13539","311050 CAMANDUCAIA",0,0,1,252,7,260,"2012"
"13540","311060 CAMBUI",0,0,5,292,1,298,"2012"
"13541","311070 CAMBUQUIRA",0,1,0,139,0,140,"2012"
"13542","311080 CAMPANARIO",0,0,0,42,0,42,"2012"
"13543","311090 CAMPANHA",1,1,4,224,2,232,"2012"
"13544","311100 CAMPESTRE",1,4,5,219,0,229,"2012"
"13545","311110 CAMPINA VERDE",1,0,3,191,0,195,"2012"
"13546","311115 CAMPO AZUL",0,0,2,41,0,43,"2012"
"13547","311120 CAMPO BELO",0,5,18,610,0,633,"2012"
"13548","311130 CAMPO DO MEIO",1,0,1,120,1,123,"2012"
"13549","311140 CAMPO FLORIDO",0,1,0,99,0,100,"2012"
"13550","311150 CAMPOS ALTOS",1,0,9,214,1,225,"2012"
"13551","311160 CAMPOS GERAIS",1,1,1,311,5,319,"2012"
"13552","311170 CANAA",0,0,0,49,2,51,"2012"
"13553","311180 CANAPOLIS",0,0,0,102,39,141,"2012"
"13554","311190 CANA VERDE",0,0,1,63,0,64,"2012"
"13555","311200 CANDEIAS",0,0,3,144,0,147,"2012"
"13556","311205 CANTAGALO",0,0,0,56,0,56,"2012"
"13557","311210 CAPARAO",0,1,0,69,0,70,"2012"
"13558","311220 CAPELA NOVA",0,0,1,36,0,37,"2012"
"13559","311230 CAPELINHA",1,2,4,523,2,532,"2012"
"13560","311240 CAPETINGA",0,1,7,63,0,71,"2012"
"13561","311250 CAPIM BRANCO",0,0,3,97,7,107,"2012"
"13562","311260 CAPINOPOLIS",0,1,0,163,1,165,"2012"
"13563","311265 CAPITAO ANDRADE",0,0,0,56,1,57,"2012"
"13564","311270 CAPITAO ENEAS",0,1,5,167,2,175,"2012"
"13565","311280 CAPITOLIO",0,0,2,62,1,65,"2012"
"13566","311290 CAPUTIRA",0,0,0,9,100,109,"2012"
"13567","311300 CARAI",1,0,6,252,6,265,"2012"
"13568","311310 CARANAIBA",0,1,1,28,0,30,"2012"
"13569","311320 CARANDAI",0,0,1,222,1,224,"2012"
"13570","311330 CARANGOLA",1,0,5,425,4,435,"2012"
"13571","311340 CARATINGA",2,2,20,1052,22,1098,"2012"
"13572","311350 CARBONITA",0,0,1,98,0,99,"2012"
"13573","311360 CAREACU",0,0,1,75,0,76,"2012"
"13574","311370 CARLOS CHAGAS",0,2,6,226,2,236,"2012"
"13575","311380 CARMESIA",0,0,2,32,0,34,"2012"
"13576","311390 CARMO DA CACHOEIRA",0,0,0,146,3,149,"2012"
"13577","311400 CARMO DA MATA",0,0,0,92,1,93,"2012"
"13578","311410 CARMO DE MINAS",0,0,3,124,1,128,"2012"
"13579","311420 CARMO DO CAJURU",2,2,5,249,2,260,"2012"
"13580","311430 CARMO DO PARANAIBA",1,0,5,360,0,366,"2012"
"13581","311440 CARMO DO RIO CLARO",1,2,7,222,0,232,"2012"
"13582","311450 CARMOPOLIS DE MINAS",0,0,1,194,3,198,"2012"
"13583","311455 CARNEIRINHO",0,0,1,107,0,108,"2012"
"13584","311460 CARRANCAS",0,0,0,36,0,36,"2012"
"13585","311470 CARVALHOPOLIS",0,0,0,34,0,34,"2012"
"13586","311480 CARVALHOS",0,0,0,45,0,45,"2012"
"13587","311490 CASA GRANDE",0,0,0,17,0,17,"2012"
"13588","311500 CASCALHO RICO",0,0,0,23,0,23,"2012"
"13589","311510 CASSIA",0,3,23,204,0,230,"2012"
"13590","311520 CONCEICAO DA BARRA DE MINAS",0,0,0,28,1,29,"2012"
"13591","311530 CATAGUASES",2,9,44,781,0,836,"2012"
"13592","311535 CATAS ALTAS",1,1,3,65,0,70,"2012"
"13593","311540 CATAS ALTAS DA NORUEGA",0,0,1,33,0,34,"2012"
"13594","311545 CATUJI",0,2,5,111,2,120,"2012"
"13595","311547 CATUTI",0,0,3,63,7,73,"2012"
"13596","311550 CAXAMBU",0,0,1,141,112,254,"2012"
"13597","311560 CEDRO DO ABAETE",0,0,0,14,0,14,"2012"
"13598","311570 CENTRAL DE MINAS",0,0,1,44,2,47,"2012"
"13599","311580 CENTRALINA",0,0,2,67,21,90,"2012"
"13600","311590 CHACARA",0,0,1,25,0,26,"2012"
"13601","311600 CHALE",0,0,0,44,30,74,"2012"
"13602","311610 CHAPADA DO NORTE",0,2,1,141,2,146,"2012"
"13603","311615 CHAPADA GAUCHA",0,1,3,178,2,184,"2012"
"13604","311620 CHIADOR",0,0,1,25,1,27,"2012"
"13605","311630 CIPOTANEA",0,0,0,66,1,67,"2012"
"13606","311640 CLARAVAL",0,0,1,19,0,20,"2012"
"13607","311650 CLARO DOS POCOES",0,0,2,70,1,73,"2012"
"13608","311660 CLAUDIO",0,3,2,350,4,359,"2012"
"13609","311670 COIMBRA",0,0,0,74,1,75,"2012"
"13610","311680 COLUNA",1,0,2,115,0,118,"2012"
"13611","311690 COMENDADOR GOMES",0,0,0,25,0,25,"2012"
"13612","311700 COMERCINHO",0,1,4,72,0,77,"2012"
"13613","311710 CONCEICAO DA APARECIDA",0,1,2,111,1,115,"2012"
"13614","311720 CONCEICAO DAS PEDRAS",0,0,2,29,0,31,"2012"
"13615","311730 CONCEICAO DAS ALAGOAS",4,0,4,383,2,393,"2012"
"13616","311740 CONCEICAO DE IPANEMA",0,0,0,50,6,56,"2012"
"13617","311750 CONCEICAO DO MATO DENTRO",2,2,5,218,3,230,"2012"
"13618","311760 CONCEICAO DO PARA",0,0,0,35,15,50,"2012"
"13619","311770 CONCEICAO DO RIO VERDE",1,1,1,139,6,148,"2012"
"13620","311780 CONCEICAO DOS OUROS",0,1,1,127,0,129,"2012"
"13621","311783 CONEGO MARINHO",0,0,0,79,3,82,"2012"
"13622","311787 CONFINS",0,0,2,75,1,78,"2012"
"13623","311790 CONGONHAL",0,1,0,93,0,94,"2012"
"13624","311800 CONGONHAS",1,2,13,698,3,717,"2012"
"13625","311810 CONGONHAS DO NORTE",0,1,0,48,0,49,"2012"
"13626","311820 CONQUISTA",0,0,1,76,3,80,"2012"
"13627","311830 CONSELHEIRO LAFAIETE",5,6,18,1545,7,1581,"2012"
"13628","311840 CONSELHEIRO PENA",5,0,1,293,0,299,"2012"
"13629","311850 CONSOLACAO",0,0,0,15,0,15,"2012"
"13630","311860 CONTAGEM",26,32,125,8541,41,8765,"2012"
"13631","311870 COQUEIRAL",0,0,0,22,59,81,"2012"
"13632","311880 CORACAO DE JESUS",3,1,6,271,2,283,"2012"
"13633","311890 CORDISBURGO",0,0,1,75,1,77,"2012"
"13634","311900 CORDISLANDIA",0,0,3,38,0,41,"2012"
"13635","311910 CORINTO",0,3,5,290,1,299,"2012"
"13636","311920 COROACI",0,0,1,93,2,96,"2012"
"13637","311930 COROMANDEL",0,1,7,275,0,283,"2012"
"13638","311940 CORONEL FABRICIANO",6,3,16,1409,35,1469,"2012"
"13639","311950 CORONEL MURTA",0,0,0,54,27,81,"2012"
"13640","311960 CORONEL PACHECO",1,0,0,30,0,31,"2012"
"13641","311970 CORONEL XAVIER CHAVES",0,0,0,39,0,39,"2012"
"13642","311980 CORREGO DANTA",0,0,1,18,0,19,"2012"
"13643","311990 CORREGO DO BOM JESUS",0,0,1,21,1,23,"2012"
"13644","311995 CORREGO FUNDO",0,0,1,65,0,66,"2012"
"13645","312000 CORREGO NOVO",0,1,1,30,0,32,"2012"
"13646","312010 COUTO DE MAGALHAES DE MINAS",0,1,0,55,0,56,"2012"
"13647","312015 CRISOLITA",2,0,2,75,0,79,"2012"
"13648","312020 CRISTAIS",0,0,2,114,0,116,"2012"
"13649","312030 CRISTALIA",0,0,3,85,4,92,"2012"
"13650","312040 CRISTIANO OTONI",0,0,2,75,0,77,"2012"
"13651","312050 CRISTINA",0,0,1,101,0,102,"2012"
"13652","312060 CRUCILANDIA",0,1,0,45,2,48,"2012"
"13653","312070 CRUZEIRO DA FORTALEZA",0,0,2,47,0,49,"2012"
"13654","312080 CRUZILIA",0,0,1,167,1,169,"2012"
"13655","312083 CUPARAQUE",1,0,1,75,0,77,"2012"
"13656","312087 CURRAL DE DENTRO",0,0,1,78,35,114,"2012"
"13657","312090 CURVELO",3,6,15,944,3,971,"2012"
"13658","312100 DATAS",0,0,1,83,0,84,"2012"
"13659","312110 DELFIM MOREIRA",0,0,2,82,0,84,"2012"
"13660","312120 DELFINOPOLIS",0,1,5,66,0,72,"2012"
"13661","312125 DELTA",2,0,2,142,1,147,"2012"
"13662","312130 DESCOBERTO",0,0,0,49,1,50,"2012"
"13663","312140 DESTERRO DE ENTRE RIOS",0,0,0,55,1,56,"2012"
"13664","312150 DESTERRO DO MELO",0,0,1,36,0,37,"2012"
"13665","312160 DIAMANTINA",5,8,8,613,4,638,"2012"
"13666","312170 DIOGO DE VASCONCELOS",0,0,1,39,0,40,"2012"
"13667","312180 DIONISIO",0,0,1,73,1,75,"2012"
"13668","312190 DIVINESIA",0,1,0,48,0,49,"2012"
"13669","312200 DIVINO",0,0,3,276,3,282,"2012"
"13670","312210 DIVINO DAS LARANJEIRAS",0,0,1,48,0,49,"2012"
"13671","312220 DIVINOLANDIA DE MINAS",0,0,0,92,1,93,"2012"
"13672","312230 DIVINOPOLIS",15,16,51,2560,5,2647,"2012"
"13673","312235 DIVISA ALEGRE",1,1,0,81,0,83,"2012"
"13674","312240 DIVISA NOVA",0,0,1,66,0,67,"2012"
"13675","312245 DIVISOPOLIS",0,2,3,80,3,88,"2012"
"13676","312247 DOM BOSCO",0,0,0,28,1,29,"2012"
"13677","312250 DOM CAVATI",1,0,0,66,1,68,"2012"
"13678","312260 DOM JOAQUIM",0,0,1,47,2,50,"2012"
"13679","312270 DOM SILVERIO",0,0,0,47,1,48,"2012"
"13680","312280 DOM VICOSO",0,1,0,28,0,29,"2012"
"13681","312290 DONA EUSEBIA",0,2,3,55,1,61,"2012"
"13682","312300 DORES DE CAMPOS",0,0,1,102,1,104,"2012"
"13683","312310 DORES DE GUANHAES",0,0,2,61,0,63,"2012"
"13684","312320 DORES DO INDAIA",0,0,1,146,0,147,"2012"
"13685","312330 DORES DO TURVO",0,0,1,58,0,59,"2012"
"13686","312340 DORESOPOLIS",0,0,0,21,0,21,"2012"
"13687","312350 DOURADOQUARA",0,0,0,16,0,16,"2012"
"13688","312352 DURANDE",0,0,0,27,74,101,"2012"
"13689","312360 ELOI MENDES",0,0,0,283,35,318,"2012"
"13690","312370 ENGENHEIRO CALDAS",0,1,4,139,3,147,"2012"
"13691","312380 ENGENHEIRO NAVARRO",0,0,0,83,0,83,"2012"
"13692","312385 ENTRE FOLHAS",1,0,2,60,0,63,"2012"
"13693","312390 ENTRE RIOS DE MINAS",0,1,7,149,0,157,"2012"
"13694","312400 ERVALIA",1,2,4,223,1,231,"2012"
"13695","312410 ESMERALDAS",2,3,13,797,14,829,"2012"
"13696","312420 ESPERA FELIZ",1,1,4,323,3,332,"2012"
"13697","312430 ESPINOSA",1,0,4,381,9,395,"2012"
"13698","312440 ESPIRITO SANTO DO DOURADO",0,0,1,54,0,55,"2012"
"13699","312450 ESTIVA",0,0,3,124,1,128,"2012"
"13700","312460 ESTRELA DALVA",0,0,0,30,0,30,"2012"
"13701","312470 ESTRELA DO INDAIA",0,0,0,28,0,28,"2012"
"13702","312480 ESTRELA DO SUL",0,0,5,87,0,92,"2012"
"13703","312490 EUGENOPOLIS",0,1,3,114,0,118,"2012"
"13704","312500 EWBANK DA CAMARA",0,0,0,46,0,46,"2012"
"13705","312510 EXTREMA",1,1,5,488,0,495,"2012"
"13706","312520 FAMA",0,0,0,20,0,20,"2012"
"13707","312530 FARIA LEMOS",0,0,0,46,2,48,"2012"
"13708","312540 FELICIO DOS SANTOS",0,0,0,68,0,68,"2012"
"13709","312550 SAO GONCALO DO RIO PRETO",0,0,1,27,0,28,"2012"
"13710","312560 FELISBURGO",1,2,1,91,2,97,"2012"
"13711","312570 FELIXLANDIA",1,0,1,144,1,147,"2012"
"13712","312580 FERNANDES TOURINHO",0,0,1,30,1,32,"2012"
"13713","312590 FERROS",0,1,0,83,1,85,"2012"
"13714","312595 FERVEDOURO",1,2,0,140,1,144,"2012"
"13715","312600 FLORESTAL",0,0,1,67,2,70,"2012"
"13716","312610 FORMIGA",0,1,5,728,3,737,"2012"
"13717","312620 FORMOSO",0,0,0,107,0,107,"2012"
"13718","312630 FORTALEZA DE MINAS",0,0,1,45,0,46,"2012"
"13719","312640 FORTUNA DE MINAS",0,0,0,31,0,31,"2012"
"13720","312650 FRANCISCO BADARO",0,0,1,43,2,46,"2012"
"13721","312660 FRANCISCO DUMONT",0,0,1,57,1,59,"2012"
"13722","312670 FRANCISCO SA",0,2,5,296,1,304,"2012"
"13723","312675 FRANCISCOPOLIS",0,0,1,64,5,70,"2012"
"13724","312680 FREI GASPAR",0,0,0,69,2,71,"2012"
"13725","312690 FREI INOCENCIO",1,1,2,124,2,130,"2012"
"13726","312695 FREI LAGONEGRO",0,0,5,50,0,55,"2012"
"13727","312700 FRONTEIRA",0,1,2,177,0,180,"2012"
"13728","312705 FRONTEIRA DOS VALES",0,0,1,63,0,64,"2012"
"13729","312707 FRUTA DE LEITE",0,0,1,4,64,69,"2012"
"13730","312710 FRUTAL",2,3,7,696,4,712,"2012"
"13731","312720 FUNILANDIA",1,1,1,47,0,50,"2012"
"13732","312730 GALILEIA",1,1,0,101,1,104,"2012"
"13733","312733 GAMELEIRAS",0,0,2,39,27,68,"2012"
"13734","312735 GLAUCILANDIA",0,0,0,36,1,37,"2012"
"13735","312737 GOIABEIRA",1,0,3,47,0,51,"2012"
"13736","312738 GOIANA",0,0,0,27,0,27,"2012"
"13737","312740 GONCALVES",0,0,1,39,0,40,"2012"
"13738","312750 GONZAGA",1,0,1,91,2,95,"2012"
"13739","312760 GOUVEIA",1,2,5,140,2,150,"2012"
"13740","312770 GOVERNADOR VALADARES",13,6,70,3586,79,3754,"2012"
"13741","312780 GRAO MOGOL",0,1,2,146,18,167,"2012"
"13742","312790 GRUPIARA",0,0,0,11,0,11,"2012"
"13743","312800 GUANHAES",2,2,7,417,13,441,"2012"
"13744","312810 GUAPE",0,0,5,127,0,132,"2012"
"13745","312820 GUARACIABA",0,1,0,74,0,75,"2012"
"13746","312825 GUARACIAMA",1,0,3,59,0,63,"2012"
"13747","312830 GUARANESIA",0,2,4,152,83,241,"2012"
"13748","312840 GUARANI",1,0,4,122,0,127,"2012"
"13749","312850 GUARARA",0,0,0,54,0,54,"2012"
"13750","312860 GUARDA-MOR",0,0,2,36,1,39,"2012"
"13751","312870 GUAXUPE",3,15,22,587,5,632,"2012"
"13752","312880 GUIDOVAL",0,0,0,67,0,67,"2012"
"13753","312890 GUIMARANIA",1,0,2,75,1,79,"2012"
"13754","312900 GUIRICEMA",0,0,1,96,1,98,"2012"
"13755","312910 GURINHATA",0,0,0,39,0,39,"2012"
"13756","312920 HELIODORA",0,0,2,72,2,76,"2012"
"13757","312930 IAPU",1,0,0,126,1,128,"2012"
"13758","312940 IBERTIOGA",0,0,0,53,1,54,"2012"
"13759","312950 IBIA",5,1,2,224,0,232,"2012"
"13760","312960 IBIAI",0,1,2,95,2,100,"2012"
"13761","312965 IBIRACATU",0,1,3,66,0,70,"2012"
"13762","312970 IBIRACI",1,1,5,153,0,160,"2012"
"13763","312980 IBIRITE",14,11,50,2540,11,2626,"2012"
"13764","312990 IBITIURA DE MINAS",0,0,0,31,0,31,"2012"
"13765","313000 IBITURUNA",0,0,0,25,0,25,"2012"
"13766","313005 ICARAI DE MINAS",0,1,3,144,1,149,"2012"
"13767","313010 IGARAPE",5,0,9,553,5,572,"2012"
"13768","313020 IGARATINGA",0,0,1,106,4,111,"2012"
"13769","313030 IGUATAMA",0,0,0,64,0,64,"2012"
"13770","313040 IJACI",1,0,0,75,0,76,"2012"
"13771","313050 ILICINEA",0,0,1,158,1,160,"2012"
"13772","313055 IMBE DE MINAS",0,0,0,81,2,83,"2012"
"13773","313060 INCONFIDENTES",1,0,2,71,0,74,"2012"
"13774","313065 INDAIABIRA",0,0,0,74,1,75,"2012"
"13775","313070 INDIANOPOLIS",0,0,1,65,0,66,"2012"
"13776","313080 INGAI",0,1,0,28,0,29,"2012"
"13777","313090 INHAPIM",2,4,3,254,4,267,"2012"
"13778","313100 INHAUMA",0,1,0,72,1,74,"2012"
"13779","313110 INIMUTABA",0,0,2,68,0,70,"2012"
"13780","313115 IPABA",0,0,0,265,0,265,"2012"
"13781","313120 IPANEMA",3,1,1,222,17,244,"2012"
"13782","313130 IPATINGA",11,14,25,3352,38,3440,"2012"
"13783","313140 IPIACU",1,0,0,38,2,41,"2012"
"13784","313150 IPUIUNA",0,0,2,105,1,108,"2012"
"13785","313160 IRAI DE MINAS",1,0,3,90,0,94,"2012"
"13786","313170 ITABIRA",2,3,19,1544,40,1608,"2012"
"13787","313180 ITABIRINHA",0,0,4,141,0,145,"2012"
"13788","313190 ITABIRITO",4,3,23,737,1,768,"2012"
"13789","313200 ITACAMBIRA",0,0,0,49,1,50,"2012"
"13790","313210 ITACARAMBI",2,1,7,266,0,276,"2012"
"13791","313220 ITAGUARA",0,1,1,162,1,165,"2012"
"13792","313230 ITAIPE",1,0,0,186,0,187,"2012"
"13793","313240 ITAJUBA",1,0,9,1221,1,1232,"2012"
"13794","313250 ITAMARANDIBA",0,1,8,493,0,502,"2012"
"13795","313260 ITAMARATI DE MINAS",0,1,6,46,0,53,"2012"
"13796","313270 ITAMBACURI",1,2,7,383,5,398,"2012"
"13797","313280 ITAMBE DO MATO DENTRO",0,1,0,12,0,13,"2012"
"13798","313290 ITAMOGI",0,1,4,121,2,128,"2012"
"13799","313300 ITAMONTE",0,1,1,161,1,164,"2012"
"13800","313310 ITANHANDU",1,1,5,157,2,166,"2012"
"13801","313320 ITANHOMI",0,0,2,153,1,156,"2012"
"13802","313330 ITAOBIM",0,1,3,265,1,270,"2012"
"13803","313340 ITAPAGIPE",0,2,1,122,1,126,"2012"
"13804","313350 ITAPECERICA",0,3,6,175,1,185,"2012"
"13805","313360 ITAPEVA",0,0,0,117,0,117,"2012"
"13806","313370 ITATIAIUCU",1,0,2,178,0,181,"2012"
"13807","313375 ITAU DE MINAS",1,0,7,173,0,181,"2012"
"13808","313380 ITAUNA",1,2,7,1024,2,1036,"2012"
"13809","313390 ITAVERAVA",0,1,0,45,1,47,"2012"
"13810","313400 ITINGA",0,0,1,129,6,136,"2012"
"13811","313410 ITUETA",0,0,0,63,1,64,"2012"
"13812","313420 ITUIUTABA",5,1,11,1199,19,1235,"2012"
"13813","313430 ITUMIRIM",0,0,1,71,0,72,"2012"
"13814","313440 ITURAMA",2,0,2,513,0,517,"2012"
"13815","313450 ITUTINGA",0,0,0,31,0,31,"2012"
"13816","313460 JABOTICATUBAS",0,0,2,155,0,157,"2012"
"13817","313470 JACINTO",0,0,5,110,1,116,"2012"
"13818","313480 JACUI",1,1,0,99,0,101,"2012"
"13819","313490 JACUTINGA",0,0,4,322,1,327,"2012"
"13820","313500 JAGUARACU",0,0,0,29,1,30,"2012"
"13821","313505 JAIBA",1,1,22,518,30,572,"2012"
"13822","313507 JAMPRUCA",0,1,2,76,3,82,"2012"
"13823","313510 JANAUBA",2,6,42,918,4,972,"2012"
"13824","313520 JANUARIA",7,1,10,964,3,985,"2012"
"13825","313530 JAPARAIBA",0,0,0,56,1,57,"2012"
"13826","313535 JAPONVAR",1,0,2,97,1,101,"2012"
"13827","313540 JECEABA",0,0,0,51,0,51,"2012"
"13828","313545 JENIPAPO DE MINAS",0,0,0,48,17,65,"2012"
"13829","313550 JEQUERI",0,1,3,150,2,156,"2012"
"13830","313560 JEQUITAI",1,0,1,102,0,104,"2012"
"13831","313570 JEQUITIBA",0,0,0,51,0,51,"2012"
"13832","313580 JEQUITINHONHA",1,0,9,91,159,260,"2012"
"13833","313590 JESUANIA",0,0,2,48,0,50,"2012"
"13834","313600 JOAIMA",0,0,1,17,210,228,"2012"
"13835","313610 JOANESIA",0,0,0,42,0,42,"2012"
"13836","313620 JOAO MONLEVADE",18,6,15,949,3,991,"2012"
"13837","313630 JOAO PINHEIRO",1,2,13,600,12,628,"2012"
"13838","313640 JOAQUIM FELICIO",0,1,1,38,0,40,"2012"
"13839","313650 JORDANIA",2,0,3,105,16,126,"2012"
"13840","313652 JOSE GONCALVES DE MINAS",0,0,0,52,2,54,"2012"
"13841","313655 JOSE RAYDAN",0,0,2,62,0,64,"2012"
"13842","313657 JOSENOPOLIS",0,0,1,45,10,56,"2012"
"13843","313660 NOVA UNIAO",0,0,0,65,1,66,"2012"
"13844","313665 JUATUBA",0,0,2,373,4,379,"2012"
"13845","313670 JUIZ DE FORA",44,28,87,6593,44,6796,"2012"
"13846","313680 JURAMENTO",0,0,0,56,1,57,"2012"
"13847","313690 JURUAIA",0,1,0,135,0,136,"2012"
"13848","313695 JUVENILIA",2,0,1,13,50,66,"2012"
"13849","313700 LADAINHA",0,1,1,180,11,193,"2012"
"13850","313710 LAGAMAR",0,0,7,90,2,99,"2012"
"13851","313720 LAGOA DA PRATA",2,1,7,555,3,568,"2012"
"13852","313730 LAGOA DOS PATOS",0,1,0,43,0,44,"2012"
"13853","313740 LAGOA DOURADA",0,0,1,109,3,113,"2012"
"13854","313750 LAGOA FORMOSA",1,1,5,142,1,150,"2012"
"13855","313753 LAGOA GRANDE",0,0,1,93,1,95,"2012"
"13856","313760 LAGOA SANTA",0,5,9,732,7,753,"2012"
"13857","313770 LAJINHA",0,0,0,132,153,285,"2012"
"13858","313780 LAMBARI",0,3,8,226,1,238,"2012"
"13859","313790 LAMIM",0,0,2,34,1,37,"2012"
"13860","313800 LARANJAL",0,0,1,40,0,41,"2012"
"13861","313810 LASSANCE",0,0,0,85,0,85,"2012"
"13862","313820 LAVRAS",1,10,24,1264,6,1305,"2012"
"13863","313830 LEANDRO FERREIRA",0,0,0,24,3,27,"2012"
"13864","313835 LEME DO PRADO",0,0,0,59,1,60,"2012"
"13865","313840 LEOPOLDINA",0,5,10,668,0,683,"2012"
"13866","313850 LIBERDADE",0,1,0,36,0,37,"2012"
"13867","313860 LIMA DUARTE",1,1,4,172,0,178,"2012"
"13868","313862 LIMEIRA DO OESTE",0,0,1,70,0,71,"2012"
"13869","313865 LONTRA",0,1,0,89,0,90,"2012"
"13870","313867 LUISBURGO",1,0,1,13,63,78,"2012"
"13871","313868 LUISLANDIA",0,2,0,99,1,102,"2012"
"13872","313870 LUMINARIAS",0,0,1,53,2,56,"2012"
"13873","313880 LUZ",0,2,2,204,0,208,"2012"
"13874","313890 MACHACALIS",0,0,2,80,0,82,"2012"
"13875","313900 MACHADO",2,3,6,478,2,491,"2012"
"13876","313910 MADRE DE DEUS DE MINAS",0,0,1,54,0,55,"2012"
"13877","313920 MALACACHETA",0,2,8,233,7,250,"2012"
"13878","313925 MAMONAS",0,0,2,17,40,59,"2012"
"13879","313930 MANGA",0,0,1,174,154,329,"2012"
"13880","313940 MANHUACU",2,3,2,90,1235,1332,"2012"
"13881","313950 MANHUMIRIM",0,0,1,211,73,285,"2012"
"13882","313960 MANTENA",2,4,12,351,1,370,"2012"
"13883","313970 MARAVILHAS",0,0,0,69,6,75,"2012"
"13884","313980 MAR DE ESPANHA",1,3,7,132,0,143,"2012"
"13885","313990 MARIA DA FE",0,0,1,164,0,165,"2012"
"13886","314000 MARIANA",3,6,9,856,26,900,"2012"
"13887","314010 MARILAC",0,0,4,49,0,53,"2012"
"13888","314015 MARIO CAMPOS",2,1,1,197,1,202,"2012"
"13889","314020 MARIPA DE MINAS",0,0,1,25,0,26,"2012"
"13890","314030 MARLIERIA",0,1,3,53,0,57,"2012"
"13891","314040 MARMELOPOLIS",1,0,0,39,0,40,"2012"
"13892","314050 MARTINHO CAMPOS",0,0,2,131,20,153,"2012"
"13893","314053 MARTINS SOARES",0,0,0,41,87,128,"2012"
"13894","314055 MATA VERDE",1,0,4,105,1,111,"2012"
"13895","314060 MATERLANDIA",0,1,1,56,0,58,"2012"
"13896","314070 MATEUS LEME",0,0,6,399,2,407,"2012"
"13897","314080 MATIAS BARBOSA",1,0,1,161,1,164,"2012"
"13898","314085 MATIAS CARDOSO",0,0,6,116,10,132,"2012"
"13899","314090 MATIPO",0,1,6,136,138,281,"2012"
"13900","314100 MATO VERDE",0,1,1,116,6,124,"2012"
"13901","314110 MATOZINHOS",0,1,7,465,44,517,"2012"
"13902","314120 MATUTINA",0,0,0,30,0,30,"2012"
"13903","314130 MEDEIROS",1,0,1,33,0,35,"2012"
"13904","314140 MEDINA",1,6,10,254,5,276,"2012"
"13905","314150 MENDES PIMENTEL",0,0,1,55,1,57,"2012"
"13906","314160 MERCES",0,0,1,88,1,90,"2012"
"13907","314170 MESQUITA",0,1,0,68,2,71,"2012"
"13908","314180 MINAS NOVAS",0,0,4,346,11,361,"2012"
"13909","314190 MINDURI",0,0,0,52,0,52,"2012"
"13910","314200 MIRABELA",0,2,5,183,0,190,"2012"
"13911","314210 MIRADOURO",1,0,3,100,1,105,"2012"
"13912","314220 MIRAI",0,0,4,147,4,155,"2012"
"13913","314225 MIRAVANIA",0,0,1,24,31,56,"2012"
"13914","314230 MOEDA",1,0,0,39,0,40,"2012"
"13915","314240 MOEMA",0,0,0,79,1,80,"2012"
"13916","314250 MONJOLOS",0,0,0,21,0,21,"2012"
"13917","314260 MONSENHOR PAULO",0,0,1,88,1,90,"2012"
"13918","314270 MONTALVANIA",1,1,1,21,218,242,"2012"
"13919","314280 MONTE ALEGRE DE MINAS",0,0,1,125,114,240,"2012"
"13920","314290 MONTE AZUL",0,1,4,49,193,247,"2012"
"13921","314300 MONTE BELO",0,0,1,128,4,133,"2012"
"13922","314310 MONTE CARMELO",0,2,16,579,0,597,"2012"
"13923","314315 MONTE FORMOSO",1,1,0,45,13,60,"2012"
"13924","314320 MONTE SANTO DE MINAS",1,0,1,209,1,212,"2012"
"13925","314330 MONTES CLAROS",14,17,132,5644,24,5831,"2012"
"13926","314340 MONTE SIAO",0,1,2,195,1,199,"2012"
"13927","314345 MONTEZUMA",0,1,0,65,2,68,"2012"
"13928","314350 MORADA NOVA DE MINAS",1,0,1,77,1,80,"2012"
"13929","314360 MORRO DA GARCA",0,0,1,29,0,30,"2012"
"13930","314370 MORRO DO PILAR",0,0,0,28,1,29,"2012"
"13931","314380 MUNHOZ",1,0,0,43,0,44,"2012"
"13932","314390 MURIAE",3,12,26,1290,2,1333,"2012"
"13933","314400 MUTUM",0,2,4,293,19,318,"2012"
"13934","314410 MUZAMBINHO",0,0,5,230,1,236,"2012"
"13935","314420 NACIP RAYDAN",1,0,1,32,0,34,"2012"
"13936","314430 NANUQUE",1,0,10,482,0,493,"2012"
"13937","314435 NAQUE",0,0,1,90,1,92,"2012"
"13938","314437 NATALANDIA",0,0,0,49,2,51,"2012"
"13939","314440 NATERCIA",0,0,0,37,0,37,"2012"
"13940","314450 NAZARENO",0,1,3,76,1,81,"2012"
"13941","314460 NEPOMUCENO",1,1,1,266,4,273,"2012"
"13942","314465 NINHEIRA",1,0,5,106,2,114,"2012"
"13943","314467 NOVA BELEM",0,0,0,47,1,48,"2012"
"13944","314470 NOVA ERA",3,2,0,215,4,224,"2012"
"13945","314480 NOVA LIMA",7,5,23,1258,19,1312,"2012"
"13946","314490 NOVA MODICA",0,0,0,25,0,25,"2012"
"13947","314500 NOVA PONTE",0,1,0,170,2,173,"2012"
"13948","314505 NOVA PORTEIRINHA",0,2,4,81,1,88,"2012"
"13949","314510 NOVA RESENDE",0,1,5,214,1,221,"2012"
"13950","314520 NOVA SERRANA",3,7,10,1269,31,1320,"2012"
"13951","314530 NOVO CRUZEIRO",3,3,6,443,13,468,"2012"
"13952","314535 NOVO ORIENTE DE MINAS",0,0,0,98,4,102,"2012"
"13953","314537 NOVORIZONTE",0,0,2,23,42,67,"2012"
"13954","314540 OLARIA",0,0,0,18,1,19,"2012"
"13955","314545 OLHOS-D'AGUA",0,0,1,81,2,84,"2012"
"13956","314550 OLIMPIO NORONHA",0,1,1,25,0,27,"2012"
"13957","314560 OLIVEIRA",0,1,2,416,4,423,"2012"
"13958","314570 OLIVEIRA FORTES",0,0,0,16,0,16,"2012"
"13959","314580 ONCA DE PITANGUI",0,0,0,28,3,31,"2012"
"13960","314585 ORATORIOS",1,0,0,66,0,67,"2012"
"13961","314587 ORIZANIA",0,0,1,104,6,111,"2012"
"13962","314590 OURO BRANCO",0,2,9,520,2,533,"2012"
"13963","314600 OURO FINO",2,0,3,321,0,326,"2012"
"13964","314610 OURO PRETO",6,3,23,824,40,896,"2012"
"13965","314620 OURO VERDE DE MINAS",0,1,3,101,1,106,"2012"
"13966","314625 PADRE CARVALHO",0,0,0,6,80,86,"2012"
"13967","314630 PADRE PARAISO",3,1,5,272,2,283,"2012"
"13968","314640 PAINEIRAS",1,0,0,41,1,43,"2012"
"13969","314650 PAINS",1,0,2,83,0,86,"2012"
"13970","314655 PAI PEDRO",0,1,2,59,1,63,"2012"
"13971","314660 PAIVA",0,0,1,17,0,18,"2012"
"13972","314670 PALMA",0,0,0,48,0,48,"2012"
"13973","314675 PALMOPOLIS",0,0,1,73,0,74,"2012"
"13974","314690 PAPAGAIOS",0,1,3,161,8,173,"2012"
"13975","314700 PARACATU",3,4,21,1233,18,1279,"2012"
"13976","314710 PARA DE MINAS",8,4,12,1014,38,1076,"2012"
"13977","314720 PARAGUACU",0,1,3,238,2,244,"2012"
"13978","314730 PARAISOPOLIS",0,0,1,211,1,213,"2012"
"13979","314740 PARAOPEBA",0,0,3,270,1,274,"2012"
"13980","314750 PASSABEM",0,0,0,12,0,12,"2012"
"13981","314760 PASSA QUATRO",1,1,1,196,2,201,"2012"
"13982","314770 PASSA TEMPO",0,0,2,68,0,70,"2012"
"13983","314780 PASSA-VINTE",0,0,0,14,0,14,"2012"
"13984","314790 PASSOS",5,5,25,1497,2,1534,"2012"
"13985","314795 PATIS",2,0,2,64,0,68,"2012"
"13986","314800 PATOS DE MINAS",1,0,29,1634,13,1677,"2012"
"13987","314810 PATROCINIO",7,3,8,1161,7,1186,"2012"
"13988","314820 PATROCINIO DO MURIAE",0,0,1,55,0,56,"2012"
"13989","314830 PAULA CANDIDO",0,1,1,82,2,86,"2012"
"13990","314840 PAULISTAS",0,0,2,46,1,49,"2012"
"13991","314850 PAVAO",0,0,4,88,1,93,"2012"
"13992","314860 PECANHA",0,1,2,234,3,240,"2012"
"13993","314870 PEDRA AZUL",4,14,22,289,4,333,"2012"
"13994","314875 PEDRA BONITA",0,0,0,104,7,111,"2012"
"13995","314880 PEDRA DO ANTA",1,0,0,32,4,37,"2012"
"13996","314890 PEDRA DO INDAIA",0,0,1,39,0,40,"2012"
"13997","314900 PEDRA DOURADA",0,0,0,26,1,27,"2012"
"13998","314910 PEDRALVA",1,1,0,123,0,125,"2012"
"13999","314915 PEDRAS DE MARIA DA CRUZ",0,1,1,139,0,141,"2012"
"14000","314920 PEDRINOPOLIS",0,0,1,30,0,31,"2012"
"14001","314930 PEDRO LEOPOLDO",0,5,12,813,19,849,"2012"
"14002","314940 PEDRO TEIXEIRA",0,0,0,18,0,18,"2012"
"14003","314950 PEQUERI",0,0,0,30,0,30,"2012"
"14004","314960 PEQUI",0,0,4,47,0,51,"2012"
"14005","314970 PERDIGAO",0,1,6,119,10,136,"2012"
"14006","314980 PERDIZES",1,1,2,168,1,173,"2012"
"14007","314990 PERDOES",1,1,1,164,0,167,"2012"
"14008","314995 PERIQUITO",0,1,2,116,3,122,"2012"
"14009","315000 PESCADOR",0,0,0,31,2,33,"2012"
"14010","315010 PIAU",0,0,0,19,0,19,"2012"
"14011","315015 PIEDADE DE CARATINGA",0,1,1,124,0,126,"2012"
"14012","315020 PIEDADE DE PONTE NOVA",0,1,0,52,1,54,"2012"
"14013","315030 PIEDADE DO RIO GRANDE",0,0,0,51,0,51,"2012"
"14014","315040 PIEDADE DOS GERAIS",0,0,1,41,1,43,"2012"
"14015","315050 PIMENTA",0,1,1,74,0,76,"2012"
"14016","315053 PINGO-D'AGUA",0,0,1,40,0,41,"2012"
"14017","315057 PINTOPOLIS",0,0,0,66,2,68,"2012"
"14018","315060 PIRACEMA",0,1,1,43,0,45,"2012"
"14019","315070 PIRAJUBA",0,0,2,64,1,67,"2012"
"14020","315080 PIRANGA",0,0,3,133,3,139,"2012"
"14021","315090 PIRANGUCU",0,1,0,76,0,77,"2012"
"14022","315100 PIRANGUINHO",0,1,1,108,0,110,"2012"
"14023","315110 PIRAPETINGA",0,0,2,142,0,144,"2012"
"14024","315120 PIRAPORA",3,7,22,779,1,812,"2012"
"14025","315130 PIRAUBA",1,1,0,141,0,143,"2012"
"14026","315140 PITANGUI",1,3,6,167,175,352,"2012"
"14027","315150 PIUMHI",0,0,1,379,0,380,"2012"
"14028","315160 PLANURA",0,2,1,164,0,167,"2012"
"14029","315170 POCO FUNDO",0,0,0,176,1,177,"2012"
"14030","315180 POCOS DE CALDAS",4,8,59,1937,12,2020,"2012"
"14031","315190 POCRANE",0,1,1,91,20,113,"2012"
"14032","315200 POMPEU",3,3,2,398,0,406,"2012"
"14033","315210 PONTE NOVA",0,3,11,690,2,706,"2012"
"14034","315213 PONTO CHIQUE",1,2,0,55,1,59,"2012"
"14035","315217 PONTO DOS VOLANTES",2,0,1,122,4,129,"2012"
"14036","315220 PORTEIRINHA",2,2,12,469,2,487,"2012"
"14037","315230 PORTO FIRME",0,0,2,96,8,106,"2012"
"14038","315240 POTE",0,0,1,197,1,199,"2012"
"14039","315250 POUSO ALEGRE",6,3,24,1794,8,1835,"2012"
"14040","315260 POUSO ALTO",0,0,0,64,0,64,"2012"
"14041","315270 PRADOS",0,0,0,81,0,81,"2012"
"14042","315280 PRATA",1,2,3,317,2,325,"2012"
"14043","315290 PRATAPOLIS",0,1,2,87,1,91,"2012"
"14044","315300 PRATINHA",0,0,0,38,2,40,"2012"
"14045","315310 PRESIDENTE BERNARDES",0,0,0,51,0,51,"2012"
"14046","315320 PRESIDENTE JUSCELINO",0,0,2,33,0,35,"2012"
"14047","315330 PRESIDENTE KUBITSCHEK",0,1,2,43,1,47,"2012"
"14048","315340 PRESIDENTE OLEGARIO",1,2,2,186,2,193,"2012"
"14049","315350 ALTO JEQUITIBA",0,0,0,84,17,101,"2012"
"14050","315360 PRUDENTE DE MORAIS",0,3,3,133,1,140,"2012"
"14051","315370 QUARTEL GERAL",1,0,0,31,0,32,"2012"
"14052","315380 QUELUZITO",0,0,0,12,0,12,"2012"
"14053","315390 RAPOSOS",1,1,3,190,4,199,"2012"
"14054","315400 RAUL SOARES",0,1,5,223,5,234,"2012"
"14055","315410 RECREIO",0,0,1,84,0,85,"2012"
"14056","315415 REDUTO",0,0,1,5,100,106,"2012"
"14057","315420 RESENDE COSTA",0,0,0,147,0,147,"2012"
"14058","315430 RESPLENDOR",8,1,4,207,3,223,"2012"
"14059","315440 RESSAQUINHA",0,0,0,48,0,48,"2012"
"14060","315445 RIACHINHO",1,3,4,106,2,116,"2012"
"14061","315450 RIACHO DOS MACHADOS",0,0,0,124,3,127,"2012"
"14062","315460 RIBEIRAO DAS NEVES",16,32,52,4600,39,4739,"2012"
"14063","315470 RIBEIRAO VERMELHO",0,0,1,39,0,40,"2012"
"14064","315480 RIO ACIMA",0,2,4,137,3,146,"2012"
"14065","315490 RIO CASCA",0,1,2,171,2,176,"2012"
"14066","315500 RIO DOCE",0,0,0,19,0,19,"2012"
"14067","315510 RIO DO PRADO",0,0,1,61,2,64,"2012"
"14068","315520 RIO ESPERA",0,0,0,23,0,23,"2012"
"14069","315530 RIO MANSO",0,0,0,39,0,39,"2012"
"14070","315540 RIO NOVO",2,2,2,78,0,84,"2012"
"14071","315550 RIO PARANAIBA",0,1,0,129,0,130,"2012"
"14072","315560 RIO PARDO DE MINAS",0,3,8,357,5,373,"2012"
"14073","315570 RIO PIRACICABA",4,1,3,155,1,164,"2012"
"14074","315580 RIO POMBA",0,2,4,192,1,199,"2012"
"14075","315590 RIO PRETO",0,0,0,36,0,36,"2012"
"14076","315600 RIO VERMELHO",2,0,3,190,2,197,"2012"
"14077","315610 RITAPOLIS",0,0,0,39,0,39,"2012"
"14078","315620 ROCHEDO DE MINAS",0,0,0,36,0,36,"2012"
"14079","315630 RODEIRO",0,1,4,111,0,116,"2012"
"14080","315640 ROMARIA",0,1,0,37,0,38,"2012"
"14081","315645 ROSARIO DA LIMEIRA",0,0,2,59,0,61,"2012"
"14082","315650 RUBELITA",0,0,1,17,71,89,"2012"
"14083","315660 RUBIM",3,0,1,105,2,111,"2012"
"14084","315670 SABARA",6,9,24,1778,6,1823,"2012"
"14085","315680 SABINOPOLIS",0,0,1,208,4,213,"2012"
"14086","315690 SACRAMENTO",0,0,2,296,5,303,"2012"
"14087","315700 SALINAS",0,1,1,56,436,494,"2012"
"14088","315710 SALTO DA DIVISA",1,2,4,63,11,81,"2012"
"14089","315720 SANTA BARBARA",0,1,11,331,19,362,"2012"
"14090","315725 SANTA BARBARA DO LESTE",1,0,2,90,1,94,"2012"
"14091","315727 SANTA BARBARA DO MONTE VERDE",0,0,1,28,1,30,"2012"
"14092","315730 SANTA BARBARA DO TUGURIO",0,1,4,35,0,40,"2012"
"14093","315733 SANTA CRUZ DE MINAS",0,1,1,71,1,74,"2012"
"14094","315737 SANTA CRUZ DE SALINAS",0,0,0,19,37,56,"2012"
"14095","315740 SANTA CRUZ DO ESCALVADO",0,0,1,37,1,39,"2012"
"14096","315750 SANTA EFIGENIA DE MINAS",0,0,1,63,0,64,"2012"
"14097","315760 SANTA FE DE MINAS",0,0,0,53,0,53,"2012"
"14098","315765 SANTA HELENA DE MINAS",0,0,2,84,14,100,"2012"
"14099","315770 SANTA JULIANA",0,0,2,148,2,152,"2012"
"14100","315780 SANTA LUZIA",7,9,44,3135,7,3202,"2012"
"14101","315790 SANTA MARGARIDA",2,2,2,156,78,240,"2012"
"14102","315800 SANTA MARIA DE ITABIRA",0,1,1,122,1,125,"2012"
"14103","315810 SANTA MARIA DO SALTO",0,2,0,39,3,44,"2012"
"14104","315820 SANTA MARIA DO SUACUI",0,0,3,213,2,218,"2012"
"14105","315830 SANTANA DA VARGEM",0,0,0,15,59,74,"2012"
"14106","315840 SANTANA DE CATAGUASES",0,1,3,34,0,38,"2012"
"14107","315850 SANTANA DE PIRAPAMA",4,0,0,57,1,62,"2012"
"14108","315860 SANTANA DO DESERTO",0,0,0,44,0,44,"2012"
"14109","315870 SANTANA DO GARAMBEU",0,0,1,28,1,30,"2012"
"14110","315880 SANTANA DO JACARE",0,0,1,39,0,40,"2012"
"14111","315890 SANTANA DO MANHUACU",0,0,0,7,92,99,"2012"
"14112","315895 SANTANA DO PARAISO",1,0,5,454,3,463,"2012"
"14113","315900 SANTANA DO RIACHO",0,0,1,41,1,43,"2012"
"14114","315910 SANTANA DOS MONTES",0,0,0,40,0,40,"2012"
"14115","315920 SANTA RITA DE CALDAS",0,1,2,90,0,93,"2012"
"14116","315930 SANTA RITA DE JACUTINGA",0,1,0,50,0,51,"2012"
"14117","315935 SANTA RITA DE MINAS",0,0,5,99,1,105,"2012"
"14118","315940 SANTA RITA DE IBITIPOCA",0,0,0,32,0,32,"2012"
"14119","315950 SANTA RITA DO ITUETO",0,0,3,75,1,79,"2012"
"14120","315960 SANTA RITA DO SAPUCAI",0,1,5,494,3,503,"2012"
"14121","315970 SANTA ROSA DA SERRA",0,0,0,30,0,30,"2012"
"14122","315980 SANTA VITORIA",3,0,1,240,11,255,"2012"
"14123","315990 SANTO ANTONIO DO AMPARO",2,2,6,211,8,229,"2012"
"14124","316000 SANTO ANTONIO DO AVENTUREIRO",0,0,0,32,0,32,"2012"
"14125","316010 SANTO ANTONIO DO GRAMA",2,0,2,67,1,72,"2012"
"14126","316020 SANTO ANTONIO DO ITAMBE",0,0,0,49,0,49,"2012"
"14127","316030 SANTO ANTONIO DO JACINTO",1,4,3,138,4,150,"2012"
"14128","316040 SANTO ANTONIO DO MONTE",1,1,9,300,1,312,"2012"
"14129","316045 SANTO ANTONIO DO RETIRO",0,0,0,53,48,101,"2012"
"14130","316050 SANTO ANTONIO DO RIO ABAIXO",0,0,0,16,1,17,"2012"
"14131","316060 SANTO HIPOLITO",0,0,1,28,0,29,"2012"
"14132","316070 SANTOS DUMONT",3,4,7,505,2,521,"2012"
"14133","316080 SAO BENTO ABADE",0,1,0,66,0,67,"2012"
"14134","316090 SAO BRAS DO SUACUI",0,0,0,28,1,29,"2012"
"14135","316095 SAO DOMINGOS DAS DORES",1,1,0,72,1,75,"2012"
"14136","316100 SAO DOMINGOS DO PRATA",3,1,5,200,3,212,"2012"
"14137","316105 SAO FELIX DE MINAS",0,0,1,30,1,32,"2012"
"14138","316110 SAO FRANCISCO",1,3,16,786,6,812,"2012"
"14139","316120 SAO FRANCISCO DE PAULA",0,0,0,64,1,65,"2012"
"14140","316130 SAO FRANCISCO DE SALES",0,0,0,71,1,72,"2012"
"14141","316140 SAO FRANCISCO DO GLORIA",0,2,0,54,0,56,"2012"
"14142","316150 SAO GERALDO",0,0,2,90,0,92,"2012"
"14143","316160 SAO GERALDO DA PIEDADE",0,0,0,48,1,49,"2012"
"14144","316165 SAO GERALDO DO BAIXIO",1,0,1,34,1,37,"2012"
"14145","316170 SAO GONCALO DO ABAETE",0,1,1,40,2,44,"2012"
"14146","316180 SAO GONCALO DO PARA",0,0,3,147,0,150,"2012"
"14147","316190 SAO GONCALO DO RIO ABAIXO",1,1,1,117,2,122,"2012"
"14148","316200 SAO GONCALO DO SAPUCAI",0,2,7,333,1,343,"2012"
"14149","316210 SAO GOTARDO",1,2,4,526,4,537,"2012"
"14150","316220 SAO JOAO BATISTA DO GLORIA",0,0,1,73,1,75,"2012"
"14151","316225 SAO JOAO DA LAGOA",0,1,0,38,1,40,"2012"
"14152","316230 SAO JOAO DA MATA",0,0,0,31,0,31,"2012"
"14153","316240 SAO JOAO DA PONTE",0,3,7,284,0,294,"2012"
"14154","316245 SAO JOAO DAS MISSOES",1,1,3,112,138,255,"2012"
"14155","316250 SAO JOAO DEL REI",2,2,10,900,18,932,"2012"
"14156","316255 SAO JOAO DO MANHUACU",0,0,1,38,150,189,"2012"
"14157","316257 SAO JOAO DO MANTENINHA",0,0,2,51,0,53,"2012"
"14158","316260 SAO JOAO DO ORIENTE",0,0,1,96,0,97,"2012"
"14159","316265 SAO JOAO DO PACUI",0,0,0,35,1,36,"2012"
"14160","316270 SAO JOAO DO PARAISO",2,0,2,254,2,260,"2012"
"14161","316280 SAO JOAO EVANGELISTA",0,0,1,197,2,200,"2012"
"14162","316290 SAO JOAO NEPOMUCENO",1,1,4,279,0,285,"2012"
"14163","316292 SAO JOAQUIM DE BICAS",0,0,5,377,6,388,"2012"
"14164","316294 SAO JOSE DA BARRA",0,0,2,71,1,74,"2012"
"14165","316295 SAO JOSE DA LAPA",0,1,2,255,5,263,"2012"
"14166","316300 SAO JOSE DA SAFIRA",0,0,2,57,1,60,"2012"
"14167","316310 SAO JOSE DA VARGINHA",0,0,0,43,1,44,"2012"
"14168","316320 SAO JOSE DO ALEGRE",0,0,1,44,0,45,"2012"
"14169","316330 SAO JOSE DO DIVINO",0,0,0,46,0,46,"2012"
"14170","316340 SAO JOSE DO GOIABAL",0,1,0,68,1,70,"2012"
"14171","316350 SAO JOSE DO JACURI",0,0,1,70,1,72,"2012"
"14172","316360 SAO JOSE DO MANTIMENTO",0,0,0,16,18,34,"2012"
"14173","316370 SAO LOURENCO",2,1,7,516,6,532,"2012"
"14174","316380 SAO MIGUEL DO ANTA",0,1,1,73,0,75,"2012"
"14175","316390 SAO PEDRO DA UNIAO",0,3,0,52,0,55,"2012"
"14176","316400 SAO PEDRO DOS FERROS",0,0,1,74,2,77,"2012"
"14177","316410 SAO PEDRO DO SUACUI",0,0,0,57,0,57,"2012"
"14178","316420 SAO ROMAO",1,1,7,117,1,127,"2012"
"14179","316430 SAO ROQUE DE MINAS",0,0,0,54,0,54,"2012"
"14180","316440 SAO SEBASTIAO DA BELA VISTA",0,0,0,72,0,72,"2012"
"14181","316443 SAO SEBASTIAO DA VARGEM ALEGRE",0,0,2,42,0,44,"2012"
"14182","316447 SAO SEBASTIAO DO ANTA",2,0,1,91,0,94,"2012"
"14183","316450 SAO SEBASTIAO DO MARANHAO",0,0,0,99,2,101,"2012"
"14184","316460 SAO SEBASTIAO DO OESTE",0,0,1,70,0,71,"2012"
"14185","316470 SAO SEBASTIAO DO PARAISO",6,1,11,804,5,827,"2012"
"14186","316480 SAO SEBASTIAO DO RIO PRETO",0,0,0,24,0,24,"2012"
"14187","316490 SAO SEBASTIAO DO RIO VERDE",0,0,0,17,0,17,"2012"
"14188","316500 SAO TIAGO",0,0,5,97,1,103,"2012"
"14189","316510 SAO TOMAS DE AQUINO",0,0,0,83,1,84,"2012"
"14190","316520 SAO THOME DAS LETRAS",0,0,1,69,3,73,"2012"
"14191","316530 SAO VICENTE DE MINAS",0,0,3,73,2,78,"2012"
"14192","316540 SAPUCAI-MIRIM",0,0,1,64,1,66,"2012"
"14193","316550 SARDOA",2,1,4,66,2,75,"2012"
"14194","316553 SARZEDO",1,2,8,424,2,437,"2012"
"14195","316555 SETUBINHA",0,1,6,151,27,185,"2012"
"14196","316556 SEM-PEIXE",0,0,1,16,1,18,"2012"
"14197","316557 SENADOR AMARAL",0,0,2,82,1,85,"2012"
"14198","316560 SENADOR CORTES",0,1,0,29,0,30,"2012"
"14199","316570 SENADOR FIRMINO",0,1,1,76,0,78,"2012"
"14200","316580 SENADOR JOSE BENTO",0,0,0,14,0,14,"2012"
"14201","316590 SENADOR MODESTINO GONCALVES",0,1,0,45,0,46,"2012"
"14202","316600 SENHORA DE OLIVEIRA",0,0,1,61,0,62,"2012"
"14203","316610 SENHORA DO PORTO",1,0,1,33,1,36,"2012"
"14204","316620 SENHORA DOS REMEDIOS",0,0,1,90,1,92,"2012"
"14205","316630 SERICITA",1,0,3,89,3,96,"2012"
"14206","316640 SERITINGA",0,0,0,17,0,17,"2012"
"14207","316650 SERRA AZUL DE MINAS",1,0,2,53,4,60,"2012"
"14208","316660 SERRA DA SAUDADE",0,0,0,9,0,9,"2012"
"14209","316670 SERRA DOS AIMORES",0,0,5,91,0,96,"2012"
"14210","316680 SERRA DO SALITRE",0,1,6,115,1,123,"2012"
"14211","316690 SERRANIA",1,0,0,86,4,91,"2012"
"14212","316695 SERRANOPOLIS DE MINAS",0,1,0,41,0,42,"2012"
"14213","316700 SERRANOS",0,0,0,19,0,19,"2012"
"14214","316710 SERRO",0,0,3,220,5,228,"2012"
"14215","316720 SETE LAGOAS",14,10,40,2824,18,2906,"2012"
"14216","316730 SILVEIRANIA",0,0,0,18,1,19,"2012"
"14217","316740 SILVIANOPOLIS",0,0,0,51,0,51,"2012"
"14218","316750 SIMAO PEREIRA",0,0,0,33,0,33,"2012"
"14219","316760 SIMONESIA",0,0,0,22,247,269,"2012"
"14220","316770 SOBRALIA",0,1,0,59,0,60,"2012"
"14221","316780 SOLEDADE DE MINAS",0,1,1,55,4,61,"2012"
"14222","316790 TABULEIRO",1,1,0,29,0,31,"2012"
"14223","316800 TAIOBEIRAS",0,2,6,455,5,468,"2012"
"14224","316805 TAPARUBA",0,0,2,37,1,40,"2012"
"14225","316810 TAPIRA",0,0,0,56,0,56,"2012"
"14226","316820 TAPIRAI",1,0,0,14,0,15,"2012"
"14227","316830 TAQUARACU DE MINAS",0,0,2,35,1,38,"2012"
"14228","316840 TARUMIRIM",0,1,3,129,5,138,"2012"
"14229","316850 TEIXEIRAS",1,0,3,121,3,128,"2012"
"14230","316860 TEOFILO OTONI",2,6,39,1733,16,1796,"2012"
"14231","316870 TIMOTEO",0,1,10,1055,32,1098,"2012"
"14232","316880 TIRADENTES",0,0,1,71,0,72,"2012"
"14233","316890 TIROS",0,1,0,47,0,48,"2012"
"14234","316900 TOCANTINS",0,0,4,189,0,193,"2012"
"14235","316905 TOCOS DO MOJI",0,0,0,32,1,33,"2012"
"14236","316910 TOLEDO",0,1,0,92,0,93,"2012"
"14237","316920 TOMBOS",2,0,0,102,0,104,"2012"
"14238","316930 TRES CORACOES",4,2,16,981,28,1031,"2012"
"14239","316935 TRES MARIAS",0,2,2,375,12,391,"2012"
"14240","316940 TRES PONTAS",2,1,5,169,598,775,"2012"
"14241","316950 TUMIRITINGA",0,0,0,90,1,91,"2012"
"14242","316960 TUPACIGUARA",1,2,4,167,4,178,"2012"
"14243","316970 TURMALINA",1,1,1,250,3,256,"2012"
"14244","316980 TURVOLANDIA",0,0,0,48,0,48,"2012"
"14245","316990 UBA",5,2,32,1335,4,1378,"2012"
"14246","317000 UBAI",1,1,1,149,2,154,"2012"
"14247","317005 UBAPORANGA",0,0,1,151,3,155,"2012"
"14248","317010 UBERABA",25,21,62,3908,15,4031,"2012"
"14249","317020 UBERLANDIA",22,25,78,8654,45,8824,"2012"
"14250","317030 UMBURATIBA",1,0,1,32,0,34,"2012"
"14251","317040 UNAI",4,1,10,1075,39,1129,"2012"
"14252","317043 UNIAO DE MINAS",0,0,0,50,3,53,"2012"
"14253","317047 URUANA DE MINAS",0,0,0,36,2,38,"2012"
"14254","317050 URUCANIA",0,1,3,132,0,136,"2012"
"14255","317052 URUCUIA",0,2,3,119,4,128,"2012"
"14256","317057 VARGEM ALEGRE",0,0,3,84,2,89,"2012"
"14257","317060 VARGEM BONITA",0,0,0,21,0,21,"2012"
"14258","317065 VARGEM GRANDE DO RIO PARDO",0,0,0,52,2,54,"2012"
"14259","317070 VARGINHA",5,7,21,1562,16,1611,"2012"
"14260","317075 VARJAO DE MINAS",2,3,5,92,1,103,"2012"
"14261","317080 VARZEA DA PALMA",1,2,6,435,2,446,"2012"
"14262","317090 VARZELANDIA",0,1,11,254,4,270,"2012"
"14263","317100 VAZANTE",0,2,1,236,0,239,"2012"
"14264","317103 VERDELANDIA",0,1,6,139,2,148,"2012"
"14265","317107 VEREDINHA",0,0,1,62,1,64,"2012"
"14266","317110 VERISSIMO",0,0,0,34,0,34,"2012"
"14267","317115 VERMELHO NOVO",0,0,0,63,2,65,"2012"
"14268","317120 VESPASIANO",7,8,18,1640,7,1680,"2012"
"14269","317130 VICOSA",5,4,14,911,25,959,"2012"
"14270","317140 VIEIRAS",1,1,3,42,0,47,"2012"
"14271","317150 MATHIAS LOBATO",0,0,2,48,1,51,"2012"
"14272","317160 VIRGEM DA LAPA",0,1,3,111,16,131,"2012"
"14273","317170 VIRGINIA",1,0,1,82,2,86,"2012"
"14274","317180 VIRGINOPOLIS",0,2,1,109,3,115,"2012"
"14275","317190 VIRGOLANDIA",1,0,5,52,3,61,"2012"
"14276","317200 VISCONDE DO RIO BRANCO",1,0,4,506,5,516,"2012"
"14277","317210 VOLTA GRANDE",0,1,2,46,0,49,"2012"
"14278","317220 WENCESLAU BRAZ",0,0,0,20,0,20,"2012"
"14279","MUNICIPIO IGNORADO - ES",0,0,1,9,0,10,"2012"
"14280","320010 AFONSO CLAUDIO",0,0,3,412,1,416,"2012"
"14281","320013 AGUIA BRANCA",0,0,3,115,0,118,"2012"
"14282","320016 AGUA DOCE DO NORTE",1,2,1,160,4,168,"2012"
"14283","320020 ALEGRE",1,2,8,393,1,405,"2012"
"14284","320030 ALFREDO CHAVES",1,0,2,137,1,141,"2012"
"14285","320035 ALTO RIO NOVO",0,0,0,88,4,92,"2012"
"14286","320040 ANCHIETA",1,0,7,353,6,367,"2012"
"14287","320050 APIACA",0,0,2,72,0,74,"2012"
"14288","320060 ARACRUZ",4,2,11,1371,10,1398,"2012"
"14289","320070 ATILIO VIVACQUA",0,2,6,137,0,145,"2012"
"14290","320080 BAIXO GUANDU",0,1,3,276,71,351,"2012"
"14291","320090 BARRA DE SAO FRANCISCO",3,1,10,634,0,648,"2012"
"14292","320100 BOA ESPERANCA",0,0,1,150,10,161,"2012"
"14293","320110 BOM JESUS DO NORTE",2,1,2,95,0,100,"2012"
"14294","320115 BREJETUBA",0,0,0,197,1,198,"2012"
"14295","320120 CACHOEIRO DE ITAPEMIRIM",1,13,44,2713,3,2774,"2012"
"14296","320130 CARIACICA",127,16,66,5766,58,6033,"2012"
"14297","320140 CASTELO",0,1,4,418,2,425,"2012"
"14298","320150 COLATINA",5,5,12,1370,6,1398,"2012"
"14299","320160 CONCEICAO DA BARRA",0,1,1,357,28,387,"2012"
"14300","320170 CONCEICAO DO CASTELO",0,0,2,166,0,168,"2012"
"14301","320180 DIVINO DE SAO LOURENCO",2,0,0,53,1,56,"2012"
"14302","320190 DOMINGOS MARTINS",0,0,7,391,1,399,"2012"
"14303","320200 DORES DO RIO PRETO",0,0,5,76,0,81,"2012"
"14304","320210 ECOPORANGA",0,0,6,307,0,313,"2012"
"14305","320220 FUNDAO",2,2,3,242,0,249,"2012"
"14306","320225 GOVERNADOR LINDENBERG",0,1,3,108,2,114,"2012"
"14307","320230 GUACUI",1,1,7,452,4,465,"2012"
"14308","320240 GUARAPARI",25,3,19,1489,22,1558,"2012"
"14309","320245 IBATIBA",0,0,6,299,10,315,"2012"
"14310","320250 IBIRACU",0,0,1,156,0,157,"2012"
"14311","320255 IBITIRAMA",0,0,2,142,1,145,"2012"
"14312","320260 ICONHA",0,0,3,141,0,144,"2012"
"14313","320265 IRUPI",0,1,4,155,20,180,"2012"
"14314","320270 ITAGUACU",0,0,1,122,19,142,"2012"
"14315","320280 ITAPEMIRIM",2,3,10,463,3,481,"2012"
"14316","320290 ITARANA",0,0,2,94,2,98,"2012"
"14317","320300 IUNA",2,5,9,345,22,383,"2012"
"14318","320305 JAGUARE",1,3,10,397,4,415,"2012"
"14319","320310 JERONIMO MONTEIRO",0,1,1,123,0,125,"2012"
"14320","320313 JOAO NEIVA",2,0,3,197,2,204,"2012"
"14321","320316 LARANJA DA TERRA",0,0,0,92,9,101,"2012"
"14322","320320 LINHARES",6,2,23,1909,421,2361,"2012"
"14323","320330 MANTENOPOLIS",0,0,5,166,12,183,"2012"
"14324","320332 MARATAIZES",0,3,7,482,0,492,"2012"
"14325","320334 MARECHAL FLORIANO",0,0,5,166,0,171,"2012"
"14326","320335 MARILANDIA",0,0,1,117,1,119,"2012"
"14327","320340 MIMOSO DO SUL",0,1,3,301,0,305,"2012"
"14328","320350 MONTANHA",0,1,6,266,6,279,"2012"
"14329","320360 MUCURICI",0,0,2,65,0,67,"2012"
"14330","320370 MUNIZ FREIRE",3,0,5,245,0,253,"2012"
"14331","320380 MUQUI",1,1,8,148,0,158,"2012"
"14332","320390 NOVA VENECIA",2,1,5,620,3,631,"2012"
"14333","320400 PANCAS",0,0,0,234,2,236,"2012"
"14334","320405 PEDRO CANARIO",0,1,4,171,163,339,"2012"
"14335","320410 PINHEIROS",0,0,0,45,314,359,"2012"
"14336","320420 PIUMA",2,1,3,279,0,285,"2012"
"14337","320425 PONTO BELO",0,0,4,63,2,69,"2012"
"14338","320430 PRESIDENTE KENNEDY",0,0,7,162,1,170,"2012"
"14339","320435 RIO BANANAL",1,0,2,193,32,228,"2012"
"14340","320440 RIO NOVO DO SUL",0,1,4,143,2,150,"2012"
"14341","320450 SANTA LEOPOLDINA",1,0,1,113,2,117,"2012"
"14342","320455 SANTA MARIA DE JETIBA",3,2,4,504,3,516,"2012"
"14343","320460 SANTA TERESA",1,1,6,263,0,271,"2012"
"14344","320465 SAO DOMINGOS DO NORTE",1,1,2,90,1,95,"2012"
"14345","320470 SAO GABRIEL DA PALHA",1,2,4,402,1,410,"2012"
"14346","320480 SAO JOSE DO CALCADO",0,1,4,139,0,144,"2012"
"14347","320490 SAO MATEUS",3,8,17,1696,24,1748,"2012"
"14348","320495 SAO ROQUE DO CANAA",0,1,1,112,1,115,"2012"
"14349","320500 SERRA",72,20,85,7366,17,7560,"2012"
"14350","320501 SOORETAMA",0,0,2,356,70,428,"2012"
"14351","320503 VARGEM ALTA",0,0,3,228,2,233,"2012"
"14352","320506 VENDA NOVA DO IMIGRANTE",1,2,9,261,2,275,"2012"
"14353","320510 VIANA",13,2,12,945,12,984,"2012"
"14354","320515 VILA PAVAO",0,0,1,105,0,106,"2012"
"14355","320517 VILA VALERIO",0,0,2,149,1,152,"2012"
"14356","320520 VILA VELHA",836,13,74,5253,45,6221,"2012"
"14357","320530 VITORIA",20,8,61,4389,25,4503,"2012"
"14358","MUNICIPIO IGNORADO - RJ",0,0,0,20,2,22,"2012"
"14359","330010 ANGRA DOS REIS",5,10,56,2609,18,2698,"2012"
"14360","330015 APERIBE",0,0,1,122,0,123,"2012"
"14361","330020 ARARUAMA",3,6,42,1516,52,1619,"2012"
"14362","330022 AREAL",0,0,1,128,0,129,"2012"
"14363","330023 ARMACAO DOS BUZIOS",0,3,22,531,20,576,"2012"
"14364","330025 ARRAIAL DO CABO",1,1,5,197,97,301,"2012"
"14365","330030 BARRA DO PIRAI",1,4,39,1016,0,1060,"2012"
"14366","330040 BARRA MANSA",5,22,88,2285,10,2410,"2012"
"14367","330045 BELFORD ROXO",24,25,149,7274,77,7549,"2012"
"14368","330050 BOM JARDIM",0,3,6,349,3,361,"2012"
"14369","330060 BOM JESUS DO ITABAPOANA",3,2,6,396,1,408,"2012"
"14370","330070 CABO FRIO",12,10,66,2710,92,2890,"2012"
"14371","330080 CACHOEIRAS DE MACACU",3,2,11,717,28,761,"2012"
"14372","330090 CAMBUCI",0,2,5,152,0,159,"2012"
"14373","330093 CARAPEBUS",0,0,3,152,0,155,"2012"
"14374","330095 COMENDADOR LEVY GASPARIAN",0,0,1,130,1,132,"2012"
"14375","330100 CAMPOS DOS GOYTACAZES",14,33,148,6130,287,6612,"2012"
"14376","330110 CANTAGALO",0,0,7,256,0,263,"2012"
"14377","330115 CARDOSO MOREIRA",0,1,0,109,4,114,"2012"
"14378","330120 CARMO",1,6,3,233,0,243,"2012"
"14379","330130 CASIMIRO DE ABREU",0,2,15,423,27,467,"2012"
"14380","330140 CONCEICAO DE MACABU",0,0,5,222,10,237,"2012"
"14381","330150 CORDEIRO",0,3,1,248,3,255,"2012"
"14382","330160 DUAS BARRAS",0,0,3,128,2,133,"2012"
"14383","330170 DUQUE DE CAXIAS",31,72,293,12774,88,13258,"2012"
"14384","330180 ENGENHEIRO PAULO DE FRONTIN",0,0,1,107,1,109,"2012"
"14385","330185 GUAPIMIRIM",1,3,16,674,13,707,"2012"
"14386","330187 IGUABA GRANDE",0,0,5,165,135,305,"2012"
"14387","330190 ITABORAI",8,22,74,3300,31,3435,"2012"
"14388","330200 ITAGUAI",3,2,23,1841,10,1879,"2012"
"14389","330205 ITALVA",0,0,3,150,0,153,"2012"
"14390","330210 ITAOCARA",0,1,4,240,0,245,"2012"
"14391","330220 ITAPERUNA",2,2,18,1204,1,1227,"2012"
"14392","330225 ITATIAIA",0,4,9,390,5,408,"2012"
"14393","330227 JAPERI",7,11,32,1427,17,1494,"2012"
"14394","330230 LAJE DO MURIAE",0,0,2,92,0,94,"2012"
"14395","330240 MACAE",4,26,63,3660,22,3775,"2012"
"14396","330245 MACUCO",0,0,2,97,1,100,"2012"
"14397","330250 MAGE",15,14,43,3471,11,3554,"2012"
"14398","330260 MANGARATIBA",0,5,9,499,5,518,"2012"
"14399","330270 MARICA",6,3,25,1069,501,1604,"2012"
"14400","330280 MENDES",0,1,7,180,0,188,"2012"
"14401","330285 MESQUITA",9,14,64,2357,24,2468,"2012"
"14402","330290 MIGUEL PEREIRA",1,2,6,237,15,261,"2012"
"14403","330300 MIRACEMA",3,0,2,370,0,375,"2012"
"14404","330310 NATIVIDADE",1,2,6,174,0,183,"2012"
"14405","330320 NILOPOLIS",4,9,36,2008,17,2074,"2012"
"14406","330330 NITEROI",17,24,123,5697,45,5906,"2012"
"14407","330340 NOVA FRIBURGO",2,4,64,2126,20,2216,"2012"
"14408","330350 NOVA IGUACU",39,78,262,11126,128,11633,"2012"
"14409","330360 PARACAMBI",0,3,3,543,2,551,"2012"
"14410","330370 PARAIBA DO SUL",1,2,4,528,2,537,"2012"
"14411","330380 PARATY",2,2,11,540,5,560,"2012"
"14412","330385 PATY DO ALFERES",2,6,4,341,21,374,"2012"
"14413","330390 PETROPOLIS",22,20,95,3592,9,3738,"2012"
"14414","330395 PINHEIRAL",0,3,5,330,2,340,"2012"
"14415","330400 PIRAI",1,3,7,352,0,363,"2012"
"14416","330410 PORCIUNCULA",0,0,5,215,0,220,"2012"
"14417","330411 PORTO REAL",0,0,7,306,1,314,"2012"
"14418","330412 QUATIS",2,0,3,161,0,166,"2012"
"14419","330414 QUEIMADOS",8,15,39,2349,23,2434,"2012"
"14420","330415 QUISSAMA",0,0,12,285,6,303,"2012"
"14421","330420 RESENDE",2,3,65,1638,0,1708,"2012"
"14422","330430 RIO BONITO",3,1,7,725,10,746,"2012"
"14423","330440 RIO CLARO",0,1,2,195,1,199,"2012"
"14424","330450 RIO DAS FLORES",0,0,3,109,3,115,"2012"
"14425","330452 RIO DAS OSTRAS",10,15,81,1958,11,2075,"2012"
"14426","330455 RIO DE JANEIRO",233,470,1675,83608,563,86549,"2012"
"14427","330460 SANTA MARIA MADALENA",0,0,2,85,0,87,"2012"
"14428","330470 SANTO ANTONIO DE PADUA",3,2,2,403,61,471,"2012"
"14429","330475 SAO FRANCISCO DE ITABAPOANA",2,0,10,412,33,457,"2012"
"14430","330480 SAO FIDELIS",1,3,14,343,77,438,"2012"
"14431","330490 SAO GONCALO",41,46,218,11459,47,11811,"2012"
"14432","330500 SAO JOAO DA BARRA",0,0,10,297,90,397,"2012"
"14433","330510 SAO JOAO DE MERITI",21,41,186,6766,29,7043,"2012"
"14434","330513 SAO JOSE DE UBA",0,0,0,102,2,104,"2012"
"14435","330515 SAO JOSE DO VALE DO RIO PRETO",0,1,5,268,1,275,"2012"
"14436","330520 SAO PEDRO DA ALDEIA",1,4,8,589,559,1161,"2012"
"14437","330530 SAO SEBASTIAO DO ALTO",0,1,7,118,0,126,"2012"
"14438","330540 SAPUCAIA",1,0,4,210,1,216,"2012"
"14439","330550 SAQUAREMA",1,0,8,382,598,989,"2012"
"14440","330555 SEROPEDICA",5,2,15,975,9,1006,"2012"
"14441","330560 SILVA JARDIM",0,2,7,278,3,290,"2012"
"14442","330570 SUMIDOURO",0,1,13,203,0,217,"2012"
"14443","330575 TANGUA",1,1,5,405,7,419,"2012"
"14444","330580 TERESOPOLIS",5,7,40,2175,9,2236,"2012"
"14445","330590 TRAJANO DE MORAES",0,1,2,77,0,80,"2012"
"14446","330600 TRES RIOS",6,3,11,1114,8,1142,"2012"
"14447","330610 VALENCA",3,4,13,816,11,847,"2012"
"14448","330615 VARRE-SAI",0,1,2,150,0,153,"2012"
"14449","330620 VASSOURAS",2,3,7,428,1,441,"2012"
"14450","330630 VOLTA REDONDA",14,10,49,3232,10,3315,"2012"
"14451","MUNICIPIO IGNORADO - SP",0,0,0,12,0,12,"2012"
"14452","350010 ADAMANTINA",0,1,12,343,2,358,"2012"
"14453","350020 ADOLFO",0,0,0,47,0,47,"2012"
"14454","350030 AGUAI",1,0,2,463,1,467,"2012"
"14455","350040 AGUAS DA PRATA",0,0,2,63,2,67,"2012"
"14456","350050 AGUAS DE LINDOIA",1,0,1,253,0,255,"2012"
"14457","350055 AGUAS DE SANTA BARBARA",0,0,2,83,0,85,"2012"
"14458","350060 AGUAS DE SAO PEDRO",0,0,0,18,0,18,"2012"
"14459","350070 AGUDOS",2,2,14,456,19,493,"2012"
"14460","350075 ALAMBARI",0,0,1,57,0,58,"2012"
"14461","350080 ALFREDO MARCONDES",0,0,1,46,0,47,"2012"
"14462","350090 ALTAIR",0,0,0,45,1,46,"2012"
"14463","350100 ALTINOPOLIS",1,0,1,162,0,164,"2012"
"14464","350110 ALTO ALEGRE",0,0,2,41,1,44,"2012"
"14465","350115 ALUMINIO",0,1,2,229,4,236,"2012"
"14466","350120 ALVARES FLORENCE",0,0,0,40,1,41,"2012"
"14467","350130 ALVARES MACHADO",1,0,5,437,1,444,"2012"
"14468","350140 ALVARO DE CARVALHO",0,0,2,48,0,50,"2012"
"14469","350150 ALVINLANDIA",1,1,0,35,0,37,"2012"
"14470","350160 AMERICANA",3,8,19,2730,2,2762,"2012"
"14471","350170 AMERICO BRASILIENSE",1,1,1,563,0,566,"2012"
"14472","350180 AMERICO DE CAMPOS",0,0,1,68,0,69,"2012"
"14473","350190 AMPARO",0,2,9,792,3,806,"2012"
"14474","350200 ANALANDIA",0,1,0,43,0,44,"2012"
"14475","350210 ANDRADINA",2,2,32,691,1,728,"2012"
"14476","350220 ANGATUBA",0,2,4,299,1,306,"2012"
"14477","350230 ANHEMBI",0,1,4,85,3,93,"2012"
"14478","350240 ANHUMAS",0,0,0,60,0,60,"2012"
"14479","350250 APARECIDA",3,4,4,465,5,481,"2012"
"14480","350260 APARECIDA D'OESTE",0,0,1,35,0,36,"2012"
"14481","350270 APIAI",0,2,5,368,3,378,"2012"
"14482","350275 ARACARIGUAMA",0,0,4,276,2,282,"2012"
"14483","350280 ARACATUBA",2,16,33,2248,4,2303,"2012"
"14484","350290 ARACOIABA DA SERRA",6,1,6,361,0,374,"2012"
"14485","350300 ARAMINA",0,0,1,46,0,47,"2012"
"14486","350310 ARANDU",0,1,1,71,0,73,"2012"
"14487","350315 ARAPEI",0,0,0,24,0,24,"2012"
"14488","350320 ARARAQUARA",2,7,25,2702,4,2740,"2012"
"14489","350330 ARARAS",0,5,16,1533,4,1558,"2012"
"14490","350335 ARCO-IRIS",0,0,0,30,0,30,"2012"
"14491","350340 AREALVA",0,0,1,68,0,69,"2012"
"14492","350350 AREIAS",0,0,2,49,0,51,"2012"
"14493","350360 AREIOPOLIS",2,1,0,111,0,114,"2012"
"14494","350370 ARIRANHA",1,0,1,105,0,107,"2012"
"14495","350380 ARTUR NOGUEIRA",2,2,4,628,6,642,"2012"
"14496","350390 ARUJA",3,10,29,1308,5,1355,"2012"
"14497","350395 ASPASIA",0,0,0,15,0,15,"2012"
"14498","350400 ASSIS",0,7,6,1203,3,1219,"2012"
"14499","350410 ATIBAIA",2,6,27,1963,9,2007,"2012"
"14500","350420 AURIFLAMA",0,0,2,174,0,176,"2012"
"14501","350430 AVAI",0,0,2,71,0,73,"2012"
"14502","350440 AVANHANDAVA",0,2,4,123,11,140,"2012"
"14503","350450 AVARE",1,4,10,1241,1,1257,"2012"
"14504","350460 BADY BASSITT",1,1,1,195,1,199,"2012"
"14505","350470 BALBINOS",0,0,0,14,0,14,"2012"
"14506","350480 BALSAMO",0,0,1,101,0,102,"2012"
"14507","350490 BANANAL",1,1,2,76,5,85,"2012"
"14508","350500 BARAO DE ANTONINA",0,0,2,34,0,36,"2012"
"14509","350510 BARBOSA",0,0,2,80,3,85,"2012"
"14510","350520 BARIRI",4,1,8,363,35,411,"2012"
"14511","350530 BARRA BONITA",1,1,8,394,5,409,"2012"
"14512","350535 BARRA DO CHAPEU",0,1,2,64,1,68,"2012"
"14513","350540 BARRA DO TURVO",0,0,1,91,2,94,"2012"
"14514","350550 BARRETOS",4,9,22,1445,6,1486,"2012"
"14515","350560 BARRINHA",0,4,6,463,2,475,"2012"
"14516","350570 BARUERI",9,17,69,5566,21,5682,"2012"
"14517","350580 BASTOS",1,2,6,274,0,283,"2012"
"14518","350590 BATATAIS",9,0,5,741,12,767,"2012"
"14519","350600 BAURU",10,7,52,4657,37,4763,"2012"
"14520","350610 BEBEDOURO",1,7,11,907,0,926,"2012"
"14521","350620 BENTO DE ABREU",0,0,2,43,0,45,"2012"
"14522","350630 BERNARDINO DE CAMPOS",0,0,1,119,1,121,"2012"
"14523","350635 BERTIOGA",2,8,25,913,8,956,"2012"
"14524","350640 BILAC",0,0,0,78,1,79,"2012"
"14525","350650 BIRIGUI",0,2,16,1368,51,1437,"2012"
"14526","350660 BIRITIBA-MIRIM",1,0,6,372,7,386,"2012"
"14527","350670 BOA ESPERANCA DO SUL",0,1,1,195,0,197,"2012"
"14528","350680 BOCAINA",0,0,1,157,0,158,"2012"
"14529","350690 BOFETE",0,2,5,114,3,124,"2012"
"14530","350700 BOITUVA",2,2,4,786,2,796,"2012"
"14531","350710 BOM JESUS DOS PERDOES",0,2,4,275,4,285,"2012"
"14532","350715 BOM SUCESSO DE ITARARE",1,1,2,55,0,59,"2012"
"14533","350720 BORA",0,0,0,17,0,17,"2012"
"14534","350730 BORACEIA",0,0,1,62,11,74,"2012"
"14535","350740 BORBOREMA",0,0,4,160,0,164,"2012"
"14536","350745 BOREBI",0,0,0,31,0,31,"2012"
"14537","350750 BOTUCATU",8,10,36,1627,9,1690,"2012"
"14538","350760 BRAGANCA PAULISTA",2,8,26,2081,2,2119,"2012"
"14539","350770 BRAUNA",0,0,4,58,3,65,"2012"
"14540","350775 BREJO ALEGRE",0,0,1,36,1,38,"2012"
"14541","350780 BRODOWSKI",0,0,4,290,0,294,"2012"
"14542","350790 BROTAS",2,7,6,273,19,307,"2012"
"14543","350800 BURI",0,3,13,314,3,333,"2012"
"14544","350810 BURITAMA",0,2,6,221,0,229,"2012"
"14545","350820 BURITIZAL",0,0,0,38,0,38,"2012"
"14546","350830 CABRALIA PAULISTA",0,3,4,62,6,75,"2012"
"14547","350840 CABREUVA",2,4,12,715,1,734,"2012"
"14548","350850 CACAPAVA",3,5,13,1293,2,1316,"2012"
"14549","350860 CACHOEIRA PAULISTA",2,0,4,410,4,420,"2012"
"14550","350870 CACONDE",0,0,2,188,0,190,"2012"
"14551","350880 CAFELANDIA",1,2,4,247,0,254,"2012"
"14552","350890 CAIABU",1,0,1,41,1,44,"2012"
"14553","350900 CAIEIRAS",3,3,8,1292,4,1310,"2012"
"14554","350910 CAIUA",1,0,1,36,0,38,"2012"
"14555","350920 CAJAMAR",5,7,27,1111,0,1150,"2012"
"14556","350925 CAJATI",3,0,3,483,4,493,"2012"
"14557","350930 CAJOBI",0,1,3,112,0,116,"2012"
"14558","350940 CAJURU",1,0,3,362,3,369,"2012"
"14559","350945 CAMPINA DO MONTE ALEGRE",0,1,1,74,0,76,"2012"
"14560","350950 CAMPINAS",42,52,138,14832,64,15128,"2012"
"14561","350960 CAMPO LIMPO PAULISTA",3,7,29,1209,4,1252,"2012"
"14562","350970 CAMPOS DO JORDAO",2,4,11,706,2,725,"2012"
"14563","350980 CAMPOS NOVOS PAULISTA",1,0,3,49,0,53,"2012"
"14564","350990 CANANEIA",0,0,2,164,2,168,"2012"
"14565","350995 CANAS",0,0,0,52,7,59,"2012"
"14566","351000 CANDIDO MOTA",1,2,4,334,0,341,"2012"
"14567","351010 CANDIDO RODRIGUES",1,0,0,15,0,16,"2012"
"14568","351015 CANITAR",0,0,0,56,1,57,"2012"
"14569","351020 CAPAO BONITO",1,1,5,671,1,679,"2012"
"14570","351030 CAPELA DO ALTO",0,0,4,255,0,259,"2012"
"14571","351040 CAPIVARI",1,3,7,721,20,752,"2012"
"14572","351050 CARAGUATATUBA",4,6,27,1538,4,1579,"2012"
"14573","351060 CARAPICUIBA",14,22,81,6621,222,6960,"2012"
"14574","351070 CARDOSO",1,0,2,130,0,133,"2012"
"14575","351080 CASA BRANCA",1,1,11,332,2,347,"2012"
"14576","351090 CASSIA DOS COQUEIROS",0,0,0,27,0,27,"2012"
"14577","351100 CASTILHO",1,1,8,234,1,245,"2012"
"14578","351110 CATANDUVA",1,6,23,1462,2,1494,"2012"
"14579","351120 CATIGUA",0,0,0,94,0,94,"2012"
"14580","351130 CEDRAL",1,0,0,81,0,82,"2012"
"14581","351140 CERQUEIRA CESAR",0,0,2,244,2,248,"2012"
"14582","351150 CERQUILHO",1,2,8,514,1,526,"2012"
"14583","351160 CESARIO LANGE",0,5,4,213,0,222,"2012"
"14584","351170 CHARQUEADA",0,1,4,192,0,197,"2012"
"14585","351190 CLEMENTINA",0,2,4,116,5,127,"2012"
"14586","351200 COLINA",1,0,3,232,0,236,"2012"
"14587","351210 COLOMBIA",1,0,1,89,0,91,"2012"
"14588","351220 CONCHAL",1,1,5,376,1,384,"2012"
"14589","351230 CONCHAS",0,2,3,210,0,215,"2012"
"14590","351240 CORDEIROPOLIS",1,0,1,271,0,273,"2012"
"14591","351250 COROADOS",0,0,2,64,3,69,"2012"
"14592","351260 CORONEL MACEDO",0,0,0,57,0,57,"2012"
"14593","351270 CORUMBATAI",0,0,0,51,0,51,"2012"
"14594","351280 COSMOPOLIS",2,1,22,804,0,829,"2012"
"14595","351290 COSMORAMA",0,0,1,73,0,74,"2012"
"14596","351300 COTIA",3,15,53,3842,21,3934,"2012"
"14597","351310 CRAVINHOS",0,0,8,401,6,415,"2012"
"14598","351320 CRISTAIS PAULISTA",0,0,1,88,1,90,"2012"
"14599","351330 CRUZALIA",0,0,1,22,0,23,"2012"
"14600","351340 CRUZEIRO",0,5,15,1065,8,1093,"2012"
"14601","351350 CUBATAO",5,13,18,1947,2,1985,"2012"
"14602","351360 CUNHA",0,1,3,261,0,265,"2012"
"14603","351370 DESCALVADO",0,2,2,388,1,393,"2012"
"14604","351380 DIADEMA",21,28,82,6305,19,6455,"2012"
"14605","351385 DIRCE REIS",0,0,0,13,0,13,"2012"
"14606","351390 DIVINOLANDIA",0,0,1,140,0,141,"2012"
"14607","351400 DOBRADA",1,0,2,108,0,111,"2012"
"14608","351410 DOIS CORREGOS",0,3,3,360,4,370,"2012"
"14609","351420 DOLCINOPOLIS",0,0,0,14,0,14,"2012"
"14610","351430 DOURADO",0,0,1,89,1,91,"2012"
"14611","351440 DRACENA",0,2,5,485,3,495,"2012"
"14612","351450 DUARTINA",1,2,1,136,9,149,"2012"
"14613","351460 DUMONT",0,0,6,93,0,99,"2012"
"14614","351470 ECHAPORA",1,0,2,81,0,84,"2012"
"14615","351480 ELDORADO",0,0,0,208,3,211,"2012"
"14616","351490 ELIAS FAUSTO",2,0,4,235,7,248,"2012"
"14617","351492 ELISIARIO",0,0,1,34,0,35,"2012"
"14618","351495 EMBAUBA",0,0,2,18,0,20,"2012"
"14619","351500 EMBU DAS ARTES",19,21,61,4446,21,4568,"2012"
"14620","351510 EMBU-GUACU",2,9,20,928,6,965,"2012"
"14621","351512 EMILIANOPOLIS",0,1,0,29,0,30,"2012"
"14622","351515 ENGENHEIRO COELHO",0,2,3,235,3,243,"2012"
"14623","351518 ESPIRITO SANTO DO PINHAL",2,2,11,451,1,467,"2012"
"14624","351519 ESPIRITO SANTO DO TURVO",1,0,1,66,1,69,"2012"
"14625","351520 ESTRELA D'OESTE",0,0,0,84,0,84,"2012"
"14626","351530 ESTRELA DO NORTE",0,0,1,33,1,35,"2012"
"14627","351535 EUCLIDES DA CUNHA PAULISTA",0,1,2,117,0,120,"2012"
"14628","351540 FARTURA",0,1,2,179,4,186,"2012"
"14629","351550 FERNANDOPOLIS",3,3,6,742,0,754,"2012"
"14630","351560 FERNANDO PRESTES",0,1,2,61,1,65,"2012"
"14631","351565 FERNAO",0,0,0,15,0,15,"2012"
"14632","351570 FERRAZ DE VASCONCELOS",4,16,48,2814,36,2918,"2012"
"14633","351580 FLORA RICA",0,0,0,15,0,15,"2012"
"14634","351590 FLOREAL",0,0,0,19,0,19,"2012"
"14635","351600 FLORIDA PAULISTA",0,1,2,128,0,131,"2012"
"14636","351610 FLORINIA",0,1,0,36,0,37,"2012"
"14637","351620 FRANCA",12,15,43,4385,13,4468,"2012"
"14638","351630 FRANCISCO MORATO",5,13,43,2758,14,2833,"2012"
"14639","351640 FRANCO DA ROCHA",6,8,35,2071,12,2132,"2012"
"14640","351650 GABRIEL MONTEIRO",1,0,2,33,0,36,"2012"
"14641","351660 GALIA",0,1,3,72,1,77,"2012"
"14642","351670 GARCA",0,2,19,517,0,538,"2012"
"14643","351680 GASTAO VIDIGAL",0,0,0,54,0,54,"2012"
"14644","351685 GAVIAO PEIXOTO",0,0,0,58,0,58,"2012"
"14645","351690 GENERAL SALGADO",0,0,0,108,0,108,"2012"
"14646","351700 GETULINA",0,0,1,104,1,106,"2012"
"14647","351710 GLICERIO",0,0,3,49,2,54,"2012"
"14648","351720 GUAICARA",0,0,1,162,1,164,"2012"
"14649","351730 GUAIMBE",1,0,1,104,0,106,"2012"
"14650","351740 GUAIRA",3,3,3,467,1,477,"2012"
"14651","351750 GUAPIACU",0,0,0,212,0,212,"2012"
"14652","351760 GUAPIARA",1,2,9,236,0,248,"2012"
"14653","351770 GUARA",2,1,0,236,0,239,"2012"
"14654","351780 GUARACAI",0,1,3,77,0,81,"2012"
"14655","351790 GUARACI",1,1,6,111,1,120,"2012"
"14656","351800 GUARANI D'OESTE",0,0,0,16,0,16,"2012"
"14657","351810 GUARANTA",1,0,5,85,1,92,"2012"
"14658","351820 GUARARAPES",0,5,9,385,0,399,"2012"
"14659","351830 GUARAREMA",0,2,8,396,0,406,"2012"
"14660","351840 GUARATINGUETA",3,6,18,1388,13,1428,"2012"
"14661","351850 GUAREI",0,1,3,133,1,138,"2012"
"14662","351860 GUARIBA",1,7,22,529,1,560,"2012"
"14663","351870 GUARUJA",11,31,114,4695,86,4937,"2012"
"14664","351880 GUARULHOS",37,99,301,20946,72,21455,"2012"
"14665","351885 GUATAPARA",0,0,5,100,1,106,"2012"
"14666","351890 GUZOLANDIA",0,0,1,65,0,66,"2012"
"14667","351900 HERCULANDIA",0,0,1,115,0,116,"2012"
"14668","351905 HOLAMBRA",0,1,1,184,0,186,"2012"
"14669","351907 HORTOLANDIA",6,4,32,2902,10,2954,"2012"
"14670","351910 IACANGA",0,0,1,104,1,106,"2012"
"14671","351920 IACRI",0,0,0,70,0,70,"2012"
"14672","351925 IARAS",0,0,0,55,1,56,"2012"
"14673","351930 IBATE",2,4,5,507,0,518,"2012"
"14674","351940 IBIRA",0,0,0,108,0,108,"2012"
"14675","351950 IBIRAREMA",0,0,0,94,0,94,"2012"
"14676","351960 IBITINGA",1,1,16,680,11,709,"2012"
"14677","351970 IBIUNA",5,5,6,1003,15,1034,"2012"
"14678","351980 ICEM",0,0,0,90,1,91,"2012"
"14679","351990 IEPE",0,1,1,91,0,93,"2012"
"14680","352000 IGARACU DO TIETE",0,2,6,290,0,298,"2012"
"14681","352010 IGARAPAVA",2,1,3,300,4,310,"2012"
"14682","352020 IGARATA",0,1,1,120,1,123,"2012"
"14683","352030 IGUAPE",2,1,5,375,10,393,"2012"
"14684","352040 ILHABELA",0,2,8,451,0,461,"2012"
"14685","352042 ILHA COMPRIDA",0,0,0,112,0,112,"2012"
"14686","352044 ILHA SOLTEIRA",2,0,6,286,3,297,"2012"
"14687","352050 INDAIATUBA",11,13,19,2927,25,2995,"2012"
"14688","352060 INDIANA",1,0,0,64,0,65,"2012"
"14689","352070 INDIAPORA",0,0,0,40,0,40,"2012"
"14690","352080 INUBIA PAULISTA",0,0,1,33,0,34,"2012"
"14691","352090 IPAUSSU",0,1,0,198,1,200,"2012"
"14692","352100 IPERO",1,2,5,351,2,361,"2012"
"14693","352110 IPEUNA",0,2,1,118,1,122,"2012"
"14694","352115 IPIGUA",0,0,0,72,1,73,"2012"
"14695","352120 IPORANGA",0,0,0,43,1,44,"2012"
"14696","352130 IPUA",1,1,3,196,2,203,"2012"
"14697","352140 IRACEMAPOLIS",0,1,2,209,3,215,"2012"
"14698","352150 IRAPUA",1,0,0,88,3,92,"2012"
"14699","352160 IRAPURU",0,1,0,75,0,76,"2012"
"14700","352170 ITABERA",1,2,7,216,0,226,"2012"
"14701","352180 ITAI",0,1,8,356,0,365,"2012"
"14702","352190 ITAJOBI",0,0,1,161,0,162,"2012"
"14703","352200 ITAJU",0,0,1,33,6,40,"2012"
"14704","352210 ITANHAEM",2,6,23,1358,87,1476,"2012"
"14705","352215 ITAOCA",0,0,1,36,0,37,"2012"
"14706","352220 ITAPECERICA DA SERRA",9,9,48,2893,14,2973,"2012"
"14707","352230 ITAPETININGA",3,4,41,2053,10,2111,"2012"
"14708","352240 ITAPEVA",5,19,38,1349,1,1412,"2012"
"14709","352250 ITAPEVI",9,18,41,3886,30,3984,"2012"
"14710","352260 ITAPIRA",0,0,10,804,0,814,"2012"
"14711","352265 ITAPIRAPUA PAULISTA",0,1,1,50,0,52,"2012"
"14712","352270 ITAPOLIS",2,1,10,512,0,525,"2012"
"14713","352280 ITAPORANGA",1,1,2,217,0,221,"2012"
"14714","352290 ITAPUI",0,0,0,152,5,157,"2012"
"14715","352300 ITAPURA",0,0,0,66,0,66,"2012"
"14716","352310 ITAQUAQUECETUBA",19,28,108,5653,39,5847,"2012"
"14717","352320 ITARARE",0,1,27,683,0,711,"2012"
"14718","352330 ITARIRI",0,1,2,164,11,178,"2012"
"14719","352340 ITATIBA",4,4,9,1377,5,1399,"2012"
"14720","352350 ITATINGA",1,2,10,304,4,321,"2012"
"14721","352360 ITIRAPINA",0,0,1,170,0,171,"2012"
"14722","352370 ITIRAPUA",0,0,1,65,1,67,"2012"
"14723","352380 ITOBI",0,1,3,79,0,83,"2012"
"14724","352390 ITU",0,15,26,2438,12,2491,"2012"
"14725","352400 ITUPEVA",3,5,11,815,2,836,"2012"
"14726","352410 ITUVERAVA",2,1,5,473,2,483,"2012"
"14727","352420 JABORANDI",0,0,2,78,1,81,"2012"
"14728","352430 JABOTICABAL",1,5,8,860,5,879,"2012"
"14729","352440 JACAREI",4,12,63,3189,5,3273,"2012"
"14730","352450 JACI",0,0,1,83,0,84,"2012"
"14731","352460 JACUPIRANGA",1,0,1,223,1,226,"2012"
"14732","352470 JAGUARIUNA",0,3,10,673,0,686,"2012"
"14733","352480 JALES",0,2,5,510,0,517,"2012"
"14734","352490 JAMBEIRO",0,1,1,58,0,60,"2012"
"14735","352500 JANDIRA",2,3,17,1707,4,1733,"2012"
"14736","352510 JARDINOPOLIS",1,1,13,488,0,503,"2012"
"14737","352520 JARINU",2,1,6,359,2,370,"2012"
"14738","352530 JAU",3,5,7,1632,9,1656,"2012"
"14739","352540 JERIQUARA",0,0,0,37,3,40,"2012"
"14740","352550 JOANOPOLIS",0,3,2,138,0,143,"2012"
"14741","352560 JOAO RAMALHO",0,0,2,53,0,55,"2012"
"14742","352570 JOSE BONIFACIO",0,0,1,465,0,466,"2012"
"14743","352580 JULIO MESQUITA",0,0,2,61,0,63,"2012"
"14744","352585 JUMIRIM",0,0,1,44,0,45,"2012"
"14745","352590 JUNDIAI",19,22,70,5249,7,5367,"2012"
"14746","352600 JUNQUEIROPOLIS",0,1,3,233,0,237,"2012"
"14747","352610 JUQUIA",1,2,0,271,12,286,"2012"
"14748","352620 JUQUITIBA",1,2,14,423,6,446,"2012"
"14749","352630 LAGOINHA",0,1,2,35,0,38,"2012"
"14750","352640 LARANJAL PAULISTA",1,1,7,332,0,341,"2012"
"14751","352650 LAVINIA",0,0,2,59,0,61,"2012"
"14752","352660 LAVRINHAS",0,1,2,112,1,116,"2012"
"14753","352670 LEME",3,2,21,1234,2,1262,"2012"
"14754","352680 LENCOIS PAULISTA",2,7,32,774,4,819,"2012"
"14755","352690 LIMEIRA",7,11,30,3549,22,3619,"2012"
"14756","352700 LINDOIA",0,0,0,82,0,82,"2012"
"14757","352710 LINS",2,0,6,972,3,983,"2012"
"14758","352720 LORENA",1,6,13,1153,66,1239,"2012"
"14759","352725 LOURDES",0,0,0,26,0,26,"2012"
"14760","352730 LOUVEIRA",2,2,9,702,0,715,"2012"
"14761","352740 LUCELIA",0,0,2,207,0,209,"2012"
"14762","352750 LUCIANOPOLIS",0,0,0,25,0,25,"2012"
"14763","352760 LUIS ANTONIO",0,0,2,186,2,190,"2012"
"14764","352770 LUIZIANIA",0,2,1,67,3,73,"2012"
"14765","352780 LUPERCIO",0,1,0,50,0,51,"2012"
"14766","352790 LUTECIA",0,2,0,30,0,32,"2012"
"14767","352800 MACATUBA",1,1,6,212,0,220,"2012"
"14768","352810 MACAUBAL",0,1,0,75,0,76,"2012"
"14769","352820 MACEDONIA",0,0,0,31,0,31,"2012"
"14770","352830 MAGDA",0,0,0,32,1,33,"2012"
"14771","352840 MAIRINQUE",1,3,5,706,4,719,"2012"
"14772","352850 MAIRIPORA",5,1,13,1088,2,1109,"2012"
"14773","352860 MANDURI",0,1,2,109,0,112,"2012"
"14774","352870 MARABA PAULISTA",0,0,1,39,0,40,"2012"
"14775","352880 MARACAI",0,0,0,174,0,174,"2012"
"14776","352885 MARAPOAMA",0,0,0,24,0,24,"2012"
"14777","352890 MARIAPOLIS",1,0,2,26,0,29,"2012"
"14778","352900 MARILIA",12,12,46,2897,8,2975,"2012"
"14779","352910 MARINOPOLIS",0,0,0,23,0,23,"2012"
"14780","352920 MARTINOPOLIS",2,0,6,268,2,278,"2012"
"14781","352930 MATAO",4,1,19,1052,2,1078,"2012"
"14782","352940 MAUA",10,13,60,5773,20,5876,"2012"
"14783","352950 MENDONCA",0,0,0,50,0,50,"2012"
"14784","352960 MERIDIANO",0,0,1,41,0,42,"2012"
"14785","352965 MESOPOLIS",0,0,1,22,0,23,"2012"
"14786","352970 MIGUELOPOLIS",0,0,3,251,0,254,"2012"
"14787","352980 MINEIROS DO TIETE",1,0,0,156,1,158,"2012"
"14788","352990 MIRACATU",1,1,8,295,16,321,"2012"
"14789","353000 MIRA ESTRELA",0,0,0,26,0,26,"2012"
"14790","353010 MIRANDOPOLIS",0,3,11,339,1,354,"2012"
"14791","353020 MIRANTE DO PARANAPANEMA",2,1,4,236,0,243,"2012"
"14792","353030 MIRASSOL",1,1,3,700,0,705,"2012"
"14793","353040 MIRASSOLANDIA",0,1,0,40,0,41,"2012"
"14794","353050 MOCOCA",0,3,10,790,2,805,"2012"
"14795","353060 MOGI DAS CRUZES",15,10,56,6207,52,6340,"2012"
"14796","353070 MOGI GUACU",6,9,21,1882,10,1928,"2012"
"14797","353080 MOGI MIRIM",2,7,22,1119,3,1153,"2012"
"14798","353090 MOMBUCA",0,0,0,52,1,53,"2012"
"14799","353100 MONCOES",0,0,2,22,0,24,"2012"
"14800","353110 MONGAGUA",2,5,11,647,16,681,"2012"
"14801","353120 MONTE ALEGRE DO SUL",0,0,1,46,1,48,"2012"
"14802","353130 MONTE ALTO",2,2,9,479,1,493,"2012"
"14803","353140 MONTE APRAZIVEL",0,2,2,206,7,217,"2012"
"14804","353150 MONTE AZUL PAULISTA",0,0,3,249,0,252,"2012"
"14805","353160 MONTE CASTELO",0,1,0,42,0,43,"2012"
"14806","353170 MONTEIRO LOBATO",0,0,1,49,1,51,"2012"
"14807","353180 MONTE MOR",4,4,2,813,19,842,"2012"
"14808","353190 MORRO AGUDO",0,1,5,416,0,422,"2012"
"14809","353200 MORUNGABA",1,1,2,155,1,160,"2012"
"14810","353205 MOTUCA",1,0,3,41,0,45,"2012"
"14811","353210 MURUTINGA DO SUL",0,0,1,32,0,33,"2012"
"14812","353215 NANTES",0,0,1,41,0,42,"2012"
"14813","353220 NARANDIBA",0,0,0,63,0,63,"2012"
"14814","353230 NATIVIDADE DA SERRA",0,0,2,57,1,60,"2012"
"14815","353240 NAZARE PAULISTA",0,0,5,226,0,231,"2012"
"14816","353250 NEVES PAULISTA",0,0,1,75,0,76,"2012"
"14817","353260 NHANDEARA",0,0,0,90,0,90,"2012"
"14818","353270 NIPOA",0,0,0,75,0,75,"2012"
"14819","353280 NOVA ALIANCA",0,0,0,67,0,67,"2012"
"14820","353282 NOVA CAMPINA",1,0,3,114,0,118,"2012"
"14821","353284 NOVA CANAA PAULISTA",0,0,0,21,0,21,"2012"
"14822","353286 NOVA CASTILHO",0,0,0,9,0,9,"2012"
"14823","353290 NOVA EUROPA",0,1,1,153,0,155,"2012"
"14824","353300 NOVA GRANADA",0,0,8,246,0,254,"2012"
"14825","353310 NOVA GUATAPORANGA",0,0,0,27,2,29,"2012"
"14826","353320 NOVA INDEPENDENCIA",0,1,3,39,0,43,"2012"
"14827","353325 NOVAIS",0,0,1,70,0,71,"2012"
"14828","353330 NOVA LUZITANIA",0,0,0,37,0,37,"2012"
"14829","353340 NOVA ODESSA",1,2,9,682,2,696,"2012"
"14830","353350 NOVO HORIZONTE",1,0,4,445,0,450,"2012"
"14831","353360 NUPORANGA",0,0,1,78,0,79,"2012"
"14832","353370 OCAUCU",0,1,2,59,0,62,"2012"
"14833","353380 OLEO",0,0,0,32,0,32,"2012"
"14834","353390 OLIMPIA",2,0,16,672,2,692,"2012"
"14835","353400 ONDA VERDE",0,0,3,52,0,55,"2012"
"14836","353410 ORIENTE",0,0,5,75,0,80,"2012"
"14837","353420 ORINDIUVA",0,0,0,87,0,87,"2012"
"14838","353430 ORLANDIA",3,3,7,521,0,534,"2012"
"14839","353440 OSASCO",24,41,179,10119,49,10412,"2012"
"14840","353450 OSCAR BRESSANE",0,1,1,32,0,34,"2012"
"14841","353460 OSVALDO CRUZ",0,0,0,335,0,335,"2012"
"14842","353470 OURINHOS",6,4,6,1404,15,1435,"2012"
"14843","353475 OUROESTE",0,1,0,138,1,140,"2012"
"14844","353480 OURO VERDE",0,0,3,126,0,129,"2012"
"14845","353490 PACAEMBU",0,1,4,103,1,109,"2012"
"14846","353500 PALESTINA",0,0,1,139,0,140,"2012"
"14847","353510 PALMARES PAULISTA",2,0,2,134,0,138,"2012"
"14848","353520 PALMEIRA D'OESTE",0,0,0,77,0,77,"2012"
"14849","353530 PALMITAL",0,0,0,247,0,247,"2012"
"14850","353540 PANORAMA",0,3,12,239,0,254,"2012"
"14851","353550 PARAGUACU PAULISTA",1,2,2,620,3,628,"2012"
"14852","353560 PARAIBUNA",0,1,3,211,2,217,"2012"
"14853","353570 PARAISO",1,0,0,73,0,74,"2012"
"14854","353580 PARANAPANEMA",0,1,3,247,0,251,"2012"
"14855","353590 PARANAPUA",0,0,0,46,0,46,"2012"
"14856","353600 PARAPUA",0,0,0,116,0,116,"2012"
"14857","353610 PARDINHO",0,0,2,85,1,88,"2012"
"14858","353620 PARIQUERA-ACU",2,0,2,292,1,297,"2012"
"14859","353625 PARISI",0,0,0,20,0,20,"2012"
"14860","353630 PATROCINIO PAULISTA",1,1,3,220,1,226,"2012"
"14861","353640 PAULICEIA",0,1,5,107,0,113,"2012"
"14862","353650 PAULINIA",5,2,21,1343,4,1375,"2012"
"14863","353657 PAULISTANIA",0,0,0,19,2,21,"2012"
"14864","353660 PAULO DE FARIA",0,0,2,106,0,108,"2012"
"14865","353670 PEDERNEIRAS",1,3,15,565,6,590,"2012"
"14866","353680 PEDRA BELA",0,1,0,54,0,55,"2012"
"14867","353690 PEDRANOPOLIS",0,0,0,23,0,23,"2012"
"14868","353700 PEDREGULHO",0,2,4,184,7,197,"2012"
"14869","353710 PEDREIRA",1,0,2,439,1,443,"2012"
"14870","353715 PEDRINHAS PAULISTA",0,1,1,30,0,32,"2012"
"14871","353720 PEDRO DE TOLEDO",0,2,0,127,2,131,"2012"
"14872","353730 PENAPOLIS",1,6,25,694,25,751,"2012"
"14873","353740 PEREIRA BARRETO",3,0,8,302,8,321,"2012"
"14874","353750 PEREIRAS",0,0,2,94,1,97,"2012"
"14875","353760 PERUIBE",3,2,8,840,127,980,"2012"
"14876","353770 PIACATU",0,0,0,58,0,58,"2012"
"14877","353780 PIEDADE",6,4,8,693,7,718,"2012"
"14878","353790 PILAR DO SUL",1,1,10,420,0,432,"2012"
"14879","353800 PINDAMONHANGABA",4,10,26,2195,41,2276,"2012"
"14880","353810 PINDORAMA",1,1,2,137,0,141,"2012"
"14881","353820 PINHALZINHO",0,0,2,131,0,133,"2012"
"14882","353830 PIQUEROBI",0,0,1,36,0,37,"2012"
"14883","353850 PIQUETE",0,0,2,132,5,139,"2012"
"14884","353860 PIRACAIA",0,3,3,349,2,357,"2012"
"14885","353870 PIRACICABA",15,10,51,5015,13,5104,"2012"
"14886","353880 PIRAJU",1,1,8,380,0,390,"2012"
"14887","353890 PIRAJUI",0,2,8,213,0,223,"2012"
"14888","353900 PIRANGI",0,0,3,99,0,102,"2012"
"14889","353910 PIRAPORA DO BOM JESUS",1,3,1,224,4,233,"2012"
"14890","353920 PIRAPOZINHO",3,2,6,288,1,300,"2012"
"14891","353930 PIRASSUNUNGA",7,0,9,831,0,847,"2012"
"14892","353940 PIRATININGA",0,1,0,173,1,175,"2012"
"14893","353950 PITANGUEIRAS",0,0,4,486,1,491,"2012"
"14894","353960 PLANALTO",0,0,0,64,0,64,"2012"
"14895","353970 PLATINA",0,0,1,52,0,53,"2012"
"14896","353980 POA",1,6,28,1667,24,1726,"2012"
"14897","353990 POLONI",0,0,1,60,0,61,"2012"
"14898","354000 POMPEIA",0,0,2,250,0,252,"2012"
"14899","354010 PONGAI",0,0,0,37,0,37,"2012"
"14900","354020 PONTAL",4,1,3,556,2,566,"2012"
"14901","354025 PONTALINDA",0,2,1,55,0,58,"2012"
"14902","354030 PONTES GESTAL",0,0,0,40,0,40,"2012"
"14903","354040 POPULINA",0,0,1,45,0,46,"2012"
"14904","354050 PORANGABA",3,0,3,92,0,98,"2012"
"14905","354060 PORTO FELIZ",1,0,4,691,0,696,"2012"
"14906","354070 PORTO FERREIRA",1,1,3,661,0,666,"2012"
"14907","354075 POTIM",3,1,2,242,1,249,"2012"
"14908","354080 POTIRENDABA",1,1,2,200,1,205,"2012"
"14909","354085 PRACINHA",0,0,1,11,0,12,"2012"
"14910","354090 PRADOPOLIS",1,1,6,211,1,220,"2012"
"14911","354100 PRAIA GRANDE",5,31,98,4273,17,4424,"2012"
"14912","354105 PRATANIA",0,0,1,64,0,65,"2012"
"14913","354110 PRESIDENTE ALVES",0,0,0,56,0,56,"2012"
"14914","354120 PRESIDENTE BERNARDES",0,1,0,123,0,124,"2012"
"14915","354130 PRESIDENTE EPITACIO",2,4,8,488,2,504,"2012"
"14916","354140 PRESIDENTE PRUDENTE",7,7,43,2570,5,2632,"2012"
"14917","354150 PRESIDENTE VENCESLAU",0,1,9,424,0,434,"2012"
"14918","354160 PROMISSAO",0,0,2,479,13,494,"2012"
"14919","354165 QUADRA",0,0,0,38,0,38,"2012"
"14920","354170 QUATA",1,0,2,178,0,181,"2012"
"14921","354180 QUEIROZ",0,0,0,49,0,49,"2012"
"14922","354190 QUELUZ",1,0,2,125,2,130,"2012"
"14923","354200 QUINTANA",0,1,0,58,0,59,"2012"
"14924","354210 RAFARD",1,0,1,113,2,117,"2012"
"14925","354220 RANCHARIA",1,0,4,383,0,388,"2012"
"14926","354230 REDENCAO DA SERRA",0,1,0,50,0,51,"2012"
"14927","354240 REGENTE FEIJO",0,3,7,218,0,228,"2012"
"14928","354250 REGINOPOLIS",0,1,0,56,0,57,"2012"
"14929","354260 REGISTRO",1,3,8,839,3,854,"2012"
"14930","354270 RESTINGA",1,2,1,95,0,99,"2012"
"14931","354280 RIBEIRA",0,0,1,28,0,29,"2012"
"14932","354290 RIBEIRAO BONITO",0,1,0,189,1,191,"2012"
"14933","354300 RIBEIRAO BRANCO",0,1,15,228,4,248,"2012"
"14934","354310 RIBEIRAO CORRENTE",0,0,0,82,0,82,"2012"
"14935","354320 RIBEIRAO DO SUL",0,0,2,60,1,63,"2012"
"14936","354323 RIBEIRAO DOS INDIOS",0,0,0,14,1,15,"2012"
"14937","354325 RIBEIRAO GRANDE",1,0,0,115,0,116,"2012"
"14938","354330 RIBEIRAO PIRES",7,4,13,1461,3,1488,"2012"
"14939","354340 RIBEIRAO PRETO",26,48,106,8022,70,8272,"2012"
"14940","354350 RIVERSUL",0,0,2,68,0,70,"2012"
"14941","354360 RIFAINA",0,1,0,45,3,49,"2012"
"14942","354370 RINCAO",1,0,0,142,0,143,"2012"
"14943","354380 RINOPOLIS",0,0,1,107,2,110,"2012"
"14944","354390 RIO CLARO",3,15,27,2462,11,2518,"2012"
"14945","354400 RIO DAS PEDRAS",1,0,5,422,1,429,"2012"
"14946","354410 RIO GRANDE DA SERRA",0,3,10,696,1,710,"2012"
"14947","354420 RIOLANDIA",0,0,1,155,0,156,"2012"
"14948","354425 ROSANA",0,0,6,227,1,234,"2012"
"14949","354430 ROSEIRA",1,0,0,127,0,128,"2012"
"14950","354440 RUBIACEA",0,0,0,24,0,24,"2012"
"14951","354450 RUBINEIA",0,0,0,17,0,17,"2012"
"14952","354460 SABINO",0,0,1,54,0,55,"2012"
"14953","354470 SAGRES",0,0,0,32,0,32,"2012"
"14954","354480 SALES",0,0,0,57,1,58,"2012"
"14955","354490 SALES OLIVEIRA",1,0,0,139,0,140,"2012"
"14956","354500 SALESOPOLIS",2,0,2,202,6,212,"2012"
"14957","354510 SALMOURAO",0,0,0,55,0,55,"2012"
"14958","354515 SALTINHO",0,1,0,92,0,93,"2012"
"14959","354520 SALTO",0,6,13,1509,12,1540,"2012"
"14960","354530 SALTO DE PIRAPORA",2,5,14,531,4,556,"2012"
"14961","354540 SALTO GRANDE",0,0,2,102,0,104,"2012"
"14962","354550 SANDOVALINA",0,0,0,64,0,64,"2012"
"14963","354560 SANTA ADELIA",1,1,3,145,1,151,"2012"
"14964","354570 SANTA ALBERTINA",0,0,1,75,0,76,"2012"
"14965","354580 SANTA BARBARA D'OESTE",6,9,33,2269,7,2324,"2012"
"14966","354600 SANTA BRANCA",0,1,4,156,0,161,"2012"
"14967","354610 SANTA CLARA D'OESTE",0,0,0,22,0,22,"2012"
"14968","354620 SANTA CRUZ DA CONCEICAO",0,0,0,36,0,36,"2012"
"14969","354625 SANTA CRUZ DA ESPERANCA",0,0,0,30,0,30,"2012"
"14970","354630 SANTA CRUZ DAS PALMEIRAS",2,0,6,422,0,430,"2012"
"14971","354640 SANTA CRUZ DO RIO PARDO",2,1,3,580,0,586,"2012"
"14972","354650 SANTA ERNESTINA",0,0,0,78,2,80,"2012"
"14973","354660 SANTA FE DO SUL",0,2,0,344,1,347,"2012"
"14974","354670 SANTA GERTRUDES",2,1,3,346,0,352,"2012"
"14975","354680 SANTA ISABEL",0,2,11,695,1,709,"2012"
"14976","354690 SANTA LUCIA",0,2,0,105,0,107,"2012"
"14977","354700 SANTA MARIA DA SERRA",0,1,1,77,0,79,"2012"
"14978","354710 SANTA MERCEDES",0,0,2,32,0,34,"2012"
"14979","354720 SANTANA DA PONTE PENSA",0,0,0,11,0,11,"2012"
"14980","354730 SANTANA DE PARNAIBA",1,7,21,1933,11,1973,"2012"
"14981","354740 SANTA RITA D'OESTE",0,0,0,32,0,32,"2012"
"14982","354750 SANTA RITA DO PASSA QUATRO",0,2,7,243,0,252,"2012"
"14983","354760 SANTA ROSA DE VITERBO",1,1,2,291,1,296,"2012"
"14984","354765 SANTA SALETE",0,0,1,14,0,15,"2012"
"14985","354770 SANTO ANASTACIO",0,2,3,204,0,209,"2012"
"14986","354780 SANTO ANDRE",18,44,109,8961,37,9169,"2012"
"14987","354790 SANTO ANTONIO DA ALEGRIA",0,1,0,75,1,77,"2012"
"14988","354800 SANTO ANTONIO DE POSSE",0,0,4,243,1,248,"2012"
"14989","354805 SANTO ANTONIO DO ARACANGUA",0,1,0,102,0,103,"2012"
"14990","354810 SANTO ANTONIO DO JARDIM",0,0,1,54,0,55,"2012"
"14991","354820 SANTO ANTONIO DO PINHAL",0,0,1,73,0,74,"2012"
"14992","354830 SANTO EXPEDITO",0,0,1,30,0,31,"2012"
"14993","354840 SANTOPOLIS DO AGUAPEI",0,0,1,57,1,59,"2012"
"14994","354850 SANTOS",9,26,109,4810,18,4972,"2012"
"14995","354860 SAO BENTO DO SAPUCAI",0,0,2,146,3,151,"2012"
"14996","354870 SAO BERNARDO DO CAMPO",17,30,132,10731,28,10938,"2012"
"14997","354880 SAO CAETANO DO SUL",1,4,13,1691,0,1709,"2012"
"14998","354890 SAO CARLOS",2,11,22,2906,15,2956,"2012"
"14999","354900 SAO FRANCISCO",0,0,0,24,0,24,"2012"
"15000","354910 SAO JOAO DA BOA VISTA",1,1,13,976,13,1004,"2012"
"15001","354920 SAO JOAO DAS DUAS PONTES",0,0,0,33,0,33,"2012"
"15002","354925 SAO JOAO DE IRACEMA",0,1,0,12,0,13,"2012"
"15003","354930 SAO JOAO DO PAU D'ALHO",0,0,0,20,0,20,"2012"
"15004","354940 SAO JOAQUIM DA BARRA",3,2,10,611,3,629,"2012"
"15005","354950 SAO JOSE DA BELA VISTA",1,0,2,100,0,103,"2012"
"15006","354960 SAO JOSE DO BARREIRO",0,0,1,43,1,45,"2012"
"15007","354970 SAO JOSE DO RIO PARDO",1,2,13,643,1,660,"2012"
"15008","354980 SAO JOSE DO RIO PRETO",9,13,28,5276,3,5329,"2012"
"15009","354990 SAO JOSE DOS CAMPOS",25,22,114,9348,41,9550,"2012"
"15010","354995 SAO LOURENCO DA SERRA",0,1,5,186,3,195,"2012"
"15011","355000 SAO LUIS DO PARAITINGA",0,0,1,92,2,95,"2012"
"15012","355010 SAO MANUEL",2,4,12,533,0,551,"2012"
"15013","355020 SAO MIGUEL ARCANJO",0,1,10,404,3,418,"2012"
"15014","355030 SAO PAULO",498,691,2299,171745,671,175904,"2012"
"15015","355040 SAO PEDRO",0,1,7,389,2,399,"2012"
"15016","355050 SAO PEDRO DO TURVO",0,0,1,88,0,89,"2012"
"15017","355060 SAO ROQUE",6,0,12,1054,10,1082,"2012"
"15018","355070 SAO SEBASTIAO",2,5,11,1285,1,1304,"2012"
"15019","355080 SAO SEBASTIAO DA GRAMA",1,1,3,112,0,117,"2012"
"15020","355090 SAO SIMAO",1,0,2,137,3,143,"2012"
"15021","355100 SAO VICENTE",5,53,175,5095,34,5362,"2012"
"15022","355110 SARAPUI",0,1,0,140,0,141,"2012"
"15023","355120 SARUTAIA",0,0,0,41,1,42,"2012"
"15024","355130 SEBASTIANOPOLIS DO SUL",0,0,1,40,0,41,"2012"
"15025","355140 SERRA AZUL",0,1,0,125,0,126,"2012"
"15026","355150 SERRANA",1,5,9,606,4,625,"2012"
"15027","355160 SERRA NEGRA",0,0,1,315,1,317,"2012"
"15028","355170 SERTAOZINHO",2,3,9,1673,10,1697,"2012"
"15029","355180 SETE BARRAS",0,2,2,206,11,221,"2012"
"15030","355190 SEVERINIA",0,0,3,214,2,219,"2012"
"15031","355200 SILVEIRAS",1,0,0,70,1,72,"2012"
"15032","355210 SOCORRO",1,2,2,401,0,406,"2012"
"15033","355220 SOROCABA",14,50,189,8768,36,9057,"2012"
"15034","355230 SUD MENNUCCI",0,0,1,113,0,114,"2012"
"15035","355240 SUMARE",13,15,43,3810,14,3895,"2012"
"15036","355250 SUZANO",6,14,50,4292,33,4395,"2012"
"15037","355255 SUZANAPOLIS",1,1,0,42,0,44,"2012"
"15038","355260 TABAPUA",0,0,3,127,0,130,"2012"
"15039","355270 TABATINGA",2,2,2,187,0,193,"2012"
"15040","355280 TABOAO DA SERRA",16,18,58,4449,11,4552,"2012"
"15041","355290 TACIBA",1,0,2,62,0,65,"2012"
"15042","355300 TAGUAI",0,0,3,190,0,193,"2012"
"15043","355310 TAIACU",0,0,1,67,0,68,"2012"
"15044","355320 TAIUVA",0,0,1,49,0,50,"2012"
"15045","355330 TAMBAU",0,0,3,285,0,288,"2012"
"15046","355340 TANABI",0,3,5,235,0,243,"2012"
"15047","355350 TAPIRAI",2,1,0,107,0,110,"2012"
"15048","355360 TAPIRATIBA",0,0,3,142,2,147,"2012"
"15049","355365 TAQUARAL",0,0,1,34,0,35,"2012"
"15050","355370 TAQUARITINGA",2,2,6,621,13,644,"2012"
"15051","355380 TAQUARITUBA",2,1,7,285,1,296,"2012"
"15052","355385 TAQUARIVAI",0,0,4,90,0,94,"2012"
"15053","355390 TARABAI",0,0,2,74,0,76,"2012"
"15054","355395 TARUMA",0,1,1,198,0,200,"2012"
"15055","355400 TATUI",7,11,25,1705,8,1756,"2012"
"15056","355410 TAUBATE",7,15,39,3859,31,3951,"2012"
"15057","355420 TEJUPA",0,2,1,80,0,83,"2012"
"15058","355430 TEODORO SAMPAIO",0,4,11,341,2,358,"2012"
"15059","355440 TERRA ROXA",0,0,0,47,47,94,"2012"
"15060","355450 TIETE",1,2,5,446,2,456,"2012"
"15061","355460 TIMBURI",0,0,0,10,0,10,"2012"
"15062","355465 TORRE DE PEDRA",0,0,0,24,0,24,"2012"
"15063","355470 TORRINHA",0,0,2,84,3,89,"2012"
"15064","355475 TRABIJU",0,0,0,21,0,21,"2012"
"15065","355480 TREMEMBE",4,3,6,527,7,547,"2012"
"15066","355490 TRES FRONTEIRAS",0,0,1,58,0,59,"2012"
"15067","355495 TUIUTI",0,0,3,62,1,66,"2012"
"15068","355500 TUPA",1,5,8,753,0,767,"2012"
"15069","355510 TUPI PAULISTA",1,0,2,164,0,167,"2012"
"15070","355520 TURIUBA",0,0,1,13,0,14,"2012"
"15071","355530 TURMALINA",0,0,0,7,0,7,"2012"
"15072","355535 UBARANA",0,0,1,91,0,92,"2012"
"15073","355540 UBATUBA",7,3,15,1132,1,1158,"2012"
"15074","355550 UBIRAJARA",2,1,0,67,1,71,"2012"
"15075","355560 UCHOA",0,0,2,114,1,117,"2012"
"15076","355570 UNIAO PAULISTA",0,0,4,20,0,24,"2012"
"15077","355580 URANIA",0,0,0,78,0,78,"2012"
"15078","355590 URU",0,0,0,16,0,16,"2012"
"15079","355600 URUPES",0,0,2,158,0,160,"2012"
"15080","355610 VALENTIM GENTIL",1,0,0,137,0,138,"2012"
"15081","355620 VALINHOS",2,5,19,1306,4,1336,"2012"
"15082","355630 VALPARAISO",0,1,4,302,1,308,"2012"
"15083","355635 VARGEM",0,0,0,96,0,96,"2012"
"15084","355640 VARGEM GRANDE DO SUL",0,2,6,524,0,532,"2012"
"15085","355645 VARGEM GRANDE PAULISTA",1,3,10,744,3,761,"2012"
"15086","355650 VARZEA PAULISTA",1,9,43,1661,3,1717,"2012"
"15087","355660 VERA CRUZ",1,1,2,111,0,115,"2012"
"15088","355670 VINHEDO",1,3,9,926,2,941,"2012"
"15089","355680 VIRADOURO",0,1,4,241,0,246,"2012"
"15090","355690 VISTA ALEGRE DO ALTO",0,1,3,95,1,100,"2012"
"15091","355695 VITORIA BRASIL",0,0,0,25,0,25,"2012"
"15092","355700 VOTORANTIM",16,9,33,1632,2,1692,"2012"
"15093","355710 VOTUPORANGA",1,5,8,1064,2,1080,"2012"
"15094","355715 ZACARIAS",0,1,0,34,0,35,"2012"
"15095","355720 CHAVANTES",0,1,3,178,2,184,"2012"
"15096","355730 ESTIVA GERBI",0,0,2,105,1,108,"2012"
"15097","410010 ABATIA",0,0,3,93,0,96,"2012"
"15098","410020 ADRIANOPOLIS",0,0,0,74,0,74,"2012"
"15099","410030 AGUDOS DO SUL",1,0,3,105,1,110,"2012"
"15100","410040 ALMIRANTE TAMANDARE",3,8,20,1847,8,1886,"2012"
"15101","410045 ALTAMIRA DO PARANA",0,1,0,50,0,51,"2012"
"15102","410050 ALTONIA",0,2,4,233,0,239,"2012"
"15103","410060 ALTO PARANA",0,1,1,158,0,160,"2012"
"15104","410070 ALTO PIQUIRI",1,1,3,123,0,128,"2012"
"15105","410080 ALVORADA DO SUL",1,0,1,96,0,98,"2012"
"15106","410090 AMAPORA",0,1,2,72,0,75,"2012"
"15107","410100 AMPERE",1,3,4,241,0,249,"2012"
"15108","410105 ANAHY",0,0,1,27,0,28,"2012"
"15109","410110 ANDIRA",1,1,3,256,0,261,"2012"
"15110","410115 ANGULO",1,0,3,31,0,35,"2012"
"15111","410120 ANTONINA",0,1,3,198,0,202,"2012"
"15112","410130 ANTONIO OLINTO",0,0,1,61,0,62,"2012"
"15113","410140 APUCARANA",24,10,17,1613,0,1664,"2012"
"15114","410150 ARAPONGAS",6,12,18,1497,0,1533,"2012"
"15115","410160 ARAPOTI",1,1,10,380,0,392,"2012"
"15116","410165 ARAPUA",0,0,0,34,0,34,"2012"
"15117","410170 ARARUNA",0,0,2,177,0,179,"2012"
"15118","410180 ARAUCARIA",4,8,23,2245,5,2285,"2012"
"15119","410185 ARIRANHA DO IVAI",0,0,1,35,0,36,"2012"
"15120","410190 ASSAI",0,1,0,226,0,227,"2012"
"15121","410200 ASSIS CHATEAUBRIAND",0,2,3,390,3,398,"2012"
"15122","410210 ASTORGA",1,2,10,335,0,348,"2012"
"15123","410220 ATALAIA",0,0,1,29,0,30,"2012"
"15124","410230 BALSA NOVA",2,0,3,195,1,201,"2012"
"15125","410240 BANDEIRANTES",1,0,9,391,0,401,"2012"
"15126","410250 BARBOSA FERRAZ",0,0,3,121,1,125,"2012"
"15127","410260 BARRACAO",0,0,1,129,0,130,"2012"
"15128","410270 BARRA DO JACARE",0,0,0,22,0,22,"2012"
"15129","410275 BELA VISTA DA CAROBA",0,0,0,49,0,49,"2012"
"15130","410280 BELA VISTA DO PARAISO",0,0,2,207,0,209,"2012"
"15131","410290 BITURUNA",0,2,1,226,0,229,"2012"
"15132","410300 BOA ESPERANCA",0,0,0,40,0,40,"2012"
"15133","410302 BOA ESPERANCA DO IGUACU",0,1,0,36,1,38,"2012"
"15134","410304 BOA VENTURA DE SAO ROQUE",0,0,1,85,0,86,"2012"
"15135","410305 BOA VISTA DA APARECIDA",0,1,1,113,0,115,"2012"
"15136","410310 BOCAIUVA DO SUL",0,0,1,178,0,179,"2012"
"15137","410315 BOM JESUS DO SUL",0,1,1,31,0,33,"2012"
"15138","410320 BOM SUCESSO",0,1,3,99,0,103,"2012"
"15139","410322 BOM SUCESSO DO SUL",0,1,0,48,0,49,"2012"
"15140","410330 BORRAZOPOLIS",2,0,2,83,0,87,"2012"
"15141","410335 BRAGANEY",0,0,2,66,0,68,"2012"
"15142","410337 BRASILANDIA DO SUL",0,0,0,38,0,38,"2012"
"15143","410340 CAFEARA",0,0,0,25,0,25,"2012"
"15144","410345 CAFELANDIA",1,0,2,204,1,208,"2012"
"15145","410347 CAFEZAL DO SUL",0,0,0,49,0,49,"2012"
"15146","410350 CALIFORNIA",2,0,3,89,1,95,"2012"
"15147","410360 CAMBARA",2,1,2,292,1,298,"2012"
"15148","410370 CAMBE",1,4,10,1270,2,1287,"2012"
"15149","410380 CAMBIRA",0,0,2,102,0,104,"2012"
"15150","410390 CAMPINA DA LAGOA",0,0,4,216,0,220,"2012"
"15151","410395 CAMPINA DO SIMAO",1,0,1,58,0,60,"2012"
"15152","410400 CAMPINA GRANDE DO SUL",3,5,13,777,2,800,"2012"
"15153","410405 CAMPO BONITO",0,0,0,69,0,69,"2012"
"15154","410410 CAMPO DO TENENTE",0,1,6,111,0,118,"2012"
"15155","410420 CAMPO LARGO",6,7,31,1686,14,1744,"2012"
"15156","410425 CAMPO MAGRO",0,3,10,398,1,412,"2012"
"15157","410430 CAMPO MOURAO",3,2,10,1273,1,1289,"2012"
"15158","410440 CANDIDO DE ABREU",0,2,2,195,1,200,"2012"
"15159","410442 CANDOI",1,2,5,226,0,234,"2012"
"15160","410445 CANTAGALO",0,2,2,181,0,185,"2012"
"15161","410450 CAPANEMA",1,1,2,217,0,221,"2012"
"15162","410460 CAPITAO LEONIDAS MARQUES",1,0,3,211,0,215,"2012"
"15163","410465 CARAMBEI",1,1,7,343,3,355,"2012"
"15164","410470 CARLOPOLIS",0,0,1,174,0,175,"2012"
"15165","410480 CASCAVEL",2,14,105,4307,7,4435,"2012"
"15166","410490 CASTRO",7,2,13,1182,2,1206,"2012"
"15167","410500 CATANDUVAS",0,2,3,117,1,123,"2012"
"15168","410510 CENTENARIO DO SUL",0,2,4,123,0,129,"2012"
"15169","410520 CERRO AZUL",1,5,4,223,1,234,"2012"
"15170","410530 CEU AZUL",1,0,2,142,1,146,"2012"
"15171","410540 CHOPINZINHO",0,0,4,268,0,272,"2012"
"15172","410550 CIANORTE",2,0,10,1017,0,1029,"2012"
"15173","410560 CIDADE GAUCHA",1,0,1,134,0,136,"2012"
"15174","410570 CLEVELANDIA",1,0,5,266,0,272,"2012"
"15175","410580 COLOMBO",8,9,46,3759,5,3827,"2012"
"15176","410590 COLORADO",0,0,8,262,0,270,"2012"
"15177","410600 CONGONHINHAS",0,0,1,121,0,122,"2012"
"15178","410610 CONSELHEIRO MAIRINCK",0,0,0,31,0,31,"2012"
"15179","410620 CONTENDA",0,2,3,246,0,251,"2012"
"15180","410630 CORBELIA",0,1,6,207,0,214,"2012"
"15181","410640 CORNELIO PROCOPIO",2,3,9,489,2,505,"2012"
"15182","410645 CORONEL DOMINGOS SOARES",2,1,1,109,3,116,"2012"
"15183","410650 CORONEL VIVIDA",2,0,4,294,0,300,"2012"
"15184","410655 CORUMBATAI DO SUL",0,0,3,39,0,42,"2012"
"15185","410657 CRUZEIRO DO IGUACU",0,0,0,58,0,58,"2012"
"15186","410660 CRUZEIRO DO OESTE",0,1,6,257,0,264,"2012"
"15187","410670 CRUZEIRO DO SUL",0,0,0,53,0,53,"2012"
"15188","410680 CRUZ MACHADO",0,1,1,199,0,201,"2012"
"15189","410685 CRUZMALTINA",0,0,1,35,0,36,"2012"
"15190","410690 CURITIBA",46,102,364,24522,45,25079,"2012"
"15191","410700 CURIUVA",1,0,0,190,0,191,"2012"
"15192","410710 DIAMANTE DO NORTE",0,0,1,61,0,62,"2012"
"15193","410712 DIAMANTE DO SUL",0,0,3,50,0,53,"2012"
"15194","410715 DIAMANTE D'OESTE",0,1,2,68,0,71,"2012"
"15195","410720 DOIS VIZINHOS",0,1,2,581,1,585,"2012"
"15196","410725 DOURADINA",0,1,1,113,0,115,"2012"
"15197","410730 DOUTOR CAMARGO",0,0,0,61,0,61,"2012"
"15198","410740 ENEAS MARQUES",2,0,0,64,0,66,"2012"
"15199","410750 ENGENHEIRO BELTRAO",1,1,4,155,0,161,"2012"
"15200","410752 ESPERANCA NOVA",0,0,1,24,0,25,"2012"
"15201","410753 ENTRE RIOS DO OESTE",0,0,1,56,0,57,"2012"
"15202","410754 ESPIGAO ALTO DO IGUACU",0,1,1,75,0,77,"2012"
"15203","410755 FAROL",0,0,1,32,0,33,"2012"
"15204","410760 FAXINAL",2,0,5,236,1,244,"2012"
"15205","410765 FAZENDA RIO GRANDE",5,12,26,1763,3,1809,"2012"
"15206","410770 FENIX",1,1,1,53,0,56,"2012"
"15207","410773 FERNANDES PINHEIRO",0,0,0,110,0,110,"2012"
"15208","410775 FIGUEIRA",0,0,0,106,1,107,"2012"
"15209","410780 FLORAI",1,0,0,48,0,49,"2012"
"15210","410785 FLOR DA SERRA DO SUL",0,0,1,51,0,52,"2012"
"15211","410790 FLORESTA",0,0,0,78,0,78,"2012"
"15212","410800 FLORESTOPOLIS",0,0,0,151,0,151,"2012"
"15213","410810 FLORIDA",0,0,0,33,0,33,"2012"
"15214","410820 FORMOSA DO OESTE",0,0,2,92,0,94,"2012"
"15215","410830 FOZ DO IGUACU",4,8,40,4329,11,4392,"2012"
"15216","410832 FRANCISCO ALVES",1,2,2,85,0,90,"2012"
"15217","410840 FRANCISCO BELTRAO",7,6,9,1160,0,1182,"2012"
"15218","410845 FOZ DO JORDAO",1,0,2,70,0,73,"2012"
"15219","410850 GENERAL CARNEIRO",0,1,0,207,0,208,"2012"
"15220","410855 GODOY MOREIRA",0,0,0,37,0,37,"2012"
"15221","410860 GOIOERE",2,1,3,305,0,311,"2012"
"15222","410865 GOIOXIM",1,2,2,108,0,113,"2012"
"15223","410870 GRANDES RIOS",0,2,3,81,0,86,"2012"
"15224","410880 GUAIRA",3,1,7,498,1,510,"2012"
"15225","410890 GUAIRACA",0,0,5,89,1,95,"2012"
"15226","410895 GUAMIRANGA",1,1,4,95,0,101,"2012"
"15227","410900 GUAPIRAMA",0,0,1,54,0,55,"2012"
"15228","410910 GUAPOREMA",0,0,0,19,0,19,"2012"
"15229","410920 GUARACI",0,0,0,51,0,51,"2012"
"15230","410930 GUARANIACU",1,0,4,189,0,194,"2012"
"15231","410940 GUARAPUAVA",14,10,23,2684,4,2735,"2012"
"15232","410950 GUARAQUECABA",0,0,4,90,0,94,"2012"
"15233","410960 GUARATUBA",0,3,13,471,1,488,"2012"
"15234","410965 HONORIO SERPA",1,0,2,75,0,78,"2012"
"15235","410970 IBAITI",2,3,19,379,0,403,"2012"
"15236","410975 IBEMA",0,0,4,104,0,108,"2012"
"15237","410980 IBIPORA",3,2,11,693,2,711,"2012"
"15238","410990 ICARAIMA",1,3,2,102,0,108,"2012"
"15239","411000 IGUARACU",0,0,1,54,0,55,"2012"
"15240","411005 IGUATU",0,0,0,12,0,12,"2012"
"15241","411007 IMBAU",1,3,2,177,3,186,"2012"
"15242","411010 IMBITUVA",4,7,3,468,0,482,"2012"
"15243","411020 INACIO MARTINS",0,2,5,153,1,161,"2012"
"15244","411030 INAJA",0,0,1,37,0,38,"2012"
"15245","411040 INDIANOPOLIS",0,0,2,58,0,60,"2012"
"15246","411050 IPIRANGA",0,0,3,193,0,196,"2012"
"15247","411060 IPORA",0,2,3,192,0,197,"2012"
"15248","411065 IRACEMA DO OESTE",0,0,0,35,0,35,"2012"
"15249","411070 IRATI",0,2,2,751,1,756,"2012"
"15250","411080 IRETAMA",0,1,1,138,0,140,"2012"
"15251","411090 ITAGUAJE",0,0,1,47,0,48,"2012"
"15252","411095 ITAIPULANDIA",0,0,3,148,0,151,"2012"
"15253","411100 ITAMBARACA",0,1,0,79,0,80,"2012"
"15254","411110 ITAMBE",0,0,0,67,0,67,"2012"
"15255","411120 ITAPEJARA D'OESTE",0,0,2,128,0,130,"2012"
"15256","411125 ITAPERUCU",2,1,2,443,1,449,"2012"
"15257","411130 ITAUNA DO SUL",0,2,2,52,0,56,"2012"
"15258","411140 IVAI",1,1,3,185,0,190,"2012"
"15259","411150 IVAIPORA",5,1,3,403,0,412,"2012"
"15260","411155 IVATE",0,0,5,112,0,117,"2012"
"15261","411160 IVATUBA",0,0,1,19,0,20,"2012"
"15262","411170 JABOTI",0,1,1,70,0,72,"2012"
"15263","411180 JACAREZINHO",3,0,4,541,0,548,"2012"
"15264","411190 JAGUAPITA",0,0,3,160,0,163,"2012"
"15265","411200 JAGUARIAIVA",2,0,10,570,0,582,"2012"
"15266","411210 JANDAIA DO SUL",0,2,0,232,0,234,"2012"
"15267","411220 JANIOPOLIS",0,0,0,66,0,66,"2012"
"15268","411230 JAPIRA",1,0,2,54,0,57,"2012"
"15269","411240 JAPURA",0,0,0,72,3,75,"2012"
"15270","411250 JARDIM ALEGRE",0,3,7,144,1,155,"2012"
"15271","411260 JARDIM OLINDA",0,0,1,19,0,20,"2012"
"15272","411270 JATAIZINHO",1,1,2,154,0,158,"2012"
"15273","411275 JESUITAS",0,1,3,92,0,96,"2012"
"15274","411280 JOAQUIM TAVORA",0,0,2,126,1,129,"2012"
"15275","411290 JUNDIAI DO SUL",0,0,0,36,0,36,"2012"
"15276","411295 JURANDA",0,0,0,94,0,94,"2012"
"15277","411300 JUSSARA",0,0,2,89,0,91,"2012"
"15278","411310 KALORE",0,0,2,43,0,45,"2012"
"15279","411320 LAPA",1,6,8,690,0,705,"2012"
"15280","411325 LARANJAL",0,1,1,96,0,98,"2012"
"15281","411330 LARANJEIRAS DO SUL",0,1,10,478,1,490,"2012"
"15282","411340 LEOPOLIS",0,0,0,24,0,24,"2012"
"15283","411342 LIDIANOPOLIS",0,0,0,39,0,39,"2012"
"15284","411345 LINDOESTE",0,0,2,61,0,63,"2012"
"15285","411350 LOANDA",2,1,2,346,0,351,"2012"
"15286","411360 LOBATO",0,1,2,55,0,58,"2012"
"15287","411370 LONDRINA",18,30,95,6995,16,7154,"2012"
"15288","411373 LUIZIANA",0,0,0,133,0,133,"2012"
"15289","411375 LUNARDELLI",0,1,1,71,0,73,"2012"
"15290","411380 LUPIONOPOLIS",0,1,0,49,0,50,"2012"
"15291","411390 MALLET",1,0,1,173,0,175,"2012"
"15292","411400 MAMBORE",1,0,2,171,1,175,"2012"
"15293","411410 MANDAGUACU",0,0,4,234,1,239,"2012"
"15294","411420 MANDAGUARI",2,3,6,387,1,399,"2012"
"15295","411430 MANDIRITUBA",0,3,7,370,1,381,"2012"
"15296","411435 MANFRINOPOLIS",0,0,0,28,0,28,"2012"
"15297","411440 MANGUEIRINHA",0,1,11,226,0,238,"2012"
"15298","411450 MANOEL RIBAS",0,0,2,207,0,209,"2012"
"15299","411460 MARECHAL CANDIDO RONDON",0,4,20,541,0,565,"2012"
"15300","411470 MARIA HELENA",0,0,1,52,0,53,"2012"
"15301","411480 MARIALVA",6,1,5,435,0,447,"2012"
"15302","411490 MARILANDIA DO SUL",1,0,0,104,1,106,"2012"
"15303","411500 MARILENA",0,0,1,108,0,109,"2012"
"15304","411510 MARILUZ",1,0,3,146,0,150,"2012"
"15305","411520 MARINGA",13,13,97,4659,0,4782,"2012"
"15306","411530 MARIOPOLIS",0,1,0,56,0,57,"2012"
"15307","411535 MARIPA",0,0,0,59,0,59,"2012"
"15308","411540 MARMELEIRO",2,0,4,153,0,159,"2012"
"15309","411545 MARQUINHO",0,1,0,68,0,69,"2012"
"15310","411550 MARUMBI",0,0,3,54,0,57,"2012"
"15311","411560 MATELANDIA",0,1,4,246,0,251,"2012"
"15312","411570 MATINHOS",1,3,7,476,2,489,"2012"
"15313","411573 MATO RICO",0,0,0,40,0,40,"2012"
"15314","411575 MAUA DA SERRA",3,0,1,159,0,163,"2012"
"15315","411580 MEDIANEIRA",3,1,17,575,0,596,"2012"
"15316","411585 MERCEDES",0,0,1,58,0,59,"2012"
"15317","411590 MIRADOR",0,0,0,37,0,37,"2012"
"15318","411600 MIRASELVA",0,1,0,26,0,27,"2012"
"15319","411605 MISSAL",0,1,1,129,0,131,"2012"
"15320","411610 MOREIRA SALES",0,0,1,146,0,147,"2012"
"15321","411620 MORRETES",1,2,0,241,1,245,"2012"
"15322","411630 MUNHOZ DE MELO",0,0,1,37,0,38,"2012"
"15323","411640 NOSSA SENHORA DAS GRACAS",0,1,0,52,0,53,"2012"
"15324","411650 NOVA ALIANCA DO IVAI",0,0,0,19,0,19,"2012"
"15325","411660 NOVA AMERICA DA COLINA",1,0,0,52,0,53,"2012"
"15326","411670 NOVA AURORA",0,0,4,140,0,144,"2012"
"15327","411680 NOVA CANTU",0,1,1,92,1,95,"2012"
"15328","411690 NOVA ESPERANCA",1,1,9,316,0,327,"2012"
"15329","411695 NOVA ESPERANCA DO SUDOESTE",0,0,1,70,2,73,"2012"
"15330","411700 NOVA FATIMA",0,0,1,103,0,104,"2012"
"15331","411705 NOVA LARANJEIRAS",1,1,5,168,5,180,"2012"
"15332","411710 NOVA LONDRINA",0,0,3,183,0,186,"2012"
"15333","411720 NOVA OLIMPIA",1,0,1,73,0,75,"2012"
"15334","411721 NOVA SANTA BARBARA",0,0,2,48,0,50,"2012"
"15335","411722 NOVA SANTA ROSA",0,2,1,106,4,113,"2012"
"15336","411725 NOVA PRATA DO IGUACU",1,0,2,124,0,127,"2012"
"15337","411727 NOVA TEBAS",0,1,2,79,1,83,"2012"
"15338","411729 NOVO ITACOLOMI",0,1,0,33,0,34,"2012"
"15339","411730 ORTIGUEIRA",1,3,2,295,1,302,"2012"
"15340","411740 OURIZONA",0,0,0,37,0,37,"2012"
"15341","411745 OURO VERDE DO OESTE",0,2,1,79,0,82,"2012"
"15342","411750 PAICANDU",0,2,10,498,0,510,"2012"
"15343","411760 PALMAS",3,0,10,855,9,877,"2012"
"15344","411770 PALMEIRA",1,1,5,467,1,475,"2012"
"15345","411780 PALMITAL",0,0,0,225,1,226,"2012"
"15346","411790 PALOTINA",0,5,2,395,0,402,"2012"
"15347","411800 PARAISO DO NORTE",0,2,0,173,0,175,"2012"
"15348","411810 PARANACITY",0,0,1,148,0,149,"2012"
"15349","411820 PARANAGUA",2,20,33,2344,13,2412,"2012"
"15350","411830 PARANAPOEMA",0,0,1,39,0,40,"2012"
"15351","411840 PARANAVAI",3,1,6,1145,0,1155,"2012"
"15352","411845 PATO BRAGADO",0,0,0,62,0,62,"2012"
"15353","411850 PATO BRANCO",3,4,33,1128,0,1168,"2012"
"15354","411860 PAULA FREITAS",0,0,0,54,0,54,"2012"
"15355","411870 PAULO FRONTIN",0,0,1,66,1,68,"2012"
"15356","411880 PEABIRU",0,0,3,185,0,188,"2012"
"15357","411885 PEROBAL",0,1,2,70,0,73,"2012"
"15358","411890 PEROLA",0,0,2,133,0,135,"2012"
"15359","411900 PEROLA D'OESTE",0,0,0,59,0,59,"2012"
"15360","411910 PIEN",0,0,0,123,0,123,"2012"
"15361","411915 PINHAIS",7,15,32,1950,2,2006,"2012"
"15362","411920 PINHALAO",0,0,1,109,0,110,"2012"
"15363","411925 PINHAL DE SAO BENTO",0,0,0,22,0,22,"2012"
"15364","411930 PINHAO",4,0,6,490,5,505,"2012"
"15365","411940 PIRAI DO SUL",2,1,2,362,0,367,"2012"
"15366","411950 PIRAQUARA",3,9,30,1641,1,1684,"2012"
"15367","411960 PITANGA",0,7,10,446,0,463,"2012"
"15368","411965 PITANGUEIRAS",0,0,2,35,0,37,"2012"
"15369","411970 PLANALTINA DO PARANA",0,0,0,57,0,57,"2012"
"15370","411980 PLANALTO",0,0,2,125,0,127,"2012"
"15371","411990 PONTA GROSSA",16,35,151,5047,8,5257,"2012"
"15372","411995 PONTAL DO PARANA",0,1,7,289,5,302,"2012"
"15373","412000 PORECATU",0,0,2,167,0,169,"2012"
"15374","412010 PORTO AMAZONAS",0,0,1,59,0,60,"2012"
"15375","412015 PORTO BARREIRO",0,0,0,39,0,39,"2012"
"15376","412020 PORTO RICO",0,0,0,37,0,37,"2012"
"15377","412030 PORTO VITORIA",0,0,0,46,0,46,"2012"
"15378","412033 PRADO FERREIRA",0,1,2,46,0,49,"2012"
"15379","412035 PRANCHITA",0,0,0,56,0,56,"2012"
"15380","412040 PRESIDENTE CASTELO BRANCO",0,0,2,63,0,65,"2012"
"15381","412050 PRIMEIRO DE MAIO",0,0,2,103,0,105,"2012"
"15382","412060 PRUDENTOPOLIS",0,1,10,641,6,658,"2012"
"15383","412065 QUARTO CENTENARIO",0,0,1,46,1,48,"2012"
"15384","412070 QUATIGUA",0,0,0,94,1,95,"2012"
"15385","412080 QUATRO BARRAS",1,1,1,336,0,339,"2012"
"15386","412085 QUATRO PONTES",0,0,0,31,0,31,"2012"
"15387","412090 QUEDAS DO IGUACU",0,2,6,502,1,511,"2012"
"15388","412100 QUERENCIA DO NORTE",0,2,9,167,0,178,"2012"
"15389","412110 QUINTA DO SOL",0,0,3,61,0,64,"2012"
"15390","412120 QUITANDINHA",1,1,1,177,0,180,"2012"
"15391","412125 RAMILANDIA",0,0,1,36,0,37,"2012"
"15392","412130 RANCHO ALEGRE",0,0,1,39,0,40,"2012"
"15393","412135 RANCHO ALEGRE D'OESTE",0,0,0,32,0,32,"2012"
"15394","412140 REALEZA",2,0,1,217,0,220,"2012"
"15395","412150 REBOUCAS",0,0,1,201,0,202,"2012"
"15396","412160 RENASCENCA",0,1,1,75,0,77,"2012"
"15397","412170 RESERVA",4,0,8,372,0,384,"2012"
"15398","412175 RESERVA DO IGUACU",0,0,3,123,2,128,"2012"
"15399","412180 RIBEIRAO CLARO",1,3,2,108,1,115,"2012"
"15400","412190 RIBEIRAO DO PINHAL",0,1,6,167,0,174,"2012"
"15401","412200 RIO AZUL",0,0,0,200,0,200,"2012"
"15402","412210 RIO BOM",0,0,0,34,0,34,"2012"
"15403","412215 RIO BONITO DO IGUACU",0,0,0,196,0,196,"2012"
"15404","412217 RIO BRANCO DO IVAI",0,0,2,40,0,42,"2012"
"15405","412220 RIO BRANCO DO SUL",0,3,7,592,1,603,"2012"
"15406","412230 RIO NEGRO",0,1,9,371,0,381,"2012"
"15407","412240 ROLANDIA",5,7,12,818,1,843,"2012"
"15408","412250 RONCADOR",0,0,2,149,1,152,"2012"
"15409","412260 RONDON",0,0,1,111,1,113,"2012"
"15410","412265 ROSARIO DO IVAI",0,0,0,83,0,83,"2012"
"15411","412270 SABAUDIA",0,0,0,77,0,77,"2012"
"15412","412280 SALGADO FILHO",0,0,1,45,0,46,"2012"
"15413","412290 SALTO DO ITARARE",0,0,0,56,0,56,"2012"
"15414","412300 SALTO DO LONTRA",1,0,0,160,1,162,"2012"
"15415","412310 SANTA AMELIA",0,1,0,59,0,60,"2012"
"15416","412320 SANTA CECILIA DO PAVAO",0,0,0,52,0,52,"2012"
"15417","412330 SANTA CRUZ DE MONTE CASTELO",1,0,0,96,0,97,"2012"
"15418","412340 SANTA FE",0,1,2,115,2,120,"2012"
"15419","412350 SANTA HELENA",0,1,4,320,0,325,"2012"
"15420","412360 SANTA INES",0,0,0,16,0,16,"2012"
"15421","412370 SANTA ISABEL DO IVAI",0,0,3,100,0,103,"2012"
"15422","412380 SANTA IZABEL DO OESTE",0,0,1,134,0,135,"2012"
"15423","412382 SANTA LUCIA",0,0,2,50,0,52,"2012"
"15424","412385 SANTA MARIA DO OESTE",0,0,3,149,1,153,"2012"
"15425","412390 SANTA MARIANA",0,0,1,110,0,111,"2012"
"15426","412395 SANTA MONICA",0,0,2,42,0,44,"2012"
"15427","412400 SANTANA DO ITARARE",0,0,1,65,0,66,"2012"
"15428","412402 SANTA TEREZA DO OESTE",0,0,6,159,0,165,"2012"
"15429","412405 SANTA TEREZINHA DE ITAIPU",1,0,3,288,4,296,"2012"
"15430","412410 SANTO ANTONIO DA PLATINA",1,2,6,620,2,631,"2012"
"15431","412420 SANTO ANTONIO DO CAIUA",0,0,0,24,0,24,"2012"
"15432","412430 SANTO ANTONIO DO PARAISO",0,0,0,25,0,25,"2012"
"15433","412440 SANTO ANTONIO DO SUDOESTE",2,0,1,235,0,238,"2012"
"15434","412450 SANTO INACIO",0,0,0,78,0,78,"2012"
"15435","412460 SAO CARLOS DO IVAI",0,0,1,85,0,86,"2012"
"15436","412470 SAO JERONIMO DA SERRA",3,1,2,158,1,165,"2012"
"15437","412480 SAO JOAO",0,1,4,118,0,123,"2012"
"15438","412490 SAO JOAO DO CAIUA",0,1,1,78,0,80,"2012"
"15439","412500 SAO JOAO DO IVAI",0,0,1,120,0,121,"2012"
"15440","412510 SAO JOAO DO TRIUNFO",0,1,2,140,1,144,"2012"
"15441","412520 SAO JORGE D'OESTE",0,1,0,106,0,107,"2012"
"15442","412530 SAO JORGE DO IVAI",0,0,1,63,0,64,"2012"
"15443","412535 SAO JORGE DO PATROCINIO",0,1,0,82,0,83,"2012"
"15444","412540 SAO JOSE DA BOA VISTA",0,0,1,61,0,62,"2012"
"15445","412545 SAO JOSE DAS PALMEIRAS",0,0,1,52,0,53,"2012"
"15446","412550 SAO JOSE DOS PINHAIS",13,22,60,4644,13,4752,"2012"
"15447","412555 SAO MANOEL DO PARANA",0,0,1,29,1,31,"2012"
"15448","412560 SAO MATEUS DO SUL",2,1,3,583,1,590,"2012"
"15449","412570 SAO MIGUEL DO IGUACU",0,0,6,368,2,376,"2012"
"15450","412575 SAO PEDRO DO IGUACU",0,0,2,75,0,77,"2012"
"15451","412580 SAO PEDRO DO IVAI",0,0,9,128,1,138,"2012"
"15452","412590 SAO PEDRO DO PARANA",0,0,0,29,0,29,"2012"
"15453","412600 SAO SEBASTIAO DA AMOREIRA",0,1,1,118,0,120,"2012"
"15454","412610 SAO TOME",0,0,1,81,0,82,"2012"
"15455","412620 SAPOPEMA",1,0,0,71,0,72,"2012"
"15456","412625 SARANDI",7,4,16,1302,0,1329,"2012"
"15457","412627 SAUDADE DO IGUACU",0,1,2,87,0,90,"2012"
"15458","412630 SENGES",1,1,5,275,0,282,"2012"
"15459","412635 SERRANOPOLIS DO IGUACU",0,0,1,57,0,58,"2012"
"15460","412640 SERTANEJA",0,0,1,68,0,69,"2012"
"15461","412650 SERTANOPOLIS",0,1,1,188,0,190,"2012"
"15462","412660 SIQUEIRA CAMPOS",0,1,0,256,0,257,"2012"
"15463","412665 SULINA",0,0,0,26,0,26,"2012"
"15464","412667 TAMARANA",0,0,3,160,1,164,"2012"
"15465","412670 TAMBOARA",0,0,1,64,0,65,"2012"
"15466","412680 TAPEJARA",0,1,5,221,0,227,"2012"
"15467","412690 TAPIRA",0,0,3,67,0,70,"2012"
"15468","412700 TEIXEIRA SOARES",0,0,1,140,0,141,"2012"
"15469","412710 TELEMACO BORBA",3,5,15,1092,2,1117,"2012"
"15470","412720 TERRA BOA",0,3,3,193,0,199,"2012"
"15471","412730 TERRA RICA",0,1,3,254,0,258,"2012"
"15472","412740 TERRA ROXA",0,0,1,200,0,201,"2012"
"15473","412750 TIBAGI",0,1,4,301,0,306,"2012"
"15474","412760 TIJUCAS DO SUL",0,0,5,174,0,179,"2012"
"15475","412770 TOLEDO",2,9,21,1792,0,1824,"2012"
"15476","412780 TOMAZINA",0,0,3,77,0,80,"2012"
"15477","412785 TRES BARRAS DO PARANA",0,1,1,173,0,175,"2012"
"15478","412788 TUNAS DO PARANA",1,3,4,120,1,129,"2012"
"15479","412790 TUNEIRAS DO OESTE",0,0,0,112,0,112,"2012"
"15480","412795 TUPASSI",0,0,2,70,0,72,"2012"
"15481","412796 TURVO",1,0,5,192,0,198,"2012"
"15482","412800 UBIRATA",0,1,2,307,0,310,"2012"
"15483","412810 UMUARAMA",1,8,24,1348,0,1381,"2012"
"15484","412820 UNIAO DA VITORIA",1,1,9,727,0,738,"2012"
"15485","412830 UNIFLOR",0,1,2,33,0,36,"2012"
"15486","412840 URAI",0,3,3,154,0,160,"2012"
"15487","412850 WENCESLAU BRAZ",1,2,0,242,2,247,"2012"
"15488","412853 VENTANIA",1,1,2,124,1,129,"2012"
"15489","412855 VERA CRUZ DO OESTE",0,0,2,83,0,85,"2012"
"15490","412860 VERE",2,0,0,91,0,93,"2012"
"15491","412862 ALTO PARAISO",0,0,1,37,0,38,"2012"
"15492","412863 DOUTOR ULYSSES",0,1,2,56,2,61,"2012"
"15493","412865 VIRMOND",0,0,1,47,0,48,"2012"
"15494","412870 VITORINO",0,0,2,82,0,84,"2012"
"15495","412880 XAMBRE",0,0,0,64,0,64,"2012"
"15496","420005 ABDON BATISTA",0,0,1,32,0,33,"2012"
"15497","420010 ABELARDO LUZ",0,1,7,261,0,269,"2012"
"15498","420020 AGROLANDIA",0,0,3,139,0,142,"2012"
"15499","420030 AGRONOMICA",0,0,1,65,0,66,"2012"
"15500","420040 AGUA DOCE",0,2,0,89,0,91,"2012"
"15501","420050 AGUAS DE CHAPECO",0,0,0,69,0,69,"2012"
"15502","420055 AGUAS FRIAS",0,0,0,29,0,29,"2012"
"15503","420060 AGUAS MORNAS",0,0,0,67,0,67,"2012"
"15504","420070 ALFREDO WAGNER",1,0,0,102,2,105,"2012"
"15505","420075 ALTO BELA VISTA",0,0,1,17,0,18,"2012"
"15506","420080 ANCHIETA",0,0,0,73,0,73,"2012"
"15507","420090 ANGELINA",0,0,0,58,0,58,"2012"
"15508","420100 ANITA GARIBALDI",0,0,2,94,0,96,"2012"
"15509","420110 ANITAPOLIS",1,0,0,24,0,25,"2012"
"15510","420120 ANTONIO CARLOS",0,0,1,101,0,102,"2012"
"15511","420125 APIUNA",0,0,2,121,0,123,"2012"
"15512","420127 ARABUTA",0,0,0,42,0,42,"2012"
"15513","420130 ARAQUARI",1,3,10,481,4,499,"2012"
"15514","420140 ARARANGUA",4,5,10,853,0,872,"2012"
"15515","420150 ARMAZEM",0,0,2,101,0,103,"2012"
"15516","420160 ARROIO TRINTA",0,0,0,28,0,28,"2012"
"15517","420165 ARVOREDO",0,0,0,24,0,24,"2012"
"15518","420170 ASCURRA",0,1,0,101,0,102,"2012"
"15519","420180 ATALANTA",0,0,1,32,0,33,"2012"
"15520","420190 AURORA",1,0,4,73,0,78,"2012"
"15521","420195 BALNEARIO ARROIO DO SILVA",4,1,1,152,0,158,"2012"
"15522","420200 BALNEARIO CAMBORIU",1,5,31,1317,0,1354,"2012"
"15523","420205 BALNEARIO BARRA DO SUL",0,0,0,107,1,108,"2012"
"15524","420207 BALNEARIO GAIVOTA",0,0,0,95,0,95,"2012"
"15525","420208 BANDEIRANTE",1,1,1,35,0,38,"2012"
"15526","420209 BARRA BONITA",0,0,1,23,0,24,"2012"
"15527","420210 BARRA VELHA",0,0,4,349,8,361,"2012"
"15528","420213 BELA VISTA DO TOLDO",0,2,3,61,0,66,"2012"
"15529","420215 BELMONTE",0,0,1,33,0,34,"2012"
"15530","420220 BENEDITO NOVO",0,0,1,101,0,102,"2012"
"15531","420230 BIGUACU",1,4,16,851,3,875,"2012"
"15532","420240 BLUMENAU",12,11,67,4311,0,4401,"2012"
"15533","420243 BOCAINA DO SUL",0,1,0,33,0,34,"2012"
"15534","420245 BOMBINHAS",0,0,2,225,2,229,"2012"
"15535","420250 BOM JARDIM DA SERRA",0,0,1,38,0,39,"2012"
"15536","420253 BOM JESUS",0,0,0,48,0,48,"2012"
"15537","420257 BOM JESUS DO OESTE",0,0,1,24,0,25,"2012"
"15538","420260 BOM RETIRO",0,1,6,110,0,117,"2012"
"15539","420270 BOTUVERA",0,1,0,62,0,63,"2012"
"15540","420280 BRACO DO NORTE",0,0,1,456,2,459,"2012"
"15541","420285 BRACO DO TROMBUDO",0,0,2,45,1,48,"2012"
"15542","420287 BRUNOPOLIS",0,0,0,33,0,33,"2012"
"15543","420290 BRUSQUE",1,1,15,1508,1,1526,"2012"
"15544","420300 CACADOR",7,8,25,1075,0,1115,"2012"
"15545","420310 CAIBI",0,1,3,54,0,58,"2012"
"15546","420315 CALMON",1,2,1,58,0,62,"2012"
"15547","420320 CAMBORIU",3,4,19,1165,0,1191,"2012"
"15548","420325 CAPAO ALTO",0,0,1,30,0,31,"2012"
"15549","420330 CAMPO ALEGRE",0,1,1,135,0,137,"2012"
"15550","420340 CAMPO BELO DO SUL",0,1,6,92,1,100,"2012"
"15551","420350 CAMPO ERE",0,1,3,132,0,136,"2012"
"15552","420360 CAMPOS NOVOS",1,0,1,468,0,470,"2012"
"15553","420370 CANELINHA",0,2,0,124,0,126,"2012"
"15554","420380 CANOINHAS",1,5,19,771,6,802,"2012"
"15555","420390 CAPINZAL",0,0,3,293,0,296,"2012"
"15556","420395 CAPIVARI DE BAIXO",0,0,3,296,0,299,"2012"
"15557","420400 CATANDUVAS",1,0,0,139,0,140,"2012"
"15558","420410 CAXAMBU DO SUL",0,0,0,46,0,46,"2012"
"15559","420415 CELSO RAMOS",0,0,0,36,0,36,"2012"
"15560","420417 CERRO NEGRO",0,1,2,37,1,41,"2012"
"15561","420419 CHAPADAO DO LAGEADO",0,0,0,37,0,37,"2012"
"15562","420420 CHAPECO",8,13,66,2911,8,3006,"2012"
"15563","420425 COCAL DO SUL",0,0,0,182,0,182,"2012"
"15564","420430 CONCORDIA",0,2,13,901,1,917,"2012"
"15565","420435 CORDILHEIRA ALTA",0,0,1,37,0,38,"2012"
"15566","420440 CORONEL FREITAS",0,1,2,93,0,96,"2012"
"15567","420445 CORONEL MARTINS",0,0,0,21,0,21,"2012"
"15568","420450 CORUPA",0,0,1,177,0,178,"2012"
"15569","420455 CORREIA PINTO",1,1,16,181,0,199,"2012"
"15570","420460 CRICIUMA",9,6,17,2691,8,2731,"2012"
"15571","420470 CUNHA PORA",0,0,1,93,0,94,"2012"
"15572","420475 CUNHATAI",0,0,0,23,0,23,"2012"
"15573","420480 CURITIBANOS",3,1,10,602,1,617,"2012"
"15574","420490 DESCANSO",0,1,1,69,0,71,"2012"
"15575","420500 DIONISIO CERQUEIRA",1,1,2,240,0,244,"2012"
"15576","420510 DONA EMMA",0,0,2,46,0,48,"2012"
"15577","420515 DOUTOR PEDRINHO",0,0,1,48,0,49,"2012"
"15578","420517 ENTRE RIOS",2,1,1,47,1,52,"2012"
"15579","420519 ERMO",0,0,0,37,0,37,"2012"
"15580","420520 ERVAL VELHO",1,0,0,49,0,50,"2012"
"15581","420530 FAXINAL DOS GUEDES",0,0,1,135,0,136,"2012"
"15582","420535 FLOR DO SERTAO",0,0,1,11,0,12,"2012"
"15583","420540 FLORIANOPOLIS",9,28,67,5361,30,5495,"2012"
"15584","420543 FORMOSA DO SUL",0,0,0,25,0,25,"2012"
"15585","420545 FORQUILHINHA",2,1,1,342,0,346,"2012"
"15586","420550 FRAIBURGO",3,1,3,542,0,549,"2012"
"15587","420555 FREI ROGERIO",0,0,1,23,0,24,"2012"
"15588","420560 GALVAO",0,1,0,49,0,50,"2012"
"15589","420570 GAROPABA",2,1,5,240,3,251,"2012"
"15590","420580 GARUVA",1,1,4,242,5,253,"2012"
"15591","420590 GASPAR",5,1,16,743,0,765,"2012"
"15592","420600 GOVERNADOR CELSO RAMOS",1,0,5,160,0,166,"2012"
"15593","420610 GRAO PARA",0,0,0,73,0,73,"2012"
"15594","420620 GRAVATAL",0,0,1,144,0,145,"2012"
"15595","420630 GUABIRUBA",0,1,1,245,0,247,"2012"
"15596","420640 GUARACIABA",0,0,0,115,0,115,"2012"
"15597","420650 GUARAMIRIM",0,1,11,616,1,629,"2012"
"15598","420660 GUARUJA DO SUL",0,0,3,67,0,70,"2012"
"15599","420665 GUATAMBU",0,3,4,58,0,65,"2012"
"15600","420670 HERVAL D'OESTE",1,1,3,270,0,275,"2012"
"15601","420675 IBIAM",0,0,1,17,0,18,"2012"
"15602","420680 IBICARE",0,0,1,38,0,39,"2012"
"15603","420690 IBIRAMA",1,0,3,252,0,256,"2012"
"15604","420700 ICARA",2,2,4,834,0,842,"2012"
"15605","420710 ILHOTA",0,0,3,163,0,166,"2012"
"15606","420720 IMARUI",0,0,0,95,0,95,"2012"
"15607","420730 IMBITUBA",0,0,9,513,3,525,"2012"
"15608","420740 IMBUIA",0,1,1,62,1,65,"2012"
"15609","420750 INDAIAL",4,0,4,798,2,808,"2012"
"15610","420757 IOMERE",0,0,0,27,0,27,"2012"
"15611","420760 IPIRA",0,0,1,50,3,54,"2012"
"15612","420765 IPORA DO OESTE",0,1,1,84,1,87,"2012"
"15613","420768 IPUACU",0,1,2,115,2,120,"2012"
"15614","420770 IPUMIRIM",0,0,1,78,0,79,"2012"
"15615","420775 IRACEMINHA",0,0,2,37,0,39,"2012"
"15616","420780 IRANI",0,1,3,108,0,112,"2012"
"15617","420785 IRATI",0,0,0,21,0,21,"2012"
"15618","420790 IRINEOPOLIS",0,3,0,109,0,112,"2012"
"15619","420800 ITA",2,0,0,71,0,73,"2012"
"15620","420810 ITAIOPOLIS",1,0,5,261,0,267,"2012"
"15621","420820 ITAJAI",16,20,104,2887,3,3030,"2012"
"15622","420830 ITAPEMA",2,4,12,650,3,671,"2012"
"15623","420840 ITAPIRANGA",1,0,2,211,0,214,"2012"
"15624","420845 ITAPOA",0,1,1,203,0,205,"2012"
"15625","420850 ITUPORANGA",1,1,13,334,0,349,"2012"
"15626","420860 JABORA",0,1,1,47,0,49,"2012"
"15627","420870 JACINTO MACHADO",0,1,0,132,0,133,"2012"
"15628","420880 JAGUARUNA",0,1,2,251,1,255,"2012"
"15629","420890 JARAGUA DO SUL",2,6,27,2297,1,2333,"2012"
"15630","420895 JARDINOPOLIS",0,0,0,16,0,16,"2012"
"15631","420900 JOACABA",0,0,4,320,0,324,"2012"
"15632","420910 JOINVILLE",9,37,116,7716,8,7886,"2012"
"15633","420915 JOSE BOITEUX",0,0,1,90,1,92,"2012"
"15634","420917 JUPIA",0,0,2,25,0,27,"2012"
"15635","420920 LACERDOPOLIS",0,0,0,20,0,20,"2012"
"15636","420930 LAGES",6,27,89,2169,8,2299,"2012"
"15637","420940 LAGUNA",2,0,4,560,0,566,"2012"
"15638","420945 LAJEADO GRANDE",0,0,0,15,0,15,"2012"
"15639","420950 LAURENTINO",0,0,1,84,0,85,"2012"
"15640","420960 LAURO MULLER",0,0,2,183,0,185,"2012"
"15641","420970 LEBON REGIS",1,0,1,158,0,160,"2012"
"15642","420980 LEOBERTO LEAL",0,0,1,28,0,29,"2012"
"15643","420985 LINDOIA DO SUL",0,0,1,54,0,55,"2012"
"15644","420990 LONTRAS",0,0,1,139,1,141,"2012"
"15645","421000 LUIZ ALVES",2,0,3,138,1,144,"2012"
"15646","421003 LUZERNA",0,0,0,48,0,48,"2012"
"15647","421005 MACIEIRA",0,0,0,16,0,16,"2012"
"15648","421010 MAFRA",1,1,6,736,1,745,"2012"
"15649","421020 MAJOR GERCINO",1,1,1,31,0,34,"2012"
"15650","421030 MAJOR VIEIRA",0,1,3,91,0,95,"2012"
"15651","421040 MARACAJA",1,1,0,90,0,92,"2012"
"15652","421050 MARAVILHA",1,1,8,305,0,315,"2012"
"15653","421055 MAREMA",0,0,0,12,0,12,"2012"
"15654","421060 MASSARANDUBA",0,1,3,182,0,186,"2012"
"15655","421070 MATOS COSTA",0,0,0,40,1,41,"2012"
"15656","421080 MELEIRO",1,0,1,71,0,73,"2012"
"15657","421085 MIRIM DOCE",0,0,0,30,0,30,"2012"
"15658","421090 MODELO",0,0,1,42,0,43,"2012"
"15659","421100 MONDAI",0,0,0,108,0,108,"2012"
"15660","421105 MONTE CARLO",0,1,1,148,2,152,"2012"
"15661","421110 MONTE CASTELO",0,0,0,136,1,137,"2012"
"15662","421120 MORRO DA FUMACA",3,0,0,240,0,243,"2012"
"15663","421125 MORRO GRANDE",0,0,0,44,0,44,"2012"
"15664","421130 NAVEGANTES",2,2,20,1136,0,1160,"2012"
"15665","421140 NOVA ERECHIM",0,0,0,58,0,58,"2012"
"15666","421145 NOVA ITABERABA",0,0,1,50,0,51,"2012"
"15667","421150 NOVA TRENTO",1,0,4,147,1,153,"2012"
"15668","421160 NOVA VENEZA",0,0,0,178,0,178,"2012"
"15669","421165 NOVO HORIZONTE",0,1,0,24,0,25,"2012"
"15670","421170 ORLEANS",1,1,16,280,1,299,"2012"
"15671","421175 OTACILIO COSTA",0,1,10,245,1,257,"2012"
"15672","421180 OURO",1,0,0,77,0,78,"2012"
"15673","421185 OURO VERDE",0,0,1,23,0,24,"2012"
"15674","421187 PAIAL",0,0,0,28,0,28,"2012"
"15675","421189 PAINEL",0,0,3,32,0,35,"2012"
"15676","421190 PALHOCA",1,2,22,2259,3,2287,"2012"
"15677","421200 PALMA SOLA",0,0,1,96,0,97,"2012"
"15678","421205 PALMEIRA",0,0,1,27,2,30,"2012"
"15679","421210 PALMITOS",0,1,4,186,0,191,"2012"
"15680","421220 PAPANDUVA",0,1,3,260,3,267,"2012"
"15681","421223 PARAISO",0,0,1,48,0,49,"2012"
"15682","421225 PASSO DE TORRES",0,0,0,79,1,80,"2012"
"15683","421227 PASSOS MAIA",0,1,0,40,0,41,"2012"
"15684","421230 PAULO LOPES",0,0,0,92,1,93,"2012"
"15685","421240 PEDRAS GRANDES",0,0,0,31,1,32,"2012"
"15686","421250 PENHA",1,2,9,305,2,319,"2012"
"15687","421260 PERITIBA",0,0,1,26,0,27,"2012"
"15688","421270 PETROLANDIA",1,0,3,77,1,82,"2012"
"15689","421280 BALNEARIO PICARRAS",3,0,7,253,0,263,"2012"
"15690","421290 PINHALZINHO",1,1,0,257,0,259,"2012"
"15691","421300 PINHEIRO PRETO",0,0,1,28,0,29,"2012"
"15692","421310 PIRATUBA",0,0,1,48,0,49,"2012"
"15693","421315 PLANALTO ALEGRE",0,0,0,28,0,28,"2012"
"15694","421320 POMERODE",2,3,2,352,0,359,"2012"
"15695","421330 PONTE ALTA",0,0,3,74,0,77,"2012"
"15696","421335 PONTE ALTA DO NORTE",0,0,0,48,1,49,"2012"
"15697","421340 PONTE SERRADA",1,1,2,179,1,184,"2012"
"15698","421350 PORTO BELO",0,0,4,214,0,218,"2012"
"15699","421360 PORTO UNIAO",1,5,8,493,0,507,"2012"
"15700","421370 POUSO REDONDO",1,0,1,242,1,245,"2012"
"15701","421380 PRAIA GRANDE",0,0,0,75,0,75,"2012"
"15702","421390 PRESIDENTE CASTELLO BRANCO",1,0,0,12,0,13,"2012"
"15703","421400 PRESIDENTE GETULIO",0,0,3,212,0,215,"2012"
"15704","421410 PRESIDENTE NEREU",0,0,0,22,0,22,"2012"
"15705","421415 PRINCESA",0,1,0,33,0,34,"2012"
"15706","421420 QUILOMBO",0,0,1,126,0,127,"2012"
"15707","421430 RANCHO QUEIMADO",0,0,1,29,1,31,"2012"
"15708","421440 RIO DAS ANTAS",0,1,3,55,0,59,"2012"
"15709","421450 RIO DO CAMPO",0,0,1,86,0,87,"2012"
"15710","421460 RIO DO OESTE",0,1,3,68,0,72,"2012"
"15711","421470 RIO DOS CEDROS",0,0,0,114,1,115,"2012"
"15712","421480 RIO DO SUL",1,3,12,878,1,895,"2012"
"15713","421490 RIO FORTUNA",0,0,0,51,0,51,"2012"
"15714","421500 RIO NEGRINHO",1,1,7,545,0,554,"2012"
"15715","421505 RIO RUFINO",0,0,2,20,0,22,"2012"
"15716","421507 RIQUEZA",0,0,1,52,0,53,"2012"
"15717","421510 RODEIO",1,0,0,92,0,93,"2012"
"15718","421520 ROMELANDIA",1,0,1,55,1,58,"2012"
"15719","421530 SALETE",0,0,0,71,0,71,"2012"
"15720","421535 SALTINHO",0,0,1,38,0,39,"2012"
"15721","421540 SALTO VELOSO",0,0,0,63,1,64,"2012"
"15722","421545 SANGAO",0,0,1,174,1,176,"2012"
"15723","421550 SANTA CECILIA",1,4,3,292,4,304,"2012"
"15724","421555 SANTA HELENA",0,0,0,24,0,24,"2012"
"15725","421560 SANTA ROSA DE LIMA",1,0,0,14,0,15,"2012"
"15726","421565 SANTA ROSA DO SUL",1,0,0,91,0,92,"2012"
"15727","421567 SANTA TEREZINHA",0,0,0,83,0,83,"2012"
"15728","421568 SANTA TEREZINHA DO PROGRESSO",0,0,0,26,0,26,"2012"
"15729","421569 SANTIAGO DO SUL",0,0,0,24,0,24,"2012"
"15730","421570 SANTO AMARO DA IMPERATRIZ",1,0,1,255,0,257,"2012"
"15731","421575 SAO BERNARDINO",0,2,3,35,0,40,"2012"
"15732","421580 SAO BENTO DO SUL",4,5,13,1151,7,1180,"2012"
"15733","421590 SAO BONIFACIO",0,0,0,20,0,20,"2012"
"15734","421600 SAO CARLOS",0,1,3,118,0,122,"2012"
"15735","421605 SAO CRISTOVAO DO SUL",0,2,1,70,1,74,"2012"
"15736","421610 SAO DOMINGOS",0,0,0,85,2,87,"2012"
"15737","421620 SAO FRANCISCO DO SUL",2,4,6,617,2,631,"2012"
"15738","421625 SAO JOAO DO OESTE",0,1,0,70,0,71,"2012"
"15739","421630 SAO JOAO BATISTA",1,0,4,365,2,372,"2012"
"15740","421635 SAO JOAO DO ITAPERIU",0,0,0,45,1,46,"2012"
"15741","421640 SAO JOAO DO SUL",0,1,0,69,0,70,"2012"
"15742","421650 SAO JOAQUIM",3,1,15,325,0,344,"2012"
"15743","421660 SAO JOSE",14,13,39,2917,5,2988,"2012"
"15744","421670 SAO JOSE DO CEDRO",0,3,2,155,0,160,"2012"
"15745","421680 SAO JOSE DO CERRITO",0,1,2,64,3,70,"2012"
"15746","421690 SAO LOURENCO DO OESTE",1,1,2,321,1,326,"2012"
"15747","421700 SAO LUDGERO",0,2,1,161,0,164,"2012"
"15748","421710 SAO MARTINHO",0,1,0,39,0,40,"2012"
"15749","421715 SAO MIGUEL DA BOA VISTA",0,0,0,16,0,16,"2012"
"15750","421720 SAO MIGUEL DO OESTE",0,1,6,458,1,466,"2012"
"15751","421725 SAO PEDRO DE ALCANTARA",0,0,0,28,0,28,"2012"
"15752","421730 SAUDADES",0,1,1,113,0,115,"2012"
"15753","421740 SCHROEDER",0,0,2,276,0,278,"2012"
"15754","421750 SEARA",0,0,5,181,0,186,"2012"
"15755","421755 SERRA ALTA",0,0,1,42,0,43,"2012"
"15756","421760 SIDEROPOLIS",0,1,0,145,0,146,"2012"
"15757","421770 SOMBRIO",0,0,1,394,0,395,"2012"
"15758","421775 SUL BRASIL",0,0,0,29,0,29,"2012"
"15759","421780 TAIO",2,1,3,221,2,229,"2012"
"15760","421790 TANGARA",0,0,5,78,0,83,"2012"
"15761","421795 TIGRINHOS",0,0,1,23,0,24,"2012"
"15762","421800 TIJUCAS",0,1,6,525,2,534,"2012"
"15763","421810 TIMBE DO SUL",0,0,0,49,0,49,"2012"
"15764","421820 TIMBO",3,0,2,465,1,471,"2012"
"15765","421825 TIMBO GRANDE",0,1,0,108,0,109,"2012"
"15766","421830 TRES BARRAS",1,0,5,277,0,283,"2012"
"15767","421835 TREVISO",0,0,0,50,0,50,"2012"
"15768","421840 TREZE DE MAIO",0,0,0,68,0,68,"2012"
"15769","421850 TREZE TILIAS",2,0,2,91,0,95,"2012"
"15770","421860 TROMBUDO CENTRAL",0,0,1,87,1,89,"2012"
"15771","421870 TUBARAO",2,2,14,1239,2,1259,"2012"
"15772","421875 TUNAPOLIS",0,0,2,56,0,58,"2012"
"15773","421880 TURVO",0,0,0,132,0,132,"2012"
"15774","421885 UNIAO DO OESTE",0,0,1,19,0,20,"2012"
"15775","421890 URUBICI",0,1,3,123,0,127,"2012"
"15776","421895 URUPEMA",0,0,0,25,1,26,"2012"
"15777","421900 URUSSANGA",0,1,1,191,0,193,"2012"
"15778","421910 VARGEAO",0,1,1,52,0,54,"2012"
"15779","421915 VARGEM",0,0,0,24,0,24,"2012"
"15780","421917 VARGEM BONITA",0,0,0,56,0,56,"2012"
"15781","421920 VIDAL RAMOS",0,1,1,81,1,84,"2012"
"15782","421930 VIDEIRA",0,0,8,673,1,682,"2012"
"15783","421935 VITOR MEIRELES",0,0,2,86,0,88,"2012"
"15784","421940 WITMARSUM",0,1,0,37,1,39,"2012"
"15785","421950 XANXERE",4,1,9,583,2,599,"2012"
"15786","421960 XAVANTINA",0,0,0,37,0,37,"2012"
"15787","421970 XAXIM",1,2,0,346,0,349,"2012"
"15788","421985 ZORTEA",0,0,1,41,0,42,"2012"
"15789","430003 ACEGUA",0,0,0,80,1,81,"2012"
"15790","430005 AGUA SANTA",0,1,0,47,0,48,"2012"
"15791","430010 AGUDO",0,0,4,178,0,182,"2012"
"15792","430020 AJURICABA",0,0,0,70,0,70,"2012"
"15793","430030 ALECRIM",0,0,2,65,0,67,"2012"
"15794","430040 ALEGRETE",1,2,12,855,1,871,"2012"
"15795","430045 ALEGRIA",0,0,0,33,0,33,"2012"
"15796","430047 ALMIRANTE TAMANDARE DO SUL",0,0,0,21,0,21,"2012"
"15797","430050 ALPESTRE",0,0,0,70,0,70,"2012"
"15798","430055 ALTO ALEGRE",1,0,1,19,0,21,"2012"
"15799","430057 ALTO FELIZ",0,0,0,19,0,19,"2012"
"15800","430060 ALVORADA",8,15,80,3302,11,3416,"2012"
"15801","430063 AMARAL FERRADOR",0,0,0,52,0,52,"2012"
"15802","430064 AMETISTA DO SUL",0,0,0,78,0,78,"2012"
"15803","430066 ANDRE DA ROCHA",0,0,1,14,0,15,"2012"
"15804","430070 ANTA GORDA",0,0,1,53,0,54,"2012"
"15805","430080 ANTONIO PRADO",0,0,1,126,0,127,"2012"
"15806","430085 ARAMBARE",2,0,0,38,0,40,"2012"
"15807","430087 ARARICA",0,1,1,101,1,104,"2012"
"15808","430090 ARATIBA",0,1,0,49,0,50,"2012"
"15809","430100 ARROIO DO MEIO",0,0,4,214,0,218,"2012"
"15810","430105 ARROIO DO SAL",0,0,2,71,1,74,"2012"
"15811","430107 ARROIO DO PADRE",0,0,1,20,0,21,"2012"
"15812","430110 ARROIO DOS RATOS",1,1,2,143,0,147,"2012"
"15813","430120 ARROIO DO TIGRE",2,0,3,123,3,131,"2012"
"15814","430130 ARROIO GRANDE",0,1,8,197,0,206,"2012"
"15815","430140 ARVOREZINHA",0,0,1,101,0,102,"2012"
"15816","430150 AUGUSTO PESTANA",0,3,1,42,0,46,"2012"
"15817","430155 AUREA",0,0,1,29,0,30,"2012"
"15818","430160 BAGE",7,8,15,1540,6,1576,"2012"
"15819","430163 BALNEARIO PINHAL",0,1,4,104,0,109,"2012"
"15820","430165 BARAO",0,0,0,56,0,56,"2012"
"15821","430170 BARAO DE COTEGIPE",0,0,0,69,0,69,"2012"
"15822","430175 BARAO DO TRIUNFO",0,0,0,65,0,65,"2012"
"15823","430180 BARRACAO",0,1,0,44,0,45,"2012"
"15824","430185 BARRA DO GUARITA",0,0,0,45,0,45,"2012"
"15825","430187 BARRA DO QUARAI",0,0,0,18,12,30,"2012"
"15826","430190 BARRA DO RIBEIRO",0,0,3,122,3,128,"2012"
"15827","430192 BARRA DO RIO AZUL",0,0,0,15,0,15,"2012"
"15828","430195 BARRA FUNDA",0,1,1,31,0,33,"2012"
"15829","430200 BARROS CASSAL",0,1,0,121,1,123,"2012"
"15830","430205 BENJAMIN CONSTANT DO SUL",0,0,1,23,0,24,"2012"
"15831","430210 BENTO GONCALVES",0,3,23,1379,1,1406,"2012"
"15832","430215 BOA VISTA DAS MISSOES",0,0,1,23,0,24,"2012"
"15833","430220 BOA VISTA DO BURICA",0,0,0,64,0,64,"2012"
"15834","430222 BOA VISTA DO CADEADO",0,0,0,7,0,7,"2012"
"15835","430223 BOA VISTA DO INCRA",0,0,1,34,0,35,"2012"
"15836","430225 BOA VISTA DO SUL",0,0,0,17,0,17,"2012"
"15837","430230 BOM JESUS",0,1,2,147,9,159,"2012"
"15838","430235 BOM PRINCIPIO",1,1,0,157,0,159,"2012"
"15839","430237 BOM PROGRESSO",0,0,0,25,0,25,"2012"
"15840","430240 BOM RETIRO DO SUL",0,2,3,145,0,150,"2012"
"15841","430245 BOQUEIRAO DO LEAO",0,1,2,80,0,83,"2012"
"15842","430250 BOSSOROCA",0,0,0,61,0,61,"2012"
"15843","430258 BOZANO",0,0,1,9,0,10,"2012"
"15844","430260 BRAGA",0,0,0,27,0,27,"2012"
"15845","430265 BROCHIER",0,0,0,33,0,33,"2012"
"15846","430270 BUTIA",0,1,2,215,2,220,"2012"
"15847","430280 CACAPAVA DO SUL",0,2,6,342,2,352,"2012"
"15848","430290 CACEQUI",0,1,1,123,2,127,"2012"
"15849","430300 CACHOEIRA DO SUL",2,2,8,984,3,999,"2012"
"15850","430310 CACHOEIRINHA",2,7,30,1886,3,1928,"2012"
"15851","430320 CACIQUE DOBLE",0,1,0,58,0,59,"2012"
"15852","430330 CAIBATE",0,0,1,43,0,44,"2012"
"15853","430340 CAICARA",0,0,0,50,0,50,"2012"
"15854","430350 CAMAQUA",2,2,10,765,4,783,"2012"
"15855","430355 CAMARGO",0,0,1,20,0,21,"2012"
"15856","430360 CAMBARA DO SUL",0,0,0,61,0,61,"2012"
"15857","430367 CAMPESTRE DA SERRA",0,0,0,29,1,30,"2012"
"15858","430370 CAMPINA DAS MISSOES",0,0,2,50,0,52,"2012"
"15859","430380 CAMPINAS DO SUL",0,1,1,56,0,58,"2012"
"15860","430390 CAMPO BOM",1,8,8,837,1,855,"2012"
"15861","430400 CAMPO NOVO",0,0,0,67,0,67,"2012"
"15862","430410 CAMPOS BORGES",0,1,0,40,0,41,"2012"
"15863","430420 CANDELARIA",1,1,6,325,0,333,"2012"
"15864","430430 CANDIDO GODOI",0,0,1,46,0,47,"2012"
"15865","430435 CANDIOTA",0,1,3,129,1,134,"2012"
"15866","430440 CANELA",1,1,20,592,1,615,"2012"
"15867","430450 CANGUCU",3,3,15,551,1,573,"2012"
"15868","430460 CANOAS",9,19,63,5072,13,5176,"2012"
"15869","430461 CANUDOS DO VALE",0,0,0,16,0,16,"2012"
"15870","430462 CAPAO BONITO DO SUL",0,0,0,19,0,19,"2012"
"15871","430463 CAPAO DA CANOA",1,4,12,719,1,737,"2012"
"15872","430465 CAPAO DO CIPO",0,0,1,29,0,30,"2012"
"15873","430466 CAPAO DO LEAO",0,1,8,289,1,299,"2012"
"15874","430467 CAPIVARI DO SUL",0,1,1,47,0,49,"2012"
"15875","430468 CAPELA DE SANTANA",1,1,3,119,0,124,"2012"
"15876","430469 CAPITAO",0,0,0,37,0,37,"2012"
"15877","430470 CARAZINHO",0,5,11,798,10,824,"2012"
"15878","430471 CARAA",0,0,1,39,0,40,"2012"
"15879","430480 CARLOS BARBOSA",0,0,3,250,1,254,"2012"
"15880","430485 CARLOS GOMES",0,0,1,9,0,10,"2012"
"15881","430490 CASCA",0,0,1,75,0,76,"2012"
"15882","430495 CASEIROS",0,0,0,19,0,19,"2012"
"15883","430500 CATUIPE",0,1,1,95,0,97,"2012"
"15884","430510 CAXIAS DO SUL",13,28,97,6029,14,6181,"2012"
"15885","430511 CENTENARIO",0,0,0,13,0,13,"2012"
"15886","430512 CERRITO",0,0,1,50,1,52,"2012"
"15887","430513 CERRO BRANCO",0,0,0,35,1,36,"2012"
"15888","430515 CERRO GRANDE",0,0,0,28,0,28,"2012"
"15889","430517 CERRO GRANDE DO SUL",0,0,2,116,1,119,"2012"
"15890","430520 CERRO LARGO",0,0,1,114,0,115,"2012"
"15891","430530 CHAPADA",0,0,0,80,0,80,"2012"
"15892","430535 CHARQUEADAS",0,0,2,344,2,348,"2012"
"15893","430537 CHARRUA",0,0,0,45,0,45,"2012"
"15894","430540 CHIAPETTA",0,0,0,53,0,53,"2012"
"15895","430543 CHUI",0,0,1,40,0,41,"2012"
"15896","430544 CHUVISCA",0,0,0,59,0,59,"2012"
"15897","430545 CIDREIRA",0,1,1,167,0,169,"2012"
"15898","430550 CIRIACO",0,0,1,40,1,42,"2012"
"15899","430558 COLINAS",0,1,0,25,0,26,"2012"
"15900","430560 COLORADO",0,0,0,37,0,37,"2012"
"15901","430570 CONDOR",0,0,1,34,0,35,"2012"
"15902","430580 CONSTANTINA",0,2,1,115,1,119,"2012"
"15903","430583 COQUEIRO BAIXO",0,1,0,13,0,14,"2012"
"15904","430585 COQUEIROS DO SUL",0,0,1,25,0,26,"2012"
"15905","430587 CORONEL BARROS",0,0,0,29,0,29,"2012"
"15906","430590 CORONEL BICACO",0,0,0,99,1,100,"2012"
"15907","430593 CORONEL PILAR",0,0,0,8,0,8,"2012"
"15908","430595 COTIPORA",0,0,0,24,0,24,"2012"
"15909","430597 COXILHA",0,0,1,40,0,41,"2012"
"15910","430600 CRISSIUMAL",0,0,2,136,0,138,"2012"
"15911","430605 CRISTAL",0,0,1,83,0,84,"2012"
"15912","430607 CRISTAL DO SUL",0,0,0,33,0,33,"2012"
"15913","430610 CRUZ ALTA",1,6,21,887,2,917,"2012"
"15914","430613 CRUZALTENSE",0,0,0,19,0,19,"2012"
"15915","430620 CRUZEIRO DO SUL",0,0,3,93,0,96,"2012"
"15916","430630 DAVID CANABARRO",0,1,0,53,0,54,"2012"
"15917","430632 DERRUBADAS",0,0,0,34,0,34,"2012"
"15918","430635 DEZESSEIS DE NOVEMBRO",0,0,0,23,0,23,"2012"
"15919","430637 DILERMANDO DE AGUIAR",0,0,2,25,0,27,"2012"
"15920","430640 DOIS IRMAOS",0,2,5,359,0,366,"2012"
"15921","430642 DOIS IRMAOS DAS MISSOES",0,0,0,35,0,35,"2012"
"15922","430645 DOIS LAJEADOS",0,0,0,29,0,29,"2012"
"15923","430650 DOM FELICIANO",0,0,0,151,0,151,"2012"
"15924","430655 DOM PEDRO DE ALCANTARA",0,0,0,15,0,15,"2012"
"15925","430660 DOM PEDRITO",0,4,4,473,0,481,"2012"
"15926","430670 DONA FRANCISCA",0,1,2,13,1,17,"2012"
"15927","430673 DOUTOR MAURICIO CARDOSO",0,1,0,32,1,34,"2012"
"15928","430675 DOUTOR RICARDO",0,0,0,11,0,11,"2012"
"15929","430676 ELDORADO DO SUL",0,3,6,539,2,550,"2012"
"15930","430680 ENCANTADO",0,0,4,234,0,238,"2012"
"15931","430690 ENCRUZILHADA DO SUL",0,2,3,308,0,313,"2012"
"15932","430692 ENGENHO VELHO",0,0,1,18,0,19,"2012"
"15933","430693 ENTRE-IJUIS",0,0,2,99,0,101,"2012"
"15934","430695 ENTRE RIOS DO SUL",0,0,1,15,0,16,"2012"
"15935","430697 EREBANGO",0,0,0,29,1,30,"2012"
"15936","430700 ERECHIM",0,3,11,1284,0,1298,"2012"
"15937","430705 ERNESTINA",0,0,0,26,0,26,"2012"
"15938","430710 HERVAL",0,0,1,72,0,73,"2012"
"15939","430720 ERVAL GRANDE",0,0,1,50,0,51,"2012"
"15940","430730 ERVAL SECO",1,0,4,75,0,80,"2012"
"15941","430740 ESMERALDA",0,0,3,27,8,38,"2012"
"15942","430745 ESPERANCA DO SUL",0,0,0,32,0,32,"2012"
"15943","430750 ESPUMOSO",0,0,2,158,0,160,"2012"
"15944","430755 ESTACAO",0,0,1,45,0,46,"2012"
"15945","430760 ESTANCIA VELHA",0,4,3,582,0,589,"2012"
"15946","430770 ESTEIO",1,3,24,1189,3,1220,"2012"
"15947","430780 ESTRELA",2,2,9,375,0,388,"2012"
"15948","430781 ESTRELA VELHA",0,0,0,30,0,30,"2012"
"15949","430783 EUGENIO DE CASTRO",0,0,0,24,0,24,"2012"
"15950","430786 FAGUNDES VARELA",0,0,0,18,0,18,"2012"
"15951","430790 FARROUPILHA",3,2,13,872,0,890,"2012"
"15952","430800 FAXINAL DO SOTURNO",0,1,2,61,1,65,"2012"
"15953","430805 FAXINALZINHO",0,0,0,28,0,28,"2012"
"15954","430807 FAZENDA VILANOVA",0,0,1,61,1,63,"2012"
"15955","430810 FELIZ",0,0,2,136,0,138,"2012"
"15956","430820 FLORES DA CUNHA",0,1,5,339,0,345,"2012"
"15957","430825 FLORIANO PEIXOTO",0,0,1,12,0,13,"2012"
"15958","430830 FONTOURA XAVIER",0,1,4,102,2,109,"2012"
"15959","430840 FORMIGUEIRO",0,0,3,54,1,58,"2012"
"15960","430843 FORQUETINHA",0,0,1,12,0,13,"2012"
"15961","430845 FORTALEZA DOS VALOS",0,1,2,43,1,47,"2012"
"15962","430850 FREDERICO WESTPHALEN",3,0,7,320,1,331,"2012"
"15963","430860 GARIBALDI",0,3,2,315,0,320,"2012"
"15964","430865 GARRUCHOS",0,0,0,37,0,37,"2012"
"15965","430870 GAURAMA",0,0,2,49,0,51,"2012"
"15966","430880 GENERAL CAMARA",0,0,0,70,0,70,"2012"
"15967","430885 GENTIL",0,0,0,17,0,17,"2012"
"15968","430890 GETULIO VARGAS",0,0,5,182,2,189,"2012"
"15969","430900 GIRUA",0,0,3,211,0,214,"2012"
"15970","430905 GLORINHA",0,0,0,73,0,73,"2012"
"15971","430910 GRAMADO",0,1,19,465,2,487,"2012"
"15972","430912 GRAMADO DOS LOUREIROS",0,0,0,27,0,27,"2012"
"15973","430915 GRAMADO XAVIER",0,1,0,38,0,39,"2012"
"15974","430920 GRAVATAI",5,9,41,3505,4,3564,"2012"
"15975","430925 GUABIJU",0,0,0,8,0,8,"2012"
"15976","430930 GUAIBA",1,12,17,1337,10,1377,"2012"
"15977","430940 GUAPORE",0,2,3,281,0,286,"2012"
"15978","430950 GUARANI DAS MISSOES",0,0,0,98,0,98,"2012"
"15979","430955 HARMONIA",0,0,0,50,0,50,"2012"
"15980","430957 HERVEIRAS",0,0,0,33,0,33,"2012"
"15981","430960 HORIZONTINA",0,1,0,184,0,185,"2012"
"15982","430965 HULHA NEGRA",1,2,0,67,0,70,"2012"
"15983","430970 HUMAITA",0,0,2,50,0,52,"2012"
"15984","430975 IBARAMA",0,0,0,37,1,38,"2012"
"15985","430980 IBIACA",0,1,0,30,0,31,"2012"
"15986","430990 IBIRAIARAS",0,0,0,68,0,68,"2012"
"15987","430995 IBIRAPUITA",0,0,0,42,1,43,"2012"
"15988","431000 IBIRUBA",0,0,4,246,0,250,"2012"
"15989","431010 IGREJINHA",0,1,7,471,0,479,"2012"
"15990","431020 IJUI",1,6,16,1041,1,1065,"2012"
"15991","431030 ILOPOLIS",0,0,0,44,0,44,"2012"
"15992","431033 IMBE",0,1,3,252,0,256,"2012"
"15993","431036 IMIGRANTE",0,0,2,27,0,29,"2012"
"15994","431040 INDEPENDENCIA",0,0,1,70,0,71,"2012"
"15995","431041 INHACORA",0,1,0,28,0,29,"2012"
"15996","431043 IPE",0,0,0,57,0,57,"2012"
"15997","431046 IPIRANGA DO SUL",0,0,0,13,0,13,"2012"
"15998","431050 IRAI",0,0,1,87,0,88,"2012"
"15999","431053 ITAARA",1,1,0,55,0,57,"2012"
"16000","431055 ITACURUBI",0,0,0,36,0,36,"2012"
"16001","431057 ITAPUCA",0,0,0,19,0,19,"2012"
"16002","431060 ITAQUI",3,3,14,418,120,558,"2012"
"16003","431065 ITATI",0,0,0,16,0,16,"2012"
"16004","431070 ITATIBA DO SUL",0,0,2,37,0,39,"2012"
"16005","431075 IVORA",0,0,1,13,0,14,"2012"
"16006","431080 IVOTI",0,0,3,270,0,273,"2012"
"16007","431085 JABOTICABA",0,0,1,35,0,36,"2012"
"16008","431087 JACUIZINHO",0,0,0,33,0,33,"2012"
"16009","431090 JACUTINGA",0,0,0,32,0,32,"2012"
"16010","431100 JAGUARAO",1,0,3,298,0,302,"2012"
"16011","431110 JAGUARI",1,0,1,103,0,105,"2012"
"16012","431112 JAQUIRANA",0,0,0,37,10,47,"2012"
"16013","431113 JARI",0,0,0,31,0,31,"2012"
"16014","431115 JOIA",0,0,0,90,0,90,"2012"
"16015","431120 JULIO DE CASTILHOS",0,0,1,225,1,227,"2012"
"16016","431123 LAGOA BONITA DO SUL",0,1,2,15,0,18,"2012"
"16017","431125 LAGOAO",0,1,1,81,1,84,"2012"
"16018","431127 LAGOA DOS TRES CANTOS",0,0,0,11,0,11,"2012"
"16019","431130 LAGOA VERMELHA",1,2,2,371,1,377,"2012"
"16020","431140 LAJEADO",0,4,13,951,0,968,"2012"
"16021","431142 LAJEADO DO BUGRE",0,0,0,33,0,33,"2012"
"16022","431150 LAVRAS DO SUL",1,0,1,67,2,71,"2012"
"16023","431160 LIBERATO SALZANO",0,0,2,46,1,49,"2012"
"16024","431162 LINDOLFO COLLOR",0,0,0,65,0,65,"2012"
"16025","431164 LINHA NOVA",0,0,0,6,0,6,"2012"
"16026","431170 MACHADINHO",0,0,2,57,0,59,"2012"
"16027","431171 MACAMBARA",1,0,0,48,1,50,"2012"
"16028","431173 MAMPITUBA",0,0,0,25,1,26,"2012"
"16029","431175 MANOEL VIANA",0,0,2,72,0,74,"2012"
"16030","431177 MAQUINE",1,0,1,49,1,52,"2012"
"16031","431179 MARATA",0,0,0,16,0,16,"2012"
"16032","431180 MARAU",1,0,8,477,0,486,"2012"
"16033","431190 MARCELINO RAMOS",0,0,0,31,0,31,"2012"
"16034","431198 MARIANA PIMENTEL",0,1,0,32,0,33,"2012"
"16035","431200 MARIANO MORO",0,0,0,24,0,24,"2012"
"16036","431205 MARQUES DE SOUZA",0,0,1,37,0,38,"2012"
"16037","431210 MATA",0,1,0,45,1,47,"2012"
"16038","431213 MATO CASTELHANO",0,0,1,24,0,25,"2012"
"16039","431215 MATO LEITAO",0,0,2,49,0,51,"2012"
"16040","431217 MATO QUEIMADO",0,0,2,13,0,15,"2012"
"16041","431220 MAXIMILIANO DE ALMEIDA",0,0,0,54,0,54,"2012"
"16042","431225 MINAS DO LEAO",0,0,1,112,1,114,"2012"
"16043","431230 MIRAGUAI",0,0,3,53,0,56,"2012"
"16044","431235 MONTAURI",0,0,1,8,0,9,"2012"
"16045","431237 MONTE ALEGRE DOS CAMPOS",0,0,0,22,3,25,"2012"
"16046","431238 MONTE BELO DO SUL",0,0,0,12,0,12,"2012"
"16047","431240 MONTENEGRO",5,4,3,820,1,833,"2012"
"16048","431242 MORMACO",0,0,1,22,0,23,"2012"
"16049","431244 MORRINHOS DO SUL",0,0,1,28,0,29,"2012"
"16050","431245 MORRO REDONDO",1,0,3,40,0,44,"2012"
"16051","431247 MORRO REUTER",0,0,1,60,0,61,"2012"
"16052","431250 MOSTARDAS",0,0,1,115,2,118,"2012"
"16053","431260 MUCUM",0,0,0,33,0,33,"2012"
"16054","431261 MUITOS CAPOES",0,0,0,19,4,23,"2012"
"16055","431262 MULITERNO",0,0,0,22,0,22,"2012"
"16056","431265 NAO-ME-TOQUE",0,1,4,219,0,224,"2012"
"16057","431267 NICOLAU VERGUEIRO",0,0,0,10,0,10,"2012"
"16058","431270 NONOAI",0,0,0,157,0,157,"2012"
"16059","431275 NOVA ALVORADA",0,0,0,30,0,30,"2012"
"16060","431280 NOVA ARACA",0,0,1,48,0,49,"2012"
"16061","431290 NOVA BASSANO",0,0,3,65,0,68,"2012"
"16062","431295 NOVA BOA VISTA",1,0,0,23,0,24,"2012"
"16063","431300 NOVA BRESCIA",0,0,0,30,0,30,"2012"
"16064","431301 NOVA CANDELARIA",0,1,0,27,0,28,"2012"
"16065","431303 NOVA ESPERANCA DO SUL",0,0,2,54,0,56,"2012"
"16066","431306 NOVA HARTZ",0,3,5,265,0,273,"2012"
"16067","431308 NOVA PADUA",0,0,0,16,0,16,"2012"
"16068","431310 NOVA PALMA",0,0,0,59,0,59,"2012"
"16069","431320 NOVA PETROPOLIS",1,1,3,209,0,214,"2012"
"16070","431330 NOVA PRATA",1,2,3,287,0,293,"2012"
"16071","431333 NOVA RAMADA",0,0,0,24,0,24,"2012"
"16072","431335 NOVA ROMA DO SUL",0,0,1,28,0,29,"2012"
"16073","431337 NOVA SANTA RITA",1,1,2,367,3,374,"2012"
"16074","431339 NOVO CABRAIS",0,0,0,44,0,44,"2012"
"16075","431340 NOVO HAMBURGO",2,18,48,3116,10,3194,"2012"
"16076","431342 NOVO MACHADO",0,0,0,19,1,20,"2012"
"16077","431344 NOVO TIRADENTES",0,0,0,20,0,20,"2012"
"16078","431346 NOVO XINGU",0,0,0,11,0,11,"2012"
"16079","431349 NOVO BARREIRO",0,0,1,46,0,47,"2012"
"16080","431350 OSORIO",2,2,10,563,0,577,"2012"
"16081","431360 PAIM FILHO",0,0,0,36,0,36,"2012"
"16082","431365 PALMARES DO SUL",0,2,2,109,0,113,"2012"
"16083","431370 PALMEIRA DAS MISSOES",1,1,5,488,1,496,"2012"
"16084","431380 PALMITINHO",0,2,2,67,0,71,"2012"
"16085","431390 PANAMBI",2,1,7,557,0,567,"2012"
"16086","431395 PANTANO GRANDE",0,0,1,120,1,122,"2012"
"16087","431400 PARAI",0,0,1,73,0,74,"2012"
"16088","431402 PARAISO DO SUL",0,0,0,51,0,51,"2012"
"16089","431403 PARECI NOVO",0,0,0,49,0,49,"2012"
"16090","431405 PAROBE",3,1,13,761,1,779,"2012"
"16091","431406 PASSA SETE",0,0,0,45,0,45,"2012"
"16092","431407 PASSO DO SOBRADO",0,1,0,65,0,66,"2012"
"16093","431410 PASSO FUNDO",8,22,65,2750,1,2846,"2012"
"16094","431413 PAULO BENTO",0,0,1,15,0,16,"2012"
"16095","431415 PAVERAMA",0,1,2,80,0,83,"2012"
"16096","431417 PEDRAS ALTAS",0,0,0,15,0,15,"2012"
"16097","431420 PEDRO OSORIO",1,1,2,79,0,83,"2012"
"16098","431430 PEJUCARA",0,0,0,41,0,41,"2012"
"16099","431440 PELOTAS",10,35,101,4101,21,4268,"2012"
"16100","431442 PICADA CAFE",0,0,3,51,0,54,"2012"
"16101","431445 PINHAL",0,0,0,28,0,28,"2012"
"16102","431446 PINHAL DA SERRA",0,0,0,19,2,21,"2012"
"16103","431447 PINHAL GRANDE",0,0,0,38,0,38,"2012"
"16104","431449 PINHEIRINHO DO VALE",0,0,4,45,0,49,"2012"
"16105","431450 PINHEIRO MACHADO",0,0,0,121,0,121,"2012"
"16106","431455 PIRAPO",0,0,0,16,0,16,"2012"
"16107","431460 PIRATINI",4,0,5,168,0,177,"2012"
"16108","431470 PLANALTO",0,0,2,125,0,127,"2012"
"16109","431475 POCO DAS ANTAS",0,0,0,15,0,15,"2012"
"16110","431477 PONTAO",0,0,0,42,0,42,"2012"
"16111","431478 PONTE PRETA",0,0,0,10,0,10,"2012"
"16112","431480 PORTAO",2,2,2,363,1,370,"2012"
"16113","431490 PORTO ALEGRE",35,104,376,18870,85,19470,"2012"
"16114","431500 PORTO LUCENA",0,0,1,39,0,40,"2012"
"16115","431505 PORTO MAUA",0,0,0,27,0,27,"2012"
"16116","431507 PORTO VERA CRUZ",0,0,0,5,0,5,"2012"
"16117","431510 PORTO XAVIER",0,0,0,113,0,113,"2012"
"16118","431513 POUSO NOVO",0,0,0,14,0,14,"2012"
"16119","431514 PRESIDENTE LUCENA",0,0,1,25,0,26,"2012"
"16120","431515 PROGRESSO",0,0,0,42,1,43,"2012"
"16121","431517 PROTASIO ALVES",0,0,1,18,0,19,"2012"
"16122","431520 PUTINGA",0,1,1,23,0,25,"2012"
"16123","431530 QUARAI",3,5,15,258,0,281,"2012"
"16124","431531 QUATRO IRMAOS",0,0,0,27,0,27,"2012"
"16125","431532 QUEVEDOS",0,2,0,27,1,30,"2012"
"16126","431535 QUINZE DE NOVEMBRO",0,0,1,34,0,35,"2012"
"16127","431540 REDENTORA",0,0,4,181,1,186,"2012"
"16128","431545 RELVADO",0,0,0,8,0,8,"2012"
"16129","431550 RESTINGA SECA",0,1,3,154,0,158,"2012"
"16130","431555 RIO DOS INDIOS",0,0,0,32,0,32,"2012"
"16131","431560 RIO GRANDE",5,21,87,2322,87,2522,"2012"
"16132","431570 RIO PARDO",1,0,9,357,0,367,"2012"
"16133","431575 RIOZINHO",0,0,1,31,0,32,"2012"
"16134","431580 ROCA SALES",0,0,0,97,0,97,"2012"
"16135","431590 RODEIO BONITO",0,0,0,64,0,64,"2012"
"16136","431595 ROLADOR",0,0,0,20,0,20,"2012"
"16137","431600 ROLANTE",0,4,7,236,0,247,"2012"
"16138","431610 RONDA ALTA",0,1,5,108,0,114,"2012"
"16139","431620 RONDINHA",0,2,3,48,0,53,"2012"
"16140","431630 ROQUE GONZALES",0,0,0,47,0,47,"2012"
"16141","431640 ROSARIO DO SUL",1,2,8,434,0,445,"2012"
"16142","431642 SAGRADA FAMILIA",0,0,0,24,0,24,"2012"
"16143","431643 SALDANHA MARINHO",0,0,0,18,0,18,"2012"
"16144","431645 SALTO DO JACUI",0,0,2,130,0,132,"2012"
"16145","431647 SALVADOR DAS MISSOES",0,0,0,25,0,25,"2012"
"16146","431650 SALVADOR DO SUL",1,0,0,75,0,76,"2012"
"16147","431660 SANANDUVA",0,0,3,146,0,149,"2012"
"16148","431670 SANTA BARBARA DO SUL",0,0,1,91,0,92,"2012"
"16149","431673 SANTA CECILIA DO SUL",0,0,0,24,0,24,"2012"
"16150","431675 SANTA CLARA DO SUL",0,1,0,62,0,63,"2012"
"16151","431680 SANTA CRUZ DO SUL",3,5,17,1548,2,1575,"2012"
"16152","431690 SANTA MARIA",7,15,61,3531,10,3624,"2012"
"16153","431695 SANTA MARIA DO HERVAL",0,0,0,37,1,38,"2012"
"16154","431697 SANTA MARGARIDA DO SUL",0,0,1,19,0,20,"2012"
"16155","431700 SANTANA DA BOA VISTA",1,1,3,65,0,70,"2012"
"16156","431710 SANT'ANA DO LIVRAMENTO",2,1,6,1039,0,1048,"2012"
"16157","431720 SANTA ROSA",2,2,34,880,1,919,"2012"
"16158","431725 SANTA TEREZA",0,0,0,7,0,7,"2012"
"16159","431730 SANTA VITORIA DO PALMAR",0,1,12,334,0,347,"2012"
"16160","431740 SANTIAGO",1,0,3,545,1,550,"2012"
"16161","431750 SANTO ANGELO",1,1,5,975,1,983,"2012"
"16162","431755 SANTO ANTONIO DO PALMA",0,0,0,21,0,21,"2012"
"16163","431760 SANTO ANTONIO DA PATRULHA",0,3,10,447,0,460,"2012"
"16164","431770 SANTO ANTONIO DAS MISSOES",0,0,1,109,0,110,"2012"
"16165","431775 SANTO ANTONIO DO PLANALTO",0,0,0,20,0,20,"2012"
"16166","431780 SANTO AUGUSTO",0,0,2,193,0,195,"2012"
"16167","431790 SANTO CRISTO",0,0,8,131,0,139,"2012"
"16168","431795 SANTO EXPEDITO DO SUL",0,0,0,16,0,16,"2012"
"16169","431800 SAO BORJA",3,0,4,753,1,761,"2012"
"16170","431805 SAO DOMINGOS DO SUL",0,0,0,27,0,27,"2012"
"16171","431810 SAO FRANCISCO DE ASSIS",0,0,0,174,0,174,"2012"
"16172","431820 SAO FRANCISCO DE PAULA",1,3,2,275,2,283,"2012"
"16173","431830 SAO GABRIEL",3,7,7,769,4,790,"2012"
"16174","431840 SAO JERONIMO",0,0,2,293,0,295,"2012"
"16175","431842 SAO JOAO DA URTIGA",1,0,1,21,0,23,"2012"
"16176","431843 SAO JOAO DO POLESINE",0,0,0,24,0,24,"2012"
"16177","431844 SAO JORGE",0,0,0,22,0,22,"2012"
"16178","431845 SAO JOSE DAS MISSOES",0,0,0,23,0,23,"2012"
"16179","431846 SAO JOSE DO HERVAL",0,0,0,14,0,14,"2012"
"16180","431848 SAO JOSE DO HORTENCIO",0,1,1,38,0,40,"2012"
"16181","431849 SAO JOSE DO INHACORA",0,0,0,13,0,13,"2012"
"16182","431850 SAO JOSE DO NORTE",2,1,5,267,7,282,"2012"
"16183","431860 SAO JOSE DO OURO",0,0,0,79,0,79,"2012"
"16184","431861 SAO JOSE DO SUL",0,0,0,19,0,19,"2012"
"16185","431862 SAO JOSE DOS AUSENTES",0,0,0,27,9,36,"2012"
"16186","431870 SAO LEOPOLDO",13,19,47,2787,12,2878,"2012"
"16187","431880 SAO LOURENCO DO SUL",1,4,18,443,0,466,"2012"
"16188","431890 SAO LUIZ GONZAGA",1,0,2,401,1,405,"2012"
"16189","431900 SAO MARCOS",1,1,3,221,0,226,"2012"
"16190","431910 SAO MARTINHO",0,0,0,58,0,58,"2012"
"16191","431912 SAO MARTINHO DA SERRA",0,0,1,25,0,26,"2012"
"16192","431915 SAO MIGUEL DAS MISSOES",0,0,1,90,1,92,"2012"
"16193","431920 SAO NICOLAU",0,0,0,72,0,72,"2012"
"16194","431930 SAO PAULO DAS MISSOES",0,1,1,58,0,60,"2012"
"16195","431935 SAO PEDRO DA SERRA",0,0,0,33,0,33,"2012"
"16196","431936 SAO PEDRO DAS MISSOES",0,0,0,28,0,28,"2012"
"16197","431937 SAO PEDRO DO BUTIA",0,0,1,23,0,24,"2012"
"16198","431940 SAO PEDRO DO SUL",0,1,2,145,1,149,"2012"
"16199","431950 SAO SEBASTIAO DO CAI",2,0,2,313,0,317,"2012"
"16200","431960 SAO SEPE",0,1,1,240,0,242,"2012"
"16201","431970 SAO VALENTIM",0,0,1,30,0,31,"2012"
"16202","431971 SAO VALENTIM DO SUL",0,0,0,5,0,5,"2012"
"16203","431973 SAO VALERIO DO SUL",0,0,0,49,0,49,"2012"
"16204","431975 SAO VENDELINO",0,0,0,20,0,20,"2012"
"16205","431980 SAO VICENTE DO SUL",1,0,2,84,0,87,"2012"
"16206","431990 SAPIRANGA",6,2,12,1064,0,1084,"2012"
"16207","432000 SAPUCAIA DO SUL",2,14,56,1826,4,1902,"2012"
"16208","432010 SARANDI",0,0,2,255,0,257,"2012"
"16209","432020 SEBERI",0,0,3,93,0,96,"2012"
"16210","432023 SEDE NOVA",0,0,1,27,0,28,"2012"
"16211","432026 SEGREDO",0,0,0,65,0,65,"2012"
"16212","432030 SELBACH",0,0,1,55,0,56,"2012"
"16213","432032 SENADOR SALGADO FILHO",0,0,0,23,0,23,"2012"
"16214","432035 SENTINELA DO SUL",0,0,0,51,0,51,"2012"
"16215","432040 SERAFINA CORREA",1,0,0,169,0,170,"2012"
"16216","432045 SERIO",0,0,1,11,0,12,"2012"
"16217","432050 SERTAO",0,0,1,51,0,52,"2012"
"16218","432055 SERTAO SANTANA",0,0,0,58,0,58,"2012"
"16219","432057 SETE DE SETEMBRO",0,0,0,15,1,16,"2012"
"16220","432060 SEVERIANO DE ALMEIDA",0,0,0,30,0,30,"2012"
"16221","432065 SILVEIRA MARTINS",0,0,0,23,0,23,"2012"
"16222","432067 SINIMBU",0,0,1,86,0,87,"2012"
"16223","432070 SOBRADINHO",0,0,3,167,0,170,"2012"
"16224","432080 SOLEDADE",1,1,4,336,0,342,"2012"
"16225","432085 TABAI",0,0,0,46,0,46,"2012"
"16226","432090 TAPEJARA",0,0,3,234,0,237,"2012"
"16227","432100 TAPERA",1,0,0,122,0,123,"2012"
"16228","432110 TAPES",1,1,6,178,0,186,"2012"
"16229","432120 TAQUARA",1,2,9,674,1,687,"2012"
"16230","432130 TAQUARI",0,0,4,274,0,278,"2012"
"16231","432132 TAQUARUCU DO SUL",1,0,0,33,0,34,"2012"
"16232","432135 TAVARES",0,0,1,38,1,40,"2012"
"16233","432140 TENENTE PORTELA",0,0,3,216,0,219,"2012"
"16234","432143 TERRA DE AREIA",0,0,2,111,0,113,"2012"
"16235","432145 TEUTONIA",0,1,1,423,0,425,"2012"
"16236","432146 TIO HUGO",0,0,0,33,0,33,"2012"
"16237","432147 TIRADENTES DO SUL",0,0,0,59,1,60,"2012"
"16238","432149 TOROPI",0,0,1,18,0,19,"2012"
"16239","432150 TORRES",1,5,2,526,2,536,"2012"
"16240","432160 TRAMANDAI",1,3,14,642,1,661,"2012"
"16241","432162 TRAVESSEIRO",0,0,1,18,0,19,"2012"
"16242","432163 TRES ARROIOS",0,0,0,17,0,17,"2012"
"16243","432166 TRES CACHOEIRAS",0,1,1,101,0,103,"2012"
"16244","432170 TRES COROAS",1,1,5,312,3,322,"2012"
"16245","432180 TRES DE MAIO",1,1,4,254,0,260,"2012"
"16246","432183 TRES FORQUILHAS",0,1,0,29,0,30,"2012"
"16247","432185 TRES PALMEIRAS",0,0,1,55,1,57,"2012"
"16248","432190 TRES PASSOS",1,2,0,310,0,313,"2012"
"16249","432195 TRINDADE DO SUL",0,0,0,72,0,72,"2012"
"16250","432200 TRIUNFO",0,2,6,376,0,384,"2012"
"16251","432210 TUCUNDUVA",0,0,0,39,0,39,"2012"
"16252","432215 TUNAS",1,0,1,41,0,43,"2012"
"16253","432218 TUPANCI DO SUL",0,0,1,16,0,17,"2012"
"16254","432220 TUPANCIRETA",0,2,6,276,0,284,"2012"
"16255","432225 TUPANDI",0,0,0,52,1,53,"2012"
"16256","432230 TUPARENDI",0,0,4,63,0,67,"2012"
"16257","432232 TURUCU",0,1,1,31,0,33,"2012"
"16258","432234 UBIRETAMA",0,0,0,22,0,22,"2012"
"16259","432235 UNIAO DA SERRA",0,0,1,6,0,7,"2012"
"16260","432237 UNISTALDA",0,0,0,23,0,23,"2012"
"16261","432240 URUGUAIANA",8,12,41,1255,558,1874,"2012"
"16262","432250 VACARIA",2,1,15,791,167,976,"2012"
"16263","432252 VALE VERDE",0,0,0,22,0,22,"2012"
"16264","432253 VALE DO SOL",1,0,0,80,0,81,"2012"
"16265","432254 VALE REAL",0,0,0,53,0,53,"2012"
"16266","432255 VANINI",1,0,1,24,0,26,"2012"
"16267","432260 VENANCIO AIRES",3,3,12,755,1,774,"2012"
"16268","432270 VERA CRUZ",0,0,3,277,1,281,"2012"
"16269","432280 VERANOPOLIS",0,0,3,278,2,283,"2012"
"16270","432285 VESPASIANO CORREA",0,0,1,9,0,10,"2012"
"16271","432290 VIADUTOS",0,0,1,47,0,48,"2012"
"16272","432300 VIAMAO",11,25,81,3268,24,3409,"2012"
"16273","432310 VICENTE DUTRA",0,0,1,75,0,76,"2012"
"16274","432320 VICTOR GRAEFF",0,0,0,19,0,19,"2012"
"16275","432330 VILA FLORES",0,0,1,26,0,27,"2012"
"16276","432335 VILA LANGARO",0,0,0,19,0,19,"2012"
"16277","432340 VILA MARIA",0,0,0,34,0,34,"2012"
"16278","432345 VILA NOVA DO SUL",0,0,0,43,0,43,"2012"
"16279","432350 VISTA ALEGRE",0,1,0,14,0,15,"2012"
"16280","432360 VISTA ALEGRE DO PRATA",0,0,0,9,0,9,"2012"
"16281","432370 VISTA GAUCHA",1,0,0,28,0,29,"2012"
"16282","432375 VITORIA DAS MISSOES",0,0,0,34,0,34,"2012"
"16283","432377 WESTFALIA",0,0,0,34,0,34,"2012"
"16284","432380 XANGRI-LA",0,1,3,192,0,196,"2012"
"16285","500020 AGUA CLARA",2,0,2,257,2,263,"2012"
"16286","500025 ALCINOPOLIS",0,0,0,42,0,42,"2012"
"16287","500060 AMAMBAI",3,2,11,731,0,747,"2012"
"16288","500070 ANASTACIO",1,0,6,389,1,397,"2012"
"16289","500080 ANAURILANDIA",0,0,2,93,0,95,"2012"
"16290","500085 ANGELICA",0,2,1,165,0,168,"2012"
"16291","500090 ANTONIO JOAO",0,1,4,151,0,156,"2012"
"16292","500100 APARECIDA DO TABOADO",1,0,9,332,0,342,"2012"
"16293","500110 AQUIDAUANA",6,1,8,738,8,761,"2012"
"16294","500124 ARAL MOREIRA",1,40,1,118,7,167,"2012"
"16295","500150 BANDEIRANTES",0,1,2,86,1,90,"2012"
"16296","500190 BATAGUASSU",1,0,2,330,3,336,"2012"
"16297","500200 BATAYPORA",0,0,2,149,0,151,"2012"
"16298","500210 BELA VISTA",3,2,3,382,1,391,"2012"
"16299","500215 BODOQUENA",0,0,0,97,1,98,"2012"
"16300","500220 BONITO",1,0,5,320,3,329,"2012"
"16301","500230 BRASILANDIA",1,0,2,160,1,164,"2012"
"16302","500240 CAARAPO",0,2,4,447,0,453,"2012"
"16303","500260 CAMAPUA",2,0,4,185,3,194,"2012"
"16304","500270 CAMPO GRANDE",30,42,136,13084,247,13539,"2012"
"16305","500280 CARACOL",0,1,1,89,0,91,"2012"
"16306","500290 CASSILANDIA",3,0,1,277,0,281,"2012"
"16307","500295 CHAPADAO DO SUL",2,0,5,355,0,362,"2012"
"16308","500310 CORGUINHO",0,0,1,46,1,48,"2012"
"16309","500315 CORONEL SAPUCAIA",1,3,4,308,12,328,"2012"
"16310","500320 CORUMBA",2,12,14,1798,7,1833,"2012"
"16311","500325 COSTA RICA",8,2,3,378,0,391,"2012"
"16312","500330 COXIM",2,1,5,508,2,518,"2012"
"16313","500345 DEODAPOLIS",0,1,3,179,0,183,"2012"
"16314","500348 DOIS IRMAOS DO BURITI",0,0,4,118,23,145,"2012"
"16315","500350 DOURADINA",0,1,2,81,0,84,"2012"
"16316","500370 DOURADOS",6,19,85,3565,19,3694,"2012"
"16317","500375 ELDORADO",1,0,0,222,0,223,"2012"
"16318","500380 FATIMA DO SUL",0,1,0,233,2,236,"2012"
"16319","500390 FIGUEIRAO",0,0,1,35,1,37,"2012"
"16320","500400 GLORIA DE DOURADOS",0,1,1,104,0,106,"2012"
"16321","500410 GUIA LOPES DA LAGUNA",0,0,2,163,4,169,"2012"
"16322","500430 IGUATEMI",1,0,1,230,0,232,"2012"
"16323","500440 INOCENCIA",0,0,3,110,0,113,"2012"
"16324","500450 ITAPORA",0,1,2,253,0,256,"2012"
"16325","500460 ITAQUIRAI",0,1,3,223,1,228,"2012"
"16326","500470 IVINHEMA",1,0,5,333,1,340,"2012"
"16327","500480 JAPORA",0,1,24,150,9,184,"2012"
"16328","500490 JARAGUARI",0,0,2,50,0,52,"2012"
"16329","500500 JARDIM",2,3,4,389,2,400,"2012"
"16330","500510 JATEI",0,0,1,49,0,50,"2012"
"16331","500515 JUTI",1,1,4,83,0,89,"2012"
"16332","500520 LADARIO",1,6,8,355,2,372,"2012"
"16333","500525 LAGUNA CARAPA",0,0,1,139,4,144,"2012"
"16334","500540 MARACAJU",3,3,17,620,1,644,"2012"
"16335","500560 MIRANDA",2,2,21,489,3,517,"2012"
"16336","500568 MUNDO NOVO",0,3,64,204,0,271,"2012"
"16337","500570 NAVIRAI",2,3,6,889,1,901,"2012"
"16338","500580 NIOAQUE",1,0,4,163,4,172,"2012"
"16339","500600 NOVA ALVORADA DO SUL",0,1,4,344,2,351,"2012"
"16340","500620 NOVA ANDRADINA",1,3,7,766,0,777,"2012"
"16341","500625 NOVO HORIZONTE DO SUL",0,0,1,71,0,72,"2012"
"16342","500630 PARANAIBA",2,2,11,572,0,587,"2012"
"16343","500635 PARANHOS",0,1,1,282,75,359,"2012"
"16344","500640 PEDRO GOMES",0,0,2,87,0,89,"2012"
"16345","500660 PONTA PORA",4,10,32,1495,254,1795,"2012"
"16346","500690 PORTO MURTINHO",0,1,10,261,9,281,"2012"
"16347","500710 RIBAS DO RIO PARDO",0,2,4,362,8,376,"2012"
"16348","500720 RIO BRILHANTE",0,2,10,623,2,637,"2012"
"16349","500730 RIO NEGRO",0,0,0,44,1,45,"2012"
"16350","500740 RIO VERDE DE MATO GROSSO",0,1,0,276,1,278,"2012"
"16351","500750 ROCHEDO",1,0,1,60,5,67,"2012"
"16352","500755 SANTA RITA DO PARDO",0,0,0,105,0,105,"2012"
"16353","500769 SAO GABRIEL DO OESTE",0,2,3,402,1,408,"2012"
"16354","500770 SETE QUEDAS",0,0,1,170,9,180,"2012"
"16355","500780 SELVIRIA",0,0,2,41,3,46,"2012"
"16356","500790 SIDROLANDIA",2,1,16,631,6,656,"2012"
"16357","500793 SONORA",2,1,3,246,0,252,"2012"
"16358","500795 TACURU",0,1,3,217,0,221,"2012"
"16359","500797 TAQUARUSSU",0,0,0,46,0,46,"2012"
"16360","500800 TERENOS",0,1,2,165,0,168,"2012"
"16361","500830 TRES LAGOAS",2,4,8,1788,2,1804,"2012"
"16362","500840 VICENTINA",0,0,0,75,0,75,"2012"
"16363","MUNICIPIO IGNORADO - MT",0,0,0,2,0,2,"2012"
"16364","510010 ACORIZAL",1,0,0,75,1,77,"2012"
"16365","510020 AGUA BOA",0,2,7,355,16,380,"2012"
"16366","510025 ALTA FLORESTA",1,2,10,812,2,827,"2012"
"16367","510030 ALTO ARAGUAIA",1,1,5,253,0,260,"2012"
"16368","510035 ALTO BOA VISTA",1,0,1,55,0,57,"2012"
"16369","510040 ALTO GARCAS",2,0,1,107,0,110,"2012"
"16370","510050 ALTO PARAGUAI",0,0,3,86,0,89,"2012"
"16371","510060 ALTO TAQUARI",0,1,2,194,0,197,"2012"
"16372","510080 APIACAS",0,0,4,124,0,128,"2012"
"16373","510100 ARAGUAIANA",0,0,1,43,0,44,"2012"
"16374","510120 ARAGUAINHA",0,0,0,10,0,10,"2012"
"16375","510125 ARAPUTANGA",0,0,0,256,0,256,"2012"
"16376","510130 ARENAPOLIS",0,0,6,145,0,151,"2012"
"16377","510140 ARIPUANA",1,1,3,372,2,379,"2012"
"16378","510160 BARAO DE MELGACO",0,0,0,63,1,64,"2012"
"16379","510170 BARRA DO BUGRES",1,4,7,472,3,487,"2012"
"16380","510180 BARRA DO GARCAS",8,7,16,886,12,929,"2012"
"16381","510185 BOM JESUS DO ARAGUAIA",0,0,0,68,3,71,"2012"
"16382","510190 BRASNORTE",1,3,2,232,10,248,"2012"
"16383","510250 CACERES",5,7,17,1451,4,1484,"2012"
"16384","510260 CAMPINAPOLIS",0,1,2,147,124,274,"2012"
"16385","510263 CAMPO NOVO DO PARECIS",1,8,13,556,1,579,"2012"
"16386","510267 CAMPO VERDE",1,4,5,596,1,607,"2012"
"16387","510268 CAMPOS DE JULIO",1,1,1,96,0,99,"2012"
"16388","510269 CANABRAVA DO NORTE",1,0,0,66,0,67,"2012"
"16389","510270 CANARANA",2,0,4,360,19,385,"2012"
"16390","510279 CARLINDA",0,0,2,111,0,113,"2012"
"16391","510285 CASTANHEIRA",0,0,0,100,0,100,"2012"
"16392","510300 CHAPADA DOS GUIMARAES",1,2,1,230,0,234,"2012"
"16393","510305 CLAUDIA",0,0,0,117,0,117,"2012"
"16394","510310 COCALINHO",0,0,1,74,0,75,"2012"
"16395","510320 COLIDER",2,3,14,441,0,460,"2012"
"16396","510325 COLNIZA",0,1,4,442,4,451,"2012"
"16397","510330 COMODORO",2,0,2,343,35,382,"2012"
"16398","510335 CONFRESA",3,0,5,406,2,416,"2012"
"16399","510336 CONQUISTA D'OESTE",0,1,0,59,1,61,"2012"
"16400","510337 COTRIGUACU",0,0,1,185,4,190,"2012"
"16401","510340 CUIABA",19,62,118,9580,10,9789,"2012"
"16402","510343 CURVELANDIA",1,0,0,54,0,55,"2012"
"16403","510345 DENISE",1,0,2,112,0,115,"2012"
"16404","510350 DIAMANTINO",3,0,4,318,0,325,"2012"
"16405","510360 DOM AQUINO",1,0,3,94,0,98,"2012"
"16406","510370 FELIZ NATAL",1,0,1,143,23,168,"2012"
"16407","510380 FIGUEIROPOLIS D'OESTE",0,0,1,57,0,58,"2012"
"16408","510385 GAUCHA DO NORTE",0,1,1,85,19,106,"2012"
"16409","510390 GENERAL CARNEIRO",0,0,3,91,9,103,"2012"
"16410","510395 GLORIA D'OESTE",0,0,0,27,0,27,"2012"
"16411","510410 GUARANTA DO NORTE",2,2,9,424,1,438,"2012"
"16412","510420 GUIRATINGA",0,0,2,104,0,106,"2012"
"16413","510450 INDIAVAI",0,0,0,44,0,44,"2012"
"16414","510452 IPIRANGA DO NORTE",0,0,1,86,0,87,"2012"
"16415","510454 ITANHANGA",0,1,2,80,0,83,"2012"
"16416","510455 ITAUBA",2,0,1,85,0,88,"2012"
"16417","510460 ITIQUIRA",1,3,5,157,0,166,"2012"
"16418","510480 JACIARA",12,4,1,425,0,442,"2012"
"16419","510490 JANGADA",0,0,1,112,1,114,"2012"
"16420","510500 JAURU",0,1,3,138,3,145,"2012"
"16421","510510 JUARA",0,1,2,506,24,533,"2012"
"16422","510515 JUINA",3,4,10,584,26,627,"2012"
"16423","510517 JURUENA",0,0,3,161,0,164,"2012"
"16424","510520 JUSCIMEIRA",6,0,2,157,0,165,"2012"
"16425","510523 LAMBARI D'OESTE",2,0,0,74,0,76,"2012"
"16426","510525 LUCAS DO RIO VERDE",3,2,8,975,2,990,"2012"
"16427","510530 LUCIARA",0,0,0,42,0,42,"2012"
"16428","510550 VILA BELA DA SANTISSIMA TRINDADE",0,0,1,216,9,226,"2012"
"16429","510558 MARCELANDIA",1,5,18,154,3,181,"2012"
"16430","510560 MATUPA",0,0,7,178,1,186,"2012"
"16431","510562 MIRASSOL D'OESTE",0,3,6,415,2,426,"2012"
"16432","510590 NOBRES",1,2,6,249,1,259,"2012"
"16433","510600 NORTELANDIA",0,0,2,83,0,85,"2012"
"16434","510610 NOSSA SENHORA DO LIVRAMENTO",0,0,5,127,1,133,"2012"
"16435","510615 NOVA BANDEIRANTES",0,2,2,153,0,157,"2012"
"16436","510617 NOVA NAZARE",0,0,3,26,38,67,"2012"
"16437","510618 NOVA LACERDA",0,2,0,71,0,73,"2012"
"16438","510619 NOVA SANTA HELENA",1,0,1,40,0,42,"2012"
"16439","510620 NOVA BRASILANDIA",0,0,0,56,0,56,"2012"
"16440","510621 NOVA CANAA DO NORTE",0,1,3,186,0,190,"2012"
"16441","510622 NOVA MUTUM",2,3,10,642,1,658,"2012"
"16442","510623 NOVA OLIMPIA",2,0,2,288,0,292,"2012"
"16443","510624 NOVA UBIRATA",1,0,3,126,0,130,"2012"
"16444","510625 NOVA XAVANTINA",0,0,0,266,1,267,"2012"
"16445","510626 NOVO MUNDO",2,1,1,73,0,77,"2012"
"16446","510627 NOVO HORIZONTE DO NORTE",0,0,1,45,0,46,"2012"
"16447","510628 NOVO SAO JOAQUIM",0,0,5,93,2,100,"2012"
"16448","510629 PARANAITA",0,0,1,144,1,146,"2012"
"16449","510630 PARANATINGA",1,0,9,323,23,356,"2012"
"16450","510631 NOVO SANTO ANTONIO",0,0,0,18,0,18,"2012"
"16451","510637 PEDRA PRETA",1,0,4,219,1,225,"2012"
"16452","510642 PEIXOTO DE AZEVEDO",2,3,21,454,2,482,"2012"
"16453","510645 PLANALTO DA SERRA",0,0,0,28,0,28,"2012"
"16454","510650 POCONE",0,1,4,384,0,389,"2012"
"16455","510665 PONTAL DO ARAGUAIA",0,0,0,80,0,80,"2012"
"16456","510670 PONTE BRANCA",0,1,3,10,0,14,"2012"
"16457","510675 PONTES E LACERDA",6,7,8,773,0,794,"2012"
"16458","510677 PORTO ALEGRE DO NORTE",0,0,0,134,0,134,"2012"
"16459","510680 PORTO DOS GAUCHOS",1,0,2,74,1,78,"2012"
"16460","510682 PORTO ESPERIDIAO",0,0,0,156,0,156,"2012"
"16461","510685 PORTO ESTRELA",0,0,0,39,0,39,"2012"
"16462","510700 POXOREO",0,1,6,223,4,234,"2012"
"16463","510704 PRIMAVERA DO LESTE",4,2,9,1067,3,1085,"2012"
"16464","510706 QUERENCIA",1,0,2,246,20,269,"2012"
"16465","510710 SAO JOSE DOS QUATRO MARCOS",2,1,4,235,0,242,"2012"
"16466","510715 RESERVA DO CABACAL",0,0,0,40,0,40,"2012"
"16467","510718 RIBEIRAO CASCALHEIRA",1,1,4,139,10,155,"2012"
"16468","510719 RIBEIRAOZINHO",0,0,0,30,0,30,"2012"
"16469","510720 RIO BRANCO",0,0,1,75,0,76,"2012"
"16470","510724 SANTA CARMEM",0,0,0,53,0,53,"2012"
"16471","510726 SANTO AFONSO",0,0,0,26,0,26,"2012"
"16472","510729 SAO JOSE DO POVO",0,0,0,21,0,21,"2012"
"16473","510730 SAO JOSE DO RIO CLARO",1,1,8,223,0,233,"2012"
"16474","510735 SAO JOSE DO XINGU",0,0,0,73,1,74,"2012"
"16475","510740 SAO PEDRO DA CIPA",0,0,2,68,0,70,"2012"
"16476","510757 RONDOLANDIA",0,0,2,35,0,37,"2012"
"16477","510760 RONDONOPOLIS",32,9,45,3567,14,3667,"2012"
"16478","510770 ROSARIO OESTE",0,0,4,153,0,157,"2012"
"16479","510774 SANTA CRUZ DO XINGU",0,0,2,21,0,23,"2012"
"16480","510775 SALTO DO CEU",0,0,0,36,0,36,"2012"
"16481","510776 SANTA RITA DO TRIVELATO",0,0,0,45,0,45,"2012"
"16482","510777 SANTA TEREZINHA",0,0,1,96,3,100,"2012"
"16483","510779 SANTO ANTONIO DO LESTE",0,0,2,42,1,45,"2012"
"16484","510780 SANTO ANTONIO DO LEVERGER",1,1,1,210,0,213,"2012"
"16485","510785 SAO FELIX DO ARAGUAIA",0,0,0,122,6,128,"2012"
"16486","510787 SAPEZAL",2,1,9,382,0,394,"2012"
"16487","510788 SERRA NOVA DOURADA",0,1,0,14,0,15,"2012"
"16488","510790 SINOP",7,6,26,2187,5,2231,"2012"
"16489","510792 SORRISO",6,4,16,1334,5,1365,"2012"
"16490","510794 TABAPORA",0,0,2,121,0,123,"2012"
"16491","510795 TANGARA DA SERRA",2,7,27,1333,2,1371,"2012"
"16492","510800 TAPURAH",0,2,2,187,0,191,"2012"
"16493","510805 TERRA NOVA DO NORTE",0,0,2,141,0,143,"2012"
"16494","510810 TESOURO",0,0,1,14,0,15,"2012"
"16495","510820 TORIXOREU",0,0,0,37,0,37,"2012"
"16496","510830 UNIAO DO SUL",1,0,1,59,0,61,"2012"
"16497","510835 VALE DE SAO DOMINGOS",1,1,0,33,0,35,"2012"
"16498","510840 VARZEA GRANDE",14,21,66,4769,16,4886,"2012"
"16499","510850 VERA",1,0,1,136,0,138,"2012"
"16500","510860 VILA RICA",0,1,0,298,2,301,"2012"
"16501","510880 NOVA GUARITA",0,0,3,53,0,56,"2012"
"16502","510885 NOVA MARILANDIA",0,1,1,47,0,49,"2012"
"16503","510890 NOVA MARINGA",0,1,1,80,0,82,"2012"
"16504","510895 NOVA MONTE VERDE",1,1,0,96,2,100,"2012"
"16505","MUNICIPIO IGNORADO - GO",0,0,0,9,0,9,"2012"
"16506","520005 ABADIA DE GOIAS",1,0,1,139,2,143,"2012"
"16507","520010 ABADIANIA",1,0,1,202,1,205,"2012"
"16508","520013 ACREUNA",1,0,54,258,0,313,"2012"
"16509","520015 ADELANDIA",0,0,1,27,0,28,"2012"
"16510","520017 AGUA FRIA DE GOIAS",0,0,0,53,0,53,"2012"
"16511","520020 AGUA LIMPA",0,0,1,19,0,20,"2012"
"16512","520025 AGUAS LINDAS DE GOIAS",6,8,55,2351,191,2611,"2012"
"16513","520030 ALEXANIA",0,3,1,326,12,342,"2012"
"16514","520050 ALOANDIA",0,0,2,23,0,25,"2012"
"16515","520055 ALTO HORIZONTE",0,0,0,90,0,90,"2012"
"16516","520060 ALTO PARAISO DE GOIAS",0,1,2,96,0,99,"2012"
"16517","520080 ALVORADA DO NORTE",0,0,1,146,0,147,"2012"
"16518","520082 AMARALINA",0,1,0,19,0,20,"2012"
"16519","520085 AMERICANO DO BRASIL",0,0,1,95,1,97,"2012"
"16520","520090 AMORINOPOLIS",0,0,0,41,0,41,"2012"
"16521","520110 ANAPOLIS",20,24,124,5471,14,5653,"2012"
"16522","520120 ANHANGUERA",0,0,0,10,0,10,"2012"
"16523","520130 ANICUNS",2,0,11,208,2,223,"2012"
"16524","520140 APARECIDA DE GOIANIA",37,42,128,7858,55,8120,"2012"
"16525","520145 APARECIDA DO RIO DOCE",0,1,0,26,0,27,"2012"
"16526","520150 APORE",0,0,1,65,0,66,"2012"
"16527","520160 ARACU",1,0,2,39,0,42,"2012"
"16528","520170 ARAGARCAS",0,1,18,265,3,287,"2012"
"16529","520180 ARAGOIANIA",1,2,4,106,4,117,"2012"
"16530","520215 ARAGUAPAZ",2,1,4,67,0,74,"2012"
"16531","520235 ARENOPOLIS",1,0,0,32,0,33,"2012"
"16532","520250 ARUANA",0,1,1,115,0,117,"2012"
"16533","520260 AURILANDIA",0,0,1,36,0,37,"2012"
"16534","520280 AVELINOPOLIS",0,1,1,23,0,25,"2012"
"16535","520310 BALIZA",0,0,0,31,0,31,"2012"
"16536","520320 BARRO ALTO",1,1,1,117,0,120,"2012"
"16537","520330 BELA VISTA DE GOIAS",1,2,10,335,3,351,"2012"
"16538","520340 BOM JARDIM DE GOIAS",0,0,5,108,0,113,"2012"
"16539","520350 BOM JESUS DE GOIAS",2,1,5,230,0,238,"2012"
"16540","520355 BONFINOPOLIS",1,1,4,110,0,116,"2012"
"16541","520357 BONOPOLIS",1,0,3,41,0,45,"2012"
"16542","520360 BRAZABRANTES",0,0,1,40,0,41,"2012"
"16543","520380 BRITANIA",0,0,1,77,0,78,"2012"
"16544","520390 BURITI ALEGRE",0,0,4,106,0,110,"2012"
"16545","520393 BURITI DE GOIAS",0,2,2,22,0,26,"2012"
"16546","520396 BURITINOPOLIS",0,0,1,33,0,34,"2012"
"16547","520400 CABECEIRAS",0,0,3,112,0,115,"2012"
"16548","520410 CACHOEIRA ALTA",0,1,2,90,0,93,"2012"
"16549","520420 CACHOEIRA DE GOIAS",0,0,0,14,0,14,"2012"
"16550","520425 CACHOEIRA DOURADA",0,2,2,109,1,114,"2012"
"16551","520430 CACU",0,4,4,111,0,119,"2012"
"16552","520440 CAIAPONIA",3,1,6,182,0,192,"2012"
"16553","520450 CALDAS NOVAS",0,5,15,1104,5,1129,"2012"
"16554","520455 CALDAZINHA",0,0,0,40,0,40,"2012"
"16555","520460 CAMPESTRE DE GOIAS",0,0,2,26,0,28,"2012"
"16556","520465 CAMPINACU",0,0,1,42,0,43,"2012"
"16557","520470 CAMPINORTE",0,2,6,151,0,159,"2012"
"16558","520480 CAMPO ALEGRE DE GOIAS",0,0,3,51,0,54,"2012"
"16559","520485 CAMPO LIMPO DE GOIAS",0,0,0,106,0,106,"2012"
"16560","520490 CAMPOS BELOS",2,3,6,314,1,326,"2012"
"16561","520495 CAMPOS VERDES",1,0,0,55,0,56,"2012"
"16562","520500 CARMO DO RIO VERDE",0,2,1,88,0,91,"2012"
"16563","520505 CASTELANDIA",0,0,1,38,0,39,"2012"
"16564","520510 CATALAO",2,7,17,1273,10,1309,"2012"
"16565","520520 CATURAI",0,0,3,50,0,53,"2012"
"16566","520530 CAVALCANTE",0,1,4,136,3,144,"2012"
"16567","520540 CERES",1,1,6,236,0,244,"2012"
"16568","520545 CEZARINA",0,1,2,127,0,130,"2012"
"16569","520547 CHAPADAO DO CEU",0,0,1,165,0,166,"2012"
"16570","520549 CIDADE OCIDENTAL",1,6,12,1007,4,1030,"2012"
"16571","520551 COCALZINHO DE GOIAS",0,2,2,190,9,203,"2012"
"16572","520552 COLINAS DO SUL",1,1,2,36,1,41,"2012"
"16573","520570 CORREGO DO OURO",0,0,0,23,1,24,"2012"
"16574","520580 CORUMBA DE GOIAS",0,0,2,97,3,102,"2012"
"16575","520590 CORUMBAIBA",0,0,3,106,0,109,"2012"
"16576","520620 CRISTALINA",1,0,18,706,8,733,"2012"
"16577","520630 CRISTIANOPOLIS",0,0,1,26,1,28,"2012"
"16578","520640 CRIXAS",1,1,5,217,0,224,"2012"
"16579","520650 CROMINIA",0,0,0,23,0,23,"2012"
"16580","520660 CUMARI",0,0,0,30,2,32,"2012"
"16581","520670 DAMIANOPOLIS",1,0,0,41,0,42,"2012"
"16582","520680 DAMOLANDIA",0,0,1,28,0,29,"2012"
"16583","520690 DAVINOPOLIS",0,0,0,17,0,17,"2012"
"16584","520710 DIORAMA",0,0,0,18,0,18,"2012"
"16585","520725 DOVERLANDIA",0,1,2,73,0,76,"2012"
"16586","520735 EDEALINA",0,1,0,50,0,51,"2012"
"16587","520740 EDEIA",0,0,3,145,0,148,"2012"
"16588","520750 ESTRELA DO NORTE",1,1,2,44,0,48,"2012"
"16589","520753 FAINA",0,0,1,43,2,46,"2012"
"16590","520760 FAZENDA NOVA",1,0,9,56,0,66,"2012"
"16591","520780 FIRMINOPOLIS",0,1,1,91,1,94,"2012"
"16592","520790 FLORES DE GOIAS",0,2,2,89,0,93,"2012"
"16593","520800 FORMOSA",4,4,11,1699,1,1719,"2012"
"16594","520810 FORMOSO",0,2,1,54,0,57,"2012"
"16595","520815 GAMELEIRA DE GOIAS",0,0,1,28,0,29,"2012"
"16596","520830 DIVINOPOLIS DE GOIAS",0,0,0,95,3,98,"2012"
"16597","520840 GOIANAPOLIS",0,0,1,157,2,160,"2012"
"16598","520850 GOIANDIRA",0,0,2,69,0,71,"2012"
"16599","520860 GOIANESIA",2,4,19,895,0,920,"2012"
"16600","520870 GOIANIA",65,86,338,20724,92,21305,"2012"
"16601","520880 GOIANIRA",2,1,18,563,3,587,"2012"
"16602","520890 GOIAS",0,3,11,258,1,273,"2012"
"16603","520910 GOIATUBA",0,0,13,430,0,443,"2012"
"16604","520915 GOUVELANDIA",1,0,0,54,0,55,"2012"
"16605","520920 GUAPO",0,0,2,184,2,188,"2012"
"16606","520929 GUARAITA",0,0,0,26,0,26,"2012"
"16607","520940 GUARANI DE GOIAS",0,0,0,31,1,32,"2012"
"16608","520945 GUARINOS",0,0,0,24,0,24,"2012"
"16609","520960 HEITORAI",0,0,1,32,0,33,"2012"
"16610","520970 HIDROLANDIA",1,2,3,225,2,233,"2012"
"16611","520980 HIDROLINA",0,0,0,35,0,35,"2012"
"16612","520990 IACIARA",2,1,7,182,0,192,"2012"
"16613","520993 INACIOLANDIA",0,1,0,83,0,84,"2012"
"16614","520995 INDIARA",1,0,5,193,0,199,"2012"
"16615","521000 INHUMAS",1,0,15,705,1,722,"2012"
"16616","521010 IPAMERI",1,1,3,266,0,271,"2012"
"16617","521015 IPIRANGA DE GOIAS",0,0,1,24,0,25,"2012"
"16618","521020 IPORA",1,2,11,379,1,394,"2012"
"16619","521030 ISRAELANDIA",0,0,0,26,0,26,"2012"
"16620","521040 ITABERAI",3,4,7,517,0,531,"2012"
"16621","521056 ITAGUARI",0,1,0,54,0,55,"2012"
"16622","521060 ITAGUARU",1,0,0,45,0,46,"2012"
"16623","521080 ITAJA",0,0,0,76,0,76,"2012"
"16624","521090 ITAPACI",0,1,7,260,0,268,"2012"
"16625","521100 ITAPIRAPUA",1,2,1,93,0,97,"2012"
"16626","521120 ITAPURANGA",2,1,3,293,1,300,"2012"
"16627","521130 ITARUMA",0,1,3,75,0,79,"2012"
"16628","521140 ITAUCU",0,0,2,65,1,68,"2012"
"16629","521150 ITUMBIARA",1,5,13,1316,0,1335,"2012"
"16630","521160 IVOLANDIA",0,0,2,24,0,26,"2012"
"16631","521170 JANDAIA",0,1,5,66,0,72,"2012"
"16632","521180 JARAGUA",1,3,14,584,5,607,"2012"
"16633","521190 JATAI",3,8,27,1277,0,1315,"2012"
"16634","521200 JAUPACI",0,0,1,41,0,42,"2012"
"16635","521205 JESUPOLIS",0,0,0,37,0,37,"2012"
"16636","521210 JOVIANIA",0,0,1,86,0,87,"2012"
"16637","521220 JUSSARA",0,4,9,257,3,273,"2012"
"16638","521225 LAGOA SANTA",0,0,0,21,0,21,"2012"
"16639","521230 LEOPOLDO DE BULHOES",0,1,2,91,1,95,"2012"
"16640","521250 LUZIANIA",4,8,56,2881,15,2964,"2012"
"16641","521260 MAIRIPOTABA",0,0,0,21,1,22,"2012"
"16642","521270 MAMBAI",0,0,3,105,3,111,"2012"
"16643","521280 MARA ROSA",1,0,3,126,0,130,"2012"
"16644","521290 MARZAGAO",0,0,0,34,0,34,"2012"
"16645","521295 MATRINCHA",0,0,0,51,0,51,"2012"
"16646","521300 MAURILANDIA",1,0,5,207,1,214,"2012"
"16647","521305 MIMOSO DE GOIAS",0,0,0,14,1,15,"2012"
"16648","521308 MINACU",0,2,2,442,1,447,"2012"
"16649","521310 MINEIROS",3,6,5,972,0,986,"2012"
"16650","521340 MOIPORA",0,0,1,12,0,13,"2012"
"16651","521350 MONTE ALEGRE DE GOIAS",1,0,1,103,1,106,"2012"
"16652","521370 MONTES CLAROS DE GOIAS",0,0,3,92,0,95,"2012"
"16653","521375 MONTIVIDIU",0,5,5,163,0,173,"2012"
"16654","521377 MONTIVIDIU DO NORTE",0,0,0,29,2,31,"2012"
"16655","521380 MORRINHOS",7,1,6,560,0,574,"2012"
"16656","521385 MORRO AGUDO DE GOIAS",0,0,0,36,0,36,"2012"
"16657","521390 MOSSAMEDES",0,0,0,44,0,44,"2012"
"16658","521400 MOZARLANDIA",1,1,7,205,0,214,"2012"
"16659","521405 MUNDO NOVO",0,0,1,69,1,71,"2012"
"16660","521410 MUTUNOPOLIS",0,0,2,48,0,50,"2012"
"16661","521440 NAZARIO",0,0,1,95,0,96,"2012"
"16662","521450 NEROPOLIS",2,3,10,384,1,400,"2012"
"16663","521460 NIQUELANDIA",5,7,18,499,5,534,"2012"
"16664","521470 NOVA AMERICA",0,0,1,24,0,25,"2012"
"16665","521480 NOVA AURORA",0,0,0,20,0,20,"2012"
"16666","521483 NOVA CRIXAS",0,2,1,162,0,165,"2012"
"16667","521486 NOVA GLORIA",0,0,1,86,0,87,"2012"
"16668","521487 NOVA IGUACU DE GOIAS",0,0,3,26,0,29,"2012"
"16669","521490 NOVA ROMA",1,0,1,29,0,31,"2012"
"16670","521500 NOVA VENEZA",0,0,3,81,0,84,"2012"
"16671","521520 NOVO BRASIL",0,0,5,30,1,36,"2012"
"16672","521523 NOVO GAMA",3,10,23,1645,13,1694,"2012"
"16673","521525 NOVO PLANALTO",0,0,1,46,0,47,"2012"
"16674","521530 ORIZONA",3,0,0,162,0,165,"2012"
"16675","521540 OURO VERDE DE GOIAS",0,1,1,42,0,44,"2012"
"16676","521550 OUVIDOR",0,0,1,47,0,48,"2012"
"16677","521560 PADRE BERNARDO",3,2,8,303,71,387,"2012"
"16678","521565 PALESTINA DE GOIAS",0,0,4,29,1,34,"2012"
"16679","521570 PALMEIRAS DE GOIAS",0,1,4,269,0,274,"2012"
"16680","521580 PALMELO",0,0,0,21,0,21,"2012"
"16681","521590 PALMINOPOLIS",0,0,0,19,0,19,"2012"
"16682","521600 PANAMA",0,0,0,22,0,22,"2012"
"16683","521630 PARANAIGUARA",1,0,3,132,0,136,"2012"
"16684","521640 PARAUNA",2,1,1,142,0,146,"2012"
"16685","521645 PEROLANDIA",1,0,0,46,0,47,"2012"
"16686","521680 PETROLINA DE GOIAS",0,1,3,92,0,96,"2012"
"16687","521690 PILAR DE GOIAS",1,0,0,26,0,27,"2012"
"16688","521710 PIRACANJUBA",2,0,7,207,1,217,"2012"
"16689","521720 PIRANHAS",0,0,0,111,0,111,"2012"
"16690","521730 PIRENOPOLIS",1,2,3,288,0,294,"2012"
"16691","521740 PIRES DO RIO",2,1,6,355,4,368,"2012"
"16692","521760 PLANALTINA",4,12,35,1498,1,1550,"2012"
"16693","521770 PONTALINA",0,2,1,184,1,188,"2012"
"16694","521800 PORANGATU",0,3,21,587,2,613,"2012"
"16695","521805 PORTEIRAO",0,0,0,30,0,30,"2012"
"16696","521810 PORTELANDIA",0,0,0,51,0,51,"2012"
"16697","521830 POSSE",2,1,16,504,0,523,"2012"
"16698","521839 PROFESSOR JAMIL",0,0,0,29,1,30,"2012"
"16699","521850 QUIRINOPOLIS",2,5,4,662,1,674,"2012"
"16700","521860 RIALMA",2,0,3,127,0,132,"2012"
"16701","521870 RIANAPOLIS",0,0,2,55,0,57,"2012"
"16702","521878 RIO QUENTE",0,0,1,45,1,47,"2012"
"16703","521880 RIO VERDE",3,13,38,3038,1,3093,"2012"
"16704","521890 RUBIATABA",0,0,12,246,0,258,"2012"
"16705","521900 SANCLERLANDIA",0,0,0,68,0,68,"2012"
"16706","521910 SANTA BARBARA DE GOIAS",0,0,2,81,0,83,"2012"
"16707","521920 SANTA CRUZ DE GOIAS",0,0,1,26,0,27,"2012"
"16708","521925 SANTA FE DE GOIAS",0,1,1,74,1,77,"2012"
"16709","521930 SANTA HELENA DE GOIAS",1,0,12,476,0,489,"2012"
"16710","521935 SANTA ISABEL",0,0,1,35,0,36,"2012"
"16711","521940 SANTA RITA DO ARAGUAIA",0,1,0,83,1,85,"2012"
"16712","521945 SANTA RITA DO NOVO DESTINO",0,0,0,24,0,24,"2012"
"16713","521950 SANTA ROSA DE GOIAS",0,0,2,28,0,30,"2012"
"16714","521960 SANTA TEREZA DE GOIAS",0,0,1,42,1,44,"2012"
"16715","521970 SANTA TEREZINHA DE GOIAS",0,1,3,138,1,143,"2012"
"16716","521971 SANTO ANTONIO DA BARRA",0,1,1,48,0,50,"2012"
"16717","521973 SANTO ANTONIO DE GOIAS",0,0,1,93,0,94,"2012"
"16718","521975 SANTO ANTONIO DO DESCOBERTO",2,8,12,1001,10,1033,"2012"
"16719","521980 SAO DOMINGOS",0,0,4,104,2,110,"2012"
"16720","521990 SAO FRANCISCO DE GOIAS",1,1,1,55,1,59,"2012"
"16721","522000 SAO JOAO D'ALIANCA",0,1,0,125,3,129,"2012"
"16722","522005 SAO JOAO DA PARAUNA",1,1,0,13,0,15,"2012"
"16723","522010 SAO LUIS DE MONTES BELOS",1,0,6,355,2,364,"2012"
"16724","522015 SAO LUIZ DO NORTE",0,0,0,73,0,73,"2012"
"16725","522020 SAO MIGUEL DO ARAGUAIA",0,2,3,310,3,318,"2012"
"16726","522026 SAO MIGUEL DO PASSA QUATRO",1,0,1,46,0,48,"2012"
"16727","522028 SAO PATRICIO",0,0,0,15,0,15,"2012"
"16728","522040 SAO SIMAO",0,0,3,260,2,265,"2012"
"16729","522045 SENADOR CANEDO",4,5,28,1792,8,1837,"2012"
"16730","522050 SERRANOPOLIS",0,0,2,72,0,74,"2012"
"16731","522060 SILVANIA",1,2,0,255,0,258,"2012"
"16732","522068 SIMOLANDIA",0,0,2,82,0,84,"2012"
"16733","522070 SITIO D'ABADIA",0,0,0,27,0,27,"2012"
"16734","522100 TAQUARAL DE GOIAS",1,0,0,52,0,53,"2012"
"16735","522108 TERESINA DE GOIAS",0,0,0,42,1,43,"2012"
"16736","522119 TEREZOPOLIS DE GOIAS",0,1,1,100,0,102,"2012"
"16737","522130 TRES RANCHOS",0,0,0,33,0,33,"2012"
"16738","522140 TRINDADE",2,6,15,1672,11,1706,"2012"
"16739","522145 TROMBAS",0,2,4,40,0,46,"2012"
"16740","522150 TURVANIA",0,0,1,44,0,45,"2012"
"16741","522155 TURVELANDIA",1,0,1,63,0,65,"2012"
"16742","522157 UIRAPURU",0,0,0,20,0,20,"2012"
"16743","522160 URUACU",4,5,37,528,0,574,"2012"
"16744","522170 URUANA",0,0,0,158,0,158,"2012"
"16745","522180 URUTAI",0,0,0,25,0,25,"2012"
"16746","522185 VALPARAISO DE GOIAS",5,6,48,2540,20,2619,"2012"
"16747","522190 VARJAO",0,0,1,34,0,35,"2012"
"16748","522200 VIANOPOLIS",1,0,1,172,0,174,"2012"
"16749","522205 VICENTINOPOLIS",0,1,1,103,0,105,"2012"
"16750","522220 VILA BOA",0,1,0,69,1,71,"2012"
"16751","522230 VILA PROPICIO",0,0,2,59,0,61,"2012"
"16752","530010 BRASILIA",126,114,648,42212,397,43497,"2012"
"16753","TOTAL",8312,12288,47529,2751923,83975,2904027,"2013"
"16754","MUNICIPIO IGNORADO - RO",0,0,1,15,0,16,"2013"
"16755","110001 ALTA FLORESTA D'OESTE",0,3,2,373,4,382,"2013"
"16756","110002 ARIQUEMES",1,4,11,1630,8,1654,"2013"
"16757","110003 CABIXI",1,0,1,68,4,74,"2013"
"16758","110004 CACOAL",3,1,24,1153,4,1185,"2013"
"16759","110005 CEREJEIRAS",0,0,4,250,17,271,"2013"
"16760","110006 COLORADO DO OESTE",1,0,0,221,34,256,"2013"
"16761","110007 CORUMBIARA",0,2,0,104,10,116,"2013"
"16762","110008 COSTA MARQUES",0,2,10,221,1,234,"2013"
"16763","110009 ESPIGAO D'OESTE",1,2,13,445,2,463,"2013"
"16764","110010 GUAJARA-MIRIM",4,1,8,861,5,879,"2013"
"16765","110011 JARU",2,4,14,894,0,914,"2013"
"16766","110012 JI-PARANA",3,4,29,1932,3,1971,"2013"
"16767","110013 MACHADINHO D'OESTE",1,4,13,491,5,514,"2013"
"16768","110014 NOVA BRASILANDIA D'OESTE",0,3,8,267,0,278,"2013"
"16769","110015 OURO PRETO DO OESTE",1,5,7,626,0,639,"2013"
"16770","110018 PIMENTA BUENO",1,0,9,569,2,581,"2013"
"16771","110020 PORTO VELHO",8,15,94,8698,112,8927,"2013"
"16772","110025 PRESIDENTE MEDICI",0,1,3,253,1,258,"2013"
"16773","110026 RIO CRESPO",0,0,0,38,0,38,"2013"
"16774","110028 ROLIM DE MOURA",3,1,8,867,0,879,"2013"
"16775","110029 SANTA LUZIA D'OESTE",0,0,2,96,0,98,"2013"
"16776","110030 VILHENA",1,0,3,1098,286,1388,"2013"
"16777","110032 SAO MIGUEL DO GUAPORE",0,0,4,350,1,355,"2013"
"16778","110033 NOVA MAMORE",0,3,9,402,2,416,"2013"
"16779","110034 ALVORADA D'OESTE",0,1,0,215,4,220,"2013"
"16780","110037 ALTO ALEGRE DOS PARECIS",0,0,1,162,0,163,"2013"
"16781","110040 ALTO PARAISO",0,1,0,210,0,211,"2013"
"16782","110045 BURITIS",1,1,2,593,1,598,"2013"
"16783","110050 NOVO HORIZONTE DO OESTE",0,0,0,122,0,122,"2013"
"16784","110060 CACAULANDIA",0,1,0,62,0,63,"2013"
"16785","110070 CAMPO NOVO DE RONDONIA",1,0,0,181,1,183,"2013"
"16786","110080 CANDEIAS DO JAMARI",0,1,5,390,9,405,"2013"
"16787","110090 CASTANHEIRAS",2,0,0,34,0,36,"2013"
"16788","110092 CHUPINGUAIA",0,0,1,122,35,158,"2013"
"16789","110094 CUJUBIM",0,0,3,199,1,203,"2013"
"16790","110100 GOVERNADOR JORGE TEIXEIRA",1,0,3,109,3,116,"2013"
"16791","110110 ITAPUA DO OESTE",0,1,1,114,7,123,"2013"
"16792","110120 MINISTRO ANDREAZZA",0,1,1,101,1,104,"2013"
"16793","110130 MIRANTE DA SERRA",0,0,3,119,0,122,"2013"
"16794","110140 MONTE NEGRO",0,0,3,219,1,223,"2013"
"16795","110143 NOVA UNIAO",0,0,1,81,0,82,"2013"
"16796","110145 PARECIS",0,1,1,53,0,55,"2013"
"16797","110146 PIMENTEIRAS DO OESTE",0,0,1,33,8,42,"2013"
"16798","110147 PRIMAVERA DE RONDONIA",0,0,0,39,0,39,"2013"
"16799","110148 SAO FELIPE D'OESTE",0,0,1,60,0,61,"2013"
"16800","110149 SAO FRANCISCO DO GUAPORE",0,1,9,251,5,266,"2013"
"16801","110150 SERINGUEIRAS",0,0,2,182,0,184,"2013"
"16802","110155 TEIXEIROPOLIS",0,0,0,80,0,80,"2013"
"16803","110160 THEOBROMA",0,0,0,106,0,106,"2013"
"16804","110170 URUPA",0,1,2,147,0,150,"2013"
"16805","110175 VALE DO ANARI",0,2,3,84,0,89,"2013"
"16806","110180 VALE DO PARAISO",0,0,2,105,0,107,"2013"
"16807","120001 ACRELANDIA",0,2,3,226,27,258,"2013"
"16808","120005 ASSIS BRASIL",0,0,1,175,37,213,"2013"
"16809","120010 BRASILEIA",3,7,7,488,25,530,"2013"
"16810","120013 BUJARI",0,0,2,176,24,202,"2013"
"16811","120017 CAPIXABA",0,0,0,172,21,193,"2013"
"16812","120020 CRUZEIRO DO SUL",3,12,18,1665,85,1783,"2013"
"16813","120025 EPITACIOLANDIA",0,1,2,265,7,275,"2013"
"16814","120030 FEIJO",0,1,5,655,130,791,"2013"
"16815","120032 JORDAO",0,0,6,81,184,271,"2013"
"16816","120033 MANCIO LIMA",0,0,10,362,27,399,"2013"
"16817","120034 MANOEL URBANO",2,0,6,216,5,229,"2013"
"16818","120035 MARECHAL THAUMATURGO",1,0,12,304,168,485,"2013"
"16819","120038 PLACIDO DE CASTRO",0,2,4,281,47,334,"2013"
"16820","120039 PORTO WALTER",1,1,5,224,56,287,"2013"
"16821","120040 RIO BRANCO",4,10,69,6357,676,7116,"2013"
"16822","120042 RODRIGUES ALVES",0,0,6,317,40,363,"2013"
"16823","120043 SANTA ROSA DO PURUS",1,0,0,83,139,223,"2013"
"16824","120045 SENADOR GUIOMARD",0,1,1,385,38,425,"2013"
"16825","120050 SENA MADUREIRA",2,2,5,834,61,904,"2013"
"16826","120060 TARAUACA",1,7,19,989,122,1138,"2013"
"16827","120070 XAPURI",0,1,7,273,13,294,"2013"
"16828","120080 PORTO ACRE",0,0,4,318,40,362,"2013"
"16829","MUNICIPIO IGNORADO - AM",0,0,0,18,0,18,"2013"
"16830","130002 ALVARAES",2,2,1,337,4,346,"2013"
"16831","130006 AMATURA",0,1,2,178,80,261,"2013"
"16832","130008 ANAMA",0,0,1,178,22,201,"2013"
"16833","130010 ANORI",0,1,0,68,216,285,"2013"
"16834","130014 APUI",3,2,11,205,2,223,"2013"
"16835","130020 ATALAIA DO NORTE",0,0,2,221,131,354,"2013"
"16836","130030 AUTAZES",6,5,9,730,127,877,"2013"
"16837","130040 BARCELOS",4,0,2,328,146,480,"2013"
"16838","130050 BARREIRINHA",2,4,7,604,152,769,"2013"
"16839","130060 BENJAMIN CONSTANT",2,4,10,1017,3,1036,"2013"
"16840","130063 BERURI",2,3,2,365,56,428,"2013"
"16841","130068 BOA VISTA DO RAMOS",0,0,4,317,0,321,"2013"
"16842","130070 BOCA DO ACRE",1,2,7,735,18,763,"2013"
"16843","130080 BORBA",2,2,11,598,92,705,"2013"
"16844","130083 CAAPIRANGA",1,1,5,155,41,203,"2013"
"16845","130090 CANUTAMA",0,1,1,193,1,196,"2013"
"16846","130100 CARAUARI",4,0,41,569,19,633,"2013"
"16847","130110 CAREIRO",0,2,4,394,42,442,"2013"
"16848","130115 CAREIRO DA VARZEA",0,0,2,135,31,168,"2013"
"16849","130120 COARI",6,3,14,1726,1,1750,"2013"
"16850","130130 CODAJAS",1,0,4,411,8,424,"2013"
"16851","130140 EIRUNEPE",2,4,13,716,117,852,"2013"
"16852","130150 ENVIRA",1,3,5,306,51,366,"2013"
"16853","130160 FONTE BOA",3,4,7,542,0,556,"2013"
"16854","130165 GUAJARA",0,4,7,297,21,329,"2013"
"16855","130170 HUMAITA",5,2,12,881,2,902,"2013"
"16856","130180 IPIXUNA",0,0,0,306,101,407,"2013"
"16857","130185 IRANDUBA",0,3,12,829,5,849,"2013"
"16858","130190 ITACOATIARA",5,2,20,1932,126,2085,"2013"
"16859","130195 ITAMARATI",1,1,2,171,85,260,"2013"
"16860","130200 ITAPIRANGA",1,0,2,179,2,184,"2013"
"16861","130210 JAPURA",0,1,4,125,0,130,"2013"
"16862","130220 JURUA",0,1,2,149,50,202,"2013"
"16863","130230 JUTAI",0,1,1,430,197,629,"2013"
"16864","130240 LABREA",2,5,13,701,7,728,"2013"
"16865","130250 MANACAPURU",9,4,35,1916,36,2000,"2013"
"16866","130255 MANAQUIRI",0,1,1,245,2,249,"2013"
"16867","130260 MANAUS",125,114,330,40692,379,41640,"2013"
"16868","130270 MANICORE",0,8,53,615,174,850,"2013"
"16869","130280 MARAA",0,0,1,327,10,338,"2013"
"16870","130290 MAUES",6,4,21,979,307,1317,"2013"
"16871","130300 NHAMUNDA",1,2,7,270,21,301,"2013"
"16872","130310 NOVA OLINDA DO NORTE",4,3,19,513,89,628,"2013"
"16873","130320 NOVO AIRAO",0,0,1,243,2,246,"2013"
"16874","130330 NOVO ARIPUANA",0,2,4,322,23,351,"2013"
"16875","130340 PARINTINS",6,7,27,1954,139,2133,"2013"
"16876","130350 PAUINI",0,0,0,364,3,367,"2013"
"16877","130353 PRESIDENTE FIGUEIREDO",0,3,8,566,3,580,"2013"
"16878","130356 RIO PRETO DA EVA",2,1,4,365,2,374,"2013"
"16879","130360 SANTA ISABEL DO RIO NEGRO",0,1,38,136,104,279,"2013"
"16880","130370 SANTO ANTONIO DO ICA",7,1,1,445,122,576,"2013"
"16881","130380 SAO GABRIEL DA CACHOEIRA",4,6,6,548,579,1143,"2013"
"16882","130390 SAO PAULO DE OLIVENCA",0,5,10,415,484,914,"2013"
"16883","130395 SAO SEBASTIAO DO UATUMA",0,3,3,154,0,160,"2013"
"16884","130400 SILVES",2,2,2,194,8,208,"2013"
"16885","130406 TABATINGA",1,2,10,1146,460,1619,"2013"
"16886","130410 TAPAUA",8,1,3,398,11,421,"2013"
"16887","130420 TEFE",8,2,17,1623,82,1732,"2013"
"16888","130423 TONANTINS",2,0,2,289,29,322,"2013"
"16889","130426 UARINI",0,5,24,187,88,304,"2013"
"16890","130430 URUCARA",5,2,14,269,12,302,"2013"
"16891","130440 URUCURITUBA",1,0,1,266,57,325,"2013"
"16892","MUNICIPIO IGNORADO - RR",0,0,0,4,4,8,"2013"
"16893","140002 AMAJARI",5,0,1,148,153,307,"2013"
"16894","140005 ALTO ALEGRE",11,1,2,228,359,601,"2013"
"16895","140010 BOA VISTA",69,13,34,6228,6,6350,"2013"
"16896","140015 BONFIM",7,1,3,290,26,327,"2013"
"16897","140017 CANTA",21,1,1,302,10,335,"2013"
"16898","140020 CARACARAI",2,2,3,345,72,424,"2013"
"16899","140023 CAROEBE",1,3,3,138,6,151,"2013"
"16900","140028 IRACEMA",2,0,0,113,32,147,"2013"
"16901","140030 MUCAJAI",6,1,3,316,25,351,"2013"
"16902","140040 NORMANDIA",9,0,0,284,88,381,"2013"
"16903","140045 PACARAIMA",6,2,2,290,51,351,"2013"
"16904","140047 RORAINOPOLIS",3,2,4,408,5,422,"2013"
"16905","140050 SAO JOAO DA BALIZA",1,1,1,115,2,120,"2013"
"16906","140060 SAO LUIZ",1,1,0,74,4,80,"2013"
"16907","140070 UIRAMUTA",10,0,1,289,159,459,"2013"
"16908","MUNICIPIO IGNORADO - PA",0,0,1,7,0,8,"2013"
"16909","150010 ABAETETUBA",5,15,52,2443,23,2538,"2013"
"16910","150013 ABEL FIGUEIREDO",0,1,6,122,0,129,"2013"
"16911","150020 ACARA",6,7,9,989,28,1039,"2013"
"16912","150030 AFUA",3,8,10,758,9,788,"2013"
"16913","150034 AGUA AZUL DO NORTE",0,0,2,187,1,190,"2013"
"16914","150040 ALENQUER",5,3,6,1084,28,1126,"2013"
"16915","150050 ALMEIRIM",3,5,18,703,25,754,"2013"
"16916","150060 ALTAMIRA",16,16,58,2407,32,2529,"2013"
"16917","150070 ANAJAS",2,7,45,589,93,736,"2013"
"16918","150080 ANANINDEUA",20,24,70,7891,30,8035,"2013"
"16919","150085 ANAPU",3,1,4,518,5,531,"2013"
"16920","150090 AUGUSTO CORREA",3,1,23,883,140,1050,"2013"
"16921","150095 AURORA DO PARA",1,3,15,397,2,418,"2013"
"16922","150100 AVEIRO",1,2,5,173,34,215,"2013"
"16923","150110 BAGRE",2,3,19,150,286,460,"2013"
"16924","150120 BAIAO",0,4,11,473,44,532,"2013"
"16925","150125 BANNACH",0,0,2,41,0,43,"2013"
"16926","150130 BARCARENA",3,6,29,1948,12,1998,"2013"
"16927","150140 BELEM",54,69,190,21492,79,21884,"2013"
"16928","150145 BELTERRA",1,2,26,240,0,269,"2013"
"16929","150150 BENEVIDES",3,3,57,947,0,1010,"2013"
"16930","150157 BOM JESUS DO TOCANTINS",1,2,1,225,1,230,"2013"
"16931","150160 BONITO",1,2,1,189,2,195,"2013"
"16932","150170 BRAGANCA",6,11,27,2059,88,2191,"2013"
"16933","150172 BRASIL NOVO",1,0,13,255,0,269,"2013"
"16934","150175 BREJO GRANDE DO ARAGUAIA",0,0,1,93,1,95,"2013"
"16935","150178 BREU BRANCO",0,4,16,612,154,786,"2013"
"16936","150180 BREVES",10,24,216,2402,8,2660,"2013"
"16937","150190 BUJARU",1,2,12,440,43,498,"2013"
"16938","150195 CACHOEIRA DO PIRIA",0,1,11,262,49,323,"2013"
"16939","150200 CACHOEIRA DO ARARI",2,1,4,260,1,268,"2013"
"16940","150210 CAMETA",10,11,63,2227,158,2469,"2013"
"16941","150215 CANAA DOS CARAJAS",2,8,28,916,0,954,"2013"
"16942","150220 CAPANEMA",5,4,24,1140,16,1189,"2013"
"16943","150230 CAPITAO POCO",6,4,7,818,4,839,"2013"
"16944","150240 CASTANHAL",6,12,16,3123,4,3161,"2013"
"16945","150250 CHAVES",1,0,10,259,11,281,"2013"
"16946","150260 COLARES",0,0,0,120,35,155,"2013"
"16947","150270 CONCEICAO DO ARAGUAIA",2,2,6,733,2,745,"2013"
"16948","150275 CONCORDIA DO PARA",0,9,19,527,4,559,"2013"
"16949","150276 CUMARU DO NORTE",1,0,2,126,0,129,"2013"
"16950","150277 CURIONOPOLIS",0,4,14,397,0,415,"2013"
"16951","150280 CURRALINHO",2,4,16,420,179,621,"2013"
"16952","150285 CURUA",1,0,0,116,103,220,"2013"
"16953","150290 CURUCA",1,1,4,455,11,472,"2013"
"16954","150293 DOM ELISEU",2,5,23,648,0,678,"2013"
"16955","150295 ELDORADO DOS CARAJAS",1,1,16,486,2,506,"2013"
"16956","150300 FARO",0,4,3,125,6,138,"2013"
"16957","150304 FLORESTA DO ARAGUAIA",0,1,1,274,1,277,"2013"
"16958","150307 GARRAFAO DO NORTE",3,0,1,459,42,505,"2013"
"16959","150309 GOIANESIA DO PARA",2,3,25,620,12,662,"2013"
"16960","150310 GURUPA",1,4,12,487,122,626,"2013"
"16961","150320 IGARAPE-ACU",1,5,10,597,8,621,"2013"
"16962","150330 IGARAPE-MIRI",3,8,30,1046,68,1155,"2013"
"16963","150340 INHANGAPI",0,1,2,179,1,183,"2013"
"16964","150345 IPIXUNA DO PARA",2,4,37,509,38,590,"2013"
"16965","150350 IRITUIA",1,4,6,417,36,464,"2013"
"16966","150360 ITAITUBA",4,13,57,1538,3,1615,"2013"
"16967","150370 ITUPIRANGA",1,3,7,841,32,884,"2013"
"16968","150375 JACAREACANGA",0,2,3,280,200,485,"2013"
"16969","150380 JACUNDA",4,4,7,853,5,873,"2013"
"16970","150390 JURUTI",1,21,58,881,55,1016,"2013"
"16971","150400 LIMOEIRO DO AJURU",0,5,18,455,5,483,"2013"
"16972","150405 MAE DO RIO",3,5,9,599,1,617,"2013"
"16973","150410 MAGALHAES BARATA",0,0,0,97,7,104,"2013"
"16974","150420 MARABA",23,17,64,4797,64,4965,"2013"
"16975","150430 MARACANA",2,2,4,396,37,441,"2013"
"16976","150440 MARAPANIM",0,1,6,299,17,323,"2013"
"16977","150442 MARITUBA",3,3,15,1752,4,1777,"2013"
"16978","150445 MEDICILANDIA",0,3,12,462,0,477,"2013"
"16979","150450 MELGACO",3,2,22,295,151,473,"2013"
"16980","150460 MOCAJUBA",1,1,5,505,6,518,"2013"
"16981","150470 MOJU",5,9,32,1119,26,1191,"2013"
"16982","150475 MOJUI DOS CAMPOS",0,0,0,0,1,1,"2013"
"16983","150480 MONTE ALEGRE",3,11,91,965,2,1072,"2013"
"16984","150490 MUANA",4,5,14,539,2,564,"2013"
"16985","150495 NOVA ESPERANCA DO PIRIA",2,0,4,348,23,377,"2013"
"16986","150497 NOVA IPIXUNA",0,0,3,203,4,210,"2013"
"16987","150500 NOVA TIMBOTEUA",0,0,2,117,5,124,"2013"
"16988","150503 NOVO PROGRESSO",0,2,7,501,0,510,"2013"
"16989","150506 NOVO REPARTIMENTO",16,0,1,1177,15,1209,"2013"
"16990","150510 OBIDOS",2,5,14,845,125,991,"2013"
"16991","150520 OEIRAS DO PARA",4,9,15,674,49,751,"2013"
"16992","150530 ORIXIMINA",7,16,34,1209,70,1336,"2013"
"16993","150540 OUREM",1,3,1,269,14,288,"2013"
"16994","150543 OURILANDIA DO NORTE",2,1,5,653,2,663,"2013"
"16995","150548 PACAJA",1,4,8,636,6,655,"2013"
"16996","150549 PALESTINA DO PARA",1,1,2,114,4,122,"2013"
"16997","150550 PARAGOMINAS",8,3,17,1967,8,2003,"2013"
"16998","150553 PARAUAPEBAS",12,19,106,5009,11,5157,"2013"
"16999","150555 PAU D'ARCO",0,0,2,128,0,130,"2013"
"17000","150560 PEIXE-BOI",1,0,1,95,0,97,"2013"
"17001","150563 PICARRA",0,2,3,134,3,142,"2013"
"17002","150565 PLACAS",0,2,7,220,0,229,"2013"
"17003","150570 PONTA DE PEDRAS",0,1,5,323,1,330,"2013"
"17004","150580 PORTEL",1,7,12,1071,188,1279,"2013"
"17005","150590 PORTO DE MOZ",0,4,14,690,24,732,"2013"
"17006","150600 PRAINHA",1,2,22,544,109,678,"2013"
"17007","150610 PRIMAVERA",0,0,2,124,36,162,"2013"
"17008","150611 QUATIPURU",1,0,0,174,5,180,"2013"
"17009","150613 REDENCAO",4,6,19,1610,2,1641,"2013"
"17010","150616 RIO MARIA",2,2,3,267,2,276,"2013"
"17011","150618 RONDON DO PARA",3,2,22,658,1,686,"2013"
"17012","150619 RUROPOLIS",1,2,13,313,1,330,"2013"
"17013","150620 SALINOPOLIS",0,0,2,680,2,684,"2013"
"17014","150630 SALVATERRA",6,6,5,335,0,352,"2013"
"17015","150635 SANTA BARBARA DO PARA",1,0,7,312,4,324,"2013"
"17016","150640 SANTA CRUZ DO ARARI",1,1,2,81,16,101,"2013"
"17017","150650 SANTA IZABEL DO PARA",6,11,16,965,2,1000,"2013"
"17018","150655 SANTA LUZIA DO PARA",2,1,8,320,10,341,"2013"
"17019","150658 SANTA MARIA DAS BARREIRAS",0,1,3,163,1,168,"2013"
"17020","150660 SANTA MARIA DO PARA",1,0,5,378,1,385,"2013"
"17021","150670 SANTANA DO ARAGUAIA",3,2,12,517,2,536,"2013"
"17022","150680 SANTAREM",13,40,204,5604,473,6334,"2013"
"17023","150690 SANTAREM NOVO",0,0,1,87,2,90,"2013"
"17024","150700 SANTO ANTONIO DO TAUA",0,0,7,479,4,490,"2013"
"17025","150710 SAO CAETANO DE ODIVELAS",2,4,4,205,8,223,"2013"
"17026","150715 SAO DOMINGOS DO ARAGUAIA",2,3,2,356,5,368,"2013"
"17027","150720 SAO DOMINGOS DO CAPIM",2,5,8,591,17,623,"2013"
"17028","150730 SAO FELIX DO XINGU",1,1,7,870,12,891,"2013"
"17029","150740 SAO FRANCISCO DO PARA",0,3,1,226,1,231,"2013"
"17030","150745 SAO GERALDO DO ARAGUAIA",1,0,8,474,9,492,"2013"
"17031","150746 SAO JOAO DA PONTA",0,0,0,69,3,72,"2013"
"17032","150747 SAO JOAO DE PIRABAS",2,2,5,351,5,365,"2013"
"17033","150750 SAO JOAO DO ARAGUAIA",0,0,4,167,0,171,"2013"
"17034","150760 SAO MIGUEL DO GUAMA",3,4,19,919,11,956,"2013"
"17035","150770 SAO SEBASTIAO DA BOA VISTA",0,8,33,455,3,499,"2013"
"17036","150775 SAPUCAIA",0,0,0,93,1,94,"2013"
"17037","150780 SENADOR JOSE PORFIRIO",1,2,1,279,7,290,"2013"
"17038","150790 SOURE",2,0,3,388,0,393,"2013"
"17039","150795 TAILANDIA",5,7,27,1457,23,1519,"2013"
"17040","150796 TERRA ALTA",1,0,2,176,1,180,"2013"
"17041","150797 TERRA SANTA",1,5,16,265,2,289,"2013"
"17042","150800 TOME-ACU",3,10,37,1404,5,1459,"2013"
"17043","150803 TRACUATEUA",0,7,10,546,15,578,"2013"
"17044","150805 TRAIRAO",3,2,7,199,1,212,"2013"
"17045","150808 TUCUMA",2,6,7,671,3,689,"2013"
"17046","150810 TUCURUI",6,10,25,1543,625,2209,"2013"
"17047","150812 ULIANOPOLIS",1,3,16,449,5,474,"2013"
"17048","150815 URUARA",4,5,19,756,7,791,"2013"
"17049","150820 VIGIA",2,1,13,779,3,798,"2013"
"17050","150830 VISEU",1,8,11,858,340,1218,"2013"
"17051","150835 VITORIA DO XINGU",0,0,1,197,0,198,"2013"
"17052","150840 XINGUARA",2,2,8,737,2,751,"2013"
"17053","MUNICIPIO IGNORADO - AP",0,0,0,0,1,1,"2013"
"17054","160005 SERRA DO NAVIO",0,0,1,85,3,89,"2013"
"17055","160010 AMAPA",1,1,6,137,9,154,"2013"
"17056","160015 PEDRA BRANCA DO AMAPARI",0,0,3,249,31,283,"2013"
"17057","160020 CALCOENE",1,2,4,158,30,195,"2013"
"17058","160021 CUTIAS",0,0,1,78,4,83,"2013"
"17059","160023 FERREIRA GOMES",1,0,1,179,12,193,"2013"
"17060","160025 ITAUBAL",1,2,2,95,15,115,"2013"
"17061","160027 LARANJAL DO JARI",4,5,17,861,0,887,"2013"
"17062","160030 MACAPA",44,32,95,9222,147,9540,"2013"
"17063","160040 MAZAGAO",1,3,7,373,65,449,"2013"
"17064","160050 OIAPOQUE",0,1,14,452,33,500,"2013"
"17065","160053 PORTO GRANDE",2,2,3,330,3,340,"2013"
"17066","160055 PRACUUBA",1,0,0,40,38,79,"2013"
"17067","160060 SANTANA",9,4,49,2195,3,2260,"2013"
"17068","160070 TARTARUGALZINHO",0,0,4,168,99,271,"2013"
"17069","160080 VITORIA DO JARI",1,2,4,263,1,271,"2013"
"17070","MUNICIPIO IGNORADO - TO",0,0,0,5,0,5,"2013"
"17071","170025 ABREULANDIA",1,0,0,36,0,37,"2013"
"17072","170030 AGUIARNOPOLIS",0,1,1,81,1,84,"2013"
"17073","170035 ALIANCA DO TOCANTINS",1,0,0,80,0,81,"2013"
"17074","170040 ALMAS",0,0,2,125,2,129,"2013"
"17075","170070 ALVORADA",0,1,0,99,1,101,"2013"
"17076","170100 ANANAS",0,2,2,152,10,166,"2013"
"17077","170105 ANGICO",0,0,0,38,7,45,"2013"
"17078","170110 APARECIDA DO RIO NEGRO",0,0,0,65,1,66,"2013"
"17079","170130 ARAGOMINAS",0,0,1,62,6,69,"2013"
"17080","170190 ARAGUACEMA",0,0,1,100,0,101,"2013"
"17081","170200 ARAGUACU",1,2,14,87,0,104,"2013"
"17082","170210 ARAGUAINA",8,9,35,2889,124,3065,"2013"
"17083","170215 ARAGUANA",0,1,3,98,4,106,"2013"
"17084","170220 ARAGUATINS",0,1,9,405,96,511,"2013"
"17085","170230 ARAPOEMA",1,0,0,99,5,105,"2013"
"17086","170240 ARRAIAS",0,1,1,184,1,187,"2013"
"17087","170255 AUGUSTINOPOLIS",0,0,7,257,79,343,"2013"
"17088","170270 AURORA DO TOCANTINS",0,0,0,34,0,34,"2013"
"17089","170290 AXIXA DO TOCANTINS",1,1,5,153,42,202,"2013"
"17090","170300 BABACULANDIA",0,0,3,104,3,110,"2013"
"17091","170305 BANDEIRANTES DO TOCANTINS",0,0,0,60,1,61,"2013"
"17092","170307 BARRA DO OURO",0,0,0,75,1,76,"2013"
"17093","170310 BARROLANDIA",0,0,1,69,4,74,"2013"
"17094","170320 BERNARDO SAYAO",0,0,1,59,1,61,"2013"
"17095","170330 BOM JESUS DO TOCANTINS",0,0,4,74,0,78,"2013"
"17096","170360 BRASILANDIA DO TOCANTINS",0,1,0,19,1,21,"2013"
"17097","170370 BREJINHO DE NAZARE",1,0,1,92,0,94,"2013"
"17098","170380 BURITI DO TOCANTINS",2,0,1,114,30,147,"2013"
"17099","170382 CACHOEIRINHA",0,0,1,21,7,29,"2013"
"17100","170384 CAMPOS LINDOS",0,2,4,115,28,149,"2013"
"17101","170386 CARIRI DO TOCANTINS",0,0,1,49,0,50,"2013"
"17102","170388 CARMOLANDIA",0,0,1,42,4,47,"2013"
"17103","170389 CARRASCO BONITO",0,0,1,55,18,74,"2013"
"17104","170390 CASEARA",1,0,0,69,3,73,"2013"
"17105","170410 CENTENARIO",0,0,1,19,0,20,"2013"
"17106","170460 CHAPADA DE AREIA",0,0,0,17,0,17,"2013"
"17107","170510 CHAPADA DA NATIVIDADE",0,0,2,47,1,50,"2013"
"17108","170550 COLINAS DO TOCANTINS",0,4,7,517,12,540,"2013"
"17109","170555 COMBINADO",1,0,0,72,0,73,"2013"
"17110","170560 CONCEICAO DO TOCANTINS",0,0,2,68,3,73,"2013"
"17111","170600 COUTO MAGALHAES",0,0,0,81,1,82,"2013"
"17112","170610 CRISTALANDIA",0,0,1,87,0,88,"2013"
"17113","170625 CRIXAS DO TOCANTINS",0,0,0,26,0,26,"2013"
"17114","170650 DARCINOPOLIS",1,0,2,86,8,97,"2013"
"17115","170700 DIANOPOLIS",2,2,5,332,1,342,"2013"
"17116","170710 DIVINOPOLIS DO TOCANTINS",1,0,0,97,1,99,"2013"
"17117","170720 DOIS IRMAOS DO TOCANTINS",1,0,0,54,0,55,"2013"
"17118","170730 DUERE",0,0,1,57,0,58,"2013"
"17119","170740 ESPERANTINA",0,2,3,111,31,147,"2013"
"17120","170755 FATIMA",0,0,0,46,1,47,"2013"
"17121","170765 FIGUEIROPOLIS",0,2,1,68,0,71,"2013"
"17122","170770 FILADELFIA",0,1,3,110,7,121,"2013"
"17123","170820 FORMOSO DO ARAGUAIA",2,2,6,240,8,258,"2013"
"17124","170825 FORTALEZA DO TABOCAO",0,1,3,37,1,42,"2013"
"17125","170830 GOIANORTE",0,1,0,38,0,39,"2013"
"17126","170900 GOIATINS",0,0,6,242,12,260,"2013"
"17127","170930 GUARAI",0,2,8,371,3,384,"2013"
"17128","170950 GURUPI",5,6,19,1222,4,1256,"2013"
"17129","170980 IPUEIRAS",0,0,0,22,0,22,"2013"
"17130","171050 ITACAJA",1,0,4,134,2,141,"2013"
"17131","171070 ITAGUATINS",0,1,2,85,10,98,"2013"
"17132","171090 ITAPIRATINS",0,0,1,26,2,29,"2013"
"17133","171110 ITAPORA DO TOCANTINS",0,0,2,37,0,39,"2013"
"17134","171150 JAU DO TOCANTINS",0,0,0,33,0,33,"2013"
"17135","171180 JUARINA",0,0,0,39,1,40,"2013"
"17136","171190 LAGOA DA CONFUSAO",0,1,2,206,2,211,"2013"
"17137","171195 LAGOA DO TOCANTINS",0,1,1,67,4,73,"2013"
"17138","171200 LAJEADO",0,0,0,48,0,48,"2013"
"17139","171215 LAVANDEIRA",0,0,2,20,0,22,"2013"
"17140","171240 LIZARDA",1,0,1,36,2,40,"2013"
"17141","171245 LUZINOPOLIS",0,0,2,37,5,44,"2013"
"17142","171250 MARIANOPOLIS DO TOCANTINS",0,1,2,44,0,47,"2013"
"17143","171270 MATEIROS",0,0,1,41,3,45,"2013"
"17144","171280 MAURILANDIA DO TOCANTINS",0,1,1,27,9,38,"2013"
"17145","171320 MIRACEMA DO TOCANTINS",1,1,1,342,0,345,"2013"
"17146","171330 MIRANORTE",0,2,1,180,1,184,"2013"
"17147","171360 MONTE DO CARMO",1,0,2,108,0,111,"2013"
"17148","171370 MONTE SANTO DO TOCANTINS",0,0,0,20,0,20,"2013"
"17149","171380 PALMEIRAS DO TOCANTINS",0,1,0,69,1,71,"2013"
"17150","171395 MURICILANDIA",0,0,0,48,1,49,"2013"
"17151","171420 NATIVIDADE",1,1,2,140,3,147,"2013"
"17152","171430 NAZARE",1,0,2,53,2,58,"2013"
"17153","171488 NOVA OLINDA",0,0,2,152,9,163,"2013"
"17154","171500 NOVA ROSALANDIA",0,0,2,54,0,56,"2013"
"17155","171510 NOVO ACORDO",1,0,2,76,0,79,"2013"
"17156","171515 NOVO ALEGRE",0,0,0,23,0,23,"2013"
"17157","171525 NOVO JARDIM",0,0,1,34,0,35,"2013"
"17158","171550 OLIVEIRA DE FATIMA",0,0,0,23,0,23,"2013"
"17159","171570 PALMEIRANTE",0,1,2,48,2,53,"2013"
"17160","171575 PALMEIROPOLIS",0,0,1,64,0,65,"2013"
"17161","171610 PARAISO DO TOCANTINS",4,2,6,783,2,797,"2013"
"17162","171620 PARANA",0,1,2,101,32,136,"2013"
"17163","171630 PAU D'ARCO",0,0,2,47,4,53,"2013"
"17164","171650 PEDRO AFONSO",0,1,4,265,1,271,"2013"
"17165","171660 PEIXE",0,0,2,121,0,123,"2013"
"17166","171665 PEQUIZEIRO",0,0,0,51,0,51,"2013"
"17167","171670 COLMEIA",0,1,4,131,1,137,"2013"
"17168","171700 PINDORAMA DO TOCANTINS",0,1,1,45,0,47,"2013"
"17169","171720 PIRAQUE",2,0,1,36,3,42,"2013"
"17170","171750 PIUM",1,0,1,78,0,80,"2013"
"17171","171780 PONTE ALTA DO BOM JESUS",2,0,2,53,0,57,"2013"
"17172","171790 PONTE ALTA DO TOCANTINS",1,1,3,114,0,119,"2013"
"17173","171800 PORTO ALEGRE DO TOCANTINS",0,0,0,42,2,44,"2013"
"17174","171820 PORTO NACIONAL",2,6,11,919,0,938,"2013"
"17175","171830 PRAIA NORTE",0,1,0,89,23,113,"2013"
"17176","171840 PRESIDENTE KENNEDY",0,0,1,45,0,46,"2013"
"17177","171845 PUGMIL",1,0,0,30,0,31,"2013"
"17178","171850 RECURSOLANDIA",0,0,5,68,1,74,"2013"
"17179","171855 RIACHINHO",0,1,1,60,0,62,"2013"
"17180","171865 RIO DA CONCEICAO",0,0,0,35,0,35,"2013"
"17181","171870 RIO DOS BOIS",0,0,2,29,0,31,"2013"
"17182","171875 RIO SONO",0,0,2,62,2,66,"2013"
"17183","171880 SAMPAIO",0,0,0,55,16,71,"2013"
"17184","171884 SANDOLANDIA",0,0,2,37,0,39,"2013"
"17185","171886 SANTA FE DO ARAGUAIA",0,0,1,130,7,138,"2013"
"17186","171888 SANTA MARIA DO TOCANTINS",0,1,1,41,0,43,"2013"
"17187","171889 SANTA RITA DO TOCANTINS",0,0,1,20,1,22,"2013"
"17188","171890 SANTA ROSA DO TOCANTINS",0,0,0,65,0,65,"2013"
"17189","171900 SANTA TEREZA DO TOCANTINS",0,0,0,63,0,63,"2013"
"17190","172000 SANTA TEREZINHA DO TOCANTINS",0,0,0,31,2,33,"2013"
"17191","172010 SAO BENTO DO TOCANTINS",1,0,2,69,18,90,"2013"
"17192","172015 SAO FELIX DO TOCANTINS",0,0,0,24,2,26,"2013"
"17193","172020 SAO MIGUEL DO TOCANTINS",0,1,9,167,7,184,"2013"
"17194","172025 SAO SALVADOR DO TOCANTINS",0,0,0,26,2,28,"2013"
"17195","172030 SAO SEBASTIAO DO TOCANTINS",0,0,1,69,13,83,"2013"
"17196","172049 SAO VALERIO",0,1,0,67,0,68,"2013"
"17197","172065 SILVANOPOLIS",0,1,1,76,1,79,"2013"
"17198","172080 SITIO NOVO DO TOCANTINS",2,0,1,137,5,145,"2013"
"17199","172085 SUCUPIRA",0,0,0,18,2,20,"2013"
"17200","172090 TAGUATINGA",0,0,1,208,1,210,"2013"
"17201","172093 TAIPAS DO TOCANTINS",0,0,0,37,1,38,"2013"
"17202","172097 TALISMA",0,0,0,28,0,28,"2013"
"17203","172100 PALMAS",2,12,46,4738,31,4829,"2013"
"17204","172110 TOCANTINIA",2,1,1,201,3,208,"2013"
"17205","172120 TOCANTINOPOLIS",2,1,6,429,20,458,"2013"
"17206","172125 TUPIRAMA",0,1,0,23,0,24,"2013"
"17207","172130 TUPIRATINS",0,0,0,23,0,23,"2013"
"17208","172208 WANDERLANDIA",0,2,0,117,15,134,"2013"
"17209","172210 XAMBIOA",0,1,8,219,7,235,"2013"
"17210","MUNICIPIO IGNORADO - MA",1,0,0,3,0,4,"2013"
"17211","210005 ACAILANDIA",7,17,41,1967,14,2046,"2013"
"17212","210010 AFONSO CUNHA",1,0,2,94,6,103,"2013"
"17213","210015 AGUA DOCE DO MARANHAO",1,6,1,133,18,159,"2013"
"17214","210020 ALCANTARA",14,1,4,200,22,241,"2013"
"17215","210030 ALDEIAS ALTAS",0,5,9,470,3,487,"2013"
"17216","210040 ALTAMIRA DO MARANHAO",0,1,3,67,5,76,"2013"
"17217","210043 ALTO ALEGRE DO MARANHAO",0,0,9,430,10,449,"2013"
"17218","210047 ALTO ALEGRE DO PINDARE",2,3,5,329,172,511,"2013"
"17219","210050 ALTO PARNAIBA",0,0,1,189,6,196,"2013"
"17220","210055 AMAPA DO MARANHAO",0,0,1,121,6,128,"2013"
"17221","210060 AMARANTE DO MARANHAO",1,3,14,669,61,748,"2013"
"17222","210070 ANAJATUBA",0,2,17,275,22,316,"2013"
"17223","210080 ANAPURUS",0,3,7,238,11,259,"2013"
"17224","210083 APICUM-ACU",0,18,0,44,207,269,"2013"
"17225","210087 ARAGUANA",0,1,7,152,24,184,"2013"
"17226","210090 ARAIOSES",2,7,17,514,43,583,"2013"
"17227","210095 ARAME",0,0,10,592,61,663,"2013"
"17228","210100 ARARI",0,3,17,435,21,476,"2013"
"17229","210110 AXIXA",0,1,5,161,8,175,"2013"
"17230","210120 BACABAL",5,14,48,1610,28,1705,"2013"
"17231","210125 BACABEIRA",1,3,11,231,5,251,"2013"
"17232","210130 BACURI",0,0,0,31,279,310,"2013"
"17233","210135 BACURITUBA",0,0,1,50,6,57,"2013"
"17234","210140 BALSAS",5,1,13,50,1827,1896,"2013"
"17235","210150 BARAO DE GRAJAU",4,0,6,252,4,266,"2013"
"17236","210160 BARRA DO CORDA",1,2,19,1447,16,1485,"2013"
"17237","210170 BARREIRINHAS",7,11,14,1075,105,1212,"2013"
"17238","210173 BELAGUA",0,2,0,41,164,207,"2013"
"17239","210177 BELA VISTA DO MARANHAO",1,1,6,173,4,185,"2013"
"17240","210180 BENEDITO LEITE",0,0,1,8,39,48,"2013"
"17241","210190 BEQUIMAO",3,1,4,132,93,233,"2013"
"17242","210193 BERNARDO DO MEARIM",0,0,2,74,1,77,"2013"
"17243","210197 BOA VISTA DO GURUPI",0,0,2,147,1,150,"2013"
"17244","210200 BOM JARDIM",2,2,15,344,215,578,"2013"
"17245","210203 BOM JESUS DAS SELVAS",2,6,17,491,7,523,"2013"
"17246","210207 BOM LUGAR",1,2,2,146,1,152,"2013"
"17247","210210 BREJO",0,4,3,616,4,627,"2013"
"17248","210215 BREJO DE AREIA",0,1,5,108,14,128,"2013"
"17249","210220 BURITI",0,2,26,536,15,579,"2013"
"17250","210230 BURITI BRAVO",0,3,0,420,2,425,"2013"
"17251","210232 BURITICUPU",1,8,41,1196,16,1262,"2013"
"17252","210235 BURITIRANA",1,1,2,171,11,186,"2013"
"17253","210237 CACHOEIRA GRANDE",0,1,1,127,33,162,"2013"
"17254","210240 CAJAPIO",0,6,18,25,124,173,"2013"
"17255","210250 CAJARI",0,4,2,92,202,300,"2013"
"17256","210255 CAMPESTRE DO MARANHAO",0,3,5,223,2,233,"2013"
"17257","210260 CANDIDO MENDES",0,1,4,254,64,323,"2013"
"17258","210270 CANTANHEDE",0,1,6,248,33,288,"2013"
"17259","210275 CAPINZAL DO NORTE",0,0,0,157,2,159,"2013"
"17260","210280 CAROLINA",0,2,9,329,3,343,"2013"
"17261","210290 CARUTAPERA",0,0,0,456,2,458,"2013"
"17262","210300 CAXIAS",7,18,27,2538,19,2609,"2013"
"17263","210310 CEDRAL",1,0,3,90,40,134,"2013"
"17264","210312 CENTRAL DO MARANHAO",0,0,0,17,101,118,"2013"
"17265","210315 CENTRO DO GUILHERME",0,0,2,192,9,203,"2013"
"17266","210317 CENTRO NOVO DO MARANHAO",0,0,1,273,33,307,"2013"
"17267","210320 CHAPADINHA",2,13,41,1509,34,1599,"2013"
"17268","210325 CIDELANDIA",0,1,7,154,23,185,"2013"
"17269","210330 CODO",12,20,76,1908,81,2097,"2013"
"17270","210340 COELHO NETO",3,4,25,820,4,856,"2013"
"17271","210350 COLINAS",0,3,18,683,9,713,"2013"
"17272","210355 CONCEICAO DO LAGO-ACU",4,6,3,226,46,285,"2013"
"17273","210360 COROATA",2,9,30,1068,29,1138,"2013"
"17274","210370 CURURUPU",0,2,3,83,410,498,"2013"
"17275","210375 DAVINOPOLIS",2,0,8,229,2,241,"2013"
"17276","210380 DOM PEDRO",0,2,7,219,172,400,"2013"
"17277","210390 DUQUE BACELAR",0,0,4,159,35,198,"2013"
"17278","210400 ESPERANTINOPOLIS",0,2,8,293,2,305,"2013"
"17279","210405 ESTREITO",1,4,18,563,3,589,"2013"
"17280","210407 FEIRA NOVA DO MARANHAO",0,0,0,10,120,130,"2013"
"17281","210408 FERNANDO FALCAO",0,1,4,118,60,183,"2013"
"17282","210409 FORMOSA DA SERRA NEGRA",0,0,1,40,232,273,"2013"
"17283","210410 FORTALEZA DOS NOGUEIRAS",0,0,0,135,72,207,"2013"
"17284","210420 FORTUNA",2,1,5,287,8,303,"2013"
"17285","210430 GODOFREDO VIANA",0,1,2,128,24,155,"2013"
"17286","210440 GONCALVES DIAS",0,0,2,40,234,276,"2013"
"17287","210450 GOVERNADOR ARCHER",1,0,1,192,4,198,"2013"
"17288","210455 GOVERNADOR EDISON LOBAO",0,0,16,257,8,281,"2013"
"17289","210460 GOVERNADOR EUGENIO BARROS",0,0,35,228,5,268,"2013"
"17290","210462 GOVERNADOR LUIZ ROCHA",1,1,1,119,0,122,"2013"
"17291","210465 GOVERNADOR NEWTON BELLO",1,1,4,151,8,165,"2013"
"17292","210467 GOVERNADOR NUNES FREIRE",1,6,5,517,10,539,"2013"
"17293","210470 GRACA ARANHA",0,0,0,87,1,88,"2013"
"17294","210480 GRAJAU",3,4,24,1429,165,1625,"2013"
"17295","210490 GUIMARAES",0,1,0,14,137,152,"2013"
"17296","210500 HUMBERTO DE CAMPOS",2,0,3,312,170,487,"2013"
"17297","210510 ICATU",1,2,7,332,56,398,"2013"
"17298","210515 IGARAPE DO MEIO",1,6,6,228,14,255,"2013"
"17299","210520 IGARAPE GRANDE",1,1,0,138,0,140,"2013"
"17300","210530 IMPERATRIZ",17,25,158,4749,37,4986,"2013"
"17301","210535 ITAIPAVA DO GRAJAU",0,0,11,247,8,266,"2013"
"17302","210540 ITAPECURU MIRIM",0,2,9,116,1150,1277,"2013"
"17303","210542 ITINGA DO MARANHAO",4,3,6,304,0,317,"2013"
"17304","210545 JATOBA",1,1,3,106,1,112,"2013"
"17305","210547 JENIPAPO DOS VIEIRAS",0,2,2,238,38,280,"2013"
"17306","210550 JOAO LISBOA",3,2,10,396,4,415,"2013"
"17307","210560 JOSELANDIA",0,4,8,208,8,228,"2013"
"17308","210565 JUNCO DO MARANHAO",0,0,5,109,1,115,"2013"
"17309","210570 LAGO DA PEDRA",1,6,10,905,2,924,"2013"
"17310","210580 LAGO DO JUNCO",1,1,4,134,1,141,"2013"
"17311","210590 LAGO VERDE",0,3,10,272,13,298,"2013"
"17312","210592 LAGOA DO MATO",1,0,0,117,9,127,"2013"
"17313","210594 LAGO DOS RODRIGUES",0,2,2,151,0,155,"2013"
"17314","210596 LAGOA GRANDE DO MARANHAO",1,3,4,191,22,221,"2013"
"17315","210598 LAJEADO NOVO",0,2,5,106,0,113,"2013"
"17316","210600 LIMA CAMPOS",1,3,5,194,10,213,"2013"
"17317","210610 LORETO",0,0,0,9,176,185,"2013"
"17318","210620 LUIS DOMINGUES",0,0,0,106,10,116,"2013"
"17319","210630 MAGALHAES DE ALMEIDA",0,4,22,203,2,231,"2013"
"17320","210632 MARACACUME",0,1,4,353,5,363,"2013"
"17321","210635 MARAJA DO SENA",0,1,6,119,11,137,"2013"
"17322","210637 MARANHAOZINHO",1,2,2,167,12,184,"2013"
"17323","210640 MATA ROMA",2,1,6,282,21,312,"2013"
"17324","210650 MATINHA",2,1,0,42,357,402,"2013"
"17325","210660 MATOES",0,2,5,408,89,504,"2013"
"17326","210663 MATOES DO NORTE",0,2,5,66,33,106,"2013"
"17327","210667 MILAGRES DO MARANHAO",0,0,2,95,0,97,"2013"
"17328","210670 MIRADOR",0,0,2,304,8,314,"2013"
"17329","210675 MIRANDA DO NORTE",0,2,2,261,45,310,"2013"
"17330","210680 MIRINZAL",0,0,0,17,184,201,"2013"
"17331","210690 MONCAO",0,6,16,483,119,624,"2013"
"17332","210700 MONTES ALTOS",1,2,3,151,3,160,"2013"
"17333","210710 MORROS",0,1,4,255,59,319,"2013"
"17334","210720 NINA RODRIGUES",0,1,4,112,74,191,"2013"
"17335","210725 NOVA COLINAS",1,0,1,50,24,76,"2013"
"17336","210730 NOVA IORQUE",0,0,0,19,31,50,"2013"
"17337","210735 NOVA OLINDA DO MARANHAO",1,0,16,315,6,338,"2013"
"17338","210740 OLHO D'AGUA DAS CUNHAS",2,1,1,210,54,268,"2013"
"17339","210745 OLINDA NOVA DO MARANHAO",0,1,0,18,189,208,"2013"
"17340","210750 PACO DO LUMIAR",4,5,21,1527,30,1587,"2013"
"17341","210760 PALMEIRANDIA",0,5,10,206,59,280,"2013"
"17342","210770 PARAIBANO",2,3,21,351,2,379,"2013"
"17343","210780 PARNARAMA",4,1,2,378,152,537,"2013"
"17344","210790 PASSAGEM FRANCA",0,1,4,333,0,338,"2013"
"17345","210800 PASTOS BONS",0,0,1,44,274,319,"2013"
"17346","210805 PAULINO NEVES",0,20,7,213,66,306,"2013"
"17347","210810 PAULO RAMOS",0,3,7,364,19,393,"2013"
"17348","210820 PEDREIRAS",1,3,4,663,0,671,"2013"
"17349","210825 PEDRO DO ROSARIO",6,5,32,145,103,291,"2013"
"17350","210830 PENALVA",1,0,17,557,76,651,"2013"
"17351","210840 PERI MIRIM",1,1,5,106,27,140,"2013"
"17352","210845 PERITORO",0,2,12,374,5,393,"2013"
"17353","210850 PINDARE-MIRIM",1,7,20,474,18,520,"2013"
"17354","210860 PINHEIRO",1,2,50,1222,113,1388,"2013"
"17355","210870 PIO XII",0,2,4,456,43,505,"2013"
"17356","210880 PIRAPEMAS",0,2,6,277,20,305,"2013"
"17357","210890 POCAO DE PEDRAS",2,1,5,249,1,258,"2013"
"17358","210900 PORTO FRANCO",0,2,8,432,0,442,"2013"
"17359","210905 PORTO RICO DO MARANHAO",0,0,0,62,23,85,"2013"
"17360","210910 PRESIDENTE DUTRA",3,4,4,784,7,802,"2013"
"17361","210920 PRESIDENTE JUSCELINO",1,1,2,141,49,194,"2013"
"17362","210923 PRESIDENTE MEDICI",1,0,0,90,1,92,"2013"
"17363","210927 PRESIDENTE SARNEY",1,1,5,258,62,327,"2013"
"17364","210930 PRESIDENTE VARGAS",4,0,8,87,79,178,"2013"
"17365","210940 PRIMEIRA CRUZ",0,0,0,139,41,180,"2013"
"17366","210945 RAPOSA",1,2,6,453,8,470,"2013"
"17367","210950 RIACHAO",3,4,9,275,31,322,"2013"
"17368","210955 RIBAMAR FIQUENE",0,2,5,125,6,138,"2013"
"17369","210960 ROSARIO",2,3,17,542,18,582,"2013"
"17370","210970 SAMBAIBA",0,1,2,32,31,66,"2013"
"17371","210975 SANTA FILOMENA DO MARANHAO",0,1,1,103,0,105,"2013"
"17372","210980 SANTA HELENA",5,4,8,220,364,601,"2013"
"17373","210990 SANTA INES",14,6,38,1529,6,1593,"2013"
"17374","211000 SANTA LUZIA",0,8,22,1104,156,1290,"2013"
"17375","211003 SANTA LUZIA DO PARUA",0,1,5,376,4,386,"2013"
"17376","211010 SANTA QUITERIA DO MARANHAO",0,0,13,453,8,474,"2013"
"17377","211020 SANTA RITA",2,6,55,597,21,681,"2013"
"17378","211023 SANTANA DO MARANHAO",0,0,5,106,21,132,"2013"
"17379","211027 SANTO AMARO DO MARANHAO",1,0,1,85,55,142,"2013"
"17380","211030 SANTO ANTONIO DOS LOPES",0,0,2,66,177,245,"2013"
"17381","211040 SAO BENEDITO DO RIO PRETO",1,0,1,51,373,426,"2013"
"17382","211050 SAO BENTO",6,3,1,491,20,521,"2013"
"17383","211060 SAO BERNARDO",2,2,23,436,8,471,"2013"
"17384","211065 SAO DOMINGOS DO AZEITAO",0,0,0,4,92,96,"2013"
"17385","211070 SAO DOMINGOS DO MARANHAO",0,1,5,622,14,642,"2013"
"17386","211080 SAO FELIX DE BALSAS",0,0,0,0,47,47,"2013"
"17387","211085 SAO FRANCISCO DO BREJAO",0,0,6,123,4,133,"2013"
"17388","211090 SAO FRANCISCO DO MARANHAO",0,0,1,121,7,129,"2013"
"17389","211100 SAO JOAO BATISTA",1,5,97,179,22,304,"2013"
"17390","211102 SAO JOAO DO CARU",2,11,10,208,4,235,"2013"
"17391","211105 SAO JOAO DO PARAISO",0,2,3,182,3,190,"2013"
"17392","211107 SAO JOAO DO SOTER",0,1,4,257,21,283,"2013"
"17393","211110 SAO JOAO DOS PATOS",1,2,6,386,4,399,"2013"
"17394","211120 SAO JOSE DE RIBAMAR",13,7,49,2987,47,3103,"2013"
"17395","211125 SAO JOSE DOS BASILIOS",0,2,2,94,1,99,"2013"
"17396","211130 SAO LUIS",87,80,319,16419,299,17204,"2013"
"17397","211140 SAO LUIS GONZAGA DO MARANHAO",0,4,10,330,4,348,"2013"
"17398","211150 SAO MATEUS DO MARANHAO",0,9,39,616,21,685,"2013"
"17399","211153 SAO PEDRO DA AGUA BRANCA",0,2,11,152,0,165,"2013"
"17400","211157 SAO PEDRO DOS CRENTES",0,0,1,65,2,68,"2013"
"17401","211160 SAO RAIMUNDO DAS MANGABEIRAS",0,1,1,11,329,342,"2013"
"17402","211163 SAO RAIMUNDO DO DOCA BEZERRA",0,0,1,68,0,69,"2013"
"17403","211167 SAO ROBERTO",0,0,3,81,5,89,"2013"
"17404","211170 SAO VICENTE FERRER",0,3,7,160,156,326,"2013"
"17405","211172 SATUBINHA",0,2,5,101,2,110,"2013"
"17406","211174 SENADOR ALEXANDRE COSTA",1,3,3,164,1,172,"2013"
"17407","211176 SENADOR LA ROCQUE",0,4,6,309,7,326,"2013"
"17408","211178 SERRANO DO MARANHAO",0,0,0,21,131,152,"2013"
"17409","211180 SITIO NOVO",0,0,8,223,6,237,"2013"
"17410","211190 SUCUPIRA DO NORTE",2,1,5,158,10,176,"2013"
"17411","211195 SUCUPIRA DO RIACHAO",0,1,2,76,1,80,"2013"
"17412","211200 TASSO FRAGOSO",0,1,0,63,63,127,"2013"
"17413","211210 TIMBIRAS",3,2,17,530,22,574,"2013"
"17414","211220 TIMON",14,6,24,2465,15,2524,"2013"
"17415","211223 TRIZIDELA DO VALE",0,1,2,309,1,313,"2013"
"17416","211227 TUFILANDIA",0,1,2,99,7,109,"2013"
"17417","211230 TUNTUM",0,2,9,598,1,610,"2013"
"17418","211240 TURIACU",1,0,0,21,667,689,"2013"
"17419","211245 TURILANDIA",0,1,2,97,241,341,"2013"
"17420","211250 TUTOIA",3,12,19,856,95,985,"2013"
"17421","211260 URBANO SANTOS",1,4,9,134,533,681,"2013"
"17422","211270 VARGEM GRANDE",7,6,34,773,60,880,"2013"
"17423","211280 VIANA",11,3,8,472,550,1044,"2013"
"17424","211285 VILA NOVA DOS MARTIRIOS",0,1,7,114,1,123,"2013"
"17425","211290 VITORIA DO MEARIM",2,1,2,75,527,607,"2013"
"17426","211300 VITORINO FREIRE",1,4,15,459,4,483,"2013"
"17427","211400 ZE DOCA",3,4,31,792,7,837,"2013"
"17428","220005 ACAUA",0,1,1,63,15,80,"2013"
"17429","220010 AGRICOLANDIA",0,0,0,48,2,50,"2013"
"17430","220020 AGUA BRANCA",0,3,2,270,20,295,"2013"
"17431","220025 ALAGOINHA DO PIAUI",0,0,2,86,1,89,"2013"
"17432","220027 ALEGRETE DO PIAUI",1,0,0,68,0,69,"2013"
"17433","220030 ALTO LONGA",2,2,3,124,3,134,"2013"
"17434","220040 ALTOS",4,1,7,459,57,528,"2013"
"17435","220045 ALVORADA DO GURGUEIA",2,0,0,22,50,74,"2013"
"17436","220050 AMARANTE",4,1,4,242,5,256,"2013"
"17437","220060 ANGICAL DO PIAUI",1,1,0,87,6,95,"2013"
"17438","220070 ANISIO DE ABREU",0,0,0,73,70,143,"2013"
"17439","220080 ANTONIO ALMEIDA",0,0,0,27,17,44,"2013"
"17440","220090 AROAZES",0,0,0,58,1,59,"2013"
"17441","220095 AROEIRAS DO ITAIM",0,0,5,16,0,21,"2013"
"17442","220100 ARRAIAL",1,1,3,45,1,51,"2013"
"17443","220105 ASSUNCAO DO PIAUI",1,0,1,98,9,109,"2013"
"17444","220110 AVELINO LOPES",0,1,2,111,70,184,"2013"
"17445","220115 BAIXA GRANDE DO RIBEIRO",0,1,0,50,192,243,"2013"
"17446","220117 BARRA D'ALCANTARA",0,0,1,45,0,46,"2013"
"17447","220120 BARRAS",6,8,9,723,19,765,"2013"
"17448","220130 BARREIRAS DO PIAUI",0,0,1,10,37,48,"2013"
"17449","220140 BARRO DURO",0,0,1,95,6,102,"2013"
"17450","220150 BATALHA",2,0,6,328,4,340,"2013"
"17451","220155 BELA VISTA DO PIAUI",0,0,0,47,3,50,"2013"
"17452","220157 BELEM DO PIAUI",0,0,7,31,0,38,"2013"
"17453","220160 BENEDITINOS",0,0,2,100,26,128,"2013"
"17454","220170 BERTOLINIA",2,1,1,87,2,93,"2013"
"17455","220173 BETANIA DO PIAUI",1,0,1,78,10,90,"2013"
"17456","220177 BOA HORA",1,0,1,33,55,90,"2013"
"17457","220180 BOCAINA",0,0,1,35,0,36,"2013"
"17458","220190 BOM JESUS",2,3,1,174,292,472,"2013"
"17459","220191 BOM PRINCIPIO DO PIAUI",0,2,1,79,5,87,"2013"
"17460","220192 BONFIM DO PIAUI",0,1,0,40,35,76,"2013"
"17461","220194 BOQUEIRAO DO PIAUI",0,0,1,22,78,101,"2013"
"17462","220196 BRASILEIRA",0,0,1,90,0,91,"2013"
"17463","220198 BREJO DO PIAUI",0,2,1,39,21,63,"2013"
"17464","220200 BURITI DOS LOPES",2,2,7,277,20,308,"2013"
"17465","220202 BURITI DOS MONTES",0,0,1,46,27,74,"2013"
"17466","220205 CABECEIRAS DO PIAUI",0,0,4,69,40,113,"2013"
"17467","220207 CAJAZEIRAS DO PIAUI",0,0,2,23,0,25,"2013"
"17468","220208 CAJUEIRO DA PRAIA",1,1,6,73,7,88,"2013"
"17469","220209 CALDEIRAO GRANDE DO PIAUI",1,0,2,50,1,54,"2013"
"17470","220210 CAMPINAS DO PIAUI",1,0,2,68,0,71,"2013"
"17471","220211 CAMPO ALEGRE DO FIDALGO",1,0,4,60,1,66,"2013"
"17472","220213 CAMPO GRANDE DO PIAUI",0,0,9,62,0,71,"2013"
"17473","220217 CAMPO LARGO DO PIAUI",0,0,1,100,2,103,"2013"
"17474","220220 CAMPO MAIOR",1,0,3,199,592,795,"2013"
"17475","220225 CANAVIEIRA",0,0,1,38,3,42,"2013"
"17476","220230 CANTO DO BURITI",1,1,9,241,12,264,"2013"
"17477","220240 CAPITAO DE CAMPOS",1,0,1,80,84,166,"2013"
"17478","220245 CAPITAO GERVASIO OLIVEIRA",0,0,0,27,0,27,"2013"
"17479","220250 CARACOL",2,0,0,95,76,173,"2013"
"17480","220253 CARAUBAS DO PIAUI",0,0,1,64,5,70,"2013"
"17481","220255 CARIDADE DO PIAUI",0,0,3,70,1,74,"2013"
"17482","220260 CASTELO DO PIAUI",0,0,4,177,130,311,"2013"
"17483","220265 CAXINGO",0,0,1,79,7,87,"2013"
"17484","220270 COCAL",1,0,6,338,25,370,"2013"
"17485","220271 COCAL DE TELHA",0,0,0,22,50,72,"2013"
"17486","220272 COCAL DOS ALVES",0,0,0,77,6,83,"2013"
"17487","220273 COIVARAS",0,1,0,39,9,49,"2013"
"17488","220275 COLONIA DO GURGUEIA",4,0,1,48,20,73,"2013"
"17489","220277 COLONIA DO PIAUI",0,1,3,72,2,78,"2013"
"17490","220280 CONCEICAO DO CANINDE",1,1,2,71,0,75,"2013"
"17491","220285 CORONEL JOSE DIAS",0,0,0,25,28,53,"2013"
"17492","220290 CORRENTE",0,0,3,160,247,410,"2013"
"17493","220300 CRISTALANDIA DO PIAUI",0,0,0,40,65,105,"2013"
"17494","220310 CRISTINO CASTRO",0,0,0,54,110,164,"2013"
"17495","220320 CURIMATA",0,0,2,110,54,166,"2013"
"17496","220323 CURRAIS",0,0,0,24,55,79,"2013"
"17497","220325 CURRALINHOS",1,0,2,60,0,63,"2013"
"17498","220327 CURRAL NOVO DO PIAUI",1,0,1,73,3,78,"2013"
"17499","220330 DEMERVAL LOBAO",0,0,4,175,8,187,"2013"
"17500","220335 DIRCEU ARCOVERDE",0,0,0,58,38,96,"2013"
"17501","220340 DOM EXPEDITO LOPES",0,0,2,87,0,89,"2013"
"17502","220342 DOMINGOS MOURAO",0,0,0,46,2,48,"2013"
"17503","220345 DOM INOCENCIO",0,0,0,54,33,87,"2013"
"17504","220350 ELESBAO VELOSO",0,1,4,144,6,155,"2013"
"17505","220360 ELISEU MARTINS",1,0,0,47,2,50,"2013"
"17506","220370 ESPERANTINA",1,1,10,633,4,649,"2013"
"17507","220375 FARTURA DO PIAUI",0,0,1,43,38,82,"2013"
"17508","220380 FLORES DO PIAUI",1,2,2,45,2,52,"2013"
"17509","220385 FLORESTA DO PIAUI",0,1,0,24,2,27,"2013"
"17510","220390 FLORIANO",5,3,22,800,4,834,"2013"
"17511","220400 FRANCINOPOLIS",1,1,1,44,0,47,"2013"
"17512","220410 FRANCISCO AYRES",0,0,1,55,4,60,"2013"
"17513","220415 FRANCISCO MACEDO",1,1,11,27,1,41,"2013"
"17514","220420 FRANCISCO SANTOS",1,1,9,84,0,95,"2013"
"17515","220430 FRONTEIRAS",0,0,7,132,0,139,"2013"
"17516","220435 GEMINIANO",0,0,2,72,1,75,"2013"
"17517","220440 GILBUES",0,3,2,123,61,189,"2013"
"17518","220450 GUADALUPE",0,0,2,144,14,160,"2013"
"17519","220455 GUARIBAS",0,1,0,37,29,67,"2013"
"17520","220460 HUGO NAPOLEAO",0,0,0,48,3,51,"2013"
"17521","220465 ILHA GRANDE",0,1,4,137,6,148,"2013"
"17522","220470 INHUMA",3,0,1,197,1,202,"2013"
"17523","220480 IPIRANGA DO PIAUI",0,0,2,127,1,130,"2013"
"17524","220490 ISAIAS COELHO",0,0,2,107,6,115,"2013"
"17525","220500 ITAINOPOLIS",1,0,6,108,0,115,"2013"
"17526","220510 ITAUEIRA",0,0,2,148,0,150,"2013"
"17527","220515 JACOBINA DO PIAUI",1,0,4,67,12,84,"2013"
"17528","220520 JAICOS",1,3,12,267,2,285,"2013"
"17529","220525 JARDIM DO MULATO",1,0,0,57,3,61,"2013"
"17530","220527 JATOBA DO PIAUI",0,0,0,18,37,55,"2013"
"17531","220530 JERUMENHA",0,1,1,57,3,62,"2013"
"17532","220535 JOAO COSTA",0,1,0,34,3,38,"2013"
"17533","220540 JOAQUIM PIRES",0,1,2,171,10,184,"2013"
"17534","220545 JOCA MARQUES",2,0,3,72,1,78,"2013"
"17535","220550 JOSE DE FREITAS",4,1,5,467,5,482,"2013"
"17536","220551 JUAZEIRO DO PIAUI",0,0,0,37,29,66,"2013"
"17537","220552 JULIO BORGES",1,0,1,66,29,97,"2013"
"17538","220553 JUREMA",0,0,0,39,35,74,"2013"
"17539","220554 LAGOINHA DO PIAUI",0,0,2,37,3,42,"2013"
"17540","220555 LAGOA ALEGRE",0,0,1,107,11,119,"2013"
"17541","220556 LAGOA DO BARRO DO PIAUI",0,2,4,55,4,65,"2013"
"17542","220557 LAGOA DE SAO FRANCISCO",0,0,1,84,3,88,"2013"
"17543","220558 LAGOA DO PIAUI",2,0,1,58,1,62,"2013"
"17544","220559 LAGOA DO SITIO",0,0,0,46,0,46,"2013"
"17545","220560 LANDRI SALES",0,0,1,41,5,47,"2013"
"17546","220570 LUIS CORREIA",0,2,6,395,27,430,"2013"
"17547","220580 LUZILANDIA",2,0,9,371,6,388,"2013"
"17548","220585 MADEIRO",0,3,4,124,1,132,"2013"
"17549","220590 MANOEL EMIDIO",33,0,1,31,2,67,"2013"
"17550","220595 MARCOLANDIA",0,0,7,117,0,124,"2013"
"17551","220600 MARCOS PARENTE",1,0,2,53,0,56,"2013"
"17552","220605 MASSAPE DO PIAUI",0,0,3,64,0,67,"2013"
"17553","220610 MATIAS OLIMPIO",1,0,1,173,1,176,"2013"
"17554","220620 MIGUEL ALVES",6,2,8,475,37,528,"2013"
"17555","220630 MIGUEL LEAO",0,0,2,18,1,21,"2013"
"17556","220635 MILTON BRANDAO",0,0,2,79,1,82,"2013"
"17557","220640 MONSENHOR GIL",1,2,0,124,20,147,"2013"
"17558","220650 MONSENHOR HIPOLITO",0,2,3,98,0,103,"2013"
"17559","220660 MONTE ALEGRE DO PIAUI",1,1,0,74,106,182,"2013"
"17560","220665 MORRO CABECA NO TEMPO",0,0,2,42,34,78,"2013"
"17561","220667 MORRO DO CHAPEU DO PIAUI",0,0,0,85,1,86,"2013"
"17562","220669 MURICI DOS PORTELAS",0,0,1,92,9,102,"2013"
"17563","220670 NAZARE DO PIAUI",0,0,4,78,1,83,"2013"
"17564","220672 NAZARIA",0,1,2,146,3,152,"2013"
"17565","220675 NOSSA SENHORA DE NAZARE",0,0,0,16,50,66,"2013"
"17566","220680 NOSSA SENHORA DOS REMEDIOS",0,0,5,145,5,155,"2013"
"17567","220690 NOVO ORIENTE DO PIAUI",0,0,2,51,0,53,"2013"
"17568","220695 NOVO SANTO ANTONIO",0,0,1,17,1,19,"2013"
"17569","220700 OEIRAS",2,1,7,427,7,444,"2013"
"17570","220710 OLHO D'AGUA DO PIAUI",0,0,2,35,3,40,"2013"
"17571","220720 PADRE MARCOS",2,1,13,80,0,96,"2013"
"17572","220730 PAES LANDIM",0,0,0,39,1,40,"2013"
"17573","220735 PAJEU DO PIAUI",0,0,0,25,0,25,"2013"
"17574","220740 PALMEIRA DO PIAUI",1,0,0,20,59,80,"2013"
"17575","220750 PALMEIRAIS",0,0,1,147,41,189,"2013"
"17576","220755 PAQUETA",0,0,2,37,0,39,"2013"
"17577","220760 PARNAGUA",0,0,1,18,126,145,"2013"
"17578","220770 PARNAIBA",9,6,31,2167,68,2281,"2013"
"17579","220775 PASSAGEM FRANCA DO PIAUI",1,0,1,59,2,63,"2013"
"17580","220777 PATOS DO PIAUI",0,0,3,54,3,60,"2013"
"17581","220779 PAU D'ARCO DO PIAUI",0,0,0,42,0,42,"2013"
"17582","220780 PAULISTANA",0,4,5,277,48,334,"2013"
"17583","220785 PAVUSSU",1,0,3,40,0,44,"2013"
"17584","220790 PEDRO II",1,4,15,481,11,512,"2013"
"17585","220793 PEDRO LAURENTINO",0,0,1,24,0,25,"2013"
"17586","220795 NOVA SANTA RITA",0,0,0,49,1,50,"2013"
"17587","220800 PICOS",2,4,45,946,4,1001,"2013"
"17588","220810 PIMENTEIRAS",1,0,0,117,2,120,"2013"
"17589","220820 PIO IX",1,3,10,211,0,225,"2013"
"17590","220830 PIRACURUCA",3,1,4,372,3,383,"2013"
"17591","220840 PIRIPIRI",1,3,8,914,14,940,"2013"
"17592","220850 PORTO",2,1,2,217,5,227,"2013"
"17593","220855 PORTO ALEGRE DO PIAUI",0,0,2,31,2,35,"2013"
"17594","220860 PRATA DO PIAUI",0,0,0,40,1,41,"2013"
"17595","220865 QUEIMADA NOVA",0,0,1,60,16,77,"2013"
"17596","220870 REDENCAO DO GURGUEIA",0,2,1,56,107,166,"2013"
"17597","220880 REGENERACAO",1,5,3,262,3,274,"2013"
"17598","220885 RIACHO FRIO",0,0,0,23,48,71,"2013"
"17599","220887 RIBEIRA DO PIAUI",0,0,2,41,4,47,"2013"
"17600","220890 RIBEIRO GONCALVES",0,1,0,9,88,98,"2013"
"17601","220900 RIO GRANDE DO PIAUI",0,1,3,70,1,75,"2013"
"17602","220910 SANTA CRUZ DO PIAUI",0,1,4,70,1,76,"2013"
"17603","220915 SANTA CRUZ DOS MILAGRES",0,0,1,49,1,51,"2013"
"17604","220920 SANTA FILOMENA",0,1,0,86,22,109,"2013"
"17605","220930 SANTA LUZ",0,0,0,29,55,84,"2013"
"17606","220935 SANTANA DO PIAUI",0,0,1,59,0,60,"2013"
"17607","220937 SANTA ROSA DO PIAUI",0,1,1,54,0,56,"2013"
"17608","220940 SANTO ANTONIO DE LISBOA",0,1,1,52,0,54,"2013"
"17609","220945 SANTO ANTONIO DOS MILAGRES",0,0,0,18,2,20,"2013"
"17610","220950 SANTO INACIO DO PIAUI",0,0,1,27,0,28,"2013"
"17611","220955 SAO BRAZ DO PIAUI",0,0,0,19,28,47,"2013"
"17612","220960 SAO FELIX DO PIAUI",0,0,0,26,2,28,"2013"
"17613","220965 SAO FRANCISCO DE ASSIS DO PIAUI",1,0,2,50,0,53,"2013"
"17614","220970 SAO FRANCISCO DO PIAUI",0,1,2,67,0,70,"2013"
"17615","220975 SAO GONCALO DO GURGUEIA",0,0,0,11,22,33,"2013"
"17616","220980 SAO GONCALO DO PIAUI",0,0,0,68,5,73,"2013"
"17617","220985 SAO JOAO DA CANABRAVA",0,0,0,45,1,46,"2013"
"17618","220987 SAO JOAO DA FRONTEIRA",0,1,2,63,0,66,"2013"
"17619","220990 SAO JOAO DA SERRA",0,0,0,44,17,61,"2013"
"17620","220995 SAO JOAO DA VARJOTA",1,1,0,65,0,67,"2013"
"17621","220997 SAO JOAO DO ARRAIAL",1,1,2,122,1,127,"2013"
"17622","221000 SAO JOAO DO PIAUI",0,1,9,302,3,315,"2013"
"17623","221005 SAO JOSE DO DIVINO",0,0,0,60,0,60,"2013"
"17624","221010 SAO JOSE DO PEIXE",0,0,1,50,0,51,"2013"
"17625","221020 SAO JOSE DO PIAUI",1,1,1,78,0,81,"2013"
"17626","221030 SAO JULIAO",1,0,4,84,1,90,"2013"
"17627","221035 SAO LOURENCO DO PIAUI",0,1,0,25,29,55,"2013"
"17628","221037 SAO LUIS DO PIAUI",0,0,2,20,0,22,"2013"
"17629","221038 SAO MIGUEL DA BAIXA GRANDE",0,0,0,23,2,25,"2013"
"17630","221039 SAO MIGUEL DO FIDALGO",0,0,0,22,0,22,"2013"
"17631","221040 SAO MIGUEL DO TAPUIO",1,0,3,184,19,207,"2013"
"17632","221050 SAO PEDRO DO PIAUI",2,0,2,152,23,179,"2013"
"17633","221060 SAO RAIMUNDO NONATO",2,2,2,264,279,549,"2013"
"17634","221062 SEBASTIAO BARROS",0,0,1,33,32,66,"2013"
"17635","221063 SEBASTIAO LEAL",0,1,3,34,20,58,"2013"
"17636","221065 SIGEFREDO PACHECO",0,0,0,24,69,93,"2013"
"17637","221070 SIMOES",1,0,1,205,0,207,"2013"
"17638","221080 SIMPLICIO MENDES",0,0,5,150,3,158,"2013"
"17639","221090 SOCORRO DO PIAUI",0,0,2,53,1,56,"2013"
"17640","221093 SUSSUAPARA",1,0,2,68,0,71,"2013"
"17641","221095 TAMBORIL DO PIAUI",0,0,0,16,20,36,"2013"
"17642","221097 TANQUE DO PIAUI",0,0,1,25,0,26,"2013"
"17643","221100 TERESINA",53,52,159,12943,149,13356,"2013"
"17644","221110 UNIAO",3,3,7,375,267,655,"2013"
"17645","221120 URUCUI",0,0,6,80,285,371,"2013"
"17646","221130 VALENCA DO PIAUI",5,0,1,269,3,278,"2013"
"17647","221135 VARZEA BRANCA",0,0,0,27,36,63,"2013"
"17648","221140 VARZEA GRANDE",0,0,1,48,0,49,"2013"
"17649","221150 VERA MENDES",0,0,7,28,1,36,"2013"
"17650","221160 VILA NOVA DO PIAUI",0,0,2,30,0,32,"2013"
"17651","221170 WALL FERRAZ",0,0,3,37,2,42,"2013"
"17652","MUNICIPIO IGNORADO - CE",0,0,0,2,0,2,"2013"
"17653","230010 ABAIARA",0,0,1,115,0,116,"2013"
"17654","230015 ACARAPE",1,2,4,235,1,243,"2013"
"17655","230020 ACARAU",2,1,6,959,0,968,"2013"
"17656","230030 ACOPIARA",4,7,35,532,0,578,"2013"
"17657","230040 AIUABA",0,2,4,149,5,160,"2013"
"17658","230050 ALCANTARAS",0,1,5,151,0,157,"2013"
"17659","230060 ALTANEIRA",0,1,3,88,0,92,"2013"
"17660","230070 ALTO SANTO",0,1,4,172,0,177,"2013"
"17661","230075 AMONTADA",4,1,18,644,9,676,"2013"
"17662","230080 ANTONINA DO NORTE",1,0,3,106,2,112,"2013"
"17663","230090 APUIARES",0,1,5,145,0,151,"2013"
"17664","230100 AQUIRAZ",2,4,12,920,5,943,"2013"
"17665","230110 ARACATI",5,5,23,925,7,965,"2013"
"17666","230120 ARACOIABA",2,2,8,376,2,390,"2013"
"17667","230125 ARARENDA",0,0,2,95,2,99,"2013"
"17668","230130 ARARIPE",0,1,18,322,0,341,"2013"
"17669","230140 ARATUBA",0,0,5,151,0,156,"2013"
"17670","230150 ARNEIROZ",1,0,4,63,1,69,"2013"
"17671","230160 ASSARE",1,3,14,278,0,296,"2013"
"17672","230170 AURORA",0,1,4,293,1,299,"2013"
"17673","230180 BAIXIO",1,0,4,73,1,79,"2013"
"17674","230185 BANABUIU",0,3,9,238,2,252,"2013"
"17675","230190 BARBALHA",1,3,17,1034,40,1095,"2013"
"17676","230195 BARREIRA",0,2,7,309,3,321,"2013"
"17677","230200 BARRO",0,1,2,281,0,284,"2013"
"17678","230205 BARROQUINHA",0,4,4,197,0,205,"2013"
"17679","230210 BATURITE",2,4,13,461,0,480,"2013"
"17680","230220 BEBERIBE",1,3,19,572,5,600,"2013"
"17681","230230 BELA CRUZ",1,3,8,393,5,410,"2013"
"17682","230240 BOA VIAGEM",3,5,10,613,1,632,"2013"
"17683","230250 BREJO SANTO",0,2,13,678,0,693,"2013"
"17684","230260 CAMOCIM",2,6,16,903,4,931,"2013"
"17685","230270 CAMPOS SALES",0,4,19,379,0,402,"2013"
"17686","230280 CANINDE",0,4,26,1010,9,1049,"2013"
"17687","230290 CAPISTRANO",1,0,7,246,2,256,"2013"
"17688","230300 CARIDADE",3,4,7,253,6,273,"2013"
"17689","230310 CARIRE",1,2,7,192,0,202,"2013"
"17690","230320 CARIRIACU",6,2,18,366,1,393,"2013"
"17691","230330 CARIUS",0,2,7,201,0,210,"2013"
"17692","230340 CARNAUBAL",3,3,7,220,1,234,"2013"
"17693","230350 CASCAVEL",2,0,13,942,13,970,"2013"
"17694","230360 CATARINA",0,1,9,134,0,144,"2013"
"17695","230365 CATUNDA",2,2,1,118,0,123,"2013"
"17696","230370 CAUCAIA",13,16,75,4926,28,5058,"2013"
"17697","230380 CEDRO",0,2,6,262,3,273,"2013"
"17698","230390 CHAVAL",0,3,0,207,3,213,"2013"
"17699","230393 CHORO",0,1,4,190,9,204,"2013"
"17700","230395 CHOROZINHO",0,2,13,284,1,300,"2013"
"17701","230400 COREAU",2,1,2,277,2,284,"2013"
"17702","230410 CRATEUS",2,4,15,900,18,939,"2013"
"17703","230420 CRATO",3,11,59,1974,2,2049,"2013"
"17704","230423 CROATA",3,3,4,192,2,204,"2013"
"17705","230425 CRUZ",0,2,4,343,2,351,"2013"
"17706","230426 DEPUTADO IRAPUAN PINHEIRO",1,1,3,80,0,85,"2013"
"17707","230427 ERERE",0,2,1,47,0,50,"2013"
"17708","230428 EUSEBIO",5,6,21,962,5,999,"2013"
"17709","230430 FARIAS BRITO",1,1,6,266,1,275,"2013"
"17710","230435 FORQUILHA",1,2,3,308,1,315,"2013"
"17711","230440 FORTALEZA",103,117,511,35873,218,36822,"2013"
"17712","230445 FORTIM",1,1,1,153,1,157,"2013"
"17713","230450 FRECHEIRINHA",1,3,4,241,0,249,"2013"
"17714","230460 GENERAL SAMPAIO",0,0,0,76,0,76,"2013"
"17715","230465 GRACA",1,4,4,166,0,175,"2013"
"17716","230470 GRANJA",5,8,15,653,3,684,"2013"
"17717","230480 GRANJEIRO",0,0,4,70,1,75,"2013"
"17718","230490 GROAIRAS",0,1,1,118,0,120,"2013"
"17719","230495 GUAIUBA",0,1,6,316,2,325,"2013"
"17720","230500 GUARACIABA DO NORTE",2,5,23,543,6,579,"2013"
"17721","230510 GUARAMIRANGA",0,0,3,72,1,76,"2013"
"17722","230520 HIDROLANDIA",3,0,3,225,0,231,"2013"
"17723","230523 HORIZONTE",3,1,23,994,4,1025,"2013"
"17724","230526 IBARETAMA",2,2,8,168,2,182,"2013"
"17725","230530 IBIAPINA",1,6,8,330,1,346,"2013"
"17726","230533 IBICUITINGA",0,0,2,194,1,197,"2013"
"17727","230535 ICAPUI",2,5,6,214,5,232,"2013"
"17728","230540 ICO",5,6,17,843,7,878,"2013"
"17729","230550 IGUATU",7,20,95,1140,3,1265,"2013"
"17730","230560 INDEPENDENCIA",0,1,2,251,8,262,"2013"
"17731","230565 IPAPORANGA",0,0,1,128,5,134,"2013"
"17732","230570 IPAUMIRIM",1,1,5,132,1,140,"2013"
"17733","230580 IPU",2,1,7,552,1,563,"2013"
"17734","230590 IPUEIRAS",0,3,19,440,8,470,"2013"
"17735","230600 IRACEMA",0,2,4,150,0,156,"2013"
"17736","230610 IRAUCUBA",2,1,2,307,0,312,"2013"
"17737","230620 ITAICABA",3,0,2,69,1,75,"2013"
"17738","230625 ITAITINGA",1,1,11,476,1,490,"2013"
"17739","230630 ITAPAGE",0,4,10,683,6,703,"2013"
"17740","230640 ITAPIPOCA",6,10,39,1920,13,1988,"2013"
"17741","230650 ITAPIUNA",2,0,8,218,2,230,"2013"
"17742","230655 ITAREMA",1,4,16,599,3,623,"2013"
"17743","230660 ITATIRA",1,1,8,247,2,259,"2013"
"17744","230670 JAGUARETAMA",0,1,6,180,1,188,"2013"
"17745","230680 JAGUARIBARA",1,0,4,137,0,142,"2013"
"17746","230690 JAGUARIBE",1,3,3,440,7,454,"2013"
"17747","230700 JAGUARUANA",0,0,9,408,2,419,"2013"
"17748","230710 JARDIM",2,0,6,433,12,453,"2013"
"17749","230720 JATI",0,0,3,103,0,106,"2013"
"17750","230725 JIJOCA DE JERICOACOARA",1,1,4,284,0,290,"2013"
"17751","230730 JUAZEIRO DO NORTE",16,35,156,3912,16,4135,"2013"
"17752","230740 JUCAS",2,4,13,302,1,322,"2013"
"17753","230750 LAVRAS DA MANGABEIRA",1,2,7,320,1,331,"2013"
"17754","230760 LIMOEIRO DO NORTE",5,4,25,750,1,785,"2013"
"17755","230763 MADALENA",1,0,7,196,1,205,"2013"
"17756","230765 MARACANAU",11,9,58,4020,14,4112,"2013"
"17757","230770 MARANGUAPE",2,1,19,1369,8,1399,"2013"
"17758","230780 MARCO",0,2,12,501,1,516,"2013"
"17759","230790 MARTINOPOLE",0,0,3,159,0,162,"2013"
"17760","230800 MASSAPE",0,2,9,533,2,546,"2013"
"17761","230810 MAURITI",1,7,4,661,5,678,"2013"
"17762","230820 MERUOCA",0,1,5,209,0,215,"2013"
"17763","230830 MILAGRES",0,2,7,401,2,412,"2013"
"17764","230835 MILHA",0,2,5,123,0,130,"2013"
"17765","230837 MIRAIMA",2,0,9,183,1,195,"2013"
"17766","230840 MISSAO VELHA",2,3,15,562,10,592,"2013"
"17767","230850 MOMBACA",3,1,22,434,0,460,"2013"
"17768","230860 MONSENHOR TABOSA",0,1,6,193,3,203,"2013"
"17769","230870 MORADA NOVA",3,2,6,673,2,686,"2013"
"17770","230880 MORAUJO",1,2,0,115,0,118,"2013"
"17771","230890 MORRINHOS",1,2,7,308,0,318,"2013"
"17772","230900 MUCAMBO",0,0,11,164,0,175,"2013"
"17773","230910 MULUNGU",1,2,4,127,0,134,"2013"
"17774","230920 NOVA OLINDA",1,2,11,246,2,262,"2013"
"17775","230930 NOVA RUSSAS",1,1,2,371,7,382,"2013"
"17776","230940 NOVO ORIENTE",1,3,5,333,17,359,"2013"
"17777","230945 OCARA",1,1,6,266,2,276,"2013"
"17778","230950 OROS",0,3,3,283,0,289,"2013"
"17779","230960 PACAJUS",4,6,24,936,3,973,"2013"
"17780","230970 PACATUBA",5,0,16,762,2,785,"2013"
"17781","230980 PACOTI",0,1,6,139,2,148,"2013"
"17782","230990 PACUJA",0,0,1,79,0,80,"2013"
"17783","231000 PALHANO",0,0,1,97,1,99,"2013"
"17784","231010 PALMACIA",0,1,1,101,0,103,"2013"
"17785","231020 PARACURU",1,3,8,624,3,639,"2013"
"17786","231025 PARAIPABA",1,0,5,423,0,429,"2013"
"17787","231030 PARAMBU",0,2,20,383,1,406,"2013"
"17788","231040 PARAMOTI",0,2,2,138,1,143,"2013"
"17789","231050 PEDRA BRANCA",1,3,9,524,3,540,"2013"
"17790","231060 PENAFORTE",0,0,4,174,0,178,"2013"
"17791","231070 PENTECOSTE",1,4,7,549,0,561,"2013"
"17792","231080 PEREIRO",0,2,4,194,0,200,"2013"
"17793","231085 PINDORETAMA",3,2,7,281,4,297,"2013"
"17794","231090 PIQUET CARNEIRO",0,3,11,142,0,156,"2013"
"17795","231095 PIRES FERREIRA",0,0,1,107,0,108,"2013"
"17796","231100 PORANGA",0,1,5,141,4,151,"2013"
"17797","231110 PORTEIRAS",1,2,8,256,1,268,"2013"
"17798","231120 POTENGI",0,2,7,143,1,153,"2013"
"17799","231123 POTIRETAMA",0,0,1,69,0,70,"2013"
"17800","231126 QUITERIANOPOLIS",1,1,4,212,12,230,"2013"
"17801","231130 QUIXADA",0,13,34,1132,10,1189,"2013"
"17802","231135 QUIXELO",2,2,13,166,2,185,"2013"
"17803","231140 QUIXERAMOBIM",3,9,62,934,3,1011,"2013"
"17804","231150 QUIXERE",0,2,7,241,2,252,"2013"
"17805","231160 REDENCAO",0,5,8,363,1,377,"2013"
"17806","231170 RERIUTABA",0,3,3,220,1,227,"2013"
"17807","231180 RUSSAS",2,9,17,916,3,947,"2013"
"17808","231190 SABOEIRO",2,2,13,186,3,206,"2013"
"17809","231195 SALITRE",1,1,11,294,1,308,"2013"
"17810","231200 SANTANA DO ACARAU",0,4,11,466,2,483,"2013"
"17811","231210 SANTANA DO CARIRI",0,2,8,262,1,273,"2013"
"17812","231220 SANTA QUITERIA",0,2,8,524,7,541,"2013"
"17813","231230 SAO BENEDITO",3,2,19,784,1,809,"2013"
"17814","231240 SAO GONCALO DO AMARANTE",4,7,13,757,3,784,"2013"
"17815","231250 SAO JOAO DO JAGUARIBE",0,0,0,64,0,64,"2013"
"17816","231260 SAO LUIS DO CURU",0,0,2,151,1,154,"2013"
"17817","231270 SENADOR POMPEU",0,2,8,286,1,297,"2013"
"17818","231280 SENADOR SA",0,0,5,102,1,108,"2013"
"17819","231290 SOBRAL",7,23,58,3168,13,3269,"2013"
"17820","231300 SOLONOPOLE",0,0,5,190,0,195,"2013"
"17821","231310 TABULEIRO DO NORTE",1,1,9,352,0,363,"2013"
"17822","231320 TAMBORIL",0,1,2,251,10,264,"2013"
"17823","231325 TARRAFAS",0,0,5,93,1,99,"2013"
"17824","231330 TAUA",4,7,28,687,4,730,"2013"
"17825","231335 TEJUCUOCA",2,1,3,258,2,266,"2013"
"17826","231340 TIANGUA",10,10,24,1225,9,1278,"2013"
"17827","231350 TRAIRI",3,0,15,662,3,683,"2013"
"17828","231355 TURURU",0,1,4,212,1,218,"2013"
"17829","231360 UBAJARA",2,1,13,533,3,552,"2013"
"17830","231370 UMARI",1,1,2,92,1,97,"2013"
"17831","231375 UMIRIM",0,4,5,296,2,307,"2013"
"17832","231380 URUBURETAMA",0,3,19,313,3,338,"2013"
"17833","231390 URUOCA",0,1,4,183,0,188,"2013"
"17834","231395 VARJOTA",0,6,9,271,0,286,"2013"
"17835","231400 VARZEA ALEGRE",1,4,22,483,2,512,"2013"
"17836","231410 VICOSA DO CEARA",4,3,13,896,8,924,"2013"
"17837","240010 ACARI",0,0,8,132,0,140,"2013"
"17838","240020 ACU",0,2,6,695,2,705,"2013"
"17839","240030 AFONSO BEZERRA",0,1,5,115,0,121,"2013"
"17840","240040 AGUA NOVA",0,0,0,44,0,44,"2013"
"17841","240050 ALEXANDRIA",0,2,1,180,0,183,"2013"
"17842","240060 ALMINO AFONSO",0,0,0,57,0,57,"2013"
"17843","240070 ALTO DO RODRIGUES",1,1,5,128,1,136,"2013"
"17844","240080 ANGICOS",0,1,1,136,1,139,"2013"
"17845","240090 ANTONIO MARTINS",0,0,1,77,1,79,"2013"
"17846","240100 APODI",1,3,2,439,1,446,"2013"
"17847","240110 AREIA BRANCA",0,2,5,339,5,351,"2013"
"17848","240120 ARES",2,1,7,188,2,200,"2013"
"17849","240130 AUGUSTO SEVERO",0,0,3,114,0,117,"2013"
"17850","240140 BAIA FORMOSA",2,1,1,103,2,109,"2013"
"17851","240145 BARAUNA",1,2,10,364,1,378,"2013"
"17852","240150 BARCELONA",0,0,2,47,2,51,"2013"
"17853","240160 BENTO FERNANDES",0,0,2,61,0,63,"2013"
"17854","240165 BODO",1,0,6,29,0,36,"2013"
"17855","240170 BOM JESUS",0,0,2,98,3,103,"2013"
"17856","240180 BREJINHO",1,1,4,142,2,150,"2013"
"17857","240185 CAICARA DO NORTE",2,0,1,72,0,75,"2013"
"17858","240190 CAICARA DO RIO DO VENTO",0,1,2,43,0,46,"2013"
"17859","240200 CAICO",2,2,36,690,1,731,"2013"
"17860","240210 CAMPO REDONDO",1,1,4,112,0,118,"2013"
"17861","240220 CANGUARETAMA",3,1,9,523,3,539,"2013"
"17862","240230 CARAUBAS",1,1,5,245,1,253,"2013"
"17863","240240 CARNAUBA DOS DANTAS",0,0,7,104,1,112,"2013"
"17864","240250 CARNAUBAIS",0,2,2,140,0,144,"2013"
"17865","240260 CEARA-MIRIM",7,1,20,1161,8,1197,"2013"
"17866","240270 CERRO CORA",0,2,10,119,0,131,"2013"
"17867","240280 CORONEL EZEQUIEL",0,1,2,67,1,71,"2013"
"17868","240290 CORONEL JOAO PESSOA",0,0,0,71,0,71,"2013"
"17869","240300 CRUZETA",0,0,5,93,0,98,"2013"
"17870","240310 CURRAIS NOVOS",1,3,30,503,8,545,"2013"
"17871","240320 DOUTOR SEVERIANO",1,1,1,99,0,102,"2013"
"17872","240325 PARNAMIRIM",6,11,60,3808,27,3912,"2013"
"17873","240330 ENCANTO",0,1,1,73,0,75,"2013"
"17874","240340 EQUADOR",0,0,3,77,0,80,"2013"
"17875","240350 ESPIRITO SANTO",1,1,4,99,2,107,"2013"
"17876","240360 EXTREMOZ",2,3,16,495,2,518,"2013"
"17877","240370 FELIPE GUERRA",0,0,0,47,1,48,"2013"
"17878","240375 FERNANDO PEDROZA",0,0,0,38,0,38,"2013"
"17879","240380 FLORANIA",0,0,9,112,2,123,"2013"
"17880","240390 FRANCISCO DANTAS",0,0,0,32,1,33,"2013"
"17881","240400 FRUTUOSO GOMES",0,0,1,36,0,37,"2013"
"17882","240410 GALINHOS",0,0,0,19,0,19,"2013"
"17883","240420 GOIANINHA",0,5,14,512,2,533,"2013"
"17884","240430 GOVERNADOR DIX-SEPT ROSADO",0,0,4,157,1,162,"2013"
"17885","240440 GROSSOS",0,1,2,115,1,119,"2013"
"17886","240450 GUAMARE",0,3,2,195,0,200,"2013"
"17887","240460 IELMO MARINHO",1,1,4,109,2,117,"2013"
"17888","240470 IPANGUACU",0,0,2,235,0,237,"2013"
"17889","240480 IPUEIRA",0,0,1,22,2,25,"2013"
"17890","240485 ITAJA",2,1,0,117,0,120,"2013"
"17891","240490 ITAU",0,0,1,63,0,64,"2013"
"17892","240500 JACANA",1,0,2,103,3,109,"2013"
"17893","240510 JANDAIRA",0,0,1,69,2,72,"2013"
"17894","240520 JANDUIS",0,0,1,71,0,72,"2013"
"17895","240530 JANUARIO CICCO",0,2,1,114,2,119,"2013"
"17896","240540 JAPI",0,1,6,99,1,107,"2013"
"17897","240550 JARDIM DE ANGICOS",0,0,2,32,1,35,"2013"
"17898","240560 JARDIM DE PIRANHAS",1,1,4,159,2,167,"2013"
"17899","240570 JARDIM DO SERIDO",0,0,0,107,0,107,"2013"
"17900","240580 JOAO CAMARA",3,2,8,476,4,493,"2013"
"17901","240590 JOAO DIAS",0,0,0,42,0,42,"2013"
"17902","240600 JOSE DA PENHA",1,0,1,82,0,84,"2013"
"17903","240610 JUCURUTU",0,0,6,245,2,253,"2013"
"17904","240615 JUNDIA",0,1,0,54,1,56,"2013"
"17905","240620 LAGOA D'ANTA",0,0,1,72,0,73,"2013"
"17906","240630 LAGOA DE PEDRAS",0,0,1,94,2,97,"2013"
"17907","240640 LAGOA DE VELHOS",0,0,1,35,0,36,"2013"
"17908","240650 LAGOA NOVA",0,0,8,194,2,204,"2013"
"17909","240660 LAGOA SALGADA",0,2,2,137,0,141,"2013"
"17910","240670 LAJES",1,0,3,90,4,98,"2013"
"17911","240680 LAJES PINTADAS",0,0,2,68,1,71,"2013"
"17912","240690 LUCRECIA",0,1,1,39,2,43,"2013"
"17913","240700 LUIS GOMES",0,2,2,130,0,134,"2013"
"17914","240710 MACAIBA",1,4,18,879,5,907,"2013"
"17915","240720 MACAU",1,1,0,174,0,176,"2013"
"17916","240725 MAJOR SALES",0,1,1,59,0,61,"2013"
"17917","240730 MARCELINO VIEIRA",0,0,1,80,0,81,"2013"
"17918","240740 MARTINS",1,0,2,87,0,90,"2013"
"17919","240750 MAXARANGUAPE",1,1,2,148,2,154,"2013"
"17920","240760 MESSIAS TARGINO",0,0,1,46,0,47,"2013"
"17921","240770 MONTANHAS",2,2,7,146,1,158,"2013"
"17922","240780 MONTE ALEGRE",0,5,9,285,1,300,"2013"
"17923","240790 MONTE DAS GAMELEIRAS",0,0,0,32,0,32,"2013"
"17924","240800 MOSSORO",11,20,85,3844,15,3975,"2013"
"17925","240810 NATAL",21,35,214,11527,43,11840,"2013"
"17926","240820 NISIA FLORESTA",1,2,11,330,5,349,"2013"
"17927","240830 NOVA CRUZ",1,5,8,460,5,479,"2013"
"17928","240840 OLHO-D'AGUA DO BORGES",1,0,0,36,0,37,"2013"
"17929","240850 OURO BRANCO",0,1,3,54,1,59,"2013"
"17930","240860 PARANA",0,0,0,54,0,54,"2013"
"17931","240870 PARAU",0,0,0,43,1,44,"2013"
"17932","240880 PARAZINHO",0,0,2,91,1,94,"2013"
"17933","240890 PARELHAS",1,1,3,320,0,325,"2013"
"17934","240895 RIO DO FOGO",0,0,4,154,2,160,"2013"
"17935","240910 PASSA E FICA",1,3,6,162,3,175,"2013"
"17936","240920 PASSAGEM",0,0,0,51,0,51,"2013"
"17937","240930 PATU",0,0,4,176,2,182,"2013"
"17938","240933 SANTA MARIA",0,1,1,42,0,44,"2013"
"17939","240940 PAU DOS FERROS",0,1,5,380,3,389,"2013"
"17940","240950 PEDRA GRANDE",0,0,0,52,2,54,"2013"
"17941","240960 PEDRA PRETA",0,0,0,24,1,25,"2013"
"17942","240970 PEDRO AVELINO",1,0,1,93,0,95,"2013"
"17943","240980 PEDRO VELHO",0,1,7,224,2,234,"2013"
"17944","240990 PENDENCIAS",0,0,1,90,0,91,"2013"
"17945","241000 PILOES",0,0,0,48,0,48,"2013"
"17946","241010 POCO BRANCO",1,1,3,140,1,146,"2013"
"17947","241020 PORTALEGRE",1,1,0,81,0,83,"2013"
"17948","241025 PORTO DO MANGUE",0,0,1,62,0,63,"2013"
"17949","241030 SERRA CAIADA",0,1,3,158,0,162,"2013"
"17950","241040 PUREZA",0,0,1,128,0,129,"2013"
"17951","241050 RAFAEL FERNANDES",0,1,0,64,0,65,"2013"
"17952","241060 RAFAEL GODEIRO",0,0,0,35,0,35,"2013"
"17953","241070 RIACHO DA CRUZ",0,0,0,42,0,42,"2013"
"17954","241080 RIACHO DE SANTANA",0,0,0,45,0,45,"2013"
"17955","241090 RIACHUELO",0,0,2,114,0,116,"2013"
"17956","241100 RODOLFO FERNANDES",1,1,0,65,0,67,"2013"
"17957","241105 TIBAU",0,0,5,62,0,67,"2013"
"17958","241110 RUY BARBOSA",0,0,3,37,1,41,"2013"
"17959","241120 SANTA CRUZ",3,1,5,574,3,586,"2013"
"17960","241140 SANTANA DO MATOS",0,2,1,144,0,147,"2013"
"17961","241142 SANTANA DO SERIDO",0,0,1,30,0,31,"2013"
"17962","241150 SANTO ANTONIO",0,2,13,313,2,330,"2013"
"17963","241160 SAO BENTO DO NORTE",0,0,0,41,0,41,"2013"
"17964","241170 SAO BENTO DO TRAIRI",1,0,1,71,1,74,"2013"
"17965","241180 SAO FERNANDO",0,1,1,26,0,28,"2013"
"17966","241190 SAO FRANCISCO DO OESTE",0,0,0,60,0,60,"2013"
"17967","241200 SAO GONCALO DO AMARANTE",7,6,15,1734,6,1768,"2013"
"17968","241210 SAO JOAO DO SABUGI",0,0,4,56,0,60,"2013"
"17969","241220 SAO JOSE DE MIPIBU",2,4,12,689,2,709,"2013"
"17970","241230 SAO JOSE DO CAMPESTRE",0,1,5,146,3,155,"2013"
"17971","241240 SAO JOSE DO SERIDO",0,2,4,43,0,49,"2013"
"17972","241250 SAO MIGUEL",1,1,2,268,0,272,"2013"
"17973","241255 SAO MIGUEL DO GOSTOSO",0,0,2,107,3,112,"2013"
"17974","241260 SAO PAULO DO POTENGI",0,1,6,205,5,217,"2013"
"17975","241270 SAO PEDRO",0,0,1,65,2,68,"2013"
"17976","241280 SAO RAFAEL",0,0,0,82,2,84,"2013"
"17977","241290 SAO TOME",1,0,3,128,1,133,"2013"
"17978","241300 SAO VICENTE",2,1,3,53,0,59,"2013"
"17979","241310 SENADOR ELOI DE SOUZA",1,1,0,69,0,71,"2013"
"17980","241320 SENADOR GEORGINO AVELINO",3,0,0,61,0,64,"2013"
"17981","241330 SERRA DE SAO BENTO",0,0,1,96,0,97,"2013"
"17982","241335 SERRA DO MEL",0,1,8,203,1,213,"2013"
"17983","241340 SERRA NEGRA DO NORTE",0,1,4,85,0,90,"2013"
"17984","241350 SERRINHA",0,0,1,106,0,107,"2013"
"17985","241355 SERRINHA DOS PINTOS",0,0,0,42,0,42,"2013"
"17986","241360 SEVERIANO MELO",0,0,2,55,0,57,"2013"
"17987","241370 SITIO NOVO",0,0,2,63,0,65,"2013"
"17988","241380 TABOLEIRO GRANDE",1,0,1,28,0,30,"2013"
"17989","241390 TAIPU",1,2,4,169,3,179,"2013"
"17990","241400 TANGARA",0,2,5,221,0,228,"2013"
"17991","241410 TENENTE ANANIAS",0,0,2,150,0,152,"2013"
"17992","241415 TENENTE LAURENTINO CRUZ",0,0,2,87,1,90,"2013"
"17993","241420 TIBAU DO SUL",1,1,5,176,0,183,"2013"
"17994","241430 TIMBAUBA DOS BATISTAS",0,0,0,30,0,30,"2013"
"17995","241440 TOUROS",3,1,8,471,7,490,"2013"
"17996","241445 TRIUNFO POTIGUAR",3,0,2,60,0,65,"2013"
"17997","241450 UMARIZAL",1,0,0,111,0,112,"2013"
"17998","241460 UPANEMA",0,1,2,189,2,194,"2013"
"17999","241470 VARZEA",0,0,3,59,0,62,"2013"
"18000","241475 VENHA-VER",0,0,0,51,0,51,"2013"
"18001","241480 VERA CRUZ",0,1,4,158,2,165,"2013"
"18002","241490 VICOSA",0,0,0,29,0,29,"2013"
"18003","241500 VILA FLOR",0,0,2,55,0,57,"2013"
"18004","250010 AGUA BRANCA",0,3,2,83,0,88,"2013"
"18005","250020 AGUIAR",0,0,0,44,10,54,"2013"
"18006","250030 ALAGOA GRANDE",1,3,9,387,5,405,"2013"
"18007","250040 ALAGOA NOVA",0,2,6,320,1,329,"2013"
"18008","250050 ALAGOINHA",1,0,5,221,3,230,"2013"
"18009","250053 ALCANTIL",1,0,1,85,1,88,"2013"
"18010","250057 ALGODAO DE JANDAIRA",0,0,0,39,0,39,"2013"
"18011","250060 ALHANDRA",1,0,5,374,1,381,"2013"
"18012","250070 SAO JOAO DO RIO DO PEIXE",0,2,3,182,0,187,"2013"
"18013","250073 AMPARO",0,0,0,35,0,35,"2013"
"18014","250077 APARECIDA",0,1,2,97,1,101,"2013"
"18015","250080 ARACAGI",2,1,5,190,2,200,"2013"
"18016","250090 ARARA",0,0,4,147,0,151,"2013"
"18017","250100 ARARUNA",1,3,8,252,1,265,"2013"
"18018","250110 AREIA",2,3,10,345,2,362,"2013"
"18019","250115 AREIA DE BARAUNAS",0,0,0,32,1,33,"2013"
"18020","250120 AREIAL",0,0,1,96,0,97,"2013"
"18021","250130 AROEIRAS",0,2,2,280,4,288,"2013"
"18022","250135 ASSUNCAO",0,0,0,67,0,67,"2013"
"18023","250140 BAIA DA TRAICAO",1,0,3,140,2,146,"2013"
"18024","250150 BANANEIRAS",0,3,7,273,0,283,"2013"
"18025","250153 BARAUNA",0,0,0,65,0,65,"2013"
"18026","250157 BARRA DE SANTANA",0,0,2,101,2,105,"2013"
"18027","250160 BARRA DE SANTA ROSA",0,0,2,167,1,170,"2013"
"18028","250170 BARRA DE SAO MIGUEL",0,0,3,83,0,86,"2013"
"18029","250180 BAYEUX",3,6,28,1354,4,1395,"2013"
"18030","250190 BELEM",0,3,9,225,3,240,"2013"
"18031","250200 BELEM DO BREJO DO CRUZ",0,2,0,102,0,104,"2013"
"18032","250205 BERNARDINO BATISTA",0,0,2,44,1,47,"2013"
"18033","250210 BOA VENTURA",0,0,0,49,1,50,"2013"
"18034","250215 BOA VISTA",0,0,0,85,0,85,"2013"
"18035","250220 BOM JESUS",0,1,1,36,0,38,"2013"
"18036","250230 BOM SUCESSO",0,0,0,45,0,45,"2013"
"18037","250240 BONITO DE SANTA FE",0,4,6,142,3,155,"2013"
"18038","250250 BOQUEIRAO",0,1,0,252,1,254,"2013"
"18039","250260 IGARACY",0,0,2,60,6,68,"2013"
"18040","250270 BORBOREMA",0,0,3,66,2,71,"2013"
"18041","250280 BREJO DO CRUZ",0,1,3,150,1,155,"2013"
"18042","250290 BREJO DOS SANTOS",1,0,0,75,0,76,"2013"
"18043","250300 CAAPORA",1,3,11,425,3,443,"2013"
"18044","250310 CABACEIRAS",0,0,0,70,0,70,"2013"
"18045","250320 CABEDELO",2,1,9,947,6,965,"2013"
"18046","250330 CACHOEIRA DOS INDIOS",1,1,4,129,0,135,"2013"
"18047","250340 CACIMBA DE AREIA",0,0,2,39,0,41,"2013"
"18048","250350 CACIMBA DE DENTRO",0,2,3,203,0,208,"2013"
"18049","250355 CACIMBAS",2,2,5,110,14,133,"2013"
"18050","250360 CAICARA",0,1,2,102,0,105,"2013"
"18051","250370 CAJAZEIRAS",2,4,23,863,0,892,"2013"
"18052","250375 CAJAZEIRINHAS",0,0,2,55,1,58,"2013"
"18053","250380 CALDAS BRANDAO",0,2,2,82,1,87,"2013"
"18054","250390 CAMALAU",0,1,2,82,0,85,"2013"
"18055","250400 CAMPINA GRANDE",9,18,87,5952,32,6098,"2013"
"18056","250403 CAPIM",0,1,1,102,1,105,"2013"
"18057","250407 CARAUBAS",0,0,1,58,0,59,"2013"
"18058","250410 CARRAPATEIRA",0,0,0,22,0,22,"2013"
"18059","250415 CASSERENGUE",0,1,2,77,1,81,"2013"
"18060","250420 CATINGUEIRA",1,1,1,56,2,61,"2013"
"18061","250430 CATOLE DO ROCHA",2,1,3,385,3,394,"2013"
"18062","250435 CATURITE",1,0,1,75,1,78,"2013"
"18063","250440 CONCEICAO",1,3,4,234,12,254,"2013"
"18064","250450 CONDADO",0,2,1,77,0,80,"2013"
"18065","250460 CONDE",0,3,7,477,2,489,"2013"
"18066","250470 CONGO",0,0,1,86,1,88,"2013"
"18067","250480 COREMAS",1,0,2,146,41,190,"2013"
"18068","250485 COXIXOLA",0,0,1,13,0,14,"2013"
"18069","250490 CRUZ DO ESPIRITO SANTO",0,2,3,279,0,284,"2013"
"18070","250500 CUBATI",0,2,1,99,0,102,"2013"
"18071","250510 CUITE",1,2,0,249,3,255,"2013"
"18072","250520 CUITEGI",0,2,3,103,1,109,"2013"
"18073","250523 CUITE DE MAMANGUAPE",1,2,0,80,1,84,"2013"
"18074","250527 CURRAL DE CIMA",0,0,0,76,0,76,"2013"
"18075","250530 CURRAL VELHO",0,0,0,32,0,32,"2013"
"18076","250535 DAMIAO",0,0,1,65,0,66,"2013"
"18077","250540 DESTERRO",0,0,4,109,2,115,"2013"
"18078","250550 VISTA SERRANA",0,0,3,39,1,43,"2013"
"18079","250560 DIAMANTE",0,0,2,69,1,72,"2013"
"18080","250570 DONA INES",0,0,4,129,0,133,"2013"
"18081","250580 DUAS ESTRADAS",0,0,0,52,0,52,"2013"
"18082","250590 EMAS",0,1,1,34,0,36,"2013"
"18083","250600 ESPERANCA",1,2,9,502,0,514,"2013"
"18084","250610 FAGUNDES",0,4,3,181,2,190,"2013"
"18085","250620 FREI MARTINHO",0,0,1,31,0,32,"2013"
"18086","250625 GADO BRAVO",1,0,1,124,0,126,"2013"
"18087","250630 GUARABIRA",1,3,15,895,1,915,"2013"
"18088","250640 GURINHEM",1,0,6,197,10,214,"2013"
"18089","250650 GURJAO",0,0,2,31,0,33,"2013"
"18090","250660 IBIARA",1,1,1,63,1,67,"2013"
"18091","250670 IMACULADA",1,1,3,126,9,140,"2013"
"18092","250680 INGA",0,3,5,275,0,283,"2013"
"18093","250690 ITABAIANA",2,1,8,311,11,333,"2013"
"18094","250700 ITAPORANGA",2,2,9,307,19,339,"2013"
"18095","250710 ITAPOROROCA",1,0,4,236,3,244,"2013"
"18096","250720 ITATUBA",0,1,3,159,3,166,"2013"
"18097","250730 JACARAU",1,2,4,202,4,213,"2013"
"18098","250740 JERICO",0,2,1,93,1,97,"2013"
"18099","250750 JOAO PESSOA",25,57,147,11298,22,11549,"2013"
"18100","250760 JUAREZ TAVORA",0,1,1,110,2,114,"2013"
"18101","250770 JUAZEIRINHO",0,1,9,289,1,300,"2013"
"18102","250780 JUNCO DO SERIDO",0,0,1,111,0,112,"2013"
"18103","250790 JURIPIRANGA",1,0,3,176,8,188,"2013"
"18104","250800 JURU",2,1,4,111,0,118,"2013"
"18105","250810 LAGOA",0,0,0,61,0,61,"2013"
"18106","250820 LAGOA DE DENTRO",0,1,2,104,3,110,"2013"
"18107","250830 LAGOA SECA",1,0,6,422,3,432,"2013"
"18108","250840 LASTRO",0,0,0,45,0,45,"2013"
"18109","250850 LIVRAMENTO",0,0,2,81,3,86,"2013"
"18110","250855 LOGRADOURO",0,0,1,45,0,46,"2013"
"18111","250860 LUCENA",1,1,6,204,2,214,"2013"
"18112","250870 MAE D'AGUA",0,0,0,43,0,43,"2013"
"18113","250880 MALTA",1,1,3,78,3,86,"2013"
"18114","250890 MAMANGUAPE",2,6,11,688,4,711,"2013"
"18115","250900 MANAIRA",0,3,4,162,0,169,"2013"
"18116","250905 MARCACAO",0,1,1,156,2,160,"2013"
"18117","250910 MARI",0,1,8,268,0,277,"2013"
"18118","250915 MARIZOPOLIS",0,0,0,98,0,98,"2013"
"18119","250920 MASSARANDUBA",0,0,4,196,2,202,"2013"
"18120","250930 MATARACA",1,0,5,132,1,139,"2013"
"18121","250933 MATINHAS",0,0,2,51,1,54,"2013"
"18122","250937 MATO GROSSO",1,1,1,20,0,23,"2013"
"18123","250939 MATUREIA",0,2,1,76,4,83,"2013"
"18124","250940 MOGEIRO",2,0,1,170,6,179,"2013"
"18125","250950 MONTADAS",0,1,1,90,2,94,"2013"
"18126","250960 MONTE HOREBE",1,0,2,64,0,67,"2013"
"18127","250970 MONTEIRO",0,2,4,485,0,491,"2013"
"18128","250980 MULUNGU",0,0,1,131,5,137,"2013"
"18129","250990 NATUBA",0,1,3,87,2,93,"2013"
"18130","251000 NAZAREZINHO",1,0,2,103,0,106,"2013"
"18131","251010 NOVA FLORESTA",0,3,1,143,0,147,"2013"
"18132","251020 NOVA OLINDA",0,0,3,58,15,76,"2013"
"18133","251030 NOVA PALMEIRA",0,0,0,43,0,43,"2013"
"18134","251040 OLHO D'AGUA",0,4,3,84,7,98,"2013"
"18135","251050 OLIVEDOS",0,0,0,50,0,50,"2013"
"18136","251060 OURO VELHO",0,0,1,38,0,39,"2013"
"18137","251065 PARARI",0,0,0,30,0,30,"2013"
"18138","251070 PASSAGEM",0,0,1,39,1,41,"2013"
"18139","251080 PATOS",5,16,39,1420,26,1506,"2013"
"18140","251090 PAULISTA",0,0,3,129,2,134,"2013"
"18141","251100 PEDRA BRANCA",0,3,2,31,1,37,"2013"
"18142","251110 PEDRA LAVRADA",1,0,3,101,0,105,"2013"
"18143","251120 PEDRAS DE FOGO",2,3,10,436,6,457,"2013"
"18144","251130 PIANCO",0,0,4,171,26,201,"2013"
"18145","251140 PICUI",0,1,4,258,0,263,"2013"
"18146","251150 PILAR",0,2,5,173,2,182,"2013"
"18147","251160 PILOES",1,2,4,132,1,140,"2013"
"18148","251170 PILOEZINHOS",0,1,2,73,1,77,"2013"
"18149","251180 PIRPIRITUBA",0,0,3,125,0,128,"2013"
"18150","251190 PITIMBU",0,0,3,285,4,292,"2013"
"18151","251200 POCINHOS",0,1,2,276,2,281,"2013"
"18152","251203 POCO DANTAS",0,2,3,57,1,63,"2013"
"18153","251207 POCO DE JOSE DE MOURA",0,1,2,41,1,45,"2013"
"18154","251210 POMBAL",0,1,5,434,9,449,"2013"
"18155","251220 PRATA",0,0,1,53,0,54,"2013"
"18156","251230 PRINCESA ISABEL",4,0,11,274,4,293,"2013"
"18157","251240 PUXINANA",1,0,4,199,1,205,"2013"
"18158","251250 QUEIMADAS",1,6,9,610,5,631,"2013"
"18159","251260 QUIXABA",0,1,1,20,0,22,"2013"
"18160","251270 REMIGIO",0,2,7,274,1,284,"2013"
"18161","251272 PEDRO REGIS",1,0,1,64,3,69,"2013"
"18162","251274 RIACHAO",0,0,0,54,0,54,"2013"
"18163","251275 RIACHAO DO BACAMARTE",1,0,2,60,1,64,"2013"
"18164","251276 RIACHAO DO POCO",0,2,3,56,1,62,"2013"
"18165","251278 RIACHO DE SANTO ANTONIO",0,0,0,43,0,43,"2013"
"18166","251280 RIACHO DOS CAVALOS",0,0,0,99,0,99,"2013"
"18167","251290 RIO TINTO",2,0,9,313,4,328,"2013"
"18168","251300 SALGADINHO",0,0,1,41,0,42,"2013"
"18169","251310 SALGADO DE SAO FELIX",1,3,1,102,2,109,"2013"
"18170","251315 SANTA CECILIA",0,0,2,85,0,87,"2013"
"18171","251320 SANTA CRUZ",1,0,1,65,0,67,"2013"
"18172","251330 SANTA HELENA",0,0,1,62,0,63,"2013"
"18173","251335 SANTA INES",0,0,3,51,1,55,"2013"
"18174","251340 SANTA LUZIA",2,2,2,199,1,206,"2013"
"18175","251350 SANTANA DE MANGUEIRA",0,0,1,58,1,60,"2013"
"18176","251360 SANTANA DOS GARROTES",0,1,2,67,3,73,"2013"
"18177","251365 JOCA CLAUDINO",0,0,0,32,0,32,"2013"
"18178","251370 SANTA RITA",1,10,54,2162,4,2231,"2013"
"18179","251380 SANTA TERESINHA",0,1,3,38,2,44,"2013"
"18180","251385 SANTO ANDRE",0,0,0,27,0,27,"2013"
"18181","251390 SAO BENTO",2,3,1,428,2,436,"2013"
"18182","251392 SAO BENTINHO",0,2,1,48,2,53,"2013"
"18183","251394 SAO DOMINGOS DO CARIRI",0,0,0,37,0,37,"2013"
"18184","251396 SAO DOMINGOS",0,0,0,36,1,37,"2013"
"18185","251398 SAO FRANCISCO",0,1,0,50,0,51,"2013"
"18186","251400 SAO JOAO DO CARIRI",0,0,3,47,1,51,"2013"
"18187","251410 SAO JOAO DO TIGRE",0,1,2,45,4,52,"2013"
"18188","251420 SAO JOSE DA LAGOA TAPADA",0,0,1,86,0,87,"2013"
"18189","251430 SAO JOSE DE CAIANA",1,1,1,95,7,105,"2013"
"18190","251440 SAO JOSE DE ESPINHARAS",0,0,2,45,5,52,"2013"
"18191","251445 SAO JOSE DOS RAMOS",0,2,2,63,1,68,"2013"
"18192","251450 SAO JOSE DE PIRANHAS",0,1,5,243,3,252,"2013"
"18193","251455 SAO JOSE DE PRINCESA",0,0,1,33,1,35,"2013"
"18194","251460 SAO JOSE DO BONFIM",0,0,2,54,3,59,"2013"
"18195","251465 SAO JOSE DO BREJO DO CRUZ",0,1,1,21,0,23,"2013"
"18196","251470 SAO JOSE DO SABUGI",1,0,1,36,1,39,"2013"
"18197","251480 SAO JOSE DOS CORDEIROS",0,0,2,46,0,48,"2013"
"18198","251490 SAO MAMEDE",0,0,7,83,3,93,"2013"
"18199","251500 SAO MIGUEL DE TAIPU",1,0,2,87,0,90,"2013"
"18200","251510 SAO SEBASTIAO DE LAGOA DE ROCA",0,0,3,162,2,167,"2013"
"18201","251520 SAO SEBASTIAO DO UMBUZEIRO",0,0,0,44,0,44,"2013"
"18202","251530 SAPE",0,3,14,712,2,731,"2013"
"18203","251540 SAO VICENTE DO SERIDO",0,2,2,160,3,167,"2013"
"18204","251550 SERRA BRANCA",0,0,2,139,2,143,"2013"
"18205","251560 SERRA DA RAIZ",0,1,2,32,0,35,"2013"
"18206","251570 SERRA GRANDE",0,0,0,30,0,30,"2013"
"18207","251580 SERRA REDONDA",0,0,2,104,1,107,"2013"
"18208","251590 SERRARIA",0,0,6,52,1,59,"2013"
"18209","251593 SERTAOZINHO",0,0,1,71,0,72,"2013"
"18210","251597 SOBRADO",0,0,1,96,0,97,"2013"
"18211","251600 SOLANEA",1,1,21,365,4,392,"2013"
"18212","251610 SOLEDADE",0,1,3,217,2,223,"2013"
"18213","251615 SOSSEGO",1,1,2,52,0,56,"2013"
"18214","251620 SOUSA",2,2,14,916,6,940,"2013"
"18215","251630 SUME",0,0,5,221,0,226,"2013"
"18216","251640 TACIMA",0,0,2,101,1,104,"2013"
"18217","251650 TAPEROA",1,4,1,207,1,214,"2013"
"18218","251660 TAVARES",0,1,5,185,1,192,"2013"
"18219","251670 TEIXEIRA",1,3,6,183,5,198,"2013"
"18220","251675 TENORIO",0,1,2,39,0,42,"2013"
"18221","251680 TRIUNFO",0,2,2,103,1,108,"2013"
"18222","251690 UIRAUNA",0,2,7,175,2,186,"2013"
"18223","251700 UMBUZEIRO",0,0,1,119,0,120,"2013"
"18224","251710 VARZEA",0,0,0,35,0,35,"2013"
"18225","251720 VIEIROPOLIS",0,0,0,45,0,45,"2013"
"18226","251740 ZABELE",1,0,0,39,0,40,"2013"
"18227","MUNICIPIO IGNORADO - PE",0,0,0,2,0,2,"2013"
"18228","260005 ABREU E LIMA",3,8,13,1498,10,1532,"2013"
"18229","260010 AFOGADOS DA INGAZEIRA",3,2,5,626,2,638,"2013"
"18230","260020 AFRANIO",0,0,3,135,159,297,"2013"
"18231","260030 AGRESTINA",3,0,2,351,6,362,"2013"
"18232","260040 AGUA PRETA",3,2,6,479,1,491,"2013"
"18233","260050 AGUAS BELAS",2,1,9,770,12,794,"2013"
"18234","260060 ALAGOINHA",0,1,5,174,0,180,"2013"
"18235","260070 ALIANCA",5,1,9,518,5,538,"2013"
"18236","260080 ALTINHO",1,1,9,258,0,269,"2013"
"18237","260090 AMARAJI",4,2,7,323,4,340,"2013"
"18238","260100 ANGELIM",4,0,4,154,1,163,"2013"
"18239","260105 ARACOIABA",1,2,5,342,6,356,"2013"
"18240","260110 ARARIPINA",3,11,18,1475,9,1516,"2013"
"18241","260120 ARCOVERDE",2,7,33,1107,4,1153,"2013"
"18242","260130 BARRA DE GUABIRABA",0,2,3,174,1,180,"2013"
"18243","260140 BARREIROS",4,5,10,845,3,867,"2013"
"18244","260150 BELEM DE MARIA",1,0,0,139,0,140,"2013"
"18245","260160 BELEM DE SAO FRANCISCO",2,1,7,315,5,330,"2013"
"18246","260170 BELO JARDIM",5,9,20,1143,4,1181,"2013"
"18247","260180 BETANIA",2,4,5,166,11,188,"2013"
"18248","260190 BEZERROS",3,3,7,744,5,762,"2013"
"18249","260200 BODOCO",5,4,5,514,3,531,"2013"
"18250","260210 BOM CONSELHO",3,7,11,656,6,683,"2013"
"18251","260220 BOM JARDIM",1,2,7,464,0,474,"2013"
"18252","260230 BONITO",4,7,4,592,0,607,"2013"
"18253","260240 BREJAO",1,1,0,176,0,178,"2013"
"18254","260250 BREJINHO",0,0,1,124,0,125,"2013"
"18255","260260 BREJO DA MADRE DE DEUS",1,3,10,726,4,744,"2013"
"18256","260270 BUENOS AIRES",0,1,1,187,0,189,"2013"
"18257","260280 BUIQUE",1,0,23,824,4,852,"2013"
"18258","260290 CABO DE SANTO AGOSTINHO",13,13,77,3293,23,3419,"2013"
"18259","260300 CABROBO",2,6,11,501,2,522,"2013"
"18260","260310 CACHOEIRINHA",2,2,12,256,0,272,"2013"
"18261","260320 CAETES",1,1,7,386,1,396,"2013"
"18262","260330 CALCADO",0,2,2,135,0,139,"2013"
"18263","260340 CALUMBI",0,1,2,89,12,104,"2013"
"18264","260345 CAMARAGIBE",2,14,43,2284,15,2358,"2013"
"18265","260350 CAMOCIM DE SAO FELIX",1,1,2,236,0,240,"2013"
"18266","260360 CAMUTANGA",0,0,5,96,1,102,"2013"
"18267","260370 CANHOTINHO",0,2,4,393,1,400,"2013"
"18268","260380 CAPOEIRAS",2,1,2,295,2,302,"2013"
"18269","260390 CARNAIBA",0,0,2,263,2,267,"2013"
"18270","260392 CARNAUBEIRA DA PENHA",0,0,6,283,3,292,"2013"
"18271","260400 CARPINA",2,5,11,1075,10,1103,"2013"
"18272","260410 CARUARU",22,20,58,5584,27,5711,"2013"
"18273","260415 CASINHAS",0,0,5,191,1,197,"2013"
"18274","260420 CATENDE",3,2,6,575,2,588,"2013"
"18275","260430 CEDRO",1,0,2,171,2,176,"2013"
"18276","260440 CHA DE ALEGRIA",1,1,2,218,1,223,"2013"
"18277","260450 CHA GRANDE",1,0,4,285,2,292,"2013"
"18278","260460 CONDADO",1,3,8,364,0,376,"2013"
"18279","260470 CORRENTES",1,2,3,218,0,224,"2013"
"18280","260480 CORTES",2,0,1,217,0,220,"2013"
"18281","260490 CUMARU",1,2,7,198,1,209,"2013"
"18282","260500 CUPIRA",2,3,4,335,0,344,"2013"
"18283","260510 CUSTODIA",2,4,5,602,3,616,"2013"
"18284","260515 DORMENTES",0,2,5,187,91,285,"2013"
"18285","260520 ESCADA",5,5,19,1511,8,1548,"2013"
"18286","260530 EXU",1,3,6,503,8,521,"2013"
"18287","260540 FEIRA NOVA",0,1,16,262,9,288,"2013"
"18288","260545 FERNANDO DE NORONHA",0,0,1,15,0,16,"2013"
"18289","260550 FERREIROS",0,0,3,148,0,151,"2013"
"18290","260560 FLORES",1,0,5,252,6,264,"2013"
"18291","260570 FLORESTA",2,6,13,453,6,480,"2013"
"18292","260580 FREI MIGUELINHO",0,1,3,138,1,143,"2013"
"18293","260590 GAMELEIRA",2,0,8,408,2,420,"2013"
"18294","260600 GARANHUNS",9,12,24,2307,3,2355,"2013"
"18295","260610 GLORIA DO GOITA",1,1,5,384,3,394,"2013"
"18296","260620 GOIANA",8,8,16,1198,7,1237,"2013"
"18297","260630 GRANITO",0,0,2,76,14,92,"2013"
"18298","260640 GRAVATA",1,2,9,1107,14,1133,"2013"
"18299","260650 IATI",1,0,2,298,2,303,"2013"
"18300","260660 IBIMIRIM",0,5,6,416,5,432,"2013"
"18301","260670 IBIRAJUBA",0,1,2,97,2,102,"2013"
"18302","260680 IGARASSU",8,8,21,1587,11,1635,"2013"
"18303","260690 IGUARACY",0,1,2,142,0,145,"2013"
"18304","260700 INAJA",3,3,8,318,20,352,"2013"
"18305","260710 INGAZEIRA",2,1,0,47,0,50,"2013"
"18306","260720 IPOJUCA",6,8,31,1547,7,1599,"2013"
"18307","260730 IPUBI",1,3,9,501,0,514,"2013"
"18308","260740 ITACURUBA",1,2,2,84,0,89,"2013"
"18309","260750 ITAIBA",2,3,2,344,6,357,"2013"
"18310","260760 ILHA DE ITAMARACA",0,1,6,312,7,326,"2013"
"18311","260765 ITAMBE",0,5,7,421,2,435,"2013"
"18312","260770 ITAPETIM",1,1,2,190,0,194,"2013"
"18313","260775 ITAPISSUMA",0,3,1,347,9,360,"2013"
"18314","260780 ITAQUITINGA",2,0,5,241,1,249,"2013"
"18315","260790 JABOATAO DOS GUARARAPES",30,53,140,9440,48,9711,"2013"
"18316","260795 JAQUEIRA",0,0,1,167,1,169,"2013"
"18317","260800 JATAUBA",1,2,5,269,2,279,"2013"
"18318","260805 JATOBA",1,3,4,224,2,234,"2013"
"18319","260810 JOAO ALFREDO",2,2,1,366,4,375,"2013"
"18320","260820 JOAQUIM NABUCO",2,1,3,259,0,265,"2013"
"18321","260825 JUCATI",1,0,3,166,0,170,"2013"
"18322","260830 JUPI",3,2,8,261,0,274,"2013"
"18323","260840 JUREMA",1,0,6,215,0,222,"2013"
"18324","260845 LAGOA DO CARRO",1,1,2,234,2,240,"2013"
"18325","260850 LAGOA DE ITAENGA",1,4,7,358,2,372,"2013"
"18326","260860 LAGOA DO OURO",0,0,0,172,0,172,"2013"
"18327","260870 LAGOA DOS GATOS",1,2,4,208,1,216,"2013"
"18328","260875 LAGOA GRANDE",4,1,12,359,5,381,"2013"
"18329","260880 LAJEDO",1,2,14,645,7,669,"2013"
"18330","260890 LIMOEIRO",3,2,12,776,2,795,"2013"
"18331","260900 MACAPARANA",1,1,11,378,2,393,"2013"
"18332","260910 MACHADOS",1,0,4,166,2,173,"2013"
"18333","260915 MANARI",2,2,5,247,19,275,"2013"
"18334","260920 MARAIAL",2,0,2,216,0,220,"2013"
"18335","260930 MIRANDIBA",3,1,7,279,0,290,"2013"
"18336","260940 MORENO",1,2,14,795,3,815,"2013"
"18337","260950 NAZARE DA MATA",2,2,16,432,4,456,"2013"
"18338","260960 OLINDA",23,29,89,5861,17,6019,"2013"
"18339","260970 OROBO",1,2,5,280,1,289,"2013"
"18340","260980 OROCO",2,2,5,265,2,276,"2013"
"18341","260990 OURICURI",8,6,16,1080,17,1127,"2013"
"18342","261000 PALMARES",5,2,7,1151,0,1165,"2013"
"18343","261010 PALMEIRINA",0,2,2,117,2,123,"2013"
"18344","261020 PANELAS",1,1,2,363,3,370,"2013"
"18345","261030 PARANATAMA",1,1,2,199,0,203,"2013"
"18346","261040 PARNAMIRIM",2,0,5,296,2,305,"2013"
"18347","261050 PASSIRA",0,1,3,425,12,441,"2013"
"18348","261060 PAUDALHO",5,5,13,826,10,859,"2013"
"18349","261070 PAULISTA",7,19,67,4023,18,4134,"2013"
"18350","261080 PEDRA",0,3,1,319,3,326,"2013"
"18351","261090 PESQUEIRA",3,6,18,948,6,981,"2013"
"18352","261100 PETROLANDIA",2,4,14,698,1,719,"2013"
"18353","261110 PETROLINA",49,43,143,5696,94,6025,"2013"
"18354","261120 POCAO",0,4,3,159,2,168,"2013"
"18355","261130 POMBOS",1,0,4,412,0,417,"2013"
"18356","261140 PRIMAVERA",0,0,3,187,1,191,"2013"
"18357","261150 QUIPAPA",1,3,3,334,1,342,"2013"
"18358","261153 QUIXABA",0,0,0,95,0,95,"2013"
"18359","261160 RECIFE",75,96,321,22572,112,23176,"2013"
"18360","261170 RIACHO DAS ALMAS",0,0,3,272,2,277,"2013"
"18361","261180 RIBEIRAO",1,3,12,765,5,786,"2013"
"18362","261190 RIO FORMOSO",2,3,8,401,1,415,"2013"
"18363","261200 SAIRE",1,1,1,131,1,135,"2013"
"18364","261210 SALGADINHO",1,0,0,89,1,91,"2013"
"18365","261220 SALGUEIRO",4,3,12,1014,2,1035,"2013"
"18366","261230 SALOA",2,2,5,203,1,213,"2013"
"18367","261240 SANHARO",0,4,7,303,0,314,"2013"
"18368","261245 SANTA CRUZ",0,3,7,221,0,231,"2013"
"18369","261247 SANTA CRUZ DA BAIXA VERDE",0,3,10,147,16,176,"2013"
"18370","261250 SANTA CRUZ DO CAPIBARIBE",3,5,13,1383,1,1405,"2013"
"18371","261255 SANTA FILOMENA",0,3,3,155,14,175,"2013"
"18372","261260 SANTA MARIA DA BOA VISTA",3,5,17,655,16,696,"2013"
"18373","261270 SANTA MARIA DO CAMBUCA",0,0,6,202,1,209,"2013"
"18374","261280 SANTA TEREZINHA",1,0,2,145,4,152,"2013"
"18375","261290 SAO BENEDITO DO SUL",1,0,4,184,1,190,"2013"
"18376","261300 SAO BENTO DO UNA",7,2,12,736,5,762,"2013"
"18377","261310 SAO CAITANO",2,0,8,532,2,544,"2013"
"18378","261320 SAO JOAO",0,0,7,348,0,355,"2013"
"18379","261330 SAO JOAQUIM DO MONTE",2,2,4,334,1,343,"2013"
"18380","261340 SAO JOSE DA COROA GRANDE",0,1,8,330,3,342,"2013"
"18381","261350 SAO JOSE DO BELMONTE",0,3,8,544,1,556,"2013"
"18382","261360 SAO JOSE DO EGITO",0,3,7,393,1,404,"2013"
"18383","261370 SAO LOURENCO DA MATA",16,6,21,1645,11,1699,"2013"
"18384","261380 SAO VICENTE FERRER",0,2,1,231,1,235,"2013"
"18385","261390 SERRA TALHADA",8,5,49,1218,125,1405,"2013"
"18386","261400 SERRITA",2,0,5,272,1,280,"2013"
"18387","261410 SERTANIA",2,2,9,443,0,456,"2013"
"18388","261420 SIRINHAEM",4,2,14,802,1,823,"2013"
"18389","261430 MOREILANDIA",0,0,2,158,2,162,"2013"
"18390","261440 SOLIDAO",0,0,0,95,1,96,"2013"
"18391","261450 SURUBIM",1,2,9,890,4,906,"2013"
"18392","261460 TABIRA",2,1,13,460,3,479,"2013"
"18393","261470 TACAIMBO",1,0,2,173,2,178,"2013"
"18394","261480 TACARATU",1,0,8,318,2,329,"2013"
"18395","261485 TAMANDARE",3,0,7,351,3,364,"2013"
"18396","261500 TAQUARITINGA DO NORTE",2,1,6,334,2,345,"2013"
"18397","261510 TEREZINHA",0,0,2,116,1,119,"2013"
"18398","261520 TERRA NOVA",0,3,4,142,0,149,"2013"
"18399","261530 TIMBAUBA",2,8,11,760,8,789,"2013"
"18400","261540 TORITAMA",2,5,6,632,2,647,"2013"
"18401","261550 TRACUNHAEM",0,1,4,219,7,231,"2013"
"18402","261560 TRINDADE",4,5,17,585,1,612,"2013"
"18403","261570 TRIUNFO",1,0,6,165,13,185,"2013"
"18404","261580 TUPANATINGA",2,4,5,310,1,322,"2013"
"18405","261590 TUPARETAMA",0,1,3,117,0,121,"2013"
"18406","261600 VENTUROSA",0,2,1,272,0,275,"2013"
"18407","261610 VERDEJANTE",1,0,5,144,0,150,"2013"
"18408","261618 VERTENTE DO LERIO",0,0,0,114,0,114,"2013"
"18409","261620 VERTENTES",1,0,2,334,0,337,"2013"
"18410","261630 VICENCIA",1,3,11,392,4,411,"2013"
"18411","261640 VITORIA DE SANTO ANTAO",7,9,30,1949,4,1999,"2013"
"18412","261650 XEXEU",5,0,3,281,0,289,"2013"
"18413","270010 AGUA BRANCA",0,3,13,142,178,336,"2013"
"18414","270020 ANADIA",0,1,6,230,6,243,"2013"
"18415","270030 ARAPIRACA",8,16,59,3679,22,3784,"2013"
"18416","270040 ATALAIA",2,3,11,591,221,828,"2013"
"18417","270050 BARRA DE SANTO ANTONIO",0,3,3,289,5,300,"2013"
"18418","270060 BARRA DE SAO MIGUEL",0,1,1,136,2,140,"2013"
"18419","270070 BATALHA",1,0,3,292,0,296,"2013"
"18420","270080 BELEM",0,0,1,75,0,76,"2013"
"18421","270090 BELO MONTE",0,1,0,85,2,88,"2013"
"18422","270100 BOCA DA MATA",0,4,9,476,2,491,"2013"
"18423","270110 BRANQUINHA",0,0,1,222,1,224,"2013"
"18424","270120 CACIMBINHAS",2,1,2,159,2,166,"2013"
"18425","270130 CAJUEIRO",1,2,4,259,108,374,"2013"
"18426","270135 CAMPESTRE",0,0,0,79,4,83,"2013"
"18427","270140 CAMPO ALEGRE",2,4,4,514,24,548,"2013"
"18428","270150 CAMPO GRANDE",0,1,1,112,5,119,"2013"
"18429","270160 CANAPI",2,3,6,264,50,325,"2013"
"18430","270170 CAPELA",0,1,3,267,3,274,"2013"
"18431","270180 CARNEIROS",0,1,6,146,2,155,"2013"
"18432","270190 CHA PRETA",0,0,0,84,23,107,"2013"
"18433","270200 COITE DO NOIA",0,0,4,180,0,184,"2013"
"18434","270210 COLONIA LEOPOLDINA",1,0,3,279,3,286,"2013"
"18435","270220 COQUEIRO SECO",1,1,1,89,3,95,"2013"
"18436","270230 CORURIPE",1,1,11,817,46,876,"2013"
"18437","270235 CRAIBAS",1,3,10,389,9,412,"2013"
"18438","270240 DELMIRO GOUVEIA",0,4,16,376,477,873,"2013"
"18439","270250 DOIS RIACHOS",0,0,2,138,1,141,"2013"
"18440","270255 ESTRELA DE ALAGOAS",0,2,5,207,0,214,"2013"
"18441","270260 FEIRA GRANDE",2,5,4,328,1,340,"2013"
"18442","270270 FELIZ DESERTO",0,0,1,63,2,66,"2013"
"18443","270280 FLEXEIRAS",0,0,2,195,4,201,"2013"
"18444","270290 GIRAU DO PONCIANO",0,5,10,569,1,585,"2013"
"18445","270300 IBATEGUARA",0,0,5,269,4,278,"2013"
"18446","270310 IGACI",1,0,5,312,2,320,"2013"
"18447","270320 IGREJA NOVA",1,0,10,419,8,438,"2013"
"18448","270330 INHAPI",0,2,5,208,101,316,"2013"
"18449","270340 JACARE DOS HOMENS",0,0,2,108,0,110,"2013"
"18450","270350 JACUIPE",0,0,1,74,1,76,"2013"
"18451","270360 JAPARATINGA",0,0,2,146,2,150,"2013"
"18452","270370 JARAMATAIA",0,0,2,80,3,85,"2013"
"18453","270375 JEQUIA DA PRAIA",0,0,1,151,3,155,"2013"
"18454","270380 JOAQUIM GOMES",0,4,11,412,17,444,"2013"
"18455","270390 JUNDIA",0,0,0,38,0,38,"2013"
"18456","270400 JUNQUEIRO",0,4,9,374,7,394,"2013"
"18457","270410 LAGOA DA CANOA",1,2,4,305,1,313,"2013"
"18458","270420 LIMOEIRO DE ANADIA",1,2,2,331,2,338,"2013"
"18459","270430 MACEIO",29,38,151,14770,184,15172,"2013"
"18460","270440 MAJOR ISIDORO",2,1,6,196,74,279,"2013"
"18461","270450 MARAGOGI",0,3,8,476,3,490,"2013"
"18462","270460 MARAVILHA",1,1,3,134,1,140,"2013"
"18463","270470 MARECHAL DEODORO",1,3,8,819,7,838,"2013"
"18464","270480 MARIBONDO",0,2,10,216,1,229,"2013"
"18465","270490 MAR VERMELHO",0,1,0,23,9,33,"2013"
"18466","270500 MATA GRANDE",0,1,5,269,89,364,"2013"
"18467","270510 MATRIZ DE CAMARAGIBE",0,0,7,435,1,443,"2013"
"18468","270520 MESSIAS",2,1,4,313,16,336,"2013"
"18469","270530 MINADOR DO NEGRAO",1,1,2,86,5,95,"2013"
"18470","270540 MONTEIROPOLIS",0,0,3,116,1,120,"2013"
"18471","270550 MURICI",2,0,3,353,195,553,"2013"
"18472","270560 NOVO LINO",0,1,2,127,28,158,"2013"
"18473","270570 OLHO D'AGUA DAS FLORES",0,0,10,371,0,381,"2013"
"18474","270580 OLHO D'AGUA DO CASADO",1,2,2,105,44,154,"2013"
"18475","270590 OLHO D'AGUA GRANDE",0,0,3,76,2,81,"2013"
"18476","270600 OLIVENCA",0,0,4,174,0,178,"2013"
"18477","270610 OURO BRANCO",0,0,3,172,5,180,"2013"
"18478","270620 PALESTINA",0,0,2,91,2,95,"2013"
"18479","270630 PALMEIRA DOS INDIOS",2,7,27,1244,2,1282,"2013"
"18480","270640 PAO DE ACUCAR",2,1,1,420,9,433,"2013"
"18481","270642 PARICONHA",1,0,2,107,65,175,"2013"
"18482","270644 PARIPUEIRA",1,1,2,200,3,207,"2013"
"18483","270650 PASSO DE CAMARAGIBE",0,1,0,240,9,250,"2013"
"18484","270660 PAULO JACINTO",0,0,0,106,21,127,"2013"
"18485","270670 PENEDO",2,4,14,1040,25,1085,"2013"
"18486","270680 PIACABUCU",0,0,1,291,9,301,"2013"
"18487","270690 PILAR",2,2,7,503,80,594,"2013"
"18488","270700 PINDOBA",0,0,0,25,5,30,"2013"
"18489","270710 PIRANHAS",1,0,6,399,10,416,"2013"
"18490","270720 POCO DAS TRINCHEIRAS",1,0,4,230,1,236,"2013"
"18491","270730 PORTO CALVO",2,4,4,460,1,471,"2013"
"18492","270740 PORTO DE PEDRAS",0,0,1,122,5,128,"2013"
"18493","270750 PORTO REAL DO COLEGIO",1,2,8,295,4,310,"2013"
"18494","270760 QUEBRANGULO",0,1,4,120,41,166,"2013"
"18495","270770 RIO LARGO",5,3,12,1137,46,1203,"2013"
"18496","270780 ROTEIRO",0,0,1,125,1,127,"2013"
"18497","270790 SANTA LUZIA DO NORTE",0,2,0,93,8,103,"2013"
"18498","270800 SANTANA DO IPANEMA",5,3,13,770,3,794,"2013"
"18499","270810 SANTANA DO MUNDAU",0,0,1,163,1,165,"2013"
"18500","270820 SAO BRAS",0,0,1,101,3,105,"2013"
"18501","270830 SAO JOSE DA LAJE",0,0,0,368,25,393,"2013"
"18502","270840 SAO JOSE DA TAPERA",1,1,6,565,21,594,"2013"
"18503","270850 SAO LUIS DO QUITUNDE",0,1,10,610,3,624,"2013"
"18504","270860 SAO MIGUEL DOS CAMPOS",1,3,18,986,4,1012,"2013"
"18505","270870 SAO MIGUEL DOS MILAGRES",0,0,1,87,2,90,"2013"
"18506","270880 SAO SEBASTIAO",2,3,9,581,1,596,"2013"
"18507","270890 SATUBA",0,0,0,159,4,163,"2013"
"18508","270895 SENADOR RUI PALMEIRA",2,0,2,204,15,223,"2013"
"18509","270900 TANQUE D'ARCA",0,0,0,83,1,84,"2013"
"18510","270910 TAQUARANA",1,2,4,304,0,311,"2013"
"18511","270915 TEOTONIO VILELA",0,2,12,529,213,756,"2013"
"18512","270920 TRAIPU",1,2,8,340,16,367,"2013"
"18513","270930 UNIAO DOS PALMARES",4,1,3,1098,10,1116,"2013"
"18514","270940 VICOSA",1,0,3,326,117,447,"2013"
"18515","MUNICIPIO IGNORADO - SE",0,0,0,2,0,2,"2013"
"18516","280010 AMPARO DE SAO FRANCISCO",0,0,0,36,0,36,"2013"
"18517","280020 AQUIDABA",1,0,8,262,16,287,"2013"
"18518","280030 ARACAJU",63,31,192,9043,45,9374,"2013"
"18519","280040 ARAUA",0,0,1,129,1,131,"2013"
"18520","280050 AREIA BRANCA",1,1,6,251,1,260,"2013"
"18521","280060 BARRA DOS COQUEIROS",5,4,11,464,1,485,"2013"
"18522","280067 BOQUIM",1,3,7,346,7,364,"2013"
"18523","280070 BREJO GRANDE",0,0,5,114,3,122,"2013"
"18524","280100 CAMPO DO BRITO",2,1,7,256,1,267,"2013"
"18525","280110 CANHOBA",1,1,1,56,9,68,"2013"
"18526","280120 CANINDE DE SAO FRANCISCO",3,3,11,444,109,570,"2013"
"18527","280130 CAPELA",5,1,13,520,43,582,"2013"
"18528","280140 CARIRA",0,2,12,262,16,292,"2013"
"18529","280150 CARMOPOLIS",1,2,12,264,2,281,"2013"
"18530","280160 CEDRO DE SAO JOAO",0,0,2,69,0,71,"2013"
"18531","280170 CRISTINAPOLIS",1,0,5,291,7,304,"2013"
"18532","280190 CUMBE",0,0,0,53,3,56,"2013"
"18533","280200 DIVINA PASTORA",1,1,2,68,0,72,"2013"
"18534","280210 ESTANCIA",3,3,11,1046,8,1071,"2013"
"18535","280220 FEIRA NOVA",0,0,1,55,22,78,"2013"
"18536","280230 FREI PAULO",0,2,3,231,0,236,"2013"
"18537","280240 GARARU",0,0,1,105,36,142,"2013"
"18538","280250 GENERAL MAYNARD",1,0,0,39,0,40,"2013"
"18539","280260 GRACHO CARDOSO",0,0,5,44,34,83,"2013"
"18540","280270 ILHA DAS FLORES",1,0,1,144,7,153,"2013"
"18541","280280 INDIAROBA",0,1,1,279,4,285,"2013"
"18542","280290 ITABAIANA",5,4,20,1403,12,1444,"2013"
"18543","280300 ITABAIANINHA",2,1,10,618,6,637,"2013"
"18544","280310 ITABI",0,1,1,44,18,64,"2013"
"18545","280320 ITAPORANGA D'AJUDA",7,2,17,474,8,508,"2013"
"18546","280330 JAPARATUBA",0,1,7,246,5,259,"2013"
"18547","280340 JAPOATA",0,1,3,206,6,216,"2013"
"18548","280350 LAGARTO",3,5,17,1364,11,1400,"2013"
"18549","280360 LARANJEIRAS",3,3,13,451,6,476,"2013"
"18550","280370 MACAMBIRA",0,0,1,96,0,97,"2013"
"18551","280380 MALHADA DOS BOIS",0,0,1,68,2,71,"2013"
"18552","280390 MALHADOR",0,1,3,162,0,166,"2013"
"18553","280400 MARUIM",8,1,13,261,3,286,"2013"
"18554","280410 MOITA BONITA",0,1,5,138,2,146,"2013"
"18555","280420 MONTE ALEGRE DE SERGIPE",1,0,4,149,94,248,"2013"
"18556","280430 MURIBECA",4,0,4,141,1,150,"2013"
"18557","280440 NEOPOLIS",4,1,5,276,9,295,"2013"
"18558","280445 NOSSA SENHORA APARECIDA",0,1,2,141,6,150,"2013"
"18559","280450 NOSSA SENHORA DA GLORIA",0,5,6,369,233,613,"2013"
"18560","280460 NOSSA SENHORA DAS DORES",3,1,12,340,30,386,"2013"
"18561","280470 NOSSA SENHORA DE LOURDES",1,0,4,99,5,109,"2013"
"18562","280480 NOSSA SENHORA DO SOCORRO",18,13,79,2865,17,2992,"2013"
"18563","280490 PACATUBA",0,1,5,236,7,249,"2013"
"18564","280500 PEDRA MOLE",0,0,0,45,1,46,"2013"
"18565","280510 PEDRINHAS",1,1,2,111,0,115,"2013"
"18566","280520 PINHAO",1,0,1,91,1,94,"2013"
"18567","280530 PIRAMBU",2,0,3,135,0,140,"2013"
"18568","280540 POCO REDONDO",1,1,9,382,113,506,"2013"
"18569","280550 POCO VERDE",3,0,3,272,4,282,"2013"
"18570","280560 PORTO DA FOLHA",2,2,11,304,101,420,"2013"
"18571","280570 PROPRIA",2,2,13,454,5,476,"2013"
"18572","280580 RIACHAO DO DANTAS",3,0,8,308,6,325,"2013"
"18573","280590 RIACHUELO",1,1,2,154,0,158,"2013"
"18574","280600 RIBEIROPOLIS",0,0,3,205,2,210,"2013"
"18575","280610 ROSARIO DO CATETE",1,1,0,171,7,180,"2013"
"18576","280620 SALGADO",2,0,4,286,4,296,"2013"
"18577","280630 SANTA LUZIA DO ITANHY",1,1,4,228,0,234,"2013"
"18578","280640 SANTANA DO SAO FRANCISCO",1,0,1,120,3,125,"2013"
"18579","280650 SANTA ROSA DE LIMA",1,2,4,59,0,66,"2013"
"18580","280660 SANTO AMARO DAS BROTAS",2,1,5,193,0,201,"2013"
"18581","280670 SAO CRISTOVAO",19,9,34,1259,5,1326,"2013"
"18582","280680 SAO DOMINGOS",1,1,1,134,1,138,"2013"
"18583","280690 SAO FRANCISCO",0,1,0,43,0,44,"2013"
"18584","280700 SAO MIGUEL DO ALEIXO",0,0,1,63,1,65,"2013"
"18585","280710 SIMAO DIAS",5,4,7,597,4,617,"2013"
"18586","280720 SIRIRI",1,3,7,114,4,129,"2013"
"18587","280730 TELHA",1,0,2,45,4,52,"2013"
"18588","280740 TOBIAS BARRETO",6,4,15,651,21,697,"2013"
"18589","280750 TOMAR DO GERU",0,1,8,185,0,194,"2013"
"18590","280760 UMBAUBA",1,2,6,406,3,418,"2013"
"18591","MUNICIPIO IGNORADO - BA",0,0,1,10,10,21,"2013"
"18592","290010 ABAIRA",0,2,0,45,7,54,"2013"
"18593","290020 ABARE",0,1,11,275,3,290,"2013"
"18594","290030 ACAJUTIBA",2,2,6,185,6,201,"2013"
"18595","290035 ADUSTINA",1,1,7,157,2,168,"2013"
"18596","290040 AGUA FRIA",0,2,6,135,41,184,"2013"
"18597","290050 ERICO CARDOSO",0,0,0,24,70,94,"2013"
"18598","290060 AIQUARA",0,0,0,48,2,50,"2013"
"18599","290070 ALAGOINHAS",7,21,63,2022,130,2243,"2013"
"18600","290080 ALCOBACA",1,2,2,287,3,295,"2013"
"18601","290090 ALMADINA",0,0,2,74,1,77,"2013"
"18602","290100 AMARGOSA",4,2,7,417,27,457,"2013"
"18603","290110 AMELIA RODRIGUES",0,0,3,195,89,287,"2013"
"18604","290115 AMERICA DOURADA",0,1,8,192,1,202,"2013"
"18605","290120 ANAGE",0,2,6,218,7,233,"2013"
"18606","290130 ANDARAI",0,0,4,115,55,174,"2013"
"18607","290135 ANDORINHA",1,1,3,145,8,158,"2013"
"18608","290140 ANGICAL",0,1,8,222,2,233,"2013"
"18609","290150 ANGUERA",0,0,0,51,38,89,"2013"
"18610","290160 ANTAS",0,1,2,122,12,137,"2013"
"18611","290170 ANTONIO CARDOSO",1,2,1,103,55,162,"2013"
"18612","290180 ANTONIO GONCALVES",0,0,0,55,96,151,"2013"
"18613","290190 APORA",0,4,8,182,10,204,"2013"
"18614","290195 APUAREMA",0,1,1,65,1,68,"2013"
"18615","290200 ARACATU",0,1,3,113,46,163,"2013"
"18616","290205 ARACAS",0,2,4,148,9,163,"2013"
"18617","290210 ARACI",2,8,10,687,87,794,"2013"
"18618","290220 ARAMARI",0,0,2,100,8,110,"2013"
"18619","290225 ARATACA",1,0,4,132,1,138,"2013"
"18620","290230 ARATUIPE",0,0,22,88,22,132,"2013"
"18621","290240 AURELINO LEAL",1,3,4,147,49,204,"2013"
"18622","290250 BAIANOPOLIS",0,1,8,164,5,178,"2013"
"18623","290260 BAIXA GRANDE",1,1,11,217,9,239,"2013"
"18624","290265 BANZAE",0,0,0,8,156,164,"2013"
"18625","290270 BARRA",2,3,18,855,1,879,"2013"
"18626","290280 BARRA DA ESTIVA",0,3,7,352,12,374,"2013"
"18627","290290 BARRA DO CHOCA",2,2,3,515,11,533,"2013"
"18628","290300 BARRA DO MENDES",1,0,6,160,0,167,"2013"
"18629","290310 BARRA DO ROCHA",0,0,0,81,1,82,"2013"
"18630","290320 BARREIRAS",12,9,77,2499,9,2606,"2013"
"18631","290323 BARRO ALTO",0,1,3,148,1,153,"2013"
"18632","290327 BARROCAS",0,1,4,198,12,215,"2013"
"18633","290330 BARRO PRETO",0,1,1,78,4,84,"2013"
"18634","290340 BELMONTE",0,5,4,298,19,326,"2013"
"18635","290350 BELO CAMPO",0,4,9,202,1,216,"2013"
"18636","290360 BIRITINGA",1,3,3,206,35,248,"2013"
"18637","290370 BOA NOVA",0,0,2,145,15,162,"2013"
"18638","290380 BOA VISTA DO TUPIM",0,1,8,222,13,244,"2013"
"18639","290390 BOM JESUS DA LAPA",1,9,14,1056,8,1088,"2013"
"18640","290395 BOM JESUS DA SERRA",0,1,9,110,0,120,"2013"
"18641","290400 BONINAL",2,1,4,147,2,156,"2013"
"18642","290405 BONITO",0,3,10,280,12,305,"2013"
"18643","290410 BOQUIRA",2,1,4,227,29,263,"2013"
"18644","290420 BOTUPORA",0,0,2,98,60,160,"2013"
"18645","290430 BREJOES",0,2,6,155,6,169,"2013"
"18646","290440 BREJOLANDIA",0,1,1,87,1,90,"2013"
"18647","290450 BROTAS DE MACAUBAS",0,0,2,125,4,131,"2013"
"18648","290460 BRUMADO",5,3,8,589,320,925,"2013"
"18649","290470 BUERAREMA",0,4,8,244,3,259,"2013"
"18650","290475 BURITIRAMA",1,2,4,254,2,263,"2013"
"18651","290480 CAATIBA",0,0,7,60,36,103,"2013"
"18652","290485 CABACEIRAS DO PARAGUACU",1,1,1,153,94,250,"2013"
"18653","290490 CACHOEIRA",0,1,0,250,159,410,"2013"
"18654","290500 CACULE",1,2,3,249,29,284,"2013"
"18655","290510 CAEM",0,1,0,165,5,171,"2013"
"18656","290515 CAETANOS",2,1,6,127,4,140,"2013"
"18657","290520 CAETITE",1,2,4,709,28,744,"2013"
"18658","290530 CAFARNAUM",0,2,6,246,3,257,"2013"
"18659","290540 CAIRU",0,7,85,145,5,242,"2013"
"18660","290550 CALDEIRAO GRANDE",0,0,4,147,5,156,"2013"
"18661","290560 CAMACAN",3,2,10,413,3,431,"2013"
"18662","290570 CAMACARI",21,18,85,4092,41,4257,"2013"
"18663","290580 CAMAMU",2,3,19,434,90,548,"2013"
"18664","290590 CAMPO ALEGRE DE LOURDES",1,1,3,435,13,453,"2013"
"18665","290600 CAMPO FORMOSO",3,1,3,380,651,1038,"2013"
"18666","290610 CANAPOLIS",1,1,3,155,0,160,"2013"
"18667","290620 CANARANA",2,2,15,345,4,368,"2013"
"18668","290630 CANAVIEIRAS",0,3,4,372,111,490,"2013"
"18669","290640 CANDEAL",0,0,1,61,50,112,"2013"
"18670","290650 CANDEIAS",4,7,17,1104,38,1170,"2013"
"18671","290660 CANDIBA",0,2,3,147,7,159,"2013"
"18672","290670 CANDIDO SALES",1,2,19,352,1,375,"2013"
"18673","290680 CANSANCAO",2,1,18,398,18,437,"2013"
"18674","290682 CANUDOS",2,2,0,145,42,191,"2013"
"18675","290685 CAPELA DO ALTO ALEGRE",0,0,1,73,20,94,"2013"
"18676","290687 CAPIM GROSSO",1,0,5,381,18,405,"2013"
"18677","290689 CARAIBAS",0,1,4,80,3,88,"2013"
"18678","290690 CARAVELAS",0,1,3,214,3,221,"2013"
"18679","290700 CARDEAL DA SILVA",0,0,3,115,4,122,"2013"
"18680","290710 CARINHANHA",0,2,10,420,20,452,"2013"
"18681","290720 CASA NOVA",2,6,17,1050,11,1086,"2013"
"18682","290730 CASTRO ALVES",0,0,10,290,40,340,"2013"
"18683","290740 CATOLANDIA",1,0,4,41,0,46,"2013"
"18684","290750 CATU",1,4,13,672,8,698,"2013"
"18685","290755 CATURAMA",0,0,0,35,72,107,"2013"
"18686","290760 CENTRAL",0,2,8,216,1,227,"2013"
"18687","290770 CHORROCHO",0,3,4,141,3,151,"2013"
"18688","290780 CICERO DANTAS",1,2,8,306,47,364,"2013"
"18689","290790 CIPO",1,2,8,175,105,291,"2013"
"18690","290800 COARACI",0,1,10,262,10,283,"2013"
"18691","290810 COCOS",0,4,5,123,96,228,"2013"
"18692","290820 CONCEICAO DA FEIRA",0,0,1,87,145,233,"2013"
"18693","290830 CONCEICAO DO ALMEIDA",0,1,2,115,20,138,"2013"
"18694","290840 CONCEICAO DO COITE",1,6,22,860,131,1020,"2013"
"18695","290850 CONCEICAO DO JACUIPE",2,0,7,253,152,414,"2013"
"18696","290860 CONDE",2,1,6,301,9,319,"2013"
"18697","290870 CONDEUBA",2,2,5,201,3,213,"2013"
"18698","290880 CONTENDAS DO SINCORA",0,3,0,27,15,45,"2013"
"18699","290890 CORACAO DE MARIA",2,0,3,175,103,283,"2013"
"18700","290900 CORDEIROS",0,3,4,69,0,76,"2013"
"18701","290910 CORIBE",2,0,2,153,0,157,"2013"
"18702","290920 CORONEL JOAO SA",2,1,9,201,3,216,"2013"
"18703","290930 CORRENTINA",1,2,4,158,260,425,"2013"
"18704","290940 COTEGIPE",1,0,2,147,34,184,"2013"
"18705","290950 CRAVOLANDIA",0,0,2,48,0,50,"2013"
"18706","290960 CRISOPOLIS",1,0,2,246,5,254,"2013"
"18707","290970 CRISTOPOLIS",3,1,6,159,0,169,"2013"
"18708","290980 CRUZ DAS ALMAS",2,2,9,759,44,816,"2013"
"18709","290990 CURACA",4,5,21,421,8,459,"2013"
"18710","291000 DARIO MEIRA",0,0,3,133,6,142,"2013"
"18711","291005 DIAS D'AVILA",5,3,24,919,9,960,"2013"
"18712","291010 DOM BASILIO",0,1,2,105,8,116,"2013"
"18713","291020 DOM MACEDO COSTA",0,0,0,35,15,50,"2013"
"18714","291030 ELISIO MEDRADO",0,3,1,77,21,102,"2013"
"18715","291040 ENCRUZILHADA",4,4,5,282,6,301,"2013"
"18716","291050 ENTRE RIOS",1,7,8,576,16,608,"2013"
"18717","291060 ESPLANADA",0,3,12,488,9,512,"2013"
"18718","291070 EUCLIDES DA CUNHA",1,1,14,554,134,704,"2013"
"18719","291072 EUNAPOLIS",5,8,26,1262,393,1694,"2013"
"18720","291075 FATIMA",0,0,7,171,25,203,"2013"
"18721","291077 FEIRA DA MATA",0,0,1,26,9,36,"2013"
"18722","291080 FEIRA DE SANTANA",14,23,86,6369,2786,9278,"2013"
"18723","291085 FILADELFIA",0,5,10,261,5,281,"2013"
"18724","291090 FIRMINO ALVES",0,0,4,53,9,66,"2013"
"18725","291100 FLORESTA AZUL",0,1,4,128,2,135,"2013"
"18726","291110 FORMOSA DO RIO PRETO",0,1,9,384,11,405,"2013"
"18727","291120 GANDU",2,4,32,474,10,522,"2013"
"18728","291125 GAVIAO",2,0,1,43,3,49,"2013"
"18729","291130 GENTIO DO OURO",0,1,3,107,0,111,"2013"
"18730","291140 GLORIA",2,3,14,220,13,252,"2013"
"18731","291150 GONGOGI",0,0,2,71,0,73,"2013"
"18732","291160 GOVERNADOR MANGABEIRA",0,1,2,137,146,286,"2013"
"18733","291165 GUAJERU",0,1,1,42,25,69,"2013"
"18734","291170 GUANAMBI",2,10,21,901,275,1209,"2013"
"18735","291180 GUARATINGA",1,0,4,220,29,254,"2013"
"18736","291185 HELIOPOLIS",0,1,7,79,36,123,"2013"
"18737","291190 IACU",2,4,8,340,4,358,"2013"
"18738","291200 IBIASSUCE",0,1,4,100,2,107,"2013"
"18739","291210 IBICARAI",1,1,4,323,8,337,"2013"
"18740","291220 IBICOARA",0,4,11,269,61,345,"2013"
"18741","291230 IBICUI",0,1,5,147,6,159,"2013"
"18742","291240 IBIPEBA",2,0,4,191,1,198,"2013"
"18743","291250 IBIPITANGA",0,1,2,54,93,150,"2013"
"18744","291260 IBIQUERA",0,1,2,44,2,49,"2013"
"18745","291270 IBIRAPITANGA",1,3,14,290,61,369,"2013"
"18746","291280 IBIRAPUA",0,0,3,96,1,100,"2013"
"18747","291290 IBIRATAIA",1,0,1,281,1,284,"2013"
"18748","291300 IBITIARA",1,3,9,157,6,176,"2013"
"18749","291310 IBITITA",3,2,4,243,0,252,"2013"
"18750","291320 IBOTIRAMA",3,2,30,325,42,402,"2013"
"18751","291330 ICHU",0,0,2,57,24,83,"2013"
"18752","291340 IGAPORA",0,0,4,171,14,189,"2013"
"18753","291345 IGRAPIUNA",0,1,31,147,9,188,"2013"
"18754","291350 IGUAI",2,1,5,289,3,300,"2013"
"18755","291360 ILHEUS",4,5,18,637,1853,2517,"2013"
"18756","291370 INHAMBUPE",0,2,21,407,24,454,"2013"
"18757","291380 IPECAETA",0,4,1,124,50,179,"2013"
"18758","291390 IPIAU",4,2,14,593,1,614,"2013"
"18759","291400 IPIRA",3,3,10,660,84,760,"2013"
"18760","291410 IPUPIARA",0,0,2,116,0,118,"2013"
"18761","291420 IRAJUBA",1,0,1,89,0,91,"2013"
"18762","291430 IRAMAIA",0,0,2,113,7,122,"2013"
"18763","291440 IRAQUARA",0,2,6,337,5,350,"2013"
"18764","291450 IRARA",1,0,10,219,115,345,"2013"
"18765","291460 IRECE",8,5,39,1116,5,1173,"2013"
"18766","291465 ITABELA",1,4,10,466,40,521,"2013"
"18767","291470 ITABERABA",4,4,21,939,13,981,"2013"
"18768","291480 ITABUNA",9,17,93,3108,6,3233,"2013"
"18769","291490 ITACARE",1,1,1,160,142,305,"2013"
"18770","291500 ITAETE",1,3,2,229,12,247,"2013"
"18771","291510 ITAGI",0,2,8,180,2,192,"2013"
"18772","291520 ITAGIBA",0,0,5,216,2,223,"2013"
"18773","291530 ITAGIMIRIM",0,0,2,81,21,104,"2013"
"18774","291535 ITAGUACU DA BAHIA",0,0,2,186,1,189,"2013"
"18775","291540 ITAJU DO COLONIA",0,0,2,53,1,56,"2013"
"18776","291550 ITAJUIPE",2,3,9,270,3,287,"2013"
"18777","291560 ITAMARAJU",9,6,17,935,24,991,"2013"
"18778","291570 ITAMARI",0,1,3,104,4,112,"2013"
"18779","291580 ITAMBE",1,1,5,341,7,355,"2013"
"18780","291590 ITANAGRA",1,1,0,73,7,82,"2013"
"18781","291600 ITANHEM",0,0,10,213,2,225,"2013"
"18782","291610 ITAPARICA",0,1,4,236,22,263,"2013"
"18783","291620 ITAPE",1,0,3,115,0,119,"2013"
"18784","291630 ITAPEBI",0,0,6,118,31,155,"2013"
"18785","291640 ITAPETINGA",4,1,3,231,824,1063,"2013"
"18786","291650 ITAPICURU",1,0,5,343,17,366,"2013"
"18787","291660 ITAPITANGA",0,2,1,73,3,79,"2013"
"18788","291670 ITAQUARA",0,3,2,100,7,112,"2013"
"18789","291680 ITARANTIM",2,1,8,160,30,201,"2013"
"18790","291685 ITATIM",1,1,5,162,37,206,"2013"
"18791","291690 ITIRUCU",2,0,2,140,0,144,"2013"
"18792","291700 ITIUBA",1,3,19,469,27,519,"2013"
"18793","291710 ITORORO",1,1,2,68,148,220,"2013"
"18794","291720 ITUACU",2,0,3,165,71,241,"2013"
"18795","291730 ITUBERA",1,5,35,391,6,438,"2013"
"18796","291733 IUIU",0,5,3,104,14,126,"2013"
"18797","291735 JABORANDI",0,1,0,111,0,112,"2013"
"18798","291740 JACARACI",0,1,2,140,6,149,"2013"
"18799","291750 JACOBINA",6,9,21,1170,39,1245,"2013"
"18800","291760 JAGUAQUARA",0,3,15,693,14,725,"2013"
"18801","291770 JAGUARARI",4,4,6,331,79,424,"2013"
"18802","291780 JAGUARIPE",0,2,28,143,40,213,"2013"
"18803","291790 JANDAIRA",1,0,0,150,4,155,"2013"
"18804","291800 JEQUIE",9,20,71,2592,66,2758,"2013"
"18805","291810 JEREMOABO",0,4,20,441,49,514,"2013"
"18806","291820 JIQUIRICA",0,0,2,120,19,141,"2013"
"18807","291830 JITAUNA",1,2,4,139,5,151,"2013"
"18808","291835 JOAO DOURADO",1,3,12,328,0,344,"2013"
"18809","291840 JUAZEIRO",18,18,76,3824,52,3988,"2013"
"18810","291845 JUCURUCU",0,1,4,94,6,105,"2013"
"18811","291850 JUSSARA",0,5,7,216,0,228,"2013"
"18812","291855 JUSSARI",0,0,3,80,0,83,"2013"
"18813","291860 JUSSIAPE",0,0,0,52,2,54,"2013"
"18814","291870 LAFAIETE COUTINHO",0,0,2,43,1,46,"2013"
"18815","291875 LAGOA REAL",0,1,0,121,4,126,"2013"
"18816","291880 LAJE",1,0,10,190,66,267,"2013"
"18817","291890 LAJEDAO",0,0,2,39,0,41,"2013"
"18818","291900 LAJEDINHO",0,0,1,41,1,43,"2013"
"18819","291905 LAJEDO DO TABOCAL",0,0,5,63,2,70,"2013"
"18820","291910 LAMARAO",0,1,6,79,8,94,"2013"
"18821","291915 LAPAO",2,3,11,362,2,380,"2013"
"18822","291920 LAURO DE FREITAS",11,16,71,3120,38,3256,"2013"
"18823","291930 LENCOIS",0,0,0,93,41,134,"2013"
"18824","291940 LICINIO DE ALMEIDA",0,1,1,147,3,152,"2013"
"18825","291950 LIVRAMENTO DE NOSSA SENHORA",0,5,11,532,17,565,"2013"
"18826","291955 LUIS EDUARDO MAGALHAES",7,6,30,1578,5,1626,"2013"
"18827","291960 MACAJUBA",2,1,3,116,8,130,"2013"
"18828","291970 MACARANI",1,5,8,167,56,237,"2013"
"18829","291980 MACAUBAS",1,1,3,504,24,533,"2013"
"18830","291990 MACURURE",0,0,4,94,3,101,"2013"
"18831","291992 MADRE DE DEUS",2,0,9,304,0,315,"2013"
"18832","291995 MAETINGA",0,0,1,72,0,73,"2013"
"18833","292000 MAIQUINIQUE",1,2,2,76,29,110,"2013"
"18834","292010 MAIRI",0,0,1,191,18,210,"2013"
"18835","292020 MALHADA",2,3,3,185,18,211,"2013"
"18836","292030 MALHADA DE PEDRAS",1,0,0,72,28,101,"2013"
"18837","292040 MANOEL VITORINO",1,0,4,168,2,175,"2013"
"18838","292045 MANSIDAO",1,0,2,100,1,104,"2013"
"18839","292050 MARACAS",0,3,7,343,2,355,"2013"
"18840","292060 MARAGOGIPE",0,0,2,207,291,500,"2013"
"18841","292070 MARAU",0,2,6,143,70,221,"2013"
"18842","292080 MARCIONILIO SOUZA",1,2,3,131,10,147,"2013"
"18843","292090 MASCOTE",2,1,4,194,4,205,"2013"
"18844","292100 MATA DE SAO JOAO",1,4,19,726,3,753,"2013"
"18845","292105 MATINA",0,0,1,140,30,171,"2013"
"18846","292110 MEDEIROS NETO",3,4,17,274,0,298,"2013"
"18847","292120 MIGUEL CALMON",2,3,7,389,3,404,"2013"
"18848","292130 MILAGRES",0,0,2,119,23,144,"2013"
"18849","292140 MIRANGABA",1,0,2,171,8,182,"2013"
"18850","292145 MIRANTE",0,2,3,101,9,115,"2013"
"18851","292150 MONTE SANTO",2,11,24,651,49,737,"2013"
"18852","292160 MORPARA",2,0,4,92,8,106,"2013"
"18853","292170 MORRO DO CHAPEU",6,4,8,483,50,551,"2013"
"18854","292180 MORTUGABA",0,1,3,116,5,125,"2013"
"18855","292190 MUCUGE",0,0,0,24,118,142,"2013"
"18856","292200 MUCURI",4,6,15,674,0,699,"2013"
"18857","292205 MULUNGU DO MORRO",0,0,6,176,0,182,"2013"
"18858","292210 MUNDO NOVO",0,7,3,237,19,266,"2013"
"18859","292220 MUNIZ FERREIRA",0,1,2,58,28,89,"2013"
"18860","292225 MUQUEM DE SAO FRANCISCO",0,1,4,154,21,180,"2013"
"18861","292230 MURITIBA",0,2,5,205,145,357,"2013"
"18862","292240 MUTUIPE",0,5,8,212,43,268,"2013"
"18863","292250 NAZARE",2,3,16,235,53,309,"2013"
"18864","292260 NILO PECANHA",2,3,35,175,6,221,"2013"
"18865","292265 NORDESTINA",1,2,2,149,6,160,"2013"
"18866","292270 NOVA CANAA",1,2,4,167,1,175,"2013"
"18867","292273 NOVA FATIMA",1,0,2,83,12,98,"2013"
"18868","292275 NOVA IBIA",0,3,1,53,2,59,"2013"
"18869","292280 NOVA ITARANA",1,2,4,94,1,102,"2013"
"18870","292285 NOVA REDENCAO",0,0,6,61,3,70,"2013"
"18871","292290 NOVA SOURE",3,0,17,223,110,353,"2013"
"18872","292300 NOVA VICOSA",8,7,14,682,2,713,"2013"
"18873","292303 NOVO HORIZONTE",0,0,6,111,0,117,"2013"
"18874","292305 NOVO TRIUNFO",0,0,1,77,7,85,"2013"
"18875","292310 OLINDINA",1,0,7,288,42,338,"2013"
"18876","292320 OLIVEIRA DOS BREJINHOS",2,1,16,220,16,255,"2013"
"18877","292330 OURICANGAS",0,0,2,96,8,106,"2013"
"18878","292335 OUROLANDIA",0,1,12,267,7,287,"2013"
"18879","292340 PALMAS DE MONTE ALTO",1,3,3,208,49,264,"2013"
"18880","292350 PALMEIRAS",0,1,3,122,16,142,"2013"
"18881","292360 PARAMIRIM",0,1,1,58,171,231,"2013"
"18882","292370 PARATINGA",1,5,12,485,20,523,"2013"
"18883","292380 PARIPIRANGA",3,1,8,278,4,294,"2013"
"18884","292390 PAU BRASIL",2,1,3,126,7,139,"2013"
"18885","292400 PAULO AFONSO",3,10,65,1662,54,1794,"2013"
"18886","292405 PE DE SERRA",3,1,3,130,9,146,"2013"
"18887","292410 PEDRAO",1,0,3,54,11,69,"2013"
"18888","292420 PEDRO ALEXANDRE",1,1,7,185,7,201,"2013"
"18889","292430 PIATA",0,1,3,245,4,253,"2013"
"18890","292440 PILAO ARCADO",2,1,11,585,40,639,"2013"
"18891","292450 PINDAI",1,1,1,193,1,197,"2013"
"18892","292460 PINDOBACU",2,0,2,295,2,301,"2013"
"18893","292465 PINTADAS",0,1,1,64,24,90,"2013"
"18894","292467 PIRAI DO NORTE",3,2,12,78,5,100,"2013"
"18895","292470 PIRIPA",0,0,2,99,2,103,"2013"
"18896","292480 PIRITIBA",1,1,6,226,6,240,"2013"
"18897","292490 PLANALTINO",0,0,0,70,0,70,"2013"
"18898","292500 PLANALTO",1,5,5,312,5,328,"2013"
"18899","292510 POCOES",0,6,29,589,19,643,"2013"
"18900","292520 POJUCA",1,1,5,548,2,557,"2013"
"18901","292525 PONTO NOVO",1,0,6,205,25,237,"2013"
"18902","292530 PORTO SEGURO",8,12,35,2201,122,2378,"2013"
"18903","292540 POTIRAGUA",0,2,2,136,7,147,"2013"
"18904","292550 PRADO",0,1,2,360,5,368,"2013"
"18905","292560 PRESIDENTE DUTRA",0,1,3,182,1,187,"2013"
"18906","292570 PRESIDENTE JANIO QUADROS",2,0,2,110,10,124,"2013"
"18907","292575 PRESIDENTE TANCREDO NEVES",1,2,29,223,69,324,"2013"
"18908","292580 QUEIMADAS",3,0,2,294,3,302,"2013"
"18909","292590 QUIJINGUE",2,4,3,250,52,311,"2013"
"18910","292593 QUIXABEIRA",0,2,0,83,4,89,"2013"
"18911","292595 RAFAEL JAMBEIRO",1,1,2,182,86,272,"2013"
"18912","292600 REMANSO",0,0,0,638,5,643,"2013"
"18913","292610 RETIROLANDIA",0,1,7,199,19,226,"2013"
"18914","292620 RIACHAO DAS NEVES",3,3,11,291,5,313,"2013"
"18915","292630 RIACHAO DO JACUIPE",2,1,4,354,25,386,"2013"
"18916","292640 RIACHO DE SANTANA",2,4,12,375,20,413,"2013"
"18917","292650 RIBEIRA DO AMPARO",0,0,2,16,160,178,"2013"
"18918","292660 RIBEIRA DO POMBAL",0,1,4,72,756,833,"2013"
"18919","292665 RIBEIRAO DO LARGO",0,1,3,65,1,70,"2013"
"18920","292670 RIO DE CONTAS",0,0,2,99,13,114,"2013"
"18921","292680 RIO DO ANTONIO",0,0,2,86,23,111,"2013"
"18922","292690 RIO DO PIRES",0,0,0,45,67,112,"2013"
"18923","292700 RIO REAL",2,4,11,525,3,545,"2013"
"18924","292710 RODELAS",0,0,4,128,2,134,"2013"
"18925","292720 RUY BARBOSA",0,3,12,412,4,431,"2013"
"18926","292730 SALINAS DA MARGARIDA",0,2,4,153,17,176,"2013"
"18927","292740 SALVADOR",196,174,727,34915,444,36456,"2013"
"18928","292750 SANTA BARBARA",0,0,5,185,90,280,"2013"
"18929","292760 SANTA BRIGIDA",0,1,11,190,9,211,"2013"
"18930","292770 SANTA CRUZ CABRALIA",1,2,8,404,8,423,"2013"
"18931","292780 SANTA CRUZ DA VITORIA",0,0,2,60,17,79,"2013"
"18932","292790 SANTA INES",1,4,5,126,8,144,"2013"
"18933","292800 SANTALUZ",1,8,25,565,14,613,"2013"
"18934","292805 SANTA LUZIA",3,2,5,170,12,192,"2013"
"18935","292810 SANTA MARIA DA VITORIA",1,3,15,567,29,615,"2013"
"18936","292820 SANTANA",2,3,5,343,6,359,"2013"
"18937","292830 SANTANOPOLIS",0,0,2,76,35,113,"2013"
"18938","292840 SANTA RITA DE CASSIA",0,3,7,396,3,409,"2013"
"18939","292850 SANTA TERESINHA",0,1,4,131,3,139,"2013"
"18940","292860 SANTO AMARO",2,4,23,609,47,685,"2013"
"18941","292870 SANTO ANTONIO DE JESUS",5,3,12,916,395,1331,"2013"
"18942","292880 SANTO ESTEVAO",2,11,15,479,257,764,"2013"
"18943","292890 SAO DESIDERIO",3,4,7,502,5,521,"2013"
"18944","292895 SAO DOMINGOS",0,0,1,74,10,85,"2013"
"18945","292900 SAO FELIX",0,0,0,34,143,177,"2013"
"18946","292905 SAO FELIX DO CORIBE",2,1,7,206,31,247,"2013"
"18947","292910 SAO FELIPE",1,1,3,180,42,227,"2013"
"18948","292920 SAO FRANCISCO DO CONDE",4,3,2,564,32,605,"2013"
"18949","292925 SAO GABRIEL",1,1,16,262,0,280,"2013"
"18950","292930 SAO GONCALO DOS CAMPOS",1,0,6,272,125,404,"2013"
"18951","292935 SAO JOSE DA VITORIA",0,0,2,76,1,79,"2013"
"18952","292937 SAO JOSE DO JACUIPE",1,0,2,92,7,102,"2013"
"18953","292940 SAO MIGUEL DAS MATAS",0,0,7,89,33,129,"2013"
"18954","292950 SAO SEBASTIAO DO PASSE",2,2,19,436,17,476,"2013"
"18955","292960 SAPEACU",0,2,3,210,9,224,"2013"
"18956","292970 SATIRO DIAS",2,1,1,171,14,189,"2013"
"18957","292975 SAUBARA",1,0,4,117,5,127,"2013"
"18958","292980 SAUDE",0,1,5,125,3,134,"2013"
"18959","292990 SEABRA",3,4,11,619,15,652,"2013"
"18960","293000 SEBASTIAO LARANJEIRAS",0,1,1,107,6,115,"2013"
"18961","293010 SENHOR DO BONFIM",0,8,43,994,56,1101,"2013"
"18962","293015 SERRA DO RAMALHO",2,2,7,490,3,504,"2013"
"18963","293020 SENTO SE",2,1,10,514,11,538,"2013"
"18964","293030 SERRA DOURADA",1,4,5,243,2,255,"2013"
"18965","293040 SERRA PRETA",2,0,1,111,59,173,"2013"
"18966","293050 SERRINHA",3,6,23,1100,30,1162,"2013"
"18967","293060 SERROLANDIA",1,0,5,134,3,143,"2013"
"18968","293070 SIMOES FILHO",10,8,29,1921,10,1978,"2013"
"18969","293075 SITIO DO MATO",1,1,2,163,20,187,"2013"
"18970","293076 SITIO DO QUINTO",2,1,4,115,8,130,"2013"
"18971","293077 SOBRADINHO",1,1,7,367,13,389,"2013"
"18972","293080 SOUTO SOARES",3,5,8,202,5,223,"2013"
"18973","293090 TABOCAS DO BREJO VELHO",1,0,4,130,3,138,"2013"
"18974","293100 TANHACU",0,2,5,131,117,255,"2013"
"18975","293105 TANQUE NOVO",1,2,4,140,59,206,"2013"
"18976","293110 TANQUINHO",0,0,0,41,46,87,"2013"
"18977","293120 TAPEROA",1,2,64,144,13,224,"2013"
"18978","293130 TAPIRAMUTA",0,3,3,177,15,198,"2013"
"18979","293135 TEIXEIRA DE FREITAS",3,9,56,2513,9,2590,"2013"
"18980","293140 TEODORO SAMPAIO",1,0,2,48,19,70,"2013"
"18981","293150 TEOFILANDIA",2,1,7,261,21,292,"2013"
"18982","293160 TEOLANDIA",2,0,16,158,13,189,"2013"
"18983","293170 TERRA NOVA",1,0,3,115,24,143,"2013"
"18984","293180 TREMEDAL",0,2,5,184,3,194,"2013"
"18985","293190 TUCANO",1,1,6,505,96,609,"2013"
"18986","293200 UAUA",2,3,6,289,2,302,"2013"
"18987","293210 UBAIRA",0,0,6,221,17,244,"2013"
"18988","293220 UBAITABA",3,1,6,266,47,323,"2013"
"18989","293230 UBATA",0,1,8,270,5,284,"2013"
"18990","293240 UIBAI",2,1,1,166,0,170,"2013"
"18991","293245 UMBURANAS",9,9,6,114,6,144,"2013"
"18992","293250 UNA",3,1,5,142,168,319,"2013"
"18993","293260 URANDI",0,0,5,159,20,184,"2013"
"18994","293270 URUCUCA",0,4,10,239,117,370,"2013"
"18995","293280 UTINGA",0,0,2,224,28,254,"2013"
"18996","293290 VALENCA",2,15,350,836,33,1236,"2013"
"18997","293300 VALENTE",2,0,5,252,38,297,"2013"
"18998","293305 VARZEA DA ROCA",0,0,4,115,8,127,"2013"
"18999","293310 VARZEA DO POCO",2,2,0,74,4,82,"2013"
"19000","293315 VARZEA NOVA",3,0,2,121,5,131,"2013"
"19001","293317 VARZEDO",0,0,3,78,31,112,"2013"
"19002","293320 VERA CRUZ",2,7,9,440,38,496,"2013"
"19003","293325 VEREDA",0,0,0,53,0,53,"2013"
"19004","293330 VITORIA DA CONQUISTA",14,36,164,5011,19,5244,"2013"
"19005","293340 WAGNER",0,2,0,104,23,129,"2013"
"19006","293345 WANDERLEY",0,1,8,176,2,187,"2013"
"19007","293350 WENCESLAU GUIMARAES",1,0,22,320,25,368,"2013"
"19008","293360 XIQUE-XIQUE",1,2,27,745,45,820,"2013"
"19009","MUNICIPIO IGNORADO - MG",0,0,0,8,1,9,"2013"
"19010","310010 ABADIA DOS DOURADOS",0,0,0,57,0,57,"2013"
"19011","310020 ABAETE",0,1,8,258,1,268,"2013"
"19012","310030 ABRE CAMPO",0,0,1,133,19,153,"2013"
"19013","310040 ACAIACA",0,0,1,36,1,38,"2013"
"19014","310050 ACUCENA",0,0,3,103,1,107,"2013"
"19015","310060 AGUA BOA",0,0,2,189,2,193,"2013"
"19016","310070 AGUA COMPRIDA",0,0,1,15,0,16,"2013"
"19017","310080 AGUANIL",0,0,1,68,0,69,"2013"
"19018","310090 AGUAS FORMOSAS",0,1,4,258,1,264,"2013"
"19019","310100 AGUAS VERMELHAS",1,2,5,175,1,184,"2013"
"19020","310110 AIMORES",1,1,5,333,3,343,"2013"
"19021","310120 AIURUOCA",0,0,0,58,1,59,"2013"
"19022","310130 ALAGOA",0,0,1,20,0,21,"2013"
"19023","310140 ALBERTINA",0,0,0,27,0,27,"2013"
"19024","310150 ALEM PARAIBA",1,4,9,399,1,414,"2013"
"19025","310160 ALFENAS",2,3,11,988,5,1009,"2013"
"19026","310163 ALFREDO VASCONCELOS",0,0,1,85,0,86,"2013"
"19027","310170 ALMENARA",3,5,9,533,5,555,"2013"
"19028","310180 ALPERCATA",0,0,2,81,5,88,"2013"
"19029","310190 ALPINOPOLIS",0,0,3,231,1,235,"2013"
"19030","310200 ALTEROSA",0,0,2,156,1,159,"2013"
"19031","310205 ALTO CAPARAO",0,0,0,75,7,82,"2013"
"19032","310210 ALTO RIO DOCE",0,2,0,96,1,99,"2013"
"19033","310220 ALVARENGA",0,0,1,63,0,64,"2013"
"19034","310230 ALVINOPOLIS",0,1,6,130,0,137,"2013"
"19035","310240 ALVORADA DE MINAS",0,1,0,56,1,58,"2013"
"19036","310250 AMPARO DO SERRA",1,1,1,62,1,66,"2013"
"19037","310260 ANDRADAS",0,0,9,417,0,426,"2013"
"19038","310270 CACHOEIRA DE PAJEU",0,2,2,88,5,97,"2013"
"19039","310280 ANDRELANDIA",0,1,0,122,0,123,"2013"
"19040","310285 ANGELANDIA",0,3,2,113,0,118,"2013"
"19041","310290 ANTONIO CARLOS",0,0,0,123,0,123,"2013"
"19042","310300 ANTONIO DIAS",0,1,0,110,1,112,"2013"
"19043","310310 ANTONIO PRADO DE MINAS",0,0,0,10,0,10,"2013"
"19044","310320 ARACAI",0,0,0,14,0,14,"2013"
"19045","310330 ARACITABA",0,0,1,13,0,14,"2013"
"19046","310340 ARACUAI",1,1,7,439,5,453,"2013"
"19047","310350 ARAGUARI",3,9,9,1381,6,1408,"2013"
"19048","310360 ARANTINA",0,0,1,29,0,30,"2013"
"19049","310370 ARAPONGA",1,0,0,79,9,89,"2013"
"19050","310375 ARAPORA",0,0,0,96,1,97,"2013"
"19051","310380 ARAPUA",1,0,0,12,0,13,"2013"
"19052","310390 ARAUJOS",0,0,2,86,0,88,"2013"
"19053","310400 ARAXA",10,4,12,1291,3,1320,"2013"
"19054","310410 ARCEBURGO",1,0,2,99,0,102,"2013"
"19055","310420 ARCOS",1,0,3,478,1,483,"2013"
"19056","310430 AREADO",0,1,2,173,0,176,"2013"
"19057","310440 ARGIRITA",0,0,0,30,0,30,"2013"
"19058","310445 ARICANDUVA",0,0,1,52,0,53,"2013"
"19059","310450 ARINOS",1,1,2,205,8,217,"2013"
"19060","310460 ASTOLFO DUTRA",1,0,6,145,0,152,"2013"
"19061","310470 ATALEIA",0,1,1,152,2,156,"2013"
"19062","310480 AUGUSTO DE LIMA",0,1,3,43,0,47,"2013"
"19063","310490 BAEPENDI",0,2,0,186,0,188,"2013"
"19064","310500 BALDIM",0,0,3,93,0,96,"2013"
"19065","310510 BAMBUI",1,1,3,220,1,226,"2013"
"19066","310520 BANDEIRA",1,2,0,18,1,22,"2013"
"19067","310530 BANDEIRA DO SUL",0,0,1,77,0,78,"2013"
"19068","310540 BARAO DE COCAIS",0,0,9,405,5,419,"2013"
"19069","310550 BARAO DE MONTE ALTO",0,1,1,28,0,30,"2013"
"19070","310560 BARBACENA",3,6,20,1434,6,1469,"2013"
"19071","310570 BARRA LONGA",0,0,0,44,1,45,"2013"
"19072","310590 BARROSO",2,1,0,256,0,259,"2013"
"19073","310600 BELA VISTA DE MINAS",2,2,0,119,1,124,"2013"
"19074","310610 BELMIRO BRAGA",0,0,1,33,0,34,"2013"
"19075","310620 BELO HORIZONTE",64,121,441,30660,95,31381,"2013"
"19076","310630 BELO ORIENTE",0,2,4,336,4,346,"2013"
"19077","310640 BELO VALE",0,1,0,86,0,87,"2013"
"19078","310650 BERILO",0,0,1,94,1,96,"2013"
"19079","310660 BERTOPOLIS",0,0,1,55,33,89,"2013"
"19080","310665 BERIZAL",0,2,0,57,0,59,"2013"
"19081","310670 BETIM",19,24,96,6204,42,6385,"2013"
"19082","310680 BIAS FORTES",0,0,0,32,0,32,"2013"
"19083","310690 BICAS",0,1,6,173,1,181,"2013"
"19084","310700 BIQUINHAS",0,1,0,24,0,25,"2013"
"19085","310710 BOA ESPERANCA",2,1,2,507,3,515,"2013"
"19086","310720 BOCAINA DE MINAS",0,0,0,25,0,25,"2013"
"19087","310730 BOCAIUVA",2,3,11,614,4,634,"2013"
"19088","310740 BOM DESPACHO",1,4,10,549,3,567,"2013"
"19089","310750 BOM JARDIM DE MINAS",0,0,0,67,2,69,"2013"
"19090","310760 BOM JESUS DA PENHA",0,0,0,36,0,36,"2013"
"19091","310770 BOM JESUS DO AMPARO",0,0,0,56,0,56,"2013"
"19092","310780 BOM JESUS DO GALHO",2,2,4,161,1,170,"2013"
"19093","310790 BOM REPOUSO",0,0,1,122,1,124,"2013"
"19094","310800 BOM SUCESSO",1,0,3,163,4,171,"2013"
"19095","310810 BONFIM",0,0,1,44,0,45,"2013"
"19096","310820 BONFINOPOLIS DE MINAS",0,0,1,50,4,55,"2013"
"19097","310825 BONITO DE MINAS",0,0,3,106,5,114,"2013"
"19098","310830 BORDA DA MATA",0,0,0,156,1,157,"2013"
"19099","310840 BOTELHOS",1,2,4,132,1,140,"2013"
"19100","310850 BOTUMIRIM",0,0,0,77,1,78,"2013"
"19101","310855 BRASILANDIA DE MINAS",0,1,5,212,10,228,"2013"
"19102","310860 BRASILIA DE MINAS",1,1,6,430,1,439,"2013"
"19103","310870 BRAS PIRES",0,0,0,30,1,31,"2013"
"19104","310880 BRAUNAS",0,0,0,69,2,71,"2013"
"19105","310890 BRAZOPOLIS",0,1,2,166,0,169,"2013"
"19106","310900 BRUMADINHO",0,4,4,426,1,435,"2013"
"19107","310910 BUENO BRANDAO",0,0,3,92,0,95,"2013"
"19108","310920 BUENOPOLIS",2,1,3,117,1,124,"2013"
"19109","310925 BUGRE",0,0,0,52,0,52,"2013"
"19110","310930 BURITIS",1,3,4,317,4,329,"2013"
"19111","310940 BURITIZEIRO",2,6,6,336,4,354,"2013"
"19112","310945 CABECEIRA GRANDE",0,0,1,77,5,83,"2013"
"19113","310950 CABO VERDE",0,0,1,159,0,160,"2013"
"19114","310960 CACHOEIRA DA PRATA",0,0,2,44,0,46,"2013"
"19115","310970 CACHOEIRA DE MINAS",0,1,0,115,0,116,"2013"
"19116","310980 CACHOEIRA DOURADA",0,0,1,30,1,32,"2013"
"19117","310990 CAETANOPOLIS",0,0,1,93,1,95,"2013"
"19118","311000 CAETE",2,1,10,492,24,529,"2013"
"19119","311010 CAIANA",0,0,1,48,0,49,"2013"
"19120","311020 CAJURI",0,0,0,42,2,44,"2013"
"19121","311030 CALDAS",0,0,2,101,0,103,"2013"
"19122","311040 CAMACHO",0,0,0,30,0,30,"2013"
"19123","311050 CAMANDUCAIA",0,1,3,237,10,251,"2013"
"19124","311060 CAMBUI",0,1,5,337,1,344,"2013"
"19125","311070 CAMBUQUIRA",2,2,2,137,0,143,"2013"
"19126","311080 CAMPANARIO",0,0,1,31,0,32,"2013"
"19127","311090 CAMPANHA",0,1,6,162,0,169,"2013"
"19128","311100 CAMPESTRE",0,2,2,193,0,197,"2013"
"19129","311110 CAMPINA VERDE",1,0,1,195,2,199,"2013"
"19130","311115 CAMPO AZUL",0,0,1,47,1,49,"2013"
"19131","311120 CAMPO BELO",2,1,12,593,0,608,"2013"
"19132","311130 CAMPO DO MEIO",1,0,1,127,0,129,"2013"
"19133","311140 CAMPO FLORIDO",0,0,2,93,3,98,"2013"
"19134","311150 CAMPOS ALTOS",1,2,2,191,1,197,"2013"
"19135","311160 CAMPOS GERAIS",0,1,7,315,5,328,"2013"
"19136","311170 CANAA",0,0,0,65,1,66,"2013"
"19137","311180 CANAPOLIS",0,0,1,119,12,132,"2013"
"19138","311190 CANA VERDE",0,0,0,59,0,59,"2013"
"19139","311200 CANDEIAS",0,0,5,137,0,142,"2013"
"19140","311205 CANTAGALO",0,0,0,37,0,37,"2013"
"19141","311210 CAPARAO",0,0,1,56,1,58,"2013"
"19142","311220 CAPELA NOVA",0,0,0,38,0,38,"2013"
"19143","311230 CAPELINHA",0,2,17,562,1,582,"2013"
"19144","311240 CAPETINGA",1,1,7,70,0,79,"2013"
"19145","311250 CAPIM BRANCO",0,0,3,109,2,114,"2013"
"19146","311260 CAPINOPOLIS",0,0,3,164,3,170,"2013"
"19147","311265 CAPITAO ANDRADE",0,0,0,56,0,56,"2013"
"19148","311270 CAPITAO ENEAS",0,2,8,179,1,190,"2013"
"19149","311280 CAPITOLIO",0,0,2,75,8,85,"2013"
"19150","311290 CAPUTIRA",1,0,1,21,92,115,"2013"
"19151","311300 CARAI",1,0,8,260,3,272,"2013"
"19152","311310 CARANAIBA",0,0,0,23,0,23,"2013"
"19153","311320 CARANDAI",1,0,2,306,2,311,"2013"
"19154","311330 CARANGOLA",0,0,5,403,3,411,"2013"
"19155","311340 CARATINGA",5,8,12,996,13,1034,"2013"
"19156","311350 CARBONITA",1,0,3,90,0,94,"2013"
"19157","311360 CAREACU",0,0,2,100,1,103,"2013"
"19158","311370 CARLOS CHAGAS",0,0,1,222,0,223,"2013"
"19159","311380 CARMESIA",2,0,0,25,0,27,"2013"
"19160","311390 CARMO DA CACHOEIRA",0,1,2,127,3,133,"2013"
"19161","311400 CARMO DA MATA",0,1,1,89,1,92,"2013"
"19162","311410 CARMO DE MINAS",0,0,3,154,0,157,"2013"
"19163","311420 CARMO DO CAJURU",1,2,6,258,1,268,"2013"
"19164","311430 CARMO DO PARANAIBA",0,3,3,341,0,347,"2013"
"19165","311440 CARMO DO RIO CLARO",0,2,2,195,1,200,"2013"
"19166","311450 CARMOPOLIS DE MINAS",0,0,2,187,6,195,"2013"
"19167","311455 CARNEIRINHO",0,0,1,92,1,94,"2013"
"19168","311460 CARRANCAS",0,0,0,48,0,48,"2013"
"19169","311470 CARVALHOPOLIS",0,0,2,45,0,47,"2013"
"19170","311480 CARVALHOS",1,0,1,42,0,44,"2013"
"19171","311490 CASA GRANDE",0,0,0,19,0,19,"2013"
"19172","311500 CASCALHO RICO",0,0,0,26,0,26,"2013"
"19173","311510 CASSIA",0,1,33,182,1,217,"2013"
"19174","311520 CONCEICAO DA BARRA DE MINAS",0,0,1,27,0,28,"2013"
"19175","311530 CATAGUASES",3,5,35,695,3,741,"2013"
"19176","311535 CATAS ALTAS",0,0,1,63,2,66,"2013"
"19177","311540 CATAS ALTAS DA NORUEGA",0,0,0,27,0,27,"2013"
"19178","311545 CATUJI",1,0,2,127,1,131,"2013"
"19179","311547 CATUTI",0,1,1,53,11,66,"2013"
"19180","311550 CAXAMBU",0,1,1,162,77,241,"2013"
"19181","311560 CEDRO DO ABAETE",0,0,0,12,0,12,"2013"
"19182","311570 CENTRAL DE MINAS",0,0,1,80,1,82,"2013"
"19183","311580 CENTRALINA",0,0,0,78,4,82,"2013"
"19184","311590 CHACARA",0,0,1,23,0,24,"2013"
"19185","311600 CHALE",0,0,0,40,26,66,"2013"
"19186","311610 CHAPADA DO NORTE",0,1,0,127,1,129,"2013"
"19187","311615 CHAPADA GAUCHA",1,2,3,179,2,187,"2013"
"19188","311620 CHIADOR",0,0,1,18,0,19,"2013"
"19189","311630 CIPOTANEA",0,0,0,50,1,51,"2013"
"19190","311640 CLARAVAL",0,0,0,12,0,12,"2013"
"19191","311650 CLARO DOS POCOES",0,0,2,70,0,72,"2013"
"19192","311660 CLAUDIO",0,1,3,363,1,368,"2013"
"19193","311670 COIMBRA",0,0,1,73,4,78,"2013"
"19194","311680 COLUNA",0,0,4,105,0,109,"2013"
"19195","311690 COMENDADOR GOMES",0,0,1,19,1,21,"2013"
"19196","311700 COMERCINHO",1,2,4,71,5,83,"2013"
"19197","311710 CONCEICAO DA APARECIDA",0,2,3,95,1,101,"2013"
"19198","311720 CONCEICAO DAS PEDRAS",0,0,0,37,0,37,"2013"
"19199","311730 CONCEICAO DAS ALAGOAS",0,1,0,374,6,381,"2013"
"19200","311740 CONCEICAO DE IPANEMA",0,0,0,42,8,50,"2013"
"19201","311750 CONCEICAO DO MATO DENTRO",0,3,5,230,2,240,"2013"
"19202","311760 CONCEICAO DO PARA",1,0,0,37,23,61,"2013"
"19203","311770 CONCEICAO DO RIO VERDE",0,2,3,145,1,151,"2013"
"19204","311780 CONCEICAO DOS OUROS",0,0,1,117,3,121,"2013"
"19205","311783 CONEGO MARINHO",0,0,1,72,2,75,"2013"
"19206","311787 CONFINS",0,0,0,84,2,86,"2013"
"19207","311790 CONGONHAL",0,0,4,98,0,102,"2013"
"19208","311800 CONGONHAS",0,2,7,657,3,669,"2013"
"19209","311810 CONGONHAS DO NORTE",0,0,2,50,1,53,"2013"
"19210","311820 CONQUISTA",0,0,0,68,5,73,"2013"
"19211","311830 CONSELHEIRO LAFAIETE",3,3,11,1598,2,1617,"2013"
"19212","311840 CONSELHEIRO PENA",2,2,5,248,3,260,"2013"
"19213","311850 CONSOLACAO",0,0,0,21,0,21,"2013"
"19214","311860 CONTAGEM",37,39,145,8520,45,8786,"2013"
"19215","311870 COQUEIRAL",0,0,0,33,66,99,"2013"
"19216","311880 CORACAO DE JESUS",1,0,2,261,9,273,"2013"
"19217","311890 CORDISBURGO",0,0,0,55,1,56,"2013"
"19218","311900 CORDISLANDIA",0,0,0,31,0,31,"2013"
"19219","311910 CORINTO",1,1,6,254,0,262,"2013"
"19220","311920 COROACI",0,0,0,70,4,74,"2013"
"19221","311930 COROMANDEL",1,1,7,278,0,287,"2013"
"19222","311940 CORONEL FABRICIANO",1,5,15,1361,13,1395,"2013"
"19223","311950 CORONEL MURTA",0,0,2,85,5,92,"2013"
"19224","311960 CORONEL PACHECO",0,1,2,27,0,30,"2013"
"19225","311970 CORONEL XAVIER CHAVES",0,1,1,44,1,47,"2013"
"19226","311980 CORREGO DANTA",0,0,1,22,0,23,"2013"
"19227","311990 CORREGO DO BOM JESUS",0,0,0,25,0,25,"2013"
"19228","311995 CORREGO FUNDO",1,0,0,64,0,65,"2013"
"19229","312000 CORREGO NOVO",1,1,3,38,1,44,"2013"
"19230","312010 COUTO DE MAGALHAES DE MINAS",0,0,0,55,0,55,"2013"
"19231","312015 CRISOLITA",0,0,1,73,4,78,"2013"
"19232","312020 CRISTAIS",1,1,0,115,0,117,"2013"
"19233","312030 CRISTALIA",0,3,4,111,2,120,"2013"
"19234","312040 CRISTIANO OTONI",0,0,0,64,1,65,"2013"
"19235","312050 CRISTINA",0,0,1,101,0,102,"2013"
"19236","312060 CRUCILANDIA",0,0,2,35,2,39,"2013"
"19237","312070 CRUZEIRO DA FORTALEZA",0,1,0,50,0,51,"2013"
"19238","312080 CRUZILIA",0,0,1,192,0,193,"2013"
"19239","312083 CUPARAQUE",0,0,0,69,1,70,"2013"
"19240","312087 CURRAL DE DENTRO",0,0,2,97,11,110,"2013"
"19241","312090 CURVELO",5,5,26,941,4,981,"2013"
"19242","312100 DATAS",0,1,1,73,0,75,"2013"
"19243","312110 DELFIM MOREIRA",0,1,1,75,0,77,"2013"
"19244","312120 DELFINOPOLIS",0,0,6,63,0,69,"2013"
"19245","312125 DELTA",1,0,6,120,2,129,"2013"
"19246","312130 DESCOBERTO",0,0,1,39,1,41,"2013"
"19247","312140 DESTERRO DE ENTRE RIOS",0,0,4,67,0,71,"2013"
"19248","312150 DESTERRO DO MELO",0,0,1,25,0,26,"2013"
"19249","312160 DIAMANTINA",3,6,11,653,2,675,"2013"
"19250","312170 DIOGO DE VASCONCELOS",0,0,0,40,0,40,"2013"
"19251","312180 DIONISIO",0,1,0,54,0,55,"2013"
"19252","312190 DIVINESIA",0,0,0,47,0,47,"2013"
"19253","312200 DIVINO",0,4,1,267,1,273,"2013"
"19254","312210 DIVINO DAS LARANJEIRAS",0,0,2,52,3,57,"2013"
"19255","312220 DIVINOLANDIA DE MINAS",0,0,2,95,0,97,"2013"
"19256","312230 DIVINOPOLIS",5,10,68,2576,7,2666,"2013"
"19257","312235 DIVISA ALEGRE",0,0,4,79,0,83,"2013"
"19258","312240 DIVISA NOVA",0,0,0,75,1,76,"2013"
"19259","312245 DIVISOPOLIS",0,0,2,75,1,78,"2013"
"19260","312247 DOM BOSCO",0,0,0,43,2,45,"2013"
"19261","312250 DOM CAVATI",0,0,0,63,1,64,"2013"
"19262","312260 DOM JOAQUIM",0,0,2,57,0,59,"2013"
"19263","312270 DOM SILVERIO",0,1,0,39,0,40,"2013"
"19264","312280 DOM VICOSO",0,0,1,27,1,29,"2013"
"19265","312290 DONA EUSEBIA",1,3,4,76,0,84,"2013"
"19266","312300 DORES DE CAMPOS",0,0,1,82,0,83,"2013"
"19267","312310 DORES DE GUANHAES",0,0,1,63,1,65,"2013"
"19268","312320 DORES DO INDAIA",0,2,1,104,1,108,"2013"
"19269","312330 DORES DO TURVO",1,0,1,26,1,29,"2013"
"19270","312340 DORESOPOLIS",0,0,0,12,0,12,"2013"
"19271","312350 DOURADOQUARA",0,0,1,18,0,19,"2013"
"19272","312352 DURANDE",0,0,0,55,46,101,"2013"
"19273","312360 ELOI MENDES",1,0,2,311,4,318,"2013"
"19274","312370 ENGENHEIRO CALDAS",2,2,1,125,5,135,"2013"
"19275","312380 ENGENHEIRO NAVARRO",0,0,0,77,1,78,"2013"
"19276","312385 ENTRE FOLHAS",1,0,0,60,1,62,"2013"
"19277","312390 ENTRE RIOS DE MINAS",1,1,3,141,0,146,"2013"
"19278","312400 ERVALIA",0,2,5,208,2,217,"2013"
"19279","312410 ESMERALDAS",5,5,17,918,14,959,"2013"
"19280","312420 ESPERA FELIZ",0,1,4,324,3,332,"2013"
"19281","312430 ESPINOSA",0,1,3,402,15,421,"2013"
"19282","312440 ESPIRITO SANTO DO DOURADO",0,0,1,57,0,58,"2013"
"19283","312450 ESTIVA",0,0,2,109,0,111,"2013"
"19284","312460 ESTRELA DALVA",0,1,0,31,0,32,"2013"
"19285","312470 ESTRELA DO INDAIA",0,0,0,25,0,25,"2013"
"19286","312480 ESTRELA DO SUL",0,0,3,90,0,93,"2013"
"19287","312490 EUGENOPOLIS",0,0,0,83,1,84,"2013"
"19288","312500 EWBANK DA CAMARA",0,0,2,40,1,43,"2013"
"19289","312510 EXTREMA",1,0,2,523,5,531,"2013"
"19290","312520 FAMA",0,0,1,22,0,23,"2013"
"19291","312530 FARIA LEMOS",0,0,1,39,1,41,"2013"
"19292","312540 FELICIO DOS SANTOS",0,0,1,57,1,59,"2013"
"19293","312550 SAO GONCALO DO RIO PRETO",0,0,0,20,0,20,"2013"
"19294","312560 FELISBURGO",0,0,2,101,0,103,"2013"
"19295","312570 FELIXLANDIA",0,2,3,140,0,145,"2013"
"19296","312580 FERNANDES TOURINHO",3,0,0,28,1,32,"2013"
"19297","312590 FERROS",1,2,1,74,0,78,"2013"
"19298","312595 FERVEDOURO",0,1,3,128,1,133,"2013"
"19299","312600 FLORESTAL",0,0,1,65,1,67,"2013"
"19300","312610 FORMIGA",0,3,6,730,0,739,"2013"
"19301","312620 FORMOSO",0,2,2,83,0,87,"2013"
"19302","312630 FORTALEZA DE MINAS",0,0,0,51,0,51,"2013"
"19303","312640 FORTUNA DE MINAS",0,0,0,25,0,25,"2013"
"19304","312650 FRANCISCO BADARO",0,2,0,69,1,72,"2013"
"19305","312660 FRANCISCO DUMONT",0,0,2,46,3,51,"2013"
"19306","312670 FRANCISCO SA",1,2,6,261,0,270,"2013"
"19307","312675 FRANCISCOPOLIS",1,0,1,44,0,46,"2013"
"19308","312680 FREI GASPAR",0,1,0,79,0,80,"2013"
"19309","312690 FREI INOCENCIO",2,0,0,116,8,126,"2013"
"19310","312695 FREI LAGONEGRO",0,0,1,44,1,46,"2013"
"19311","312700 FRONTEIRA",2,3,4,159,0,168,"2013"
"19312","312705 FRONTEIRA DOS VALES",0,2,1,59,0,62,"2013"
"19313","312707 FRUTA DE LEITE",0,1,0,7,54,62,"2013"
"19314","312710 FRUTAL",2,2,21,652,6,683,"2013"
"19315","312720 FUNILANDIA",0,0,1,44,0,45,"2013"
"19316","312730 GALILEIA",2,0,2,76,1,81,"2013"
"19317","312733 GAMELEIRAS",0,0,5,37,26,68,"2013"
"19318","312735 GLAUCILANDIA",0,0,0,30,0,30,"2013"
"19319","312737 GOIABEIRA",0,0,2,38,1,41,"2013"
"19320","312738 GOIANA",0,0,0,26,0,26,"2013"
"19321","312740 GONCALVES",0,0,0,39,0,39,"2013"
"19322","312750 GONZAGA",0,0,0,90,0,90,"2013"
"19323","312760 GOUVEIA",0,1,2,136,0,139,"2013"
"19324","312770 GOVERNADOR VALADARES",29,12,60,3552,96,3749,"2013"
"19325","312780 GRAO MOGOL",1,0,0,164,17,182,"2013"
"19326","312790 GRUPIARA",0,0,0,8,0,8,"2013"
"19327","312800 GUANHAES",0,2,7,396,4,409,"2013"
"19328","312810 GUAPE",0,0,2,143,1,146,"2013"
"19329","312820 GUARACIABA",1,2,1,82,2,88,"2013"
"19330","312825 GUARACIAMA",0,1,1,59,1,62,"2013"
"19331","312830 GUARANESIA",1,1,4,158,45,209,"2013"
"19332","312840 GUARANI",1,0,2,120,0,123,"2013"
"19333","312850 GUARARA",0,0,1,47,0,48,"2013"
"19334","312860 GUARDA-MOR",0,0,2,67,0,69,"2013"
"19335","312870 GUAXUPE",4,13,29,540,7,593,"2013"
"19336","312880 GUIDOVAL",0,0,1,95,0,96,"2013"
"19337","312890 GUIMARANIA",1,0,0,81,0,82,"2013"
"19338","312900 GUIRICEMA",1,0,2,67,1,71,"2013"
"19339","312910 GURINHATA",0,0,0,43,0,43,"2013"
"19340","312920 HELIODORA",1,0,1,52,1,55,"2013"
"19341","312930 IAPU",0,0,0,118,1,119,"2013"
"19342","312940 IBERTIOGA",0,0,0,59,1,60,"2013"
"19343","312950 IBIA",1,3,3,273,0,280,"2013"
"19344","312960 IBIAI",0,0,2,105,3,110,"2013"
"19345","312965 IBIRACATU",1,1,0,71,1,74,"2013"
"19346","312970 IBIRACI",1,1,5,157,0,164,"2013"
"19347","312980 IBIRITE",10,8,49,2600,7,2674,"2013"
"19348","312990 IBITIURA DE MINAS",0,0,0,35,0,35,"2013"
"19349","313000 IBITURUNA",0,0,0,31,2,33,"2013"
"19350","313005 ICARAI DE MINAS",0,1,2,135,0,138,"2013"
"19351","313010 IGARAPE",3,2,17,587,7,616,"2013"
"19352","313020 IGARATINGA",4,0,2,140,6,152,"2013"
"19353","313030 IGUATAMA",0,0,1,62,0,63,"2013"
"19354","313040 IJACI",0,0,2,71,0,73,"2013"
"19355","313050 ILICINEA",1,0,2,151,7,161,"2013"
"19356","313055 IMBE DE MINAS",2,1,1,72,0,76,"2013"
"19357","313060 INCONFIDENTES",2,0,1,56,0,59,"2013"
"19358","313065 INDAIABIRA",0,0,1,74,2,77,"2013"
"19359","313070 INDIANOPOLIS",0,0,1,80,2,83,"2013"
"19360","313080 INGAI",0,0,0,29,0,29,"2013"
"19361","313090 INHAPIM",0,0,7,263,3,273,"2013"
"19362","313100 INHAUMA",0,0,2,65,0,67,"2013"
"19363","313110 INIMUTABA",0,0,2,69,1,72,"2013"
"19364","313115 IPABA",0,0,1,249,0,250,"2013"
"19365","313120 IPANEMA",2,4,4,225,23,258,"2013"
"19366","313130 IPATINGA",8,8,30,3213,24,3283,"2013"
"19367","313140 IPIACU",0,0,0,27,0,27,"2013"
"19368","313150 IPUIUNA",1,0,0,87,3,91,"2013"
"19369","313160 IRAI DE MINAS",0,1,0,87,0,88,"2013"
"19370","313170 ITABIRA",4,4,10,1589,27,1634,"2013"
"19371","313180 ITABIRINHA",0,0,2,104,1,107,"2013"
"19372","313190 ITABIRITO",0,2,14,678,2,696,"2013"
"19373","313200 ITACAMBIRA",0,0,1,51,1,53,"2013"
"19374","313210 ITACARAMBI",0,1,6,327,3,337,"2013"
"19375","313220 ITAGUARA",0,1,4,134,1,140,"2013"
"19376","313230 ITAIPE",0,1,3,184,3,191,"2013"
"19377","313240 ITAJUBA",1,4,9,1263,2,1279,"2013"
"19378","313250 ITAMARANDIBA",1,3,5,467,2,478,"2013"
"19379","313260 ITAMARATI DE MINAS",0,0,4,41,0,45,"2013"
"19380","313270 ITAMBACURI",0,2,5,396,6,409,"2013"
"19381","313280 ITAMBE DO MATO DENTRO",0,1,0,12,0,13,"2013"
"19382","313290 ITAMOGI",0,0,1,129,1,131,"2013"
"19383","313300 ITAMONTE",0,0,3,161,8,172,"2013"
"19384","313310 ITANHANDU",0,0,4,196,2,202,"2013"
"19385","313320 ITANHOMI",1,0,3,165,2,171,"2013"
"19386","313330 ITAOBIM",0,0,0,252,0,252,"2013"
"19387","313340 ITAPAGIPE",0,0,1,125,1,127,"2013"
"19388","313350 ITAPECERICA",0,1,3,162,1,167,"2013"
"19389","313360 ITAPEVA",0,0,0,119,0,119,"2013"
"19390","313370 ITATIAIUCU",0,0,0,151,0,151,"2013"
"19391","313375 ITAU DE MINAS",0,1,3,175,0,179,"2013"
"19392","313380 ITAUNA",2,6,4,1115,5,1132,"2013"
"19393","313390 ITAVERAVA",0,0,0,56,4,60,"2013"
"19394","313400 ITINGA",0,1,1,161,2,165,"2013"
"19395","313410 ITUETA",0,1,2,78,1,82,"2013"
"19396","313420 ITUIUTABA",4,1,10,1169,24,1208,"2013"
"19397","313430 ITUMIRIM",0,0,1,67,0,68,"2013"
"19398","313440 ITURAMA",0,3,1,504,0,508,"2013"
"19399","313450 ITUTINGA",0,1,2,47,0,50,"2013"
"19400","313460 JABOTICATUBAS",0,2,2,179,1,184,"2013"
"19401","313470 JACINTO",0,3,7,119,1,130,"2013"
"19402","313480 JACUI",0,1,1,85,0,87,"2013"
"19403","313490 JACUTINGA",0,1,3,285,2,291,"2013"
"19404","313500 JAGUARACU",0,1,0,38,0,39,"2013"
"19405","313505 JAIBA",1,4,27,537,5,574,"2013"
"19406","313507 JAMPRUCA",0,0,0,62,3,65,"2013"
"19407","313510 JANAUBA",7,1,44,963,2,1017,"2013"
"19408","313520 JANUARIA",3,2,7,973,28,1013,"2013"
"19409","313530 JAPARAIBA",0,0,0,41,0,41,"2013"
"19410","313535 JAPONVAR",0,0,2,111,0,113,"2013"
"19411","313540 JECEABA",0,0,1,37,0,38,"2013"
"19412","313545 JENIPAPO DE MINAS",0,0,3,80,2,85,"2013"
"19413","313550 JEQUERI",0,1,3,95,1,100,"2013"
"19414","313560 JEQUITAI",0,0,3,80,0,83,"2013"
"19415","313570 JEQUITIBA",0,0,0,57,0,57,"2013"
"19416","313580 JEQUITINHONHA",1,2,4,236,34,277,"2013"
"19417","313590 JESUANIA",0,0,4,48,0,52,"2013"
"19418","313600 JOAIMA",1,0,1,135,61,198,"2013"
"19419","313610 JOANESIA",0,0,0,36,0,36,"2013"
"19420","313620 JOAO MONLEVADE",12,3,8,976,3,1002,"2013"
"19421","313630 JOAO PINHEIRO",1,7,5,595,5,613,"2013"
"19422","313640 JOAQUIM FELICIO",1,0,0,30,2,33,"2013"
"19423","313650 JORDANIA",1,0,0,93,9,103,"2013"
"19424","313652 JOSE GONCALVES DE MINAS",3,0,0,62,1,66,"2013"
"19425","313655 JOSE RAYDAN",0,0,2,63,0,65,"2013"
"19426","313657 JOSENOPOLIS",0,0,0,33,25,58,"2013"
"19427","313660 NOVA UNIAO",0,0,0,57,1,58,"2013"
"19428","313665 JUATUBA",0,2,3,353,3,361,"2013"
"19429","313670 JUIZ DE FORA",54,25,93,6299,24,6495,"2013"
"19430","313680 JURAMENTO",0,0,3,46,0,49,"2013"
"19431","313690 JURUAIA",0,0,1,128,0,129,"2013"
"19432","313695 JUVENILIA",0,0,0,26,44,70,"2013"
"19433","313700 LADAINHA",1,0,2,180,9,192,"2013"
"19434","313710 LAGAMAR",0,0,1,51,0,52,"2013"
"19435","313720 LAGOA DA PRATA",2,0,2,500,5,509,"2013"
"19436","313730 LAGOA DOS PATOS",0,1,1,40,1,43,"2013"
"19437","313740 LAGOA DOURADA",0,1,2,146,3,152,"2013"
"19438","313750 LAGOA FORMOSA",0,0,2,167,0,169,"2013"
"19439","313753 LAGOA GRANDE",0,1,2,92,2,97,"2013"
"19440","313760 LAGOA SANTA",3,5,9,714,1,732,"2013"
"19441","313770 LAJINHA",1,5,2,170,62,240,"2013"
"19442","313780 LAMBARI",1,0,3,199,0,203,"2013"
"19443","313790 LAMIM",0,0,0,31,0,31,"2013"
"19444","313800 LARANJAL",0,0,0,34,0,34,"2013"
"19445","313810 LASSANCE",2,0,1,66,1,70,"2013"
"19446","313820 LAVRAS",3,5,22,1416,6,1452,"2013"
"19447","313830 LEANDRO FERREIRA",0,0,0,34,5,39,"2013"
"19448","313835 LEME DO PRADO",0,0,0,53,0,53,"2013"
"19449","313840 LEOPOLDINA",0,4,14,575,0,593,"2013"
"19450","313850 LIBERDADE",0,0,1,29,0,30,"2013"
"19451","313860 LIMA DUARTE",0,0,7,167,1,175,"2013"
"19452","313862 LIMEIRA DO OESTE",0,0,1,79,0,80,"2013"
"19453","313865 LONTRA",0,0,3,93,0,96,"2013"
"19454","313867 LUISBURGO",0,0,0,16,80,96,"2013"
"19455","313868 LUISLANDIA",1,0,0,66,0,67,"2013"
"19456","313870 LUMINARIAS",0,0,0,45,0,45,"2013"
"19457","313880 LUZ",1,1,4,181,0,187,"2013"
"19458","313890 MACHACALIS",1,0,5,84,0,90,"2013"
"19459","313900 MACHADO",2,3,6,408,1,420,"2013"
"19460","313910 MADRE DE DEUS DE MINAS",0,0,1,46,0,47,"2013"
"19461","313920 MALACACHETA",0,4,2,214,4,224,"2013"
"19462","313925 MAMONAS",0,0,1,19,24,44,"2013"
"19463","313930 MANGA",0,1,2,236,86,325,"2013"
"19464","313940 MANHUACU",3,1,4,239,1066,1313,"2013"
"19465","313950 MANHUMIRIM",1,0,2,219,51,273,"2013"
"19466","313960 MANTENA",1,1,7,299,1,309,"2013"
"19467","313970 MARAVILHAS",1,1,1,79,2,84,"2013"
"19468","313980 MAR DE ESPANHA",1,0,4,107,0,112,"2013"
"19469","313990 MARIA DA FE",0,1,3,191,1,196,"2013"
"19470","314000 MARIANA",2,6,13,867,24,912,"2013"
"19471","314010 MARILAC",0,0,0,52,2,54,"2013"
"19472","314015 MARIO CAMPOS",0,0,4,233,1,238,"2013"
"19473","314020 MARIPA DE MINAS",0,1,0,28,0,29,"2013"
"19474","314030 MARLIERIA",1,0,1,43,0,45,"2013"
"19475","314040 MARMELOPOLIS",0,0,3,28,0,31,"2013"
"19476","314050 MARTINHO CAMPOS",0,0,2,113,14,129,"2013"
"19477","314053 MARTINS SOARES",0,0,1,57,57,115,"2013"
"19478","314055 MATA VERDE",0,0,2,77,0,79,"2013"
"19479","314060 MATERLANDIA",0,0,0,42,0,42,"2013"
"19480","314070 MATEUS LEME",0,0,0,412,3,415,"2013"
"19481","314080 MATIAS BARBOSA",3,0,2,152,1,158,"2013"
"19482","314085 MATIAS CARDOSO",0,0,5,118,16,139,"2013"
"19483","314090 MATIPO",0,0,5,149,131,285,"2013"
"19484","314100 MATO VERDE",0,1,2,103,6,112,"2013"
"19485","314110 MATOZINHOS",2,0,3,477,12,494,"2013"
"19486","314120 MATUTINA",0,1,0,29,1,31,"2013"
"19487","314130 MEDEIROS",0,0,1,35,0,36,"2013"
"19488","314140 MEDINA",0,1,5,254,1,261,"2013"
"19489","314150 MENDES PIMENTEL",0,1,0,61,1,63,"2013"
"19490","314160 MERCES",0,1,0,96,1,98,"2013"
"19491","314170 MESQUITA",0,0,1,73,1,75,"2013"
"19492","314180 MINAS NOVAS",1,1,2,339,8,351,"2013"
"19493","314190 MINDURI",0,0,0,39,1,40,"2013"
"19494","314200 MIRABELA",0,0,1,163,0,164,"2013"
"19495","314210 MIRADOURO",0,0,1,40,0,41,"2013"
"19496","314220 MIRAI",2,0,1,106,3,112,"2013"
"19497","314225 MIRAVANIA",0,0,0,30,13,43,"2013"
"19498","314230 MOEDA",0,0,1,36,1,38,"2013"
"19499","314240 MOEMA",0,0,2,78,0,80,"2013"
"19500","314250 MONJOLOS",0,1,0,23,0,24,"2013"
"19501","314260 MONSENHOR PAULO",0,0,2,82,0,84,"2013"
"19502","314270 MONTALVANIA",0,0,0,23,211,234,"2013"
"19503","314280 MONTE ALEGRE DE MINAS",1,2,1,127,77,208,"2013"
"19504","314290 MONTE AZUL",0,0,3,65,201,269,"2013"
"19505","314300 MONTE BELO",0,0,2,127,1,130,"2013"
"19506","314310 MONTE CARMELO",0,1,6,625,0,632,"2013"
"19507","314315 MONTE FORMOSO",0,1,0,49,5,55,"2013"
"19508","314320 MONTE SANTO DE MINAS",0,1,2,245,3,251,"2013"
"19509","314330 MONTES CLAROS",20,20,136,5576,18,5770,"2013"
"19510","314340 MONTE SIAO",1,0,0,203,0,204,"2013"
"19511","314345 MONTEZUMA",0,1,5,81,2,89,"2013"
"19512","314350 MORADA NOVA DE MINAS",0,0,1,89,4,94,"2013"
"19513","314360 MORRO DA GARCA",0,0,1,21,0,22,"2013"
"19514","314370 MORRO DO PILAR",0,0,0,29,1,30,"2013"
"19515","314380 MUNHOZ",0,0,2,58,0,60,"2013"
"19516","314390 MURIAE",9,10,37,1474,4,1534,"2013"
"19517","314400 MUTUM",0,1,3,292,29,325,"2013"
"19518","314410 MUZAMBINHO",1,1,3,246,0,251,"2013"
"19519","314420 NACIP RAYDAN",0,0,0,29,0,29,"2013"
"19520","314430 NANUQUE",0,2,7,515,1,525,"2013"
"19521","314435 NAQUE",0,0,0,95,2,97,"2013"
"19522","314437 NATALANDIA",0,0,0,37,0,37,"2013"
"19523","314440 NATERCIA",0,0,0,28,0,28,"2013"
"19524","314450 NAZARENO",0,0,1,81,1,83,"2013"
"19525","314460 NEPOMUCENO",0,0,4,263,1,268,"2013"
"19526","314465 NINHEIRA",1,0,6,103,0,110,"2013"
"19527","314467 NOVA BELEM",0,0,0,45,0,45,"2013"
"19528","314470 NOVA ERA",2,0,2,224,0,228,"2013"
"19529","314480 NOVA LIMA",5,1,24,1283,17,1330,"2013"
"19530","314490 NOVA MODICA",0,0,0,36,2,38,"2013"
"19531","314500 NOVA PONTE",0,1,1,176,0,178,"2013"
"19532","314505 NOVA PORTEIRINHA",0,0,7,100,0,107,"2013"
"19533","314510 NOVA RESENDE",0,0,6,199,3,208,"2013"
"19534","314520 NOVA SERRANA",3,3,21,1223,61,1311,"2013"
"19535","314530 NOVO CRUZEIRO",0,2,7,378,17,404,"2013"
"19536","314535 NOVO ORIENTE DE MINAS",0,1,3,118,7,129,"2013"
"19537","314537 NOVORIZONTE",0,0,1,31,34,66,"2013"
"19538","314540 OLARIA",0,0,0,16,0,16,"2013"
"19539","314545 OLHOS-D'AGUA",0,0,2,82,1,85,"2013"
"19540","314550 OLIMPIO NORONHA",0,0,0,26,0,26,"2013"
"19541","314560 OLIVEIRA",2,0,6,426,0,434,"2013"
"19542","314570 OLIVEIRA FORTES",0,0,0,13,0,13,"2013"
"19543","314580 ONCA DE PITANGUI",1,1,1,18,6,27,"2013"
"19544","314585 ORATORIOS",0,0,0,50,0,50,"2013"
"19545","314587 ORIZANIA",0,2,1,96,2,101,"2013"
"19546","314590 OURO BRANCO",1,3,2,511,5,522,"2013"
"19547","314600 OURO FINO",5,0,1,296,1,303,"2013"
"19548","314610 OURO PRETO",1,4,36,820,21,882,"2013"
"19549","314620 OURO VERDE DE MINAS",0,0,2,76,1,79,"2013"
"19550","314625 PADRE CARVALHO",0,0,0,13,67,80,"2013"
"19551","314630 PADRE PARAISO",2,1,4,277,0,284,"2013"
"19552","314640 PAINEIRAS",1,0,1,30,0,32,"2013"
"19553","314650 PAINS",0,0,0,62,0,62,"2013"
"19554","314655 PAI PEDRO",2,0,2,61,5,70,"2013"
"19555","314660 PAIVA",0,0,0,14,0,14,"2013"
"19556","314670 PALMA",1,1,0,44,0,46,"2013"
"19557","314675 PALMOPOLIS",0,1,2,56,0,59,"2013"
"19558","314690 PAPAGAIOS",0,1,3,169,20,193,"2013"
"19559","314700 PARACATU",5,3,23,1182,11,1224,"2013"
"19560","314710 PARA DE MINAS",17,3,9,1063,30,1122,"2013"
"19561","314720 PARAGUACU",2,1,4,234,2,243,"2013"
"19562","314730 PARAISOPOLIS",0,0,1,242,2,245,"2013"
"19563","314740 PARAOPEBA",2,1,4,332,2,341,"2013"
"19564","314750 PASSABEM",0,0,0,16,0,16,"2013"
"19565","314760 PASSA QUATRO",0,1,4,171,1,177,"2013"
"19566","314770 PASSA TEMPO",1,0,2,54,2,59,"2013"
"19567","314780 PASSA-VINTE",0,0,1,19,0,20,"2013"
"19568","314790 PASSOS",4,4,23,1349,7,1387,"2013"
"19569","314795 PATIS",0,0,1,55,0,56,"2013"
"19570","314800 PATOS DE MINAS",1,4,16,1669,0,1690,"2013"
"19571","314810 PATROCINIO",4,4,8,1225,0,1241,"2013"
"19572","314820 PATROCINIO DO MURIAE",0,0,0,40,0,40,"2013"
"19573","314830 PAULA CANDIDO",0,1,0,87,5,93,"2013"
"19574","314840 PAULISTAS",0,0,0,56,1,57,"2013"
"19575","314850 PAVAO",0,0,0,102,4,106,"2013"
"19576","314860 PECANHA",0,1,1,146,0,148,"2013"
"19577","314870 PEDRA AZUL",1,8,14,330,2,355,"2013"
"19578","314875 PEDRA BONITA",2,0,2,92,5,101,"2013"
"19579","314880 PEDRA DO ANTA",0,0,0,34,3,37,"2013"
"19580","314890 PEDRA DO INDAIA",0,0,0,30,0,30,"2013"
"19581","314900 PEDRA DOURADA",0,1,0,30,0,31,"2013"
"19582","314910 PEDRALVA",0,0,0,116,1,117,"2013"
"19583","314915 PEDRAS DE MARIA DA CRUZ",0,0,1,127,3,131,"2013"
"19584","314920 PEDRINOPOLIS",0,1,0,29,0,30,"2013"
"19585","314930 PEDRO LEOPOLDO",0,2,6,722,16,746,"2013"
"19586","314940 PEDRO TEIXEIRA",0,0,0,15,0,15,"2013"
"19587","314950 PEQUERI",0,0,3,36,0,39,"2013"
"19588","314960 PEQUI",1,0,1,47,0,49,"2013"
"19589","314970 PERDIGAO",0,0,2,141,21,164,"2013"
"19590","314980 PERDIZES",0,0,3,201,0,204,"2013"
"19591","314990 PERDOES",1,0,3,208,0,212,"2013"
"19592","314995 PERIQUITO",0,2,1,93,0,96,"2013"
"19593","315000 PESCADOR",0,1,0,31,0,32,"2013"
"19594","315010 PIAU",1,0,1,24,0,26,"2013"
"19595","315015 PIEDADE DE CARATINGA",0,0,0,125,0,125,"2013"
"19596","315020 PIEDADE DE PONTE NOVA",0,2,0,48,0,50,"2013"
"19597","315030 PIEDADE DO RIO GRANDE",0,0,0,33,0,33,"2013"
"19598","315040 PIEDADE DOS GERAIS",0,0,2,38,0,40,"2013"
"19599","315050 PIMENTA",0,0,2,71,0,73,"2013"
"19600","315053 PINGO-D'AGUA",0,0,1,62,0,63,"2013"
"19601","315057 PINTOPOLIS",0,0,0,76,4,80,"2013"
"19602","315060 PIRACEMA",0,0,0,63,1,64,"2013"
"19603","315070 PIRAJUBA",0,0,0,67,0,67,"2013"
"19604","315080 PIRANGA",1,1,1,156,1,160,"2013"
"19605","315090 PIRANGUCU",1,0,1,49,0,51,"2013"
"19606","315100 PIRANGUINHO",0,0,1,121,0,122,"2013"
"19607","315110 PIRAPETINGA",0,0,2,135,0,137,"2013"
"19608","315120 PIRAPORA",3,3,12,821,0,839,"2013"
"19609","315130 PIRAUBA",1,0,3,143,2,149,"2013"
"19610","315140 PITANGUI",2,2,3,147,183,337,"2013"
"19611","315150 PIUMHI",2,2,3,378,3,388,"2013"
"19612","315160 PLANURA",1,0,3,115,1,120,"2013"
"19613","315170 POCO FUNDO",1,0,0,157,0,158,"2013"
"19614","315180 POCOS DE CALDAS",1,8,70,1883,8,1970,"2013"
"19615","315190 POCRANE",0,0,0,62,27,89,"2013"
"19616","315200 POMPEU",2,1,3,402,3,411,"2013"
"19617","315210 PONTE NOVA",3,0,5,640,4,652,"2013"
"19618","315213 PONTO CHIQUE",1,0,0,57,0,58,"2013"
"19619","315217 PONTO DOS VOLANTES",0,0,2,143,4,149,"2013"
"19620","315220 PORTEIRINHA",2,1,9,461,0,473,"2013"
"19621","315230 PORTO FIRME",0,1,0,81,4,86,"2013"
"19622","315240 POTE",0,1,3,180,1,185,"2013"
"19623","315250 POUSO ALEGRE",1,8,29,1839,8,1885,"2013"
"19624","315260 POUSO ALTO",0,0,0,81,0,81,"2013"
"19625","315270 PRADOS",1,1,2,106,0,110,"2013"
"19626","315280 PRATA",2,1,3,319,3,328,"2013"
"19627","315290 PRATAPOLIS",0,0,0,86,0,86,"2013"
"19628","315300 PRATINHA",0,0,1,25,0,26,"2013"
"19629","315310 PRESIDENTE BERNARDES",0,0,0,37,3,40,"2013"
"19630","315320 PRESIDENTE JUSCELINO",0,0,0,39,0,39,"2013"
"19631","315330 PRESIDENTE KUBITSCHEK",0,1,0,35,0,36,"2013"
"19632","315340 PRESIDENTE OLEGARIO",0,1,2,186,0,189,"2013"
"19633","315350 ALTO JEQUITIBA",0,0,1,96,16,113,"2013"
"19634","315360 PRUDENTE DE MORAIS",0,1,1,143,0,145,"2013"
"19635","315370 QUARTEL GERAL",0,0,0,31,1,32,"2013"
"19636","315380 QUELUZITO",0,0,1,14,0,15,"2013"
"19637","315390 RAPOSOS",0,1,1,221,2,225,"2013"
"19638","315400 RAUL SOARES",1,0,2,219,0,222,"2013"
"19639","315410 RECREIO",0,0,0,95,0,95,"2013"
"19640","315415 REDUTO",0,0,0,20,64,84,"2013"
"19641","315420 RESENDE COSTA",0,0,0,139,0,139,"2013"
"19642","315430 RESPLENDOR",1,2,2,176,4,185,"2013"
"19643","315440 RESSAQUINHA",0,0,0,53,0,53,"2013"
"19644","315445 RIACHINHO",0,0,0,70,0,70,"2013"
"19645","315450 RIACHO DOS MACHADOS",4,1,4,117,1,127,"2013"
"19646","315460 RIBEIRAO DAS NEVES",11,21,65,4675,40,4812,"2013"
"19647","315470 RIBEIRAO VERMELHO",0,0,0,33,0,33,"2013"
"19648","315480 RIO ACIMA",0,0,2,123,2,127,"2013"
"19649","315490 RIO CASCA",1,1,2,177,2,183,"2013"
"19650","315500 RIO DOCE",0,0,0,18,0,18,"2013"
"19651","315510 RIO DO PRADO",0,0,5,65,1,71,"2013"
"19652","315520 RIO ESPERA",0,0,1,34,0,35,"2013"
"19653","315530 RIO MANSO",0,0,0,42,0,42,"2013"
"19654","315540 RIO NOVO",0,0,1,97,0,98,"2013"
"19655","315550 RIO PARANAIBA",0,0,2,133,0,135,"2013"
"19656","315560 RIO PARDO DE MINAS",3,2,5,378,4,392,"2013"
"19657","315570 RIO PIRACICABA",2,0,0,157,0,159,"2013"
"19658","315580 RIO POMBA",0,0,2,175,2,179,"2013"
"19659","315590 RIO PRETO",0,0,0,31,0,31,"2013"
"19660","315600 RIO VERMELHO",1,2,0,150,4,157,"2013"
"19661","315610 RITAPOLIS",0,0,0,39,0,39,"2013"
"19662","315620 ROCHEDO DE MINAS",0,0,1,28,0,29,"2013"
"19663","315630 RODEIRO",0,0,4,107,0,111,"2013"
"19664","315640 ROMARIA",0,0,0,40,0,40,"2013"
"19665","315645 ROSARIO DA LIMEIRA",0,0,0,29,0,29,"2013"
"19666","315650 RUBELITA",0,0,0,15,61,76,"2013"
"19667","315660 RUBIM",0,2,1,90,2,95,"2013"
"19668","315670 SABARA",7,12,28,1743,7,1797,"2013"
"19669","315680 SABINOPOLIS",0,1,7,187,2,197,"2013"
"19670","315690 SACRAMENTO",1,0,2,299,1,303,"2013"
"19671","315700 SALINAS",0,2,1,98,432,533,"2013"
"19672","315710 SALTO DA DIVISA",0,1,2,68,7,78,"2013"
"19673","315720 SANTA BARBARA",0,0,9,418,21,448,"2013"
"19674","315725 SANTA BARBARA DO LESTE",0,0,2,89,2,93,"2013"
"19675","315727 SANTA BARBARA DO MONTE VERDE",0,0,0,33,0,33,"2013"
"19676","315730 SANTA BARBARA DO TUGURIO",0,0,2,38,0,40,"2013"
"19677","315733 SANTA CRUZ DE MINAS",0,2,1,81,2,86,"2013"
"19678","315737 SANTA CRUZ DE SALINAS",0,1,0,11,28,40,"2013"
"19679","315740 SANTA CRUZ DO ESCALVADO",1,0,0,46,0,47,"2013"
"19680","315750 SANTA EFIGENIA DE MINAS",2,0,0,56,3,61,"2013"
"19681","315760 SANTA FE DE MINAS",0,0,1,51,2,54,"2013"
"19682","315765 SANTA HELENA DE MINAS",0,2,6,89,16,113,"2013"
"19683","315770 SANTA JULIANA",0,0,0,113,0,113,"2013"
"19684","315780 SANTA LUZIA",6,21,47,3156,7,3237,"2013"
"19685","315790 SANTA MARGARIDA",1,0,5,164,57,227,"2013"
"19686","315800 SANTA MARIA DE ITABIRA",1,1,3,143,2,150,"2013"
"19687","315810 SANTA MARIA DO SALTO",0,0,1,37,1,39,"2013"
"19688","315820 SANTA MARIA DO SUACUI",2,1,2,173,2,180,"2013"
"19689","315830 SANTANA DA VARGEM",1,0,0,17,61,79,"2013"
"19690","315840 SANTANA DE CATAGUASES",0,0,0,41,0,41,"2013"
"19691","315850 SANTANA DE PIRAPAMA",0,0,0,55,0,55,"2013"
"19692","315860 SANTANA DO DESERTO",0,0,0,45,1,46,"2013"
"19693","315870 SANTANA DO GARAMBEU",0,0,0,30,0,30,"2013"
"19694","315880 SANTANA DO JACARE",0,0,0,52,0,52,"2013"
"19695","315890 SANTANA DO MANHUACU",0,0,0,18,87,105,"2013"
"19696","315895 SANTANA DO PARAISO",0,0,5,490,6,501,"2013"
"19697","315900 SANTANA DO RIACHO",0,0,1,40,0,41,"2013"
"19698","315910 SANTANA DOS MONTES",0,0,0,31,0,31,"2013"
"19699","315920 SANTA RITA DE CALDAS",0,1,1,76,1,79,"2013"
"19700","315930 SANTA RITA DE JACUTINGA",1,0,0,39,1,41,"2013"
"19701","315935 SANTA RITA DE MINAS",0,0,1,103,2,106,"2013"
"19702","315940 SANTA RITA DE IBITIPOCA",0,1,5,34,0,40,"2013"
"19703","315950 SANTA RITA DO ITUETO",0,0,0,46,0,46,"2013"
"19704","315960 SANTA RITA DO SAPUCAI",1,0,9,542,0,552,"2013"
"19705","315970 SANTA ROSA DA SERRA",0,0,0,28,0,28,"2013"
"19706","315980 SANTA VITORIA",1,0,0,251,0,252,"2013"
"19707","315990 SANTO ANTONIO DO AMPARO",1,0,2,191,1,195,"2013"
"19708","316000 SANTO ANTONIO DO AVENTUREIRO",0,0,0,25,0,25,"2013"
"19709","316010 SANTO ANTONIO DO GRAMA",0,0,0,60,0,60,"2013"
"19710","316020 SANTO ANTONIO DO ITAMBE",0,0,1,37,2,40,"2013"
"19711","316030 SANTO ANTONIO DO JACINTO",0,2,10,115,0,127,"2013"
"19712","316040 SANTO ANTONIO DO MONTE",1,0,2,341,0,344,"2013"
"19713","316045 SANTO ANTONIO DO RETIRO",1,0,1,43,22,67,"2013"
"19714","316050 SANTO ANTONIO DO RIO ABAIXO",0,0,0,23,0,23,"2013"
"19715","316060 SANTO HIPOLITO",0,0,0,23,0,23,"2013"
"19716","316070 SANTOS DUMONT",1,2,9,491,7,510,"2013"
"19717","316080 SAO BENTO ABADE",0,2,3,59,0,64,"2013"
"19718","316090 SAO BRAS DO SUACUI",0,0,1,47,0,48,"2013"
"19719","316095 SAO DOMINGOS DAS DORES",0,0,1,70,0,71,"2013"
"19720","316100 SAO DOMINGOS DO PRATA",2,1,2,177,3,185,"2013"
"19721","316105 SAO FELIX DE MINAS",1,0,0,33,0,34,"2013"
"19722","316110 SAO FRANCISCO",4,2,7,838,13,864,"2013"
"19723","316120 SAO FRANCISCO DE PAULA",0,0,0,65,1,66,"2013"
"19724","316130 SAO FRANCISCO DE SALES",0,0,1,73,1,75,"2013"
"19725","316140 SAO FRANCISCO DO GLORIA",0,0,1,33,1,35,"2013"
"19726","316150 SAO GERALDO",0,0,0,81,2,83,"2013"
"19727","316160 SAO GERALDO DA PIEDADE",1,0,1,53,4,59,"2013"
"19728","316165 SAO GERALDO DO BAIXIO",0,1,0,34,1,36,"2013"
"19729","316170 SAO GONCALO DO ABAETE",0,0,0,58,1,59,"2013"
"19730","316180 SAO GONCALO DO PARA",0,0,2,138,1,141,"2013"
"19731","316190 SAO GONCALO DO RIO ABAIXO",2,0,1,132,0,135,"2013"
"19732","316200 SAO GONCALO DO SAPUCAI",0,0,9,356,2,367,"2013"
"19733","316210 SAO GOTARDO",1,2,5,541,2,551,"2013"
"19734","316220 SAO JOAO BATISTA DO GLORIA",0,0,1,77,0,78,"2013"
"19735","316225 SAO JOAO DA LAGOA",0,0,1,52,1,54,"2013"
"19736","316230 SAO JOAO DA MATA",0,0,0,31,0,31,"2013"
"19737","316240 SAO JOAO DA PONTE",2,1,10,293,3,309,"2013"
"19738","316245 SAO JOAO DAS MISSOES",0,1,2,169,83,255,"2013"
"19739","316250 SAO JOAO DEL REI",3,2,10,967,16,998,"2013"
"19740","316255 SAO JOAO DO MANHUACU",0,0,0,80,78,158,"2013"
"19741","316257 SAO JOAO DO MANTENINHA",0,0,3,66,0,69,"2013"
"19742","316260 SAO JOAO DO ORIENTE",0,0,0,79,0,79,"2013"
"19743","316265 SAO JOAO DO PACUI",0,0,0,44,1,45,"2013"
"19744","316270 SAO JOAO DO PARAISO",2,0,2,274,4,282,"2013"
"19745","316280 SAO JOAO EVANGELISTA",0,1,1,178,2,182,"2013"
"19746","316290 SAO JOAO NEPOMUCENO",1,0,6,249,0,256,"2013"
"19747","316292 SAO JOAQUIM DE BICAS",1,1,8,364,4,378,"2013"
"19748","316294 SAO JOSE DA BARRA",0,0,4,74,0,78,"2013"
"19749","316295 SAO JOSE DA LAPA",1,2,5,312,2,322,"2013"
"19750","316300 SAO JOSE DA SAFIRA",0,0,3,47,6,56,"2013"
"19751","316310 SAO JOSE DA VARGINHA",0,0,0,32,1,33,"2013"
"19752","316320 SAO JOSE DO ALEGRE",0,0,0,45,0,45,"2013"
"19753","316330 SAO JOSE DO DIVINO",0,1,0,41,1,43,"2013"
"19754","316340 SAO JOSE DO GOIABAL",0,1,1,59,0,61,"2013"
"19755","316350 SAO JOSE DO JACURI",0,0,0,47,1,48,"2013"
"19756","316360 SAO JOSE DO MANTIMENTO",0,0,0,22,12,34,"2013"
"19757","316370 SAO LOURENCO",0,2,5,507,1,515,"2013"
"19758","316380 SAO MIGUEL DO ANTA",1,0,0,59,2,62,"2013"
"19759","316390 SAO PEDRO DA UNIAO",1,0,0,46,0,47,"2013"
"19760","316400 SAO PEDRO DOS FERROS",0,0,2,96,0,98,"2013"
"19761","316410 SAO PEDRO DO SUACUI",1,0,0,63,0,64,"2013"
"19762","316420 SAO ROMAO",1,2,6,104,0,113,"2013"
"19763","316430 SAO ROQUE DE MINAS",0,0,0,53,0,53,"2013"
"19764","316440 SAO SEBASTIAO DA BELA VISTA",0,0,2,67,0,69,"2013"
"19765","316443 SAO SEBASTIAO DA VARGEM ALEGRE",0,0,1,23,0,24,"2013"
"19766","316447 SAO SEBASTIAO DO ANTA",2,0,2,88,2,94,"2013"
"19767","316450 SAO SEBASTIAO DO MARANHAO",0,1,1,93,4,99,"2013"
"19768","316460 SAO SEBASTIAO DO OESTE",0,3,2,74,0,79,"2013"
"19769","316470 SAO SEBASTIAO DO PARAISO",2,7,6,876,2,893,"2013"
"19770","316480 SAO SEBASTIAO DO RIO PRETO",0,0,0,13,2,15,"2013"
"19771","316490 SAO SEBASTIAO DO RIO VERDE",0,0,0,26,0,26,"2013"
"19772","316500 SAO TIAGO",0,0,1,116,0,117,"2013"
"19773","316510 SAO TOMAS DE AQUINO",0,0,2,78,0,80,"2013"
"19774","316520 SAO THOME DAS LETRAS",0,0,1,79,0,80,"2013"
"19775","316530 SAO VICENTE DE MINAS",0,0,0,37,0,37,"2013"
"19776","316540 SAPUCAI-MIRIM",0,0,0,70,0,70,"2013"
"19777","316550 SARDOA",1,0,5,59,3,68,"2013"
"19778","316553 SARZEDO",3,3,3,488,1,498,"2013"
"19779","316555 SETUBINHA",1,2,4,169,13,189,"2013"
"19780","316556 SEM-PEIXE",0,0,0,16,0,16,"2013"
"19781","316557 SENADOR AMARAL",0,0,2,78,0,80,"2013"
"19782","316560 SENADOR CORTES",0,1,1,24,0,26,"2013"
"19783","316570 SENADOR FIRMINO",0,2,0,73,0,75,"2013"
"19784","316580 SENADOR JOSE BENTO",0,0,1,9,0,10,"2013"
"19785","316590 SENADOR MODESTINO GONCALVES",0,1,0,41,1,43,"2013"
"19786","316600 SENHORA DE OLIVEIRA",0,1,0,46,0,47,"2013"
"19787","316610 SENHORA DO PORTO",0,0,0,34,1,35,"2013"
"19788","316620 SENHORA DOS REMEDIOS",0,0,1,65,0,66,"2013"
"19789","316630 SERICITA",0,0,0,76,3,79,"2013"
"19790","316640 SERITINGA",0,0,0,14,0,14,"2013"
"19791","316650 SERRA AZUL DE MINAS",0,0,0,49,1,50,"2013"
"19792","316660 SERRA DA SAUDADE",0,0,0,8,0,8,"2013"
"19793","316670 SERRA DOS AIMORES",1,1,0,102,1,105,"2013"
"19794","316680 SERRA DO SALITRE",0,1,1,123,1,126,"2013"
"19795","316690 SERRANIA",0,1,1,91,1,94,"2013"
"19796","316695 SERRANOPOLIS DE MINAS",1,0,1,57,0,59,"2013"
"19797","316700 SERRANOS",0,0,0,19,0,19,"2013"
"19798","316710 SERRO",1,1,3,237,3,245,"2013"
"19799","316720 SETE LAGOAS",7,7,38,2869,13,2934,"2013"
"19800","316730 SILVEIRANIA",0,0,0,26,0,26,"2013"
"19801","316740 SILVIANOPOLIS",0,0,1,58,0,59,"2013"
"19802","316750 SIMAO PEREIRA",0,0,0,23,0,23,"2013"
"19803","316760 SIMONESIA",0,0,0,62,206,268,"2013"
"19804","316770 SOBRALIA",0,0,1,55,0,56,"2013"
"19805","316780 SOLEDADE DE MINAS",0,0,0,66,3,69,"2013"
"19806","316790 TABULEIRO",0,0,0,25,0,25,"2013"
"19807","316800 TAIOBEIRAS",0,2,4,405,7,418,"2013"
"19808","316805 TAPARUBA",1,0,0,34,1,36,"2013"
"19809","316810 TAPIRA",0,1,0,37,0,38,"2013"
"19810","316820 TAPIRAI",0,0,0,12,0,12,"2013"
"19811","316830 TAQUARACU DE MINAS",1,0,0,32,1,34,"2013"
"19812","316840 TARUMIRIM",1,0,4,140,4,149,"2013"
"19813","316850 TEIXEIRAS",0,0,2,113,8,123,"2013"
"19814","316860 TEOFILO OTONI",6,8,22,1771,17,1824,"2013"
"19815","316870 TIMOTEO",1,2,13,1061,6,1083,"2013"
"19816","316880 TIRADENTES",0,0,1,75,1,77,"2013"
"19817","316890 TIROS",0,0,0,47,0,47,"2013"
"19818","316900 TOCANTINS",0,0,4,198,0,202,"2013"
"19819","316905 TOCOS DO MOJI",0,0,0,21,0,21,"2013"
"19820","316910 TOLEDO",0,0,0,65,0,65,"2013"
"19821","316920 TOMBOS",0,0,1,85,3,89,"2013"
"19822","316930 TRES CORACOES",3,5,8,986,2,1004,"2013"
"19823","316935 TRES MARIAS",2,1,3,360,8,374,"2013"
"19824","316940 TRES PONTAS",2,1,4,217,521,745,"2013"
"19825","316950 TUMIRITINGA",0,1,0,65,3,69,"2013"
"19826","316960 TUPACIGUARA",1,1,3,240,5,250,"2013"
"19827","316970 TURMALINA",0,3,0,241,2,246,"2013"
"19828","316980 TURVOLANDIA",0,0,0,51,0,51,"2013"
"19829","316990 UBA",4,6,31,1282,6,1329,"2013"
"19830","317000 UBAI",0,1,1,161,2,165,"2013"
"19831","317005 UBAPORANGA",0,0,2,151,4,157,"2013"
"19832","317010 UBERABA",21,17,64,4039,26,4167,"2013"
"19833","317020 UBERLANDIA",33,20,98,8812,43,9006,"2013"
"19834","317030 UMBURATIBA",0,0,0,39,0,39,"2013"
"19835","317040 UNAI",5,3,4,1075,41,1128,"2013"
"19836","317043 UNIAO DE MINAS",0,0,0,60,0,60,"2013"
"19837","317047 URUANA DE MINAS",0,0,0,36,4,40,"2013"
"19838","317050 URUCANIA",1,1,2,126,0,130,"2013"
"19839","317052 URUCUIA",1,2,1,125,3,132,"2013"
"19840","317057 VARGEM ALEGRE",0,0,3,80,1,84,"2013"
"19841","317060 VARGEM BONITA",0,0,0,27,0,27,"2013"
"19842","317065 VARGEM GRANDE DO RIO PARDO",0,0,1,40,3,44,"2013"
"19843","317070 VARGINHA",3,2,15,1564,5,1589,"2013"
"19844","317075 VARJAO DE MINAS",0,1,2,79,0,82,"2013"
"19845","317080 VARZEA DA PALMA",4,3,9,423,0,439,"2013"
"19846","317090 VARZELANDIA",1,2,8,259,1,271,"2013"
"19847","317100 VAZANTE",0,0,3,242,1,246,"2013"
"19848","317103 VERDELANDIA",0,0,8,138,2,148,"2013"
"19849","317107 VEREDINHA",0,0,1,56,1,58,"2013"
"19850","317110 VERISSIMO",1,0,0,32,2,35,"2013"
"19851","317115 VERMELHO NOVO",0,0,0,55,4,59,"2013"
"19852","317120 VESPASIANO",6,7,30,1780,4,1827,"2013"
"19853","317130 VICOSA",0,4,10,891,37,942,"2013"
"19854","317140 VIEIRAS",0,0,2,31,0,33,"2013"
"19855","317150 MATHIAS LOBATO",0,0,3,34,1,38,"2013"
"19856","317160 VIRGEM DA LAPA",0,3,2,103,3,111,"2013"
"19857","317170 VIRGINIA",0,0,1,83,0,84,"2013"
"19858","317180 VIRGINOPOLIS",0,1,3,154,1,159,"2013"
"19859","317190 VIRGOLANDIA",0,0,0,51,1,52,"2013"
"19860","317200 VISCONDE DO RIO BRANCO",0,1,4,487,1,493,"2013"
"19861","317210 VOLTA GRANDE",0,0,1,51,0,52,"2013"
"19862","317220 WENCESLAU BRAZ",1,0,0,16,0,17,"2013"
"19863","MUNICIPIO IGNORADO - ES",0,0,0,4,0,4,"2013"
"19864","320010 AFONSO CLAUDIO",0,0,7,413,0,420,"2013"
"19865","320013 AGUIA BRANCA",1,0,1,88,0,90,"2013"
"19866","320016 AGUA DOCE DO NORTE",0,1,2,150,0,153,"2013"
"19867","320020 ALEGRE",1,1,4,363,0,369,"2013"
"19868","320030 ALFREDO CHAVES",0,1,2,135,0,138,"2013"
"19869","320035 ALTO RIO NOVO",0,0,2,88,1,91,"2013"
"19870","320040 ANCHIETA",0,2,5,429,0,436,"2013"
"19871","320050 APIACA",0,0,2,64,0,66,"2013"
"19872","320060 ARACRUZ",1,5,10,1403,0,1419,"2013"
"19873","320070 ATILIO VIVACQUA",0,0,3,150,0,153,"2013"
"19874","320080 BAIXO GUANDU",2,1,6,391,1,401,"2013"
"19875","320090 BARRA DE SAO FRANCISCO",3,3,14,593,1,614,"2013"
"19876","320100 BOA ESPERANCA",0,1,0,180,17,198,"2013"
"19877","320110 BOM JESUS DO NORTE",0,1,1,120,0,122,"2013"
"19878","320115 BREJETUBA",0,1,2,194,0,197,"2013"
"19879","320120 CACHOEIRO DE ITAPEMIRIM",1,7,35,2659,1,2703,"2013"
"19880","320130 CARIACICA",30,13,92,5931,45,6111,"2013"
"19881","320140 CASTELO",0,2,6,441,2,451,"2013"
"19882","320150 COLATINA",2,8,10,1431,0,1451,"2013"
"19883","320160 CONCEICAO DA BARRA",0,2,9,412,0,423,"2013"
"19884","320170 CONCEICAO DO CASTELO",0,1,1,161,0,163,"2013"
"19885","320180 DIVINO DE SAO LOURENCO",2,0,3,50,0,55,"2013"
"19886","320190 DOMINGOS MARTINS",1,2,11,475,0,489,"2013"
"19887","320200 DORES DO RIO PRETO",0,0,3,70,0,73,"2013"
"19888","320210 ECOPORANGA",0,0,6,261,0,267,"2013"
"19889","320220 FUNDAO",5,1,3,245,0,254,"2013"
"19890","320225 GOVERNADOR LINDENBERG",0,1,1,118,0,120,"2013"
"19891","320230 GUACUI",1,6,6,434,2,449,"2013"
"19892","320240 GUARAPARI",5,3,36,1534,59,1637,"2013"
"19893","320245 IBATIBA",0,0,4,299,21,324,"2013"
"19894","320250 IBIRACU",0,0,1,153,0,154,"2013"
"19895","320255 IBITIRAMA",0,0,2,135,0,137,"2013"
"19896","320260 ICONHA",0,0,2,135,1,138,"2013"
"19897","320265 IRUPI",1,1,3,116,20,141,"2013"
"19898","320270 ITAGUACU",0,1,2,111,0,114,"2013"
"19899","320280 ITAPEMIRIM",2,1,12,504,1,520,"2013"
"19900","320290 ITARANA",0,1,1,96,0,98,"2013"
"19901","320300 IUNA",0,1,3,255,27,286,"2013"
"19902","320305 JAGUARE",0,2,8,461,0,471,"2013"
"19903","320310 JERONIMO MONTEIRO",0,0,3,125,0,128,"2013"
"19904","320313 JOAO NEIVA",0,0,3,208,2,213,"2013"
"19905","320316 LARANJA DA TERRA",0,2,2,87,0,91,"2013"
"19906","320320 LINHARES",1,6,20,2423,1,2451,"2013"
"19907","320330 MANTENOPOLIS",0,1,2,160,0,163,"2013"
"19908","320332 MARATAIZES",0,1,11,522,4,538,"2013"
"19909","320334 MARECHAL FLORIANO",1,1,5,200,1,208,"2013"
"19910","320335 MARILANDIA",1,0,1,118,0,120,"2013"
"19911","320340 MIMOSO DO SUL",0,0,6,284,2,292,"2013"
"19912","320350 MONTANHA",0,1,6,232,4,243,"2013"
"19913","320360 MUCURICI",0,1,5,70,1,77,"2013"
"19914","320370 MUNIZ FREIRE",2,2,0,223,1,228,"2013"
"19915","320380 MUQUI",0,2,5,137,6,150,"2013"
"19916","320390 NOVA VENECIA",1,0,8,668,1,678,"2013"
"19917","320400 PANCAS",1,0,4,226,3,234,"2013"
"19918","320405 PEDRO CANARIO",0,4,6,384,3,397,"2013"
"19919","320410 PINHEIROS",0,0,1,54,317,372,"2013"
"19920","320420 PIUMA",0,1,7,276,1,285,"2013"
"19921","320425 PONTO BELO",0,0,2,81,2,85,"2013"
"19922","320430 PRESIDENTE KENNEDY",0,0,3,157,0,160,"2013"
"19923","320435 RIO BANANAL",2,1,4,243,0,250,"2013"
"19924","320440 RIO NOVO DO SUL",0,0,0,125,0,125,"2013"
"19925","320450 SANTA LEOPOLDINA",0,0,2,102,1,105,"2013"
"19926","320455 SANTA MARIA DE JETIBA",1,1,2,488,0,492,"2013"
"19927","320460 SANTA TERESA",0,0,5,232,1,238,"2013"
"19928","320465 SAO DOMINGOS DO NORTE",0,1,1,78,0,80,"2013"
"19929","320470 SAO GABRIEL DA PALHA",0,2,7,437,0,446,"2013"
"19930","320480 SAO JOSE DO CALCADO",0,0,0,143,0,143,"2013"
"19931","320490 SAO MATEUS",3,4,21,1690,13,1731,"2013"
"19932","320495 SAO ROQUE DO CANAA",0,0,4,109,0,113,"2013"
"19933","320500 SERRA",56,23,101,7677,6,7863,"2013"
"19934","320501 SOORETAMA",1,2,3,451,1,458,"2013"
"19935","320503 VARGEM ALTA",0,0,4,255,0,259,"2013"
"19936","320506 VENDA NOVA DO IMIGRANTE",2,0,4,254,0,260,"2013"
"19937","320510 VIANA",2,1,12,1069,11,1095,"2013"
"19938","320515 VILA PAVAO",0,1,1,120,0,122,"2013"
"19939","320517 VILA VALERIO",0,0,5,164,0,169,"2013"
"19940","320520 VILA VELHA",77,6,78,6235,50,6446,"2013"
"19941","320530 VITORIA",8,9,57,4561,22,4657,"2013"
"19942","MUNICIPIO IGNORADO - RJ",0,1,3,18,1,23,"2013"
"19943","330010 ANGRA DOS REIS",5,14,79,2528,27,2653,"2013"
"19944","330015 APERIBE",1,0,2,130,2,135,"2013"
"19945","330020 ARARUAMA",1,7,21,1542,43,1614,"2013"
"19946","330022 AREAL",1,0,0,128,1,130,"2013"
"19947","330023 ARMACAO DOS BUZIOS",1,4,15,586,10,616,"2013"
"19948","330025 ARRAIAL DO CABO",0,2,3,225,101,331,"2013"
"19949","330030 BARRA DO PIRAI",3,7,18,1101,2,1131,"2013"
"19950","330040 BARRA MANSA",4,12,76,2097,8,2197,"2013"
"19951","330045 BELFORD ROXO",17,28,164,7065,63,7337,"2013"
"19952","330050 BOM JARDIM",0,1,8,319,4,332,"2013"
"19953","330060 BOM JESUS DO ITABAPOANA",1,2,3,422,2,430,"2013"
"19954","330070 CABO FRIO",4,9,55,2689,37,2794,"2013"
"19955","330080 CACHOEIRAS DE MACACU",3,2,13,745,7,770,"2013"
"19956","330090 CAMBUCI",1,1,1,137,1,141,"2013"
"19957","330093 CARAPEBUS",0,0,2,155,3,160,"2013"
"19958","330095 COMENDADOR LEVY GASPARIAN",0,0,3,112,0,115,"2013"
"19959","330100 CAMPOS DOS GOYTACAZES",11,46,132,6426,809,7424,"2013"
"19960","330110 CANTAGALO",0,1,6,208,1,216,"2013"
"19961","330115 CARDOSO MOREIRA",0,0,2,122,9,133,"2013"
"19962","330120 CARMO",1,0,2,213,0,216,"2013"
"19963","330130 CASIMIRO DE ABREU",1,1,7,492,0,501,"2013"
"19964","330140 CONCEICAO DE MACABU",0,2,9,254,9,274,"2013"
"19965","330150 CORDEIRO",0,1,1,228,1,231,"2013"
"19966","330160 DUAS BARRAS",0,0,1,140,6,147,"2013"
"19967","330170 DUQUE DE CAXIAS",15,65,245,12609,104,13038,"2013"
"19968","330180 ENGENHEIRO PAULO DE FRONTIN",1,2,0,123,1,127,"2013"
"19969","330185 GUAPIMIRIM",3,7,14,717,10,751,"2013"
"19970","330187 IGUABA GRANDE",0,1,3,101,193,298,"2013"
"19971","330190 ITABORAI",13,22,77,3180,19,3311,"2013"
"19972","330200 ITAGUAI",4,6,29,1856,13,1908,"2013"
"19973","330205 ITALVA",0,0,1,126,3,130,"2013"
"19974","330210 ITAOCARA",0,3,0,251,1,255,"2013"
"19975","330220 ITAPERUNA",3,1,8,1144,2,1158,"2013"
"19976","330225 ITATIAIA",2,1,16,377,3,399,"2013"
"19977","330227 JAPERI",4,8,31,1451,23,1517,"2013"
"19978","330230 LAJE DO MURIAE",0,1,1,99,0,101,"2013"
"19979","330240 MACAE",3,14,76,3931,14,4038,"2013"
"19980","330245 MACUCO",0,0,3,105,0,108,"2013"
"19981","330250 MAGE",13,11,71,3277,1,3373,"2013"
"19982","330260 MANGARATIBA",1,2,6,511,0,520,"2013"
"19983","330270 MARICA",2,8,34,1099,479,1622,"2013"
"19984","330280 MENDES",0,1,4,187,2,194,"2013"
"19985","330285 MESQUITA",6,15,66,2513,11,2611,"2013"
"19986","330290 MIGUEL PEREIRA",0,6,2,214,31,253,"2013"
"19987","330300 MIRACEMA",1,0,4,321,2,328,"2013"
"19988","330310 NATIVIDADE",0,1,7,183,0,191,"2013"
"19989","330320 NILOPOLIS",4,14,53,1947,6,2024,"2013"
"19990","330330 NITEROI",14,28,133,5907,21,6103,"2013"
"19991","330340 NOVA FRIBURGO",4,4,42,2105,11,2166,"2013"
"19992","330350 NOVA IGUACU",28,61,224,11072,118,11503,"2013"
"19993","330360 PARACAMBI",3,1,9,464,2,479,"2013"
"19994","330370 PARAIBA DO SUL",7,2,7,517,2,535,"2013"
"19995","330380 PARATY",9,4,13,542,0,568,"2013"
"19996","330385 PATY DO ALFERES",1,0,12,308,47,368,"2013"
"19997","330390 PETROPOLIS",26,27,95,3626,9,3783,"2013"
"19998","330395 PINHEIRAL",2,1,1,289,1,294,"2013"
"19999","330400 PIRAI",0,0,6,359,3,368,"2013"
"20000","330410 PORCIUNCULA",0,1,6,211,0,218,"2013"
"20001","330411 PORTO REAL",0,2,6,289,0,297,"2013"
"20002","330412 QUATIS",1,2,3,193,0,199,"2013"
"20003","330414 QUEIMADOS",2,13,51,2297,12,2375,"2013"
"20004","330415 QUISSAMA",0,1,9,304,0,314,"2013"
"20005","330420 RESENDE",2,6,66,1654,5,1733,"2013"
"20006","330430 RIO BONITO",0,2,9,751,10,772,"2013"
"20007","330440 RIO CLARO",0,1,1,199,0,201,"2013"
"20008","330450 RIO DAS FLORES",0,0,3,119,4,126,"2013"
"20009","330452 RIO DAS OSTRAS",5,11,61,2146,17,2240,"2013"
"20010","330455 RIO DE JANEIRO",171,421,1738,84676,655,87661,"2013"
"20011","330460 SANTA MARIA MADALENA",0,1,3,106,1,111,"2013"
"20012","330470 SANTO ANTONIO DE PADUA",2,2,7,421,50,482,"2013"
"20013","330475 SAO FRANCISCO DE ITABAPOANA",3,4,6,418,57,488,"2013"
"20014","330480 SAO FIDELIS",0,4,11,373,54,442,"2013"
"20015","330490 SAO GONCALO",57,41,273,11042,50,11463,"2013"
"20016","330500 SAO JOAO DA BARRA",2,1,10,354,114,481,"2013"
"20017","330510 SAO JOAO DE MERITI",18,29,137,6584,20,6788,"2013"
"20018","330513 SAO JOSE DE UBA",0,0,0,114,0,114,"2013"
"20019","330515 SAO JOSE DO VALE DO RIO PRETO",1,1,1,243,2,248,"2013"
"20020","330520 SAO PEDRO DA ALDEIA",0,3,5,452,708,1168,"2013"
"20021","330530 SAO SEBASTIAO DO ALTO",1,0,2,89,1,93,"2013"
"20022","330540 SAPUCAIA",0,0,2,179,4,185,"2013"
"20023","330550 SAQUAREMA",0,1,5,286,623,915,"2013"
"20024","330555 SEROPEDICA",3,8,15,992,8,1026,"2013"
"20025","330560 SILVA JARDIM",2,0,2,289,4,297,"2013"
"20026","330570 SUMIDOURO",0,0,4,192,0,196,"2013"
"20027","330575 TANGUA",0,1,8,477,9,495,"2013"
"20028","330580 TERESOPOLIS",5,9,31,2300,12,2357,"2013"
"20029","330590 TRAJANO DE MORAES",1,0,1,84,1,87,"2013"
"20030","330600 TRES RIOS",8,7,11,1065,4,1095,"2013"
"20031","330610 VALENCA",2,6,14,853,3,878,"2013"
"20032","330615 VARRE-SAI",1,1,7,161,1,171,"2013"
"20033","330620 VASSOURAS",1,3,4,444,0,452,"2013"
"20034","330630 VOLTA REDONDA",8,11,57,3308,6,3390,"2013"
"20035","MUNICIPIO IGNORADO - SP",0,0,1,5,9,15,"2013"
"20036","350010 ADAMANTINA",0,1,6,346,0,353,"2013"
"20037","350020 ADOLFO",0,0,0,43,0,43,"2013"
"20038","350030 AGUAI",0,0,6,406,2,414,"2013"
"20039","350040 AGUAS DA PRATA",0,0,1,67,1,69,"2013"
"20040","350050 AGUAS DE LINDOIA",0,0,0,237,0,237,"2013"
"20041","350055 AGUAS DE SANTA BARBARA",0,0,4,60,1,65,"2013"
"20042","350060 AGUAS DE SAO PEDRO",0,0,0,32,1,33,"2013"
"20043","350070 AGUDOS",1,4,9,519,7,540,"2013"
"20044","350075 ALAMBARI",0,1,1,66,0,68,"2013"
"20045","350080 ALFREDO MARCONDES",0,0,1,45,0,46,"2013"
"20046","350090 ALTAIR",0,0,0,44,0,44,"2013"
"20047","350100 ALTINOPOLIS",1,0,3,187,3,194,"2013"
"20048","350110 ALTO ALEGRE",0,0,0,47,0,47,"2013"
"20049","350115 ALUMINIO",1,0,3,257,1,262,"2013"
"20050","350120 ALVARES FLORENCE",0,0,0,33,0,33,"2013"
"20051","350130 ALVARES MACHADO",0,1,2,397,0,400,"2013"
"20052","350140 ALVARO DE CARVALHO",0,0,1,48,0,49,"2013"
"20053","350150 ALVINLANDIA",0,0,1,46,0,47,"2013"
"20054","350160 AMERICANA",2,8,25,2619,3,2657,"2013"
"20055","350170 AMERICO BRASILIENSE",0,1,4,536,0,541,"2013"
"20056","350180 AMERICO DE CAMPOS",0,1,1,49,0,51,"2013"
"20057","350190 AMPARO",0,3,10,835,2,850,"2013"
"20058","350200 ANALANDIA",0,0,0,35,0,35,"2013"
"20059","350210 ANDRADINA",1,2,16,692,5,716,"2013"
"20060","350220 ANGATUBA",2,0,6,296,2,306,"2013"
"20061","350230 ANHEMBI",0,1,5,75,0,81,"2013"
"20062","350240 ANHUMAS",0,0,0,49,1,50,"2013"
"20063","350250 APARECIDA",3,2,11,458,36,510,"2013"
"20064","350260 APARECIDA D'OESTE",0,0,0,46,0,46,"2013"
"20065","350270 APIAI",1,2,6,342,1,352,"2013"
"20066","350275 ARACARIGUAMA",3,0,1,296,1,301,"2013"
"20067","350280 ARACATUBA",5,8,28,2247,0,2288,"2013"
"20068","350290 ARACOIABA DA SERRA",0,2,1,403,0,406,"2013"
"20069","350300 ARAMINA",0,0,0,56,0,56,"2013"
"20070","350310 ARANDU",0,1,1,70,0,72,"2013"
"20071","350315 ARAPEI",0,0,1,16,0,17,"2013"
"20072","350320 ARARAQUARA",10,7,16,2665,4,2702,"2013"
"20073","350330 ARARAS",4,4,16,1478,5,1507,"2013"
"20074","350335 ARCO-IRIS",0,0,0,19,0,19,"2013"
"20075","350340 AREALVA",0,0,0,69,0,69,"2013"
"20076","350350 AREIAS",0,0,1,39,0,40,"2013"
"20077","350360 AREIOPOLIS",0,0,6,130,1,137,"2013"
"20078","350370 ARIRANHA",0,0,0,124,0,124,"2013"
"20079","350380 ARTUR NOGUEIRA",0,1,4,585,7,597,"2013"
"20080","350390 ARUJA",8,5,23,1271,8,1315,"2013"
"20081","350395 ASPASIA",0,0,0,14,0,14,"2013"
"20082","350400 ASSIS",2,2,13,1237,4,1258,"2013"
"20083","350410 ATIBAIA",3,8,26,1989,14,2040,"2013"
"20084","350420 AURIFLAMA",0,0,0,144,0,144,"2013"
"20085","350430 AVAI",0,0,1,78,0,79,"2013"
"20086","350440 AVANHANDAVA",0,1,8,144,2,155,"2013"
"20087","350450 AVARE",4,5,12,1251,0,1272,"2013"
"20088","350460 BADY BASSITT",2,3,0,211,1,217,"2013"
"20089","350470 BALBINOS",0,0,0,15,3,18,"2013"
"20090","350480 BALSAMO",1,0,1,89,0,91,"2013"
"20091","350490 BANANAL",1,0,4,86,1,92,"2013"
"20092","350500 BARAO DE ANTONINA",0,0,0,42,0,42,"2013"
"20093","350510 BARBOSA",0,2,2,80,0,84,"2013"
"20094","350520 BARIRI",2,0,5,415,1,423,"2013"
"20095","350530 BARRA BONITA",0,0,2,355,3,360,"2013"
"20096","350535 BARRA DO CHAPEU",0,0,2,77,0,79,"2013"
"20097","350540 BARRA DO TURVO",0,0,2,88,2,92,"2013"
"20098","350550 BARRETOS",6,11,23,1442,11,1493,"2013"
"20099","350560 BARRINHA",1,2,9,424,1,437,"2013"
"20100","350570 BARUERI",9,15,52,5700,12,5788,"2013"
"20101","350580 BASTOS",0,2,0,270,0,272,"2013"
"20102","350590 BATATAIS",1,4,6,642,6,659,"2013"
"20103","350600 BAURU",27,22,59,4676,37,4821,"2013"
"20104","350610 BEBEDOURO",0,5,8,823,1,837,"2013"
"20105","350620 BENTO DE ABREU",0,0,0,36,0,36,"2013"
"20106","350630 BERNARDINO DE CAMPOS",0,0,0,123,0,123,"2013"
"20107","350635 BERTIOGA",0,5,22,864,5,896,"2013"
"20108","350640 BILAC",0,0,1,72,0,73,"2013"
"20109","350650 BIRIGUI",6,6,24,1415,0,1451,"2013"
"20110","350660 BIRITIBA-MIRIM",2,2,3,319,38,364,"2013"
"20111","350670 BOA ESPERANCA DO SUL",0,0,2,191,0,193,"2013"
"20112","350680 BOCAINA",0,0,1,157,2,160,"2013"
"20113","350690 BOFETE",0,0,1,122,2,125,"2013"
"20114","350700 BOITUVA",1,1,9,792,1,804,"2013"
"20115","350710 BOM JESUS DOS PERDOES",0,1,2,295,1,299,"2013"
"20116","350715 BOM SUCESSO DE ITARARE",0,0,4,66,0,70,"2013"
"20117","350720 BORA",0,0,0,5,0,5,"2013"
"20118","350730 BORACEIA",0,0,1,60,1,62,"2013"
"20119","350740 BORBOREMA",3,0,3,136,2,144,"2013"
"20120","350745 BOREBI",0,0,0,29,1,30,"2013"
"20121","350750 BOTUCATU",8,16,48,1572,11,1655,"2013"
"20122","350760 BRAGANCA PAULISTA",0,5,18,2020,4,2047,"2013"
"20123","350770 BRAUNA",0,0,1,62,1,64,"2013"
"20124","350775 BREJO ALEGRE",0,0,0,27,0,27,"2013"
"20125","350780 BRODOWSKI",3,1,6,272,5,287,"2013"
"20126","350790 BROTAS",0,4,6,283,0,293,"2013"
"20127","350800 BURI",1,2,10,284,1,298,"2013"
"20128","350810 BURITAMA",0,1,8,210,1,220,"2013"
"20129","350820 BURITIZAL",0,0,0,48,0,48,"2013"
"20130","350830 CABRALIA PAULISTA",0,0,1,64,1,66,"2013"
"20131","350840 CABREUVA",1,0,6,662,0,669,"2013"
"20132","350850 CACAPAVA",0,1,10,1249,8,1268,"2013"
"20133","350860 CACHOEIRA PAULISTA",1,2,4,398,10,415,"2013"
"20134","350870 CACONDE",1,1,2,170,2,176,"2013"
"20135","350880 CAFELANDIA",0,2,3,240,0,245,"2013"
"20136","350890 CAIABU",0,0,0,47,0,47,"2013"
"20137","350900 CAIEIRAS",2,2,19,1319,9,1351,"2013"
"20138","350910 CAIUA",0,0,1,39,0,40,"2013"
"20139","350920 CAJAMAR",3,4,13,1074,8,1102,"2013"
"20140","350925 CAJATI",1,1,2,448,5,457,"2013"
"20141","350930 CAJOBI",0,0,3,105,0,108,"2013"
"20142","350940 CAJURU",0,2,1,356,3,362,"2013"
"20143","350945 CAMPINA DO MONTE ALEGRE",0,0,2,69,0,71,"2013"
"20144","350950 CAMPINAS",35,54,145,15049,63,15346,"2013"
"20145","350960 CAMPO LIMPO PAULISTA",1,5,20,1153,6,1185,"2013"
"20146","350970 CAMPOS DO JORDAO",2,2,5,710,6,725,"2013"
"20147","350980 CAMPOS NOVOS PAULISTA",0,0,2,71,0,73,"2013"
"20148","350990 CANANEIA",0,0,1,164,5,170,"2013"
"20149","350995 CANAS",0,0,0,72,13,85,"2013"
"20150","351000 CANDIDO MOTA",3,0,3,314,2,322,"2013"
"20151","351010 CANDIDO RODRIGUES",0,0,0,31,0,31,"2013"
"20152","351015 CANITAR",1,1,2,60,2,66,"2013"
"20153","351020 CAPAO BONITO",0,1,6,721,0,728,"2013"
"20154","351030 CAPELA DO ALTO",2,1,2,225,1,231,"2013"
"20155","351040 CAPIVARI",0,3,4,647,31,685,"2013"
"20156","351050 CARAGUATATUBA",1,3,24,1514,1,1543,"2013"
"20157","351060 CARAPICUIBA",9,35,105,6750,38,6937,"2013"
"20158","351070 CARDOSO",0,0,0,141,0,141,"2013"
"20159","351080 CASA BRANCA",1,2,2,294,1,300,"2013"
"20160","351090 CASSIA DOS COQUEIROS",0,0,0,18,1,19,"2013"
"20161","351100 CASTILHO",0,2,10,261,3,276,"2013"
"20162","351110 CATANDUVA",5,5,10,1329,2,1351,"2013"
"20163","351120 CATIGUA",0,0,1,88,0,89,"2013"
"20164","351130 CEDRAL",1,1,0,80,0,82,"2013"
"20165","351140 CERQUEIRA CESAR",1,2,3,232,2,240,"2013"
"20166","351150 CERQUILHO",1,4,0,504,5,514,"2013"
"20167","351160 CESARIO LANGE",0,0,3,224,1,228,"2013"
"20168","351170 CHARQUEADA",0,1,5,187,1,194,"2013"
"20169","351190 CLEMENTINA",1,0,4,109,1,115,"2013"
"20170","351200 COLINA",0,1,4,237,0,242,"2013"
"20171","351210 COLOMBIA",0,0,0,111,1,112,"2013"
"20172","351220 CONCHAL",1,0,2,403,2,408,"2013"
"20173","351230 CONCHAS",0,1,4,188,19,212,"2013"
"20174","351240 CORDEIROPOLIS",3,0,5,296,2,306,"2013"
"20175","351250 COROADOS",0,0,1,77,0,78,"2013"
"20176","351260 CORONEL MACEDO",0,0,0,46,0,46,"2013"
"20177","351270 CORUMBATAI",0,0,2,65,0,67,"2013"
"20178","351280 COSMOPOLIS",6,1,21,858,2,888,"2013"
"20179","351290 COSMORAMA",0,0,3,66,0,69,"2013"
"20180","351300 COTIA",7,9,39,4000,14,4069,"2013"
"20181","351310 CRAVINHOS",0,3,9,419,2,433,"2013"
"20182","351320 CRISTAIS PAULISTA",0,1,1,119,1,122,"2013"
"20183","351330 CRUZALIA",0,1,1,21,0,23,"2013"
"20184","351340 CRUZEIRO",5,5,26,970,12,1018,"2013"
"20185","351350 CUBATAO",5,16,38,1829,2,1890,"2013"
"20186","351360 CUNHA",0,0,2,228,1,231,"2013"
"20187","351370 DESCALVADO",0,0,1,403,1,405,"2013"
"20188","351380 DIADEMA",9,23,61,6202,26,6321,"2013"
"20189","351385 DIRCE REIS",0,1,0,35,0,36,"2013"
"20190","351390 DIVINOLANDIA",0,0,2,142,0,144,"2013"
"20191","351400 DOBRADA",0,0,1,121,1,123,"2013"
"20192","351410 DOIS CORREGOS",0,2,0,341,1,344,"2013"
"20193","351420 DOLCINOPOLIS",0,0,0,20,0,20,"2013"
"20194","351430 DOURADO",0,0,1,81,0,82,"2013"
"20195","351440 DRACENA",1,0,4,457,2,464,"2013"
"20196","351450 DUARTINA",1,1,1,138,1,142,"2013"
"20197","351460 DUMONT",0,2,7,86,0,95,"2013"
"20198","351470 ECHAPORA",0,0,2,57,0,59,"2013"
"20199","351480 ELDORADO",1,0,1,216,11,229,"2013"
"20200","351490 ELIAS FAUSTO",0,1,2,172,5,180,"2013"
"20201","351492 ELISIARIO",0,0,0,41,0,41,"2013"
"20202","351495 EMBAUBA",0,0,0,23,0,23,"2013"
"20203","351500 EMBU DAS ARTES",12,16,54,4486,12,4580,"2013"
"20204","351510 EMBU-GUACU",2,2,15,950,6,975,"2013"
"20205","351512 EMILIANOPOLIS",0,0,1,26,0,27,"2013"
"20206","351515 ENGENHEIRO COELHO",0,0,1,252,0,253,"2013"
"20207","351518 ESPIRITO SANTO DO PINHAL",0,5,6,485,0,496,"2013"
"20208","351519 ESPIRITO SANTO DO TURVO",0,0,0,52,1,53,"2013"
"20209","351520 ESTRELA D'OESTE",1,0,1,86,0,88,"2013"
"20210","351530 ESTRELA DO NORTE",0,0,1,41,0,42,"2013"
"20211","351535 EUCLIDES DA CUNHA PAULISTA",0,2,0,127,1,130,"2013"
"20212","351540 FARTURA",0,1,1,188,0,190,"2013"
"20213","351550 FERNANDOPOLIS",1,2,8,760,2,773,"2013"
"20214","351560 FERNANDO PRESTES",0,0,0,42,1,43,"2013"
"20215","351565 FERNAO",0,0,0,20,0,20,"2013"
"20216","351570 FERRAZ DE VASCONCELOS",13,12,42,2769,49,2885,"2013"
"20217","351580 FLORA RICA",0,0,0,17,0,17,"2013"
"20218","351590 FLOREAL",0,0,0,28,0,28,"2013"
"20219","351600 FLORIDA PAULISTA",1,2,1,106,0,110,"2013"
"20220","351610 FLORINIA",1,0,0,38,0,39,"2013"
"20221","351620 FRANCA",11,21,61,4522,20,4635,"2013"
"20222","351630 FRANCISCO MORATO",14,15,47,2857,15,2948,"2013"
"20223","351640 FRANCO DA ROCHA",4,3,26,2021,12,2066,"2013"
"20224","351650 GABRIEL MONTEIRO",0,0,0,43,0,43,"2013"
"20225","351660 GALIA",3,1,0,68,0,72,"2013"
"20226","351670 GARCA",2,4,18,514,0,538,"2013"
"20227","351680 GASTAO VIDIGAL",0,0,0,49,0,49,"2013"
"20228","351685 GAVIAO PEIXOTO",0,1,2,63,0,66,"2013"
"20229","351690 GENERAL SALGADO",1,0,1,122,0,124,"2013"
"20230","351700 GETULINA",2,0,1,110,0,113,"2013"
"20231","351710 GLICERIO",0,0,2,59,0,61,"2013"
"20232","351720 GUAICARA",1,0,0,126,0,127,"2013"
"20233","351730 GUAIMBE",1,1,0,76,0,78,"2013"
"20234","351740 GUAIRA",3,3,6,461,1,474,"2013"
"20235","351750 GUAPIACU",0,0,1,200,0,201,"2013"
"20236","351760 GUAPIARA",1,1,7,245,0,254,"2013"
"20237","351770 GUARA",3,1,3,214,1,222,"2013"
"20238","351780 GUARACAI",1,1,6,70,0,78,"2013"
"20239","351790 GUARACI",0,2,2,119,4,127,"2013"
"20240","351800 GUARANI D'OESTE",0,0,0,18,0,18,"2013"
"20241","351810 GUARANTA",1,1,1,69,0,72,"2013"
"20242","351820 GUARARAPES",2,1,6,381,0,390,"2013"
"20243","351830 GUARAREMA",1,2,8,398,2,411,"2013"
"20244","351840 GUARATINGUETA",6,7,11,1357,29,1410,"2013"
"20245","351850 GUAREI",0,0,3,151,1,155,"2013"
"20246","351860 GUARIBA",0,4,43,536,0,583,"2013"
"20247","351870 GUARUJA",11,24,65,4498,39,4637,"2013"
"20248","351880 GUARULHOS",40,75,247,20881,82,21325,"2013"
"20249","351885 GUATAPARA",2,0,3,71,3,79,"2013"
"20250","351890 GUZOLANDIA",0,0,1,62,0,63,"2013"
"20251","351900 HERCULANDIA",0,0,4,92,0,96,"2013"
"20252","351905 HOLAMBRA",0,2,2,155,1,160,"2013"
"20253","351907 HORTOLANDIA",5,6,26,2942,8,2987,"2013"
"20254","351910 IACANGA",1,0,2,121,3,127,"2013"
"20255","351920 IACRI",0,1,0,74,0,75,"2013"
"20256","351925 IARAS",1,1,1,79,0,82,"2013"
"20257","351930 IBATE",1,0,4,492,1,498,"2013"
"20258","351940 IBIRA",1,0,0,131,0,132,"2013"
"20259","351950 IBIRAREMA",1,0,1,89,0,91,"2013"
"20260","351960 IBITINGA",0,2,12,675,4,693,"2013"
"20261","351970 IBIUNA",1,3,11,968,91,1074,"2013"
"20262","351980 ICEM",0,0,1,103,0,104,"2013"
"20263","351990 IEPE",0,1,2,96,0,99,"2013"
"20264","352000 IGARACU DO TIETE",0,1,5,271,2,279,"2013"
"20265","352010 IGARAPAVA",0,2,5,283,7,297,"2013"
"20266","352020 IGARATA",1,0,2,135,3,141,"2013"
"20267","352030 IGUAPE",1,3,3,328,3,338,"2013"
"20268","352040 ILHABELA",0,1,3,443,1,448,"2013"
"20269","352042 ILHA COMPRIDA",0,1,3,110,2,116,"2013"
"20270","352044 ILHA SOLTEIRA",0,1,2,276,1,280,"2013"
"20271","352050 INDAIATUBA",4,5,24,2916,26,2975,"2013"
"20272","352060 INDIANA",0,0,1,62,0,63,"2013"
"20273","352070 INDIAPORA",0,0,1,34,0,35,"2013"
"20274","352080 INUBIA PAULISTA",0,0,0,43,0,43,"2013"
"20275","352090 IPAUSSU",2,0,1,152,8,163,"2013"
"20276","352100 IPERO",1,0,4,336,4,345,"2013"
"20277","352110 IPEUNA",0,0,0,100,0,100,"2013"
"20278","352115 IPIGUA",0,0,0,56,0,56,"2013"
"20279","352120 IPORANGA",0,0,0,61,1,62,"2013"
"20280","352130 IPUA",0,0,2,179,2,183,"2013"
"20281","352140 IRACEMAPOLIS",0,0,4,223,0,227,"2013"
"20282","352150 IRAPUA",0,0,0,83,1,84,"2013"
"20283","352160 IRAPURU",0,0,1,65,0,66,"2013"
"20284","352170 ITABERA",2,1,14,222,1,240,"2013"
"20285","352180 ITAI",1,0,6,316,2,325,"2013"
"20286","352190 ITAJOBI",0,0,1,158,0,159,"2013"
"20287","352200 ITAJU",0,0,0,41,1,42,"2013"
"20288","352210 ITANHAEM",1,3,16,1419,3,1442,"2013"
"20289","352215 ITAOCA",1,1,1,42,0,45,"2013"
"20290","352220 ITAPECERICA DA SERRA",11,9,34,2865,10,2929,"2013"
"20291","352230 ITAPETININGA",8,3,37,2098,10,2156,"2013"
"20292","352240 ITAPEVA",3,9,52,1359,4,1427,"2013"
"20293","352250 ITAPEVI",8,19,48,4019,18,4112,"2013"
"20294","352260 ITAPIRA",2,4,5,766,2,779,"2013"
"20295","352265 ITAPIRAPUA PAULISTA",0,1,1,46,2,50,"2013"
"20296","352270 ITAPOLIS",0,3,16,485,1,505,"2013"
"20297","352280 ITAPORANGA",1,0,3,204,0,208,"2013"
"20298","352290 ITAPUI",0,0,1,158,2,161,"2013"
"20299","352300 ITAPURA",0,1,2,59,0,62,"2013"
"20300","352310 ITAQUAQUECETUBA",18,30,72,5583,37,5740,"2013"
"20301","352320 ITARARE",2,3,16,654,0,675,"2013"
"20302","352330 ITARIRI",1,0,1,147,3,152,"2013"
"20303","352340 ITATIBA",4,2,11,1430,57,1504,"2013"
"20304","352350 ITATINGA",1,1,6,242,2,252,"2013"
"20305","352360 ITIRAPINA",0,1,0,172,0,173,"2013"
"20306","352370 ITIRAPUA",0,0,3,68,1,72,"2013"
"20307","352380 ITOBI",0,0,1,75,0,76,"2013"
"20308","352390 ITU",3,7,27,2325,8,2370,"2013"
"20309","352400 ITUPEVA",2,1,6,836,3,848,"2013"
"20310","352410 ITUVERAVA",2,0,7,440,2,451,"2013"
"20311","352420 JABORANDI",1,1,3,83,0,88,"2013"
"20312","352430 JABOTICABAL",5,5,2,794,5,811,"2013"
"20313","352440 JACAREI",11,10,35,3108,38,3202,"2013"
"20314","352450 JACI",0,1,3,78,0,82,"2013"
"20315","352460 JACUPIRANGA",0,0,1,223,3,227,"2013"
"20316","352470 JAGUARIUNA",0,5,7,705,2,719,"2013"
"20317","352480 JALES",0,2,1,532,1,536,"2013"
"20318","352490 JAMBEIRO",0,1,1,78,2,82,"2013"
"20319","352500 JANDIRA",0,11,16,1691,9,1727,"2013"
"20320","352510 JARDINOPOLIS",2,1,7,560,3,573,"2013"
"20321","352520 JARINU",1,0,6,404,6,417,"2013"
"20322","352530 JAU",2,3,11,1573,12,1601,"2013"
"20323","352540 JERIQUARA",0,0,0,34,1,35,"2013"
"20324","352550 JOANOPOLIS",0,2,0,138,0,140,"2013"
"20325","352560 JOAO RAMALHO",0,0,3,61,0,64,"2013"
"20326","352570 JOSE BONIFACIO",0,2,3,424,1,430,"2013"
"20327","352580 JULIO MESQUITA",1,1,3,57,0,62,"2013"
"20328","352585 JUMIRIM",0,0,0,34,1,35,"2013"
"20329","352590 JUNDIAI",13,18,64,5363,11,5469,"2013"
"20330","352600 JUNQUEIROPOLIS",0,1,5,251,0,257,"2013"
"20331","352610 JUQUIA",0,3,2,313,0,318,"2013"
"20332","352620 JUQUITIBA",1,0,7,460,4,472,"2013"
"20333","352630 LAGOINHA",0,0,2,31,0,33,"2013"
"20334","352640 LARANJAL PAULISTA",1,4,5,332,0,342,"2013"
"20335","352650 LAVINIA",0,0,4,42,0,46,"2013"
"20336","352660 LAVRINHAS",0,0,3,96,1,100,"2013"
"20337","352670 LEME",6,4,12,1211,3,1236,"2013"
"20338","352680 LENCOIS PAULISTA",2,4,19,836,3,864,"2013"
"20339","352690 LIMEIRA",9,7,27,3462,7,3512,"2013"
"20340","352700 LINDOIA",0,0,1,79,0,80,"2013"
"20341","352710 LINS",1,5,8,938,0,952,"2013"
"20342","352720 LORENA",3,4,9,1085,147,1248,"2013"
"20343","352725 LOURDES",0,0,1,17,0,18,"2013"
"20344","352730 LOUVEIRA",2,2,12,687,1,704,"2013"
"20345","352740 LUCELIA",0,0,2,208,1,211,"2013"
"20346","352750 LUCIANOPOLIS",0,0,0,22,0,22,"2013"
"20347","352760 LUIS ANTONIO",0,1,5,159,0,165,"2013"
"20348","352770 LUIZIANIA",0,2,0,73,0,75,"2013"
"20349","352780 LUPERCIO",0,1,6,45,0,52,"2013"
"20350","352790 LUTECIA",0,0,0,35,0,35,"2013"
"20351","352800 MACATUBA",0,1,3,214,1,219,"2013"
"20352","352810 MACAUBAL",0,0,0,80,0,80,"2013"
"20353","352820 MACEDONIA",0,0,0,26,0,26,"2013"
"20354","352830 MAGDA",0,0,1,37,0,38,"2013"
"20355","352840 MAIRINQUE",1,1,6,674,1,683,"2013"
"20356","352850 MAIRIPORA",3,0,10,1139,7,1159,"2013"
"20357","352860 MANDURI",0,1,1,106,0,108,"2013"
"20358","352870 MARABA PAULISTA",0,0,1,32,0,33,"2013"
"20359","352880 MARACAI",0,0,0,154,3,157,"2013"
"20360","352885 MARAPOAMA",0,0,0,26,0,26,"2013"
"20361","352890 MARIAPOLIS",0,0,3,38,0,41,"2013"
"20362","352900 MARILIA",8,4,42,2924,6,2984,"2013"
"20363","352910 MARINOPOLIS",0,0,0,21,0,21,"2013"
"20364","352920 MARTINOPOLIS",0,2,3,290,2,297,"2013"
"20365","352930 MATAO",5,2,11,1017,2,1037,"2013"
"20366","352940 MAUA",9,22,67,5678,24,5800,"2013"
"20367","352950 MENDONCA",0,0,0,51,0,51,"2013"
"20368","352960 MERIDIANO",0,0,0,32,0,32,"2013"
"20369","352965 MESOPOLIS",0,0,0,22,0,22,"2013"
"20370","352970 MIGUELOPOLIS",0,0,6,254,10,270,"2013"
"20371","352980 MINEIROS DO TIETE",0,0,0,153,1,154,"2013"
"20372","352990 MIRACATU",2,1,2,274,4,283,"2013"
"20373","353000 MIRA ESTRELA",0,0,0,23,0,23,"2013"
"20374","353010 MIRANDOPOLIS",1,2,8,315,0,326,"2013"
"20375","353020 MIRANTE DO PARANAPANEMA",0,1,3,196,0,200,"2013"
"20376","353030 MIRASSOL",2,2,5,680,1,690,"2013"
"20377","353040 MIRASSOLANDIA",0,1,0,52,0,53,"2013"
"20378","353050 MOCOCA",3,2,11,792,4,812,"2013"
"20379","353060 MOGI DAS CRUZES",14,16,58,5491,485,6064,"2013"
"20380","353070 MOGI GUACU",7,10,37,1854,7,1915,"2013"
"20381","353080 MOGI MIRIM",5,3,17,1141,16,1182,"2013"
"20382","353090 MOMBUCA",0,0,0,59,4,63,"2013"
"20383","353100 MONCOES",0,0,0,30,0,30,"2013"
"20384","353110 MONGAGUA",1,3,9,631,2,646,"2013"
"20385","353120 MONTE ALEGRE DO SUL",1,0,1,74,0,76,"2013"
"20386","353130 MONTE ALTO",0,0,9,522,1,532,"2013"
"20387","353140 MONTE APRAZIVEL",0,0,3,207,4,214,"2013"
"20388","353150 MONTE AZUL PAULISTA",0,1,1,210,2,214,"2013"
"20389","353160 MONTE CASTELO",0,0,1,49,0,50,"2013"
"20390","353170 MONTEIRO LOBATO",0,0,0,33,2,35,"2013"
"20391","353180 MONTE MOR",4,1,9,834,60,908,"2013"
"20392","353190 MORRO AGUDO",4,1,2,439,0,446,"2013"
"20393","353200 MORUNGABA",2,1,0,142,4,149,"2013"
"20394","353205 MOTUCA",0,0,0,51,0,51,"2013"
"20395","353210 MURUTINGA DO SUL",0,1,0,38,0,39,"2013"
"20396","353215 NANTES",0,0,1,32,0,33,"2013"
"20397","353220 NARANDIBA",0,0,0,74,0,74,"2013"
"20398","353230 NATIVIDADE DA SERRA",0,0,2,61,1,64,"2013"
"20399","353240 NAZARE PAULISTA",0,1,8,222,17,248,"2013"
"20400","353250 NEVES PAULISTA",0,0,1,82,0,83,"2013"
"20401","353260 NHANDEARA",0,0,1,108,0,109,"2013"
"20402","353270 NIPOA",0,0,0,61,2,63,"2013"
"20403","353280 NOVA ALIANCA",0,0,0,75,0,75,"2013"
"20404","353282 NOVA CAMPINA",0,0,3,132,0,135,"2013"
"20405","353284 NOVA CANAA PAULISTA",0,0,0,13,0,13,"2013"
"20406","353286 NOVA CASTILHO",0,0,0,16,0,16,"2013"
"20407","353290 NOVA EUROPA",0,0,0,153,3,156,"2013"
"20408","353300 NOVA GRANADA",2,0,3,240,0,245,"2013"
"20409","353310 NOVA GUATAPORANGA",0,0,0,23,0,23,"2013"
"20410","353320 NOVA INDEPENDENCIA",0,1,1,39,2,43,"2013"
"20411","353325 NOVAIS",0,0,1,60,0,61,"2013"
"20412","353330 NOVA LUZITANIA",0,0,0,52,0,52,"2013"
"20413","353340 NOVA ODESSA",4,3,6,669,3,685,"2013"
"20414","353350 NOVO HORIZONTE",0,0,5,456,0,461,"2013"
"20415","353360 NUPORANGA",0,0,0,72,0,72,"2013"
"20416","353370 OCAUCU",1,1,3,68,0,73,"2013"
"20417","353380 OLEO",0,0,0,25,1,26,"2013"
"20418","353390 OLIMPIA",2,1,14,633,4,654,"2013"
"20419","353400 ONDA VERDE",0,0,0,45,0,45,"2013"
"20420","353410 ORIENTE",2,0,1,73,0,76,"2013"
"20421","353420 ORINDIUVA",0,1,0,75,0,76,"2013"
"20422","353430 ORLANDIA",3,0,8,516,0,527,"2013"
"20423","353440 OSASCO",28,46,136,10101,35,10346,"2013"
"20424","353450 OSCAR BRESSANE",2,0,0,12,0,14,"2013"
"20425","353460 OSVALDO CRUZ",0,1,2,344,0,347,"2013"
"20426","353470 OURINHOS",0,1,16,1335,56,1408,"2013"
"20427","353475 OUROESTE",0,0,1,112,0,113,"2013"
"20428","353480 OURO VERDE",0,1,1,96,4,102,"2013"
"20429","353490 PACAEMBU",0,0,3,119,0,122,"2013"
"20430","353500 PALESTINA",0,0,2,128,0,130,"2013"
"20431","353510 PALMARES PAULISTA",0,1,0,131,2,134,"2013"
"20432","353520 PALMEIRA D'OESTE",1,0,0,72,0,73,"2013"
"20433","353530 PALMITAL",1,0,3,227,0,231,"2013"
"20434","353540 PANORAMA",1,2,10,228,0,241,"2013"
"20435","353550 PARAGUACU PAULISTA",1,1,5,594,4,605,"2013"
"20436","353560 PARAIBUNA",0,0,1,201,3,205,"2013"
"20437","353570 PARAISO",0,0,0,67,0,67,"2013"
"20438","353580 PARANAPANEMA",1,1,6,227,0,235,"2013"
"20439","353590 PARANAPUA",0,0,0,53,0,53,"2013"
"20440","353600 PARAPUA",0,0,0,112,0,112,"2013"
"20441","353610 PARDINHO",1,2,4,76,1,84,"2013"
"20442","353620 PARIQUERA-ACU",2,0,0,256,5,263,"2013"
"20443","353625 PARISI",0,0,0,24,0,24,"2013"
"20444","353630 PATROCINIO PAULISTA",2,3,7,219,2,233,"2013"
"20445","353640 PAULICEIA",2,1,4,98,0,105,"2013"
"20446","353650 PAULINIA",1,3,5,1344,6,1359,"2013"
"20447","353657 PAULISTANIA",0,0,0,17,1,18,"2013"
"20448","353660 PAULO DE FARIA",0,0,1,103,0,104,"2013"
"20449","353670 PEDERNEIRAS",1,1,12,625,5,644,"2013"
"20450","353680 PEDRA BELA",0,0,1,68,0,69,"2013"
"20451","353690 PEDRANOPOLIS",0,0,1,28,0,29,"2013"
"20452","353700 PEDREGULHO",1,1,5,180,1,188,"2013"
"20453","353710 PEDREIRA",0,2,3,512,3,520,"2013"
"20454","353715 PEDRINHAS PAULISTA",0,0,0,23,0,23,"2013"
"20455","353720 PEDRO DE TOLEDO",0,1,3,119,2,125,"2013"
"20456","353730 PENAPOLIS",2,7,28,707,1,745,"2013"
"20457","353740 PEREIRA BARRETO",0,5,7,319,3,334,"2013"
"20458","353750 PEREIRAS",0,1,0,59,9,69,"2013"
"20459","353760 PERUIBE",1,3,12,865,95,976,"2013"
"20460","353770 PIACATU",0,0,2,75,0,77,"2013"
"20461","353780 PIEDADE",3,0,13,638,20,674,"2013"
"20462","353790 PILAR DO SUL",1,0,9,366,0,376,"2013"
"20463","353800 PINDAMONHANGABA",4,5,31,2196,32,2268,"2013"
"20464","353810 PINDORAMA",2,1,0,158,1,162,"2013"
"20465","353820 PINHALZINHO",0,1,2,156,0,159,"2013"
"20466","353830 PIQUEROBI",0,0,1,39,1,41,"2013"
"20467","353850 PIQUETE",0,0,1,124,20,145,"2013"
"20468","353860 PIRACAIA",0,1,10,310,5,326,"2013"
"20469","353870 PIRACICABA",10,20,70,5173,5,5278,"2013"
"20470","353880 PIRAJU",0,4,6,342,0,352,"2013"
"20471","353890 PIRAJUI",1,2,1,227,12,243,"2013"
"20472","353900 PIRANGI",0,0,1,101,2,104,"2013"
"20473","353910 PIRAPORA DO BOM JESUS",0,2,3,237,2,244,"2013"
"20474","353920 PIRAPOZINHO",1,3,6,312,1,323,"2013"
"20475","353930 PIRASSUNUNGA",1,2,7,844,3,857,"2013"
"20476","353940 PIRATININGA",1,0,1,182,2,186,"2013"
"20477","353950 PITANGUEIRAS",3,1,5,483,1,493,"2013"
"20478","353960 PLANALTO",0,0,0,62,0,62,"2013"
"20479","353970 PLATINA",0,0,1,33,0,34,"2013"
"20480","353980 POA",0,7,23,1609,55,1694,"2013"
"20481","353990 POLONI",0,0,0,65,1,66,"2013"
"20482","354000 POMPEIA",2,2,4,254,0,262,"2013"
"20483","354010 PONGAI",0,0,0,28,0,28,"2013"
"20484","354020 PONTAL",4,2,1,538,0,545,"2013"
"20485","354025 PONTALINDA",0,0,1,53,1,55,"2013"
"20486","354030 PONTES GESTAL",0,0,0,34,0,34,"2013"
"20487","354040 POPULINA",1,0,1,47,1,50,"2013"
"20488","354050 PORANGABA",0,1,3,69,6,79,"2013"
"20489","354060 PORTO FELIZ",3,2,8,680,5,698,"2013"
"20490","354070 PORTO FERREIRA",6,1,6,681,1,695,"2013"
"20491","354075 POTIM",3,2,3,250,31,289,"2013"
"20492","354080 POTIRENDABA",0,0,2,197,2,201,"2013"
"20493","354085 PRACINHA",0,0,1,11,0,12,"2013"
"20494","354090 PRADOPOLIS",0,2,10,204,1,217,"2013"
"20495","354100 PRAIA GRANDE",8,28,97,4136,13,4282,"2013"
"20496","354105 PRATANIA",0,1,4,64,0,69,"2013"
"20497","354110 PRESIDENTE ALVES",0,0,0,53,0,53,"2013"
"20498","354120 PRESIDENTE BERNARDES",1,2,2,109,0,114,"2013"
"20499","354130 PRESIDENTE EPITACIO",2,0,3,547,2,554,"2013"
"20500","354140 PRESIDENTE PRUDENTE",6,9,46,2595,2,2658,"2013"
"20501","354150 PRESIDENTE VENCESLAU",0,0,5,395,0,400,"2013"
"20502","354160 PROMISSAO",0,1,5,473,1,480,"2013"
"20503","354165 QUADRA",0,1,0,39,0,40,"2013"
"20504","354170 QUATA",0,1,1,155,2,159,"2013"
"20505","354180 QUEIROZ",0,1,1,43,0,45,"2013"
"20506","354190 QUELUZ",2,0,4,113,2,121,"2013"
"20507","354200 QUINTANA",0,1,1,74,0,76,"2013"
"20508","354210 RAFARD",0,0,1,82,5,88,"2013"
"20509","354220 RANCHARIA",0,2,5,380,0,387,"2013"
"20510","354230 REDENCAO DA SERRA",0,1,1,38,0,40,"2013"
"20511","354240 REGENTE FEIJO",3,1,4,216,0,224,"2013"
"20512","354250 REGINOPOLIS",0,0,2,70,2,74,"2013"
"20513","354260 REGISTRO",2,1,6,888,4,901,"2013"
"20514","354270 RESTINGA",0,0,3,108,0,111,"2013"
"20515","354280 RIBEIRA",0,0,2,41,0,43,"2013"
"20516","354290 RIBEIRAO BONITO",0,0,0,162,0,162,"2013"
"20517","354300 RIBEIRAO BRANCO",0,3,9,258,3,273,"2013"
"20518","354310 RIBEIRAO CORRENTE",0,0,0,67,0,67,"2013"
"20519","354320 RIBEIRAO DO SUL",0,0,0,42,1,43,"2013"
"20520","354323 RIBEIRAO DOS INDIOS",0,0,0,21,0,21,"2013"
"20521","354325 RIBEIRAO GRANDE",0,1,1,107,0,109,"2013"
"20522","354330 RIBEIRAO PIRES",9,6,19,1409,1,1444,"2013"
"20523","354340 RIBEIRAO PRETO",17,39,134,7970,50,8210,"2013"
"20524","354350 RIVERSUL",0,0,3,65,0,68,"2013"
"20525","354360 RIFAINA",0,0,1,34,1,36,"2013"
"20526","354370 RINCAO",0,1,3,133,2,139,"2013"
"20527","354380 RINOPOLIS",1,0,4,93,0,98,"2013"
"20528","354390 RIO CLARO",3,6,19,2300,6,2334,"2013"
"20529","354400 RIO DAS PEDRAS",0,2,4,460,1,467,"2013"
"20530","354410 RIO GRANDE DA SERRA",2,1,9,599,6,617,"2013"
"20531","354420 RIOLANDIA",0,0,0,133,0,133,"2013"
"20532","354425 ROSANA",2,1,6,241,1,251,"2013"
"20533","354430 ROSEIRA",0,1,1,136,17,155,"2013"
"20534","354440 RUBIACEA",0,0,1,26,0,27,"2013"
"20535","354450 RUBINEIA",0,0,0,25,0,25,"2013"
"20536","354460 SABINO",0,0,1,49,0,50,"2013"
"20537","354470 SAGRES",0,1,0,36,0,37,"2013"
"20538","354480 SALES",0,0,2,69,0,71,"2013"
"20539","354490 SALES OLIVEIRA",0,1,1,130,17,149,"2013"
"20540","354500 SALESOPOLIS",0,1,1,181,21,204,"2013"
"20541","354510 SALMOURAO",0,0,0,60,0,60,"2013"
"20542","354515 SALTINHO",0,0,1,85,0,86,"2013"
"20543","354520 SALTO",3,5,19,1531,6,1564,"2013"
"20544","354530 SALTO DE PIRAPORA",1,1,6,595,0,603,"2013"
"20545","354540 SALTO GRANDE",1,0,0,129,2,132,"2013"
"20546","354550 SANDOVALINA",0,0,1,54,1,56,"2013"
"20547","354560 SANTA ADELIA",1,0,1,164,3,169,"2013"
"20548","354570 SANTA ALBERTINA",0,0,1,62,0,63,"2013"
"20549","354580 SANTA BARBARA D'OESTE",3,10,31,2162,6,2212,"2013"
"20550","354600 SANTA BRANCA",0,1,0,142,0,143,"2013"
"20551","354610 SANTA CLARA D'OESTE",0,0,0,22,0,22,"2013"
"20552","354620 SANTA CRUZ DA CONCEICAO",0,0,0,44,0,44,"2013"
"20553","354625 SANTA CRUZ DA ESPERANCA",0,0,0,30,0,30,"2013"
"20554","354630 SANTA CRUZ DAS PALMEIRAS",3,1,10,429,0,443,"2013"
"20555","354640 SANTA CRUZ DO RIO PARDO",2,1,3,561,0,567,"2013"
"20556","354650 SANTA ERNESTINA",0,0,3,55,1,59,"2013"
"20557","354660 SANTA FE DO SUL",1,1,1,319,0,322,"2013"
"20558","354670 SANTA GERTRUDES",1,1,8,311,3,324,"2013"
"20559","354680 SANTA ISABEL",2,2,12,728,3,747,"2013"
"20560","354690 SANTA LUCIA",0,2,1,115,1,119,"2013"
"20561","354700 SANTA MARIA DA SERRA",0,0,0,90,0,90,"2013"
"20562","354710 SANTA MERCEDES",0,0,2,37,0,39,"2013"
"20563","354720 SANTANA DA PONTE PENSA",0,0,0,11,0,11,"2013"
"20564","354730 SANTANA DE PARNAIBA",2,10,24,2010,7,2053,"2013"
"20565","354740 SANTA RITA D'OESTE",0,0,0,25,0,25,"2013"
"20566","354750 SANTA RITA DO PASSA QUATRO",0,1,5,257,0,263,"2013"
"20567","354760 SANTA ROSA DE VITERBO",0,0,1,297,0,298,"2013"
"20568","354765 SANTA SALETE",0,0,0,15,0,15,"2013"
"20569","354770 SANTO ANASTACIO",1,2,3,206,0,212,"2013"
"20570","354780 SANTO ANDRE",18,39,103,8755,26,8941,"2013"
"20571","354790 SANTO ANTONIO DA ALEGRIA",0,1,0,69,0,70,"2013"
"20572","354800 SANTO ANTONIO DE POSSE",0,1,3,273,0,277,"2013"
"20573","354805 SANTO ANTONIO DO ARACANGUA",0,0,2,110,0,112,"2013"
"20574","354810 SANTO ANTONIO DO JARDIM",0,1,1,58,0,60,"2013"
"20575","354820 SANTO ANTONIO DO PINHAL",0,1,1,82,1,85,"2013"
"20576","354830 SANTO EXPEDITO",0,1,0,30,0,31,"2013"
"20577","354840 SANTOPOLIS DO AGUAPEI",1,0,1,65,0,67,"2013"
"20578","354850 SANTOS",12,26,100,4819,16,4973,"2013"
"20579","354860 SAO BENTO DO SAPUCAI",1,0,2,136,1,140,"2013"
"20580","354870 SAO BERNARDO DO CAMPO",14,37,136,10704,38,10929,"2013"
"20581","354880 SAO CAETANO DO SUL",0,2,9,1643,0,1654,"2013"
"20582","354890 SAO CARLOS",4,15,23,2963,5,3010,"2013"
"20583","354900 SAO FRANCISCO",0,1,0,37,1,39,"2013"
"20584","354910 SAO JOAO DA BOA VISTA",2,4,6,968,7,987,"2013"
"20585","354920 SAO JOAO DAS DUAS PONTES",0,0,0,40,0,40,"2013"
"20586","354925 SAO JOAO DE IRACEMA",0,0,0,15,0,15,"2013"
"20587","354930 SAO JOAO DO PAU D'ALHO",0,0,0,17,0,17,"2013"
"20588","354940 SAO JOAQUIM DA BARRA",1,4,16,571,4,596,"2013"
"20589","354950 SAO JOSE DA BELA VISTA",1,0,2,105,1,109,"2013"
"20590","354960 SAO JOSE DO BARREIRO",0,0,1,40,0,41,"2013"
"20591","354970 SAO JOSE DO RIO PARDO",4,4,14,669,1,692,"2013"
"20592","354980 SAO JOSE DO RIO PRETO",13,19,37,5286,3,5358,"2013"
"20593","354990 SAO JOSE DOS CAMPOS",9,37,84,9132,293,9555,"2013"
"20594","354995 SAO LOURENCO DA SERRA",0,0,5,208,0,213,"2013"
"20595","355000 SAO LUIS DO PARAITINGA",0,0,3,101,0,104,"2013"
"20596","355010 SAO MANUEL",0,7,14,488,6,515,"2013"
"20597","355020 SAO MIGUEL ARCANJO",0,1,6,417,2,426,"2013"
"20598","355030 SAO PAULO",446,674,2246,169047,574,172987,"2013"
"20599","355040 SAO PEDRO",0,0,6,395,0,401,"2013"
"20600","355050 SAO PEDRO DO TURVO",0,1,0,85,4,90,"2013"
"20601","355060 SAO ROQUE",3,7,14,994,7,1025,"2013"
"20602","355070 SAO SEBASTIAO",3,4,11,1275,1,1294,"2013"
"20603","355080 SAO SEBASTIAO DA GRAMA",1,0,0,140,0,141,"2013"
"20604","355090 SAO SIMAO",1,1,4,151,4,161,"2013"
"20605","355100 SAO VICENTE",15,37,138,5013,33,5236,"2013"
"20606","355110 SARAPUI",0,1,2,99,0,102,"2013"
"20607","355120 SARUTAIA",0,0,0,46,0,46,"2013"
"20608","355130 SEBASTIANOPOLIS DO SUL",0,0,0,37,0,37,"2013"
"20609","355140 SERRA AZUL",1,1,0,123,5,130,"2013"
"20610","355150 SERRANA",1,7,15,611,23,657,"2013"
"20611","355160 SERRA NEGRA",0,3,2,284,3,292,"2013"
"20612","355170 SERTAOZINHO",5,3,14,1589,11,1622,"2013"
"20613","355180 SETE BARRAS",0,2,3,225,1,231,"2013"
"20614","355190 SEVERINIA",0,1,4,178,3,186,"2013"
"20615","355200 SILVEIRAS",0,0,3,59,2,64,"2013"
"20616","355210 SOCORRO",0,1,3,407,0,411,"2013"
"20617","355220 SOROCABA",26,30,168,8845,43,9112,"2013"
"20618","355230 SUD MENNUCCI",0,1,0,112,1,114,"2013"
"20619","355240 SUMARE",6,7,38,3799,21,3871,"2013"
"20620","355250 SUZANO",4,14,56,4191,85,4350,"2013"
"20621","355255 SUZANAPOLIS",0,0,0,53,1,54,"2013"
"20622","355260 TABAPUA",2,0,3,134,0,139,"2013"
"20623","355270 TABATINGA",0,0,4,172,0,176,"2013"
"20624","355280 TABOAO DA SERRA",12,14,55,4445,22,4548,"2013"
"20625","355290 TACIBA",0,1,1,83,0,85,"2013"
"20626","355300 TAGUAI",0,0,2,175,2,179,"2013"
"20627","355310 TAIACU",0,0,0,66,0,66,"2013"
"20628","355320 TAIUVA",0,0,1,48,0,49,"2013"
"20629","355330 TAMBAU",1,2,1,309,0,313,"2013"
"20630","355340 TANABI",2,1,8,303,0,314,"2013"
"20631","355350 TAPIRAI",0,0,2,86,1,89,"2013"
"20632","355360 TAPIRATIBA",0,2,1,120,1,124,"2013"
"20633","355365 TAQUARAL",0,0,1,31,0,32,"2013"
"20634","355370 TAQUARITINGA",3,0,3,647,1,654,"2013"
"20635","355380 TAQUARITUBA",1,2,13,297,0,313,"2013"
"20636","355385 TAQUARIVAI",0,1,2,72,0,75,"2013"
"20637","355390 TARABAI",0,1,1,91,0,93,"2013"
"20638","355395 TARUMA",1,0,1,187,1,190,"2013"
"20639","355400 TATUI",3,5,19,1671,3,1701,"2013"
"20640","355410 TAUBATE",5,16,56,4024,33,4134,"2013"
"20641","355420 TEJUPA",0,0,0,66,0,66,"2013"
"20642","355430 TEODORO SAMPAIO",0,3,3,314,2,322,"2013"
"20643","355440 TERRA ROXA",0,0,0,64,45,109,"2013"
"20644","355450 TIETE",1,3,9,485,1,499,"2013"
"20645","355460 TIMBURI",0,0,2,23,0,25,"2013"
"20646","355465 TORRE DE PEDRA",0,0,0,32,1,33,"2013"
"20647","355470 TORRINHA",0,0,1,113,1,115,"2013"
"20648","355475 TRABIJU",0,0,0,18,0,18,"2013"
"20649","355480 TREMEMBE",0,1,7,564,11,583,"2013"
"20650","355490 TRES FRONTEIRAS",0,1,0,65,0,66,"2013"
"20651","355495 TUIUTI",0,1,1,61,0,63,"2013"
"20652","355500 TUPA",0,2,3,691,1,697,"2013"
"20653","355510 TUPI PAULISTA",0,0,0,163,0,163,"2013"
"20654","355520 TURIUBA",0,0,0,18,0,18,"2013"
"20655","355530 TURMALINA",0,0,2,13,0,15,"2013"
"20656","355535 UBARANA",0,1,1,73,0,75,"2013"
"20657","355540 UBATUBA",4,10,24,1054,1,1093,"2013"
"20658","355550 UBIRAJARA",0,0,0,61,1,62,"2013"
"20659","355560 UCHOA",2,1,2,114,0,119,"2013"
"20660","355570 UNIAO PAULISTA",0,0,0,26,0,26,"2013"
"20661","355580 URANIA",1,0,2,87,0,90,"2013"
"20662","355590 URU",0,0,0,20,0,20,"2013"
"20663","355600 URUPES",0,0,1,124,0,125,"2013"
"20664","355610 VALENTIM GENTIL",0,0,2,153,0,155,"2013"
"20665","355620 VALINHOS",15,8,11,1345,7,1386,"2013"
"20666","355630 VALPARAISO",0,0,5,342,0,347,"2013"
"20667","355635 VARGEM",0,1,2,125,0,128,"2013"
"20668","355640 VARGEM GRANDE DO SUL",0,4,2,494,1,501,"2013"
"20669","355645 VARGEM GRANDE PAULISTA",2,2,12,690,3,709,"2013"
"20670","355650 VARZEA PAULISTA",3,4,35,1701,2,1745,"2013"
"20671","355660 VERA CRUZ",0,1,3,112,1,117,"2013"
"20672","355670 VINHEDO",1,2,13,933,17,966,"2013"
"20673","355680 VIRADOURO",3,2,1,229,1,236,"2013"
"20674","355690 VISTA ALEGRE DO ALTO",0,1,2,80,1,84,"2013"
"20675","355695 VITORIA BRASIL",0,0,0,18,0,18,"2013"
"20676","355700 VOTORANTIM",4,9,36,1614,8,1671,"2013"
"20677","355710 VOTUPORANGA",3,1,10,1056,0,1070,"2013"
"20678","355715 ZACARIAS",0,0,0,24,0,24,"2013"
"20679","355720 CHAVANTES",0,0,1,171,0,172,"2013"
"20680","355730 ESTIVA GERBI",0,1,3,127,0,131,"2013"
"20681","MUNICIPIO IGNORADO - PR",0,1,0,2,1,4,"2013"
"20682","410010 ABATIA",0,1,2,95,0,98,"2013"
"20683","410020 ADRIANOPOLIS",0,0,1,70,2,73,"2013"
"20684","410030 AGUDOS DO SUL",0,0,2,112,0,114,"2013"
"20685","410040 ALMIRANTE TAMANDARE",9,5,25,1878,6,1923,"2013"
"20686","410045 ALTAMIRA DO PARANA",0,0,0,54,0,54,"2013"
"20687","410050 ALTONIA",1,3,7,284,0,295,"2013"
"20688","410060 ALTO PARANA",0,0,2,179,0,181,"2013"
"20689","410070 ALTO PIQUIRI",0,1,6,127,0,134,"2013"
"20690","410080 ALVORADA DO SUL",0,1,1,81,0,83,"2013"
"20691","410090 AMAPORA",0,0,0,71,0,71,"2013"
"20692","410100 AMPERE",0,0,4,243,3,250,"2013"
"20693","410105 ANAHY",0,0,0,33,0,33,"2013"
"20694","410110 ANDIRA",1,1,3,234,0,239,"2013"
"20695","410115 ANGULO",0,0,0,46,0,46,"2013"
"20696","410120 ANTONINA",2,1,4,309,0,316,"2013"
"20697","410130 ANTONIO OLINTO",0,0,1,73,2,76,"2013"
"20698","410140 APUCARANA",7,1,16,1682,2,1708,"2013"
"20699","410150 ARAPONGAS",5,7,16,1630,2,1660,"2013"
"20700","410160 ARAPOTI",1,1,6,360,1,369,"2013"
"20701","410165 ARAPUA",0,0,0,43,0,43,"2013"
"20702","410170 ARARUNA",1,0,0,173,1,175,"2013"
"20703","410180 ARAUCARIA",3,8,21,2298,6,2336,"2013"
"20704","410185 ARIRANHA DO IVAI",0,0,1,35,0,36,"2013"
"20705","410190 ASSAI",0,1,4,208,0,213,"2013"
"20706","410200 ASSIS CHATEAUBRIAND",2,0,5,362,2,371,"2013"
"20707","410210 ASTORGA",0,2,1,345,0,348,"2013"
"20708","410220 ATALAIA",0,0,0,48,0,48,"2013"
"20709","410230 BALSA NOVA",0,1,5,191,0,197,"2013"
"20710","410240 BANDEIRANTES",0,1,4,422,0,427,"2013"
"20711","410250 BARBOSA FERRAZ",1,1,2,119,1,124,"2013"
"20712","410260 BARRACAO",1,0,4,132,0,137,"2013"
"20713","410270 BARRA DO JACARE",1,0,0,35,0,36,"2013"
"20714","410275 BELA VISTA DA CAROBA",0,0,2,26,0,28,"2013"
"20715","410280 BELA VISTA DO PARAISO",0,2,2,220,0,224,"2013"
"20716","410290 BITURUNA",0,2,0,232,0,234,"2013"
"20717","410300 BOA ESPERANCA",0,0,0,51,0,51,"2013"
"20718","410302 BOA ESPERANCA DO IGUACU",0,0,1,36,0,37,"2013"
"20719","410304 BOA VENTURA DE SAO ROQUE",0,1,3,85,0,89,"2013"
"20720","410305 BOA VISTA DA APARECIDA",0,0,0,107,1,108,"2013"
"20721","410310 BOCAIUVA DO SUL",1,1,3,159,0,164,"2013"
"20722","410315 BOM JESUS DO SUL",0,0,1,40,0,41,"2013"
"20723","410320 BOM SUCESSO",1,0,3,98,0,102,"2013"
"20724","410322 BOM SUCESSO DO SUL",0,1,0,43,0,44,"2013"
"20725","410330 BORRAZOPOLIS",1,1,2,63,0,67,"2013"
"20726","410335 BRAGANEY",0,0,2,80,1,83,"2013"
"20727","410337 BRASILANDIA DO SUL",0,0,1,45,0,46,"2013"
"20728","410340 CAFEARA",0,0,1,20,0,21,"2013"
"20729","410345 CAFELANDIA",0,1,1,240,0,242,"2013"
"20730","410347 CAFEZAL DO SUL",0,0,0,45,0,45,"2013"
"20731","410350 CALIFORNIA",0,1,2,90,0,93,"2013"
"20732","410360 CAMBARA",0,0,3,284,0,287,"2013"
"20733","410370 CAMBE",10,8,34,1335,4,1391,"2013"
"20734","410380 CAMBIRA",0,0,1,88,0,89,"2013"
"20735","410390 CAMPINA DA LAGOA",1,3,0,209,1,214,"2013"
"20736","410395 CAMPINA DO SIMAO",0,0,0,47,1,48,"2013"
"20737","410400 CAMPINA GRANDE DO SUL",2,5,13,766,2,788,"2013"
"20738","410405 CAMPO BONITO",0,0,2,56,0,58,"2013"
"20739","410410 CAMPO DO TENENTE",0,2,3,113,2,120,"2013"
"20740","410420 CAMPO LARGO",5,15,34,1729,12,1795,"2013"
"20741","410425 CAMPO MAGRO",0,1,7,398,2,408,"2013"
"20742","410430 CAMPO MOURAO",0,3,11,1314,0,1328,"2013"
"20743","410440 CANDIDO DE ABREU",1,0,3,192,1,197,"2013"
"20744","410442 CANDOI",1,3,4,212,0,220,"2013"
"20745","410445 CANTAGALO",1,2,7,177,3,190,"2013"
"20746","410450 CAPANEMA",0,1,0,230,0,231,"2013"
"20747","410460 CAPITAO LEONIDAS MARQUES",0,0,0,180,0,180,"2013"
"20748","410465 CARAMBEI",0,0,9,362,0,371,"2013"
"20749","410470 CARLOPOLIS",0,2,2,181,3,188,"2013"
"20750","410480 CASCAVEL",3,24,98,4517,4,4646,"2013"
"20751","410490 CASTRO",5,4,15,1203,4,1231,"2013"
"20752","410500 CATANDUVAS",0,0,3,110,0,113,"2013"
"20753","410510 CENTENARIO DO SUL",0,0,2,112,2,116,"2013"
"20754","410520 CERRO AZUL",1,0,5,230,1,237,"2013"
"20755","410530 CEU AZUL",0,0,1,129,0,130,"2013"
"20756","410540 CHOPINZINHO",0,2,5,250,0,257,"2013"
"20757","410550 CIANORTE",1,4,8,1034,0,1047,"2013"
"20758","410560 CIDADE GAUCHA",1,3,2,155,0,161,"2013"
"20759","410570 CLEVELANDIA",2,1,3,278,0,284,"2013"
"20760","410580 COLOMBO",11,15,49,3768,11,3854,"2013"
"20761","410590 COLORADO",1,1,7,259,0,268,"2013"
"20762","410600 CONGONHINHAS",0,0,1,138,0,139,"2013"
"20763","410610 CONSELHEIRO MAIRINCK",0,0,1,39,1,41,"2013"
"20764","410620 CONTENDA",0,1,2,216,2,221,"2013"
"20765","410630 CORBELIA",1,0,1,190,0,192,"2013"
"20766","410640 CORNELIO PROCOPIO",0,3,9,542,2,556,"2013"
"20767","410645 CORONEL DOMINGOS SOARES",0,2,0,110,1,113,"2013"
"20768","410650 CORONEL VIVIDA",0,1,6,317,1,325,"2013"
"20769","410655 CORUMBATAI DO SUL",1,0,0,33,0,34,"2013"
"20770","410657 CRUZEIRO DO IGUACU",0,0,0,55,0,55,"2013"
"20771","410660 CRUZEIRO DO OESTE",1,1,6,252,2,262,"2013"
"20772","410670 CRUZEIRO DO SUL",0,0,1,57,0,58,"2013"
"20773","410680 CRUZ MACHADO",1,0,4,233,0,238,"2013"
"20774","410685 CRUZMALTINA",0,0,1,41,0,42,"2013"
"20775","410690 CURITIBA",51,93,333,24415,40,24932,"2013"
"20776","410700 CURIUVA",1,0,0,172,0,173,"2013"
"20777","410710 DIAMANTE DO NORTE",0,0,0,66,0,66,"2013"
"20778","410712 DIAMANTE DO SUL",0,0,1,37,0,38,"2013"
"20779","410715 DIAMANTE D'OESTE",0,0,2,74,2,78,"2013"
"20780","410720 DOIS VIZINHOS",4,2,6,548,7,567,"2013"
"20781","410725 DOURADINA",0,1,1,140,0,142,"2013"
"20782","410730 DOUTOR CAMARGO",0,0,1,72,0,73,"2013"
"20783","410740 ENEAS MARQUES",0,0,0,60,0,60,"2013"
"20784","410750 ENGENHEIRO BELTRAO",0,1,0,162,1,164,"2013"
"20785","410752 ESPERANCA NOVA",0,1,0,24,0,25,"2013"
"20786","410753 ENTRE RIOS DO OESTE",0,0,0,38,0,38,"2013"
"20787","410754 ESPIGAO ALTO DO IGUACU",0,0,2,65,0,67,"2013"
"20788","410755 FAROL",0,0,1,44,0,45,"2013"
"20789","410760 FAXINAL",1,3,3,258,1,266,"2013"
"20790","410765 FAZENDA RIO GRANDE",7,12,22,1726,4,1771,"2013"
"20791","410770 FENIX",0,1,1,69,0,71,"2013"
"20792","410773 FERNANDES PINHEIRO",0,0,0,86,0,86,"2013"
"20793","410775 FIGUEIRA",0,1,0,103,0,104,"2013"
"20794","410780 FLORAI",1,0,1,61,0,63,"2013"
"20795","410785 FLOR DA SERRA DO SUL",0,0,2,66,0,68,"2013"
"20796","410790 FLORESTA",1,1,0,90,0,92,"2013"
"20797","410800 FLORESTOPOLIS",0,0,0,151,0,151,"2013"
"20798","410810 FLORIDA",0,1,0,30,0,31,"2013"
"20799","410820 FORMOSA DO OESTE",0,0,10,67,0,77,"2013"
"20800","410830 FOZ DO IGUACU",7,17,42,4304,15,4385,"2013"
"20801","410832 FRANCISCO ALVES",0,1,3,91,0,95,"2013"
"20802","410840 FRANCISCO BELTRAO",7,4,11,1170,0,1192,"2013"
"20803","410845 FOZ DO JORDAO",0,1,3,81,0,85,"2013"
"20804","410850 GENERAL CARNEIRO",0,2,4,195,0,201,"2013"
"20805","410855 GODOY MOREIRA",0,0,0,32,1,33,"2013"
"20806","410860 GOIOERE",0,2,5,390,4,401,"2013"
"20807","410865 GOIOXIM",0,0,1,88,0,89,"2013"
"20808","410870 GRANDES RIOS",0,2,2,92,0,96,"2013"
"20809","410880 GUAIRA",1,0,5,465,1,472,"2013"
"20810","410890 GUAIRACA",0,1,0,90,0,91,"2013"
"20811","410895 GUAMIRANGA",0,0,0,105,0,105,"2013"
"20812","410900 GUAPIRAMA",0,1,2,53,0,56,"2013"
"20813","410910 GUAPOREMA",0,0,0,24,0,24,"2013"
"20814","410920 GUARACI",1,0,3,58,0,62,"2013"
"20815","410930 GUARANIACU",2,2,8,176,0,188,"2013"
"20816","410940 GUARAPUAVA",8,17,25,2744,1,2795,"2013"
"20817","410950 GUARAQUECABA",0,0,1,106,1,108,"2013"
"20818","410960 GUARATUBA",0,2,11,508,0,521,"2013"
"20819","410965 HONORIO SERPA",0,0,1,63,0,64,"2013"
"20820","410970 IBAITI",1,1,19,347,1,369,"2013"
"20821","410975 IBEMA",0,1,4,112,0,117,"2013"
"20822","410980 IBIPORA",4,4,9,705,7,729,"2013"
"20823","410990 ICARAIMA",0,0,1,118,0,119,"2013"
"20824","411000 IGUARACU",1,0,3,61,0,65,"2013"
"20825","411005 IGUATU",0,0,0,16,0,16,"2013"
"20826","411007 IMBAU",1,0,1,184,0,186,"2013"
"20827","411010 IMBITUVA",1,1,2,458,0,462,"2013"
"20828","411020 INACIO MARTINS",1,0,1,167,1,170,"2013"
"20829","411030 INAJA",0,0,0,36,0,36,"2013"
"20830","411040 INDIANOPOLIS",0,0,0,64,0,64,"2013"
"20831","411050 IPIRANGA",1,1,6,167,0,175,"2013"
"20832","411060 IPORA",2,2,0,182,0,186,"2013"
"20833","411065 IRACEMA DO OESTE",0,0,2,14,0,16,"2013"
"20834","411070 IRATI",0,4,1,798,0,803,"2013"
"20835","411080 IRETAMA",0,0,3,142,0,145,"2013"
"20836","411090 ITAGUAJE",0,0,2,51,0,53,"2013"
"20837","411095 ITAIPULANDIA",0,0,3,148,1,152,"2013"
"20838","411100 ITAMBARACA",0,0,2,77,0,79,"2013"
"20839","411110 ITAMBE",0,2,2,66,0,70,"2013"
"20840","411120 ITAPEJARA D'OESTE",0,0,0,116,0,116,"2013"
"20841","411125 ITAPERUCU",1,0,3,519,2,525,"2013"
"20842","411130 ITAUNA DO SUL",1,2,1,53,0,57,"2013"
"20843","411140 IVAI",0,0,2,218,0,220,"2013"
"20844","411150 IVAIPORA",2,1,7,386,0,396,"2013"
"20845","411155 IVATE",0,1,3,103,0,107,"2013"
"20846","411160 IVATUBA",0,0,0,31,0,31,"2013"
"20847","411170 JABOTI",0,0,1,68,0,69,"2013"
"20848","411180 JACAREZINHO",0,2,1,575,1,579,"2013"
"20849","411190 JAGUAPITA",0,1,2,186,0,189,"2013"
"20850","411200 JAGUARIAIVA",2,2,11,513,0,528,"2013"
"20851","411210 JANDAIA DO SUL",0,1,3,262,0,266,"2013"
"20852","411220 JANIOPOLIS",0,0,1,71,0,72,"2013"
"20853","411230 JAPIRA",1,0,1,55,0,57,"2013"
"20854","411240 JAPURA",0,0,0,82,0,82,"2013"
"20855","411250 JARDIM ALEGRE",1,0,3,149,1,154,"2013"
"20856","411260 JARDIM OLINDA",0,0,1,19,0,20,"2013"
"20857","411270 JATAIZINHO",0,2,5,160,0,167,"2013"
"20858","411275 JESUITAS",0,1,3,99,0,103,"2013"
"20859","411280 JOAQUIM TAVORA",0,2,2,144,0,148,"2013"
"20860","411290 JUNDIAI DO SUL",0,0,1,24,0,25,"2013"
"20861","411295 JURANDA",0,0,3,103,0,106,"2013"
"20862","411300 JUSSARA",0,0,1,89,0,90,"2013"
"20863","411310 KALORE",0,1,1,52,0,54,"2013"
"20864","411320 LAPA",0,3,17,604,1,625,"2013"
"20865","411325 LARANJAL",0,0,1,102,0,103,"2013"
"20866","411330 LARANJEIRAS DO SUL",2,3,7,477,1,490,"2013"
"20867","411340 LEOPOLIS",0,1,1,38,0,40,"2013"
"20868","411342 LIDIANOPOLIS",0,1,4,41,0,46,"2013"
"20869","411345 LINDOESTE",0,0,3,74,0,77,"2013"
"20870","411350 LOANDA",0,0,1,294,1,296,"2013"
"20871","411360 LOBATO",1,0,0,53,0,54,"2013"
"20872","411370 LONDRINA",21,28,89,7038,19,7195,"2013"
"20873","411373 LUIZIANA",0,0,1,104,0,105,"2013"
"20874","411375 LUNARDELLI",0,0,2,44,0,46,"2013"
"20875","411380 LUPIONOPOLIS",0,1,1,55,0,57,"2013"
"20876","411390 MALLET",0,0,0,138,0,138,"2013"
"20877","411400 MAMBORE",0,0,3,162,1,166,"2013"
"20878","411410 MANDAGUACU",2,0,0,281,0,283,"2013"
"20879","411420 MANDAGUARI",4,0,5,425,0,434,"2013"
"20880","411430 MANDIRITUBA",0,0,10,358,0,368,"2013"
"20881","411435 MANFRINOPOLIS",0,0,0,27,0,27,"2013"
"20882","411440 MANGUEIRINHA",1,4,14,230,0,249,"2013"
"20883","411450 MANOEL RIBAS",0,0,3,200,2,205,"2013"
"20884","411460 MARECHAL CANDIDO RONDON",1,3,11,625,0,640,"2013"
"20885","411470 MARIA HELENA",0,1,2,61,1,65,"2013"
"20886","411480 MARIALVA",2,1,3,468,0,474,"2013"
"20887","411490 MARILANDIA DO SUL",1,1,4,113,0,119,"2013"
"20888","411500 MARILENA",0,0,1,100,0,101,"2013"
"20889","411510 MARILUZ",0,0,4,139,0,143,"2013"
"20890","411520 MARINGA",12,12,67,4830,4,4925,"2013"
"20891","411530 MARIOPOLIS",1,0,1,78,0,80,"2013"
"20892","411535 MARIPA",0,1,0,65,0,66,"2013"
"20893","411540 MARMELEIRO",0,0,0,165,0,165,"2013"
"20894","411545 MARQUINHO",1,1,2,72,0,76,"2013"
"20895","411550 MARUMBI",0,0,1,55,0,56,"2013"
"20896","411560 MATELANDIA",1,1,3,239,0,244,"2013"
"20897","411570 MATINHOS",1,5,4,478,1,489,"2013"
"20898","411573 MATO RICO",0,0,0,32,0,32,"2013"
"20899","411575 MAUA DA SERRA",1,2,1,141,1,146,"2013"
"20900","411580 MEDIANEIRA",1,2,9,663,0,675,"2013"
"20901","411585 MERCEDES",0,0,1,51,0,52,"2013"
"20902","411590 MIRADOR",0,1,0,24,0,25,"2013"
"20903","411600 MIRASELVA",0,1,1,12,0,14,"2013"
"20904","411605 MISSAL",0,0,3,130,1,134,"2013"
"20905","411610 MOREIRA SALES",1,0,1,158,0,160,"2013"
"20906","411620 MORRETES",0,1,0,242,2,245,"2013"
"20907","411630 MUNHOZ DE MELO",0,0,0,42,0,42,"2013"
"20908","411640 NOSSA SENHORA DAS GRACAS",0,1,3,54,0,58,"2013"
"20909","411650 NOVA ALIANCA DO IVAI",0,0,0,21,0,21,"2013"
"20910","411660 NOVA AMERICA DA COLINA",0,0,0,40,0,40,"2013"
"20911","411670 NOVA AURORA",0,1,3,126,0,130,"2013"
"20912","411680 NOVA CANTU",0,0,1,81,0,82,"2013"
"20913","411690 NOVA ESPERANCA",0,0,4,312,0,316,"2013"
"20914","411695 NOVA ESPERANCA DO SUDOESTE",0,0,3,66,0,69,"2013"
"20915","411700 NOVA FATIMA",0,0,2,84,1,87,"2013"
"20916","411705 NOVA LARANJEIRAS",0,1,1,158,2,162,"2013"
"20917","411710 NOVA LONDRINA",0,1,0,176,1,178,"2013"
"20918","411720 NOVA OLIMPIA",0,0,1,77,0,78,"2013"
"20919","411721 NOVA SANTA BARBARA",0,0,0,46,0,46,"2013"
"20920","411722 NOVA SANTA ROSA",0,0,2,88,0,90,"2013"
"20921","411725 NOVA PRATA DO IGUACU",0,0,0,102,1,103,"2013"
"20922","411727 NOVA TEBAS",0,0,2,83,0,85,"2013"
"20923","411729 NOVO ITACOLOMI",0,0,1,28,0,29,"2013"
"20924","411730 ORTIGUEIRA",1,0,9,282,0,292,"2013"
"20925","411740 OURIZONA",0,0,1,52,0,53,"2013"
"20926","411745 OURO VERDE DO OESTE",1,1,1,75,0,78,"2013"
"20927","411750 PAICANDU",0,1,1,557,1,560,"2013"
"20928","411760 PALMAS",7,1,6,876,2,892,"2013"
"20929","411770 PALMEIRA",2,1,6,453,3,465,"2013"
"20930","411780 PALMITAL",0,0,4,219,0,223,"2013"
"20931","411790 PALOTINA",1,3,13,407,0,424,"2013"
"20932","411800 PARAISO DO NORTE",0,2,0,159,0,161,"2013"
"20933","411810 PARANACITY",2,1,4,131,0,138,"2013"
"20934","411820 PARANAGUA",5,8,38,2339,4,2394,"2013"
"20935","411830 PARANAPOEMA",0,0,0,39,0,39,"2013"
"20936","411840 PARANAVAI",0,3,4,1216,0,1223,"2013"
"20937","411845 PATO BRAGADO",0,0,1,53,0,54,"2013"
"20938","411850 PATO BRANCO",5,6,20,1138,1,1170,"2013"
"20939","411860 PAULA FREITAS",1,0,1,73,0,75,"2013"
"20940","411870 PAULO FRONTIN",0,0,1,80,0,81,"2013"
"20941","411880 PEABIRU",0,0,2,170,0,172,"2013"
"20942","411885 PEROBAL",0,0,1,76,0,77,"2013"
"20943","411890 PEROLA",0,0,2,144,0,146,"2013"
"20944","411900 PEROLA D'OESTE",0,0,1,69,0,70,"2013"
"20945","411910 PIEN",0,1,3,155,0,159,"2013"
"20946","411915 PINHAIS",5,2,36,1972,7,2022,"2013"
"20947","411920 PINHALAO",0,0,0,90,0,90,"2013"
"20948","411925 PINHAL DE SAO BENTO",0,0,0,39,0,39,"2013"
"20949","411930 PINHAO",2,2,4,527,1,536,"2013"
"20950","411940 PIRAI DO SUL",2,1,3,347,0,353,"2013"
"20951","411950 PIRAQUARA",2,6,40,1569,4,1621,"2013"
"20952","411960 PITANGA",0,2,17,446,0,465,"2013"
"20953","411965 PITANGUEIRAS",0,0,0,36,0,36,"2013"
"20954","411970 PLANALTINA DO PARANA",0,0,0,49,0,49,"2013"
"20955","411980 PLANALTO",1,0,1,121,1,124,"2013"
"20956","411990 PONTA GROSSA",13,29,107,5046,1,5196,"2013"
"20957","411995 PONTAL DO PARANA",1,1,5,316,1,324,"2013"
"20958","412000 PORECATU",0,0,2,150,1,153,"2013"
"20959","412010 PORTO AMAZONAS",0,0,1,51,0,52,"2013"
"20960","412015 PORTO BARREIRO",0,0,0,47,0,47,"2013"
"20961","412020 PORTO RICO",0,0,0,24,0,24,"2013"
"20962","412030 PORTO VITORIA",0,0,0,62,0,62,"2013"
"20963","412033 PRADO FERREIRA",0,0,0,55,0,55,"2013"
"20964","412035 PRANCHITA",1,0,1,57,0,59,"2013"
"20965","412040 PRESIDENTE CASTELO BRANCO",1,0,2,67,0,70,"2013"
"20966","412050 PRIMEIRO DE MAIO",1,0,3,87,0,91,"2013"
"20967","412060 PRUDENTOPOLIS",2,1,11,620,1,635,"2013"
"20968","412065 QUARTO CENTENARIO",0,0,2,56,3,61,"2013"
"20969","412070 QUATIGUA",1,1,0,83,0,85,"2013"
"20970","412080 QUATRO BARRAS",2,1,3,350,0,356,"2013"
"20971","412085 QUATRO PONTES",0,0,0,30,0,30,"2013"
"20972","412090 QUEDAS DO IGUACU",1,3,14,427,1,446,"2013"
"20973","412100 QUERENCIA DO NORTE",1,1,2,187,1,192,"2013"
"20974","412110 QUINTA DO SOL",0,0,1,49,0,50,"2013"
"20975","412120 QUITANDINHA",0,0,5,202,0,207,"2013"
"20976","412125 RAMILANDIA",1,0,0,66,0,67,"2013"
"20977","412130 RANCHO ALEGRE",0,0,2,45,0,47,"2013"
"20978","412135 RANCHO ALEGRE D'OESTE",0,0,1,27,0,28,"2013"
"20979","412140 REALEZA",1,2,3,217,2,225,"2013"
"20980","412150 REBOUCAS",1,0,1,201,0,203,"2013"
"20981","412160 RENASCENCA",0,1,1,84,0,86,"2013"
"20982","412170 RESERVA",2,3,4,380,2,391,"2013"
"20983","412175 RESERVA DO IGUACU",0,1,3,108,0,112,"2013"
"20984","412180 RIBEIRAO CLARO",1,0,1,137,1,140,"2013"
"20985","412190 RIBEIRAO DO PINHAL",0,2,3,166,0,171,"2013"
"20986","412200 RIO AZUL",0,0,1,189,0,190,"2013"
"20987","412210 RIO BOM",0,0,0,38,0,38,"2013"
"20988","412215 RIO BONITO DO IGUACU",3,0,5,197,0,205,"2013"
"20989","412217 RIO BRANCO DO IVAI",0,0,0,48,0,48,"2013"
"20990","412220 RIO BRANCO DO SUL",1,1,15,590,2,609,"2013"
"20991","412230 RIO NEGRO",0,3,4,337,1,345,"2013"
"20992","412240 ROLANDIA",6,1,6,868,2,883,"2013"
"20993","412250 RONCADOR",1,0,0,163,0,164,"2013"
"20994","412260 RONDON",0,0,1,130,0,131,"2013"
"20995","412265 ROSARIO DO IVAI",0,2,2,60,1,65,"2013"
"20996","412270 SABAUDIA",0,0,1,78,0,79,"2013"
"20997","412280 SALGADO FILHO",0,0,1,64,0,65,"2013"
"20998","412290 SALTO DO ITARARE",1,0,1,47,0,49,"2013"
"20999","412300 SALTO DO LONTRA",1,0,0,199,3,203,"2013"
"21000","412310 SANTA AMELIA",1,0,1,48,1,51,"2013"
"21001","412320 SANTA CECILIA DO PAVAO",0,0,1,48,0,49,"2013"
"21002","412330 SANTA CRUZ DE MONTE CASTELO",0,0,1,103,0,104,"2013"
"21003","412340 SANTA FE",1,2,2,115,0,120,"2013"
"21004","412350 SANTA HELENA",0,2,5,319,0,326,"2013"
"21005","412360 SANTA INES",0,0,0,26,0,26,"2013"
"21006","412370 SANTA ISABEL DO IVAI",0,1,0,116,1,118,"2013"
"21007","412380 SANTA IZABEL DO OESTE",0,0,0,137,1,138,"2013"
"21008","412382 SANTA LUCIA",0,0,0,43,0,43,"2013"
"21009","412385 SANTA MARIA DO OESTE",0,0,1,143,1,145,"2013"
"21010","412390 SANTA MARIANA",3,1,3,112,1,120,"2013"
"21011","412395 SANTA MONICA",0,0,1,53,1,55,"2013"
"21012","412400 SANTANA DO ITARARE",1,0,1,43,0,45,"2013"
"21013","412402 SANTA TEREZA DO OESTE",2,1,1,152,0,156,"2013"
"21014","412405 SANTA TEREZINHA DE ITAIPU",0,1,0,294,3,298,"2013"
"21015","412410 SANTO ANTONIO DA PLATINA",0,3,4,556,6,569,"2013"
"21016","412420 SANTO ANTONIO DO CAIUA",0,0,0,30,0,30,"2013"
"21017","412430 SANTO ANTONIO DO PARAISO",0,0,1,32,0,33,"2013"
"21018","412440 SANTO ANTONIO DO SUDOESTE",0,1,1,229,2,233,"2013"
"21019","412450 SANTO INACIO",0,0,2,101,0,103,"2013"
"21020","412460 SAO CARLOS DO IVAI",0,0,0,91,0,91,"2013"
"21021","412470 SAO JERONIMO DA SERRA",1,0,4,167,2,174,"2013"
"21022","412480 SAO JOAO",0,0,4,129,0,133,"2013"
"21023","412490 SAO JOAO DO CAIUA",1,0,0,68,0,69,"2013"
"21024","412500 SAO JOAO DO IVAI",0,0,1,139,1,141,"2013"
"21025","412510 SAO JOAO DO TRIUNFO",0,1,2,156,0,159,"2013"
"21026","412520 SAO JORGE D'OESTE",0,0,2,106,0,108,"2013"
"21027","412530 SAO JORGE DO IVAI",0,0,1,46,0,47,"2013"
"21028","412535 SAO JORGE DO PATROCINIO",0,0,1,75,0,76,"2013"
"21029","412540 SAO JOSE DA BOA VISTA",1,0,0,60,0,61,"2013"
"21030","412545 SAO JOSE DAS PALMEIRAS",0,0,0,54,0,54,"2013"
"21031","412550 SAO JOSE DOS PINHAIS",7,26,94,4867,17,5011,"2013"
"21032","412555 SAO MANOEL DO PARANA",0,0,0,20,0,20,"2013"
"21033","412560 SAO MATEUS DO SUL",0,2,6,591,1,600,"2013"
"21034","412570 SAO MIGUEL DO IGUACU",3,0,5,369,5,382,"2013"
"21035","412575 SAO PEDRO DO IGUACU",1,0,3,74,0,78,"2013"
"21036","412580 SAO PEDRO DO IVAI",0,0,1,100,0,101,"2013"
"21037","412590 SAO PEDRO DO PARANA",0,0,1,35,0,36,"2013"
"21038","412600 SAO SEBASTIAO DA AMOREIRA",0,0,3,124,0,127,"2013"
"21039","412610 SAO TOME",0,0,0,97,0,97,"2013"
"21040","412620 SAPOPEMA",0,0,1,77,0,78,"2013"
"21041","412625 SARANDI",11,4,19,1339,1,1374,"2013"
"21042","412627 SAUDADE DO IGUACU",0,0,2,71,0,73,"2013"
"21043","412630 SENGES",0,1,6,258,2,267,"2013"
"21044","412635 SERRANOPOLIS DO IGUACU",0,0,0,62,0,62,"2013"
"21045","412640 SERTANEJA",0,0,0,80,0,80,"2013"
"21046","412650 SERTANOPOLIS",0,2,2,205,1,210,"2013"
"21047","412660 SIQUEIRA CAMPOS",0,1,3,275,0,279,"2013"
"21048","412665 SULINA",0,0,1,40,0,41,"2013"
"21049","412667 TAMARANA",2,1,1,161,0,165,"2013"
"21050","412670 TAMBOARA",0,0,1,59,0,60,"2013"
"21051","412680 TAPEJARA",1,0,3,220,1,225,"2013"
"21052","412690 TAPIRA",1,1,0,63,0,65,"2013"
"21053","412700 TEIXEIRA SOARES",1,0,0,124,0,125,"2013"
"21054","412710 TELEMACO BORBA",3,6,12,1065,0,1086,"2013"
"21055","412720 TERRA BOA",1,0,2,227,0,230,"2013"
"21056","412730 TERRA RICA",1,0,5,221,0,227,"2013"
"21057","412740 TERRA ROXA",1,3,2,203,0,209,"2013"
"21058","412750 TIBAGI",0,0,8,298,1,307,"2013"
"21059","412760 TIJUCAS DO SUL",1,2,2,220,0,225,"2013"
"21060","412770 TOLEDO",2,12,23,1862,0,1899,"2013"
"21061","412780 TOMAZINA",1,1,1,95,0,98,"2013"
"21062","412785 TRES BARRAS DO PARANA",0,0,4,174,0,178,"2013"
"21063","412788 TUNAS DO PARANA",0,1,1,95,0,97,"2013"
"21064","412790 TUNEIRAS DO OESTE",1,0,0,103,0,104,"2013"
"21065","412795 TUPASSI",0,0,0,86,1,87,"2013"
"21066","412796 TURVO",0,1,5,209,0,215,"2013"
"21067","412800 UBIRATA",0,0,3,235,0,238,"2013"
"21068","412810 UMUARAMA",1,5,26,1349,0,1381,"2013"
"21069","412820 UNIAO DA VITORIA",2,1,9,759,1,772,"2013"
"21070","412830 UNIFLOR",0,0,0,22,0,22,"2013"
"21071","412840 URAI",0,0,3,110,0,113,"2013"
"21072","412850 WENCESLAU BRAZ",0,0,4,272,0,276,"2013"
"21073","412853 VENTANIA",1,0,2,124,2,129,"2013"
"21074","412855 VERA CRUZ DO OESTE",0,1,2,107,0,110,"2013"
"21075","412860 VERE",1,0,0,97,0,98,"2013"
"21076","412862 ALTO PARAISO",0,1,0,45,0,46,"2013"
"21077","412863 DOUTOR ULYSSES",0,0,1,62,0,63,"2013"
"21078","412865 VIRMOND",0,0,0,54,1,55,"2013"
"21079","412870 VITORINO",1,0,1,87,0,89,"2013"
"21080","412880 XAMBRE",0,1,2,60,0,63,"2013"
"21081","MUNICIPIO IGNORADO - SC",0,0,0,1,0,1,"2013"
"21082","420005 ABDON BATISTA",0,0,0,48,0,48,"2013"
"21083","420010 ABELARDO LUZ",1,1,5,251,0,258,"2013"
"21084","420020 AGROLANDIA",0,1,2,134,1,138,"2013"
"21085","420030 AGRONOMICA",0,0,0,41,0,41,"2013"
"21086","420040 AGUA DOCE",1,0,1,71,0,73,"2013"
"21087","420050 AGUAS DE CHAPECO",0,0,0,71,0,71,"2013"
"21088","420055 AGUAS FRIAS",0,0,0,32,0,32,"2013"
"21089","420060 AGUAS MORNAS",0,0,0,60,0,60,"2013"
"21090","420070 ALFREDO WAGNER",0,0,6,108,0,114,"2013"
"21091","420075 ALTO BELA VISTA",0,0,0,8,0,8,"2013"
"21092","420080 ANCHIETA",1,0,1,76,0,78,"2013"
"21093","420090 ANGELINA",0,0,0,51,0,51,"2013"
"21094","420100 ANITA GARIBALDI",0,1,2,111,0,114,"2013"
"21095","420110 ANITAPOLIS",0,1,0,29,0,30,"2013"
"21096","420120 ANTONIO CARLOS",0,1,0,96,0,97,"2013"
"21097","420125 APIUNA",0,1,1,121,2,125,"2013"
"21098","420127 ARABUTA",0,0,0,45,0,45,"2013"
"21099","420130 ARAQUARI",1,0,10,447,1,459,"2013"
"21100","420140 ARARANGUA",7,4,3,812,3,829,"2013"
"21101","420150 ARMAZEM",1,0,0,94,0,95,"2013"
"21102","420160 ARROIO TRINTA",0,0,1,31,0,32,"2013"
"21103","420165 ARVOREDO",0,0,0,24,0,24,"2013"
"21104","420170 ASCURRA",0,0,1,78,0,79,"2013"
"21105","420180 ATALANTA",0,1,1,43,0,45,"2013"
"21106","420190 AURORA",0,0,3,65,0,68,"2013"
"21107","420195 BALNEARIO ARROIO DO SILVA",0,0,0,149,0,149,"2013"
"21108","420200 BALNEARIO CAMBORIU",3,3,15,1416,5,1442,"2013"
"21109","420205 BALNEARIO BARRA DO SUL",0,0,0,107,0,107,"2013"
"21110","420207 BALNEARIO GAIVOTA",0,0,0,118,0,118,"2013"
"21111","420208 BANDEIRANTE",0,0,0,32,0,32,"2013"
"21112","420209 BARRA BONITA",0,0,2,16,0,18,"2013"
"21113","420210 BARRA VELHA",1,2,9,397,2,411,"2013"
"21114","420213 BELA VISTA DO TOLDO",0,1,0,67,0,68,"2013"
"21115","420215 BELMONTE",0,0,2,27,0,29,"2013"
"21116","420220 BENEDITO NOVO",0,1,1,107,1,110,"2013"
"21117","420230 BIGUACU",3,6,11,867,2,889,"2013"
"21118","420240 BLUMENAU",8,6,55,4199,0,4268,"2013"
"21119","420243 BOCAINA DO SUL",0,0,1,47,0,48,"2013"
"21120","420245 BOMBINHAS",0,1,1,263,0,265,"2013"
"21121","420250 BOM JARDIM DA SERRA",0,0,0,39,0,39,"2013"
"21122","420253 BOM JESUS",0,0,1,33,0,34,"2013"
"21123","420257 BOM JESUS DO OESTE",0,0,0,26,0,26,"2013"
"21124","420260 BOM RETIRO",0,2,5,103,0,110,"2013"
"21125","420270 BOTUVERA",0,1,1,55,0,57,"2013"
"21126","420280 BRACO DO NORTE",0,2,3,449,2,456,"2013"
"21127","420285 BRACO DO TROMBUDO",0,0,0,59,0,59,"2013"
"21128","420287 BRUNOPOLIS",0,0,0,33,1,34,"2013"
"21129","420290 BRUSQUE",8,4,12,1601,0,1625,"2013"
"21130","420300 CACADOR",9,7,22,1137,0,1175,"2013"
"21131","420310 CAIBI",1,0,0,70,0,71,"2013"
"21132","420315 CALMON",0,0,4,70,0,74,"2013"
"21133","420320 CAMBORIU",2,4,14,1148,23,1191,"2013"
"21134","420325 CAPAO ALTO",1,0,0,25,0,26,"2013"
"21135","420330 CAMPO ALEGRE",0,1,3,102,0,106,"2013"
"21136","420340 CAMPO BELO DO SUL",0,0,4,103,2,109,"2013"
"21137","420350 CAMPO ERE",1,2,0,136,0,139,"2013"
"21138","420360 CAMPOS NOVOS",1,1,1,478,1,482,"2013"
"21139","420370 CANELINHA",0,0,0,138,3,141,"2013"
"21140","420380 CANOINHAS",3,0,13,804,4,824,"2013"
"21141","420390 CAPINZAL",0,1,5,319,0,325,"2013"
"21142","420395 CAPIVARI DE BAIXO",0,1,1,316,1,319,"2013"
"21143","420400 CATANDUVAS",0,1,2,133,0,136,"2013"
"21144","420410 CAXAMBU DO SUL",0,0,0,48,0,48,"2013"
"21145","420415 CELSO RAMOS",0,0,0,31,0,31,"2013"
"21146","420417 CERRO NEGRO",0,0,2,33,0,35,"2013"
"21147","420419 CHAPADAO DO LAGEADO",0,1,2,41,0,44,"2013"
"21148","420420 CHAPECO",7,19,46,3104,7,3183,"2013"
"21149","420425 COCAL DO SUL",1,0,1,193,1,196,"2013"
"21150","420430 CONCORDIA",0,1,13,875,0,889,"2013"
"21151","420435 CORDILHEIRA ALTA",0,0,0,42,0,42,"2013"
"21152","420440 CORONEL FREITAS",1,0,1,100,0,102,"2013"
"21153","420445 CORONEL MARTINS",0,0,1,14,0,15,"2013"
"21154","420450 CORUPA",0,0,2,165,0,167,"2013"
"21155","420455 CORREIA PINTO",0,3,7,206,0,216,"2013"
"21156","420460 CRICIUMA",4,7,26,2772,3,2812,"2013"
"21157","420470 CUNHA PORA",0,0,0,137,1,138,"2013"
"21158","420475 CUNHATAI",0,0,0,17,0,17,"2013"
"21159","420480 CURITIBANOS",2,1,21,595,5,624,"2013"
"21160","420490 DESCANSO",0,0,1,83,0,84,"2013"
"21161","420500 DIONISIO CERQUEIRA",0,0,6,232,3,241,"2013"
"21162","420510 DONA EMMA",0,1,0,41,0,42,"2013"
"21163","420515 DOUTOR PEDRINHO",1,0,0,35,0,36,"2013"
"21164","420517 ENTRE RIOS",1,0,2,47,1,51,"2013"
"21165","420519 ERMO",0,0,1,32,0,33,"2013"
"21166","420520 ERVAL VELHO",0,0,1,42,0,43,"2013"
"21167","420530 FAXINAL DOS GUEDES",0,0,1,166,0,167,"2013"
"21168","420535 FLOR DO SERTAO",0,0,0,20,0,20,"2013"
"21169","420540 FLORIANOPOLIS",10,16,69,5515,20,5630,"2013"
"21170","420543 FORMOSA DO SUL",0,0,1,24,0,25,"2013"
"21171","420545 FORQUILHINHA",2,2,2,342,0,348,"2013"
"21172","420550 FRAIBURGO",0,2,5,523,0,530,"2013"
"21173","420555 FREI ROGERIO",0,0,0,37,0,37,"2013"
"21174","420560 GALVAO",0,0,2,43,0,45,"2013"
"21175","420570 GAROPABA",0,0,2,246,4,252,"2013"
"21176","420580 GARUVA",0,0,3,273,3,279,"2013"
"21177","420590 GASPAR",2,5,17,775,1,800,"2013"
"21178","420600 GOVERNADOR CELSO RAMOS",0,1,4,134,0,139,"2013"
"21179","420610 GRAO PARA",0,2,1,67,0,70,"2013"
"21180","420620 GRAVATAL",0,0,2,125,0,127,"2013"
"21181","420630 GUABIRUBA",0,1,1,248,0,250,"2013"
"21182","420640 GUARACIABA",0,0,1,84,0,85,"2013"
"21183","420650 GUARAMIRIM",0,1,5,631,1,638,"2013"
"21184","420660 GUARUJA DO SUL",0,0,0,59,0,59,"2013"
"21185","420665 GUATAMBU",1,0,4,72,0,77,"2013"
"21186","420670 HERVAL D'OESTE",0,1,1,271,0,273,"2013"
"21187","420675 IBIAM",0,0,0,26,0,26,"2013"
"21188","420680 IBICARE",0,1,1,30,0,32,"2013"
"21189","420690 IBIRAMA",0,2,6,244,0,252,"2013"
"21190","420700 ICARA",1,1,6,694,1,703,"2013"
"21191","420710 ILHOTA",4,0,2,160,0,166,"2013"
"21192","420720 IMARUI",0,0,0,118,0,118,"2013"
"21193","420730 IMBITUBA",2,0,10,499,1,512,"2013"
"21194","420740 IMBUIA",1,0,3,65,0,69,"2013"
"21195","420750 INDAIAL",3,2,1,790,1,797,"2013"
"21196","420757 IOMERE",0,1,0,30,0,31,"2013"
"21197","420760 IPIRA",0,0,0,44,0,44,"2013"
"21198","420765 IPORA DO OESTE",0,1,0,83,0,84,"2013"
"21199","420768 IPUACU",0,1,3,124,1,129,"2013"
"21200","420770 IPUMIRIM",0,0,3,105,0,108,"2013"
"21201","420775 IRACEMINHA",0,0,0,39,0,39,"2013"
"21202","420780 IRANI",0,0,1,123,0,124,"2013"
"21203","420785 IRATI",0,0,0,30,0,30,"2013"
"21204","420790 IRINEOPOLIS",0,0,6,127,1,134,"2013"
"21205","420800 ITA",0,0,1,57,0,58,"2013"
"21206","420810 ITAIOPOLIS",1,1,2,277,2,283,"2013"
"21207","420820 ITAJAI",16,15,96,2898,3,3028,"2013"
"21208","420830 ITAPEMA",2,0,11,681,6,700,"2013"
"21209","420840 ITAPIRANGA",0,0,2,176,1,179,"2013"
"21210","420845 ITAPOA",0,0,5,195,0,200,"2013"
"21211","420850 ITUPORANGA",0,4,8,315,1,328,"2013"
"21212","420860 JABORA",0,1,0,62,0,63,"2013"
"21213","420870 JACINTO MACHADO",2,2,3,114,0,121,"2013"
"21214","420880 JAGUARUNA",1,0,1,224,0,226,"2013"
"21215","420890 JARAGUA DO SUL",6,5,41,2258,0,2310,"2013"
"21216","420895 JARDINOPOLIS",0,0,1,24,0,25,"2013"
"21217","420900 JOACABA",0,3,5,328,0,336,"2013"
"21218","420910 JOINVILLE",8,26,125,7681,8,7848,"2013"
"21219","420915 JOSE BOITEUX",0,0,0,83,1,84,"2013"
"21220","420917 JUPIA",0,0,1,17,0,18,"2013"
"21221","420920 LACERDOPOLIS",0,0,0,19,0,19,"2013"
"21222","420930 LAGES",6,20,95,2206,13,2340,"2013"
"21223","420940 LAGUNA",1,3,3,562,4,573,"2013"
"21224","420945 LAJEADO GRANDE",0,0,0,12,0,12,"2013"
"21225","420950 LAURENTINO",1,0,3,97,0,101,"2013"
"21226","420960 LAURO MULLER",0,0,0,194,0,194,"2013"
"21227","420970 LEBON REGIS",0,0,4,155,1,160,"2013"
"21228","420980 LEOBERTO LEAL",0,0,0,30,0,30,"2013"
"21229","420985 LINDOIA DO SUL",0,0,0,42,0,42,"2013"
"21230","420990 LONTRAS",0,0,2,166,1,169,"2013"
"21231","421000 LUIZ ALVES",1,1,6,160,0,168,"2013"
"21232","421003 LUZERNA",0,0,1,42,0,43,"2013"
"21233","421005 MACIEIRA",0,0,0,33,0,33,"2013"
"21234","421010 MAFRA",0,1,13,812,1,827,"2013"
"21235","421020 MAJOR GERCINO",0,0,0,27,0,27,"2013"
"21236","421030 MAJOR VIEIRA",0,0,0,91,0,91,"2013"
"21237","421040 MARACAJA",0,0,0,79,0,79,"2013"
"21238","421050 MARAVILHA",2,1,4,303,0,310,"2013"
"21239","421055 MAREMA",0,0,0,12,0,12,"2013"
"21240","421060 MASSARANDUBA",0,1,4,163,0,168,"2013"
"21241","421070 MATOS COSTA",0,0,0,30,0,30,"2013"
"21242","421080 MELEIRO",0,0,1,74,1,76,"2013"
"21243","421085 MIRIM DOCE",0,0,1,29,0,30,"2013"
"21244","421090 MODELO",0,1,0,43,0,44,"2013"
"21245","421100 MONDAI",0,0,1,105,0,106,"2013"
"21246","421105 MONTE CARLO",1,1,3,148,1,154,"2013"
"21247","421110 MONTE CASTELO",3,0,1,102,0,106,"2013"
"21248","421120 MORRO DA FUMACA",0,1,2,255,0,258,"2013"
"21249","421125 MORRO GRANDE",0,0,1,55,0,56,"2013"
"21250","421130 NAVEGANTES",3,1,17,1208,0,1229,"2013"
"21251","421140 NOVA ERECHIM",0,1,1,50,0,52,"2013"
"21252","421145 NOVA ITABERABA",0,0,1,54,0,55,"2013"
"21253","421150 NOVA TRENTO",0,0,1,151,0,152,"2013"
"21254","421160 NOVA VENEZA",1,1,0,174,1,177,"2013"
"21255","421165 NOVO HORIZONTE",0,1,1,19,0,21,"2013"
"21256","421170 ORLEANS",0,1,7,252,0,260,"2013"
"21257","421175 OTACILIO COSTA",0,3,8,241,0,252,"2013"
"21258","421180 OURO",0,0,0,78,0,78,"2013"
"21259","421185 OURO VERDE",0,0,1,26,0,27,"2013"
"21260","421187 PAIAL",0,0,0,14,0,14,"2013"
"21261","421189 PAINEL",0,0,0,18,0,18,"2013"
"21262","421190 PALHOCA",4,14,23,2350,5,2396,"2013"
"21263","421200 PALMA SOLA",0,2,2,108,0,112,"2013"
"21264","421205 PALMEIRA",0,0,1,32,0,33,"2013"
"21265","421210 PALMITOS",0,0,2,186,0,188,"2013"
"21266","421220 PAPANDUVA",0,0,3,221,1,225,"2013"
"21267","421223 PARAISO",0,0,2,46,0,48,"2013"
"21268","421225 PASSO DE TORRES",0,0,0,88,0,88,"2013"
"21269","421227 PASSOS MAIA",0,1,3,51,0,55,"2013"
"21270","421230 PAULO LOPES",0,0,2,96,0,98,"2013"
"21271","421240 PEDRAS GRANDES",1,0,0,31,0,32,"2013"
"21272","421250 PENHA",2,0,4,366,0,372,"2013"
"21273","421260 PERITIBA",0,1,0,31,0,32,"2013"
"21274","421265 PESCARIA BRAVA",0,0,0,9,0,9,"2013"
"21275","421270 PETROLANDIA",0,0,1,68,0,69,"2013"
"21276","421280 BALNEARIO PICARRAS",5,1,11,275,0,292,"2013"
"21277","421290 PINHALZINHO",0,2,3,261,0,266,"2013"
"21278","421300 PINHEIRO PRETO",0,1,0,46,0,47,"2013"
"21279","421310 PIRATUBA",0,0,2,67,0,69,"2013"
"21280","421315 PLANALTO ALEGRE",0,0,0,32,0,32,"2013"
"21281","421320 POMERODE",2,1,9,322,0,334,"2013"
"21282","421330 PONTE ALTA",0,1,1,71,1,74,"2013"
"21283","421335 PONTE ALTA DO NORTE",0,0,0,55,1,56,"2013"
"21284","421340 PONTE SERRADA",1,1,1,144,0,147,"2013"
"21285","421350 PORTO BELO",0,0,7,237,0,244,"2013"
"21286","421360 PORTO UNIAO",3,1,8,418,1,431,"2013"
"21287","421370 POUSO REDONDO",0,0,4,216,1,221,"2013"
"21288","421380 PRAIA GRANDE",0,1,1,85,0,87,"2013"
"21289","421390 PRESIDENTE CASTELLO BRANCO",0,0,0,16,0,16,"2013"
"21290","421400 PRESIDENTE GETULIO",1,0,2,216,0,219,"2013"
"21291","421410 PRESIDENTE NEREU",0,0,0,27,0,27,"2013"
"21292","421415 PRINCESA",0,0,2,29,0,31,"2013"
"21293","421420 QUILOMBO",0,1,2,146,0,149,"2013"
"21294","421430 RANCHO QUEIMADO",0,0,0,24,0,24,"2013"
"21295","421440 RIO DAS ANTAS",0,0,0,61,0,61,"2013"
"21296","421450 RIO DO CAMPO",0,0,0,63,0,63,"2013"
"21297","421460 RIO DO OESTE",0,0,1,81,0,82,"2013"
"21298","421470 RIO DOS CEDROS",0,0,5,104,0,109,"2013"
"21299","421480 RIO DO SUL",2,0,19,911,3,935,"2013"
"21300","421490 RIO FORTUNA",0,0,0,52,0,52,"2013"
"21301","421500 RIO NEGRINHO",4,2,10,522,1,539,"2013"
"21302","421505 RIO RUFINO",0,0,0,22,0,22,"2013"
"21303","421507 RIQUEZA",0,0,2,37,0,39,"2013"
"21304","421510 RODEIO",1,0,0,113,0,114,"2013"
"21305","421520 ROMELANDIA",0,2,2,45,0,49,"2013"
"21306","421530 SALETE",0,1,2,91,0,94,"2013"
"21307","421535 SALTINHO",0,0,0,46,0,46,"2013"
"21308","421540 SALTO VELOSO",0,0,0,58,0,58,"2013"
"21309","421545 SANGAO",0,0,1,203,0,204,"2013"
"21310","421550 SANTA CECILIA",0,1,2,313,1,317,"2013"
"21311","421555 SANTA HELENA",0,0,1,25,0,26,"2013"
"21312","421560 SANTA ROSA DE LIMA",0,0,0,21,0,21,"2013"
"21313","421565 SANTA ROSA DO SUL",1,0,2,95,0,98,"2013"
"21314","421567 SANTA TEREZINHA",0,0,0,95,0,95,"2013"
"21315","421568 SANTA TEREZINHA DO PROGRESSO",0,0,1,34,1,36,"2013"
"21316","421569 SANTIAGO DO SUL",0,0,0,11,0,11,"2013"
"21317","421570 SANTO AMARO DA IMPERATRIZ",1,1,3,295,0,300,"2013"
"21318","421575 SAO BERNARDINO",0,0,0,34,0,34,"2013"
"21319","421580 SAO BENTO DO SUL",5,1,11,1149,6,1172,"2013"
"21320","421590 SAO BONIFACIO",0,0,0,19,0,19,"2013"
"21321","421600 SAO CARLOS",0,1,0,122,0,123,"2013"
"21322","421605 SAO CRISTOVAO DO SUL",0,1,2,57,0,60,"2013"
"21323","421610 SAO DOMINGOS",0,1,4,124,0,129,"2013"
"21324","421620 SAO FRANCISCO DO SUL",1,1,6,614,5,627,"2013"
"21325","421625 SAO JOAO DO OESTE",0,0,2,52,1,55,"2013"
"21326","421630 SAO JOAO BATISTA",3,1,5,438,0,447,"2013"
"21327","421635 SAO JOAO DO ITAPERIU",0,0,0,31,0,31,"2013"
"21328","421640 SAO JOAO DO SUL",0,1,0,68,0,69,"2013"
"21329","421650 SAO JOAQUIM",2,2,12,287,1,304,"2013"
"21330","421660 SAO JOSE",8,12,33,2993,3,3049,"2013"
"21331","421670 SAO JOSE DO CEDRO",1,1,5,155,1,163,"2013"
"21332","421680 SAO JOSE DO CERRITO",0,0,6,74,2,82,"2013"
"21333","421690 SAO LOURENCO DO OESTE",0,1,4,321,0,326,"2013"
"21334","421700 SAO LUDGERO",1,0,1,180,0,182,"2013"
"21335","421710 SAO MARTINHO",0,0,0,25,0,25,"2013"
"21336","421715 SAO MIGUEL DA BOA VISTA",0,0,0,19,0,19,"2013"
"21337","421720 SAO MIGUEL DO OESTE",0,3,14,453,0,470,"2013"
"21338","421725 SAO PEDRO DE ALCANTARA",0,0,0,23,0,23,"2013"
"21339","421730 SAUDADES",0,1,1,99,0,101,"2013"
"21340","421740 SCHROEDER",0,0,5,217,0,222,"2013"
"21341","421750 SEARA",0,0,2,194,0,196,"2013"
"21342","421755 SERRA ALTA",0,0,1,39,0,40,"2013"
"21343","421760 SIDEROPOLIS",0,0,0,119,0,119,"2013"
"21344","421770 SOMBRIO",2,2,1,373,0,378,"2013"
"21345","421775 SUL BRASIL",0,0,1,24,0,25,"2013"
"21346","421780 TAIO",0,1,5,230,1,237,"2013"
"21347","421790 TANGARA",0,0,3,95,0,98,"2013"
"21348","421795 TIGRINHOS",0,0,0,27,0,27,"2013"
"21349","421800 TIJUCAS",3,3,6,523,4,539,"2013"
"21350","421810 TIMBE DO SUL",0,0,0,59,1,60,"2013"
"21351","421820 TIMBO",4,0,4,426,0,434,"2013"
"21352","421825 TIMBO GRANDE",0,1,2,110,2,115,"2013"
"21353","421830 TRES BARRAS",1,1,10,246,0,258,"2013"
"21354","421835 TREVISO",1,0,0,45,0,46,"2013"
"21355","421840 TREZE DE MAIO",0,0,0,88,0,88,"2013"
"21356","421850 TREZE TILIAS",0,0,0,101,0,101,"2013"
"21357","421860 TROMBUDO CENTRAL",0,0,1,94,0,95,"2013"
"21358","421870 TUBARAO",5,2,13,1235,5,1260,"2013"
"21359","421875 TUNAPOLIS",0,0,4,45,0,49,"2013"
"21360","421880 TURVO",0,1,0,151,0,152,"2013"
"21361","421885 UNIAO DO OESTE",0,0,1,36,0,37,"2013"
"21362","421890 URUBICI",0,2,6,117,1,126,"2013"
"21363","421895 URUPEMA",0,0,1,33,1,35,"2013"
"21364","421900 URUSSANGA",0,0,2,183,0,185,"2013"
"21365","421910 VARGEAO",0,0,1,48,0,49,"2013"
"21366","421915 VARGEM",0,0,0,30,0,30,"2013"
"21367","421917 VARGEM BONITA",0,0,0,53,0,53,"2013"
"21368","421920 VIDAL RAMOS",0,0,0,73,0,73,"2013"
"21369","421930 VIDEIRA",3,0,7,751,2,763,"2013"
"21370","421935 VITOR MEIRELES",0,0,2,68,2,72,"2013"
"21371","421940 WITMARSUM",0,0,1,36,0,37,"2013"
"21372","421950 XANXERE",3,6,6,632,3,650,"2013"
"21373","421960 XAVANTINA",0,0,0,24,0,24,"2013"
"21374","421970 XAXIM",0,0,0,355,2,357,"2013"
"21375","421985 ZORTEA",0,0,0,44,0,44,"2013"
"21376","422000 BALNEARIO RINCAO",0,0,1,131,0,132,"2013"
"21377","430003 ACEGUA",0,2,1,54,0,57,"2013"
"21378","430005 AGUA SANTA",0,1,1,42,0,44,"2013"
"21379","430010 AGUDO",0,4,4,171,1,180,"2013"
"21380","430020 AJURICABA",0,0,1,80,0,81,"2013"
"21381","430030 ALECRIM",0,0,1,50,1,52,"2013"
"21382","430040 ALEGRETE",0,1,10,923,1,935,"2013"
"21383","430045 ALEGRIA",1,0,0,33,0,34,"2013"
"21384","430047 ALMIRANTE TAMANDARE DO SUL",0,1,0,23,0,24,"2013"
"21385","430050 ALPESTRE",0,0,1,60,0,61,"2013"
"21386","430055 ALTO ALEGRE",0,0,0,21,0,21,"2013"
"21387","430057 ALTO FELIZ",1,1,1,18,0,21,"2013"
"21388","430060 ALVORADA",3,25,68,3253,3,3352,"2013"
"21389","430063 AMARAL FERRADOR",0,0,1,59,0,60,"2013"
"21390","430064 AMETISTA DO SUL",0,0,0,78,0,78,"2013"
"21391","430066 ANDRE DA ROCHA",0,0,0,13,0,13,"2013"
"21392","430070 ANTA GORDA",0,0,0,52,0,52,"2013"
"21393","430080 ANTONIO PRADO",1,1,0,127,0,129,"2013"
"21394","430085 ARAMBARE",1,0,0,41,1,43,"2013"
"21395","430087 ARARICA",0,0,0,82,0,82,"2013"
"21396","430090 ARATIBA",0,1,1,55,0,57,"2013"
"21397","430100 ARROIO DO MEIO",0,0,1,216,0,217,"2013"
"21398","430105 ARROIO DO SAL",0,0,1,95,0,96,"2013"
"21399","430107 ARROIO DO PADRE",0,0,0,19,0,19,"2013"
"21400","430110 ARROIO DOS RATOS",0,0,1,181,0,182,"2013"
"21401","430120 ARROIO DO TIGRE",0,1,0,107,0,108,"2013"
"21402","430130 ARROIO GRANDE",1,4,13,193,0,211,"2013"
"21403","430140 ARVOREZINHA",0,0,3,87,0,90,"2013"
"21404","430150 AUGUSTO PESTANA",0,1,0,76,0,77,"2013"
"21405","430155 AUREA",0,0,0,30,0,30,"2013"
"21406","430160 BAGE",1,6,21,1548,8,1584,"2013"
"21407","430163 BALNEARIO PINHAL",1,0,1,150,0,152,"2013"
"21408","430165 BARAO",0,0,1,41,0,42,"2013"
"21409","430170 BARAO DE COTEGIPE",0,0,2,58,0,60,"2013"
"21410","430175 BARAO DO TRIUNFO",0,1,0,55,1,57,"2013"
"21411","430180 BARRACAO",1,0,0,48,0,49,"2013"
"21412","430185 BARRA DO GUARITA",0,0,0,42,0,42,"2013"
"21413","430187 BARRA DO QUARAI",0,0,1,22,17,40,"2013"
"21414","430190 BARRA DO RIBEIRO",0,0,5,137,9,151,"2013"
"21415","430192 BARRA DO RIO AZUL",0,0,0,12,0,12,"2013"
"21416","430195 BARRA FUNDA",0,0,0,20,0,20,"2013"
"21417","430200 BARROS CASSAL",0,0,1,118,0,119,"2013"
"21418","430205 BENJAMIN CONSTANT DO SUL",0,0,1,33,0,34,"2013"
"21419","430210 BENTO GONCALVES",3,3,20,1443,0,1469,"2013"
"21420","430215 BOA VISTA DAS MISSOES",0,0,0,17,0,17,"2013"
"21421","430220 BOA VISTA DO BURICA",0,1,0,57,0,58,"2013"
"21422","430222 BOA VISTA DO CADEADO",0,0,0,33,0,33,"2013"
"21423","430223 BOA VISTA DO INCRA",0,0,0,39,0,39,"2013"
"21424","430225 BOA VISTA DO SUL",0,0,0,16,0,16,"2013"
"21425","430230 BOM JESUS",0,4,0,137,3,144,"2013"
"21426","430235 BOM PRINCIPIO",0,0,2,120,0,122,"2013"
"21427","430237 BOM PROGRESSO",0,0,0,33,0,33,"2013"
"21428","430240 BOM RETIRO DO SUL",0,1,0,149,0,150,"2013"
"21429","430245 BOQUEIRAO DO LEAO",0,0,2,102,0,104,"2013"
"21430","430250 BOSSOROCA",0,0,1,50,0,51,"2013"
"21431","430258 BOZANO",0,0,0,20,0,20,"2013"
"21432","430260 BRAGA",0,0,0,45,0,45,"2013"
"21433","430265 BROCHIER",0,0,0,32,0,32,"2013"
"21434","430270 BUTIA",0,2,2,232,1,237,"2013"
"21435","430280 CACAPAVA DO SUL",4,1,6,409,4,424,"2013"
"21436","430290 CACEQUI",1,1,2,126,0,130,"2013"
"21437","430300 CACHOEIRA DO SUL",2,2,12,958,2,976,"2013"
"21438","430310 CACHOEIRINHA",7,6,23,1893,3,1932,"2013"
"21439","430320 CACIQUE DOBLE",0,0,0,60,0,60,"2013"
"21440","430330 CAIBATE",0,0,0,76,0,76,"2013"
"21441","430340 CAICARA",0,0,0,38,0,38,"2013"
"21442","430350 CAMAQUA",2,2,11,773,6,794,"2013"
"21443","430355 CAMARGO",0,0,1,31,0,32,"2013"
"21444","430360 CAMBARA DO SUL",0,0,0,69,0,69,"2013"
"21445","430367 CAMPESTRE DA SERRA",0,0,0,33,0,33,"2013"
"21446","430370 CAMPINA DAS MISSOES",0,0,2,65,1,68,"2013"
"21447","430380 CAMPINAS DO SUL",0,0,1,50,0,51,"2013"
"21448","430390 CAMPO BOM",1,1,8,801,0,811,"2013"
"21449","430400 CAMPO NOVO",0,0,0,69,0,69,"2013"
"21450","430410 CAMPOS BORGES",0,1,1,34,0,36,"2013"
"21451","430420 CANDELARIA",0,2,6,331,0,339,"2013"
"21452","430430 CANDIDO GODOI",0,0,0,56,0,56,"2013"
"21453","430435 CANDIOTA",0,0,0,128,0,128,"2013"
"21454","430440 CANELA",1,1,20,614,3,639,"2013"
"21455","430450 CANGUCU",2,3,7,545,1,558,"2013"
"21456","430460 CANOAS",15,24,126,5153,17,5335,"2013"
"21457","430461 CANUDOS DO VALE",0,0,1,23,0,24,"2013"
"21458","430462 CAPAO BONITO DO SUL",0,0,1,16,0,17,"2013"
"21459","430463 CAPAO DA CANOA",1,2,14,794,2,813,"2013"
"21460","430465 CAPAO DO CIPO",0,0,1,31,0,32,"2013"
"21461","430466 CAPAO DO LEAO",0,3,12,297,3,315,"2013"
"21462","430467 CAPIVARI DO SUL",0,0,0,45,0,45,"2013"
"21463","430468 CAPELA DE SANTANA",0,0,0,142,0,142,"2013"
"21464","430469 CAPITAO",0,0,5,33,0,38,"2013"
"21465","430470 CARAZINHO",2,4,14,877,10,907,"2013"
"21466","430471 CARAA",0,0,0,66,0,66,"2013"
"21467","430480 CARLOS BARBOSA",0,2,5,261,0,268,"2013"
"21468","430485 CARLOS GOMES",0,0,0,9,0,9,"2013"
"21469","430490 CASCA",1,1,2,69,0,73,"2013"
"21470","430495 CASEIROS",0,0,1,37,0,38,"2013"
"21471","430500 CATUIPE",1,0,0,111,0,112,"2013"
"21472","430510 CAXIAS DO SUL",13,37,128,6208,6,6392,"2013"
"21473","430511 CENTENARIO",0,0,0,30,0,30,"2013"
"21474","430512 CERRITO",1,0,0,54,0,55,"2013"
"21475","430513 CERRO BRANCO",1,0,1,25,0,27,"2013"
"21476","430515 CERRO GRANDE",0,0,0,28,0,28,"2013"
"21477","430517 CERRO GRANDE DO SUL",0,0,4,133,1,138,"2013"
"21478","430520 CERRO LARGO",0,0,2,128,0,130,"2013"
"21479","430530 CHAPADA",0,2,3,56,0,61,"2013"
"21480","430535 CHARQUEADAS",0,1,5,389,1,396,"2013"
"21481","430537 CHARRUA",0,0,1,39,0,40,"2013"
"21482","430540 CHIAPETTA",0,0,2,64,0,66,"2013"
"21483","430543 CHUI",0,0,1,41,0,42,"2013"
"21484","430544 CHUVISCA",0,1,1,60,0,62,"2013"
"21485","430545 CIDREIRA",0,2,4,158,0,164,"2013"
"21486","430550 CIRIACO",0,0,0,37,0,37,"2013"
"21487","430558 COLINAS",0,0,1,14,0,15,"2013"
"21488","430560 COLORADO",0,0,1,28,0,29,"2013"
"21489","430570 CONDOR",0,0,0,29,0,29,"2013"
"21490","430580 CONSTANTINA",0,0,1,119,0,120,"2013"
"21491","430583 COQUEIRO BAIXO",0,0,0,6,0,6,"2013"
"21492","430585 COQUEIROS DO SUL",0,0,0,20,1,21,"2013"
"21493","430587 CORONEL BARROS",0,0,0,33,0,33,"2013"
"21494","430590 CORONEL BICACO",1,0,1,112,0,114,"2013"
"21495","430593 CORONEL PILAR",0,0,0,3,0,3,"2013"
"21496","430595 COTIPORA",0,0,0,24,0,24,"2013"
"21497","430597 COXILHA",0,1,1,35,0,37,"2013"
"21498","430600 CRISSIUMAL",1,0,0,117,0,118,"2013"
"21499","430605 CRISTAL",1,0,3,85,0,89,"2013"
"21500","430607 CRISTAL DO SUL",0,0,1,26,0,27,"2013"
"21501","430610 CRUZ ALTA",6,6,23,836,1,872,"2013"
"21502","430613 CRUZALTENSE",0,0,0,16,0,16,"2013"
"21503","430620 CRUZEIRO DO SUL",0,0,1,110,0,111,"2013"
"21504","430630 DAVID CANABARRO",0,1,0,34,1,36,"2013"
"21505","430632 DERRUBADAS",0,0,0,29,0,29,"2013"
"21506","430635 DEZESSEIS DE NOVEMBRO",0,0,1,23,0,24,"2013"
"21507","430637 DILERMANDO DE AGUIAR",0,1,2,21,0,24,"2013"
"21508","430640 DOIS IRMAOS",0,0,3,350,0,353,"2013"
"21509","430642 DOIS IRMAOS DAS MISSOES",0,0,0,32,0,32,"2013"
"21510","430645 DOIS LAJEADOS",0,1,0,21,0,22,"2013"
"21511","430650 DOM FELICIANO",0,0,2,158,1,161,"2013"
"21512","430655 DOM PEDRO DE ALCANTARA",0,0,1,9,0,10,"2013"
"21513","430660 DOM PEDRITO",2,1,3,426,1,433,"2013"
"21514","430670 DONA FRANCISCA",0,0,0,30,0,30,"2013"
"21515","430673 DOUTOR MAURICIO CARDOSO",0,0,0,38,0,38,"2013"
"21516","430675 DOUTOR RICARDO",0,0,0,11,0,11,"2013"
"21517","430676 ELDORADO DO SUL",1,1,9,557,4,572,"2013"
"21518","430680 ENCANTADO",0,0,6,245,1,252,"2013"
"21519","430690 ENCRUZILHADA DO SUL",0,1,7,265,1,274,"2013"
"21520","430692 ENGENHO VELHO",1,0,1,35,0,37,"2013"
"21521","430693 ENTRE-IJUIS",1,0,3,92,1,97,"2013"
"21522","430695 ENTRE RIOS DO SUL",0,0,0,29,0,29,"2013"
"21523","430697 EREBANGO",0,2,1,36,0,39,"2013"
"21524","430700 ERECHIM",0,3,18,1308,0,1329,"2013"
"21525","430705 ERNESTINA",0,0,0,25,0,25,"2013"
"21526","430710 HERVAL",1,1,1,46,2,51,"2013"
"21527","430720 ERVAL GRANDE",0,0,1,44,0,45,"2013"
"21528","430730 ERVAL SECO",0,0,0,86,0,86,"2013"
"21529","430740 ESMERALDA",0,0,1,30,4,35,"2013"
"21530","430745 ESPERANCA DO SUL",0,0,0,49,0,49,"2013"
"21531","430750 ESPUMOSO",0,1,2,164,0,167,"2013"
"21532","430755 ESTACAO",0,0,0,64,0,64,"2013"
"21533","430760 ESTANCIA VELHA",0,0,12,635,0,647,"2013"
"21534","430770 ESTEIO",1,0,23,1091,4,1119,"2013"
"21535","430780 ESTRELA",1,4,12,407,0,424,"2013"
"21536","430781 ESTRELA VELHA",0,0,0,32,0,32,"2013"
"21537","430783 EUGENIO DE CASTRO",0,0,1,24,0,25,"2013"
"21538","430786 FAGUNDES VARELA",0,0,0,18,0,18,"2013"
"21539","430790 FARROUPILHA",1,3,9,804,0,817,"2013"
"21540","430800 FAXINAL DO SOTURNO",0,0,0,57,0,57,"2013"
"21541","430805 FAXINALZINHO",0,0,0,25,0,25,"2013"
"21542","430807 FAZENDA VILANOVA",0,1,1,51,0,53,"2013"
"21543","430810 FELIZ",0,1,3,134,0,138,"2013"
"21544","430820 FLORES DA CUNHA",0,1,3,310,0,314,"2013"
"21545","430825 FLORIANO PEIXOTO",0,1,0,13,0,14,"2013"
"21546","430830 FONTOURA XAVIER",0,1,0,88,0,89,"2013"
"21547","430840 FORMIGUEIRO",0,1,0,60,0,61,"2013"
"21548","430843 FORQUETINHA",0,0,0,17,0,17,"2013"
"21549","430845 FORTALEZA DOS VALOS",0,0,1,48,0,49,"2013"
"21550","430850 FREDERICO WESTPHALEN",1,1,11,372,0,385,"2013"
"21551","430860 GARIBALDI",0,1,5,341,1,348,"2013"
"21552","430865 GARRUCHOS",0,0,0,15,0,15,"2013"
"21553","430870 GAURAMA",0,0,0,49,0,49,"2013"
"21554","430880 GENERAL CAMARA",0,0,1,77,1,79,"2013"
"21555","430885 GENTIL",0,0,0,27,0,27,"2013"
"21556","430890 GETULIO VARGAS",0,1,5,164,0,170,"2013"
"21557","430900 GIRUA",0,1,0,190,1,192,"2013"
"21558","430905 GLORINHA",0,0,2,86,0,88,"2013"
"21559","430910 GRAMADO",1,2,8,503,0,514,"2013"
"21560","430912 GRAMADO DOS LOUREIROS",0,0,0,25,0,25,"2013"
"21561","430915 GRAMADO XAVIER",0,0,1,34,1,36,"2013"
"21562","430920 GRAVATAI",8,6,61,3508,7,3590,"2013"
"21563","430925 GUABIJU",0,0,0,12,0,12,"2013"
"21564","430930 GUAIBA",2,4,17,1313,12,1348,"2013"
"21565","430940 GUAPORE",1,1,7,272,0,281,"2013"
"21566","430950 GUARANI DAS MISSOES",0,0,0,83,0,83,"2013"
"21567","430955 HARMONIA",0,0,0,59,0,59,"2013"
"21568","430957 HERVEIRAS",0,0,0,33,0,33,"2013"
"21569","430960 HORIZONTINA",1,1,1,223,0,226,"2013"
"21570","430965 HULHA NEGRA",1,0,0,67,0,68,"2013"
"21571","430970 HUMAITA",1,0,0,43,0,44,"2013"
"21572","430975 IBARAMA",0,1,0,47,0,48,"2013"
"21573","430980 IBIACA",0,0,1,37,0,38,"2013"
"21574","430990 IBIRAIARAS",0,0,2,67,0,69,"2013"
"21575","430995 IBIRAPUITA",1,0,1,42,0,44,"2013"
"21576","431000 IBIRUBA",0,0,1,275,0,276,"2013"
"21577","431010 IGREJINHA",2,2,4,481,5,494,"2013"
"21578","431020 IJUI",3,6,13,1115,1,1138,"2013"
"21579","431030 ILOPOLIS",0,0,0,26,0,26,"2013"
"21580","431033 IMBE",0,1,10,260,0,271,"2013"
"21581","431036 IMIGRANTE",0,0,1,28,0,29,"2013"
"21582","431040 INDEPENDENCIA",0,0,1,77,0,78,"2013"
"21583","431041 INHACORA",0,0,0,30,0,30,"2013"
"21584","431043 IPE",0,0,1,67,0,68,"2013"
"21585","431046 IPIRANGA DO SUL",0,0,0,15,0,15,"2013"
"21586","431050 IRAI",0,2,0,97,0,99,"2013"
"21587","431053 ITAARA",0,0,1,54,1,56,"2013"
"21588","431055 ITACURUBI",0,0,0,42,0,42,"2013"
"21589","431057 ITAPUCA",0,0,0,21,0,21,"2013"
"21590","431060 ITAQUI",3,1,10,539,3,556,"2013"
"21591","431065 ITATI",0,0,1,17,0,18,"2013"
"21592","431070 ITATIBA DO SUL",0,0,1,22,0,23,"2013"
"21593","431075 IVORA",0,0,0,19,0,19,"2013"
"21594","431080 IVOTI",2,0,2,273,0,277,"2013"
"21595","431085 JABOTICABA",0,0,2,31,0,33,"2013"
"21596","431087 JACUIZINHO",0,0,0,29,0,29,"2013"
"21597","431090 JACUTINGA",0,0,1,28,0,29,"2013"
"21598","431100 JAGUARAO",2,2,4,314,0,322,"2013"
"21599","431110 JAGUARI",0,0,1,111,0,112,"2013"
"21600","431112 JAQUIRANA",0,1,0,35,3,39,"2013"
"21601","431113 JARI",0,0,2,32,0,34,"2013"
"21602","431115 JOIA",0,1,3,96,0,100,"2013"
"21603","431120 JULIO DE CASTILHOS",0,1,3,248,0,252,"2013"
"21604","431123 LAGOA BONITA DO SUL",1,0,0,18,0,19,"2013"
"21605","431125 LAGOAO",0,1,0,80,0,81,"2013"
"21606","431127 LAGOA DOS TRES CANTOS",0,0,0,20,0,20,"2013"
"21607","431130 LAGOA VERMELHA",1,2,3,385,1,392,"2013"
"21608","431140 LAJEADO",0,4,12,1054,1,1071,"2013"
"21609","431142 LAJEADO DO BUGRE",0,0,0,36,0,36,"2013"
"21610","431150 LAVRAS DO SUL",0,0,1,64,1,66,"2013"
"21611","431160 LIBERATO SALZANO",0,0,3,58,0,61,"2013"
"21612","431162 LINDOLFO COLLOR",0,0,1,72,0,73,"2013"
"21613","431164 LINHA NOVA",0,0,0,6,0,6,"2013"
"21614","431170 MACHADINHO",0,2,2,72,0,76,"2013"
"21615","431171 MACAMBARA",0,0,0,39,0,39,"2013"
"21616","431173 MAMPITUBA",0,0,0,29,0,29,"2013"
"21617","431175 MANOEL VIANA",0,0,0,73,0,73,"2013"
"21618","431177 MAQUINE",0,0,1,51,0,52,"2013"
"21619","431179 MARATA",0,0,0,15,0,15,"2013"
"21620","431180 MARAU",1,2,10,460,0,473,"2013"
"21621","431190 MARCELINO RAMOS",0,1,1,33,0,35,"2013"
"21622","431198 MARIANA PIMENTEL",0,0,0,32,0,32,"2013"
"21623","431200 MARIANO MORO",0,0,1,16,0,17,"2013"
"21624","431205 MARQUES DE SOUZA",0,0,0,41,0,41,"2013"
"21625","431210 MATA",0,0,0,43,0,43,"2013"
"21626","431213 MATO CASTELHANO",0,0,2,21,0,23,"2013"
"21627","431215 MATO LEITAO",0,4,0,43,0,47,"2013"
"21628","431217 MATO QUEIMADO",0,0,0,20,0,20,"2013"
"21629","431220 MAXIMILIANO DE ALMEIDA",0,0,0,56,0,56,"2013"
"21630","431225 MINAS DO LEAO",0,0,3,96,0,99,"2013"
"21631","431230 MIRAGUAI",0,0,1,66,0,67,"2013"
"21632","431235 MONTAURI",0,0,0,8,0,8,"2013"
"21633","431237 MONTE ALEGRE DOS CAMPOS",0,0,0,27,3,30,"2013"
"21634","431238 MONTE BELO DO SUL",0,0,1,15,0,16,"2013"
"21635","431240 MONTENEGRO",2,3,9,879,2,895,"2013"
"21636","431242 MORMACO",0,0,1,27,0,28,"2013"
"21637","431244 MORRINHOS DO SUL",0,0,1,24,0,25,"2013"
"21638","431245 MORRO REDONDO",2,0,0,46,0,48,"2013"
"21639","431247 MORRO REUTER",0,0,1,61,0,62,"2013"
"21640","431250 MOSTARDAS",0,0,2,111,0,113,"2013"
"21641","431260 MUCUM",0,0,0,51,0,51,"2013"
"21642","431261 MUITOS CAPOES",1,0,0,29,2,32,"2013"
"21643","431262 MULITERNO",0,0,0,20,0,20,"2013"
"21644","431265 NAO-ME-TOQUE",1,1,4,208,0,214,"2013"
"21645","431267 NICOLAU VERGUEIRO",0,0,1,20,0,21,"2013"
"21646","431270 NONOAI",0,1,1,146,2,150,"2013"
"21647","431275 NOVA ALVORADA",0,1,1,29,0,31,"2013"
"21648","431280 NOVA ARACA",0,0,0,45,0,45,"2013"
"21649","431290 NOVA BASSANO",1,1,2,71,0,75,"2013"
"21650","431295 NOVA BOA VISTA",0,0,0,17,0,17,"2013"
"21651","431300 NOVA BRESCIA",0,0,0,21,0,21,"2013"
"21652","431301 NOVA CANDELARIA",1,0,0,19,0,20,"2013"
"21653","431303 NOVA ESPERANCA DO SUL",1,1,0,45,0,47,"2013"
"21654","431306 NOVA HARTZ",0,0,3,267,0,270,"2013"
"21655","431308 NOVA PADUA",0,0,0,13,0,13,"2013"
"21656","431310 NOVA PALMA",0,0,3,66,0,69,"2013"
"21657","431320 NOVA PETROPOLIS",0,0,2,219,0,221,"2013"
"21658","431330 NOVA PRATA",2,1,6,319,0,328,"2013"
"21659","431333 NOVA RAMADA",0,0,0,19,0,19,"2013"
"21660","431335 NOVA ROMA DO SUL",0,0,0,19,0,19,"2013"
"21661","431337 NOVA SANTA RITA",1,0,3,358,0,362,"2013"
"21662","431339 NOVO CABRAIS",0,0,1,29,0,30,"2013"
"21663","431340 NOVO HAMBURGO",1,11,49,3106,6,3173,"2013"
"21664","431342 NOVO MACHADO",0,0,0,25,0,25,"2013"
"21665","431344 NOVO TIRADENTES",0,0,0,32,0,32,"2013"
"21666","431346 NOVO XINGU",0,0,0,16,0,16,"2013"
"21667","431349 NOVO BARREIRO",0,0,0,33,0,33,"2013"
"21668","431350 OSORIO",0,2,8,586,0,596,"2013"
"21669","431360 PAIM FILHO",0,0,0,29,0,29,"2013"
"21670","431365 PALMARES DO SUL",2,0,2,123,1,128,"2013"
"21671","431370 PALMEIRA DAS MISSOES",1,2,7,431,1,442,"2013"
"21672","431380 PALMITINHO",0,5,5,83,0,93,"2013"
"21673","431390 PANAMBI",2,2,3,584,0,591,"2013"
"21674","431395 PANTANO GRANDE",0,0,1,104,0,105,"2013"
"21675","431400 PARAI",1,0,0,77,0,78,"2013"
"21676","431402 PARAISO DO SUL",0,0,0,63,1,64,"2013"
"21677","431403 PARECI NOVO",0,0,0,36,0,36,"2013"
"21678","431405 PAROBE",3,3,16,737,1,760,"2013"
"21679","431406 PASSA SETE",0,0,2,39,0,41,"2013"
"21680","431407 PASSO DO SOBRADO",0,0,2,59,0,61,"2013"
"21681","431410 PASSO FUNDO",6,21,55,2701,3,2786,"2013"
"21682","431413 PAULO BENTO",0,0,0,17,0,17,"2013"
"21683","431415 PAVERAMA",0,0,2,86,0,88,"2013"
"21684","431417 PEDRAS ALTAS",0,0,2,24,0,26,"2013"
"21685","431420 PEDRO OSORIO",0,1,4,96,1,102,"2013"
"21686","431430 PEJUCARA",0,0,1,49,0,50,"2013"
"21687","431440 PELOTAS",6,31,102,4190,18,4347,"2013"
"21688","431442 PICADA CAFE",0,2,0,40,0,42,"2013"
"21689","431445 PINHAL",0,2,0,36,0,38,"2013"
"21690","431446 PINHAL DA SERRA",0,0,0,23,2,25,"2013"
"21691","431447 PINHAL GRANDE",0,0,1,38,0,39,"2013"
"21692","431449 PINHEIRINHO DO VALE",0,2,2,36,0,40,"2013"
"21693","431450 PINHEIRO MACHADO",0,2,2,101,1,106,"2013"
"21694","431454 PINTO BANDEIRA",0,0,1,22,0,23,"2013"
"21695","431455 PIRAPO",0,0,0,19,0,19,"2013"
"21696","431460 PIRATINI",0,2,3,189,1,195,"2013"
"21697","431470 PLANALTO",0,0,1,120,0,121,"2013"
"21698","431475 POCO DAS ANTAS",0,0,0,13,0,13,"2013"
"21699","431477 PONTAO",0,1,0,38,0,39,"2013"
"21700","431478 PONTE PRETA",0,0,0,11,0,11,"2013"
"21701","431480 PORTAO",1,1,11,380,1,394,"2013"
"21702","431490 PORTO ALEGRE",48,96,351,19159,85,19739,"2013"
"21703","431500 PORTO LUCENA",1,1,2,31,0,35,"2013"
"21704","431505 PORTO MAUA",0,0,0,15,0,15,"2013"
"21705","431507 PORTO VERA CRUZ",0,0,0,9,0,9,"2013"
"21706","431510 PORTO XAVIER",0,1,1,114,0,116,"2013"
"21707","431513 POUSO NOVO",0,0,0,11,2,13,"2013"
"21708","431514 PRESIDENTE LUCENA",0,0,0,30,0,30,"2013"
"21709","431515 PROGRESSO",0,0,1,44,2,47,"2013"
"21710","431517 PROTASIO ALVES",0,0,0,16,0,16,"2013"
"21711","431520 PUTINGA",0,0,0,25,0,25,"2013"
"21712","431530 QUARAI",0,1,8,273,2,284,"2013"
"21713","431531 QUATRO IRMAOS",0,0,0,14,0,14,"2013"
"21714","431532 QUEVEDOS",0,1,0,23,0,24,"2013"
"21715","431535 QUINZE DE NOVEMBRO",0,0,0,28,0,28,"2013"
"21716","431540 REDENTORA",0,0,1,193,0,194,"2013"
"21717","431545 RELVADO",0,1,0,14,0,15,"2013"
"21718","431550 RESTINGA SECA",0,1,4,162,0,167,"2013"
"21719","431555 RIO DOS INDIOS",0,0,1,24,0,25,"2013"
"21720","431560 RIO GRANDE",1,13,68,2578,109,2769,"2013"
"21721","431570 RIO PARDO",0,2,5,341,1,349,"2013"
"21722","431575 RIOZINHO",0,0,0,48,0,48,"2013"
"21723","431580 ROCA SALES",0,0,1,88,0,89,"2013"
"21724","431590 RODEIO BONITO",0,0,4,76,0,80,"2013"
"21725","431595 ROLADOR",0,0,1,22,0,23,"2013"
"21726","431600 ROLANTE",0,0,2,241,3,246,"2013"
"21727","431610 RONDA ALTA",0,0,0,114,0,114,"2013"
"21728","431620 RONDINHA",1,0,1,49,0,51,"2013"
"21729","431630 ROQUE GONZALES",0,0,0,82,0,82,"2013"
"21730","431640 ROSARIO DO SUL",2,1,12,405,1,421,"2013"
"21731","431642 SAGRADA FAMILIA",0,1,0,24,0,25,"2013"
"21732","431643 SALDANHA MARINHO",0,0,1,28,0,29,"2013"
"21733","431645 SALTO DO JACUI",0,0,0,148,0,148,"2013"
"21734","431647 SALVADOR DAS MISSOES",0,0,0,21,0,21,"2013"
"21735","431650 SALVADOR DO SUL",0,2,0,59,0,61,"2013"
"21736","431660 SANANDUVA",0,0,4,157,0,161,"2013"
"21737","431670 SANTA BARBARA DO SUL",0,0,1,93,1,95,"2013"
"21738","431673 SANTA CECILIA DO SUL",0,0,0,15,0,15,"2013"
"21739","431675 SANTA CLARA DO SUL",0,0,1,86,0,87,"2013"
"21740","431680 SANTA CRUZ DO SUL",5,6,31,1642,1,1685,"2013"
"21741","431690 SANTA MARIA",5,27,67,3334,8,3441,"2013"
"21742","431695 SANTA MARIA DO HERVAL",0,0,1,50,0,51,"2013"
"21743","431697 SANTA MARGARIDA DO SUL",0,1,1,24,0,26,"2013"
"21744","431700 SANTANA DA BOA VISTA",0,1,1,63,0,65,"2013"
"21745","431710 SANT'ANA DO LIVRAMENTO",2,4,11,1030,2,1049,"2013"
"21746","431720 SANTA ROSA",5,7,26,878,3,919,"2013"
"21747","431725 SANTA TEREZA",0,0,0,9,0,9,"2013"
"21748","431730 SANTA VITORIA DO PALMAR",0,0,7,405,1,413,"2013"
"21749","431740 SANTIAGO",0,1,5,579,1,586,"2013"
"21750","431750 SANTO ANGELO",2,3,9,1040,0,1054,"2013"
"21751","431755 SANTO ANTONIO DO PALMA",0,0,0,26,0,26,"2013"
"21752","431760 SANTO ANTONIO DA PATRULHA",0,1,4,454,2,461,"2013"
"21753","431770 SANTO ANTONIO DAS MISSOES",0,0,0,112,0,112,"2013"
"21754","431775 SANTO ANTONIO DO PLANALTO",0,0,0,23,0,23,"2013"
"21755","431780 SANTO AUGUSTO",1,2,2,185,0,190,"2013"
"21756","431790 SANTO CRISTO",0,0,6,139,0,145,"2013"
"21757","431795 SANTO EXPEDITO DO SUL",0,0,0,21,0,21,"2013"
"21758","431800 SAO BORJA",1,3,4,764,2,774,"2013"
"21759","431805 SAO DOMINGOS DO SUL",0,0,0,16,0,16,"2013"
"21760","431810 SAO FRANCISCO DE ASSIS",0,0,1,176,0,177,"2013"
"21761","431820 SAO FRANCISCO DE PAULA",0,1,2,260,1,264,"2013"
"21762","431830 SAO GABRIEL",0,4,11,758,1,774,"2013"
"21763","431840 SAO JERONIMO",0,0,2,268,0,270,"2013"
"21764","431842 SAO JOAO DA URTIGA",0,0,1,33,0,34,"2013"
"21765","431843 SAO JOAO DO POLESINE",0,0,0,21,0,21,"2013"
"21766","431844 SAO JORGE",0,0,0,17,0,17,"2013"
"21767","431845 SAO JOSE DAS MISSOES",0,0,0,28,0,28,"2013"
"21768","431846 SAO JOSE DO HERVAL",0,0,0,18,0,18,"2013"
"21769","431848 SAO JOSE DO HORTENCIO",0,0,0,47,0,47,"2013"
"21770","431849 SAO JOSE DO INHACORA",0,0,0,15,0,15,"2013"
"21771","431850 SAO JOSE DO NORTE",2,1,10,239,8,260,"2013"
"21772","431860 SAO JOSE DO OURO",1,0,0,73,0,74,"2013"
"21773","431861 SAO JOSE DO SUL",0,0,0,14,0,14,"2013"
"21774","431862 SAO JOSE DOS AUSENTES",0,1,0,45,1,47,"2013"
"21775","431870 SAO LEOPOLDO",3,15,55,3009,8,3090,"2013"
"21776","431880 SAO LOURENCO DO SUL",0,1,9,380,0,390,"2013"
"21777","431890 SAO LUIZ GONZAGA",2,1,3,418,0,424,"2013"
"21778","431900 SAO MARCOS",0,2,1,245,0,248,"2013"
"21779","431910 SAO MARTINHO",0,0,0,62,0,62,"2013"
"21780","431912 SAO MARTINHO DA SERRA",0,0,0,31,0,31,"2013"
"21781","431915 SAO MIGUEL DAS MISSOES",0,1,1,90,0,92,"2013"
"21782","431920 SAO NICOLAU",0,0,1,53,0,54,"2013"
"21783","431930 SAO PAULO DAS MISSOES",0,0,0,42,0,42,"2013"
"21784","431935 SAO PEDRO DA SERRA",0,0,0,46,0,46,"2013"
"21785","431936 SAO PEDRO DAS MISSOES",0,0,0,21,0,21,"2013"
"21786","431937 SAO PEDRO DO BUTIA",0,0,0,21,0,21,"2013"
"21787","431940 SAO PEDRO DO SUL",0,1,3,154,1,159,"2013"
"21788","431950 SAO SEBASTIAO DO CAI",1,1,5,320,1,328,"2013"
"21789","431960 SAO SEPE",0,1,0,253,0,254,"2013"
"21790","431970 SAO VALENTIM",0,0,0,27,0,27,"2013"
"21791","431971 SAO VALENTIM DO SUL",0,0,0,15,0,15,"2013"
"21792","431973 SAO VALERIO DO SUL",0,0,0,42,0,42,"2013"
"21793","431975 SAO VENDELINO",0,0,0,21,0,21,"2013"
"21794","431980 SAO VICENTE DO SUL",0,1,1,98,1,101,"2013"
"21795","431990 SAPIRANGA",3,2,16,1092,1,1114,"2013"
"21796","432000 SAPUCAIA DO SUL",8,10,73,1821,0,1912,"2013"
"21797","432010 SARANDI",0,1,7,248,0,256,"2013"
"21798","432020 SEBERI",0,0,3,133,0,136,"2013"
"21799","432023 SEDE NOVA",0,0,0,30,0,30,"2013"
"21800","432026 SEGREDO",1,0,0,60,1,62,"2013"
"21801","432030 SELBACH",0,0,0,47,0,47,"2013"
"21802","432032 SENADOR SALGADO FILHO",0,0,0,23,0,23,"2013"
"21803","432035 SENTINELA DO SUL",0,0,0,52,0,52,"2013"
"21804","432040 SERAFINA CORREA",0,0,2,166,0,168,"2013"
"21805","432045 SERIO",0,0,0,26,0,26,"2013"
"21806","432050 SERTAO",0,0,1,58,1,60,"2013"
"21807","432055 SERTAO SANTANA",0,0,0,58,3,61,"2013"
"21808","432057 SETE DE SETEMBRO",0,1,0,11,0,12,"2013"
"21809","432060 SEVERIANO DE ALMEIDA",0,1,0,28,0,29,"2013"
"21810","432065 SILVEIRA MARTINS",0,0,2,27,0,29,"2013"
"21811","432067 SINIMBU",0,0,1,61,0,62,"2013"
"21812","432070 SOBRADINHO",0,1,3,153,0,157,"2013"
"21813","432080 SOLEDADE",1,2,7,381,4,395,"2013"
"21814","432085 TABAI",0,0,1,39,0,40,"2013"
"21815","432090 TAPEJARA",0,0,2,265,0,267,"2013"
"21816","432100 TAPERA",1,0,0,121,1,123,"2013"
"21817","432110 TAPES",1,1,6,176,1,185,"2013"
"21818","432120 TAQUARA",1,1,6,752,1,761,"2013"
"21819","432130 TAQUARI",0,1,3,317,0,321,"2013"
"21820","432132 TAQUARUCU DO SUL",0,0,1,33,0,34,"2013"
"21821","432135 TAVARES",0,0,3,51,0,54,"2013"
"21822","432140 TENENTE PORTELA",0,0,2,221,1,224,"2013"
"21823","432143 TERRA DE AREIA",1,2,1,108,3,115,"2013"
"21824","432145 TEUTONIA",0,3,4,369,0,376,"2013"
"21825","432146 TIO HUGO",0,0,0,39,0,39,"2013"
"21826","432147 TIRADENTES DO SUL",0,0,0,51,0,51,"2013"
"21827","432149 TOROPI",0,0,0,17,0,17,"2013"
"21828","432150 TORRES",0,1,4,459,0,464,"2013"
"21829","432160 TRAMANDAI",1,0,16,741,0,758,"2013"
"21830","432162 TRAVESSEIRO",0,0,0,9,0,9,"2013"
"21831","432163 TRES ARROIOS",0,0,0,8,0,8,"2013"
"21832","432166 TRES CACHOEIRAS",0,0,1,105,0,106,"2013"
"21833","432170 TRES COROAS",2,2,6,308,0,318,"2013"
"21834","432180 TRES DE MAIO",1,0,2,308,0,311,"2013"
"21835","432183 TRES FORQUILHAS",0,0,1,33,0,34,"2013"
"21836","432185 TRES PALMEIRAS",0,0,2,70,0,72,"2013"
"21837","432190 TRES PASSOS",1,1,0,317,0,319,"2013"
"21838","432195 TRINDADE DO SUL",0,0,1,67,0,68,"2013"
"21839","432200 TRIUNFO",2,0,4,359,2,367,"2013"
"21840","432210 TUCUNDUVA",0,0,3,45,0,48,"2013"
"21841","432215 TUNAS",0,0,1,46,0,47,"2013"
"21842","432218 TUPANCI DO SUL",0,0,0,13,0,13,"2013"
"21843","432220 TUPANCIRETA",0,3,4,262,2,271,"2013"
"21844","432225 TUPANDI",0,0,1,43,0,44,"2013"
"21845","432230 TUPARENDI",0,0,0,73,0,73,"2013"
"21846","432232 TURUCU",0,0,1,28,0,29,"2013"
"21847","432234 UBIRETAMA",0,0,0,17,0,17,"2013"
"21848","432235 UNIAO DA SERRA",0,0,0,10,0,10,"2013"
"21849","432237 UNISTALDA",0,0,0,26,0,26,"2013"
"21850","432240 URUGUAIANA",8,11,16,1082,792,1909,"2013"
"21851","432250 VACARIA",1,3,11,863,24,902,"2013"
"21852","432252 VALE VERDE",1,0,0,21,0,22,"2013"
"21853","432253 VALE DO SOL",0,1,0,100,1,102,"2013"
"21854","432254 VALE REAL",0,0,0,58,0,58,"2013"
"21855","432255 VANINI",0,0,0,18,0,18,"2013"
"21856","432260 VENANCIO AIRES",0,3,15,689,0,707,"2013"
"21857","432270 VERA CRUZ",0,1,1,278,1,281,"2013"
"21858","432280 VERANOPOLIS",0,0,5,253,0,258,"2013"
"21859","432285 VESPASIANO CORREA",0,0,0,12,0,12,"2013"
"21860","432290 VIADUTOS",0,0,0,31,1,32,"2013"
"21861","432300 VIAMAO",6,17,66,3400,36,3525,"2013"
"21862","432310 VICENTE DUTRA",0,1,2,47,0,50,"2013"
"21863","432320 VICTOR GRAEFF",0,0,2,33,0,35,"2013"
"21864","432330 VILA FLORES",0,0,0,30,0,30,"2013"
"21865","432335 VILA LANGARO",0,0,1,11,0,12,"2013"
"21866","432340 VILA MARIA",0,0,0,35,0,35,"2013"
"21867","432345 VILA NOVA DO SUL",1,0,0,30,0,31,"2013"
"21868","432350 VISTA ALEGRE",0,0,1,22,0,23,"2013"
"21869","432360 VISTA ALEGRE DO PRATA",0,0,0,4,0,4,"2013"
"21870","432370 VISTA GAUCHA",0,1,0,23,0,24,"2013"
"21871","432375 VITORIA DAS MISSOES",0,0,1,35,0,36,"2013"
"21872","432377 WESTFALIA",0,0,0,45,0,45,"2013"
"21873","432380 XANGRI-LA",0,3,11,212,0,226,"2013"
"21874","500020 AGUA CLARA",1,0,1,276,0,278,"2013"
"21875","500025 ALCINOPOLIS",0,0,0,44,0,44,"2013"
"21876","500060 AMAMBAI",5,1,12,686,0,704,"2013"
"21877","500070 ANASTACIO",1,0,1,371,2,375,"2013"
"21878","500080 ANAURILANDIA",0,1,3,95,0,99,"2013"
"21879","500085 ANGELICA",0,0,0,155,0,155,"2013"
"21880","500090 ANTONIO JOAO",1,0,2,171,1,175,"2013"
"21881","500100 APARECIDA DO TABOADO",1,0,7,329,0,337,"2013"
"21882","500110 AQUIDAUANA",3,1,9,745,9,767,"2013"
"21883","500124 ARAL MOREIRA",1,47,5,115,4,172,"2013"
"21884","500150 BANDEIRANTES",0,0,1,79,1,81,"2013"
"21885","500190 BATAGUASSU",0,1,3,308,0,312,"2013"
"21886","500200 BATAYPORA",0,0,3,159,0,162,"2013"
"21887","500210 BELA VISTA",3,1,3,429,1,437,"2013"
"21888","500215 BODOQUENA",0,0,2,130,0,132,"2013"
"21889","500220 BONITO",2,2,2,314,0,320,"2013"
"21890","500230 BRASILANDIA",0,1,2,125,0,128,"2013"
"21891","500240 CAARAPO",1,2,2,499,0,504,"2013"
"21892","500260 CAMAPUA",1,0,1,188,4,194,"2013"
"21893","500270 CAMPO GRANDE",35,32,124,13326,176,13693,"2013"
"21894","500280 CARACOL",0,2,0,75,0,77,"2013"
"21895","500290 CASSILANDIA",1,0,1,276,0,278,"2013"
"21896","500295 CHAPADAO DO SUL",0,0,2,373,1,376,"2013"
"21897","500310 CORGUINHO",0,0,0,36,1,37,"2013"
"21898","500315 CORONEL SAPUCAIA",2,3,3,357,4,369,"2013"
"21899","500320 CORUMBA",4,15,18,1934,11,1982,"2013"
"21900","500325 COSTA RICA",2,2,3,362,0,369,"2013"
"21901","500330 COXIM",0,5,4,531,0,540,"2013"
"21902","500345 DEODAPOLIS",0,1,2,179,0,182,"2013"
"21903","500348 DOIS IRMAOS DO BURITI",1,0,2,123,1,127,"2013"
"21904","500350 DOURADINA",0,1,3,77,2,83,"2013"
"21905","500370 DOURADOS",10,35,79,3552,18,3694,"2013"
"21906","500375 ELDORADO",0,1,5,220,0,226,"2013"
"21907","500380 FATIMA DO SUL",0,2,8,254,1,265,"2013"
"21908","500390 FIGUEIRAO",0,0,2,34,0,36,"2013"
"21909","500400 GLORIA DE DOURADOS",0,1,1,123,0,125,"2013"
"21910","500410 GUIA LOPES DA LAGUNA",1,2,1,135,2,141,"2013"
"21911","500430 IGUATEMI",0,0,1,235,0,236,"2013"
"21912","500440 INOCENCIA",0,1,1,94,0,96,"2013"
"21913","500450 ITAPORA",0,0,4,238,4,246,"2013"
"21914","500460 ITAQUIRAI",0,1,6,221,1,229,"2013"
"21915","500470 IVINHEMA",1,2,4,309,0,316,"2013"
"21916","500480 JAPORA",0,0,16,177,4,197,"2013"
"21917","500490 JARAGUARI",0,0,0,45,0,45,"2013"
"21918","500500 JARDIM",1,1,3,395,4,404,"2013"
"21919","500510 JATEI",0,0,2,71,0,73,"2013"
"21920","500515 JUTI",0,1,6,101,0,108,"2013"
"21921","500520 LADARIO",1,8,4,358,1,372,"2013"
"21922","500525 LAGUNA CARAPA",0,2,1,120,3,126,"2013"
"21923","500540 MARACAJU",3,5,16,608,6,638,"2013"
"21924","500560 MIRANDA",0,1,8,463,2,474,"2013"
"21925","500568 MUNDO NOVO",0,0,109,186,0,295,"2013"
"21926","500570 NAVIRAI",1,2,8,855,1,867,"2013"
"21927","500580 NIOAQUE",1,1,4,161,1,168,"2013"
"21928","500600 NOVA ALVORADA DO SUL",0,2,3,324,0,329,"2013"
"21929","500620 NOVA ANDRADINA",1,2,1,667,2,673,"2013"
"21930","500625 NOVO HORIZONTE DO SUL",1,0,0,73,0,74,"2013"
"21931","500627 PARAISO DAS AGUAS",1,0,0,30,0,31,"2013"
"21932","500630 PARANAIBA",0,3,10,513,0,526,"2013"
"21933","500635 PARANHOS",0,0,3,296,51,350,"2013"
"21934","500640 PEDRO GOMES",0,0,1,103,0,104,"2013"
"21935","500660 PONTA PORA",4,5,33,1372,196,1610,"2013"
"21936","500690 PORTO MURTINHO",0,2,2,246,5,255,"2013"
"21937","500710 RIBAS DO RIO PARDO",0,0,3,337,4,344,"2013"
"21938","500720 RIO BRILHANTE",1,4,10,632,1,648,"2013"
"21939","500730 RIO NEGRO",0,0,1,55,1,57,"2013"
"21940","500740 RIO VERDE DE MATO GROSSO",1,0,2,269,0,272,"2013"
"21941","500750 ROCHEDO",0,0,0,37,0,37,"2013"
"21942","500755 SANTA RITA DO PARDO",0,0,0,75,0,75,"2013"
"21943","500769 SAO GABRIEL DO OESTE",0,0,4,408,0,412,"2013"
"21944","500770 SETE QUEDAS",0,0,0,149,4,153,"2013"
"21945","500780 SELVIRIA",0,0,1,57,0,58,"2013"
"21946","500790 SIDROLANDIA",0,2,10,654,5,671,"2013"
"21947","500793 SONORA",0,0,5,281,1,287,"2013"
"21948","500795 TACURU",2,2,2,219,0,225,"2013"
"21949","500797 TAQUARUSSU",0,0,2,48,0,50,"2013"
"21950","500800 TERENOS",0,0,0,172,3,175,"2013"
"21951","500830 TRES LAGOAS",3,2,9,1936,2,1952,"2013"
"21952","500840 VICENTINA",0,0,0,62,0,62,"2013"
"21953","MUNICIPIO IGNORADO - MT",0,0,0,6,0,6,"2013"
"21954","510010 ACORIZAL",1,1,0,69,0,71,"2013"
"21955","510020 AGUA BOA",0,1,12,313,6,332,"2013"
"21956","510025 ALTA FLORESTA",3,0,10,816,0,829,"2013"
"21957","510030 ALTO ARAGUAIA",0,0,7,269,2,278,"2013"
"21958","510035 ALTO BOA VISTA",0,0,2,52,0,54,"2013"
"21959","510040 ALTO GARCAS",0,0,2,115,2,119,"2013"
"21960","510050 ALTO PARAGUAI",0,0,1,101,0,102,"2013"
"21961","510060 ALTO TAQUARI",0,0,0,181,0,181,"2013"
"21962","510080 APIACAS",0,2,0,108,0,110,"2013"
"21963","510100 ARAGUAIANA",0,1,0,48,0,49,"2013"
"21964","510120 ARAGUAINHA",0,0,0,9,0,9,"2013"
"21965","510125 ARAPUTANGA",0,0,0,239,0,239,"2013"
"21966","510130 ARENAPOLIS",0,0,3,148,0,151,"2013"
"21967","510140 ARIPUANA",1,3,2,396,0,402,"2013"
"21968","510160 BARAO DE MELGACO",0,0,1,58,1,60,"2013"
"21969","510170 BARRA DO BUGRES",2,7,11,555,3,578,"2013"
"21970","510180 BARRA DO GARCAS",4,7,16,926,12,965,"2013"
"21971","510185 BOM JESUS DO ARAGUAIA",0,0,1,69,36,106,"2013"
"21972","510190 BRASNORTE",0,0,4,210,8,222,"2013"
"21973","510250 CACERES",8,6,21,1471,4,1510,"2013"
"21974","510260 CAMPINAPOLIS",0,0,5,138,207,350,"2013"
"21975","510263 CAMPO NOVO DO PARECIS",0,8,15,585,1,609,"2013"
"21976","510267 CAMPO VERDE",1,2,7,613,1,624,"2013"
"21977","510268 CAMPOS DE JULIO",1,3,4,110,0,118,"2013"
"21978","510269 CANABRAVA DO NORTE",0,0,0,55,0,55,"2013"
"21979","510270 CANARANA",0,1,4,352,42,399,"2013"
"21980","510279 CARLINDA",0,1,2,113,0,116,"2013"
"21981","510285 CASTANHEIRA",0,0,2,105,0,107,"2013"
"21982","510300 CHAPADA DOS GUIMARAES",0,1,5,227,4,237,"2013"
"21983","510305 CLAUDIA",0,2,5,125,1,133,"2013"
"21984","510310 COCALINHO",0,1,1,62,2,66,"2013"
"21985","510320 COLIDER",1,0,17,478,0,496,"2013"
"21986","510325 COLNIZA",0,2,1,424,10,437,"2013"
"21987","510330 COMODORO",2,2,5,289,71,369,"2013"
"21988","510335 CONFRESA",1,0,1,389,5,396,"2013"
"21989","510336 CONQUISTA D'OESTE",0,2,0,55,2,59,"2013"
"21990","510337 COTRIGUACU",0,0,0,145,1,146,"2013"
"21991","510340 CUIABA",27,41,124,9924,10,10126,"2013"
"21992","510343 CURVELANDIA",0,0,0,63,0,63,"2013"
"21993","510345 DENISE",0,1,2,81,1,85,"2013"
"21994","510350 DIAMANTINO",3,4,1,309,0,317,"2013"
"21995","510360 DOM AQUINO",1,0,0,83,0,84,"2013"
"21996","510370 FELIZ NATAL",0,0,2,181,13,196,"2013"
"21997","510380 FIGUEIROPOLIS D'OESTE",0,0,0,45,0,45,"2013"
"21998","510385 GAUCHA DO NORTE",0,0,0,76,12,88,"2013"
"21999","510390 GENERAL CARNEIRO",1,1,2,66,8,78,"2013"
"22000","510395 GLORIA D'OESTE",0,0,0,34,0,34,"2013"
"22001","510410 GUARANTA DO NORTE",1,1,21,462,0,485,"2013"
"22002","510420 GUIRATINGA",1,1,2,127,0,131,"2013"
"22003","510450 INDIAVAI",0,0,1,40,0,41,"2013"
"22004","510452 IPIRANGA DO NORTE",0,1,1,77,0,79,"2013"
"22005","510454 ITANHANGA",1,0,0,73,0,74,"2013"
"22006","510455 ITAUBA",1,1,1,78,0,81,"2013"
"22007","510460 ITIQUIRA",1,1,5,174,2,183,"2013"
"22008","510480 JACIARA",3,0,2,464,1,470,"2013"
"22009","510490 JANGADA",0,1,0,90,1,92,"2013"
"22010","510500 JAURU",0,0,2,149,0,151,"2013"
"22011","510510 JUARA",2,0,0,559,8,569,"2013"
"22012","510515 JUINA",2,1,5,597,19,624,"2013"
"22013","510517 JURUENA",0,1,1,154,0,156,"2013"
"22014","510520 JUSCIMEIRA",1,0,2,137,1,141,"2013"
"22015","510523 LAMBARI D'OESTE",0,0,2,78,0,80,"2013"
"22016","510525 LUCAS DO RIO VERDE",3,4,15,1108,1,1131,"2013"
"22017","510530 LUCIARA",1,0,0,32,1,34,"2013"
"22018","510550 VILA BELA DA SANTISSIMA TRINDADE",1,0,0,197,2,200,"2013"
"22019","510558 MARCELANDIA",2,3,18,165,8,196,"2013"
"22020","510560 MATUPA",0,0,11,274,0,285,"2013"
"22021","510562 MIRASSOL D'OESTE",3,2,2,384,0,391,"2013"
"22022","510590 NOBRES",1,0,3,260,1,265,"2013"
"22023","510600 NORTELANDIA",0,1,5,84,1,91,"2013"
"22024","510610 NOSSA SENHORA DO LIVRAMENTO",1,3,1,146,2,153,"2013"
"22025","510615 NOVA BANDEIRANTES",0,1,5,147,0,153,"2013"
"22026","510617 NOVA NAZARE",1,0,1,51,8,61,"2013"
"22027","510618 NOVA LACERDA",1,0,0,73,2,76,"2013"
"22028","510619 NOVA SANTA HELENA",0,1,1,62,0,64,"2013"
"22029","510620 NOVA BRASILANDIA",0,0,0,55,0,55,"2013"
"22030","510621 NOVA CANAA DO NORTE",0,0,4,176,0,180,"2013"
"22031","510622 NOVA MUTUM",2,1,8,740,1,752,"2013"
"22032","510623 NOVA OLIMPIA",0,0,3,301,0,304,"2013"
"22033","510624 NOVA UBIRATA",0,0,6,136,2,144,"2013"
"22034","510625 NOVA XAVANTINA",0,0,3,272,1,276,"2013"
"22035","510626 NOVO MUNDO",1,1,4,72,1,79,"2013"
"22036","510627 NOVO HORIZONTE DO NORTE",0,1,0,39,0,40,"2013"
"22037","510628 NOVO SAO JOAQUIM",0,0,2,94,0,96,"2013"
"22038","510629 PARANAITA",1,0,3,152,0,156,"2013"
"22039","510630 PARANATINGA",1,7,9,307,3,327,"2013"
"22040","510631 NOVO SANTO ANTONIO",0,1,0,17,0,18,"2013"
"22041","510637 PEDRA PRETA",2,0,1,216,1,220,"2013"
"22042","510642 PEIXOTO DE AZEVEDO",0,6,30,510,1,547,"2013"
"22043","510645 PLANALTO DA SERRA",0,0,1,24,0,25,"2013"
"22044","510650 POCONE",0,1,6,487,1,495,"2013"
"22045","510665 PONTAL DO ARAGUAIA",0,1,1,67,0,69,"2013"
"22046","510670 PONTE BRANCA",0,0,3,17,0,20,"2013"
"22047","510675 PONTES E LACERDA",1,6,8,744,6,765,"2013"
"22048","510677 PORTO ALEGRE DO NORTE",2,0,1,130,0,133,"2013"
"22049","510680 PORTO DOS GAUCHOS",0,0,2,81,3,86,"2013"
"22050","510682 PORTO ESPERIDIAO",0,1,1,184,0,186,"2013"
"22051","510685 PORTO ESTRELA",0,1,0,45,1,47,"2013"
"22052","510700 POXOREO",0,1,2,237,6,246,"2013"
"22053","510704 PRIMAVERA DO LESTE",1,2,6,1087,10,1106,"2013"
"22054","510706 QUERENCIA",0,1,0,274,19,294,"2013"
"22055","510710 SAO JOSE DOS QUATRO MARCOS",1,0,2,248,1,252,"2013"
"22056","510715 RESERVA DO CABACAL",0,0,0,25,0,25,"2013"
"22057","510718 RIBEIRAO CASCALHEIRA",0,2,2,137,22,163,"2013"
"22058","510719 RIBEIRAOZINHO",0,0,1,42,0,43,"2013"
"22059","510720 RIO BRANCO",1,0,1,65,0,67,"2013"
"22060","510724 SANTA CARMEM",0,0,0,48,1,49,"2013"
"22061","510726 SANTO AFONSO",0,1,0,40,0,41,"2013"
"22062","510729 SAO JOSE DO POVO",0,0,0,27,0,27,"2013"
"22063","510730 SAO JOSE DO RIO CLARO",0,1,3,276,0,280,"2013"
"22064","510735 SAO JOSE DO XINGU",0,0,1,71,1,73,"2013"
"22065","510740 SAO PEDRO DA CIPA",0,0,0,58,0,58,"2013"
"22066","510757 RONDOLANDIA",0,0,0,35,0,35,"2013"
"22067","510760 RONDONOPOLIS",20,8,39,3611,21,3699,"2013"
"22068","510770 ROSARIO OESTE",0,3,1,183,1,188,"2013"
"22069","510774 SANTA CRUZ DO XINGU",0,0,0,28,0,28,"2013"
"22070","510775 SALTO DO CEU",0,0,0,41,0,41,"2013"
"22071","510776 SANTA RITA DO TRIVELATO",0,0,0,32,0,32,"2013"
"22072","510777 SANTA TEREZINHA",0,1,2,106,2,111,"2013"
"22073","510779 SANTO ANTONIO DO LESTE",0,0,1,32,1,34,"2013"
"22074","510780 SANTO ANTONIO DO LEVERGER",2,0,1,197,2,202,"2013"
"22075","510785 SAO FELIX DO ARAGUAIA",0,1,1,113,7,122,"2013"
"22076","510787 SAPEZAL",0,4,7,353,1,365,"2013"
"22077","510788 SERRA NOVA DOURADA",0,0,0,14,0,14,"2013"
"22078","510790 SINOP",9,5,40,2409,4,2467,"2013"
"22079","510792 SORRISO",4,3,29,1503,3,1542,"2013"
"22080","510794 TABAPORA",0,1,6,121,0,128,"2013"
"22081","510795 TANGARA DA SERRA",6,8,24,1394,2,1434,"2013"
"22082","510800 TAPURAH",0,0,2,188,0,190,"2013"
"22083","510805 TERRA NOVA DO NORTE",0,0,6,131,0,137,"2013"
"22084","510810 TESOURO",0,0,0,29,0,29,"2013"
"22085","510820 TORIXOREU",0,0,1,31,0,32,"2013"
"22086","510830 UNIAO DO SUL",0,0,4,40,0,44,"2013"
"22087","510835 VALE DE SAO DOMINGOS",2,0,0,47,0,49,"2013"
"22088","510840 VARZEA GRANDE",17,17,56,4868,23,4981,"2013"
"22089","510850 VERA",0,1,4,140,1,146,"2013"
"22090","510860 VILA RICA",1,0,2,294,0,297,"2013"
"22091","510880 NOVA GUARITA",0,1,3,66,0,70,"2013"
"22092","510885 NOVA MARILANDIA",0,0,3,47,0,50,"2013"
"22093","510890 NOVA MARINGA",0,1,0,100,1,102,"2013"
"22094","510895 NOVA MONTE VERDE",0,0,0,63,0,63,"2013"
"22095","MUNICIPIO IGNORADO - GO",0,0,0,11,0,11,"2013"
"22096","520005 ABADIA DE GOIAS",0,0,2,131,2,135,"2013"
"22097","520010 ABADIANIA",0,0,4,158,2,164,"2013"
"22098","520013 ACREUNA",0,1,87,185,1,274,"2013"
"22099","520015 ADELANDIA",0,0,0,26,0,26,"2013"
"22100","520017 AGUA FRIA DE GOIAS",0,0,0,50,1,51,"2013"
"22101","520020 AGUA LIMPA",0,0,0,17,0,17,"2013"
"22102","520025 AGUAS LINDAS DE GOIAS",9,10,43,2276,248,2586,"2013"
"22103","520030 ALEXANIA",1,3,7,360,9,380,"2013"
"22104","520050 ALOANDIA",0,0,2,23,0,25,"2013"
"22105","520055 ALTO HORIZONTE",0,0,0,75,0,75,"2013"
"22106","520060 ALTO PARAISO DE GOIAS",0,1,0,94,6,101,"2013"
"22107","520080 ALVORADA DO NORTE",0,0,2,120,1,123,"2013"
"22108","520082 AMARALINA",0,0,2,19,0,21,"2013"
"22109","520085 AMERICANO DO BRASIL",0,1,1,77,0,79,"2013"
"22110","520090 AMORINOPOLIS",0,0,1,30,0,31,"2013"
"22111","520110 ANAPOLIS",13,31,125,5681,17,5867,"2013"
"22112","520120 ANHANGUERA",0,0,0,12,1,13,"2013"
"22113","520130 ANICUNS",0,2,2,205,4,213,"2013"
"22114","520140 APARECIDA DE GOIANIA",24,35,110,7731,32,7932,"2013"
"22115","520145 APARECIDA DO RIO DOCE",0,0,0,20,0,20,"2013"
"22116","520150 APORE",0,1,0,69,0,70,"2013"
"22117","520160 ARACU",0,0,0,31,0,31,"2013"
"22118","520170 ARAGARCAS",1,0,18,263,0,282,"2013"
"22119","520180 ARAGOIANIA",1,0,1,125,0,127,"2013"
"22120","520215 ARAGUAPAZ",0,0,0,60,0,60,"2013"
"22121","520235 ARENOPOLIS",0,0,0,39,0,39,"2013"
"22122","520250 ARUANA",0,0,1,99,1,101,"2013"
"22123","520260 AURILANDIA",0,0,0,28,0,28,"2013"
"22124","520280 AVELINOPOLIS",0,2,1,19,0,22,"2013"
"22125","520310 BALIZA",0,1,3,35,0,39,"2013"
"22126","520320 BARRO ALTO",0,0,2,93,0,95,"2013"
"22127","520330 BELA VISTA DE GOIAS",0,3,7,355,1,366,"2013"
"22128","520340 BOM JARDIM DE GOIAS",2,0,2,61,1,66,"2013"
"22129","520350 BOM JESUS DE GOIAS",0,5,4,277,3,289,"2013"
"22130","520355 BONFINOPOLIS",0,0,0,107,2,109,"2013"
"22131","520357 BONOPOLIS",0,0,0,39,0,39,"2013"
"22132","520360 BRAZABRANTES",0,0,0,40,0,40,"2013"
"22133","520380 BRITANIA",0,0,2,71,1,74,"2013"
"22134","520390 BURITI ALEGRE",0,0,1,98,0,99,"2013"
"22135","520393 BURITI DE GOIAS",0,0,0,29,0,29,"2013"
"22136","520396 BURITINOPOLIS",0,1,0,35,0,36,"2013"
"22137","520400 CABECEIRAS",0,0,1,116,1,118,"2013"
"22138","520410 CACHOEIRA ALTA",0,0,1,117,1,119,"2013"
"22139","520420 CACHOEIRA DE GOIAS",0,0,0,23,0,23,"2013"
"22140","520425 CACHOEIRA DOURADA",0,0,1,105,1,107,"2013"
"22141","520430 CACU",1,0,1,159,0,161,"2013"
"22142","520440 CAIAPONIA",1,2,7,176,0,186,"2013"
"22143","520450 CALDAS NOVAS",6,5,14,1147,1,1173,"2013"
"22144","520455 CALDAZINHA",0,0,0,42,1,43,"2013"
"22145","520460 CAMPESTRE DE GOIAS",0,0,2,53,1,56,"2013"
"22146","520465 CAMPINACU",0,1,0,41,0,42,"2013"
"22147","520470 CAMPINORTE",0,1,6,151,0,158,"2013"
"22148","520480 CAMPO ALEGRE DE GOIAS",0,0,0,73,0,73,"2013"
"22149","520485 CAMPO LIMPO DE GOIAS",0,0,0,85,1,86,"2013"
"22150","520490 CAMPOS BELOS",1,0,8,371,1,381,"2013"
"22151","520495 CAMPOS VERDES",0,0,0,49,0,49,"2013"
"22152","520500 CARMO DO RIO VERDE",0,0,2,119,0,121,"2013"
"22153","520505 CASTELANDIA",0,0,2,30,0,32,"2013"
"22154","520510 CATALAO",2,3,19,1303,3,1330,"2013"
"22155","520520 CATURAI",0,0,3,38,1,42,"2013"
"22156","520530 CAVALCANTE",2,0,4,150,0,156,"2013"
"22157","520540 CERES",1,1,2,242,0,246,"2013"
"22158","520545 CEZARINA",0,1,2,125,0,128,"2013"
"22159","520547 CHAPADAO DO CEU",1,1,6,160,0,168,"2013"
"22160","520549 CIDADE OCIDENTAL",3,6,9,970,10,998,"2013"
"22161","520551 COCALZINHO DE GOIAS",0,1,4,194,13,212,"2013"
"22162","520552 COLINAS DO SUL",0,1,0,45,0,46,"2013"
"22163","520570 CORREGO DO OURO",0,0,1,22,0,23,"2013"
"22164","520580 CORUMBA DE GOIAS",0,0,5,104,2,111,"2013"
"22165","520590 CORUMBAIBA",0,0,2,93,1,96,"2013"
"22166","520620 CRISTALINA",0,5,19,767,9,800,"2013"
"22167","520630 CRISTIANOPOLIS",0,0,1,30,1,32,"2013"
"22168","520640 CRIXAS",0,2,2,190,1,195,"2013"
"22169","520650 CROMINIA",0,0,0,59,1,60,"2013"
"22170","520660 CUMARI",0,0,0,26,0,26,"2013"
"22171","520670 DAMIANOPOLIS",0,1,0,47,0,48,"2013"
"22172","520680 DAMOLANDIA",0,1,0,28,0,29,"2013"
"22173","520690 DAVINOPOLIS",0,0,0,16,0,16,"2013"
"22174","520710 DIORAMA",0,0,1,17,0,18,"2013"
"22175","520725 DOVERLANDIA",0,1,1,59,0,61,"2013"
"22176","520735 EDEALINA",0,0,0,47,0,47,"2013"
"22177","520740 EDEIA",2,0,2,143,1,148,"2013"
"22178","520750 ESTRELA DO NORTE",0,0,2,43,0,45,"2013"
"22179","520753 FAINA",0,0,2,59,0,61,"2013"
"22180","520760 FAZENDA NOVA",0,0,0,55,0,55,"2013"
"22181","520780 FIRMINOPOLIS",0,1,0,90,0,91,"2013"
"22182","520790 FLORES DE GOIAS",0,1,2,109,0,112,"2013"
"22183","520800 FORMOSA",4,5,7,1763,4,1783,"2013"
"22184","520810 FORMOSO",0,0,0,62,0,62,"2013"
"22185","520815 GAMELEIRA DE GOIAS",0,0,0,31,0,31,"2013"
"22186","520830 DIVINOPOLIS DE GOIAS",0,0,1,63,0,64,"2013"
"22187","520840 GOIANAPOLIS",0,0,6,162,0,168,"2013"
"22188","520850 GOIANDIRA",0,0,0,52,0,52,"2013"
"22189","520860 GOIANESIA",1,4,27,855,2,889,"2013"
"22190","520870 GOIANIA",67,77,330,21438,114,22026,"2013"
"22191","520880 GOIANIRA",4,2,6,709,2,723,"2013"
"22192","520890 GOIAS",1,1,17,346,0,365,"2013"
"22193","520910 GOIATUBA",1,0,8,434,0,443,"2013"
"22194","520915 GOUVELANDIA",0,1,1,63,0,65,"2013"
"22195","520920 GUAPO",1,0,3,169,3,176,"2013"
"22196","520929 GUARAITA",1,0,0,19,0,20,"2013"
"22197","520940 GUARANI DE GOIAS",0,1,0,30,0,31,"2013"
"22198","520945 GUARINOS",0,0,0,23,0,23,"2013"
"22199","520960 HEITORAI",0,0,1,46,0,47,"2013"
"22200","520970 HIDROLANDIA",1,2,2,273,0,278,"2013"
"22201","520980 HIDROLINA",0,2,2,36,0,40,"2013"
"22202","520990 IACIARA",1,1,6,189,2,199,"2013"
"22203","520993 INACIOLANDIA",0,0,1,83,0,84,"2013"
"22204","520995 INDIARA",0,1,5,227,0,233,"2013"
"22205","521000 INHUMAS",3,3,18,652,1,677,"2013"
"22206","521010 IPAMERI",0,2,1,301,4,308,"2013"
"22207","521015 IPIRANGA DE GOIAS",0,0,0,19,0,19,"2013"
"22208","521020 IPORA",2,0,2,383,0,387,"2013"
"22209","521030 ISRAELANDIA",0,0,0,22,0,22,"2013"
"22210","521040 ITABERAI",0,5,6,538,3,552,"2013"
"22211","521056 ITAGUARI",0,0,0,58,0,58,"2013"
"22212","521060 ITAGUARU",0,0,0,42,0,42,"2013"
"22213","521080 ITAJA",0,0,1,79,0,80,"2013"
"22214","521090 ITAPACI",1,2,2,294,0,299,"2013"
"22215","521100 ITAPIRAPUA",0,0,1,87,0,88,"2013"
"22216","521120 ITAPURANGA",2,2,4,299,0,307,"2013"
"22217","521130 ITARUMA",0,0,1,78,0,79,"2013"
"22218","521140 ITAUCU",0,0,2,68,2,72,"2013"
"22219","521150 ITUMBIARA",3,5,8,1331,4,1351,"2013"
"22220","521160 IVOLANDIA",0,1,1,23,0,25,"2013"
"22221","521170 JANDAIA",2,0,3,63,0,68,"2013"
"22222","521180 JARAGUA",4,3,16,539,5,567,"2013"
"22223","521190 JATAI",4,6,34,1459,0,1503,"2013"
"22224","521200 JAUPACI",0,1,1,34,0,36,"2013"
"22225","521205 JESUPOLIS",0,0,1,29,0,30,"2013"
"22226","521210 JOVIANIA",0,0,0,83,0,83,"2013"
"22227","521220 JUSSARA",0,1,6,242,1,250,"2013"
"22228","521225 LAGOA SANTA",0,0,0,15,0,15,"2013"
"22229","521230 LEOPOLDO DE BULHOES",0,0,0,71,0,71,"2013"
"22230","521250 LUZIANIA",5,19,74,3049,24,3171,"2013"
"22231","521260 MAIRIPOTABA",0,0,0,27,0,27,"2013"
"22232","521270 MAMBAI",0,1,1,123,1,126,"2013"
"22233","521280 MARA ROSA",0,1,2,125,0,128,"2013"
"22234","521290 MARZAGAO",0,0,0,32,0,32,"2013"
"22235","521295 MATRINCHA",0,0,2,56,0,58,"2013"
"22236","521300 MAURILANDIA",2,0,0,187,0,189,"2013"
"22237","521305 MIMOSO DE GOIAS",0,0,0,10,5,15,"2013"
"22238","521308 MINACU",0,2,7,434,0,443,"2013"
"22239","521310 MINEIROS",5,1,11,1029,0,1046,"2013"
"22240","521340 MOIPORA",0,0,0,8,0,8,"2013"
"22241","521350 MONTE ALEGRE DE GOIAS",0,0,0,113,5,118,"2013"
"22242","521370 MONTES CLAROS DE GOIAS",0,0,1,91,0,92,"2013"
"22243","521375 MONTIVIDIU",0,0,6,154,2,162,"2013"
"22244","521377 MONTIVIDIU DO NORTE",0,0,0,40,0,40,"2013"
"22245","521380 MORRINHOS",7,1,7,592,1,608,"2013"
"22246","521385 MORRO AGUDO DE GOIAS",0,0,0,30,0,30,"2013"
"22247","521390 MOSSAMEDES",0,0,0,43,0,43,"2013"
"22248","521400 MOZARLANDIA",1,1,2,186,1,191,"2013"
"22249","521405 MUNDO NOVO",0,0,3,70,1,74,"2013"
"22250","521410 MUTUNOPOLIS",0,0,6,50,0,56,"2013"
"22251","521440 NAZARIO",0,1,1,104,1,107,"2013"
"22252","521450 NEROPOLIS",1,0,11,374,4,390,"2013"
"22253","521460 NIQUELANDIA",0,1,13,470,2,486,"2013"
"22254","521470 NOVA AMERICA",0,0,0,33,0,33,"2013"
"22255","521480 NOVA AURORA",0,0,0,24,0,24,"2013"
"22256","521483 NOVA CRIXAS",0,0,0,172,0,172,"2013"
"22257","521486 NOVA GLORIA",0,0,3,85,0,88,"2013"
"22258","521487 NOVA IGUACU DE GOIAS",0,0,4,25,0,29,"2013"
"22259","521490 NOVA ROMA",0,0,0,22,0,22,"2013"
"22260","521500 NOVA VENEZA",0,1,0,84,1,86,"2013"
"22261","521520 NOVO BRASIL",0,0,1,30,0,31,"2013"
"22262","521523 NOVO GAMA",0,4,33,1642,15,1694,"2013"
"22263","521525 NOVO PLANALTO",0,0,0,39,0,39,"2013"
"22264","521530 ORIZONA",0,0,3,150,0,153,"2013"
"22265","521540 OURO VERDE DE GOIAS",0,0,0,49,1,50,"2013"
"22266","521550 OUVIDOR",0,2,0,66,0,68,"2013"
"22267","521560 PADRE BERNARDO",1,0,0,311,69,381,"2013"
"22268","521565 PALESTINA DE GOIAS",1,0,3,37,0,41,"2013"
"22269","521570 PALMEIRAS DE GOIAS",1,0,2,323,2,328,"2013"
"22270","521580 PALMELO",0,0,1,19,0,20,"2013"
"22271","521590 PALMINOPOLIS",0,1,1,39,0,41,"2013"
"22272","521600 PANAMA",0,0,0,21,0,21,"2013"
"22273","521630 PARANAIGUARA",0,0,1,114,0,115,"2013"
"22274","521640 PARAUNA",1,0,2,127,2,132,"2013"
"22275","521645 PEROLANDIA",0,1,0,42,0,43,"2013"
"22276","521680 PETROLINA DE GOIAS",0,0,0,90,0,90,"2013"
"22277","521690 PILAR DE GOIAS",1,0,1,23,0,25,"2013"
"22278","521710 PIRACANJUBA",0,0,5,250,1,256,"2013"
"22279","521720 PIRANHAS",0,0,3,111,0,114,"2013"
"22280","521730 PIRENOPOLIS",1,2,7,256,2,268,"2013"
"22281","521740 PIRES DO RIO",1,0,6,339,1,347,"2013"
"22282","521760 PLANALTINA",8,12,28,1460,13,1521,"2013"
"22283","521770 PONTALINA",0,1,0,216,0,217,"2013"
"22284","521800 PORANGATU",0,2,20,559,5,586,"2013"
"22285","521805 PORTEIRAO",0,0,1,42,0,43,"2013"
"22286","521810 PORTELANDIA",0,0,0,74,0,74,"2013"
"22287","521830 POSSE",1,4,13,542,1,561,"2013"
"22288","521839 PROFESSOR JAMIL",1,0,2,29,0,32,"2013"
"22289","521850 QUIRINOPOLIS",1,2,6,598,1,608,"2013"
"22290","521860 RIALMA",0,0,3,123,0,126,"2013"
"22291","521870 RIANAPOLIS",1,0,0,66,0,67,"2013"
"22292","521878 RIO QUENTE",0,0,2,40,1,43,"2013"
"22293","521880 RIO VERDE",8,10,47,3228,0,3293,"2013"
"22294","521890 RUBIATABA",0,1,4,215,0,220,"2013"
"22295","521900 SANCLERLANDIA",0,0,1,83,0,84,"2013"
"22296","521910 SANTA BARBARA DE GOIAS",0,0,0,90,1,91,"2013"
"22297","521920 SANTA CRUZ DE GOIAS",0,1,0,28,0,29,"2013"
"22298","521925 SANTA FE DE GOIAS",1,0,0,59,0,60,"2013"
"22299","521930 SANTA HELENA DE GOIAS",1,2,9,528,0,540,"2013"
"22300","521935 SANTA ISABEL",0,0,0,32,0,32,"2013"
"22301","521940 SANTA RITA DO ARAGUAIA",0,0,0,102,1,103,"2013"
"22302","521945 SANTA RITA DO NOVO DESTINO",1,0,0,25,1,27,"2013"
"22303","521950 SANTA ROSA DE GOIAS",0,0,0,29,0,29,"2013"
"22304","521960 SANTA TEREZA DE GOIAS",0,0,1,44,1,46,"2013"
"22305","521970 SANTA TEREZINHA DE GOIAS",1,0,7,139,0,147,"2013"
"22306","521971 SANTO ANTONIO DA BARRA",0,0,1,45,0,46,"2013"
"22307","521973 SANTO ANTONIO DE GOIAS",1,0,0,90,0,91,"2013"
"22308","521975 SANTO ANTONIO DO DESCOBERTO",3,5,17,987,14,1026,"2013"
"22309","521980 SAO DOMINGOS",0,0,4,143,1,148,"2013"
"22310","521990 SAO FRANCISCO DE GOIAS",0,0,2,76,1,79,"2013"
"22311","522000 SAO JOAO D'ALIANCA",0,0,0,123,0,123,"2013"
"22312","522005 SAO JOAO DA PARAUNA",0,0,0,12,0,12,"2013"
"22313","522010 SAO LUIS DE MONTES BELOS",0,0,5,369,1,375,"2013"
"22314","522015 SAO LUIZ DO NORTE",1,0,3,69,0,73,"2013"
"22315","522020 SAO MIGUEL DO ARAGUAIA",0,0,3,306,0,309,"2013"
"22316","522026 SAO MIGUEL DO PASSA QUATRO",1,1,0,28,1,31,"2013"
"22317","522028 SAO PATRICIO",0,0,2,13,0,15,"2013"
"22318","522040 SAO SIMAO",0,0,4,227,0,231,"2013"
"22319","522045 SENADOR CANEDO",4,10,24,1902,3,1943,"2013"
"22320","522050 SERRANOPOLIS",0,0,2,78,0,80,"2013"
"22321","522060 SILVANIA",0,2,5,237,1,245,"2013"
"22322","522068 SIMOLANDIA",0,1,3,105,2,111,"2013"
"22323","522070 SITIO D'ABADIA",0,0,1,22,0,23,"2013"
"22324","522100 TAQUARAL DE GOIAS",0,0,0,37,0,37,"2013"
"22325","522108 TERESINA DE GOIAS",1,1,0,35,0,37,"2013"
"22326","522119 TEREZOPOLIS DE GOIAS",0,0,2,109,0,111,"2013"
"22327","522130 TRES RANCHOS",0,0,0,35,1,36,"2013"
"22328","522140 TRINDADE",5,3,24,1583,13,1628,"2013"
"22329","522145 TROMBAS",0,0,2,21,1,24,"2013"
"22330","522150 TURVANIA",0,0,1,58,0,59,"2013"
"22331","522155 TURVELANDIA",0,0,0,68,0,68,"2013"
"22332","522157 UIRAPURU",0,0,0,19,0,19,"2013"
"22333","522160 URUACU",4,11,82,432,1,530,"2013"
"22334","522170 URUANA",2,0,4,140,0,146,"2013"
"22335","522180 URUTAI",0,0,0,33,0,33,"2013"
"22336","522185 VALPARAISO DE GOIAS",5,12,22,2372,29,2440,"2013"
"22337","522190 VARJAO",0,0,1,44,1,46,"2013"
"22338","522200 VIANOPOLIS",1,1,1,160,1,164,"2013"
"22339","522205 VICENTINOPOLIS",1,1,0,106,0,108,"2013"
"22340","522220 VILA BOA",0,1,0,73,1,75,"2013"
"22341","522230 VILA PROPICIO",0,0,2,64,0,66,"2013"
"22342","530010 BRASILIA",138,156,713,43048,475,44530,"2013"
"22343","TOTAL",8341,12599,47847,2830725,79747,2979259,"2014"
"22344","MUNICIPIO IGNORADO - RO",0,0,0,4,0,4,"2014"
"22345","110001 ALTA FLORESTA D'OESTE",0,4,1,334,2,341,"2014"
"22346","110002 ARIQUEMES",4,3,15,1621,4,1647,"2014"
"22347","110003 CABIXI",0,0,3,72,0,75,"2014"
"22348","110004 CACOAL",0,7,13,1287,0,1307,"2014"
"22349","110005 CEREJEIRAS",0,1,6,243,0,250,"2014"
"22350","110006 COLORADO DO OESTE",0,0,3,269,1,273,"2014"
"22351","110007 CORUMBIARA",0,1,1,122,1,125,"2014"
"22352","110008 COSTA MARQUES",0,0,11,255,1,267,"2014"
"22353","110009 ESPIGAO D'OESTE",1,0,4,490,1,496,"2014"
"22354","110010 GUAJARA-MIRIM",1,3,14,905,0,923,"2014"
"22355","110011 JARU",0,1,5,860,1,867,"2014"
"22356","110012 JI-PARANA",2,8,14,1931,1,1956,"2014"
"22357","110013 MACHADINHO D'OESTE",0,0,8,499,0,507,"2014"
"22358","110014 NOVA BRASILANDIA D'OESTE",1,0,18,235,0,254,"2014"
"22359","110015 OURO PRETO DO OESTE",1,2,9,662,0,674,"2014"
"22360","110018 PIMENTA BUENO",1,2,9,585,0,597,"2014"
"22361","110020 PORTO VELHO",10,18,100,8892,110,9130,"2014"
"22362","110025 PRESIDENTE MEDICI",0,1,3,285,0,289,"2014"
"22363","110026 RIO CRESPO",0,0,3,33,0,36,"2014"
"22364","110028 ROLIM DE MOURA",0,2,7,937,1,947,"2014"
"22365","110029 SANTA LUZIA D'OESTE",1,0,1,101,0,103,"2014"
"22366","110030 VILHENA",3,3,10,1392,10,1418,"2014"
"22367","110032 SAO MIGUEL DO GUAPORE",0,1,11,352,0,364,"2014"
"22368","110033 NOVA MAMORE",1,1,5,414,4,425,"2014"
"22369","110034 ALVORADA D'OESTE",0,0,1,182,1,184,"2014"
"22370","110037 ALTO ALEGRE DOS PARECIS",0,1,5,166,0,172,"2014"
"22371","110040 ALTO PARAISO",0,2,4,248,0,254,"2014"
"22372","110045 BURITIS",0,1,10,607,2,620,"2014"
"22373","110050 NOVO HORIZONTE DO OESTE",1,1,1,90,0,93,"2014"
"22374","110060 CACAULANDIA",0,0,3,55,0,58,"2014"
"22375","110070 CAMPO NOVO DE RONDONIA",1,1,1,177,1,181,"2014"
"22376","110080 CANDEIAS DO JAMARI",0,0,4,288,4,296,"2014"
"22377","110090 CASTANHEIRAS",0,1,0,45,0,46,"2014"
"22378","110092 CHUPINGUAIA",0,1,1,154,2,158,"2014"
"22379","110094 CUJUBIM",0,0,2,235,3,240,"2014"
"22380","110100 GOVERNADOR JORGE TEIXEIRA",0,0,1,122,1,124,"2014"
"22381","110110 ITAPUA DO OESTE",0,0,0,97,0,97,"2014"
"22382","110120 MINISTRO ANDREAZZA",0,0,3,103,1,107,"2014"
"22383","110130 MIRANTE DA SERRA",0,0,0,137,0,137,"2014"
"22384","110140 MONTE NEGRO",0,0,6,196,2,204,"2014"
"22385","110143 NOVA UNIAO",0,0,0,110,0,110,"2014"
"22386","110145 PARECIS",0,0,0,49,0,49,"2014"
"22387","110146 PIMENTEIRAS DO OESTE",0,0,0,37,0,37,"2014"
"22388","110147 PRIMAVERA DE RONDONIA",0,0,0,47,0,47,"2014"
"22389","110148 SAO FELIPE D'OESTE",0,0,1,57,1,59,"2014"
"22390","110149 SAO FRANCISCO DO GUAPORE",2,0,4,302,0,308,"2014"
"22391","110150 SERINGUEIRAS",2,1,6,161,0,170,"2014"
"22392","110155 TEIXEIROPOLIS",0,0,0,69,0,69,"2014"
"22393","110160 THEOBROMA",0,0,1,124,0,125,"2014"
"22394","110170 URUPA",1,0,2,119,0,122,"2014"
"22395","110175 VALE DO ANARI",0,0,1,127,0,128,"2014"
"22396","110180 VALE DO PARAISO",0,0,0,90,0,90,"2014"
"22397","120001 ACRELANDIA",3,1,2,247,16,269,"2014"
"22398","120005 ASSIS BRASIL",0,0,2,181,13,196,"2014"
"22399","120010 BRASILEIA",3,7,8,508,21,547,"2014"
"22400","120013 BUJARI",0,0,1,215,26,242,"2014"
"22401","120017 CAPIXABA",0,0,1,199,34,234,"2014"
"22402","120020 CRUZEIRO DO SUL",2,7,15,1706,88,1818,"2014"
"22403","120025 EPITACIOLANDIA",1,1,2,254,4,262,"2014"
"22404","120030 FEIJO",2,2,6,652,167,829,"2014"
"22405","120032 JORDAO",0,2,6,116,158,282,"2014"
"22406","120033 MANCIO LIMA",1,0,5,398,9,413,"2014"
"22407","120034 MANOEL URBANO",1,0,0,235,7,243,"2014"
"22408","120035 MARECHAL THAUMATURGO",1,3,10,306,138,458,"2014"
"22409","120038 PLACIDO DE CASTRO",0,0,3,289,30,322,"2014"
"22410","120039 PORTO WALTER",0,1,6,207,36,250,"2014"
"22411","120040 RIO BRANCO",3,10,95,6309,594,7011,"2014"
"22412","120042 RODRIGUES ALVES",0,1,6,365,22,394,"2014"
"22413","120043 SANTA ROSA DO PURUS",3,0,2,121,59,185,"2014"
"22414","120045 SENADOR GUIOMARD",0,1,7,409,36,453,"2014"
"22415","120050 SENA MADUREIRA",2,1,5,771,48,827,"2014"
"22416","120060 TARAUACA",5,2,20,1086,117,1230,"2014"
"22417","120070 XAPURI",1,1,7,283,14,306,"2014"
"22418","120080 PORTO ACRE",0,1,5,324,38,368,"2014"
"22419","MUNICIPIO IGNORADO - AM",0,0,0,22,1,23,"2014"
"22420","130002 ALVARAES",0,0,4,303,1,308,"2014"
"22421","130006 AMATURA",2,1,0,147,114,264,"2014"
"22422","130008 ANAMA",0,0,5,202,5,212,"2014"
"22423","130010 ANORI",0,0,13,214,40,267,"2014"
"22424","130014 APUI",1,1,8,213,0,223,"2014"
"22425","130020 ATALAIA DO NORTE",2,1,4,253,175,435,"2014"
"22426","130030 AUTAZES",6,6,24,782,137,955,"2014"
"22427","130040 BARCELOS",3,0,6,305,105,419,"2014"
"22428","130050 BARREIRINHA",4,4,7,595,146,756,"2014"
"22429","130060 BENJAMIN CONSTANT",0,4,17,986,70,1077,"2014"
"22430","130063 BERURI",0,1,13,396,78,488,"2014"
"22431","130068 BOA VISTA DO RAMOS",1,1,6,319,1,328,"2014"
"22432","130070 BOCA DO ACRE",1,1,18,700,14,734,"2014"
"22433","130080 BORBA",2,2,9,626,72,711,"2014"
"22434","130083 CAAPIRANGA",1,2,2,173,26,204,"2014"
"22435","130090 CANUTAMA",0,1,4,225,1,231,"2014"
"22436","130100 CARAUARI",29,0,0,350,279,658,"2014"
"22437","130110 CAREIRO",3,2,2,441,26,474,"2014"
"22438","130115 CAREIRO DA VARZEA",0,1,1,161,45,208,"2014"
"22439","130120 COARI",2,3,16,1682,1,1704,"2014"
"22440","130130 CODAJAS",1,2,5,413,5,426,"2014"
"22441","130140 EIRUNEPE",1,2,21,705,123,852,"2014"
"22442","130150 ENVIRA",1,0,1,334,50,386,"2014"
"22443","130160 FONTE BOA",2,2,7,594,1,606,"2014"
"22444","130165 GUAJARA",0,1,4,328,23,356,"2014"
"22445","130170 HUMAITA",2,4,17,944,3,970,"2014"
"22446","130180 IPIXUNA",0,0,1,267,138,406,"2014"
"22447","130185 IRANDUBA",2,5,10,850,6,873,"2014"
"22448","130190 ITACOATIARA",2,2,16,1957,91,2068,"2014"
"22449","130195 ITAMARATI",1,3,2,186,68,260,"2014"
"22450","130200 ITAPIRANGA",0,0,8,143,3,154,"2014"
"22451","130210 JAPURA",0,0,2,142,4,148,"2014"
"22452","130220 JURUA",0,0,1,172,20,193,"2014"
"22453","130230 JUTAI",1,0,0,466,164,631,"2014"
"22454","130240 LABREA",1,6,37,655,16,715,"2014"
"22455","130250 MANACAPURU",10,8,11,2063,38,2130,"2014"
"22456","130255 MANAQUIRI",0,0,2,224,7,233,"2014"
"22457","130260 MANAUS",136,157,326,41806,384,42809,"2014"
"22458","130270 MANICORE",2,2,30,723,146,903,"2014"
"22459","130280 MARAA",1,0,6,349,43,399,"2014"
"22460","130290 MAUES",3,5,17,1053,284,1362,"2014"
"22461","130300 NHAMUNDA",1,0,7,315,34,357,"2014"
"22462","130310 NOVA OLINDA DO NORTE",2,2,15,504,96,619,"2014"
"22463","130320 NOVO AIRAO",0,1,3,289,14,307,"2014"
"22464","130330 NOVO ARIPUANA",0,1,7,313,23,344,"2014"
"22465","130340 PARINTINS",9,8,27,1896,116,2056,"2014"
"22466","130350 PAUINI",0,1,2,358,3,364,"2014"
"22467","130353 PRESIDENTE FIGUEIREDO",2,7,4,569,3,585,"2014"
"22468","130356 RIO PRETO DA EVA",2,2,2,404,2,412,"2014"
"22469","130360 SANTA ISABEL DO RIO NEGRO",0,2,35,112,76,225,"2014"
"22470","130370 SANTO ANTONIO DO ICA",10,0,2,510,130,652,"2014"
"22471","130380 SAO GABRIEL DA CACHOEIRA",11,5,21,688,529,1254,"2014"
"22472","130390 SAO PAULO DE OLIVENCA",0,3,14,474,496,987,"2014"
"22473","130395 SAO SEBASTIAO DO UATUMA",0,1,1,161,0,163,"2014"
"22474","130400 SILVES",0,0,0,172,8,180,"2014"
"22475","130406 TABATINGA",3,6,39,1210,562,1820,"2014"
"22476","130410 TAPAUA",0,0,4,353,34,391,"2014"
"22477","130420 TEFE",12,2,14,1520,41,1589,"2014"
"22478","130423 TONANTINS",3,1,1,318,43,366,"2014"
"22479","130426 UARINI",0,3,19,205,75,302,"2014"
"22480","130430 URUCARA",3,4,12,253,12,284,"2014"
"22481","130440 URUCURITUBA",0,0,3,292,34,329,"2014"
"22482","MUNICIPIO IGNORADO - RR",0,0,1,6,0,7,"2014"
"22483","140002 AMAJARI",4,1,1,172,120,298,"2014"
"22484","140005 ALTO ALEGRE",6,1,5,206,345,563,"2014"
"22485","140010 BOA VISTA",45,17,53,6616,24,6755,"2014"
"22486","140015 BONFIM",5,0,4,272,44,325,"2014"
"22487","140017 CANTA",8,3,3,317,31,362,"2014"
"22488","140020 CARACARAI",1,1,1,338,52,393,"2014"
"22489","140023 CAROEBE",0,0,1,144,9,154,"2014"
"22490","140028 IRACEMA",1,0,1,114,40,156,"2014"
"22491","140030 MUCAJAI",5,2,1,279,12,299,"2014"
"22492","140040 NORMANDIA",5,0,2,277,92,376,"2014"
"22493","140045 PACARAIMA",1,1,3,298,37,340,"2014"
"22494","140047 RORAINOPOLIS",4,2,5,423,8,442,"2014"
"22495","140050 SAO JOAO DA BALIZA",0,0,2,113,2,117,"2014"
"22496","140060 SAO LUIZ",1,0,1,63,2,67,"2014"
"22497","140070 UIRAMUTA",11,1,3,275,176,466,"2014"
"22498","MUNICIPIO IGNORADO - PA",0,0,0,2,0,2,"2014"
"22499","150010 ABAETETUBA",9,14,27,2639,16,2705,"2014"
"22500","150013 ABEL FIGUEIREDO",0,0,2,98,0,100,"2014"
"22501","150020 ACARA",4,3,13,1046,50,1116,"2014"
"22502","150030 AFUA",2,5,15,780,4,806,"2014"
"22503","150034 AGUA AZUL DO NORTE",0,0,2,180,0,182,"2014"
"22504","150040 ALENQUER",6,2,4,1091,30,1133,"2014"
"22505","150050 ALMEIRIM",3,11,23,739,25,801,"2014"
"22506","150060 ALTAMIRA",21,11,32,2743,59,2866,"2014"
"22507","150070 ANAJAS",4,12,49,586,86,737,"2014"
"22508","150080 ANANINDEUA",20,26,70,8140,26,8282,"2014"
"22509","150085 ANAPU",3,3,8,526,2,542,"2014"
"22510","150090 AUGUSTO CORREA",2,5,13,832,138,990,"2014"
"22511","150095 AURORA DO PARA",1,2,12,457,0,472,"2014"
"22512","150100 AVEIRO",0,2,2,162,28,194,"2014"
"22513","150110 BAGRE",0,8,12,306,222,548,"2014"
"22514","150120 BAIAO",2,3,14,527,32,578,"2014"
"22515","150125 BANNACH",1,0,0,46,1,48,"2014"
"22516","150130 BARCARENA",3,2,44,2044,12,2105,"2014"
"22517","150140 BELEM",57,64,202,21126,81,21530,"2014"
"22518","150145 BELTERRA",1,2,17,219,1,240,"2014"
"22519","150150 BENEVIDES",1,10,19,1045,4,1079,"2014"
"22520","150157 BOM JESUS DO TOCANTINS",0,2,5,195,1,203,"2014"
"22521","150160 BONITO",0,2,3,206,4,215,"2014"
"22522","150170 BRAGANCA",6,13,30,2227,76,2352,"2014"
"22523","150172 BRASIL NOVO",2,2,7,277,2,290,"2014"
"22524","150175 BREJO GRANDE DO ARAGUAIA",0,2,1,86,3,92,"2014"
"22525","150178 BREU BRANCO",5,2,25,745,74,851,"2014"
"22526","150180 BREVES",15,22,89,2638,10,2774,"2014"
"22527","150190 BUJARU",3,2,18,431,47,501,"2014"
"22528","150195 CACHOEIRA DO PIRIA",0,0,2,259,52,313,"2014"
"22529","150200 CACHOEIRA DO ARARI",1,1,8,288,3,301,"2014"
"22530","150210 CAMETA",3,9,67,2238,194,2511,"2014"
"22531","150215 CANAA DOS CARAJAS",7,4,28,1083,2,1124,"2014"
"22532","150220 CAPANEMA",5,1,16,1063,10,1095,"2014"
"22533","150230 CAPITAO POCO",13,0,7,827,5,852,"2014"
"22534","150240 CASTANHAL",3,9,32,3170,4,3218,"2014"
"22535","150250 CHAVES",0,1,5,319,17,342,"2014"
"22536","150260 COLARES",0,2,0,159,21,182,"2014"
"22537","150270 CONCEICAO DO ARAGUAIA",4,5,11,785,0,805,"2014"
"22538","150275 CONCORDIA DO PARA",2,3,15,480,5,505,"2014"
"22539","150276 CUMARU DO NORTE",0,0,1,133,3,137,"2014"
"22540","150277 CURIONOPOLIS",0,3,5,391,0,399,"2014"
"22541","150280 CURRALINHO",4,7,11,457,166,645,"2014"
"22542","150285 CURUA",0,0,3,158,86,247,"2014"
"22543","150290 CURUCA",0,2,2,512,14,530,"2014"
"22544","150293 DOM ELISEU",1,2,18,681,3,705,"2014"
"22545","150295 ELDORADO DOS CARAJAS",1,0,9,535,2,547,"2014"
"22546","150300 FARO",2,2,1,153,16,174,"2014"
"22547","150304 FLORESTA DO ARAGUAIA",0,0,5,290,1,296,"2014"
"22548","150307 GARRAFAO DO NORTE",9,0,4,441,54,508,"2014"
"22549","150309 GOIANESIA DO PARA",3,6,20,492,15,536,"2014"
"22550","150310 GURUPA",2,6,12,614,96,730,"2014"
"22551","150320 IGARAPE-ACU",1,4,12,588,5,610,"2014"
"22552","150330 IGARAPE-MIRI",3,8,36,1046,73,1166,"2014"
"22553","150340 INHANGAPI",0,0,2,164,0,166,"2014"
"22554","150345 IPIXUNA DO PARA",3,4,25,517,27,576,"2014"
"22555","150350 IRITUIA",0,1,1,430,30,462,"2014"
"22556","150360 ITAITUBA",1,7,33,2123,3,2167,"2014"
"22557","150370 ITUPIRANGA",0,2,5,835,24,866,"2014"
"22558","150375 JACAREACANGA",1,1,4,321,240,567,"2014"
"22559","150380 JACUNDA",6,1,10,883,19,919,"2014"
"22560","150390 JURUTI",1,9,37,973,53,1073,"2014"
"22561","150400 LIMOEIRO DO AJURU",0,6,24,378,36,444,"2014"
"22562","150405 MAE DO RIO",0,4,8,608,1,621,"2014"
"22563","150410 MAGALHAES BARATA",0,0,1,112,4,117,"2014"
"22564","150420 MARABA",8,11,54,4987,68,5128,"2014"
"22565","150430 MARACANA",1,0,2,399,19,421,"2014"
"22566","150440 MARAPANIM",1,2,3,359,4,369,"2014"
"22567","150442 MARITUBA",3,5,25,1814,6,1853,"2014"
"22568","150445 MEDICILANDIA",3,1,5,423,0,432,"2014"
"22569","150450 MELGACO",3,4,18,366,211,602,"2014"
"22570","150460 MOCAJUBA",1,1,4,499,11,516,"2014"
"22571","150470 MOJU",10,10,26,1130,41,1217,"2014"
"22572","150475 MOJUI DOS CAMPOS",0,2,5,159,2,168,"2014"
"22573","150480 MONTE ALEGRE",2,14,82,995,1,1094,"2014"
"22574","150490 MUANA",5,4,15,585,1,610,"2014"
"22575","150495 NOVA ESPERANCA DO PIRIA",2,1,6,369,23,401,"2014"
"22576","150497 NOVA IPIXUNA",2,0,3,205,5,215,"2014"
"22577","150500 NOVA TIMBOTEUA",0,0,3,165,3,171,"2014"
"22578","150503 NOVO PROGRESSO",1,1,13,557,5,577,"2014"
"22579","150506 NOVO REPARTIMENTO",2,1,4,1246,7,1260,"2014"
"22580","150510 OBIDOS",0,2,18,906,122,1048,"2014"
"22581","150520 OEIRAS DO PARA",5,2,14,606,75,702,"2014"
"22582","150530 ORIXIMINA",4,19,37,1371,51,1482,"2014"
"22583","150540 OUREM",3,3,0,250,12,268,"2014"
"22584","150543 OURILANDIA DO NORTE",0,1,1,666,0,668,"2014"
"22585","150548 PACAJA",1,1,7,611,5,625,"2014"
"22586","150549 PALESTINA DO PARA",0,0,3,93,4,100,"2014"
"22587","150550 PARAGOMINAS",6,10,23,2013,17,2069,"2014"
"22588","150553 PARAUAPEBAS",8,21,71,5251,9,5360,"2014"
"22589","150555 PAU D'ARCO",1,4,1,131,0,137,"2014"
"22590","150560 PEIXE-BOI",0,1,1,117,0,119,"2014"
"22591","150563 PICARRA",1,1,3,147,2,154,"2014"
"22592","150565 PLACAS",0,0,9,289,1,299,"2014"
"22593","150570 PONTA DE PEDRAS",1,0,0,329,2,332,"2014"
"22594","150580 PORTEL",2,8,16,1106,348,1480,"2014"
"22595","150590 PORTO DE MOZ",1,5,10,622,37,675,"2014"
"22596","150600 PRAINHA",3,5,19,507,121,655,"2014"
"22597","150610 PRIMAVERA",1,0,4,157,31,193,"2014"
"22598","150611 QUATIPURU",0,0,2,168,3,173,"2014"
"22599","150613 REDENCAO",8,8,14,1620,1,1651,"2014"
"22600","150616 RIO MARIA",1,0,3,304,0,308,"2014"
"22601","150618 RONDON DO PARA",3,3,23,642,1,672,"2014"
"22602","150619 RUROPOLIS",4,4,14,351,0,373,"2014"
"22603","150620 SALINOPOLIS",1,2,5,726,2,736,"2014"
"22604","150630 SALVATERRA",2,3,10,332,2,349,"2014"
"22605","150635 SANTA BARBARA DO PARA",0,1,4,333,3,341,"2014"
"22606","150640 SANTA CRUZ DO ARARI",1,0,0,78,9,88,"2014"
"22607","150650 SANTA IZABEL DO PARA",2,7,10,955,4,978,"2014"
"22608","150655 SANTA LUZIA DO PARA",0,0,8,315,15,338,"2014"
"22609","150658 SANTA MARIA DAS BARREIRAS",0,2,4,175,0,181,"2014"
"22610","150660 SANTA MARIA DO PARA",1,3,2,366,1,373,"2014"
"22611","150670 SANTANA DO ARAGUAIA",1,6,11,551,1,570,"2014"
"22612","150680 SANTAREM",23,39,169,5853,511,6595,"2014"
"22613","150690 SANTAREM NOVO",0,0,1,108,3,112,"2014"
"22614","150700 SANTO ANTONIO DO TAUA",0,1,4,452,20,477,"2014"
"22615","150710 SAO CAETANO DE ODIVELAS",0,1,2,210,9,222,"2014"
"22616","150715 SAO DOMINGOS DO ARAGUAIA",0,1,3,366,0,370,"2014"
"22617","150720 SAO DOMINGOS DO CAPIM",1,4,6,550,18,579,"2014"
"22618","150730 SAO FELIX DO XINGU",1,3,13,894,4,915,"2014"
"22619","150740 SAO FRANCISCO DO PARA",0,0,4,219,0,223,"2014"
"22620","150745 SAO GERALDO DO ARAGUAIA",0,0,5,428,3,436,"2014"
"22621","150746 SAO JOAO DA PONTA",0,1,1,77,3,82,"2014"
"22622","150747 SAO JOAO DE PIRABAS",3,1,3,320,9,336,"2014"
"22623","150750 SAO JOAO DO ARAGUAIA",0,2,0,161,2,165,"2014"
"22624","150760 SAO MIGUEL DO GUAMA",6,1,8,971,20,1006,"2014"
"22625","150770 SAO SEBASTIAO DA BOA VISTA",0,4,50,476,1,531,"2014"
"22626","150775 SAPUCAIA",0,0,1,79,2,82,"2014"
"22627","150780 SENADOR JOSE PORFIRIO",2,1,7,258,3,271,"2014"
"22628","150790 SOURE",4,2,2,419,1,428,"2014"
"22629","150795 TAILANDIA",9,9,23,1474,22,1537,"2014"
"22630","150796 TERRA ALTA",2,1,4,167,2,176,"2014"
"22631","150797 TERRA SANTA",0,11,10,291,2,314,"2014"
"22632","150800 TOME-ACU",1,4,12,1389,9,1415,"2014"
"22633","150803 TRACUATEUA",1,5,10,535,16,567,"2014"
"22634","150805 TRAIRAO",0,0,6,213,4,223,"2014"
"22635","150808 TUCUMA",0,8,17,636,1,662,"2014"
"22636","150810 TUCURUI",5,5,19,1883,254,2166,"2014"
"22637","150812 ULIANOPOLIS",2,5,8,446,0,461,"2014"
"22638","150815 URUARA",5,3,15,767,3,793,"2014"
"22639","150820 VIGIA",0,3,13,729,4,749,"2014"
"22640","150830 VISEU",4,3,8,858,342,1215,"2014"
"22641","150835 VITORIA DO XINGU",0,3,4,249,1,257,"2014"
"22642","150840 XINGUARA",2,6,10,797,2,817,"2014"
"22643","160005 SERRA DO NAVIO",1,0,1,71,0,73,"2014"
"22644","160010 AMAPA",0,0,4,130,7,141,"2014"
"22645","160015 PEDRA BRANCA DO AMAPARI",0,1,4,233,36,274,"2014"
"22646","160020 CALCOENE",0,2,2,177,13,194,"2014"
"22647","160021 CUTIAS",0,0,1,78,2,81,"2014"
"22648","160023 FERREIRA GOMES",1,0,0,183,3,187,"2014"
"22649","160025 ITAUBAL",0,2,2,102,15,121,"2014"
"22650","160027 LARANJAL DO JARI",2,6,24,962,2,996,"2014"
"22651","160030 MACAPA",28,32,111,9500,128,9799,"2014"
"22652","160040 MAZAGAO",5,1,7,367,52,432,"2014"
"22653","160050 OIAPOQUE",2,3,10,465,49,529,"2014"
"22654","160053 PORTO GRANDE",1,1,8,412,5,427,"2014"
"22655","160055 PRACUUBA",0,0,2,43,27,72,"2014"
"22656","160060 SANTANA",9,10,45,2313,1,2378,"2014"
"22657","160070 TARTARUGALZINHO",0,1,8,196,88,293,"2014"
"22658","160080 VITORIA DO JARI",2,2,4,264,2,274,"2014"
"22659","MUNICIPIO IGNORADO - TO",0,0,1,4,0,5,"2014"
"22660","170025 ABREULANDIA",0,0,1,40,0,41,"2014"
"22661","170030 AGUIARNOPOLIS",0,0,1,78,1,80,"2014"
"22662","170035 ALIANCA DO TOCANTINS",0,0,0,78,0,78,"2014"
"22663","170040 ALMAS",0,0,3,124,1,128,"2014"
"22664","170070 ALVORADA",0,1,3,121,0,125,"2014"
"22665","170100 ANANAS",0,2,2,154,5,163,"2014"
"22666","170105 ANGICO",0,1,0,38,1,40,"2014"
"22667","170110 APARECIDA DO RIO NEGRO",0,0,1,70,0,71,"2014"
"22668","170130 ARAGOMINAS",0,0,0,55,1,56,"2014"
"22669","170190 ARAGUACEMA",0,0,1,67,0,68,"2014"
"22670","170200 ARAGUACU",0,0,2,102,0,104,"2014"
"22671","170210 ARAGUAINA",7,15,56,3083,39,3200,"2014"
"22672","170215 ARAGUANA",0,0,1,77,3,81,"2014"
"22673","170220 ARAGUATINS",0,0,11,565,71,647,"2014"
"22674","170230 ARAPOEMA",0,0,1,93,0,94,"2014"
"22675","170240 ARRAIAS",0,1,4,163,0,168,"2014"
"22676","170255 AUGUSTINOPOLIS",2,1,2,304,29,338,"2014"
"22677","170270 AURORA DO TOCANTINS",0,0,2,30,0,32,"2014"
"22678","170290 AXIXA DO TOCANTINS",0,1,5,164,17,187,"2014"
"22679","170300 BABACULANDIA",0,0,1,106,3,110,"2014"
"22680","170305 BANDEIRANTES DO TOCANTINS",2,0,0,43,1,46,"2014"
"22681","170307 BARRA DO OURO",0,1,0,81,3,85,"2014"
"22682","170310 BARROLANDIA",0,0,1,82,0,83,"2014"
"22683","170320 BERNARDO SAYAO",0,0,0,59,1,60,"2014"
"22684","170330 BOM JESUS DO TOCANTINS",0,0,1,76,0,77,"2014"
"22685","170360 BRASILANDIA DO TOCANTINS",0,0,0,33,0,33,"2014"
"22686","170370 BREJINHO DE NAZARE",0,0,1,87,1,89,"2014"
"22687","170380 BURITI DO TOCANTINS",0,0,0,132,18,150,"2014"
"22688","170382 CACHOEIRINHA",0,0,0,41,4,45,"2014"
"22689","170384 CAMPOS LINDOS",2,0,4,127,33,166,"2014"
"22690","170386 CARIRI DO TOCANTINS",0,1,0,32,0,33,"2014"
"22691","170388 CARMOLANDIA",0,0,3,47,1,51,"2014"
"22692","170389 CARRASCO BONITO",0,0,3,54,8,65,"2014"
"22693","170390 CASEARA",0,0,0,64,1,65,"2014"
"22694","170410 CENTENARIO",0,0,0,30,0,30,"2014"
"22695","170460 CHAPADA DE AREIA",0,0,0,21,0,21,"2014"
"22696","170510 CHAPADA DA NATIVIDADE",0,0,0,41,0,41,"2014"
"22697","170550 COLINAS DO TOCANTINS",0,3,12,539,10,564,"2014"
"22698","170555 COMBINADO",0,0,0,56,0,56,"2014"
"22699","170560 CONCEICAO DO TOCANTINS",0,1,3,57,3,64,"2014"
"22700","170600 COUTO MAGALHAES",0,0,2,81,1,84,"2014"
"22701","170610 CRISTALANDIA",0,0,0,100,2,102,"2014"
"22702","170625 CRIXAS DO TOCANTINS",0,0,0,21,0,21,"2014"
"22703","170650 DARCINOPOLIS",1,0,1,103,1,106,"2014"
"22704","170700 DIANOPOLIS",2,3,10,305,0,320,"2014"
"22705","170710 DIVINOPOLIS DO TOCANTINS",2,1,0,94,1,98,"2014"
"22706","170720 DOIS IRMAOS DO TOCANTINS",0,0,2,68,0,70,"2014"
"22707","170730 DUERE",0,0,3,57,0,60,"2014"
"22708","170740 ESPERANTINA",0,1,4,121,12,138,"2014"
"22709","170755 FATIMA",0,0,0,58,0,58,"2014"
"22710","170765 FIGUEIROPOLIS",1,1,2,73,2,79,"2014"
"22711","170770 FILADELFIA",2,0,0,114,2,118,"2014"
"22712","170820 FORMOSO DO ARAGUAIA",1,1,5,292,1,300,"2014"
"22713","170825 FORTALEZA DO TABOCAO",1,0,0,54,0,55,"2014"
"22714","170830 GOIANORTE",0,1,2,48,0,51,"2014"
"22715","170900 GOIATINS",0,2,6,257,7,272,"2014"
"22716","170930 GUARAI",2,1,2,378,0,383,"2014"
"22717","170950 GURUPI",15,3,21,1332,2,1373,"2014"
"22718","170980 IPUEIRAS",0,0,1,21,1,23,"2014"
"22719","171050 ITACAJA",0,1,4,136,9,150,"2014"
"22720","171070 ITAGUATINS",0,0,1,69,9,79,"2014"
"22721","171090 ITAPIRATINS",0,1,1,41,0,43,"2014"
"22722","171110 ITAPORA DO TOCANTINS",0,0,0,39,0,39,"2014"
"22723","171150 JAU DO TOCANTINS",1,1,1,29,0,32,"2014"
"22724","171180 JUARINA",0,0,2,31,1,34,"2014"
"22725","171190 LAGOA DA CONFUSAO",2,0,1,208,4,215,"2014"
"22726","171195 LAGOA DO TOCANTINS",0,0,0,55,3,58,"2014"
"22727","171200 LAJEADO",0,1,0,57,0,58,"2014"
"22728","171215 LAVANDEIRA",0,0,0,20,1,21,"2014"
"22729","171240 LIZARDA",0,0,1,43,3,47,"2014"
"22730","171245 LUZINOPOLIS",0,0,1,37,2,40,"2014"
"22731","171250 MARIANOPOLIS DO TOCANTINS",0,0,1,49,0,50,"2014"
"22732","171270 MATEIROS",0,1,0,40,1,42,"2014"
"22733","171280 MAURILANDIA DO TOCANTINS",0,0,0,36,2,38,"2014"
"22734","171320 MIRACEMA DO TOCANTINS",0,1,1,302,0,304,"2014"
"22735","171330 MIRANORTE",0,0,2,172,0,174,"2014"
"22736","171360 MONTE DO CARMO",0,0,1,83,0,84,"2014"
"22737","171370 MONTE SANTO DO TOCANTINS",1,0,0,40,0,41,"2014"
"22738","171380 PALMEIRAS DO TOCANTINS",0,0,1,65,1,67,"2014"
"22739","171395 MURICILANDIA",0,0,2,45,1,48,"2014"
"22740","171420 NATIVIDADE",0,0,4,101,0,105,"2014"
"22741","171430 NAZARE",0,0,0,54,1,55,"2014"
"22742","171488 NOVA OLINDA",0,3,4,186,2,195,"2014"
"22743","171500 NOVA ROSALANDIA",0,0,0,68,0,68,"2014"
"22744","171510 NOVO ACORDO",0,0,0,60,3,63,"2014"
"22745","171515 NOVO ALEGRE",0,0,1,18,0,19,"2014"
"22746","171525 NOVO JARDIM",1,1,1,30,0,33,"2014"
"22747","171550 OLIVEIRA DE FATIMA",0,0,0,21,0,21,"2014"
"22748","171570 PALMEIRANTE",0,0,0,47,3,50,"2014"
"22749","171575 PALMEIROPOLIS",2,0,1,69,1,73,"2014"
"22750","171610 PARAISO DO TOCANTINS",1,1,3,843,1,849,"2014"
"22751","171620 PARANA",0,0,1,137,1,139,"2014"
"22752","171630 PAU D'ARCO",0,0,1,72,2,75,"2014"
"22753","171650 PEDRO AFONSO",1,1,10,246,1,259,"2014"
"22754","171660 PEIXE",3,0,1,122,3,129,"2014"
"22755","171665 PEQUIZEIRO",0,0,1,76,0,77,"2014"
"22756","171670 COLMEIA",0,0,2,130,0,132,"2014"
"22757","171700 PINDORAMA DO TOCANTINS",0,0,2,58,1,61,"2014"
"22758","171720 PIRAQUE",0,0,2,32,1,35,"2014"
"22759","171750 PIUM",0,1,1,97,0,99,"2014"
"22760","171780 PONTE ALTA DO BOM JESUS",0,0,1,52,1,54,"2014"
"22761","171790 PONTE ALTA DO TOCANTINS",0,0,1,121,0,122,"2014"
"22762","171800 PORTO ALEGRE DO TOCANTINS",0,0,0,49,0,49,"2014"
"22763","171820 PORTO NACIONAL",2,4,11,1012,3,1032,"2014"
"22764","171830 PRAIA NORTE",0,0,1,107,12,120,"2014"
"22765","171840 PRESIDENTE KENNEDY",0,1,1,50,0,52,"2014"
"22766","171845 PUGMIL",0,0,0,34,0,34,"2014"
"22767","171850 RECURSOLANDIA",0,1,2,53,1,57,"2014"
"22768","171855 RIACHINHO",0,0,0,65,1,66,"2014"
"22769","171865 RIO DA CONCEICAO",0,1,1,38,0,40,"2014"
"22770","171870 RIO DOS BOIS",0,0,2,42,0,44,"2014"
"22771","171875 RIO SONO",0,0,3,47,1,51,"2014"
"22772","171880 SAMPAIO",0,1,2,80,6,89,"2014"
"22773","171884 SANDOLANDIA",1,2,0,49,1,53,"2014"
"22774","171886 SANTA FE DO ARAGUAIA",1,1,2,106,4,114,"2014"
"22775","171888 SANTA MARIA DO TOCANTINS",0,0,1,28,0,29,"2014"
"22776","171889 SANTA RITA DO TOCANTINS",0,1,0,25,0,26,"2014"
"22777","171890 SANTA ROSA DO TOCANTINS",0,0,0,72,1,73,"2014"
"22778","171900 SANTA TEREZA DO TOCANTINS",0,0,0,61,3,64,"2014"
"22779","172000 SANTA TEREZINHA DO TOCANTINS",0,0,0,25,0,25,"2014"
"22780","172010 SAO BENTO DO TOCANTINS",0,0,3,73,7,83,"2014"
"22781","172015 SAO FELIX DO TOCANTINS",0,0,0,21,2,23,"2014"
"22782","172020 SAO MIGUEL DO TOCANTINS",0,0,3,130,1,134,"2014"
"22783","172025 SAO SALVADOR DO TOCANTINS",0,0,0,35,1,36,"2014"
"22784","172030 SAO SEBASTIAO DO TOCANTINS",1,0,1,52,6,60,"2014"
"22785","172049 SAO VALERIO",1,0,0,55,2,58,"2014"
"22786","172065 SILVANOPOLIS",0,0,2,91,1,94,"2014"
"22787","172080 SITIO NOVO DO TOCANTINS",0,0,8,156,1,165,"2014"
"22788","172085 SUCUPIRA",1,0,1,15,0,17,"2014"
"22789","172090 TAGUATINGA",0,0,5,195,0,200,"2014"
"22790","172093 TAIPAS DO TOCANTINS",0,0,0,32,0,32,"2014"
"22791","172097 TALISMA",0,0,0,24,0,24,"2014"
"22792","172100 PALMAS",14,5,66,5052,25,5162,"2014"
"22793","172110 TOCANTINIA",2,0,1,172,3,178,"2014"
"22794","172120 TOCANTINOPOLIS",0,3,4,449,18,474,"2014"
"22795","172125 TUPIRAMA",0,0,0,23,0,23,"2014"
"22796","172130 TUPIRATINS",0,0,0,25,1,26,"2014"
"22797","172208 WANDERLANDIA",1,1,2,147,1,152,"2014"
"22798","172210 XAMBIOA",3,1,6,245,2,257,"2014"
"22799","MUNICIPIO IGNORADO - MA",0,0,0,2,0,2,"2014"
"22800","210005 ACAILANDIA",10,13,49,1902,88,2062,"2014"
"22801","210010 AFONSO CUNHA",0,2,2,107,2,113,"2014"
"22802","210015 AGUA DOCE DO MARANHAO",1,1,2,108,35,147,"2014"
"22803","210020 ALCANTARA",0,2,7,201,33,243,"2014"
"22804","210030 ALDEIAS ALTAS",1,2,5,453,0,461,"2014"
"22805","210040 ALTAMIRA DO MARANHAO",0,0,4,100,0,104,"2014"
"22806","210043 ALTO ALEGRE DO MARANHAO",0,6,10,457,6,479,"2014"
"22807","210047 ALTO ALEGRE DO PINDARE",0,1,6,381,68,456,"2014"
"22808","210050 ALTO PARNAIBA",1,1,3,135,7,147,"2014"
"22809","210055 AMAPA DO MARANHAO",0,1,1,117,5,124,"2014"
"22810","210060 AMARANTE DO MARANHAO",2,1,24,694,63,784,"2014"
"22811","210070 ANAJATUBA",0,4,21,259,74,358,"2014"
"22812","210080 ANAPURUS",1,1,8,277,4,291,"2014"
"22813","210083 APICUM-ACU",1,3,0,28,247,279,"2014"
"22814","210087 ARAGUANA",0,2,10,147,11,170,"2014"
"22815","210090 ARAIOSES",3,5,16,538,23,585,"2014"
"22816","210095 ARAME",0,2,25,549,1,577,"2014"
"22817","210100 ARARI",1,1,20,379,41,442,"2014"
"22818","210110 AXIXA",0,1,3,197,7,208,"2014"
"22819","210120 BACABAL",3,15,48,1689,29,1784,"2014"
"22820","210125 BACABEIRA",0,1,5,248,6,260,"2014"
"22821","210130 BACURI",0,0,0,27,249,276,"2014"
"22822","210135 BACURITUBA",0,0,0,80,5,85,"2014"
"22823","210140 BALSAS",3,0,5,76,2031,2115,"2014"
"22824","210150 BARAO DE GRAJAU",1,1,9,257,2,270,"2014"
"22825","210160 BARRA DO CORDA",3,12,27,1571,37,1650,"2014"
"22826","210170 BARREIRINHAS",1,3,5,1173,82,1264,"2014"
"22827","210173 BELAGUA",0,1,3,48,148,200,"2014"
"22828","210177 BELA VISTA DO MARANHAO",1,3,3,202,0,209,"2014"
"22829","210180 BENEDITO LEITE",0,0,0,31,30,61,"2014"
"22830","210190 BEQUIMAO",0,3,10,115,134,262,"2014"
"22831","210193 BERNARDO DO MEARIM",0,0,1,107,0,108,"2014"
"22832","210197 BOA VISTA DO GURUPI",0,0,3,134,2,139,"2014"
"22833","210200 BOM JARDIM",3,5,10,472,166,656,"2014"
"22834","210203 BOM JESUS DAS SELVAS",2,3,22,504,17,548,"2014"
"22835","210207 BOM LUGAR",0,2,5,162,2,171,"2014"
"22836","210210 BREJO",2,2,6,590,2,602,"2014"
"22837","210215 BREJO DE AREIA",0,1,3,109,4,117,"2014"
"22838","210220 BURITI",2,7,23,614,10,656,"2014"
"22839","210230 BURITI BRAVO",0,2,3,413,4,422,"2014"
"22840","210232 BURITICUPU",7,2,21,1327,23,1380,"2014"
"22841","210235 BURITIRANA",0,1,7,206,6,220,"2014"
"22842","210237 CACHOEIRA GRANDE",0,2,3,152,33,190,"2014"
"22843","210240 CAJAPIO",0,0,0,43,123,166,"2014"
"22844","210250 CAJARI",0,0,1,133,136,270,"2014"
"22845","210255 CAMPESTRE DO MARANHAO",0,3,5,201,3,212,"2014"
"22846","210260 CANDIDO MENDES",0,0,2,298,41,341,"2014"
"22847","210270 CANTANHEDE",0,3,2,176,101,282,"2014"
"22848","210275 CAPINZAL DO NORTE",1,0,2,152,14,169,"2014"
"22849","210280 CAROLINA",0,0,5,310,6,321,"2014"
"22850","210290 CARUTAPERA",0,1,3,496,1,501,"2014"
"22851","210300 CAXIAS",2,11,29,2489,13,2544,"2014"
"22852","210310 CEDRAL",0,0,1,59,61,121,"2014"
"22853","210312 CENTRAL DO MARANHAO",0,1,0,22,101,124,"2014"
"22854","210315 CENTRO DO GUILHERME",1,1,4,180,10,196,"2014"
"22855","210317 CENTRO NOVO DO MARANHAO",0,0,2,277,38,317,"2014"
"22856","210320 CHAPADINHA",4,4,65,1405,20,1498,"2014"
"22857","210325 CIDELANDIA",1,2,4,157,21,185,"2014"
"22858","210330 CODO",19,14,97,2006,61,2197,"2014"
"22859","210340 COELHO NETO",1,10,33,801,6,851,"2014"
"22860","210350 COLINAS",3,1,14,742,9,769,"2014"
"22861","210355 CONCEICAO DO LAGO-ACU",0,3,7,215,46,271,"2014"
"22862","210360 COROATA",2,9,35,1106,31,1183,"2014"
"22863","210370 CURURUPU",0,0,0,122,389,511,"2014"
"22864","210375 DAVINOPOLIS",2,1,15,199,0,217,"2014"
"22865","210380 DOM PEDRO",0,1,8,332,90,431,"2014"
"22866","210390 DUQUE BACELAR",1,3,7,179,12,202,"2014"
"22867","210400 ESPERANTINOPOLIS",0,0,6,279,1,286,"2014"
"22868","210405 ESTREITO",3,6,19,572,2,602,"2014"
"22869","210407 FEIRA NOVA DO MARANHAO",0,0,0,9,95,104,"2014"
"22870","210408 FERNANDO FALCAO",1,1,1,126,37,166,"2014"
"22871","210409 FORMOSA DA SERRA NEGRA",0,0,2,87,220,309,"2014"
"22872","210410 FORTALEZA DOS NOGUEIRAS",0,1,0,191,40,232,"2014"
"22873","210420 FORTUNA",1,0,5,272,19,297,"2014"
"22874","210430 GODOFREDO VIANA",0,0,0,143,6,149,"2014"
"22875","210440 GONCALVES DIAS",0,0,1,61,193,255,"2014"
"22876","210450 GOVERNADOR ARCHER",0,0,0,175,3,178,"2014"
"22877","210455 GOVERNADOR EDISON LOBAO",3,2,7,266,3,281,"2014"
"22878","210460 GOVERNADOR EUGENIO BARROS",0,0,21,195,4,220,"2014"
"22879","210462 GOVERNADOR LUIZ ROCHA",1,2,0,97,0,100,"2014"
"22880","210465 GOVERNADOR NEWTON BELLO",0,1,3,151,2,157,"2014"
"22881","210467 GOVERNADOR NUNES FREIRE",4,1,5,532,12,554,"2014"
"22882","210470 GRACA ARANHA",0,0,1,67,0,68,"2014"
"22883","210480 GRAJAU",2,6,39,1610,58,1715,"2014"
"22884","210490 GUIMARAES",0,0,0,23,131,154,"2014"
"22885","210500 HUMBERTO DE CAMPOS",1,3,2,383,120,509,"2014"
"22886","210510 ICATU",1,3,11,325,55,395,"2014"
"22887","210515 IGARAPE DO MEIO",0,1,3,202,10,216,"2014"
"22888","210520 IGARAPE GRANDE",0,1,2,153,1,157,"2014"
"22889","210530 IMPERATRIZ",15,18,144,4976,45,5198,"2014"
"22890","210535 ITAIPAVA DO GRAJAU",0,2,8,221,13,244,"2014"
"22891","210540 ITAPECURU MIRIM",0,1,4,100,1201,1306,"2014"
"22892","210542 ITINGA DO MARANHAO",2,3,12,302,1,320,"2014"
"22893","210545 JATOBA",0,0,5,138,2,145,"2014"
"22894","210547 JENIPAPO DOS VIEIRAS",0,0,4,248,32,284,"2014"
"22895","210550 JOAO LISBOA",1,3,17,436,3,460,"2014"
"22896","210560 JOSELANDIA",0,0,4,248,2,254,"2014"
"22897","210565 JUNCO DO MARANHAO",0,2,1,118,5,126,"2014"
"22898","210570 LAGO DA PEDRA",5,3,10,879,1,898,"2014"
"22899","210580 LAGO DO JUNCO",0,5,3,163,1,172,"2014"
"22900","210590 LAGO VERDE",0,3,17,274,1,295,"2014"
"22901","210592 LAGOA DO MATO",1,2,0,129,4,136,"2014"
"22902","210594 LAGO DOS RODRIGUES",2,2,1,126,0,131,"2014"
"22903","210596 LAGOA GRANDE DO MARANHAO",0,1,2,159,20,182,"2014"
"22904","210598 LAJEADO NOVO",0,1,0,104,0,105,"2014"
"22905","210600 LIMA CAMPOS",1,0,7,196,0,204,"2014"
"22906","210610 LORETO",0,0,0,3,157,160,"2014"
"22907","210620 LUIS DOMINGUES",0,0,0,93,22,115,"2014"
"22908","210630 MAGALHAES DE ALMEIDA",3,1,4,216,4,228,"2014"
"22909","210632 MARACACUME",2,0,10,352,5,369,"2014"
"22910","210635 MARAJA DO SENA",0,2,0,103,8,113,"2014"
"22911","210637 MARANHAOZINHO",2,1,0,185,15,203,"2014"
"22912","210640 MATA ROMA",0,1,6,280,20,307,"2014"
"22913","210650 MATINHA",1,0,0,68,332,401,"2014"
"22914","210660 MATOES",1,3,6,351,109,470,"2014"
"22915","210663 MATOES DO NORTE",0,0,1,57,69,127,"2014"
"22916","210667 MILAGRES DO MARANHAO",0,0,1,93,0,94,"2014"
"22917","210670 MIRADOR",0,1,5,351,9,366,"2014"
"22918","210675 MIRANDA DO NORTE",0,2,7,254,64,327,"2014"
"22919","210680 MIRINZAL",1,0,1,19,176,197,"2014"
"22920","210690 MONCAO",1,4,7,576,47,635,"2014"
"22921","210700 MONTES ALTOS",1,0,4,142,6,153,"2014"
"22922","210710 MORROS",0,1,8,282,52,343,"2014"
"22923","210720 NINA RODRIGUES",0,2,3,93,120,218,"2014"
"22924","210725 NOVA COLINAS",0,0,1,65,12,78,"2014"
"22925","210730 NOVA IORQUE",0,0,0,24,39,63,"2014"
"22926","210735 NOVA OLINDA DO MARANHAO",2,2,14,270,6,294,"2014"
"22927","210740 OLHO D'AGUA DAS CUNHAS",3,3,5,159,98,268,"2014"
"22928","210745 OLINDA NOVA DO MARANHAO",0,0,3,14,192,209,"2014"
"22929","210750 PACO DO LUMIAR",7,5,32,1614,24,1682,"2014"
"22930","210760 PALMEIRANDIA",2,1,5,208,72,288,"2014"
"22931","210770 PARAIBANO",2,5,11,329,3,350,"2014"
"22932","210780 PARNARAMA",2,3,8,379,101,493,"2014"
"22933","210790 PASSAGEM FRANCA",0,0,2,351,0,353,"2014"
"22934","210800 PASTOS BONS",1,0,4,49,275,329,"2014"
"22935","210805 PAULINO NEVES",15,5,13,238,21,292,"2014"
"22936","210810 PAULO RAMOS",0,0,11,402,5,418,"2014"
"22937","210820 PEDREIRAS",1,2,6,684,0,693,"2014"
"22938","210825 PEDRO DO ROSARIO",0,2,19,165,101,287,"2014"
"22939","210830 PENALVA",3,2,8,567,71,651,"2014"
"22940","210840 PERI MIRIM",1,1,6,115,12,135,"2014"
"22941","210845 PERITORO",0,2,11,428,2,443,"2014"
"22942","210850 PINDARE-MIRIM",3,4,7,584,7,605,"2014"
"22943","210860 PINHEIRO",1,12,54,1299,76,1442,"2014"
"22944","210870 PIO XII",0,4,2,489,9,504,"2014"
"22945","210880 PIRAPEMAS",1,0,4,235,29,269,"2014"
"22946","210890 POCAO DE PEDRAS",0,0,2,267,0,269,"2014"
"22947","210900 PORTO FRANCO",1,3,5,422,0,431,"2014"
"22948","210905 PORTO RICO DO MARANHAO",1,0,0,57,15,73,"2014"
"22949","210910 PRESIDENTE DUTRA",3,4,8,845,1,861,"2014"
"22950","210920 PRESIDENTE JUSCELINO",0,2,5,148,30,185,"2014"
"22951","210923 PRESIDENTE MEDICI",0,0,2,112,4,118,"2014"
"22952","210927 PRESIDENTE SARNEY",1,4,11,266,92,374,"2014"
"22953","210930 PRESIDENTE VARGAS",1,0,7,110,95,213,"2014"
"22954","210940 PRIMEIRA CRUZ",0,0,0,152,34,186,"2014"
"22955","210945 RAPOSA",1,8,6,540,10,565,"2014"
"22956","210950 RIACHAO",6,4,6,304,39,359,"2014"
"22957","210955 RIBAMAR FIQUENE",0,0,3,135,2,140,"2014"
"22958","210960 ROSARIO",1,4,15,582,19,621,"2014"
"22959","210970 SAMBAIBA",0,0,0,22,40,62,"2014"
"22960","210975 SANTA FILOMENA DO MARANHAO",0,0,1,62,1,64,"2014"
"22961","210980 SANTA HELENA",3,4,8,456,152,623,"2014"
"22962","210990 SANTA INES",8,10,25,1496,2,1541,"2014"
"22963","211000 SANTA LUZIA",0,5,34,1183,95,1317,"2014"
"22964","211003 SANTA LUZIA DO PARUA",0,3,2,389,7,401,"2014"
"22965","211010 SANTA QUITERIA DO MARANHAO",1,1,4,489,8,503,"2014"
"22966","211020 SANTA RITA",2,6,54,579,19,660,"2014"
"22967","211023 SANTANA DO MARANHAO",0,0,1,121,23,145,"2014"
"22968","211027 SANTO AMARO DO MARANHAO",1,2,2,112,43,160,"2014"
"22969","211030 SANTO ANTONIO DOS LOPES",2,2,0,59,184,247,"2014"
"22970","211040 SAO BENEDITO DO RIO PRETO",3,1,9,61,333,407,"2014"
"22971","211050 SAO BENTO",3,0,1,524,17,545,"2014"
"22972","211060 SAO BERNARDO",2,1,17,455,4,479,"2014"
"22973","211065 SAO DOMINGOS DO AZEITAO",0,0,1,20,126,147,"2014"
"22974","211070 SAO DOMINGOS DO MARANHAO",1,3,11,670,11,696,"2014"
"22975","211080 SAO FELIX DE BALSAS",0,0,0,1,53,54,"2014"
"22976","211085 SAO FRANCISCO DO BREJAO",0,1,5,111,7,124,"2014"
"22977","211090 SAO FRANCISCO DO MARANHAO",1,1,4,126,8,140,"2014"
"22978","211100 SAO JOAO BATISTA",0,2,68,187,16,273,"2014"
"22979","211102 SAO JOAO DO CARU",0,10,12,188,5,215,"2014"
"22980","211105 SAO JOAO DO PARAISO",0,1,0,137,1,139,"2014"
"22981","211107 SAO JOAO DO SOTER",1,1,4,310,5,321,"2014"
"22982","211110 SAO JOAO DOS PATOS",1,0,2,431,3,437,"2014"
"22983","211120 SAO JOSE DE RIBAMAR",14,23,40,3257,54,3388,"2014"
"22984","211125 SAO JOSE DOS BASILIOS",1,0,2,120,6,129,"2014"
"22985","211130 SAO LUIS",73,96,265,15840,262,16536,"2014"
"22986","211140 SAO LUIS GONZAGA DO MARANHAO",1,0,4,305,3,313,"2014"
"22987","211150 SAO MATEUS DO MARANHAO",1,7,6,679,9,702,"2014"
"22988","211153 SAO PEDRO DA AGUA BRANCA",2,3,5,154,3,167,"2014"
"22989","211157 SAO PEDRO DOS CRENTES",0,0,1,48,3,52,"2014"
"22990","211160 SAO RAIMUNDO DAS MANGABEIRAS",0,0,1,6,345,352,"2014"
"22991","211163 SAO RAIMUNDO DO DOCA BEZERRA",0,0,1,100,3,104,"2014"
"22992","211167 SAO ROBERTO",0,1,0,85,0,86,"2014"
"22993","211170 SAO VICENTE FERRER",0,0,7,223,79,309,"2014"
"22994","211172 SATUBINHA",1,1,1,123,3,129,"2014"
"22995","211174 SENADOR ALEXANDRE COSTA",0,0,7,174,3,184,"2014"
"22996","211176 SENADOR LA ROCQUE",4,5,10,294,9,322,"2014"
"22997","211178 SERRANO DO MARANHAO",1,0,0,20,129,150,"2014"
"22998","211180 SITIO NOVO",2,4,9,226,7,248,"2014"
"22999","211190 SUCUPIRA DO NORTE",1,1,4,176,5,187,"2014"
"23000","211195 SUCUPIRA DO RIACHAO",0,2,1,84,0,87,"2014"
"23001","211200 TASSO FRAGOSO",0,1,4,76,74,155,"2014"
"23002","211210 TIMBIRAS",0,4,5,512,15,536,"2014"
"23003","211220 TIMON",9,13,18,2748,17,2805,"2014"
"23004","211223 TRIZIDELA DO VALE",1,1,3,294,0,299,"2014"
"23005","211227 TUFILANDIA",0,0,4,97,2,103,"2014"
"23006","211230 TUNTUM",1,1,5,602,6,615,"2014"
"23007","211240 TURIACU",0,3,1,29,703,736,"2014"
"23008","211245 TURILANDIA",1,2,6,263,116,388,"2014"
"23009","211250 TUTOIA",10,4,16,895,65,990,"2014"
"23010","211260 URBANO SANTOS",0,0,5,142,514,661,"2014"
"23011","211270 VARGEM GRANDE",6,12,27,897,73,1015,"2014"
"23012","211280 VIANA",2,7,18,823,268,1118,"2014"
"23013","211285 VILA NOVA DOS MARTIRIOS",0,1,4,156,0,161,"2014"
"23014","211290 VITORIA DO MEARIM",3,0,6,93,429,531,"2014"
"23015","211300 VITORINO FREIRE",0,0,5,520,4,529,"2014"
"23016","211400 ZE DOCA",2,10,20,749,16,797,"2014"
"23017","220005 ACAUA",1,1,1,70,14,87,"2014"
"23018","220010 AGRICOLANDIA",0,0,1,71,4,76,"2014"
"23019","220020 AGUA BRANCA",0,1,5,265,2,273,"2014"
"23020","220025 ALAGOINHA DO PIAUI",0,1,3,74,0,78,"2014"
"23021","220027 ALEGRETE DO PIAUI",0,0,3,56,0,59,"2014"
"23022","220030 ALTO LONGA",0,0,1,118,7,126,"2014"
"23023","220040 ALTOS",6,1,5,529,47,588,"2014"
"23024","220045 ALVORADA DO GURGUEIA",0,0,0,38,36,74,"2014"
"23025","220050 AMARANTE",1,2,3,245,0,251,"2014"
"23026","220060 ANGICAL DO PIAUI",0,0,0,77,4,81,"2014"
"23027","220070 ANISIO DE ABREU",0,1,2,137,10,150,"2014"
"23028","220080 ANTONIO ALMEIDA",0,0,0,26,24,50,"2014"
"23029","220090 AROAZES",0,0,0,64,3,67,"2014"
"23030","220095 AROEIRAS DO ITAIM",0,0,0,25,0,25,"2014"
"23031","220100 ARRAIAL",0,0,2,47,1,50,"2014"
"23032","220105 ASSUNCAO DO PIAUI",0,1,1,105,24,131,"2014"
"23033","220110 AVELINO LOPES",1,0,0,134,47,182,"2014"
"23034","220115 BAIXA GRANDE DO RIBEIRO",1,2,3,133,81,220,"2014"
"23035","220117 BARRA D'ALCANTARA",0,0,0,50,0,50,"2014"
"23036","220120 BARRAS",107,5,9,569,16,706,"2014"
"23037","220130 BARREIRAS DO PIAUI",0,0,1,12,12,25,"2014"
"23038","220140 BARRO DURO",0,0,1,113,3,117,"2014"
"23039","220150 BATALHA",2,1,4,323,6,336,"2014"
"23040","220155 BELA VISTA DO PIAUI",1,2,4,41,0,48,"2014"
"23041","220157 BELEM DO PIAUI",0,0,7,23,0,30,"2014"
"23042","220160 BENEDITINOS",1,0,2,97,26,126,"2014"
"23043","220170 BERTOLINIA",2,1,0,79,0,82,"2014"
"23044","220173 BETANIA DO PIAUI",1,1,3,67,26,98,"2014"
"23045","220177 BOA HORA",1,0,1,34,71,107,"2014"
"23046","220180 BOCAINA",0,0,3,39,0,42,"2014"
"23047","220190 BOM JESUS",0,0,1,179,272,452,"2014"
"23048","220191 BOM PRINCIPIO DO PIAUI",0,1,1,87,1,90,"2014"
"23049","220192 BONFIM DO PIAUI",1,0,0,67,10,78,"2014"
"23050","220194 BOQUEIRAO DO PIAUI",0,0,1,21,94,116,"2014"
"23051","220196 BRASILEIRA",0,0,1,88,1,90,"2014"
"23052","220198 BREJO DO PIAUI",0,0,0,45,0,45,"2014"
"23053","220200 BURITI DOS LOPES",1,1,5,297,10,314,"2014"
"23054","220202 BURITI DOS MONTES",0,0,1,43,28,72,"2014"
"23055","220205 CABECEIRAS DO PIAUI",2,0,1,52,63,118,"2014"
"23056","220207 CAJAZEIRAS DO PIAUI",1,0,1,34,1,37,"2014"
"23057","220208 CAJUEIRO DA PRAIA",0,1,3,110,3,117,"2014"
"23058","220209 CALDEIRAO GRANDE DO PIAUI",1,2,5,48,0,56,"2014"
"23059","220210 CAMPINAS DO PIAUI",0,0,0,58,1,59,"2014"
"23060","220211 CAMPO ALEGRE DO FIDALGO",0,1,1,53,1,56,"2014"
"23061","220213 CAMPO GRANDE DO PIAUI",0,1,4,67,0,72,"2014"
"23062","220217 CAMPO LARGO DO PIAUI",2,1,3,108,2,116,"2014"
"23063","220220 CAMPO MAIOR",2,2,5,174,552,735,"2014"
"23064","220225 CANAVIEIRA",0,1,2,40,0,43,"2014"
"23065","220230 CANTO DO BURITI",1,1,3,242,5,252,"2014"
"23066","220240 CAPITAO DE CAMPOS",0,0,1,100,98,199,"2014"
"23067","220245 CAPITAO GERVASIO OLIVEIRA",1,0,2,48,0,51,"2014"
"23068","220250 CARACOL",0,1,1,123,31,156,"2014"
"23069","220253 CARAUBAS DO PIAUI",0,0,4,74,2,80,"2014"
"23070","220255 CARIDADE DO PIAUI",0,1,1,70,0,72,"2014"
"23071","220260 CASTELO DO PIAUI",0,3,3,164,117,287,"2014"
"23072","220265 CAXINGO",0,0,1,72,2,75,"2014"
"23073","220270 COCAL",0,0,8,349,20,377,"2014"
"23074","220271 COCAL DE TELHA",1,0,1,17,56,75,"2014"
"23075","220272 COCAL DOS ALVES",0,0,0,74,1,75,"2014"
"23076","220273 COIVARAS",0,0,0,36,13,49,"2014"
"23077","220275 COLONIA DO GURGUEIA",9,1,3,55,14,82,"2014"
"23078","220277 COLONIA DO PIAUI",1,2,3,87,1,94,"2014"
"23079","220280 CONCEICAO DO CANINDE",0,0,2,57,2,61,"2014"
"23080","220285 CORONEL JOSE DIAS",0,0,0,51,11,62,"2014"
"23081","220290 CORRENTE",1,1,4,141,275,422,"2014"
"23082","220300 CRISTALANDIA DO PIAUI",0,0,2,44,67,113,"2014"
"23083","220310 CRISTINO CASTRO",0,0,0,67,87,154,"2014"
"23084","220320 CURIMATA",0,0,3,120,44,167,"2014"
"23085","220323 CURRAIS",0,0,0,32,45,77,"2014"
"23086","220325 CURRALINHOS",0,0,1,57,1,59,"2014"
"23087","220327 CURRAL NOVO DO PIAUI",0,1,0,64,5,70,"2014"
"23088","220330 DEMERVAL LOBAO",2,0,1,198,4,205,"2014"
"23089","220335 DIRCEU ARCOVERDE",0,0,0,76,8,84,"2014"
"23090","220340 DOM EXPEDITO LOPES",0,0,4,79,0,83,"2014"
"23091","220342 DOMINGOS MOURAO",0,0,1,51,3,55,"2014"
"23092","220345 DOM INOCENCIO",0,0,0,77,17,94,"2014"
"23093","220350 ELESBAO VELOSO",0,0,5,159,1,165,"2014"
"23094","220360 ELISEU MARTINS",8,1,0,38,4,51,"2014"
"23095","220370 ESPERANTINA",1,0,22,666,2,691,"2014"
"23096","220375 FARTURA DO PIAUI",0,1,1,61,9,72,"2014"
"23097","220380 FLORES DO PIAUI",1,1,1,39,0,42,"2014"
"23098","220385 FLORESTA DO PIAUI",0,0,2,27,1,30,"2014"
"23099","220390 FLORIANO",2,8,22,970,2,1004,"2014"
"23100","220400 FRANCINOPOLIS",1,0,0,50,0,51,"2014"
"23101","220410 FRANCISCO AYRES",0,0,1,60,0,61,"2014"
"23102","220415 FRANCISCO MACEDO",0,0,4,45,1,50,"2014"
"23103","220420 FRANCISCO SANTOS",0,0,6,117,1,124,"2014"
"23104","220430 FRONTEIRAS",0,0,7,146,0,153,"2014"
"23105","220435 GEMINIANO",0,1,5,63,0,69,"2014"
"23106","220440 GILBUES",0,1,5,95,85,186,"2014"
"23107","220450 GUADALUPE",0,1,4,180,1,186,"2014"
"23108","220455 GUARIBAS",0,0,1,46,12,59,"2014"
"23109","220460 HUGO NAPOLEAO",0,0,1,49,0,50,"2014"
"23110","220465 ILHA GRANDE",1,0,2,148,2,153,"2014"
"23111","220470 INHUMA",1,0,1,198,1,201,"2014"
"23112","220480 IPIRANGA DO PIAUI",0,0,1,122,1,124,"2014"
"23113","220490 ISAIAS COELHO",0,0,7,114,5,126,"2014"
"23114","220500 ITAINOPOLIS",0,0,4,100,2,106,"2014"
"23115","220510 ITAUEIRA",0,0,3,118,0,121,"2014"
"23116","220515 JACOBINA DO PIAUI",0,0,4,56,16,76,"2014"
"23117","220520 JAICOS",1,2,15,311,0,329,"2014"
"23118","220525 JARDIM DO MULATO",1,0,1,57,2,61,"2014"
"23119","220527 JATOBA DO PIAUI",0,0,0,13,46,59,"2014"
"23120","220530 JERUMENHA",0,2,0,85,0,87,"2014"
"23121","220535 JOAO COSTA",0,0,0,37,1,38,"2014"
"23122","220540 JOAQUIM PIRES",1,2,5,189,5,202,"2014"
"23123","220545 JOCA MARQUES",0,0,1,79,1,81,"2014"
"23124","220550 JOSE DE FREITAS",2,0,5,552,7,566,"2014"
"23125","220551 JUAZEIRO DO PIAUI",0,0,2,22,48,72,"2014"
"23126","220552 JULIO BORGES",0,0,0,52,17,69,"2014"
"23127","220553 JUREMA",0,0,0,58,4,62,"2014"
"23128","220554 LAGOINHA DO PIAUI",0,0,2,34,0,36,"2014"
"23129","220555 LAGOA ALEGRE",1,0,3,118,3,125,"2014"
"23130","220556 LAGOA DO BARRO DO PIAUI",2,0,4,61,5,72,"2014"
"23131","220557 LAGOA DE SAO FRANCISCO",0,1,2,71,0,74,"2014"
"23132","220558 LAGOA DO PIAUI",0,0,1,60,5,66,"2014"
"23133","220559 LAGOA DO SITIO",0,1,2,68,0,71,"2014"
"23134","220560 LANDRI SALES",0,2,3,66,1,72,"2014"
"23135","220570 LUIS CORREIA",0,2,7,419,21,449,"2014"
"23136","220580 LUZILANDIA",1,0,7,384,7,399,"2014"
"23137","220585 MADEIRO",1,1,2,141,0,145,"2014"
"23138","220590 MANOEL EMIDIO",40,0,1,32,0,73,"2014"
"23139","220595 MARCOLANDIA",1,1,9,131,0,142,"2014"
"23140","220600 MARCOS PARENTE",0,0,1,50,0,51,"2014"
"23141","220605 MASSAPE DO PIAUI",0,0,1,43,0,44,"2014"
"23142","220610 MATIAS OLIMPIO",2,2,3,170,2,179,"2014"
"23143","220620 MIGUEL ALVES",10,5,9,464,39,527,"2014"
"23144","220630 MIGUEL LEAO",0,0,0,16,0,16,"2014"
"23145","220635 MILTON BRANDAO",0,0,2,55,0,57,"2014"
"23146","220640 MONSENHOR GIL",0,0,3,122,5,130,"2014"
"23147","220650 MONSENHOR HIPOLITO",0,0,5,98,1,104,"2014"
"23148","220660 MONTE ALEGRE DO PIAUI",0,2,0,76,92,170,"2014"
"23149","220665 MORRO CABECA NO TEMPO",0,3,1,35,21,60,"2014"
"23150","220667 MORRO DO CHAPEU DO PIAUI",0,1,3,83,1,88,"2014"
"23151","220669 MURICI DOS PORTELAS",0,0,1,86,6,93,"2014"
"23152","220670 NAZARE DO PIAUI",0,1,1,74,2,78,"2014"
"23153","220672 NAZARIA",1,0,1,155,8,165,"2014"
"23154","220675 NOSSA SENHORA DE NAZARE",0,0,0,18,47,65,"2014"
"23155","220680 NOSSA SENHORA DOS REMEDIOS",27,1,1,121,7,157,"2014"
"23156","220690 NOVO ORIENTE DO PIAUI",1,0,1,75,0,77,"2014"
"23157","220695 NOVO SANTO ANTONIO",1,0,0,17,1,19,"2014"
"23158","220700 OEIRAS",3,4,9,434,2,452,"2014"
"23159","220710 OLHO D'AGUA DO PIAUI",0,0,0,31,3,34,"2014"
"23160","220720 PADRE MARCOS",0,0,8,60,0,68,"2014"
"23161","220730 PAES LANDIM",0,1,0,62,1,64,"2014"
"23162","220735 PAJEU DO PIAUI",0,0,0,25,0,25,"2014"
"23163","220740 PALMEIRA DO PIAUI",0,0,0,31,45,76,"2014"
"23164","220750 PALMEIRAIS",0,0,4,178,37,219,"2014"
"23165","220755 PAQUETA",0,0,3,38,1,42,"2014"
"23166","220760 PARNAGUA",0,0,0,46,120,166,"2014"
"23167","220770 PARNAIBA",9,12,27,2226,45,2319,"2014"
"23168","220775 PASSAGEM FRANCA DO PIAUI",0,1,1,78,2,82,"2014"
"23169","220777 PATOS DO PIAUI",1,2,1,40,5,49,"2014"
"23170","220779 PAU D'ARCO DO PIAUI",0,0,1,35,2,38,"2014"
"23171","220780 PAULISTANA",0,2,8,240,77,327,"2014"
"23172","220785 PAVUSSU",2,0,0,40,0,42,"2014"
"23173","220790 PEDRO II",1,2,12,518,22,555,"2014"
"23174","220793 PEDRO LAURENTINO",0,0,0,27,0,27,"2014"
"23175","220795 NOVA SANTA RITA",0,0,2,56,0,58,"2014"
"23176","220800 PICOS",3,5,52,1046,3,1109,"2014"
"23177","220810 PIMENTEIRAS",2,1,0,112,1,116,"2014"
"23178","220820 PIO IX",3,1,4,198,0,206,"2014"
"23179","220830 PIRACURUCA",2,2,2,465,1,472,"2014"
"23180","220840 PIRIPIRI",4,0,12,932,8,956,"2014"
"23181","220850 PORTO",3,2,7,193,5,210,"2014"
"23182","220855 PORTO ALEGRE DO PIAUI",0,1,2,30,2,35,"2014"
"23183","220860 PRATA DO PIAUI",0,0,0,37,1,38,"2014"
"23184","220865 QUEIMADA NOVA",1,1,1,61,29,93,"2014"
"23185","220870 REDENCAO DO GURGUEIA",1,0,0,54,97,152,"2014"
"23186","220880 REGENERACAO",0,2,3,271,5,281,"2014"
"23187","220885 RIACHO FRIO",0,0,1,23,58,82,"2014"
"23188","220887 RIBEIRA DO PIAUI",0,0,1,37,0,38,"2014"
"23189","220890 RIBEIRO GONCALVES",0,1,0,32,79,112,"2014"
"23190","220900 RIO GRANDE DO PIAUI",0,0,2,79,2,83,"2014"
"23191","220910 SANTA CRUZ DO PIAUI",1,1,3,69,0,74,"2014"
"23192","220915 SANTA CRUZ DOS MILAGRES",0,1,0,18,0,19,"2014"
"23193","220920 SANTA FILOMENA",0,0,3,79,17,99,"2014"
"23194","220930 SANTA LUZ",0,0,0,47,36,83,"2014"
"23195","220935 SANTANA DO PIAUI",0,0,2,55,0,57,"2014"
"23196","220937 SANTA ROSA DO PIAUI",0,0,4,53,0,57,"2014"
"23197","220940 SANTO ANTONIO DE LISBOA",0,1,3,68,0,72,"2014"
"23198","220945 SANTO ANTONIO DOS MILAGRES",0,0,0,36,0,36,"2014"
"23199","220950 SANTO INACIO DO PIAUI",0,0,1,49,0,50,"2014"
"23200","220955 SAO BRAZ DO PIAUI",0,0,0,58,2,60,"2014"
"23201","220960 SAO FELIX DO PIAUI",0,0,0,18,0,18,"2014"
"23202","220965 SAO FRANCISCO DE ASSIS DO PIAUI",0,1,3,84,0,88,"2014"
"23203","220970 SAO FRANCISCO DO PIAUI",0,0,1,74,0,75,"2014"
"23204","220975 SAO GONCALO DO GURGUEIA",0,0,0,13,18,31,"2014"
"23205","220980 SAO GONCALO DO PIAUI",1,0,1,72,2,76,"2014"
"23206","220985 SAO JOAO DA CANABRAVA",0,1,2,53,1,57,"2014"
"23207","220987 SAO JOAO DA FRONTEIRA",0,0,1,68,1,70,"2014"
"23208","220990 SAO JOAO DA SERRA",0,0,2,46,20,68,"2014"
"23209","220995 SAO JOAO DA VARJOTA",0,0,0,70,0,70,"2014"
"23210","220997 SAO JOAO DO ARRAIAL",0,0,3,138,3,144,"2014"
"23211","221000 SAO JOAO DO PIAUI",0,2,8,287,0,297,"2014"
"23212","221005 SAO JOSE DO DIVINO",1,0,1,65,0,67,"2014"
"23213","221010 SAO JOSE DO PEIXE",0,0,0,40,1,41,"2014"
"23214","221020 SAO JOSE DO PIAUI",0,0,9,86,0,95,"2014"
"23215","221030 SAO JULIAO",1,0,1,65,0,67,"2014"
"23216","221035 SAO LOURENCO DO PIAUI",0,0,0,50,5,55,"2014"
"23217","221037 SAO LUIS DO PIAUI",0,0,1,23,1,25,"2014"
"23218","221038 SAO MIGUEL DA BAIXA GRANDE",0,0,0,14,0,14,"2014"
"23219","221039 SAO MIGUEL DO FIDALGO",1,0,0,25,0,26,"2014"
"23220","221040 SAO MIGUEL DO TAPUIO",0,3,3,186,42,234,"2014"
"23221","221050 SAO PEDRO DO PIAUI",0,0,2,181,7,190,"2014"
"23222","221060 SAO RAIMUNDO NONATO",1,4,4,468,116,593,"2014"
"23223","221062 SEBASTIAO BARROS",0,0,0,25,40,65,"2014"
"23224","221063 SEBASTIAO LEAL",0,0,1,35,8,44,"2014"
"23225","221065 SIGEFREDO PACHECO",0,0,1,36,70,107,"2014"
"23226","221070 SIMOES",0,1,2,218,1,222,"2014"
"23227","221080 SIMPLICIO MENDES",0,0,3,174,1,178,"2014"
"23228","221090 SOCORRO DO PIAUI",1,1,0,38,1,41,"2014"
"23229","221093 SUSSUAPARA",0,0,3,81,0,84,"2014"
"23230","221095 TAMBORIL DO PIAUI",0,0,0,44,3,47,"2014"
"23231","221097 TANQUE DO PIAUI",0,0,0,27,0,27,"2014"
"23232","221100 TERESINA",58,46,131,13583,116,13934,"2014"
"23233","221110 UNIAO",1,3,5,406,257,672,"2014"
"23234","221120 URUCUI",8,1,2,125,240,376,"2014"
"23235","221130 VALENCA DO PIAUI",6,0,0,281,1,288,"2014"
"23236","221135 VARZEA BRANCA",0,0,2,60,10,72,"2014"
"23237","221140 VARZEA GRANDE",2,0,1,37,2,42,"2014"
"23238","221150 VERA MENDES",0,0,6,24,1,31,"2014"
"23239","221160 VILA NOVA DO PIAUI",0,0,1,26,0,27,"2014"
"23240","221170 WALL FERRAZ",0,0,4,32,2,38,"2014"
"23241","230010 ABAIARA",0,1,4,128,2,135,"2014"
"23242","230015 ACARAPE",2,1,3,230,1,237,"2014"
"23243","230020 ACARAU",2,5,12,944,1,964,"2014"
"23244","230030 ACOPIARA",1,5,52,573,0,631,"2014"
"23245","230040 AIUABA",0,2,8,142,4,156,"2014"
"23246","230050 ALCANTARAS",1,1,4,138,1,145,"2014"
"23247","230060 ALTANEIRA",0,1,5,87,0,93,"2014"
"23248","230070 ALTO SANTO",1,0,3,185,0,189,"2014"
"23249","230075 AMONTADA",2,3,29,586,7,627,"2014"
"23250","230080 ANTONINA DO NORTE",0,1,5,93,0,99,"2014"
"23251","230090 APUIARES",0,0,3,145,0,148,"2014"
"23252","230100 AQUIRAZ",4,7,27,1025,15,1078,"2014"
"23253","230110 ARACATI",4,9,25,864,6,908,"2014"
"23254","230120 ARACOIABA",2,2,9,366,3,382,"2014"
"23255","230125 ARARENDA",0,0,3,118,4,125,"2014"
"23256","230130 ARARIPE",1,3,20,318,3,345,"2014"
"23257","230140 ARATUBA",2,1,2,175,0,180,"2014"
"23258","230150 ARNEIROZ",1,2,6,85,1,95,"2014"
"23259","230160 ASSARE",1,0,10,242,0,253,"2014"
"23260","230170 AURORA",0,3,6,350,0,359,"2014"
"23261","230180 BAIXIO",0,0,0,58,2,60,"2014"
"23262","230185 BANABUIU",0,0,6,249,2,257,"2014"
"23263","230190 BARBALHA",3,6,25,1036,48,1118,"2014"
"23264","230195 BARREIRA",0,0,9,286,1,296,"2014"
"23265","230200 BARRO",0,3,5,255,1,264,"2014"
"23266","230205 BARROQUINHA",0,1,4,202,0,207,"2014"
"23267","230210 BATURITE",2,2,9,564,1,578,"2014"
"23268","230220 BEBERIBE",5,0,9,564,1,579,"2014"
"23269","230230 BELA CRUZ",0,3,8,359,3,373,"2014"
"23270","230240 BOA VIAGEM",0,5,16,661,1,683,"2014"
"23271","230250 BREJO SANTO",2,1,5,690,0,698,"2014"
"23272","230260 CAMOCIM",3,7,16,983,3,1012,"2014"
"23273","230270 CAMPOS SALES",0,4,9,348,0,361,"2014"
"23274","230280 CANINDE",1,1,29,1086,5,1122,"2014"
"23275","230290 CAPISTRANO",2,2,6,235,0,245,"2014"
"23276","230300 CARIDADE",0,0,7,254,0,261,"2014"
"23277","230310 CARIRE",0,2,7,215,3,227,"2014"
"23278","230320 CARIRIACU",2,1,15,334,3,355,"2014"
"23279","230330 CARIUS",0,6,7,177,3,193,"2014"
"23280","230340 CARNAUBAL",3,0,5,217,1,226,"2014"
"23281","230350 CASCAVEL",3,1,20,949,14,987,"2014"
"23282","230360 CATARINA",0,3,2,139,0,144,"2014"
"23283","230365 CATUNDA",0,0,4,105,0,109,"2014"
"23284","230370 CAUCAIA",6,15,87,4865,39,5012,"2014"
"23285","230380 CEDRO",1,2,2,324,5,334,"2014"
"23286","230390 CHAVAL",1,1,3,168,1,174,"2014"
"23287","230393 CHORO",0,1,1,202,2,206,"2014"
"23288","230395 CHOROZINHO",0,1,5,301,0,307,"2014"
"23289","230400 COREAU",0,2,5,297,0,304,"2014"
"23290","230410 CRATEUS",1,1,16,983,22,1023,"2014"
"23291","230420 CRATO",3,19,78,2119,11,2230,"2014"
"23292","230423 CROATA",0,1,2,227,3,233,"2014"
"23293","230425 CRUZ",0,2,4,332,1,339,"2014"
"23294","230426 DEPUTADO IRAPUAN PINHEIRO",1,2,7,82,0,92,"2014"
"23295","230427 ERERE",0,0,1,44,0,45,"2014"
"23296","230428 EUSEBIO",4,4,18,1055,2,1083,"2014"
"23297","230430 FARIAS BRITO",0,2,12,236,1,251,"2014"
"23298","230435 FORQUILHA",1,2,5,307,2,317,"2014"
"23299","230440 FORTALEZA",95,128,579,37193,200,38195,"2014"
"23300","230445 FORTIM",0,0,4,173,0,177,"2014"
"23301","230450 FRECHEIRINHA",0,0,6,251,2,259,"2014"
"23302","230460 GENERAL SAMPAIO",0,1,3,82,1,87,"2014"
"23303","230465 GRACA",0,0,5,143,0,148,"2014"
"23304","230470 GRANJA",2,13,25,694,3,737,"2014"
"23305","230480 GRANJEIRO",0,0,2,49,1,52,"2014"
"23306","230490 GROAIRAS",0,2,8,134,0,144,"2014"
"23307","230495 GUAIUBA",0,1,2,364,3,370,"2014"
"23308","230500 GUARACIABA DO NORTE",1,5,27,557,3,593,"2014"
"23309","230510 GUARAMIRANGA",0,0,0,82,0,82,"2014"
"23310","230520 HIDROLANDIA",0,0,4,197,1,202,"2014"
"23311","230523 HORIZONTE",6,9,24,1162,6,1207,"2014"
"23312","230526 IBARETAMA",0,0,4,202,2,208,"2014"
"23313","230530 IBIAPINA",2,1,7,314,7,331,"2014"
"23314","230533 IBICUITINGA",0,2,4,150,0,156,"2014"
"23315","230535 ICAPUI",0,3,6,251,0,260,"2014"
"23316","230540 ICO",5,3,29,909,7,953,"2014"
"23317","230550 IGUATU",2,20,86,1275,9,1392,"2014"
"23318","230560 INDEPENDENCIA",1,0,8,285,14,308,"2014"
"23319","230565 IPAPORANGA",1,0,1,131,5,138,"2014"
"23320","230570 IPAUMIRIM",1,0,4,149,1,155,"2014"
"23321","230580 IPU",1,3,9,541,2,556,"2014"
"23322","230590 IPUEIRAS",1,3,13,446,2,465,"2014"
"23323","230600 IRACEMA",0,2,6,177,0,185,"2014"
"23324","230610 IRAUCUBA",2,5,7,341,0,355,"2014"
"23325","230620 ITAICABA",0,1,0,99,1,101,"2014"
"23326","230625 ITAITINGA",0,2,9,441,3,455,"2014"
"23327","230630 ITAPAGE",4,5,9,757,0,775,"2014"
"23328","230640 ITAPIPOCA",5,4,45,2016,9,2079,"2014"
"23329","230650 ITAPIUNA",1,3,4,222,1,231,"2014"
"23330","230655 ITAREMA",1,2,7,605,5,620,"2014"
"23331","230660 ITATIRA",0,0,5,297,2,304,"2014"
"23332","230670 JAGUARETAMA",0,1,3,170,0,174,"2014"
"23333","230680 JAGUARIBARA",0,2,3,143,0,148,"2014"
"23334","230690 JAGUARIBE",1,1,8,503,1,514,"2014"
"23335","230700 JAGUARUANA",1,3,9,376,0,389,"2014"
"23336","230710 JARDIM",1,6,10,412,9,438,"2014"
"23337","230720 JATI",1,0,3,114,0,118,"2014"
"23338","230725 JIJOCA DE JERICOACOARA",2,2,10,274,2,290,"2014"
"23339","230730 JUAZEIRO DO NORTE",13,12,172,3930,32,4159,"2014"
"23340","230740 JUCAS",1,2,17,343,0,363,"2014"
"23341","230750 LAVRAS DA MANGABEIRA",4,0,4,329,2,339,"2014"
"23342","230760 LIMOEIRO DO NORTE",2,3,19,730,2,756,"2014"
"23343","230763 MADALENA",0,2,2,190,1,195,"2014"
"23344","230765 MARACANAU",13,11,54,4373,21,4472,"2014"
"23345","230770 MARANGUAPE",1,8,27,1376,9,1421,"2014"
"23346","230780 MARCO",1,5,15,471,2,494,"2014"
"23347","230790 MARTINOPOLE",1,0,5,161,1,168,"2014"
"23348","230800 MASSAPE",0,3,10,502,4,519,"2014"
"23349","230810 MAURITI",3,3,9,698,1,714,"2014"
"23350","230820 MERUOCA",0,0,6,183,0,189,"2014"
"23351","230830 MILAGRES",1,2,8,387,0,398,"2014"
"23352","230835 MILHA",0,0,6,114,1,121,"2014"
"23353","230837 MIRAIMA",0,1,2,193,2,198,"2014"
"23354","230840 MISSAO VELHA",0,2,8,532,25,567,"2014"
"23355","230850 MOMBACA",0,2,15,465,2,484,"2014"
"23356","230860 MONSENHOR TABOSA",0,0,6,207,3,216,"2014"
"23357","230870 MORADA NOVA",3,1,5,705,2,716,"2014"
"23358","230880 MORAUJO",1,0,1,125,0,127,"2014"
"23359","230890 MORRINHOS",0,4,5,275,0,284,"2014"
"23360","230900 MUCAMBO",1,1,2,160,0,164,"2014"
"23361","230910 MULUNGU",1,0,3,144,0,148,"2014"
"23362","230920 NOVA OLINDA",2,2,17,222,1,244,"2014"
"23363","230930 NOVA RUSSAS",0,1,6,326,2,335,"2014"
"23364","230940 NOVO ORIENTE",1,4,6,353,10,374,"2014"
"23365","230945 OCARA",0,2,9,285,1,297,"2014"
"23366","230950 OROS",1,0,11,250,0,262,"2014"
"23367","230960 PACAJUS",5,7,22,931,7,972,"2014"
"23368","230970 PACATUBA",3,4,9,918,6,940,"2014"
"23369","230980 PACOTI",0,1,7,158,3,169,"2014"
"23370","230990 PACUJA",0,0,2,72,0,74,"2014"
"23371","231000 PALHANO",0,1,2,108,0,111,"2014"
"23372","231010 PALMACIA",0,0,1,106,1,108,"2014"
"23373","231020 PARACURU",1,5,7,570,1,584,"2014"
"23374","231025 PARAIPABA",1,5,7,410,1,424,"2014"
"23375","231030 PARAMBU",0,0,8,391,0,399,"2014"
"23376","231040 PARAMOTI",2,0,3,138,2,145,"2014"
"23377","231050 PEDRA BRANCA",0,2,10,530,3,545,"2014"
"23378","231060 PENAFORTE",0,0,3,165,1,169,"2014"
"23379","231070 PENTECOSTE",0,0,9,433,2,444,"2014"
"23380","231080 PEREIRO",0,1,7,220,1,229,"2014"
"23381","231085 PINDORETAMA",0,2,7,304,1,314,"2014"
"23382","231090 PIQUET CARNEIRO",0,2,8,145,0,155,"2014"
"23383","231095 PIRES FERREIRA",2,0,2,100,0,104,"2014"
"23384","231100 PORANGA",0,0,4,150,3,157,"2014"
"23385","231110 PORTEIRAS",0,0,9,257,0,266,"2014"
"23386","231120 POTENGI",0,1,5,128,2,136,"2014"
"23387","231123 POTIRETAMA",1,0,1,79,0,81,"2014"
"23388","231126 QUITERIANOPOLIS",0,2,7,235,8,252,"2014"
"23389","231130 QUIXADA",2,3,16,1206,5,1232,"2014"
"23390","231135 QUIXELO",0,3,9,158,0,170,"2014"
"23391","231140 QUIXERAMOBIM",1,9,53,1035,6,1104,"2014"
"23392","231150 QUIXERE",2,3,10,279,0,294,"2014"
"23393","231160 REDENCAO",0,6,3,428,1,438,"2014"
"23394","231170 RERIUTABA",0,6,7,231,0,244,"2014"
"23395","231180 RUSSAS",3,8,28,942,2,983,"2014"
"23396","231190 SABOEIRO",1,5,10,173,0,189,"2014"
"23397","231195 SALITRE",0,3,15,222,1,241,"2014"
"23398","231200 SANTANA DO ACARAU",0,4,13,460,3,480,"2014"
"23399","231210 SANTANA DO CARIRI",1,2,5,182,1,191,"2014"
"23400","231220 SANTA QUITERIA",1,3,13,581,0,598,"2014"
"23401","231230 SAO BENEDITO",2,3,22,724,0,751,"2014"
"23402","231240 SAO GONCALO DO AMARANTE",1,7,16,830,6,860,"2014"
"23403","231250 SAO JOAO DO JAGUARIBE",0,0,0,71,1,72,"2014"
"23404","231260 SAO LUIS DO CURU",0,0,5,195,1,201,"2014"
"23405","231270 SENADOR POMPEU",1,3,6,299,2,311,"2014"
"23406","231280 SENADOR SA",0,3,2,103,0,108,"2014"
"23407","231290 SOBRAL",14,12,77,3357,11,3471,"2014"
"23408","231300 SOLONOPOLE",1,1,2,168,0,172,"2014"
"23409","231310 TABULEIRO DO NORTE",0,3,10,392,0,405,"2014"
"23410","231320 TAMBORIL",3,3,6,278,5,295,"2014"
"23411","231325 TARRAFAS",1,0,5,79,4,89,"2014"
"23412","231330 TAUA",1,4,43,692,0,740,"2014"
"23413","231335 TEJUCUOCA",0,0,3,232,1,236,"2014"
"23414","231340 TIANGUA",2,7,27,1288,4,1328,"2014"
"23415","231350 TRAIRI",2,6,23,737,2,770,"2014"
"23416","231355 TURURU",0,2,6,263,0,271,"2014"
"23417","231360 UBAJARA",3,6,14,471,2,496,"2014"
"23418","231370 UMARI",0,0,0,86,0,86,"2014"
"23419","231375 UMIRIM",1,0,15,293,1,310,"2014"
"23420","231380 URUBURETAMA",0,0,15,339,3,357,"2014"
"23421","231390 URUOCA",0,1,5,166,0,172,"2014"
"23422","231395 VARJOTA",0,4,7,230,2,243,"2014"
"23423","231400 VARZEA ALEGRE",1,2,20,521,0,544,"2014"
"23424","231410 VICOSA DO CEARA",0,7,11,895,9,922,"2014"
"23425","240010 ACARI",0,1,9,137,0,147,"2014"
"23426","240020 ACU",3,1,9,821,1,835,"2014"
"23427","240030 AFONSO BEZERRA",0,2,1,119,0,122,"2014"
"23428","240040 AGUA NOVA",0,0,0,47,0,47,"2014"
"23429","240050 ALEXANDRIA",1,1,2,176,1,181,"2014"
"23430","240060 ALMINO AFONSO",0,0,0,61,0,61,"2014"
"23431","240070 ALTO DO RODRIGUES",1,1,4,220,2,228,"2014"
"23432","240080 ANGICOS",0,0,2,140,0,142,"2014"
"23433","240090 ANTONIO MARTINS",0,0,0,90,0,90,"2014"
"23434","240100 APODI",0,3,0,409,1,413,"2014"
"23435","240110 AREIA BRANCA",1,0,9,342,3,355,"2014"
"23436","240120 ARES",0,0,2,159,0,161,"2014"
"23437","240130 AUGUSTO SEVERO",0,1,3,98,0,102,"2014"
"23438","240140 BAIA FORMOSA",0,0,0,121,1,122,"2014"
"23439","240145 BARAUNA",1,0,8,398,2,409,"2014"
"23440","240150 BARCELONA",0,0,0,41,1,42,"2014"
"23441","240160 BENTO FERNANDES",2,0,1,64,0,67,"2014"
"23442","240165 BODO",0,0,3,39,0,42,"2014"
"23443","240170 BOM JESUS",1,0,0,131,7,139,"2014"
"23444","240180 BREJINHO",1,0,4,172,0,177,"2014"
"23445","240185 CAICARA DO NORTE",0,0,0,66,0,66,"2014"
"23446","240190 CAICARA DO RIO DO VENTO",0,0,0,51,0,51,"2014"
"23447","240200 CAICO",1,5,24,683,0,713,"2014"
"23448","240210 CAMPO REDONDO",0,0,0,145,1,146,"2014"
"23449","240220 CANGUARETAMA",4,0,10,513,5,532,"2014"
"23450","240230 CARAUBAS",0,3,7,289,0,299,"2014"
"23451","240240 CARNAUBA DOS DANTAS",0,0,4,108,0,112,"2014"
"23452","240250 CARNAUBAIS",0,1,0,137,0,138,"2014"
"23453","240260 CEARA-MIRIM",4,6,20,1245,7,1282,"2014"
"23454","240270 CERRO CORA",0,2,5,141,1,149,"2014"
"23455","240280 CORONEL EZEQUIEL",0,0,1,69,2,72,"2014"
"23456","240290 CORONEL JOAO PESSOA",2,1,0,68,0,71,"2014"
"23457","240300 CRUZETA",0,3,4,87,0,94,"2014"
"23458","240310 CURRAIS NOVOS",1,3,20,506,6,536,"2014"
"23459","240320 DOUTOR SEVERIANO",0,0,1,112,0,113,"2014"
"23460","240325 PARNAMIRIM",5,21,48,3939,12,4025,"2014"
"23461","240330 ENCANTO",2,0,3,88,0,93,"2014"
"23462","240340 EQUADOR",0,0,7,57,0,64,"2014"
"23463","240350 ESPIRITO SANTO",0,1,2,88,1,92,"2014"
"23464","240360 EXTREMOZ",0,1,8,535,0,544,"2014"
"23465","240370 FELIPE GUERRA",0,0,0,69,0,69,"2014"
"23466","240375 FERNANDO PEDROZA",0,0,0,33,1,34,"2014"
"23467","240380 FLORANIA",0,0,2,113,2,117,"2014"
"23468","240390 FRANCISCO DANTAS",0,0,0,51,0,51,"2014"
"23469","240400 FRUTUOSO GOMES",0,0,0,48,0,48,"2014"
"23470","240410 GALINHOS",0,0,1,30,0,31,"2014"
"23471","240420 GOIANINHA",1,2,9,446,4,462,"2014"
"23472","240430 GOVERNADOR DIX-SEPT ROSADO",0,0,2,164,2,168,"2014"
"23473","240440 GROSSOS",0,1,1,126,0,128,"2014"
"23474","240450 GUAMARE",1,2,3,257,5,268,"2014"
"23475","240460 IELMO MARINHO",2,2,3,107,0,114,"2014"
"23476","240470 IPANGUACU",2,0,0,211,1,214,"2014"
"23477","240480 IPUEIRA",0,0,0,20,0,20,"2014"
"23478","240485 ITAJA",1,0,0,119,0,120,"2014"
"23479","240490 ITAU",0,0,0,60,0,60,"2014"
"23480","240500 JACANA",1,0,1,98,0,100,"2014"
"23481","240510 JANDAIRA",1,0,3,98,0,102,"2014"
"23482","240520 JANDUIS",2,0,1,67,0,70,"2014"
"23483","240530 JANUARIO CICCO",2,0,2,115,2,121,"2014"
"23484","240540 JAPI",0,0,5,100,0,105,"2014"
"23485","240550 JARDIM DE ANGICOS",0,0,1,26,0,27,"2014"
"23486","240560 JARDIM DE PIRANHAS",0,0,4,162,0,166,"2014"
"23487","240570 JARDIM DO SERIDO",1,0,4,121,0,126,"2014"
"23488","240580 JOAO CAMARA",0,0,8,520,1,529,"2014"
"23489","240590 JOAO DIAS",0,0,0,42,0,42,"2014"
"23490","240600 JOSE DA PENHA",1,0,1,78,0,80,"2014"
"23491","240610 JUCURUTU",1,0,0,211,0,212,"2014"
"23492","240615 JUNDIA",0,0,2,49,1,52,"2014"
"23493","240620 LAGOA D'ANTA",1,0,1,87,3,92,"2014"
"23494","240630 LAGOA DE PEDRAS",0,0,2,84,0,86,"2014"
"23495","240640 LAGOA DE VELHOS",0,2,0,39,0,41,"2014"
"23496","240650 LAGOA NOVA",0,2,13,233,0,248,"2014"
"23497","240660 LAGOA SALGADA",1,2,2,130,1,136,"2014"
"23498","240670 LAJES",1,2,1,103,0,107,"2014"
"23499","240680 LAJES PINTADAS",0,0,2,65,0,67,"2014"
"23500","240690 LUCRECIA",1,1,1,47,0,50,"2014"
"23501","240700 LUIS GOMES",0,0,2,159,0,161,"2014"
"23502","240710 MACAIBA",3,6,15,865,4,893,"2014"
"23503","240720 MACAU",1,3,6,449,0,459,"2014"
"23504","240725 MAJOR SALES",0,0,0,51,0,51,"2014"
"23505","240730 MARCELINO VIEIRA",0,2,3,83,0,88,"2014"
"23506","240740 MARTINS",0,0,1,100,0,101,"2014"
"23507","240750 MAXARANGUAPE",0,3,4,149,2,158,"2014"
"23508","240760 MESSIAS TARGINO",0,1,0,50,0,51,"2014"
"23509","240770 MONTANHAS",0,2,3,136,1,142,"2014"
"23510","240780 MONTE ALEGRE",0,1,9,285,2,297,"2014"
"23511","240790 MONTE DAS GAMELEIRAS",0,1,0,31,1,33,"2014"
"23512","240800 MOSSORO",7,13,69,3845,20,3954,"2014"
"23513","240810 NATAL",14,46,217,11540,45,11862,"2014"
"23514","240820 NISIA FLORESTA",3,2,1,373,1,380,"2014"
"23515","240830 NOVA CRUZ",1,3,11,457,6,478,"2014"
"23516","240840 OLHO-D'AGUA DO BORGES",0,0,1,51,0,52,"2014"
"23517","240850 OURO BRANCO",0,2,2,50,0,54,"2014"
"23518","240860 PARANA",0,0,1,52,0,53,"2014"
"23519","240870 PARAU",0,0,0,56,0,56,"2014"
"23520","240880 PARAZINHO",0,0,1,75,0,76,"2014"
"23521","240890 PARELHAS",0,3,5,315,0,323,"2014"
"23522","240895 RIO DO FOGO",0,0,3,154,1,158,"2014"
"23523","240910 PASSA E FICA",0,2,3,158,2,165,"2014"
"23524","240920 PASSAGEM",0,0,0,40,1,41,"2014"
"23525","240930 PATU",0,0,0,140,0,140,"2014"
"23526","240933 SANTA MARIA",0,0,0,60,1,61,"2014"
"23527","240940 PAU DOS FERROS",2,0,2,406,0,410,"2014"
"23528","240950 PEDRA GRANDE",0,0,0,58,1,59,"2014"
"23529","240960 PEDRA PRETA",0,0,2,36,0,38,"2014"
"23530","240970 PEDRO AVELINO",0,1,1,66,2,70,"2014"
"23531","240980 PEDRO VELHO",0,0,4,171,0,175,"2014"
"23532","240990 PENDENCIAS",1,2,4,191,0,198,"2014"
"23533","241000 PILOES",0,0,0,39,0,39,"2014"
"23534","241010 POCO BRANCO",1,1,3,173,3,181,"2014"
"23535","241020 PORTALEGRE",0,0,1,108,0,109,"2014"
"23536","241025 PORTO DO MANGUE",1,0,1,69,2,73,"2014"
"23537","241030 SERRA CAIADA",0,2,2,143,4,151,"2014"
"23538","241040 PUREZA",2,0,3,148,0,153,"2014"
"23539","241050 RAFAEL FERNANDES",1,0,2,64,0,67,"2014"
"23540","241060 RAFAEL GODEIRO",0,0,0,29,0,29,"2014"
"23541","241070 RIACHO DA CRUZ",0,0,2,32,0,34,"2014"
"23542","241080 RIACHO DE SANTANA",0,0,2,42,0,44,"2014"
"23543","241090 RIACHUELO",0,1,3,93,0,97,"2014"
"23544","241100 RODOLFO FERNANDES",0,1,0,70,0,71,"2014"
"23545","241105 TIBAU",0,0,0,76,0,76,"2014"
"23546","241110 RUY BARBOSA",0,0,2,32,0,34,"2014"
"23547","241120 SANTA CRUZ",0,3,9,608,7,627,"2014"
"23548","241140 SANTANA DO MATOS",0,1,2,129,1,133,"2014"
"23549","241142 SANTANA DO SERIDO",0,0,1,26,0,27,"2014"
"23550","241150 SANTO ANTONIO",0,2,8,319,3,332,"2014"
"23551","241160 SAO BENTO DO NORTE",0,0,0,38,0,38,"2014"
"23552","241170 SAO BENTO DO TRAIRI",0,0,0,69,2,71,"2014"
"23553","241180 SAO FERNANDO",0,1,3,39,1,44,"2014"
"23554","241190 SAO FRANCISCO DO OESTE",1,0,0,62,0,63,"2014"
"23555","241200 SAO GONCALO DO AMARANTE",2,3,19,1833,3,1860,"2014"
"23556","241210 SAO JOAO DO SABUGI",0,0,2,55,0,57,"2014"
"23557","241220 SAO JOSE DE MIPIBU",2,3,6,652,3,666,"2014"
"23558","241230 SAO JOSE DO CAMPESTRE",0,0,4,165,0,169,"2014"
"23559","241240 SAO JOSE DO SERIDO",0,0,3,56,0,59,"2014"
"23560","241250 SAO MIGUEL",0,0,4,316,1,321,"2014"
"23561","241255 SAO MIGUEL DO GOSTOSO",0,2,0,103,0,105,"2014"
"23562","241260 SAO PAULO DO POTENGI",1,0,2,227,2,232,"2014"
"23563","241270 SAO PEDRO",1,1,2,62,2,68,"2014"
"23564","241280 SAO RAFAEL",1,2,1,81,0,85,"2014"
"23565","241290 SAO TOME",0,2,2,135,1,140,"2014"
"23566","241300 SAO VICENTE",0,2,3,69,1,75,"2014"
"23567","241310 SENADOR ELOI DE SOUZA",1,0,2,78,3,84,"2014"
"23568","241320 SENADOR GEORGINO AVELINO",0,2,0,58,0,60,"2014"
"23569","241330 SERRA DE SAO BENTO",0,3,0,79,0,82,"2014"
"23570","241335 SERRA DO MEL",0,0,3,210,1,214,"2014"
"23571","241340 SERRA NEGRA DO NORTE",0,0,3,82,0,85,"2014"
"23572","241350 SERRINHA",0,2,3,98,0,103,"2014"
"23573","241355 SERRINHA DOS PINTOS",0,0,0,62,0,62,"2014"
"23574","241360 SEVERIANO MELO",0,0,0,90,0,90,"2014"
"23575","241370 SITIO NOVO",0,0,0,60,1,61,"2014"
"23576","241380 TABOLEIRO GRANDE",0,0,0,27,0,27,"2014"
"23577","241390 TAIPU",0,0,3,170,0,173,"2014"
"23578","241400 TANGARA",0,1,5,224,8,238,"2014"
"23579","241410 TENENTE ANANIAS",0,0,1,163,0,164,"2014"
"23580","241415 TENENTE LAURENTINO CRUZ",0,1,3,83,0,87,"2014"
"23581","241420 TIBAU DO SUL",1,3,4,207,10,225,"2014"
"23582","241430 TIMBAUBA DOS BATISTAS",1,0,0,32,0,33,"2014"
"23583","241440 TOUROS",1,2,7,490,4,504,"2014"
"23584","241445 TRIUNFO POTIGUAR",0,0,2,48,2,52,"2014"
"23585","241450 UMARIZAL",1,0,3,118,0,122,"2014"
"23586","241460 UPANEMA",2,0,2,179,2,185,"2014"
"23587","241470 VARZEA",0,0,1,46,2,49,"2014"
"23588","241475 VENHA-VER",0,0,0,65,0,65,"2014"
"23589","241480 VERA CRUZ",3,1,4,157,1,166,"2014"
"23590","241490 VICOSA",0,0,0,31,0,31,"2014"
"23591","241500 VILA FLOR",0,0,0,45,0,45,"2014"
"23592","250010 AGUA BRANCA",0,1,2,91,2,96,"2014"
"23593","250020 AGUIAR",0,0,2,59,5,66,"2014"
"23594","250030 ALAGOA GRANDE",2,4,4,353,1,364,"2014"
"23595","250040 ALAGOA NOVA",1,2,12,320,1,336,"2014"
"23596","250050 ALAGOINHA",0,2,2,236,0,240,"2014"
"23597","250053 ALCANTIL",0,0,2,110,2,114,"2014"
"23598","250057 ALGODAO DE JANDAIRA",0,0,0,38,0,38,"2014"
"23599","250060 ALHANDRA",0,2,8,416,2,428,"2014"
"23600","250070 SAO JOAO DO RIO DO PEIXE",1,2,3,196,0,202,"2014"
"23601","250073 AMPARO",0,0,2,37,0,39,"2014"
"23602","250077 APARECIDA",1,0,0,116,1,118,"2014"
"23603","250080 ARACAGI",1,1,3,223,0,228,"2014"
"23604","250090 ARARA",0,1,1,130,0,132,"2014"
"23605","250100 ARARUNA",2,0,6,231,1,240,"2014"
"23606","250110 AREIA",0,5,5,353,2,365,"2014"
"23607","250115 AREIA DE BARAUNAS",0,0,1,20,0,21,"2014"
"23608","250120 AREIAL",1,0,1,121,0,123,"2014"
"23609","250130 AROEIRAS",0,3,7,329,5,344,"2014"
"23610","250135 ASSUNCAO",0,0,1,66,0,67,"2014"
"23611","250140 BAIA DA TRAICAO",0,0,1,160,0,161,"2014"
"23612","250150 BANANEIRAS",0,3,5,300,0,308,"2014"
"23613","250153 BARAUNA",0,1,1,66,0,68,"2014"
"23614","250157 BARRA DE SANTANA",0,0,2,95,1,98,"2014"
"23615","250160 BARRA DE SANTA ROSA",0,1,5,139,0,145,"2014"
"23616","250170 BARRA DE SAO MIGUEL",0,0,1,66,2,69,"2014"
"23617","250180 BAYEUX",2,11,32,1287,3,1335,"2014"
"23618","250190 BELEM",0,4,6,227,0,237,"2014"
"23619","250200 BELEM DO BREJO DO CRUZ",0,0,1,87,0,88,"2014"
"23620","250205 BERNARDINO BATISTA",0,0,3,58,1,62,"2014"
"23621","250210 BOA VENTURA",0,0,2,70,0,72,"2014"
"23622","250215 BOA VISTA",0,0,2,105,0,107,"2014"
"23623","250220 BOM JESUS",0,0,3,32,0,35,"2014"
"23624","250230 BOM SUCESSO",0,1,1,53,0,55,"2014"
"23625","250240 BONITO DE SANTA FE",1,0,4,168,0,173,"2014"
"23626","250250 BOQUEIRAO",1,0,9,284,2,296,"2014"
"23627","250260 IGARACY",0,1,2,83,7,93,"2014"
"23628","250270 BORBOREMA",0,1,1,66,0,68,"2014"
"23629","250280 BREJO DO CRUZ",0,1,2,166,0,169,"2014"
"23630","250290 BREJO DOS SANTOS",0,0,1,71,0,72,"2014"
"23631","250300 CAAPORA",0,0,11,385,2,398,"2014"
"23632","250310 CABACEIRAS",0,0,3,61,1,65,"2014"
"23633","250320 CABEDELO",0,3,12,917,2,934,"2014"
"23634","250330 CACHOEIRA DOS INDIOS",0,0,6,118,3,127,"2014"
"23635","250340 CACIMBA DE AREIA",0,1,1,53,0,55,"2014"
"23636","250350 CACIMBA DE DENTRO",0,1,3,211,3,218,"2014"
"23637","250355 CACIMBAS",1,2,2,124,11,140,"2014"
"23638","250360 CAICARA",0,1,6,109,1,117,"2014"
"23639","250370 CAJAZEIRAS",6,4,22,808,1,841,"2014"
"23640","250375 CAJAZEIRINHAS",0,0,2,52,0,54,"2014"
"23641","250380 CALDAS BRANDAO",0,0,3,101,5,109,"2014"
"23642","250390 CAMALAU",0,0,0,87,1,88,"2014"
"23643","250400 CAMPINA GRANDE",12,33,86,6475,4,6610,"2014"
"23644","250403 CAPIM",0,0,3,92,3,98,"2014"
"23645","250407 CARAUBAS",0,0,1,43,0,44,"2014"
"23646","250410 CARRAPATEIRA",0,0,2,36,0,38,"2014"
"23647","250415 CASSERENGUE",0,1,2,88,0,91,"2014"
"23648","250420 CATINGUEIRA",0,1,0,54,2,57,"2014"
"23649","250430 CATOLE DO ROCHA",1,6,5,420,0,432,"2014"
"23650","250435 CATURITE",0,0,1,66,0,67,"2014"
"23651","250440 CONCEICAO",2,4,9,258,0,273,"2014"
"23652","250450 CONDADO",0,3,1,83,1,88,"2014"
"23653","250460 CONDE",0,1,12,440,2,455,"2014"
"23654","250470 CONGO",1,0,0,103,0,104,"2014"
"23655","250480 COREMAS",1,1,3,151,41,197,"2014"
"23656","250485 COXIXOLA",0,0,0,21,0,21,"2014"
"23657","250490 CRUZ DO ESPIRITO SANTO",0,1,5,201,0,207,"2014"
"23658","250500 CUBATI",0,1,0,106,0,107,"2014"
"23659","250510 CUITE",0,3,2,244,8,257,"2014"
"23660","250520 CUITEGI",1,0,1,123,2,127,"2014"
"23661","250523 CUITE DE MAMANGUAPE",0,0,3,76,2,81,"2014"
"23662","250527 CURRAL DE CIMA",0,0,1,48,1,50,"2014"
"23663","250530 CURRAL VELHO",0,0,0,25,0,25,"2014"
"23664","250535 DAMIAO",0,1,0,58,0,59,"2014"
"23665","250540 DESTERRO",0,0,2,106,6,114,"2014"
"23666","250550 VISTA SERRANA",0,0,1,47,0,48,"2014"
"23667","250560 DIAMANTE",0,0,1,83,2,86,"2014"
"23668","250570 DONA INES",1,1,7,154,0,163,"2014"
"23669","250580 DUAS ESTRADAS",0,0,1,74,0,75,"2014"
"23670","250590 EMAS",0,0,1,41,1,43,"2014"
"23671","250600 ESPERANCA",1,0,11,545,1,558,"2014"
"23672","250610 FAGUNDES",0,0,5,186,1,192,"2014"
"23673","250620 FREI MARTINHO",0,1,0,29,0,30,"2014"
"23674","250625 GADO BRAVO",0,2,1,124,2,129,"2014"
"23675","250630 GUARABIRA",4,7,8,840,3,862,"2014"
"23676","250640 GURINHEM",0,1,4,198,17,220,"2014"
"23677","250650 GURJAO",0,0,0,40,0,40,"2014"
"23678","250660 IBIARA",0,0,0,63,2,65,"2014"
"23679","250670 IMACULADA",2,2,7,135,5,151,"2014"
"23680","250680 INGA",0,1,5,223,2,231,"2014"
"23681","250690 ITABAIANA",1,1,4,316,27,349,"2014"
"23682","250700 ITAPORANGA",1,2,8,350,16,377,"2014"
"23683","250710 ITAPOROROCA",0,3,7,232,2,244,"2014"
"23684","250720 ITATUBA",0,1,2,156,0,159,"2014"
"23685","250730 JACARAU",0,0,1,186,2,189,"2014"
"23686","250740 JERICO",0,1,1,81,0,83,"2014"
"23687","250750 JOAO PESSOA",25,64,149,11515,26,11779,"2014"
"23688","250760 JUAREZ TAVORA",0,0,2,110,0,112,"2014"
"23689","250770 JUAZEIRINHO",1,2,2,332,1,338,"2014"
"23690","250780 JUNCO DO SERIDO",0,0,1,91,1,93,"2014"
"23691","250790 JURIPIRANGA",0,1,4,162,14,181,"2014"
"23692","250800 JURU",1,0,6,108,1,116,"2014"
"23693","250810 LAGOA",0,0,2,51,1,54,"2014"
"23694","250820 LAGOA DE DENTRO",1,2,2,121,2,128,"2014"
"23695","250830 LAGOA SECA",2,2,4,385,1,394,"2014"
"23696","250840 LASTRO",0,0,0,44,0,44,"2014"
"23697","250850 LIVRAMENTO",0,1,4,106,4,115,"2014"
"23698","250855 LOGRADOURO",0,0,2,52,1,55,"2014"
"23699","250860 LUCENA",0,2,3,151,1,157,"2014"
"23700","250870 MAE D'AGUA",0,1,2,38,2,43,"2014"
"23701","250880 MALTA",0,0,4,81,2,87,"2014"
"23702","250890 MAMANGUAPE",2,1,13,624,4,644,"2014"
"23703","250900 MANAIRA",0,1,6,150,0,157,"2014"
"23704","250905 MARCACAO",0,0,4,133,2,139,"2014"
"23705","250910 MARI",0,1,5,255,1,262,"2014"
"23706","250915 MARIZOPOLIS",0,1,2,90,1,94,"2014"
"23707","250920 MASSARANDUBA",1,3,6,193,1,204,"2014"
"23708","250930 MATARACA",0,3,2,146,1,152,"2014"
"23709","250933 MATINHAS",0,0,2,80,0,82,"2014"
"23710","250937 MATO GROSSO",0,0,1,44,0,45,"2014"
"23711","250939 MATUREIA",1,1,4,96,3,105,"2014"
"23712","250940 MOGEIRO",1,0,5,202,12,220,"2014"
"23713","250950 MONTADAS",1,1,2,86,1,91,"2014"
"23714","250960 MONTE HOREBE",0,2,2,64,1,69,"2014"
"23715","250970 MONTEIRO",1,4,4,484,1,494,"2014"
"23716","250980 MULUNGU",0,0,0,143,0,143,"2014"
"23717","250990 NATUBA",0,1,3,103,2,109,"2014"
"23718","251000 NAZAREZINHO",0,0,0,106,1,107,"2014"
"23719","251010 NOVA FLORESTA",0,0,3,142,2,147,"2014"
"23720","251020 NOVA OLINDA",0,0,2,39,11,52,"2014"
"23721","251030 NOVA PALMEIRA",0,0,0,43,0,43,"2014"
"23722","251040 OLHO D'AGUA",0,2,4,84,5,95,"2014"
"23723","251050 OLIVEDOS",0,0,2,49,0,51,"2014"
"23724","251060 OURO VELHO",0,0,0,37,0,37,"2014"
"23725","251065 PARARI",0,0,0,21,0,21,"2014"
"23726","251070 PASSAGEM",0,0,2,30,2,34,"2014"
"23727","251080 PATOS",4,21,53,1433,36,1547,"2014"
"23728","251090 PAULISTA",0,1,0,157,1,159,"2014"
"23729","251100 PEDRA BRANCA",0,0,1,58,4,63,"2014"
"23730","251110 PEDRA LAVRADA",1,1,0,88,2,92,"2014"
"23731","251120 PEDRAS DE FOGO",1,0,7,422,6,436,"2014"
"23732","251130 PIANCO",0,4,3,152,14,173,"2014"
"23733","251140 PICUI",1,1,6,255,0,263,"2014"
"23734","251150 PILAR",0,1,4,147,7,159,"2014"
"23735","251160 PILOES",0,0,1,133,2,136,"2014"
"23736","251170 PILOEZINHOS",0,0,1,87,0,88,"2014"
"23737","251180 PIRPIRITUBA",0,1,0,153,0,154,"2014"
"23738","251190 PITIMBU",0,1,4,249,3,257,"2014"
"23739","251200 POCINHOS",0,1,8,290,0,299,"2014"
"23740","251203 POCO DANTAS",1,0,1,55,0,57,"2014"
"23741","251207 POCO DE JOSE DE MOURA",0,1,2,42,0,45,"2014"
"23742","251210 POMBAL",0,2,6,417,3,428,"2014"
"23743","251220 PRATA",0,0,0,50,0,50,"2014"
"23744","251230 PRINCESA ISABEL",0,2,14,294,2,312,"2014"
"23745","251240 PUXINANA",0,0,5,216,1,222,"2014"
"23746","251250 QUEIMADAS",1,4,13,672,6,696,"2014"
"23747","251260 QUIXABA",0,0,0,23,0,23,"2014"
"23748","251270 REMIGIO",0,1,3,285,0,289,"2014"
"23749","251272 PEDRO REGIS",0,0,3,61,0,64,"2014"
"23750","251274 RIACHAO",0,0,2,53,0,55,"2014"
"23751","251275 RIACHAO DO BACAMARTE",0,0,0,64,0,64,"2014"
"23752","251276 RIACHAO DO POCO",0,0,1,48,1,50,"2014"
"23753","251278 RIACHO DE SANTO ANTONIO",0,0,2,41,0,43,"2014"
"23754","251280 RIACHO DOS CAVALOS",1,3,2,117,0,123,"2014"
"23755","251290 RIO TINTO",3,2,5,271,0,281,"2014"
"23756","251300 SALGADINHO",0,1,0,44,0,45,"2014"
"23757","251310 SALGADO DE SAO FELIX",2,1,2,118,9,132,"2014"
"23758","251315 SANTA CECILIA",0,0,0,98,2,100,"2014"
"23759","251320 SANTA CRUZ",0,0,0,77,1,78,"2014"
"23760","251330 SANTA HELENA",0,2,3,61,1,67,"2014"
"23761","251335 SANTA INES",2,0,0,45,2,49,"2014"
"23762","251340 SANTA LUZIA",2,6,4,204,2,218,"2014"
"23763","251350 SANTANA DE MANGUEIRA",0,0,0,59,1,60,"2014"
"23764","251360 SANTANA DOS GARROTES",1,0,0,70,7,78,"2014"
"23765","251365 JOCA CLAUDINO",0,0,0,21,0,21,"2014"
"23766","251370 SANTA RITA",2,5,41,1724,4,1776,"2014"
"23767","251380 SANTA TERESINHA",0,0,2,77,1,80,"2014"
"23768","251385 SANTO ANDRE",0,0,0,26,0,26,"2014"
"23769","251390 SAO BENTO",3,5,4,437,1,450,"2014"
"23770","251392 SAO BENTINHO",0,0,1,49,0,50,"2014"
"23771","251394 SAO DOMINGOS DO CARIRI",0,1,0,33,0,34,"2014"
"23772","251396 SAO DOMINGOS",0,0,1,36,1,38,"2014"
"23773","251398 SAO FRANCISCO",0,0,0,41,0,41,"2014"
"23774","251400 SAO JOAO DO CARIRI",0,0,0,59,0,59,"2014"
"23775","251410 SAO JOAO DO TIGRE",0,0,2,48,0,50,"2014"
"23776","251420 SAO JOSE DA LAGOA TAPADA",1,0,0,87,1,89,"2014"
"23777","251430 SAO JOSE DE CAIANA",1,2,2,71,3,79,"2014"
"23778","251440 SAO JOSE DE ESPINHARAS",0,0,2,43,1,46,"2014"
"23779","251445 SAO JOSE DOS RAMOS",0,1,0,64,7,72,"2014"
"23780","251450 SAO JOSE DE PIRANHAS",1,4,1,252,2,260,"2014"
"23781","251455 SAO JOSE DE PRINCESA",0,0,2,40,1,43,"2014"
"23782","251460 SAO JOSE DO BONFIM",0,1,4,44,5,54,"2014"
"23783","251465 SAO JOSE DO BREJO DO CRUZ",1,0,0,19,0,20,"2014"
"23784","251470 SAO JOSE DO SABUGI",0,0,0,62,0,62,"2014"
"23785","251480 SAO JOSE DOS CORDEIROS",0,0,2,50,0,52,"2014"
"23786","251490 SAO MAMEDE",0,2,4,89,5,100,"2014"
"23787","251500 SAO MIGUEL DE TAIPU",0,2,1,78,3,84,"2014"
"23788","251510 SAO SEBASTIAO DE LAGOA DE ROCA",1,1,1,163,3,169,"2014"
"23789","251520 SAO SEBASTIAO DO UMBUZEIRO",0,1,1,49,0,51,"2014"
"23790","251530 SAPE",1,7,13,673,1,695,"2014"
"23791","251540 SAO VICENTE DO SERIDO",3,3,3,176,4,189,"2014"
"23792","251550 SERRA BRANCA",1,1,2,158,2,164,"2014"
"23793","251560 SERRA DA RAIZ",0,0,1,35,1,37,"2014"
"23794","251570 SERRA GRANDE",0,0,1,40,0,41,"2014"
"23795","251580 SERRA REDONDA",0,1,2,101,0,104,"2014"
"23796","251590 SERRARIA",0,0,1,74,0,75,"2014"
"23797","251593 SERTAOZINHO",0,1,1,79,0,81,"2014"
"23798","251597 SOBRADO",1,0,3,92,0,96,"2014"
"23799","251600 SOLANEA",1,5,14,358,2,380,"2014"
"23800","251610 SOLEDADE",0,1,3,230,0,234,"2014"
"23801","251615 SOSSEGO",0,1,1,59,0,61,"2014"
"23802","251620 SOUSA",4,4,15,950,5,978,"2014"
"23803","251630 SUME",1,1,5,216,2,225,"2014"
"23804","251640 TACIMA",0,0,1,90,0,91,"2014"
"23805","251650 TAPEROA",0,1,8,192,2,203,"2014"
"23806","251660 TAVARES",1,0,6,170,3,180,"2014"
"23807","251670 TEIXEIRA",0,2,6,197,9,214,"2014"
"23808","251675 TENORIO",0,0,0,48,1,49,"2014"
"23809","251680 TRIUNFO",2,0,3,111,0,116,"2014"
"23810","251690 UIRAUNA",0,0,2,178,1,181,"2014"
"23811","251700 UMBUZEIRO",0,0,4,142,0,146,"2014"
"23812","251710 VARZEA",1,2,0,32,0,35,"2014"
"23813","251720 VIEIROPOLIS",0,0,0,49,0,49,"2014"
"23814","251740 ZABELE",0,0,0,43,0,43,"2014"
"23815","MUNICIPIO IGNORADO - PE",0,0,0,0,1,1,"2014"
"23816","260005 ABREU E LIMA",6,2,25,1481,12,1526,"2014"
"23817","260010 AFOGADOS DA INGAZEIRA",2,3,9,639,0,653,"2014"
"23818","260020 AFRANIO",2,2,8,152,141,305,"2014"
"23819","260030 AGRESTINA",3,0,2,350,1,356,"2014"
"23820","260040 AGUA PRETA",3,3,17,515,13,551,"2014"
"23821","260050 AGUAS BELAS",2,2,14,740,7,765,"2014"
"23822","260060 ALAGOINHA",1,0,1,172,0,174,"2014"
"23823","260070 ALIANCA",1,1,5,604,0,611,"2014"
"23824","260080 ALTINHO",3,0,0,236,0,239,"2014"
"23825","260090 AMARAJI",1,17,10,309,0,337,"2014"
"23826","260100 ANGELIM",0,1,2,154,0,157,"2014"
"23827","260105 ARACOIABA",4,4,5,296,5,314,"2014"
"23828","260110 ARARIPINA",7,12,22,1546,5,1592,"2014"
"23829","260120 ARCOVERDE",7,7,23,1119,3,1159,"2014"
"23830","260130 BARRA DE GUABIRABA",0,1,1,165,0,167,"2014"
"23831","260140 BARREIROS",4,4,7,834,3,852,"2014"
"23832","260150 BELEM DE MARIA",0,2,3,146,1,152,"2014"
"23833","260160 BELEM DE SAO FRANCISCO",4,3,4,341,3,355,"2014"
"23834","260170 BELO JARDIM",2,4,21,1158,7,1192,"2014"
"23835","260180 BETANIA",1,0,7,177,4,189,"2014"
"23836","260190 BEZERROS",1,1,6,750,4,762,"2014"
"23837","260200 BODOCO",0,6,3,489,3,501,"2014"
"23838","260210 BOM CONSELHO",3,4,11,649,0,667,"2014"
"23839","260220 BOM JARDIM",1,0,5,472,1,479,"2014"
"23840","260230 BONITO",1,1,6,600,3,611,"2014"
"23841","260240 BREJAO",2,1,3,172,1,179,"2014"
"23842","260250 BREJINHO",0,0,2,107,3,112,"2014"
"23843","260260 BREJO DA MADRE DE DEUS",1,4,4,687,6,702,"2014"
"23844","260270 BUENOS AIRES",0,2,1,182,0,185,"2014"
"23845","260280 BUIQUE",4,2,26,836,11,879,"2014"
"23846","260290 CABO DE SANTO AGOSTINHO",8,13,59,3054,24,3158,"2014"
"23847","260300 CABROBO",2,3,8,555,1,569,"2014"
"23848","260310 CACHOEIRINHA",2,1,9,221,0,233,"2014"
"23849","260320 CAETES",1,1,6,401,2,411,"2014"
"23850","260330 CALCADO",0,0,2,139,1,142,"2014"
"23851","260340 CALUMBI",1,0,5,76,1,83,"2014"
"23852","260345 CAMARAGIBE",6,16,40,2407,13,2482,"2014"
"23853","260350 CAMOCIM DE SAO FELIX",0,1,2,197,1,201,"2014"
"23854","260360 CAMUTANGA",0,0,4,124,3,131,"2014"
"23855","260370 CANHOTINHO",2,6,7,353,2,370,"2014"
"23856","260380 CAPOEIRAS",1,1,8,278,1,289,"2014"
"23857","260390 CARNAIBA",0,1,4,279,0,284,"2014"
"23858","260392 CARNAUBEIRA DA PENHA",1,3,4,293,4,305,"2014"
"23859","260400 CARPINA",5,3,15,1078,2,1103,"2014"
"23860","260410 CARUARU",10,19,58,5629,22,5738,"2014"
"23861","260415 CASINHAS",0,0,1,165,0,166,"2014"
"23862","260420 CATENDE",1,1,10,581,0,593,"2014"
"23863","260430 CEDRO",1,0,0,152,2,155,"2014"
"23864","260440 CHA DE ALEGRIA",0,2,3,209,2,216,"2014"
"23865","260450 CHA GRANDE",2,0,3,320,1,326,"2014"
"23866","260460 CONDADO",3,1,10,357,3,374,"2014"
"23867","260470 CORRENTES",1,2,3,210,0,216,"2014"
"23868","260480 CORTES",1,0,1,213,2,217,"2014"
"23869","260490 CUMARU",1,3,0,191,2,197,"2014"
"23870","260500 CUPIRA",3,2,1,387,2,395,"2014"
"23871","260510 CUSTODIA",3,4,7,519,0,533,"2014"
"23872","260515 DORMENTES",2,2,3,192,44,243,"2014"
"23873","260520 ESCADA",5,4,19,1542,8,1578,"2014"
"23874","260530 EXU",2,8,7,482,7,506,"2014"
"23875","260540 FEIRA NOVA",2,0,15,280,0,297,"2014"
"23876","260545 FERNANDO DE NORONHA",1,0,0,21,0,22,"2014"
"23877","260550 FERREIROS",0,0,2,115,1,118,"2014"
"23878","260560 FLORES",2,0,6,253,1,262,"2014"
"23879","260570 FLORESTA",2,3,12,443,1,461,"2014"
"23880","260580 FREI MIGUELINHO",0,0,3,139,0,142,"2014"
"23881","260590 GAMELEIRA",0,0,7,365,1,373,"2014"
"23882","260600 GARANHUNS",12,7,26,2312,3,2360,"2014"
"23883","260610 GLORIA DO GOITA",2,2,3,372,2,381,"2014"
"23884","260620 GOIANA",6,3,22,1269,8,1308,"2014"
"23885","260630 GRANITO",0,1,2,111,2,116,"2014"
"23886","260640 GRAVATA",3,3,20,1236,4,1266,"2014"
"23887","260650 IATI",2,2,2,296,0,302,"2014"
"23888","260660 IBIMIRIM",1,1,9,458,4,473,"2014"
"23889","260670 IBIRAJUBA",1,0,1,92,1,95,"2014"
"23890","260680 IGARASSU",8,9,33,1616,18,1684,"2014"
"23891","260690 IGUARACY",0,1,1,162,1,165,"2014"
"23892","260700 INAJA",4,4,7,301,18,334,"2014"
"23893","260710 INGAZEIRA",0,0,1,57,0,58,"2014"
"23894","260720 IPOJUCA",7,9,27,1523,10,1576,"2014"
"23895","260730 IPUBI",0,5,10,493,1,509,"2014"
"23896","260740 ITACURUBA",0,0,1,80,0,81,"2014"
"23897","260750 ITAIBA",1,0,5,343,3,352,"2014"
"23898","260760 ILHA DE ITAMARACA",2,1,6,284,4,297,"2014"
"23899","260765 ITAMBE",3,3,6,457,3,472,"2014"
"23900","260770 ITAPETIM",2,2,0,197,0,201,"2014"
"23901","260775 ITAPISSUMA",2,2,7,349,3,363,"2014"
"23902","260780 ITAQUITINGA",0,2,0,255,1,258,"2014"
"23903","260790 JABOATAO DOS GUARARAPES",36,49,154,9509,71,9819,"2014"
"23904","260795 JAQUEIRA",0,0,4,203,3,210,"2014"
"23905","260800 JATAUBA",0,3,3,280,1,287,"2014"
"23906","260805 JATOBA",0,0,5,233,4,242,"2014"
"23907","260810 JOAO ALFREDO",1,1,4,352,1,359,"2014"
"23908","260820 JOAQUIM NABUCO",1,0,3,243,0,247,"2014"
"23909","260825 JUCATI",0,0,4,188,0,192,"2014"
"23910","260830 JUPI",2,2,5,288,2,299,"2014"
"23911","260840 JUREMA",2,1,7,182,2,194,"2014"
"23912","260845 LAGOA DO CARRO",1,1,6,229,0,237,"2014"
"23913","260850 LAGOA DE ITAENGA",2,0,10,380,3,395,"2014"
"23914","260860 LAGOA DO OURO",1,1,2,155,0,159,"2014"
"23915","260870 LAGOA DOS GATOS",2,0,1,189,0,192,"2014"
"23916","260875 LAGOA GRANDE",1,5,14,357,2,379,"2014"
"23917","260880 LAJEDO",0,2,10,689,5,706,"2014"
"23918","260890 LIMOEIRO",0,1,11,797,1,810,"2014"
"23919","260900 MACAPARANA",2,2,17,366,0,387,"2014"
"23920","260910 MACHADOS",2,0,1,185,1,189,"2014"
"23921","260915 MANARI",0,0,5,227,6,238,"2014"
"23922","260920 MARAIAL",1,0,4,224,2,231,"2014"
"23923","260930 MIRANDIBA",1,0,1,233,3,238,"2014"
"23924","260940 MORENO",0,2,17,810,4,833,"2014"
"23925","260950 NAZARE DA MATA",2,2,5,472,1,482,"2014"
"23926","260960 OLINDA",29,31,93,5869,26,6048,"2014"
"23927","260970 OROBO",0,1,7,291,1,300,"2014"
"23928","260980 OROCO",2,2,8,291,1,304,"2014"
"23929","260990 OURICURI",4,7,13,1194,9,1227,"2014"
"23930","261000 PALMARES",8,3,16,1726,4,1757,"2014"
"23931","261010 PALMEIRINA",0,1,1,107,1,110,"2014"
"23932","261020 PANELAS",0,3,6,329,1,339,"2014"
"23933","261030 PARANATAMA",0,0,1,199,0,200,"2014"
"23934","261040 PARNAMIRIM",3,3,4,286,0,296,"2014"
"23935","261050 PASSIRA",0,5,21,380,5,411,"2014"
"23936","261060 PAUDALHO",5,3,17,885,4,914,"2014"
"23937","261070 PAULISTA",24,17,72,4176,14,4303,"2014"
"23938","261080 PEDRA",1,3,4,281,1,290,"2014"
"23939","261090 PESQUEIRA",3,7,12,980,5,1007,"2014"
"23940","261100 PETROLANDIA",2,2,14,674,1,693,"2014"
"23941","261110 PETROLINA",37,35,109,6147,88,6416,"2014"
"23942","261120 POCAO",0,0,4,158,1,163,"2014"
"23943","261130 POMBOS",2,3,3,382,0,390,"2014"
"23944","261140 PRIMAVERA",1,4,2,193,1,201,"2014"
"23945","261150 QUIPAPA",4,0,4,337,1,346,"2014"
"23946","261153 QUIXABA",0,0,4,95,0,99,"2014"
"23947","261160 RECIFE",78,91,355,22844,138,23506,"2014"
"23948","261170 RIACHO DAS ALMAS",0,1,3,335,7,346,"2014"
"23949","261180 RIBEIRAO",2,4,6,866,6,884,"2014"
"23950","261190 RIO FORMOSO",0,2,6,387,0,395,"2014"
"23951","261200 SAIRE",1,0,2,112,0,115,"2014"
"23952","261210 SALGADINHO",0,0,1,64,3,68,"2014"
"23953","261220 SALGUEIRO",1,4,18,1032,0,1055,"2014"
"23954","261230 SALOA",1,0,2,247,0,250,"2014"
"23955","261240 SANHARO",2,2,6,295,2,307,"2014"
"23956","261245 SANTA CRUZ",0,1,5,254,4,264,"2014"
"23957","261247 SANTA CRUZ DA BAIXA VERDE",1,0,11,170,0,182,"2014"
"23958","261250 SANTA CRUZ DO CAPIBARIBE",6,8,14,1367,4,1399,"2014"
"23959","261255 SANTA FILOMENA",0,2,3,177,3,185,"2014"
"23960","261260 SANTA MARIA DA BOA VISTA",5,6,31,765,2,809,"2014"
"23961","261270 SANTA MARIA DO CAMBUCA",0,1,0,166,1,168,"2014"
"23962","261280 SANTA TEREZINHA",0,0,2,156,1,159,"2014"
"23963","261290 SAO BENEDITO DO SUL",0,0,4,146,1,151,"2014"
"23964","261300 SAO BENTO DO UNA",2,0,9,791,1,803,"2014"
"23965","261310 SAO CAITANO",1,2,6,473,1,483,"2014"
"23966","261320 SAO JOAO",2,4,6,321,0,333,"2014"
"23967","261330 SAO JOAQUIM DO MONTE",1,3,3,349,0,356,"2014"
"23968","261340 SAO JOSE DA COROA GRANDE",1,0,1,376,3,381,"2014"
"23969","261350 SAO JOSE DO BELMONTE",0,2,8,568,0,578,"2014"
"23970","261360 SAO JOSE DO EGITO",2,1,7,448,0,458,"2014"
"23971","261370 SAO LOURENCO DA MATA",11,10,22,1705,7,1755,"2014"
"23972","261380 SAO VICENTE FERRER",0,0,4,237,1,242,"2014"
"23973","261390 SERRA TALHADA",9,10,75,1357,9,1460,"2014"
"23974","261400 SERRITA",0,2,8,243,0,253,"2014"
"23975","261410 SERTANIA",2,4,4,394,3,407,"2014"
"23976","261420 SIRINHAEM",0,10,22,710,2,744,"2014"
"23977","261430 MOREILANDIA",0,1,2,169,1,173,"2014"
"23978","261440 SOLIDAO",0,0,2,112,0,114,"2014"
"23979","261450 SURUBIM",3,5,11,862,3,884,"2014"
"23980","261460 TABIRA",4,2,9,403,2,420,"2014"
"23981","261470 TACAIMBO",0,2,2,148,2,154,"2014"
"23982","261480 TACARATU",2,3,2,327,2,336,"2014"
"23983","261485 TAMANDARE",5,4,8,370,3,390,"2014"
"23984","261500 TAQUARITINGA DO NORTE",2,1,12,329,2,346,"2014"
"23985","261510 TEREZINHA",1,0,2,107,0,110,"2014"
"23986","261520 TERRA NOVA",0,0,5,138,1,144,"2014"
"23987","261530 TIMBAUBA",3,4,17,782,4,810,"2014"
"23988","261540 TORITAMA",6,1,7,568,2,584,"2014"
"23989","261550 TRACUNHAEM",0,3,3,203,0,209,"2014"
"23990","261560 TRINDADE",1,1,8,586,2,598,"2014"
"23991","261570 TRIUNFO",0,1,5,182,2,190,"2014"
"23992","261580 TUPANATINGA",0,2,8,289,9,308,"2014"
"23993","261590 TUPARETAMA",0,1,1,117,0,119,"2014"
"23994","261600 VENTUROSA",4,1,2,258,0,265,"2014"
"23995","261610 VERDEJANTE",3,0,3,141,0,147,"2014"
"23996","261618 VERTENTE DO LERIO",1,0,1,105,0,107,"2014"
"23997","261620 VERTENTES",1,2,0,386,0,389,"2014"
"23998","261630 VICENCIA",1,0,3,395,2,401,"2014"
"23999","261640 VITORIA DE SANTO ANTAO",6,5,17,2064,2,2094,"2014"
"24000","261650 XEXEU",1,0,4,292,1,298,"2014"
"24001","270010 AGUA BRANCA",1,0,7,142,127,277,"2014"
"24002","270020 ANADIA",0,1,4,251,7,263,"2014"
"24003","270030 ARAPIRACA",3,26,42,3989,5,4065,"2014"
"24004","270040 ATALAIA",0,1,12,487,226,726,"2014"
"24005","270050 BARRA DE SANTO ANTONIO",0,0,4,279,4,287,"2014"
"24006","270060 BARRA DE SAO MIGUEL",0,0,3,145,2,150,"2014"
"24007","270070 BATALHA",0,1,1,296,0,298,"2014"
"24008","270080 BELEM",0,0,1,77,1,79,"2014"
"24009","270090 BELO MONTE",0,0,0,95,1,96,"2014"
"24010","270100 BOCA DA MATA",2,5,7,415,3,432,"2014"
"24011","270110 BRANQUINHA",2,0,1,225,3,231,"2014"
"24012","270120 CACIMBINHAS",0,2,5,170,2,179,"2014"
"24013","270130 CAJUEIRO",2,4,1,238,127,372,"2014"
"24014","270135 CAMPESTRE",1,1,0,63,7,72,"2014"
"24015","270140 CAMPO ALEGRE",1,2,6,482,14,505,"2014"
"24016","270150 CAMPO GRANDE",0,1,4,172,2,179,"2014"
"24017","270160 CANAPI",0,0,3,214,42,259,"2014"
"24018","270170 CAPELA",1,2,0,222,9,234,"2014"
"24019","270180 CARNEIROS",0,0,2,177,0,179,"2014"
"24020","270190 CHA PRETA",0,0,2,104,11,117,"2014"
"24021","270200 COITE DO NOIA",1,4,4,173,1,183,"2014"
"24022","270210 COLONIA LEOPOLDINA",2,1,1,254,3,261,"2014"
"24023","270220 COQUEIRO SECO",0,0,0,78,1,79,"2014"
"24024","270230 CORURIPE",1,3,9,724,175,912,"2014"
"24025","270235 CRAIBAS",0,2,5,400,2,409,"2014"
"24026","270240 DELMIRO GOUVEIA",1,6,8,369,480,864,"2014"
"24027","270250 DOIS RIACHOS",0,0,1,139,0,140,"2014"
"24028","270255 ESTRELA DE ALAGOAS",0,1,2,184,0,187,"2014"
"24029","270260 FEIRA GRANDE",1,2,0,333,1,337,"2014"
"24030","270270 FELIZ DESERTO",0,0,0,61,8,69,"2014"
"24031","270280 FLEXEIRAS",0,1,3,177,7,188,"2014"
"24032","270290 GIRAU DO PONCIANO",0,1,6,567,3,577,"2014"
"24033","270300 IBATEGUARA",1,1,2,253,2,259,"2014"
"24034","270310 IGACI",0,1,6,365,0,372,"2014"
"24035","270320 IGREJA NOVA",0,1,7,359,37,404,"2014"
"24036","270330 INHAPI",3,3,5,208,96,315,"2014"
"24037","270340 JACARE DOS HOMENS",0,0,1,100,0,101,"2014"
"24038","270350 JACUIPE",0,0,2,44,1,47,"2014"
"24039","270360 JAPARATINGA",0,1,4,109,2,116,"2014"
"24040","270370 JARAMATAIA",0,0,0,122,0,122,"2014"
"24041","270375 JEQUIA DA PRAIA",0,1,2,150,18,171,"2014"
"24042","270380 JOAQUIM GOMES",0,3,4,396,13,416,"2014"
"24043","270390 JUNDIA",0,0,0,39,0,39,"2014"
"24044","270400 JUNQUEIRO",1,2,6,371,5,385,"2014"
"24045","270410 LAGOA DA CANOA",0,2,8,290,1,301,"2014"
"24046","270420 LIMOEIRO DE ANADIA",0,1,7,363,3,374,"2014"
"24047","270430 MACEIO",21,50,153,14469,193,14886,"2014"
"24048","270440 MAJOR ISIDORO",0,0,3,225,56,284,"2014"
"24049","270450 MARAGOGI",2,2,3,462,9,478,"2014"
"24050","270460 MARAVILHA",1,0,1,133,2,137,"2014"
"24051","270470 MARECHAL DEODORO",0,1,9,787,9,806,"2014"
"24052","270480 MARIBONDO",0,0,3,174,0,177,"2014"
"24053","270490 MAR VERMELHO",0,0,1,28,2,31,"2014"
"24054","270500 MATA GRANDE",0,2,2,261,103,368,"2014"
"24055","270510 MATRIZ DE CAMARAGIBE",2,2,8,449,3,464,"2014"
"24056","270520 MESSIAS",0,1,4,236,11,252,"2014"
"24057","270530 MINADOR DO NEGRAO",0,0,1,80,0,81,"2014"
"24058","270540 MONTEIROPOLIS",0,0,1,135,0,136,"2014"
"24059","270550 MURICI",1,2,3,400,139,545,"2014"
"24060","270560 NOVO LINO",0,0,5,155,8,168,"2014"
"24061","270570 OLHO D'AGUA DAS FLORES",1,1,1,363,3,369,"2014"
"24062","270580 OLHO D'AGUA DO CASADO",0,0,1,113,27,141,"2014"
"24063","270590 OLHO D'AGUA GRANDE",0,2,0,88,1,91,"2014"
"24064","270600 OLIVENCA",0,0,1,184,1,186,"2014"
"24065","270610 OURO BRANCO",0,1,1,152,0,154,"2014"
"24066","270620 PALESTINA",0,0,0,83,0,83,"2014"
"24067","270630 PALMEIRA DOS INDIOS",1,5,16,1269,0,1291,"2014"
"24068","270640 PAO DE ACUCAR",6,1,6,428,7,448,"2014"
"24069","270642 PARICONHA",0,0,4,116,64,184,"2014"
"24070","270644 PARIPUEIRA",0,0,6,196,7,209,"2014"
"24071","270650 PASSO DE CAMARAGIBE",1,2,1,219,3,226,"2014"
"24072","270660 PAULO JACINTO",0,0,2,92,11,105,"2014"
"24073","270670 PENEDO",3,3,14,962,83,1065,"2014"
"24074","270680 PIACABUCU",0,0,4,263,17,284,"2014"
"24075","270690 PILAR",3,1,5,497,80,586,"2014"
"24076","270700 PINDOBA",0,0,0,42,4,46,"2014"
"24077","270710 PIRANHAS",1,1,2,417,24,445,"2014"
"24078","270720 POCO DAS TRINCHEIRAS",0,0,3,199,1,203,"2014"
"24079","270730 PORTO CALVO",0,1,6,423,6,436,"2014"
"24080","270740 PORTO DE PEDRAS",0,0,1,107,0,108,"2014"
"24081","270750 PORTO REAL DO COLEGIO",0,1,1,322,16,340,"2014"
"24082","270760 QUEBRANGULO",1,0,5,217,11,234,"2014"
"24083","270770 RIO LARGO",0,0,13,1120,43,1176,"2014"
"24084","270780 ROTEIRO",1,1,3,128,1,134,"2014"
"24085","270790 SANTA LUZIA DO NORTE",0,0,1,114,2,117,"2014"
"24086","270800 SANTANA DO IPANEMA",2,2,9,832,7,852,"2014"
"24087","270810 SANTANA DO MUNDAU",1,1,1,163,1,167,"2014"
"24088","270820 SAO BRAS",0,0,7,122,4,133,"2014"
"24089","270830 SAO JOSE DA LAJE",1,1,7,384,6,399,"2014"
"24090","270840 SAO JOSE DA TAPERA",1,4,9,522,12,548,"2014"
"24091","270850 SAO LUIS DO QUITUNDE",1,1,3,580,10,595,"2014"
"24092","270860 SAO MIGUEL DOS CAMPOS",2,8,11,957,4,982,"2014"
"24093","270870 SAO MIGUEL DOS MILAGRES",0,0,0,77,0,77,"2014"
"24094","270880 SAO SEBASTIAO",0,3,7,578,11,599,"2014"
"24095","270890 SATUBA",0,0,2,174,3,179,"2014"
"24096","270895 SENADOR RUI PALMEIRA",0,0,3,214,8,225,"2014"
"24097","270900 TANQUE D'ARCA",0,1,3,87,0,91,"2014"
"24098","270910 TAQUARANA",1,0,7,292,0,300,"2014"
"24099","270915 TEOTONIO VILELA",2,3,15,547,127,694,"2014"
"24100","270920 TRAIPU",1,6,5,325,3,340,"2014"
"24101","270930 UNIAO DOS PALMARES",4,6,1,1143,5,1159,"2014"
"24102","270940 VICOSA",1,0,6,371,39,417,"2014"
"24103","280010 AMPARO DE SAO FRANCISCO",0,0,2,54,0,56,"2014"
"24104","280020 AQUIDABA",0,3,5,270,14,292,"2014"
"24105","280030 ARACAJU",35,35,185,9245,86,9586,"2014"
"24106","280040 ARAUA",0,0,1,157,2,160,"2014"
"24107","280050 AREIA BRANCA",0,1,9,263,9,282,"2014"
"24108","280060 BARRA DOS COQUEIROS",1,3,9,450,2,465,"2014"
"24109","280067 BOQUIM",0,1,7,352,2,362,"2014"
"24110","280070 BREJO GRANDE",0,1,5,121,3,130,"2014"
"24111","280100 CAMPO DO BRITO",0,0,6,212,6,224,"2014"
"24112","280110 CANHOBA",0,0,2,63,3,68,"2014"
"24113","280120 CANINDE DE SAO FRANCISCO",1,2,14,546,39,602,"2014"
"24114","280130 CAPELA",3,3,16,501,56,579,"2014"
"24115","280140 CARIRA",1,1,10,293,15,320,"2014"
"24116","280150 CARMOPOLIS",0,3,6,305,2,316,"2014"
"24117","280160 CEDRO DE SAO JOAO",0,0,2,75,2,79,"2014"
"24118","280170 CRISTINAPOLIS",2,0,2,311,2,317,"2014"
"24119","280190 CUMBE",0,0,0,52,7,59,"2014"
"24120","280200 DIVINA PASTORA",0,1,3,75,2,81,"2014"
"24121","280210 ESTANCIA",3,2,12,1012,5,1034,"2014"
"24122","280220 FEIRA NOVA",0,0,2,87,15,104,"2014"
"24123","280230 FREI PAULO",0,1,6,232,3,242,"2014"
"24124","280240 GARARU",1,1,4,141,11,158,"2014"
"24125","280250 GENERAL MAYNARD",0,0,1,30,2,33,"2014"
"24126","280260 GRACHO CARDOSO",0,0,1,61,6,68,"2014"
"24127","280270 ILHA DAS FLORES",1,0,1,120,4,126,"2014"
"24128","280280 INDIAROBA",0,0,2,290,0,292,"2014"
"24129","280290 ITABAIANA",5,4,49,1382,25,1465,"2014"
"24130","280300 ITABAIANINHA",0,3,5,652,3,663,"2014"
"24131","280310 ITABI",0,0,0,49,6,55,"2014"
"24132","280320 ITAPORANGA D'AJUDA",4,6,14,525,13,562,"2014"
"24133","280330 JAPARATUBA",2,3,8,269,7,289,"2014"
"24134","280340 JAPOATA",0,2,3,198,8,211,"2014"
"24135","280350 LAGARTO",4,7,21,1421,10,1463,"2014"
"24136","280360 LARANJEIRAS",3,3,16,417,7,446,"2014"
"24137","280370 MACAMBIRA",0,0,15,101,3,119,"2014"
"24138","280380 MALHADA DOS BOIS",0,1,1,69,0,71,"2014"
"24139","280390 MALHADOR",0,0,6,174,0,180,"2014"
"24140","280400 MARUIM",0,1,7,276,7,291,"2014"
"24141","280410 MOITA BONITA",1,0,6,131,2,140,"2014"
"24142","280420 MONTE ALEGRE DE SERGIPE",1,1,8,207,30,247,"2014"
"24143","280430 MURIBECA",0,0,3,106,6,115,"2014"
"24144","280440 NEOPOLIS",0,0,4,264,11,279,"2014"
"24145","280445 NOSSA SENHORA APARECIDA",0,0,7,101,3,111,"2014"
"24146","280450 NOSSA SENHORA DA GLORIA",4,3,15,497,42,561,"2014"
"24147","280460 NOSSA SENHORA DAS DORES",1,0,8,337,13,359,"2014"
"24148","280470 NOSSA SENHORA DE LOURDES",0,0,1,88,3,92,"2014"
"24149","280480 NOSSA SENHORA DO SOCORRO",16,11,70,2810,20,2927,"2014"
"24150","280490 PACATUBA",1,1,1,210,12,225,"2014"
"24151","280500 PEDRA MOLE",0,0,2,38,0,40,"2014"
"24152","280510 PEDRINHAS",1,0,1,103,1,106,"2014"
"24153","280520 PINHAO",0,1,8,99,1,109,"2014"
"24154","280530 PIRAMBU",0,0,5,153,4,162,"2014"
"24155","280540 POCO REDONDO",2,1,5,434,43,485,"2014"
"24156","280550 POCO VERDE",2,0,2,273,6,283,"2014"
"24157","280560 PORTO DA FOLHA",0,4,13,350,45,412,"2014"
"24158","280570 PROPRIA",2,2,4,446,9,463,"2014"
"24159","280580 RIACHAO DO DANTAS",0,0,2,270,4,276,"2014"
"24160","280590 RIACHUELO",1,2,8,175,1,187,"2014"
"24161","280600 RIBEIROPOLIS",0,0,8,199,5,212,"2014"
"24162","280610 ROSARIO DO CATETE",1,0,6,162,6,175,"2014"
"24163","280620 SALGADO",0,0,4,256,4,264,"2014"
"24164","280630 SANTA LUZIA DO ITANHY",0,1,3,220,0,224,"2014"
"24165","280640 SANTANA DO SAO FRANCISCO",0,1,1,104,4,110,"2014"
"24166","280650 SANTA ROSA DE LIMA",0,0,1,85,2,88,"2014"
"24167","280660 SANTO AMARO DAS BROTAS",0,1,0,187,3,191,"2014"
"24168","280670 SAO CRISTOVAO",8,4,28,1308,23,1371,"2014"
"24169","280680 SAO DOMINGOS",0,0,6,121,3,130,"2014"
"24170","280690 SAO FRANCISCO",0,0,0,61,2,63,"2014"
"24171","280700 SAO MIGUEL DO ALEIXO",0,0,2,47,5,54,"2014"
"24172","280710 SIMAO DIAS",1,0,10,553,5,569,"2014"
"24173","280720 SIRIRI",0,0,0,107,9,116,"2014"
"24174","280730 TELHA",0,1,2,46,2,51,"2014"
"24175","280740 TOBIAS BARRETO",2,4,14,699,13,732,"2014"
"24176","280750 TOMAR DO GERU",0,0,0,178,3,181,"2014"
"24177","280760 UMBAUBA",0,0,2,401,6,409,"2014"
"24178","MUNICIPIO IGNORADO - BA",0,0,1,16,12,29,"2014"
"24179","290010 ABAIRA",0,0,1,46,2,49,"2014"
"24180","290020 ABARE",0,0,6,310,2,318,"2014"
"24181","290030 ACAJUTIBA",0,0,5,167,6,178,"2014"
"24182","290035 ADUSTINA",0,0,3,169,2,174,"2014"
"24183","290040 AGUA FRIA",0,1,2,129,47,179,"2014"
"24184","290050 ERICO CARDOSO",1,1,2,31,75,110,"2014"
"24185","290060 AIQUARA",0,0,0,48,0,48,"2014"
"24186","290070 ALAGOINHAS",5,16,41,2169,126,2357,"2014"
"24187","290080 ALCOBACA",0,3,5,288,9,305,"2014"
"24188","290090 ALMADINA",0,0,3,65,0,68,"2014"
"24189","290100 AMARGOSA",0,5,13,345,91,454,"2014"
"24190","290110 AMELIA RODRIGUES",1,0,4,181,99,285,"2014"
"24191","290115 AMERICA DOURADA",1,2,4,253,2,262,"2014"
"24192","290120 ANAGE",1,1,8,263,7,280,"2014"
"24193","290130 ANDARAI",0,0,4,147,11,162,"2014"
"24194","290135 ANDORINHA",1,2,10,152,3,168,"2014"
"24195","290140 ANGICAL",0,1,3,183,2,189,"2014"
"24196","290150 ANGUERA",0,0,0,56,36,92,"2014"
"24197","290160 ANTAS",0,0,4,152,4,160,"2014"
"24198","290170 ANTONIO CARDOSO",0,0,1,101,86,188,"2014"
"24199","290180 ANTONIO GONCALVES",0,0,0,13,97,110,"2014"
"24200","290190 APORA",0,2,4,179,8,193,"2014"
"24201","290195 APUAREMA",0,1,2,59,1,63,"2014"
"24202","290200 ARACATU",1,1,3,116,33,154,"2014"
"24203","290205 ARACAS",0,2,6,177,7,192,"2014"
"24204","290210 ARACI",2,9,16,591,41,659,"2014"
"24205","290220 ARAMARI",0,0,2,91,16,109,"2014"
"24206","290225 ARATACA",0,0,9,119,2,130,"2014"
"24207","290230 ARATUIPE",0,2,27,78,22,129,"2014"
"24208","290240 AURELINO LEAL",0,2,6,180,38,226,"2014"
"24209","290250 BAIANOPOLIS",1,0,2,205,6,214,"2014"
"24210","290260 BAIXA GRANDE",1,3,6,205,10,225,"2014"
"24211","290265 BANZAE",0,0,2,19,156,177,"2014"
"24212","290270 BARRA",8,4,16,853,2,883,"2014"
"24213","290280 BARRA DA ESTIVA",1,6,8,320,16,351,"2014"
"24214","290290 BARRA DO CHOCA",1,3,12,529,18,563,"2014"
"24215","290300 BARRA DO MENDES",1,1,6,160,2,170,"2014"
"24216","290310 BARRA DO ROCHA",0,0,1,69,0,70,"2014"
"24217","290320 BARREIRAS",8,12,59,2652,12,2743,"2014"
"24218","290323 BARRO ALTO",0,1,2,145,0,148,"2014"
"24219","290327 BARROCAS",0,2,3,211,14,230,"2014"
"24220","290330 BARRO PRETO",0,0,4,74,0,78,"2014"
"24221","290340 BELMONTE",4,1,7,301,6,319,"2014"
"24222","290350 BELO CAMPO",0,4,10,198,3,215,"2014"
"24223","290360 BIRITINGA",6,0,2,211,21,240,"2014"
"24224","290370 BOA NOVA",0,1,6,138,9,154,"2014"
"24225","290380 BOA VISTA DO TUPIM",0,1,4,232,4,241,"2014"
"24226","290390 BOM JESUS DA LAPA",6,2,21,1103,4,1136,"2014"
"24227","290395 BOM JESUS DA SERRA",0,1,5,112,5,123,"2014"
"24228","290400 BONINAL",0,1,5,133,7,146,"2014"
"24229","290405 BONITO",0,5,8,188,6,207,"2014"
"24230","290410 BOQUIRA",0,2,3,216,31,252,"2014"
"24231","290420 BOTUPORA",1,1,1,79,37,119,"2014"
"24232","290430 BREJOES",1,1,1,174,4,181,"2014"
"24233","290440 BREJOLANDIA",0,1,1,67,0,69,"2014"
"24234","290450 BROTAS DE MACAUBAS",0,0,2,112,0,114,"2014"
"24235","290460 BRUMADO",1,1,5,575,342,924,"2014"
"24236","290470 BUERAREMA",1,2,8,229,3,243,"2014"
"24237","290475 BURITIRAMA",1,3,8,308,4,324,"2014"
"24238","290480 CAATIBA",0,0,1,52,53,106,"2014"
"24239","290485 CABACEIRAS DO PARAGUACU",0,1,0,97,118,216,"2014"
"24240","290490 CACHOEIRA",2,0,2,253,185,442,"2014"
"24241","290500 CACULE",3,3,5,256,37,304,"2014"
"24242","290510 CAEM",0,1,3,122,2,128,"2014"
"24243","290515 CAETANOS",0,0,3,138,2,143,"2014"
"24244","290520 CAETITE",0,2,7,664,20,693,"2014"
"24245","290530 CAFARNAUM",2,2,7,288,2,301,"2014"
"24246","290540 CAIRU",2,5,83,152,3,245,"2014"
"24247","290550 CALDEIRAO GRANDE",1,1,1,159,1,163,"2014"
"24248","290560 CAMACAN",0,5,6,392,3,406,"2014"
"24249","290570 CAMACARI",32,21,77,4158,34,4322,"2014"
"24250","290580 CAMAMU",2,2,33,379,18,434,"2014"
"24251","290590 CAMPO ALEGRE DE LOURDES",2,1,1,468,13,485,"2014"
"24252","290600 CAMPO FORMOSO",1,2,4,93,977,1077,"2014"
"24253","290610 CANAPOLIS",0,0,4,139,0,143,"2014"
"24254","290620 CANARANA",1,3,8,323,1,336,"2014"
"24255","290630 CANAVIEIRAS",0,1,4,376,80,461,"2014"
"24256","290640 CANDEAL",0,0,2,49,40,91,"2014"
"24257","290650 CANDEIAS",4,9,24,1029,72,1138,"2014"
"24258","290660 CANDIBA",0,1,0,144,2,147,"2014"
"24259","290670 CANDIDO SALES",1,3,12,336,6,358,"2014"
"24260","290680 CANSANCAO",0,5,6,461,9,481,"2014"
"24261","290682 CANUDOS",1,0,6,209,31,247,"2014"
"24262","290685 CAPELA DO ALTO ALEGRE",0,0,2,88,8,98,"2014"
"24263","290687 CAPIM GROSSO",1,3,7,431,8,450,"2014"
"24264","290689 CARAIBAS",0,0,2,97,2,101,"2014"
"24265","290690 CARAVELAS",0,1,4,231,2,238,"2014"
"24266","290700 CARDEAL DA SILVA",0,1,1,121,4,127,"2014"
"24267","290710 CARINHANHA",1,1,5,455,19,481,"2014"
"24268","290720 CASA NOVA",2,3,20,1045,22,1092,"2014"
"24269","290730 CASTRO ALVES",1,1,6,226,26,260,"2014"
"24270","290740 CATOLANDIA",0,0,3,46,0,49,"2014"
"24271","290750 CATU",3,3,10,665,5,686,"2014"
"24272","290755 CATURAMA",0,0,1,33,40,74,"2014"
"24273","290760 CENTRAL",0,3,10,234,1,248,"2014"
"24274","290770 CHORROCHO",0,0,7,152,4,163,"2014"
"24275","290780 CICERO DANTAS",0,2,8,280,39,329,"2014"
"24276","290790 CIPO",0,1,5,135,79,220,"2014"
"24277","290800 COARACI",2,3,8,248,5,266,"2014"
"24278","290810 COCOS",0,1,1,174,108,284,"2014"
"24279","290820 CONCEICAO DA FEIRA",0,1,2,72,149,224,"2014"
"24280","290830 CONCEICAO DO ALMEIDA",0,0,4,117,25,146,"2014"
"24281","290840 CONCEICAO DO COITE",1,6,28,966,73,1074,"2014"
"24282","290850 CONCEICAO DO JACUIPE",0,3,2,257,157,419,"2014"
"24283","290860 CONDE",1,2,4,343,6,356,"2014"
"24284","290870 CONDEUBA",1,0,6,187,2,196,"2014"
"24285","290880 CONTENDAS DO SINCORA",0,0,1,37,17,55,"2014"
"24286","290890 CORACAO DE MARIA",0,0,0,165,117,282,"2014"
"24287","290900 CORDEIROS",2,1,4,64,1,72,"2014"
"24288","290910 CORIBE",5,1,5,182,0,193,"2014"
"24289","290920 CORONEL JOAO SA",0,0,3,175,5,183,"2014"
"24290","290930 CORRENTINA",2,0,8,331,80,421,"2014"
"24291","290940 COTEGIPE",2,0,4,158,14,178,"2014"
"24292","290950 CRAVOLANDIA",0,0,3,53,0,56,"2014"
"24293","290960 CRISOPOLIS",0,1,5,241,6,253,"2014"
"24294","290970 CRISTOPOLIS",1,1,5,178,1,186,"2014"
"24295","290980 CRUZ DAS ALMAS",3,6,7,644,105,765,"2014"
"24296","290990 CURACA",3,8,12,497,4,524,"2014"
"24297","291000 DARIO MEIRA",2,0,2,122,4,130,"2014"
"24298","291005 DIAS D'AVILA",3,10,24,1018,11,1066,"2014"
"24299","291010 DOM BASILIO",0,1,4,117,3,125,"2014"
"24300","291020 DOM MACEDO COSTA",0,0,0,21,17,38,"2014"
"24301","291030 ELISIO MEDRADO",1,1,0,35,24,61,"2014"
"24302","291040 ENCRUZILHADA",1,3,6,217,12,239,"2014"
"24303","291050 ENTRE RIOS",1,3,7,511,7,529,"2014"
"24304","291060 ESPLANADA",1,1,13,430,4,449,"2014"
"24305","291070 EUCLIDES DA CUNHA",2,5,19,657,82,765,"2014"
"24306","291072 EUNAPOLIS",1,11,32,1630,31,1705,"2014"
"24307","291075 FATIMA",0,2,5,175,15,197,"2014"
"24308","291077 FEIRA DA MATA",0,0,2,44,2,48,"2014"
"24309","291080 FEIRA DE SANTANA",15,18,78,5786,3774,9671,"2014"
"24310","291085 FILADELFIA",1,1,7,244,8,261,"2014"
"24311","291090 FIRMINO ALVES",0,1,0,39,13,53,"2014"
"24312","291100 FLORESTA AZUL",0,0,6,113,2,121,"2014"
"24313","291110 FORMOSA DO RIO PRETO",4,0,4,358,24,390,"2014"
"24314","291120 GANDU",0,10,19,410,6,445,"2014"
"24315","291125 GAVIAO",0,0,0,43,2,45,"2014"
"24316","291130 GENTIO DO OURO",0,3,1,143,0,147,"2014"
"24317","291140 GLORIA",1,5,11,256,2,275,"2014"
"24318","291150 GONGOGI",0,0,9,85,2,96,"2014"
"24319","291160 GOVERNADOR MANGABEIRA",1,1,3,108,166,279,"2014"
"24320","291165 GUAJERU",0,0,2,61,17,80,"2014"
"24321","291170 GUANAMBI",4,9,32,1083,129,1257,"2014"
"24322","291180 GUARATINGA",1,1,8,239,11,260,"2014"
"24323","291185 HELIOPOLIS",0,0,2,90,32,124,"2014"
"24324","291190 IACU",0,5,10,395,7,417,"2014"
"24325","291200 IBIASSUCE",0,0,0,97,2,99,"2014"
"24326","291210 IBICARAI",0,2,8,290,4,304,"2014"
"24327","291220 IBICOARA",1,2,7,248,32,290,"2014"
"24328","291230 IBICUI",2,0,5,150,7,164,"2014"
"24329","291240 IBIPEBA",2,4,3,192,6,207,"2014"
"24330","291250 IBIPITANGA",1,1,0,66,106,174,"2014"
"24331","291260 IBIQUERA",1,1,0,50,1,53,"2014"
"24332","291270 IBIRAPITANGA",5,3,15,327,4,354,"2014"
"24333","291280 IBIRAPUA",1,0,3,97,5,106,"2014"
"24334","291290 IBIRATAIA",2,0,3,279,0,284,"2014"
"24335","291300 IBITIARA",1,1,3,168,11,184,"2014"
"24336","291310 IBITITA",0,4,2,237,0,243,"2014"
"24337","291320 IBOTIRAMA",1,6,29,370,3,409,"2014"
"24338","291330 ICHU",0,2,3,45,8,58,"2014"
"24339","291340 IGAPORA",0,1,4,157,11,173,"2014"
"24340","291345 IGRAPIUNA",1,3,14,122,26,166,"2014"
"24341","291350 IGUAI",4,1,2,309,2,318,"2014"
"24342","291360 ILHEUS",5,8,15,779,1733,2540,"2014"
"24343","291370 INHAMBUPE",3,10,12,359,14,398,"2014"
"24344","291380 IPECAETA",0,0,2,84,80,166,"2014"
"24345","291390 IPIAU",2,4,7,627,3,643,"2014"
"24346","291400 IPIRA",3,4,10,767,72,856,"2014"
"24347","291410 IPUPIARA",1,0,1,99,1,102,"2014"
"24348","291420 IRAJUBA",2,0,2,78,2,84,"2014"
"24349","291430 IRAMAIA",1,0,1,113,3,118,"2014"
"24350","291440 IRAQUARA",1,1,12,337,2,353,"2014"
"24351","291450 IRARA",0,1,6,228,115,350,"2014"
"24352","291460 IRECE",5,3,17,1161,1,1187,"2014"
"24353","291465 ITABELA",2,3,9,526,1,541,"2014"
"24354","291470 ITABERABA",6,1,15,893,6,921,"2014"
"24355","291480 ITABUNA",17,24,87,3014,3,3145,"2014"
"24356","291490 ITACARE",0,3,4,159,148,314,"2014"
"24357","291500 ITAETE",0,3,3,213,2,221,"2014"
"24358","291510 ITAGI",0,1,3,170,2,176,"2014"
"24359","291520 ITAGIBA",0,1,1,204,0,206,"2014"
"24360","291530 ITAGIMIRIM",0,1,4,97,2,104,"2014"
"24361","291535 ITAGUACU DA BAHIA",1,0,3,157,0,161,"2014"
"24362","291540 ITAJU DO COLONIA",0,1,4,77,1,83,"2014"
"24363","291550 ITAJUIPE",2,1,6,262,2,273,"2014"
"24364","291560 ITAMARAJU",1,11,19,1027,23,1081,"2014"
"24365","291570 ITAMARI",1,1,4,71,2,79,"2014"
"24366","291580 ITAMBE",1,2,10,243,20,276,"2014"
"24367","291590 ITANAGRA",0,0,2,83,3,88,"2014"
"24368","291600 ITANHEM",0,0,9,226,0,235,"2014"
"24369","291610 ITAPARICA",1,2,11,229,4,247,"2014"
"24370","291620 ITAPE",0,0,2,125,0,127,"2014"
"24371","291630 ITAPEBI",2,2,3,117,5,129,"2014"
"24372","291640 ITAPETINGA",4,0,1,263,814,1082,"2014"
"24373","291650 ITAPICURU",3,3,9,374,18,407,"2014"
"24374","291660 ITAPITANGA",0,3,4,85,3,95,"2014"
"24375","291670 ITAQUARA",0,2,3,89,7,101,"2014"
"24376","291680 ITARANTIM",1,2,1,184,61,249,"2014"
"24377","291685 ITATIM",0,1,3,152,43,199,"2014"
"24378","291690 ITIRUCU",0,2,5,136,1,144,"2014"
"24379","291700 ITIUBA",2,1,10,459,23,495,"2014"
"24380","291710 ITORORO",1,0,0,47,155,203,"2014"
"24381","291720 ITUACU",0,1,3,188,71,263,"2014"
"24382","291730 ITUBERA",4,2,28,317,3,354,"2014"
"24383","291733 IUIU",1,1,3,115,21,141,"2014"
"24384","291735 JABORANDI",0,0,2,127,2,131,"2014"
"24385","291740 JACARACI",0,1,5,123,5,134,"2014"
"24386","291750 JACOBINA",3,12,42,1131,16,1204,"2014"
"24387","291760 JAGUAQUARA",1,6,16,705,4,732,"2014"
"24388","291770 JAGUARARI",2,0,8,376,32,418,"2014"
"24389","291780 JAGUARIPE",1,2,17,100,41,161,"2014"
"24390","291790 JANDAIRA",1,3,3,161,0,168,"2014"
"24391","291800 JEQUIE",7,11,51,2513,21,2603,"2014"
"24392","291810 JEREMOABO",0,4,21,436,25,486,"2014"
"24393","291820 JIQUIRICA",0,1,4,121,27,153,"2014"
"24394","291830 JITAUNA",0,0,4,167,4,175,"2014"
"24395","291835 JOAO DOURADO",0,3,14,342,2,361,"2014"
"24396","291840 JUAZEIRO",16,29,66,3801,40,3952,"2014"
"24397","291845 JUCURUCU",0,0,3,91,3,97,"2014"
"24398","291850 JUSSARA",0,5,12,207,1,225,"2014"
"24399","291855 JUSSARI",0,0,3,88,0,91,"2014"
"24400","291860 JUSSIAPE",0,0,4,55,2,61,"2014"
"24401","291870 LAFAIETE COUTINHO",1,1,0,29,0,31,"2014"
"24402","291875 LAGOA REAL",0,1,1,129,2,133,"2014"
"24403","291880 LAJE",0,1,4,197,80,282,"2014"
"24404","291890 LAJEDAO",0,0,1,36,0,37,"2014"
"24405","291900 LAJEDINHO",0,0,0,44,1,45,"2014"
"24406","291905 LAJEDO DO TABOCAL",0,0,1,56,2,59,"2014"
"24407","291910 LAMARAO",0,0,2,85,26,113,"2014"
"24408","291915 LAPAO",1,1,20,397,1,420,"2014"
"24409","291920 LAURO DE FREITAS",17,11,50,3171,35,3284,"2014"
"24410","291930 LENCOIS",0,1,4,148,2,155,"2014"
"24411","291940 LICINIO DE ALMEIDA",1,1,2,118,3,125,"2014"
"24412","291950 LIVRAMENTO DE NOSSA SENHORA",0,2,5,516,13,536,"2014"
"24413","291955 LUIS EDUARDO MAGALHAES",4,5,23,1644,5,1681,"2014"
"24414","291960 MACAJUBA",0,1,10,129,4,144,"2014"
"24415","291970 MACARANI",1,1,2,128,63,195,"2014"
"24416","291980 MACAUBAS",6,3,10,528,29,576,"2014"
"24417","291990 MACURURE",0,1,4,106,1,112,"2014"
"24418","291992 MADRE DE DEUS",1,1,2,312,1,317,"2014"
"24419","291995 MAETINGA",0,0,0,79,2,81,"2014"
"24420","292000 MAIQUINIQUE",0,0,5,77,51,133,"2014"
"24421","292010 MAIRI",1,3,1,181,12,198,"2014"
"24422","292020 MALHADA",0,1,3,240,14,258,"2014"
"24423","292030 MALHADA DE PEDRAS",0,0,3,66,40,109,"2014"
"24424","292040 MANOEL VITORINO",1,1,5,168,3,178,"2014"
"24425","292045 MANSIDAO",0,1,2,83,0,86,"2014"
"24426","292050 MARACAS",3,1,8,360,1,373,"2014"
"24427","292060 MARAGOGIPE",2,0,3,199,296,500,"2014"
"24428","292070 MARAU",0,2,4,127,74,207,"2014"
"24429","292080 MARCIONILIO SOUZA",0,1,0,130,3,134,"2014"
"24430","292090 MASCOTE",1,0,4,168,2,175,"2014"
"24431","292100 MATA DE SAO JOAO",4,5,12,725,9,755,"2014"
"24432","292105 MATINA",0,1,5,131,12,149,"2014"
"24433","292110 MEDEIROS NETO",0,5,6,276,0,287,"2014"
"24434","292120 MIGUEL CALMON",0,4,11,386,5,406,"2014"
"24435","292130 MILAGRES",0,1,2,99,28,130,"2014"
"24436","292140 MIRANGABA",0,1,5,198,5,209,"2014"
"24437","292145 MIRANTE",0,1,2,82,7,92,"2014"
"24438","292150 MONTE SANTO",0,4,20,561,95,680,"2014"
"24439","292160 MORPARA",0,1,3,93,1,98,"2014"
"24440","292170 MORRO DO CHAPEU",4,0,12,487,3,506,"2014"
"24441","292180 MORTUGABA",1,0,4,93,2,100,"2014"
"24442","292190 MUCUGE",0,0,2,38,145,185,"2014"
"24443","292200 MUCURI",0,6,15,646,0,667,"2014"
"24444","292205 MULUNGU DO MORRO",1,4,6,226,1,238,"2014"
"24445","292210 MUNDO NOVO",2,0,1,194,21,218,"2014"
"24446","292220 MUNIZ FERREIRA",0,0,1,32,35,68,"2014"
"24447","292225 MUQUEM DE SAO FRANCISCO",2,3,15,152,0,172,"2014"
"24448","292230 MURITIBA",0,0,3,153,175,331,"2014"
"24449","292240 MUTUIPE",2,2,4,186,74,268,"2014"
"24450","292250 NAZARE",1,1,17,216,80,315,"2014"
"24451","292260 NILO PECANHA",0,3,40,135,6,184,"2014"
"24452","292265 NORDESTINA",0,2,3,141,4,150,"2014"
"24453","292270 NOVA CANAA",2,2,7,182,2,195,"2014"
"24454","292273 NOVA FATIMA",0,0,2,93,12,107,"2014"
"24455","292275 NOVA IBIA",1,1,2,65,0,69,"2014"
"24456","292280 NOVA ITARANA",0,0,5,115,5,125,"2014"
"24457","292285 NOVA REDENCAO",0,0,2,78,7,87,"2014"
"24458","292290 NOVA SOURE",3,2,10,269,63,347,"2014"
"24459","292300 NOVA VICOSA",7,4,13,691,2,717,"2014"
"24460","292303 NOVO HORIZONTE",0,0,5,127,2,134,"2014"
"24461","292305 NOVO TRIUNFO",0,1,2,85,4,92,"2014"
"24462","292310 OLINDINA",1,1,9,293,32,336,"2014"
"24463","292320 OLIVEIRA DOS BREJINHOS",0,2,12,225,7,246,"2014"
"24464","292330 OURICANGAS",0,0,1,83,3,87,"2014"
"24465","292335 OUROLANDIA",1,2,4,239,6,252,"2014"
"24466","292340 PALMAS DE MONTE ALTO",0,1,4,281,27,313,"2014"
"24467","292350 PALMEIRAS",2,0,4,137,11,154,"2014"
"24468","292360 PARAMIRIM",0,5,1,70,175,251,"2014"
"24469","292370 PARATINGA",2,4,11,455,7,479,"2014"
"24470","292380 PARIPIRANGA",0,1,7,354,3,365,"2014"
"24471","292390 PAU BRASIL",0,2,8,130,10,150,"2014"
"24472","292400 PAULO AFONSO",5,11,63,1744,21,1844,"2014"
"24473","292405 PE DE SERRA",1,0,2,127,17,147,"2014"
"24474","292410 PEDRAO",0,2,1,51,12,66,"2014"
"24475","292420 PEDRO ALEXANDRE",0,0,11,202,5,218,"2014"
"24476","292430 PIATA",1,5,5,284,2,297,"2014"
"24477","292440 PILAO ARCADO",1,1,6,530,23,561,"2014"
"24478","292450 PINDAI",1,0,1,190,10,202,"2014"
"24479","292460 PINDOBACU",1,0,1,299,6,307,"2014"
"24480","292465 PINTADAS",0,0,4,72,15,91,"2014"
"24481","292467 PIRAI DO NORTE",0,2,17,78,7,104,"2014"
"24482","292470 PIRIPA",0,0,2,120,0,122,"2014"
"24483","292480 PIRITIBA",2,4,7,193,2,208,"2014"
"24484","292490 PLANALTINO",0,0,2,81,1,84,"2014"
"24485","292500 PLANALTO",1,1,5,300,10,317,"2014"
"24486","292510 POCOES",2,4,26,621,14,667,"2014"
"24487","292520 POJUCA",1,2,8,503,1,515,"2014"
"24488","292525 PONTO NOVO",0,4,10,215,23,252,"2014"
"24489","292530 PORTO SEGURO",8,13,47,2404,93,2565,"2014"
"24490","292540 POTIRAGUA",1,1,0,104,17,123,"2014"
"24491","292550 PRADO",2,2,4,397,2,407,"2014"
"24492","292560 PRESIDENTE DUTRA",5,3,2,158,1,169,"2014"
"24493","292570 PRESIDENTE JANIO QUADROS",0,0,3,114,8,125,"2014"
"24494","292575 PRESIDENTE TANCREDO NEVES",0,3,27,211,71,312,"2014"
"24495","292580 QUEIMADAS",0,0,4,319,1,324,"2014"
"24496","292590 QUIJINGUE",3,1,10,267,25,306,"2014"
"24497","292593 QUIXABEIRA",0,0,2,106,0,108,"2014"
"24498","292595 RAFAEL JAMBEIRO",2,3,2,200,67,274,"2014"
"24499","292600 REMANSO",2,1,1,655,4,663,"2014"
"24500","292610 RETIROLANDIA",0,1,5,181,18,205,"2014"
"24501","292620 RIACHAO DAS NEVES",0,1,2,283,8,294,"2014"
"24502","292630 RIACHAO DO JACUIPE",2,1,10,358,21,392,"2014"
"24503","292640 RIACHO DE SANTANA",1,1,5,425,15,447,"2014"
"24504","292650 RIBEIRA DO AMPARO",0,0,2,44,160,206,"2014"
"24505","292660 RIBEIRA DO POMBAL",0,3,4,96,696,799,"2014"
"24506","292665 RIBEIRAO DO LARGO",0,1,2,50,8,61,"2014"
"24507","292670 RIO DE CONTAS",0,2,2,137,11,152,"2014"
"24508","292680 RIO DO ANTONIO",0,1,0,106,29,136,"2014"
"24509","292690 RIO DO PIRES",1,0,0,32,93,126,"2014"
"24510","292700 RIO REAL",1,0,5,516,4,526,"2014"
"24511","292710 RODELAS",2,0,2,155,5,164,"2014"
"24512","292720 RUY BARBOSA",1,2,11,453,4,471,"2014"
"24513","292730 SALINAS DA MARGARIDA",0,2,4,168,21,195,"2014"
"24514","292740 SALVADOR",179,187,692,35316,302,36676,"2014"
"24515","292750 SANTA BARBARA",0,0,1,171,109,281,"2014"
"24516","292760 SANTA BRIGIDA",1,2,8,189,8,208,"2014"
"24517","292770 SANTA CRUZ CABRALIA",1,1,7,400,6,415,"2014"
"24518","292780 SANTA CRUZ DA VITORIA",0,0,1,52,4,57,"2014"
"24519","292790 SANTA INES",1,0,0,115,4,120,"2014"
"24520","292800 SANTALUZ",2,3,17,583,6,611,"2014"
"24521","292805 SANTA LUZIA",1,1,3,169,6,180,"2014"
"24522","292810 SANTA MARIA DA VITORIA",3,3,3,547,17,573,"2014"
"24523","292820 SANTANA",2,0,4,311,0,317,"2014"
"24524","292830 SANTANOPOLIS",0,0,0,41,36,77,"2014"
"24525","292840 SANTA RITA DE CASSIA",2,4,8,412,7,433,"2014"
"24526","292850 SANTA TERESINHA",1,0,3,110,10,124,"2014"
"24527","292860 SANTO AMARO",2,5,23,595,34,659,"2014"
"24528","292870 SANTO ANTONIO DE JESUS",3,3,11,773,584,1374,"2014"
"24529","292880 SANTO ESTEVAO",1,1,5,464,269,740,"2014"
"24530","292890 SAO DESIDERIO",1,5,12,547,1,566,"2014"
"24531","292895 SAO DOMINGOS",0,2,4,59,14,79,"2014"
"24532","292900 SAO FELIX",0,1,3,26,135,165,"2014"
"24533","292905 SAO FELIX DO CORIBE",0,0,6,181,54,241,"2014"
"24534","292910 SAO FELIPE",1,2,1,143,66,213,"2014"
"24535","292920 SAO FRANCISCO DO CONDE",2,1,12,599,25,639,"2014"
"24536","292925 SAO GABRIEL",1,2,5,255,5,268,"2014"
"24537","292930 SAO GONCALO DOS CAMPOS",0,1,3,263,166,433,"2014"
"24538","292935 SAO JOSE DA VITORIA",0,1,3,87,0,91,"2014"
"24539","292937 SAO JOSE DO JACUIPE",0,0,2,112,3,117,"2014"
"24540","292940 SAO MIGUEL DAS MATAS",0,0,1,54,47,102,"2014"
"24541","292950 SAO SEBASTIAO DO PASSE",1,4,11,494,16,526,"2014"
"24542","292960 SAPEACU",0,1,2,231,16,250,"2014"
"24543","292970 SATIRO DIAS",2,2,7,174,6,191,"2014"
"24544","292975 SAUBARA",0,1,6,99,2,108,"2014"
"24545","292980 SAUDE",0,0,6,92,3,101,"2014"
"24546","292990 SEABRA",4,1,8,578,10,601,"2014"
"24547","293000 SEBASTIAO LARANJEIRAS",0,0,0,94,8,102,"2014"
"24548","293010 SENHOR DO BONFIM",4,14,31,1059,38,1146,"2014"
"24549","293015 SERRA DO RAMALHO",1,4,6,511,0,522,"2014"
"24550","293020 SENTO SE",1,4,13,464,2,484,"2014"
"24551","293030 SERRA DOURADA",0,0,13,219,0,232,"2014"
"24552","293040 SERRA PRETA",2,2,1,82,57,144,"2014"
"24553","293050 SERRINHA",3,5,14,1070,46,1138,"2014"
"24554","293060 SERROLANDIA",0,3,4,158,4,169,"2014"
"24555","293070 SIMOES FILHO",7,10,30,1792,9,1848,"2014"
"24556","293075 SITIO DO MATO",0,0,7,191,5,203,"2014"
"24557","293076 SITIO DO QUINTO",1,0,8,132,7,148,"2014"
"24558","293077 SOBRADINHO",2,2,9,372,6,391,"2014"
"24559","293080 SOUTO SOARES",1,1,4,228,1,235,"2014"
"24560","293090 TABOCAS DO BREJO VELHO",0,0,1,149,1,151,"2014"
"24561","293100 TANHACU",0,2,7,139,116,264,"2014"
"24562","293105 TANQUE NOVO",1,3,6,126,70,206,"2014"
"24563","293110 TANQUINHO",0,1,0,29,41,71,"2014"
"24564","293120 TAPEROA",1,2,65,179,10,257,"2014"
"24565","293130 TAPIRAMUTA",1,3,6,206,8,224,"2014"
"24566","293135 TEIXEIRA DE FREITAS",4,13,37,2585,11,2650,"2014"
"24567","293140 TEODORO SAMPAIO",3,0,1,32,22,58,"2014"
"24568","293150 TEOFILANDIA",1,5,4,282,18,310,"2014"
"24569","293160 TEOLANDIA",0,3,18,151,8,180,"2014"
"24570","293170 TERRA NOVA",0,1,2,88,27,118,"2014"
"24571","293180 TREMEDAL",2,0,7,170,2,181,"2014"
"24572","293190 TUCANO",0,7,3,553,75,638,"2014"
"24573","293200 UAUA",2,2,7,270,3,284,"2014"
"24574","293210 UBAIRA",0,1,8,229,29,267,"2014"
"24575","293220 UBAITABA",1,2,3,228,65,299,"2014"
"24576","293230 UBATA",1,2,6,205,0,214,"2014"
"24577","293240 UIBAI",1,1,4,161,0,167,"2014"
"24578","293245 UMBURANAS",9,13,5,132,8,167,"2014"
"24579","293250 UNA",1,1,3,79,178,262,"2014"
"24580","293260 URANDI",0,2,7,206,9,224,"2014"
"24581","293270 URUCUCA",0,1,2,98,221,322,"2014"
"24582","293280 UTINGA",0,0,8,270,5,283,"2014"
"24583","293290 VALENCA",4,22,508,860,15,1409,"2014"
"24584","293300 VALENTE",1,0,7,210,30,248,"2014"
"24585","293305 VARZEA DA ROCA",0,2,2,132,4,140,"2014"
"24586","293310 VARZEA DO POCO",0,1,4,79,1,85,"2014"
"24587","293315 VARZEA NOVA",0,0,6,133,1,140,"2014"
"24588","293317 VARZEDO",0,0,0,73,43,116,"2014"
"24589","293320 VERA CRUZ",4,4,16,448,17,489,"2014"
"24590","293325 VEREDA",0,0,2,83,0,85,"2014"
"24591","293330 VITORIA DA CONQUISTA",24,24,141,5123,55,5367,"2014"
"24592","293340 WAGNER",0,0,0,109,11,120,"2014"
"24593","293345 WANDERLEY",1,1,2,177,1,182,"2014"
"24594","293350 WENCESLAU GUIMARAES",0,3,16,293,15,327,"2014"
"24595","293360 XIQUE-XIQUE",4,7,10,785,39,845,"2014"
"24596","MUNICIPIO IGNORADO - MG",0,0,0,5,1,6,"2014"
"24597","310010 ABADIA DOS DOURADOS",0,0,1,70,0,71,"2014"
"24598","310020 ABAETE",0,0,5,255,0,260,"2014"
"24599","310030 ABRE CAMPO",1,0,1,129,27,158,"2014"
"24600","310040 ACAIACA",0,0,1,37,0,38,"2014"
"24601","310050 ACUCENA",0,0,1,95,0,96,"2014"
"24602","310060 AGUA BOA",0,2,0,148,0,150,"2014"
"24603","310070 AGUA COMPRIDA",0,0,0,20,1,21,"2014"
"24604","310080 AGUANIL",0,0,1,52,0,53,"2014"
"24605","310090 AGUAS FORMOSAS",1,0,3,255,3,262,"2014"
"24606","310100 AGUAS VERMELHAS",0,0,3,157,2,162,"2014"
"24607","310110 AIMORES",1,3,4,310,2,320,"2014"
"24608","310120 AIURUOCA",0,0,1,42,0,43,"2014"
"24609","310130 ALAGOA",0,0,1,27,0,28,"2014"
"24610","310140 ALBERTINA",0,0,0,22,0,22,"2014"
"24611","310150 ALEM PARAIBA",1,3,8,442,2,456,"2014"
"24612","310160 ALFENAS",4,2,14,997,7,1024,"2014"
"24613","310163 ALFREDO VASCONCELOS",0,1,1,70,0,72,"2014"
"24614","310170 ALMENARA",4,5,16,514,3,542,"2014"
"24615","310180 ALPERCATA",2,0,3,78,8,91,"2014"
"24616","310190 ALPINOPOLIS",0,0,6,277,1,284,"2014"
"24617","310200 ALTEROSA",1,0,1,167,1,170,"2014"
"24618","310205 ALTO CAPARAO",1,0,0,59,8,68,"2014"
"24619","310210 ALTO RIO DOCE",0,0,1,96,1,98,"2014"
"24620","310220 ALVARENGA",0,0,2,36,3,41,"2014"
"24621","310230 ALVINOPOLIS",1,0,1,143,0,145,"2014"
"24622","310240 ALVORADA DE MINAS",0,0,1,47,1,49,"2014"
"24623","310250 AMPARO DO SERRA",0,0,2,53,0,55,"2014"
"24624","310260 ANDRADAS",0,1,2,448,0,451,"2014"
"24625","310270 CACHOEIRA DE PAJEU",2,1,3,90,3,99,"2014"
"24626","310280 ANDRELANDIA",0,1,2,109,0,112,"2014"
"24627","310285 ANGELANDIA",0,0,5,134,1,140,"2014"
"24628","310290 ANTONIO CARLOS",0,1,0,104,0,105,"2014"
"24629","310300 ANTONIO DIAS",0,0,3,106,1,110,"2014"
"24630","310310 ANTONIO PRADO DE MINAS",0,0,0,9,0,9,"2014"
"24631","310320 ARACAI",0,0,0,20,0,20,"2014"
"24632","310330 ARACITABA",0,0,0,15,0,15,"2014"
"24633","310340 ARACUAI",0,4,12,446,8,470,"2014"
"24634","310350 ARAGUARI",2,4,18,1357,6,1387,"2014"
"24635","310360 ARANTINA",0,0,1,41,0,42,"2014"
"24636","310370 ARAPONGA",0,1,1,88,6,96,"2014"
"24637","310375 ARAPORA",1,0,1,117,4,123,"2014"
"24638","310380 ARAPUA",0,0,0,22,0,22,"2014"
"24639","310390 ARAUJOS",0,0,0,120,0,120,"2014"
"24640","310400 ARAXA",6,4,10,1376,5,1401,"2014"
"24641","310410 ARCEBURGO",0,2,1,84,1,88,"2014"
"24642","310420 ARCOS",0,2,4,463,2,471,"2014"
"24643","310430 AREADO",1,1,0,171,1,174,"2014"
"24644","310440 ARGIRITA",0,0,1,30,0,31,"2014"
"24645","310445 ARICANDUVA",0,0,0,60,0,60,"2014"
"24646","310450 ARINOS",1,0,3,206,7,217,"2014"
"24647","310460 ASTOLFO DUTRA",0,1,2,121,1,125,"2014"
"24648","310470 ATALEIA",1,1,3,160,2,167,"2014"
"24649","310480 AUGUSTO DE LIMA",0,0,1,60,1,62,"2014"
"24650","310490 BAEPENDI",0,0,2,164,1,167,"2014"
"24651","310500 BALDIM",1,0,2,103,0,106,"2014"
"24652","310510 BAMBUI",1,0,2,248,0,251,"2014"
"24653","310520 BANDEIRA",1,0,0,24,0,25,"2014"
"24654","310530 BANDEIRA DO SUL",1,0,1,58,0,60,"2014"
"24655","310540 BARAO DE COCAIS",6,3,4,445,5,463,"2014"
"24656","310550 BARAO DE MONTE ALTO",0,0,2,44,0,46,"2014"
"24657","310560 BARBACENA",1,5,29,1440,3,1478,"2014"
"24658","310570 BARRA LONGA",0,0,1,50,0,51,"2014"
"24659","310590 BARROSO",0,0,2,251,2,255,"2014"
"24660","310600 BELA VISTA DE MINAS",2,1,0,132,4,139,"2014"
"24661","310610 BELMIRO BRAGA",0,1,0,33,0,34,"2014"
"24662","310620 BELO HORIZONTE",80,153,501,30903,95,31732,"2014"
"24663","310630 BELO ORIENTE",2,2,4,332,0,340,"2014"
"24664","310640 BELO VALE",0,1,0,89,0,90,"2014"
"24665","310650 BERILO",0,0,1,115,1,117,"2014"
"24666","310660 BERTOPOLIS",0,2,2,71,21,96,"2014"
"24667","310665 BERIZAL",0,0,0,44,0,44,"2014"
"24668","310670 BETIM",17,27,95,6337,31,6507,"2014"
"24669","310680 BIAS FORTES",0,0,2,25,0,27,"2014"
"24670","310690 BICAS",1,1,1,135,0,138,"2014"
"24671","310700 BIQUINHAS",0,0,1,27,0,28,"2014"
"24672","310710 BOA ESPERANCA",5,0,3,508,3,519,"2014"
"24673","310720 BOCAINA DE MINAS",0,1,0,43,0,44,"2014"
"24674","310730 BOCAIUVA",10,1,15,661,9,696,"2014"
"24675","310740 BOM DESPACHO",2,2,11,597,0,612,"2014"
"24676","310750 BOM JARDIM DE MINAS",0,0,0,70,1,71,"2014"
"24677","310760 BOM JESUS DA PENHA",0,0,0,45,0,45,"2014"
"24678","310770 BOM JESUS DO AMPARO",0,1,1,87,1,90,"2014"
"24679","310780 BOM JESUS DO GALHO",0,0,24,152,4,180,"2014"
"24680","310790 BOM REPOUSO",0,0,4,104,0,108,"2014"
"24681","310800 BOM SUCESSO",0,2,5,175,3,185,"2014"
"24682","310810 BONFIM",0,0,5,55,3,63,"2014"
"24683","310820 BONFINOPOLIS DE MINAS",0,0,0,55,2,57,"2014"
"24684","310825 BONITO DE MINAS",0,0,1,98,19,118,"2014"
"24685","310830 BORDA DA MATA",2,1,2,158,2,165,"2014"
"24686","310840 BOTELHOS",0,0,5,120,3,128,"2014"
"24687","310850 BOTUMIRIM",0,1,2,64,0,67,"2014"
"24688","310855 BRASILANDIA DE MINAS",1,1,7,208,18,235,"2014"
"24689","310860 BRASILIA DE MINAS",3,1,5,476,3,488,"2014"
"24690","310870 BRAS PIRES",0,0,0,45,1,46,"2014"
"24691","310880 BRAUNAS",0,0,0,42,0,42,"2014"
"24692","310890 BRAZOPOLIS",0,0,0,158,0,158,"2014"
"24693","310900 BRUMADINHO",2,2,2,478,1,485,"2014"
"24694","310910 BUENO BRANDAO",1,0,1,66,0,68,"2014"
"24695","310920 BUENOPOLIS",1,0,3,127,1,132,"2014"
"24696","310925 BUGRE",0,0,0,48,0,48,"2014"
"24697","310930 BURITIS",0,1,4,357,0,362,"2014"
"24698","310940 BURITIZEIRO",0,1,8,361,3,373,"2014"
"24699","310945 CABECEIRA GRANDE",0,0,1,55,5,61,"2014"
"24700","310950 CABO VERDE",0,0,0,126,0,126,"2014"
"24701","310960 CACHOEIRA DA PRATA",0,1,0,45,0,46,"2014"
"24702","310970 CACHOEIRA DE MINAS",0,0,2,115,0,117,"2014"
"24703","310980 CACHOEIRA DOURADA",0,0,0,25,1,26,"2014"
"24704","310990 CAETANOPOLIS",0,0,1,128,0,129,"2014"
"24705","311000 CAETE",3,0,9,500,8,520,"2014"
"24706","311010 CAIANA",0,1,0,70,0,71,"2014"
"24707","311020 CAJURI",0,0,0,32,4,36,"2014"
"24708","311030 CALDAS",0,0,1,114,0,115,"2014"
"24709","311040 CAMACHO",0,0,3,31,0,34,"2014"
"24710","311050 CAMANDUCAIA",0,1,4,258,3,266,"2014"
"24711","311060 CAMBUI",0,0,2,328,3,333,"2014"
"24712","311070 CAMBUQUIRA",0,0,5,144,0,149,"2014"
"24713","311080 CAMPANARIO",0,0,0,37,3,40,"2014"
"24714","311090 CAMPANHA",0,0,0,178,0,178,"2014"
"24715","311100 CAMPESTRE",0,0,4,179,0,183,"2014"
"24716","311110 CAMPINA VERDE",0,0,3,195,0,198,"2014"
"24717","311115 CAMPO AZUL",0,1,0,45,0,46,"2014"
"24718","311120 CAMPO BELO",1,0,13,571,0,585,"2014"
"24719","311130 CAMPO DO MEIO",0,0,2,123,0,125,"2014"
"24720","311140 CAMPO FLORIDO",1,0,1,107,3,112,"2014"
"24721","311150 CAMPOS ALTOS",2,1,4,192,2,201,"2014"
"24722","311160 CAMPOS GERAIS",1,0,4,311,9,325,"2014"
"24723","311170 CANAA",1,0,0,45,3,49,"2014"
"24724","311180 CANAPOLIS",0,0,1,116,3,120,"2014"
"24725","311190 CANA VERDE",0,0,0,56,0,56,"2014"
"24726","311200 CANDEIAS",1,0,6,135,1,143,"2014"
"24727","311205 CANTAGALO",0,1,0,48,0,49,"2014"
"24728","311210 CAPARAO",0,0,1,74,0,75,"2014"
"24729","311220 CAPELA NOVA",0,0,0,35,0,35,"2014"
"24730","311230 CAPELINHA",3,2,12,522,1,540,"2014"
"24731","311240 CAPETINGA",0,3,3,74,0,80,"2014"
"24732","311250 CAPIM BRANCO",0,0,1,113,2,116,"2014"
"24733","311260 CAPINOPOLIS",0,1,1,139,0,141,"2014"
"24734","311265 CAPITAO ANDRADE",1,0,3,64,4,72,"2014"
"24735","311270 CAPITAO ENEAS",1,1,5,188,1,196,"2014"
"24736","311280 CAPITOLIO",0,0,1,79,1,81,"2014"
"24737","311290 CAPUTIRA",0,0,0,37,82,119,"2014"
"24738","311300 CARAI",0,1,12,251,2,266,"2014"
"24739","311310 CARANAIBA",0,0,1,24,0,25,"2014"
"24740","311320 CARANDAI",0,1,1,276,0,278,"2014"
"24741","311330 CARANGOLA",0,2,7,423,1,433,"2014"
"24742","311340 CARATINGA",1,4,26,1178,18,1227,"2014"
"24743","311350 CARBONITA",0,0,3,73,0,76,"2014"
"24744","311360 CAREACU",0,0,2,75,1,78,"2014"
"24745","311370 CARLOS CHAGAS",1,3,7,233,3,247,"2014"
"24746","311380 CARMESIA",0,0,0,35,1,36,"2014"
"24747","311390 CARMO DA CACHOEIRA",0,1,0,111,2,114,"2014"
"24748","311400 CARMO DA MATA",0,0,0,101,2,103,"2014"
"24749","311410 CARMO DE MINAS",0,2,8,142,1,153,"2014"
"24750","311420 CARMO DO CAJURU",0,1,7,271,0,279,"2014"
"24751","311430 CARMO DO PARANAIBA",1,0,1,347,0,349,"2014"
"24752","311440 CARMO DO RIO CLARO",1,0,1,216,2,220,"2014"
"24753","311450 CARMOPOLIS DE MINAS",0,2,1,205,7,215,"2014"
"24754","311455 CARNEIRINHO",1,0,0,116,0,117,"2014"
"24755","311460 CARRANCAS",0,0,0,44,1,45,"2014"
"24756","311470 CARVALHOPOLIS",0,0,0,48,0,48,"2014"
"24757","311480 CARVALHOS",0,1,0,35,0,36,"2014"
"24758","311490 CASA GRANDE",0,0,0,21,0,21,"2014"
"24759","311500 CASCALHO RICO",0,0,0,34,1,35,"2014"
"24760","311510 CASSIA",1,0,13,202,0,216,"2014"
"24761","311520 CONCEICAO DA BARRA DE MINAS",0,0,0,31,0,31,"2014"
"24762","311530 CATAGUASES",3,7,52,762,1,825,"2014"
"24763","311535 CATAS ALTAS",0,1,1,60,2,64,"2014"
"24764","311540 CATAS ALTAS DA NORUEGA",0,0,0,36,0,36,"2014"
"24765","311545 CATUJI",0,1,8,139,3,151,"2014"
"24766","311547 CATUTI",1,1,0,30,16,48,"2014"
"24767","311550 CAXAMBU",0,0,2,201,54,257,"2014"
"24768","311560 CEDRO DO ABAETE",0,0,0,8,0,8,"2014"
"24769","311570 CENTRAL DE MINAS",1,0,0,57,3,61,"2014"
"24770","311580 CENTRALINA",1,0,1,96,18,116,"2014"
"24771","311590 CHACARA",0,0,0,21,0,21,"2014"
"24772","311600 CHALE",0,0,0,55,26,81,"2014"
"24773","311610 CHAPADA DO NORTE",0,1,2,131,4,138,"2014"
"24774","311615 CHAPADA GAUCHA",1,1,3,191,2,198,"2014"
"24775","311620 CHIADOR",0,0,0,30,0,30,"2014"
"24776","311630 CIPOTANEA",0,0,0,56,1,57,"2014"
"24777","311640 CLARAVAL",1,0,1,11,1,14,"2014"
"24778","311650 CLARO DOS POCOES",0,0,0,81,1,82,"2014"
"24779","311660 CLAUDIO",0,0,2,330,5,337,"2014"
"24780","311670 COIMBRA",0,2,0,76,2,80,"2014"
"24781","311680 COLUNA",0,1,2,109,0,112,"2014"
"24782","311690 COMENDADOR GOMES",0,0,0,26,0,26,"2014"
"24783","311700 COMERCINHO",0,1,5,74,0,80,"2014"
"24784","311710 CONCEICAO DA APARECIDA",0,1,1,121,0,123,"2014"
"24785","311720 CONCEICAO DAS PEDRAS",0,0,1,31,0,32,"2014"
"24786","311730 CONCEICAO DAS ALAGOAS",1,1,4,408,1,415,"2014"
"24787","311740 CONCEICAO DE IPANEMA",0,0,0,45,10,55,"2014"
"24788","311750 CONCEICAO DO MATO DENTRO",3,1,2,244,6,256,"2014"
"24789","311760 CONCEICAO DO PARA",0,0,0,46,9,55,"2014"
"24790","311770 CONCEICAO DO RIO VERDE",1,0,3,152,1,157,"2014"
"24791","311780 CONCEICAO DOS OUROS",0,0,0,108,1,109,"2014"
"24792","311783 CONEGO MARINHO",1,0,0,70,2,73,"2014"
"24793","311787 CONFINS",0,0,1,78,2,81,"2014"
"24794","311790 CONGONHAL",1,0,0,94,0,95,"2014"
"24795","311800 CONGONHAS",0,6,10,721,1,738,"2014"
"24796","311810 CONGONHAS DO NORTE",0,0,2,61,4,67,"2014"
"24797","311820 CONQUISTA",0,0,1,78,2,81,"2014"
"24798","311830 CONSELHEIRO LAFAIETE",7,6,12,1706,2,1733,"2014"
"24799","311840 CONSELHEIRO PENA",0,0,2,247,6,255,"2014"
"24800","311850 CONSOLACAO",0,0,2,21,0,23,"2014"
"24801","311860 CONTAGEM",21,32,131,8669,51,8904,"2014"
"24802","311870 COQUEIRAL",0,0,1,62,24,87,"2014"
"24803","311880 CORACAO DE JESUS",3,1,2,275,5,286,"2014"
"24804","311890 CORDISBURGO",0,0,2,61,1,64,"2014"
"24805","311900 CORDISLANDIA",0,0,2,47,0,49,"2014"
"24806","311910 CORINTO",0,3,11,322,2,338,"2014"
"24807","311920 COROACI",0,0,2,73,9,84,"2014"
"24808","311930 COROMANDEL",1,0,3,317,0,321,"2014"
"24809","311940 CORONEL FABRICIANO",4,8,16,1372,24,1424,"2014"
"24810","311950 CORONEL MURTA",0,0,0,101,12,113,"2014"
"24811","311960 CORONEL PACHECO",0,1,1,25,0,27,"2014"
"24812","311970 CORONEL XAVIER CHAVES",0,0,0,34,0,34,"2014"
"24813","311980 CORREGO DANTA",0,0,0,22,0,22,"2014"
"24814","311990 CORREGO DO BOM JESUS",0,0,3,26,0,29,"2014"
"24815","311995 CORREGO FUNDO",0,0,0,54,0,54,"2014"
"24816","312000 CORREGO NOVO",0,0,2,29,0,31,"2014"
"24817","312010 COUTO DE MAGALHAES DE MINAS",0,0,1,46,3,50,"2014"
"24818","312015 CRISOLITA",1,0,0,92,4,97,"2014"
"24819","312020 CRISTAIS",1,0,6,124,0,131,"2014"
"24820","312030 CRISTALIA",0,0,0,79,1,80,"2014"
"24821","312040 CRISTIANO OTONI",0,0,1,63,0,64,"2014"
"24822","312050 CRISTINA",0,2,2,98,0,102,"2014"
"24823","312060 CRUCILANDIA",0,0,1,41,0,42,"2014"
"24824","312070 CRUZEIRO DA FORTALEZA",0,0,1,63,0,64,"2014"
"24825","312080 CRUZILIA",0,1,1,190,1,193,"2014"
"24826","312083 CUPARAQUE",0,0,0,77,3,80,"2014"
"24827","312087 CURRAL DE DENTRO",0,1,2,105,8,116,"2014"
"24828","312090 CURVELO",3,3,28,991,3,1028,"2014"
"24829","312100 DATAS",0,1,4,71,1,77,"2014"
"24830","312110 DELFIM MOREIRA",0,0,0,85,1,86,"2014"
"24831","312120 DELFINOPOLIS",0,0,5,72,1,78,"2014"
"24832","312125 DELTA",0,0,1,130,0,131,"2014"
"24833","312130 DESCOBERTO",0,1,1,52,0,54,"2014"
"24834","312140 DESTERRO DE ENTRE RIOS",0,0,1,63,1,65,"2014"
"24835","312150 DESTERRO DO MELO",0,0,1,27,1,29,"2014"
"24836","312160 DIAMANTINA",0,6,14,662,14,696,"2014"
"24837","312170 DIOGO DE VASCONCELOS",0,0,0,38,0,38,"2014"
"24838","312180 DIONISIO",0,2,0,59,0,61,"2014"
"24839","312190 DIVINESIA",0,0,3,48,0,51,"2014"
"24840","312200 DIVINO",1,0,5,262,0,268,"2014"
"24841","312210 DIVINO DAS LARANJEIRAS",1,0,0,48,5,54,"2014"
"24842","312220 DIVINOLANDIA DE MINAS",0,0,4,98,5,107,"2014"
"24843","312230 DIVINOPOLIS",2,17,47,2666,7,2739,"2014"
"24844","312235 DIVISA ALEGRE",0,0,2,85,0,87,"2014"
"24845","312240 DIVISA NOVA",0,0,0,74,0,74,"2014"
"24846","312245 DIVISOPOLIS",0,0,1,70,2,73,"2014"
"24847","312247 DOM BOSCO",0,0,0,32,2,34,"2014"
"24848","312250 DOM CAVATI",0,0,5,55,1,61,"2014"
"24849","312260 DOM JOAQUIM",0,1,0,72,0,73,"2014"
"24850","312270 DOM SILVERIO",0,0,0,36,0,36,"2014"
"24851","312280 DOM VICOSO",0,0,0,22,0,22,"2014"
"24852","312290 DONA EUSEBIA",0,0,4,55,0,59,"2014"
"24853","312300 DORES DE CAMPOS",0,0,0,83,2,85,"2014"
"24854","312310 DORES DE GUANHAES",0,0,2,61,2,65,"2014"
"24855","312320 DORES DO INDAIA",0,0,0,131,0,131,"2014"
"24856","312330 DORES DO TURVO",0,0,1,44,0,45,"2014"
"24857","312340 DORESOPOLIS",0,1,0,13,0,14,"2014"
"24858","312350 DOURADOQUARA",0,0,0,9,0,9,"2014"
"24859","312352 DURANDE",1,0,0,53,67,121,"2014"
"24860","312360 ELOI MENDES",0,1,1,276,5,283,"2014"
"24861","312370 ENGENHEIRO CALDAS",0,0,1,133,15,149,"2014"
"24862","312380 ENGENHEIRO NAVARRO",0,0,2,77,0,79,"2014"
"24863","312385 ENTRE FOLHAS",0,0,0,70,1,71,"2014"
"24864","312390 ENTRE RIOS DE MINAS",1,1,2,158,0,162,"2014"
"24865","312400 ERVALIA",0,1,9,196,1,207,"2014"
"24866","312410 ESMERALDAS",6,7,14,1057,10,1094,"2014"
"24867","312420 ESPERA FELIZ",0,1,4,326,6,337,"2014"
"24868","312430 ESPINOSA",1,1,8,382,15,407,"2014"
"24869","312440 ESPIRITO SANTO DO DOURADO",0,0,2,63,0,65,"2014"
"24870","312450 ESTIVA",0,0,5,109,0,114,"2014"
"24871","312460 ESTRELA DALVA",0,0,0,17,0,17,"2014"
"24872","312470 ESTRELA DO INDAIA",0,0,0,26,0,26,"2014"
"24873","312480 ESTRELA DO SUL",0,0,0,72,0,72,"2014"
"24874","312490 EUGENOPOLIS",0,0,0,91,0,91,"2014"
"24875","312500 EWBANK DA CAMARA",0,1,0,51,1,53,"2014"
"24876","312510 EXTREMA",2,2,1,590,1,596,"2014"
"24877","312520 FAMA",0,1,0,18,0,19,"2014"
"24878","312530 FARIA LEMOS",0,0,0,37,0,37,"2014"
"24879","312540 FELICIO DOS SANTOS",0,1,5,64,2,72,"2014"
"24880","312550 SAO GONCALO DO RIO PRETO",1,0,1,31,1,34,"2014"
"24881","312560 FELISBURGO",0,1,0,81,0,82,"2014"
"24882","312570 FELIXLANDIA",0,1,7,159,0,167,"2014"
"24883","312580 FERNANDES TOURINHO",0,0,0,36,3,39,"2014"
"24884","312590 FERROS",0,0,0,90,0,90,"2014"
"24885","312595 FERVEDOURO",0,2,1,117,1,121,"2014"
"24886","312600 FLORESTAL",0,0,0,80,0,80,"2014"
"24887","312610 FORMIGA",3,1,6,747,1,758,"2014"
"24888","312620 FORMOSO",0,0,0,94,0,94,"2014"
"24889","312630 FORTALEZA DE MINAS",0,0,1,29,1,31,"2014"
"24890","312640 FORTUNA DE MINAS",2,0,1,32,0,35,"2014"
"24891","312650 FRANCISCO BADARO",0,1,1,65,1,68,"2014"
"24892","312660 FRANCISCO DUMONT",2,0,1,65,2,70,"2014"
"24893","312670 FRANCISCO SA",1,1,6,236,1,245,"2014"
"24894","312675 FRANCISCOPOLIS",0,0,0,49,3,52,"2014"
"24895","312680 FREI GASPAR",0,0,0,67,1,68,"2014"
"24896","312690 FREI INOCENCIO",0,0,2,98,7,107,"2014"
"24897","312695 FREI LAGONEGRO",0,1,1,46,0,48,"2014"
"24898","312700 FRONTEIRA",1,2,1,152,0,156,"2014"
"24899","312705 FRONTEIRA DOS VALES",0,0,0,55,1,56,"2014"
"24900","312707 FRUTA DE LEITE",0,0,0,6,60,66,"2014"
"24901","312710 FRUTAL",1,2,9,750,3,765,"2014"
"24902","312720 FUNILANDIA",0,0,1,47,0,48,"2014"
"24903","312730 GALILEIA",0,1,2,66,8,77,"2014"
"24904","312733 GAMELEIRAS",0,2,1,22,25,50,"2014"
"24905","312735 GLAUCILANDIA",0,1,3,35,0,39,"2014"
"24906","312737 GOIABEIRA",0,0,0,42,2,44,"2014"
"24907","312738 GOIANA",0,1,1,29,0,31,"2014"
"24908","312740 GONCALVES",0,0,0,33,0,33,"2014"
"24909","312750 GONZAGA",0,0,1,77,4,82,"2014"
"24910","312760 GOUVEIA",0,0,4,134,3,141,"2014"
"24911","312770 GOVERNADOR VALADARES",18,10,81,3638,240,3987,"2014"
"24912","312780 GRAO MOGOL",0,0,2,158,23,183,"2014"
"24913","312790 GRUPIARA",0,0,0,13,0,13,"2014"
"24914","312800 GUANHAES",4,1,19,449,1,474,"2014"
"24915","312810 GUAPE",0,0,5,126,1,132,"2014"
"24916","312820 GUARACIABA",0,0,2,102,0,104,"2014"
"24917","312825 GUARACIAMA",1,1,3,64,0,69,"2014"
"24918","312830 GUARANESIA",0,0,3,199,31,233,"2014"
"24919","312840 GUARANI",0,0,0,90,0,90,"2014"
"24920","312850 GUARARA",1,1,1,37,0,40,"2014"
"24921","312860 GUARDA-MOR",0,0,1,100,3,104,"2014"
"24922","312870 GUAXUPE",2,5,37,609,2,655,"2014"
"24923","312880 GUIDOVAL",0,1,4,65,0,70,"2014"
"24924","312890 GUIMARANIA",0,0,2,70,1,73,"2014"
"24925","312900 GUIRICEMA",0,0,0,64,0,64,"2014"
"24926","312910 GURINHATA",0,0,1,32,1,34,"2014"
"24927","312920 HELIODORA",0,0,3,65,0,68,"2014"
"24928","312930 IAPU",0,0,0,115,1,116,"2014"
"24929","312940 IBERTIOGA",0,1,0,77,0,78,"2014"
"24930","312950 IBIA",1,0,5,260,1,267,"2014"
"24931","312960 IBIAI",0,0,4,105,1,110,"2014"
"24932","312965 IBIRACATU",0,0,2,81,0,83,"2014"
"24933","312970 IBIRACI",0,1,4,110,1,116,"2014"
"24934","312980 IBIRITE",10,8,30,2698,13,2759,"2014"
"24935","312990 IBITIURA DE MINAS",1,0,0,33,0,34,"2014"
"24936","313000 IBITURUNA",0,0,0,35,1,36,"2014"
"24937","313005 ICARAI DE MINAS",0,2,0,146,1,149,"2014"
"24938","313010 IGARAPE",1,2,11,561,12,587,"2014"
"24939","313020 IGARATINGA",1,0,3,111,6,121,"2014"
"24940","313030 IGUATAMA",0,0,1,86,0,87,"2014"
"24941","313040 IJACI",0,0,0,82,0,82,"2014"
"24942","313050 ILICINEA",2,0,0,147,2,151,"2014"
"24943","313055 IMBE DE MINAS",0,0,4,72,0,76,"2014"
"24944","313060 INCONFIDENTES",0,0,3,49,0,52,"2014"
"24945","313065 INDAIABIRA",0,0,1,87,0,88,"2014"
"24946","313070 INDIANOPOLIS",0,0,1,50,3,54,"2014"
"24947","313080 INGAI",0,0,0,34,0,34,"2014"
"24948","313090 INHAPIM",0,4,2,233,1,240,"2014"
"24949","313100 INHAUMA",0,0,1,78,1,80,"2014"
"24950","313110 INIMUTABA",0,1,2,65,0,68,"2014"
"24951","313115 IPABA",1,2,3,236,4,246,"2014"
"24952","313120 IPANEMA",0,0,3,198,34,235,"2014"
"24953","313130 IPATINGA",5,8,32,3303,39,3387,"2014"
"24954","313140 IPIACU",0,0,0,34,0,34,"2014"
"24955","313150 IPUIUNA",1,0,2,77,0,80,"2014"
"24956","313160 IRAI DE MINAS",0,0,0,80,1,81,"2014"
"24957","313170 ITABIRA",12,2,16,1664,20,1714,"2014"
"24958","313180 ITABIRINHA",1,0,2,149,2,154,"2014"
"24959","313190 ITABIRITO",2,1,16,733,2,754,"2014"
"24960","313200 ITACAMBIRA",0,1,1,48,0,50,"2014"
"24961","313210 ITACARAMBI",0,1,6,273,4,284,"2014"
"24962","313220 ITAGUARA",1,0,1,148,0,150,"2014"
"24963","313230 ITAIPE",2,0,7,144,0,153,"2014"
"24964","313240 ITAJUBA",1,2,8,1282,0,1293,"2014"
"24965","313250 ITAMARANDIBA",2,0,8,498,1,509,"2014"
"24966","313260 ITAMARATI DE MINAS",1,3,1,49,0,54,"2014"
"24967","313270 ITAMBACURI",1,2,6,328,7,344,"2014"
"24968","313280 ITAMBE DO MATO DENTRO",0,0,0,24,0,24,"2014"
"24969","313290 ITAMOGI",0,0,1,115,0,116,"2014"
"24970","313300 ITAMONTE",0,0,2,150,0,152,"2014"
"24971","313310 ITANHANDU",1,1,1,171,0,174,"2014"
"24972","313320 ITANHOMI",1,0,0,171,5,177,"2014"
"24973","313330 ITAOBIM",1,0,4,267,4,276,"2014"
"24974","313340 ITAPAGIPE",0,0,2,112,0,114,"2014"
"24975","313350 ITAPECERICA",0,0,2,197,0,199,"2014"
"24976","313360 ITAPEVA",0,0,1,108,2,111,"2014"
"24977","313370 ITATIAIUCU",0,0,2,149,0,151,"2014"
"24978","313375 ITAU DE MINAS",1,0,4,170,0,175,"2014"
"24979","313380 ITAUNA",1,1,2,1103,2,1109,"2014"
"24980","313390 ITAVERAVA",0,0,0,56,0,56,"2014"
"24981","313400 ITINGA",0,0,2,172,2,176,"2014"
"24982","313410 ITUETA",0,0,2,75,0,77,"2014"
"24983","313420 ITUIUTABA",5,2,5,1256,18,1286,"2014"
"24984","313430 ITUMIRIM",0,0,1,82,2,85,"2014"
"24985","313440 ITURAMA",0,1,3,545,0,549,"2014"
"24986","313450 ITUTINGA",1,1,0,46,1,49,"2014"
"24987","313460 JABOTICATUBAS",1,3,4,166,0,174,"2014"
"24988","313470 JACINTO",1,1,7,110,0,119,"2014"
"24989","313480 JACUI",0,1,2,76,0,79,"2014"
"24990","313490 JACUTINGA",2,1,2,259,2,266,"2014"
"24991","313500 JAGUARACU",0,0,0,35,0,35,"2014"
"24992","313505 JAIBA",3,1,25,591,28,648,"2014"
"24993","313507 JAMPRUCA",0,0,3,56,4,63,"2014"
"24994","313510 JANAUBA",2,2,53,1039,14,1110,"2014"
"24995","313520 JANUARIA",2,4,12,989,25,1032,"2014"
"24996","313530 JAPARAIBA",0,0,0,41,0,41,"2014"
"24997","313535 JAPONVAR",0,0,1,96,0,97,"2014"
"24998","313540 JECEABA",0,0,0,66,0,66,"2014"
"24999","313545 JENIPAPO DE MINAS",1,0,3,86,0,90,"2014"
"25000","313550 JEQUERI",0,0,0,125,1,126,"2014"
"25001","313560 JEQUITAI",0,0,2,94,0,96,"2014"
"25002","313570 JEQUITIBA",2,0,1,54,0,57,"2014"
"25003","313580 JEQUITINHONHA",1,0,5,272,15,293,"2014"
"25004","313590 JESUANIA",0,0,0,47,0,47,"2014"
"25005","313600 JOAIMA",0,0,0,219,19,238,"2014"
"25006","313610 JOANESIA",0,0,1,48,0,49,"2014"
"25007","313620 JOAO MONLEVADE",4,4,16,915,10,949,"2014"
"25008","313630 JOAO PINHEIRO",1,3,10,642,30,686,"2014"
"25009","313640 JOAQUIM FELICIO",1,0,2,31,1,35,"2014"
"25010","313650 JORDANIA",0,5,4,109,10,128,"2014"
"25011","313652 JOSE GONCALVES DE MINAS",0,1,0,60,0,61,"2014"
"25012","313655 JOSE RAYDAN",0,0,1,49,0,50,"2014"
"25013","313657 JOSENOPOLIS",0,1,0,14,31,46,"2014"
"25014","313660 NOVA UNIAO",0,0,0,65,1,66,"2014"
"25015","313665 JUATUBA",1,1,6,459,2,469,"2014"
"25016","313670 JUIZ DE FORA",33,44,97,6582,14,6770,"2014"
"25017","313680 JURAMENTO",0,1,3,35,0,39,"2014"
"25018","313690 JURUAIA",0,0,0,122,0,122,"2014"
"25019","313695 JUVENILIA",0,0,0,43,58,101,"2014"
"25020","313700 LADAINHA",1,2,6,207,3,219,"2014"
"25021","313710 LAGAMAR",0,0,1,54,0,55,"2014"
"25022","313720 LAGOA DA PRATA",0,3,10,540,3,556,"2014"
"25023","313730 LAGOA DOS PATOS",0,0,0,45,0,45,"2014"
"25024","313740 LAGOA DOURADA",0,0,0,165,1,166,"2014"
"25025","313750 LAGOA FORMOSA",1,1,1,139,0,142,"2014"
"25026","313753 LAGOA GRANDE",0,0,0,70,4,74,"2014"
"25027","313760 LAGOA SANTA",2,3,12,821,5,843,"2014"
"25028","313770 LAJINHA",0,1,2,239,77,319,"2014"
"25029","313780 LAMBARI",0,1,6,229,0,236,"2014"
"25030","313790 LAMIM",0,0,0,31,0,31,"2014"
"25031","313800 LARANJAL",0,0,0,36,1,37,"2014"
"25032","313810 LASSANCE",3,2,2,60,0,67,"2014"
"25033","313820 LAVRAS",5,2,16,1370,5,1398,"2014"
"25034","313830 LEANDRO FERREIRA",0,0,0,37,0,37,"2014"
"25035","313835 LEME DO PRADO",0,0,1,51,0,52,"2014"
"25036","313840 LEOPOLDINA",2,2,6,621,4,635,"2014"
"25037","313850 LIBERDADE",0,0,0,42,0,42,"2014"
"25038","313860 LIMA DUARTE",1,1,4,168,0,174,"2014"
"25039","313862 LIMEIRA DO OESTE",0,0,2,89,1,92,"2014"
"25040","313865 LONTRA",0,1,0,93,0,94,"2014"
"25041","313867 LUISBURGO",1,0,0,26,77,104,"2014"
"25042","313868 LUISLANDIA",1,0,2,91,2,96,"2014"
"25043","313870 LUMINARIAS",0,0,0,55,0,55,"2014"
"25044","313880 LUZ",1,1,3,173,1,179,"2014"
"25045","313890 MACHACALIS",2,0,2,94,1,99,"2014"
"25046","313900 MACHADO",1,0,5,462,2,470,"2014"
"25047","313910 MADRE DE DEUS DE MINAS",0,0,0,48,0,48,"2014"
"25048","313920 MALACACHETA",1,1,5,247,5,259,"2014"
"25049","313925 MAMONAS",0,0,1,16,30,47,"2014"
"25050","313930 MANGA",1,0,1,171,178,351,"2014"
"25051","313940 MANHUACU",3,1,4,333,980,1321,"2014"
"25052","313950 MANHUMIRIM",0,0,0,224,71,295,"2014"
"25053","313960 MANTENA",0,1,5,366,5,377,"2014"
"25054","313970 MARAVILHAS",0,0,0,78,1,79,"2014"
"25055","313980 MAR DE ESPANHA",0,2,2,146,1,151,"2014"
"25056","313990 MARIA DA FE",0,0,1,182,0,183,"2014"
"25057","314000 MARIANA",3,7,16,896,26,948,"2014"
"25058","314010 MARILAC",0,0,3,59,1,63,"2014"
"25059","314015 MARIO CAMPOS",0,1,2,207,0,210,"2014"
"25060","314020 MARIPA DE MINAS",0,0,0,22,0,22,"2014"
"25061","314030 MARLIERIA",0,0,0,46,0,46,"2014"
"25062","314040 MARMELOPOLIS",0,0,0,30,0,30,"2014"
"25063","314050 MARTINHO CAMPOS",0,1,3,132,10,146,"2014"
"25064","314053 MARTINS SOARES",0,0,1,66,75,142,"2014"
"25065","314055 MATA VERDE",1,0,0,56,0,57,"2014"
"25066","314060 MATERLANDIA",0,0,1,33,0,34,"2014"
"25067","314070 MATEUS LEME",1,3,6,462,4,476,"2014"
"25068","314080 MATIAS BARBOSA",0,0,2,153,2,157,"2014"
"25069","314085 MATIAS CARDOSO",1,0,6,124,17,148,"2014"
"25070","314090 MATIPO",2,1,0,139,118,260,"2014"
"25071","314100 MATO VERDE",2,2,7,145,16,172,"2014"
"25072","314110 MATOZINHOS",1,0,7,542,15,565,"2014"
"25073","314120 MATUTINA",1,0,0,38,0,39,"2014"
"25074","314130 MEDEIROS",0,1,1,25,0,27,"2014"
"25075","314140 MEDINA",1,4,12,237,1,255,"2014"
"25076","314150 MENDES PIMENTEL",1,0,2,62,1,66,"2014"
"25077","314160 MERCES",1,0,3,103,6,113,"2014"
"25078","314170 MESQUITA",0,0,0,56,0,56,"2014"
"25079","314180 MINAS NOVAS",0,1,1,318,14,334,"2014"
"25080","314190 MINDURI",1,0,0,34,0,35,"2014"
"25081","314200 MIRABELA",1,0,3,169,1,174,"2014"
"25082","314210 MIRADOURO",0,1,2,69,1,73,"2014"
"25083","314220 MIRAI",2,0,1,138,3,144,"2014"
"25084","314225 MIRAVANIA",0,0,0,33,21,54,"2014"
"25085","314230 MOEDA",0,0,0,56,1,57,"2014"
"25086","314240 MOEMA",0,0,2,73,0,75,"2014"
"25087","314250 MONJOLOS",0,0,0,20,0,20,"2014"
"25088","314260 MONSENHOR PAULO",0,0,0,81,0,81,"2014"
"25089","314270 MONTALVANIA",0,0,1,26,172,199,"2014"
"25090","314280 MONTE ALEGRE DE MINAS",2,0,0,98,146,246,"2014"
"25091","314290 MONTE AZUL",1,1,6,69,195,272,"2014"
"25092","314300 MONTE BELO",0,0,2,114,0,116,"2014"
"25093","314310 MONTE CARMELO",1,1,8,611,0,621,"2014"
"25094","314315 MONTE FORMOSO",0,0,1,41,0,42,"2014"
"25095","314320 MONTE SANTO DE MINAS",0,3,2,212,0,217,"2014"
"25096","314330 MONTES CLAROS",17,18,150,6089,23,6297,"2014"
"25097","314340 MONTE SIAO",0,0,1,225,0,226,"2014"
"25098","314345 MONTEZUMA",1,0,2,75,2,80,"2014"
"25099","314350 MORADA NOVA DE MINAS",1,0,1,92,0,94,"2014"
"25100","314360 MORRO DA GARCA",0,0,3,29,0,32,"2014"
"25101","314370 MORRO DO PILAR",0,0,1,36,3,40,"2014"
"25102","314380 MUNHOZ",0,0,0,54,1,55,"2014"
"25103","314390 MURIAE",0,2,19,1341,5,1367,"2014"
"25104","314400 MUTUM",0,2,0,319,33,354,"2014"
"25105","314410 MUZAMBINHO",1,0,3,229,0,233,"2014"
"25106","314420 NACIP RAYDAN",0,0,1,22,4,27,"2014"
"25107","314430 NANUQUE",3,0,9,553,1,566,"2014"
"25108","314435 NAQUE",0,0,3,109,4,116,"2014"
"25109","314437 NATALANDIA",0,0,0,47,1,48,"2014"
"25110","314440 NATERCIA",0,0,0,41,1,42,"2014"
"25111","314450 NAZARENO",0,0,0,66,0,66,"2014"
"25112","314460 NEPOMUCENO",1,0,2,336,2,341,"2014"
"25113","314465 NINHEIRA",1,2,1,99,3,106,"2014"
"25114","314467 NOVA BELEM",0,0,0,44,0,44,"2014"
"25115","314470 NOVA ERA",1,2,1,234,0,238,"2014"
"25116","314480 NOVA LIMA",2,4,15,1362,7,1390,"2014"
"25117","314490 NOVA MODICA",0,0,0,41,0,41,"2014"
"25118","314500 NOVA PONTE",1,1,0,164,0,166,"2014"
"25119","314505 NOVA PORTEIRINHA",0,0,3,102,0,105,"2014"
"25120","314510 NOVA RESENDE",1,0,3,172,1,177,"2014"
"25121","314520 NOVA SERRANA",1,0,12,1365,17,1395,"2014"
"25122","314530 NOVO CRUZEIRO",1,3,2,408,7,421,"2014"
"25123","314535 NOVO ORIENTE DE MINAS",0,0,1,119,5,125,"2014"
"25124","314537 NOVORIZONTE",0,0,0,21,28,49,"2014"
"25125","314540 OLARIA",0,0,0,19,0,19,"2014"
"25126","314545 OLHOS-D'AGUA",1,1,2,70,0,74,"2014"
"25127","314550 OLIMPIO NORONHA",0,0,0,31,0,31,"2014"
"25128","314560 OLIVEIRA",1,2,4,416,1,424,"2014"
"25129","314570 OLIVEIRA FORTES",0,1,1,14,0,16,"2014"
"25130","314580 ONCA DE PITANGUI",0,0,0,22,2,24,"2014"
"25131","314585 ORATORIOS",0,1,0,63,1,65,"2014"
"25132","314587 ORIZANIA",0,1,2,118,0,121,"2014"
"25133","314590 OURO BRANCO",0,1,8,546,1,556,"2014"
"25134","314600 OURO FINO",5,0,0,338,0,343,"2014"
"25135","314610 OURO PRETO",5,6,36,863,36,946,"2014"
"25136","314620 OURO VERDE DE MINAS",0,0,1,69,2,72,"2014"
"25137","314625 PADRE CARVALHO",0,0,0,27,72,99,"2014"
"25138","314630 PADRE PARAISO",1,0,4,242,3,250,"2014"
"25139","314640 PAINEIRAS",1,0,1,30,0,32,"2014"
"25140","314650 PAINS",0,1,1,78,0,80,"2014"
"25141","314655 PAI PEDRO",0,2,3,62,4,71,"2014"
"25142","314660 PAIVA",0,0,0,17,0,17,"2014"
"25143","314670 PALMA",0,0,0,58,0,58,"2014"
"25144","314675 PALMOPOLIS",0,2,2,72,0,76,"2014"
"25145","314690 PAPAGAIOS",0,1,3,176,8,188,"2014"
"25146","314700 PARACATU",1,5,17,1306,1,1330,"2014"
"25147","314710 PARA DE MINAS",15,3,11,1125,47,1201,"2014"
"25148","314720 PARAGUACU",1,1,3,231,1,237,"2014"
"25149","314730 PARAISOPOLIS",0,0,0,233,3,236,"2014"
"25150","314740 PARAOPEBA",0,0,5,276,2,283,"2014"
"25151","314750 PASSABEM",0,0,0,19,0,19,"2014"
"25152","314760 PASSA QUATRO",0,1,4,158,0,163,"2014"
"25153","314770 PASSA TEMPO",0,1,1,62,1,65,"2014"
"25154","314780 PASSA-VINTE",0,0,1,24,0,25,"2014"
"25155","314790 PASSOS",6,4,29,1422,16,1477,"2014"
"25156","314795 PATIS",0,0,2,51,0,53,"2014"
"25157","314800 PATOS DE MINAS",7,2,25,1805,4,1843,"2014"
"25158","314810 PATROCINIO",4,1,10,1206,1,1222,"2014"
"25159","314820 PATROCINIO DO MURIAE",0,1,4,60,0,65,"2014"
"25160","314830 PAULA CANDIDO",0,1,1,93,3,98,"2014"
"25161","314840 PAULISTAS",0,0,0,41,0,41,"2014"
"25162","314850 PAVAO",0,0,1,80,3,84,"2014"
"25163","314860 PECANHA",0,0,2,195,3,200,"2014"
"25164","314870 PEDRA AZUL",1,3,9,321,3,337,"2014"
"25165","314875 PEDRA BONITA",0,0,0,79,8,87,"2014"
"25166","314880 PEDRA DO ANTA",0,0,0,38,4,42,"2014"
"25167","314890 PEDRA DO INDAIA",0,0,0,34,0,34,"2014"
"25168","314900 PEDRA DOURADA",0,0,0,27,0,27,"2014"
"25169","314910 PEDRALVA",0,0,3,129,0,132,"2014"
"25170","314915 PEDRAS DE MARIA DA CRUZ",0,0,1,147,2,150,"2014"
"25171","314920 PEDRINOPOLIS",0,0,0,31,0,31,"2014"
"25172","314930 PEDRO LEOPOLDO",2,3,4,791,19,819,"2014"
"25173","314940 PEDRO TEIXEIRA",0,0,1,18,0,19,"2014"
"25174","314950 PEQUERI",0,0,0,32,0,32,"2014"
"25175","314960 PEQUI",2,0,1,45,2,50,"2014"
"25176","314970 PERDIGAO",0,0,1,158,8,167,"2014"
"25177","314980 PERDIZES",0,3,1,173,0,177,"2014"
"25178","314990 PERDOES",2,3,4,235,1,245,"2014"
"25179","314995 PERIQUITO",0,0,0,79,8,87,"2014"
"25180","315000 PESCADOR",0,0,0,49,1,50,"2014"
"25181","315010 PIAU",1,0,0,27,0,28,"2014"
"25182","315015 PIEDADE DE CARATINGA",1,1,5,114,3,124,"2014"
"25183","315020 PIEDADE DE PONTE NOVA",1,0,1,48,0,50,"2014"
"25184","315030 PIEDADE DO RIO GRANDE",0,0,0,48,0,48,"2014"
"25185","315040 PIEDADE DOS GERAIS",1,0,1,33,4,39,"2014"
"25186","315050 PIMENTA",0,0,2,69,0,71,"2014"
"25187","315053 PINGO-D'AGUA",0,0,1,47,0,48,"2014"
"25188","315057 PINTOPOLIS",1,1,1,100,1,104,"2014"
"25189","315060 PIRACEMA",0,0,0,36,1,37,"2014"
"25190","315070 PIRAJUBA",0,1,2,64,1,68,"2014"
"25191","315080 PIRANGA",0,2,0,155,1,158,"2014"
"25192","315090 PIRANGUCU",1,1,1,61,0,64,"2014"
"25193","315100 PIRANGUINHO",1,0,0,104,0,105,"2014"
"25194","315110 PIRAPETINGA",0,1,0,173,1,175,"2014"
"25195","315120 PIRAPORA",5,7,12,885,1,910,"2014"
"25196","315130 PIRAUBA",1,2,2,123,3,131,"2014"
"25197","315140 PITANGUI",2,1,1,243,62,309,"2014"
"25198","315150 PIUMHI",1,0,4,366,0,371,"2014"
"25199","315160 PLANURA",1,3,1,145,0,150,"2014"
"25200","315170 POCO FUNDO",0,0,1,154,0,155,"2014"
"25201","315180 POCOS DE CALDAS",4,11,67,1932,7,2021,"2014"
"25202","315190 POCRANE",0,0,0,74,12,86,"2014"
"25203","315200 POMPEU",0,1,11,425,0,437,"2014"
"25204","315210 PONTE NOVA",1,2,5,680,4,692,"2014"
"25205","315213 PONTO CHIQUE",0,0,0,57,1,58,"2014"
"25206","315217 PONTO DOS VOLANTES",1,0,0,138,1,140,"2014"
"25207","315220 PORTEIRINHA",2,2,19,499,3,525,"2014"
"25208","315230 PORTO FIRME",0,1,1,104,4,110,"2014"
"25209","315240 POTE",0,0,4,190,0,194,"2014"
"25210","315250 POUSO ALEGRE",5,7,36,1919,4,1971,"2014"
"25211","315260 POUSO ALTO",0,0,0,64,0,64,"2014"
"25212","315270 PRADOS",0,0,1,92,0,93,"2014"
"25213","315280 PRATA",0,0,2,333,0,335,"2014"
"25214","315290 PRATAPOLIS",1,0,3,80,0,84,"2014"
"25215","315300 PRATINHA",0,1,0,39,0,40,"2014"
"25216","315310 PRESIDENTE BERNARDES",1,0,1,39,0,41,"2014"
"25217","315320 PRESIDENTE JUSCELINO",0,0,1,34,0,35,"2014"
"25218","315330 PRESIDENTE KUBITSCHEK",1,0,0,53,1,55,"2014"
"25219","315340 PRESIDENTE OLEGARIO",0,0,2,187,1,190,"2014"
"25220","315350 ALTO JEQUITIBA",1,0,0,98,17,116,"2014"
"25221","315360 PRUDENTE DE MORAIS",0,0,3,153,0,156,"2014"
"25222","315370 QUARTEL GERAL",0,2,0,33,0,35,"2014"
"25223","315380 QUELUZITO",0,0,0,8,0,8,"2014"
"25224","315390 RAPOSOS",1,0,2,223,1,227,"2014"
"25225","315400 RAUL SOARES",0,2,7,259,7,275,"2014"
"25226","315410 RECREIO",0,0,1,98,0,99,"2014"
"25227","315415 REDUTO",1,0,0,29,88,118,"2014"
"25228","315420 RESENDE COSTA",0,0,0,148,0,148,"2014"
"25229","315430 RESPLENDOR",2,1,6,210,2,221,"2014"
"25230","315440 RESSAQUINHA",0,0,1,50,2,53,"2014"
"25231","315445 RIACHINHO",0,0,0,73,2,75,"2014"
"25232","315450 RIACHO DOS MACHADOS",2,0,7,120,1,130,"2014"
"25233","315460 RIBEIRAO DAS NEVES",20,24,84,4758,64,4950,"2014"
"25234","315470 RIBEIRAO VERMELHO",0,0,2,46,0,48,"2014"
"25235","315480 RIO ACIMA",0,2,5,122,0,129,"2014"
"25236","315490 RIO CASCA",0,1,1,171,1,174,"2014"
"25237","315500 RIO DOCE",0,0,0,19,0,19,"2014"
"25238","315510 RIO DO PRADO",1,0,3,53,0,57,"2014"
"25239","315520 RIO ESPERA",1,0,0,39,0,40,"2014"
"25240","315530 RIO MANSO",0,0,1,40,2,43,"2014"
"25241","315540 RIO NOVO",1,0,2,78,0,81,"2014"
"25242","315550 RIO PARANAIBA",0,0,3,113,2,118,"2014"
"25243","315560 RIO PARDO DE MINAS",1,1,12,411,3,428,"2014"
"25244","315570 RIO PIRACICABA",2,0,0,144,1,147,"2014"
"25245","315580 RIO POMBA",0,1,2,187,1,191,"2014"
"25246","315590 RIO PRETO",0,0,0,36,0,36,"2014"
"25247","315600 RIO VERMELHO",1,2,5,132,2,142,"2014"
"25248","315610 RITAPOLIS",0,0,0,44,0,44,"2014"
"25249","315620 ROCHEDO DE MINAS",0,0,0,15,0,15,"2014"
"25250","315630 RODEIRO",1,0,3,107,0,111,"2014"
"25251","315640 ROMARIA",0,0,0,40,0,40,"2014"
"25252","315645 ROSARIO DA LIMEIRA",0,0,1,45,0,46,"2014"
"25253","315650 RUBELITA",0,0,0,8,64,72,"2014"
"25254","315660 RUBIM",0,2,3,85,2,92,"2014"
"25255","315670 SABARA",5,7,29,1798,16,1855,"2014"
"25256","315680 SABINOPOLIS",0,1,1,179,2,183,"2014"
"25257","315690 SACRAMENTO",2,1,4,321,4,332,"2014"
"25258","315700 SALINAS",0,0,2,110,447,559,"2014"
"25259","315710 SALTO DA DIVISA",0,1,6,84,0,91,"2014"
"25260","315720 SANTA BARBARA",1,0,13,399,9,422,"2014"
"25261","315725 SANTA BARBARA DO LESTE",0,1,2,104,1,108,"2014"
"25262","315727 SANTA BARBARA DO MONTE VERDE",0,0,0,34,0,34,"2014"
"25263","315730 SANTA BARBARA DO TUGURIO",0,0,0,34,0,34,"2014"
"25264","315733 SANTA CRUZ DE MINAS",0,1,2,99,0,102,"2014"
"25265","315737 SANTA CRUZ DE SALINAS",0,0,0,14,39,53,"2014"
"25266","315740 SANTA CRUZ DO ESCALVADO",0,0,0,42,0,42,"2014"
"25267","315750 SANTA EFIGENIA DE MINAS",0,1,1,64,5,71,"2014"
"25268","315760 SANTA FE DE MINAS",0,0,0,46,0,46,"2014"
"25269","315765 SANTA HELENA DE MINAS",0,2,2,96,19,119,"2014"
"25270","315770 SANTA JULIANA",0,0,2,184,2,188,"2014"
"25271","315780 SANTA LUZIA",10,16,47,3141,18,3232,"2014"
"25272","315790 SANTA MARGARIDA",0,0,0,170,80,250,"2014"
"25273","315800 SANTA MARIA DE ITABIRA",1,1,1,148,0,151,"2014"
"25274","315810 SANTA MARIA DO SALTO",0,0,3,43,1,47,"2014"
"25275","315820 SANTA MARIA DO SUACUI",0,0,0,180,2,182,"2014"
"25276","315830 SANTANA DA VARGEM",0,1,3,51,29,84,"2014"
"25277","315840 SANTANA DE CATAGUASES",0,1,0,17,0,18,"2014"
"25278","315850 SANTANA DE PIRAPAMA",0,0,1,53,0,54,"2014"
"25279","315860 SANTANA DO DESERTO",0,0,0,43,0,43,"2014"
"25280","315870 SANTANA DO GARAMBEU",0,0,0,20,0,20,"2014"
"25281","315880 SANTANA DO JACARE",0,0,0,42,0,42,"2014"
"25282","315890 SANTANA DO MANHUACU",0,0,0,26,82,108,"2014"
"25283","315895 SANTANA DO PARAISO",0,1,7,578,9,595,"2014"
"25284","315900 SANTANA DO RIACHO",0,0,1,50,0,51,"2014"
"25285","315910 SANTANA DOS MONTES",0,0,0,27,0,27,"2014"
"25286","315920 SANTA RITA DE CALDAS",1,0,0,71,1,73,"2014"
"25287","315930 SANTA RITA DE JACUTINGA",0,0,0,30,0,30,"2014"
"25288","315935 SANTA RITA DE MINAS",0,0,3,88,1,92,"2014"
"25289","315940 SANTA RITA DE IBITIPOCA",0,1,0,37,2,40,"2014"
"25290","315950 SANTA RITA DO ITUETO",0,1,2,78,0,81,"2014"
"25291","315960 SANTA RITA DO SAPUCAI",0,1,2,521,1,525,"2014"
"25292","315970 SANTA ROSA DA SERRA",0,0,1,36,0,37,"2014"
"25293","315980 SANTA VITORIA",0,0,1,258,1,260,"2014"
"25294","315990 SANTO ANTONIO DO AMPARO",2,1,1,212,1,217,"2014"
"25295","316000 SANTO ANTONIO DO AVENTUREIRO",0,0,0,30,0,30,"2014"
"25296","316010 SANTO ANTONIO DO GRAMA",1,0,0,55,1,57,"2014"
"25297","316020 SANTO ANTONIO DO ITAMBE",0,0,1,35,1,37,"2014"
"25298","316030 SANTO ANTONIO DO JACINTO",0,2,12,107,1,122,"2014"
"25299","316040 SANTO ANTONIO DO MONTE",1,0,2,376,1,380,"2014"
"25300","316045 SANTO ANTONIO DO RETIRO",0,1,2,69,10,82,"2014"
"25301","316050 SANTO ANTONIO DO RIO ABAIXO",0,0,0,14,0,14,"2014"
"25302","316060 SANTO HIPOLITO",0,0,1,35,0,36,"2014"
"25303","316070 SANTOS DUMONT",3,3,10,562,5,583,"2014"
"25304","316080 SAO BENTO ABADE",0,0,1,73,0,74,"2014"
"25305","316090 SAO BRAS DO SUACUI",0,0,0,42,0,42,"2014"
"25306","316095 SAO DOMINGOS DAS DORES",0,0,5,76,0,81,"2014"
"25307","316100 SAO DOMINGOS DO PRATA",1,1,1,184,4,191,"2014"
"25308","316105 SAO FELIX DE MINAS",0,0,0,39,0,39,"2014"
"25309","316110 SAO FRANCISCO",1,3,16,867,7,894,"2014"
"25310","316120 SAO FRANCISCO DE PAULA",1,0,0,52,1,54,"2014"
"25311","316130 SAO FRANCISCO DE SALES",0,0,1,56,0,57,"2014"
"25312","316140 SAO FRANCISCO DO GLORIA",0,0,0,57,1,58,"2014"
"25313","316150 SAO GERALDO",1,1,0,98,0,100,"2014"
"25314","316160 SAO GERALDO DA PIEDADE",1,0,0,34,0,35,"2014"
"25315","316165 SAO GERALDO DO BAIXIO",0,0,0,34,5,39,"2014"
"25316","316170 SAO GONCALO DO ABAETE",0,1,0,56,0,57,"2014"
"25317","316180 SAO GONCALO DO PARA",0,0,4,134,2,140,"2014"
"25318","316190 SAO GONCALO DO RIO ABAIXO",0,1,1,133,4,139,"2014"
"25319","316200 SAO GONCALO DO SAPUCAI",0,1,12,337,0,350,"2014"
"25320","316210 SAO GOTARDO",0,1,3,588,1,593,"2014"
"25321","316220 SAO JOAO BATISTA DO GLORIA",0,0,1,83,1,85,"2014"
"25322","316225 SAO JOAO DA LAGOA",0,0,0,38,0,38,"2014"
"25323","316230 SAO JOAO DA MATA",0,0,0,22,0,22,"2014"
"25324","316240 SAO JOAO DA PONTE",1,1,4,281,2,289,"2014"
"25325","316245 SAO JOAO DAS MISSOES",2,0,4,149,136,291,"2014"
"25326","316250 SAO JOAO DEL REI",4,3,8,932,4,951,"2014"
"25327","316255 SAO JOAO DO MANHUACU",1,0,2,88,73,164,"2014"
"25328","316257 SAO JOAO DO MANTENINHA",0,0,2,61,2,65,"2014"
"25329","316260 SAO JOAO DO ORIENTE",0,0,2,104,0,106,"2014"
"25330","316265 SAO JOAO DO PACUI",0,0,2,39,1,42,"2014"
"25331","316270 SAO JOAO DO PARAISO",0,2,1,247,23,273,"2014"
"25332","316280 SAO JOAO EVANGELISTA",0,0,4,202,1,207,"2014"
"25333","316290 SAO JOAO NEPOMUCENO",1,1,3,309,0,314,"2014"
"25334","316292 SAO JOAQUIM DE BICAS",2,1,8,391,13,415,"2014"
"25335","316294 SAO JOSE DA BARRA",1,0,1,68,0,70,"2014"
"25336","316295 SAO JOSE DA LAPA",1,1,2,313,6,323,"2014"
"25337","316300 SAO JOSE DA SAFIRA",2,1,1,49,2,55,"2014"
"25338","316310 SAO JOSE DA VARGINHA",2,0,2,43,2,49,"2014"
"25339","316320 SAO JOSE DO ALEGRE",1,0,0,55,0,56,"2014"
"25340","316330 SAO JOSE DO DIVINO",1,0,0,47,0,48,"2014"
"25341","316340 SAO JOSE DO GOIABAL",0,0,0,57,2,59,"2014"
"25342","316350 SAO JOSE DO JACURI",0,0,0,53,0,53,"2014"
"25343","316360 SAO JOSE DO MANTIMENTO",0,0,0,22,15,37,"2014"
"25344","316370 SAO LOURENCO",0,1,5,550,4,560,"2014"
"25345","316380 SAO MIGUEL DO ANTA",0,0,1,74,3,78,"2014"
"25346","316390 SAO PEDRO DA UNIAO",1,0,0,39,0,40,"2014"
"25347","316400 SAO PEDRO DOS FERROS",0,1,0,82,1,84,"2014"
"25348","316410 SAO PEDRO DO SUACUI",0,0,0,52,2,54,"2014"
"25349","316420 SAO ROMAO",1,4,8,116,0,129,"2014"
"25350","316430 SAO ROQUE DE MINAS",0,1,0,54,0,55,"2014"
"25351","316440 SAO SEBASTIAO DA BELA VISTA",0,0,0,78,1,79,"2014"
"25352","316443 SAO SEBASTIAO DA VARGEM ALEGRE",0,1,0,29,0,30,"2014"
"25353","316447 SAO SEBASTIAO DO ANTA",2,1,3,92,2,100,"2014"
"25354","316450 SAO SEBASTIAO DO MARANHAO",0,0,1,106,0,107,"2014"
"25355","316460 SAO SEBASTIAO DO OESTE",0,1,3,104,2,110,"2014"
"25356","316470 SAO SEBASTIAO DO PARAISO",6,5,11,830,2,854,"2014"
"25357","316480 SAO SEBASTIAO DO RIO PRETO",0,0,0,17,0,17,"2014"
"25358","316490 SAO SEBASTIAO DO RIO VERDE",0,0,0,29,0,29,"2014"
"25359","316500 SAO TIAGO",0,0,2,113,0,115,"2014"
"25360","316510 SAO TOMAS DE AQUINO",0,1,1,96,0,98,"2014"
"25361","316520 SAO THOME DAS LETRAS",0,0,2,63,1,66,"2014"
"25362","316530 SAO VICENTE DE MINAS",1,0,0,90,1,92,"2014"
"25363","316540 SAPUCAI-MIRIM",0,0,0,80,0,80,"2014"
"25364","316550 SARDOA",1,0,4,73,8,86,"2014"
"25365","316553 SARZEDO",3,2,4,485,1,495,"2014"
"25366","316555 SETUBINHA",3,3,5,141,14,166,"2014"
"25367","316556 SEM-PEIXE",0,0,0,19,1,20,"2014"
"25368","316557 SENADOR AMARAL",0,0,1,86,0,87,"2014"
"25369","316560 SENADOR CORTES",0,1,1,31,1,34,"2014"
"25370","316570 SENADOR FIRMINO",0,0,1,80,1,82,"2014"
"25371","316580 SENADOR JOSE BENTO",0,0,0,14,0,14,"2014"
"25372","316590 SENADOR MODESTINO GONCALVES",0,0,0,36,0,36,"2014"
"25373","316600 SENHORA DE OLIVEIRA",0,0,2,59,0,61,"2014"
"25374","316610 SENHORA DO PORTO",0,0,2,44,1,47,"2014"
"25375","316620 SENHORA DOS REMEDIOS",0,0,0,92,0,92,"2014"
"25376","316630 SERICITA",0,0,1,91,7,99,"2014"
"25377","316640 SERITINGA",0,0,0,15,0,15,"2014"
"25378","316650 SERRA AZUL DE MINAS",0,0,2,39,0,41,"2014"
"25379","316660 SERRA DA SAUDADE",0,0,0,9,0,9,"2014"
"25380","316670 SERRA DOS AIMORES",0,1,3,86,0,90,"2014"
"25381","316680 SERRA DO SALITRE",0,1,4,128,1,134,"2014"
"25382","316690 SERRANIA",1,0,2,100,1,104,"2014"
"25383","316695 SERRANOPOLIS DE MINAS",0,1,7,44,0,52,"2014"
"25384","316700 SERRANOS",0,0,0,16,0,16,"2014"
"25385","316710 SERRO",0,1,5,256,4,266,"2014"
"25386","316720 SETE LAGOAS",8,8,33,2929,12,2990,"2014"
"25387","316730 SILVEIRANIA",1,0,0,22,0,23,"2014"
"25388","316740 SILVIANOPOLIS",0,0,2,64,1,67,"2014"
"25389","316750 SIMAO PEREIRA",0,0,1,39,0,40,"2014"
"25390","316760 SIMONESIA",1,1,1,80,182,265,"2014"
"25391","316770 SOBRALIA",0,0,0,53,4,57,"2014"
"25392","316780 SOLEDADE DE MINAS",0,0,2,62,1,65,"2014"
"25393","316790 TABULEIRO",0,0,0,51,0,51,"2014"
"25394","316800 TAIOBEIRAS",2,1,4,477,6,490,"2014"
"25395","316805 TAPARUBA",0,0,1,34,2,37,"2014"
"25396","316810 TAPIRA",0,0,0,33,0,33,"2014"
"25397","316820 TAPIRAI",0,0,0,8,0,8,"2014"
"25398","316830 TAQUARACU DE MINAS",0,0,2,40,0,42,"2014"
"25399","316840 TARUMIRIM",0,0,5,173,6,184,"2014"
"25400","316850 TEIXEIRAS",0,1,1,112,2,116,"2014"
"25401","316860 TEOFILO OTONI",3,6,33,1887,17,1946,"2014"
"25402","316870 TIMOTEO",3,5,15,1062,11,1096,"2014"
"25403","316880 TIRADENTES",0,0,1,89,0,90,"2014"
"25404","316890 TIROS",0,0,1,63,0,64,"2014"
"25405","316900 TOCANTINS",3,0,5,187,3,198,"2014"
"25406","316905 TOCOS DO MOJI",0,0,1,38,0,39,"2014"
"25407","316910 TOLEDO",0,0,1,70,1,72,"2014"
"25408","316920 TOMBOS",0,1,2,110,1,114,"2014"
"25409","316930 TRES CORACOES",2,6,8,1054,7,1077,"2014"
"25410","316935 TRES MARIAS",0,1,5,365,10,381,"2014"
"25411","316940 TRES PONTAS",0,1,9,447,255,712,"2014"
"25412","316950 TUMIRITINGA",0,0,0,56,10,66,"2014"
"25413","316960 TUPACIGUARA",0,0,2,237,4,243,"2014"
"25414","316970 TURMALINA",0,12,0,220,1,233,"2014"
"25415","316980 TURVOLANDIA",0,0,0,71,0,71,"2014"
"25416","316990 UBA",4,6,24,1265,16,1315,"2014"
"25417","317000 UBAI",0,0,1,131,2,134,"2014"
"25418","317005 UBAPORANGA",0,2,8,162,2,174,"2014"
"25419","317010 UBERABA",15,11,48,4165,48,4287,"2014"
"25420","317020 UBERLANDIA",31,26,98,9273,46,9474,"2014"
"25421","317030 UMBURATIBA",0,0,1,41,1,43,"2014"
"25422","317040 UNAI",5,2,12,1161,36,1216,"2014"
"25423","317043 UNIAO DE MINAS",0,0,0,57,0,57,"2014"
"25424","317047 URUANA DE MINAS",0,0,1,41,3,45,"2014"
"25425","317050 URUCANIA",0,1,1,134,0,136,"2014"
"25426","317052 URUCUIA",0,2,2,132,4,140,"2014"
"25427","317057 VARGEM ALEGRE",0,1,5,61,1,68,"2014"
"25428","317060 VARGEM BONITA",0,0,0,19,0,19,"2014"
"25429","317065 VARGEM GRANDE DO RIO PARDO",0,0,0,68,1,69,"2014"
"25430","317070 VARGINHA",3,5,18,1705,8,1739,"2014"
"25431","317075 VARJAO DE MINAS",0,1,0,86,0,87,"2014"
"25432","317080 VARZEA DA PALMA",1,1,6,484,1,493,"2014"
"25433","317090 VARZELANDIA",1,1,4,253,1,260,"2014"
"25434","317100 VAZANTE",1,0,2,227,1,231,"2014"
"25435","317103 VERDELANDIA",2,3,6,130,1,142,"2014"
"25436","317107 VEREDINHA",0,2,0,52,0,54,"2014"
"25437","317110 VERISSIMO",0,0,1,34,1,36,"2014"
"25438","317115 VERMELHO NOVO",0,0,2,48,0,50,"2014"
"25439","317120 VESPASIANO",5,4,24,1941,12,1986,"2014"
"25440","317130 VICOSA",2,5,10,871,23,911,"2014"
"25441","317140 VIEIRAS",0,0,0,37,0,37,"2014"
"25442","317150 MATHIAS LOBATO",1,0,4,54,10,69,"2014"
"25443","317160 VIRGEM DA LAPA",0,0,2,115,5,122,"2014"
"25444","317170 VIRGINIA",0,0,1,79,0,80,"2014"
"25445","317180 VIRGINOPOLIS",0,1,1,132,0,134,"2014"
"25446","317190 VIRGOLANDIA",0,0,0,57,9,66,"2014"
"25447","317200 VISCONDE DO RIO BRANCO",0,0,3,489,1,493,"2014"
"25448","317210 VOLTA GRANDE",1,0,2,52,0,55,"2014"
"25449","317220 WENCESLAU BRAZ",0,0,1,24,0,25,"2014"
"25450","320010 AFONSO CLAUDIO",2,3,11,366,0,382,"2014"
"25451","320013 AGUIA BRANCA",0,0,2,124,1,127,"2014"
"25452","320016 AGUA DOCE DO NORTE",0,0,5,146,1,152,"2014"
"25453","320020 ALEGRE",0,0,3,415,0,418,"2014"
"25454","320030 ALFREDO CHAVES",0,1,2,122,0,125,"2014"
"25455","320035 ALTO RIO NOVO",0,1,2,98,1,102,"2014"
"25456","320040 ANCHIETA",0,0,3,449,1,453,"2014"
"25457","320050 APIACA",1,0,2,94,2,99,"2014"
"25458","320060 ARACRUZ",0,6,10,1506,2,1524,"2014"
"25459","320070 ATILIO VIVACQUA",0,1,2,161,1,165,"2014"
"25460","320080 BAIXO GUANDU",0,4,2,393,0,399,"2014"
"25461","320090 BARRA DE SAO FRANCISCO",4,3,6,632,0,645,"2014"
"25462","320100 BOA ESPERANCA",0,2,4,181,11,198,"2014"
"25463","320110 BOM JESUS DO NORTE",2,1,3,110,0,116,"2014"
"25464","320115 BREJETUBA",0,0,2,169,1,172,"2014"
"25465","320120 CACHOEIRO DE ITAPEMIRIM",4,5,28,2875,7,2919,"2014"
"25466","320130 CARIACICA",9,19,83,6169,58,6338,"2014"
"25467","320140 CASTELO",0,1,6,461,2,470,"2014"
"25468","320150 COLATINA",5,6,33,1473,15,1532,"2014"
"25469","320160 CONCEICAO DA BARRA",2,2,4,400,4,412,"2014"
"25470","320170 CONCEICAO DO CASTELO",0,0,4,175,0,179,"2014"
"25471","320180 DIVINO DE SAO LOURENCO",0,0,1,57,0,58,"2014"
"25472","320190 DOMINGOS MARTINS",0,1,5,466,1,473,"2014"
"25473","320200 DORES DO RIO PRETO",0,0,1,62,1,64,"2014"
"25474","320210 ECOPORANGA",2,0,4,318,0,324,"2014"
"25475","320220 FUNDAO",0,1,5,235,0,241,"2014"
"25476","320225 GOVERNADOR LINDENBERG",0,1,1,109,2,113,"2014"
"25477","320230 GUACUI",1,2,13,438,0,454,"2014"
"25478","320240 GUARAPARI",0,6,30,1706,17,1759,"2014"
"25479","320245 IBATIBA",0,2,5,320,15,342,"2014"
"25480","320250 IBIRACU",0,0,1,162,0,163,"2014"
"25481","320255 IBITIRAMA",0,0,5,138,1,144,"2014"
"25482","320260 ICONHA",1,0,0,140,1,142,"2014"
"25483","320265 IRUPI",0,0,2,145,17,164,"2014"
"25484","320270 ITAGUACU",0,1,6,145,0,152,"2014"
"25485","320280 ITAPEMIRIM",1,0,12,547,2,562,"2014"
"25486","320290 ITARANA",1,0,2,98,0,101,"2014"
"25487","320300 IUNA",0,1,3,350,24,378,"2014"
"25488","320305 JAGUARE",3,2,10,502,1,518,"2014"
"25489","320310 JERONIMO MONTEIRO",0,1,3,121,0,125,"2014"
"25490","320313 JOAO NEIVA",1,2,4,199,1,207,"2014"
"25491","320316 LARANJA DA TERRA",0,0,1,93,1,95,"2014"
"25492","320320 LINHARES",4,7,21,2633,2,2667,"2014"
"25493","320330 MANTENOPOLIS",1,0,3,175,1,180,"2014"
"25494","320332 MARATAIZES",4,5,15,532,0,556,"2014"
"25495","320334 MARECHAL FLORIANO",0,1,5,243,0,249,"2014"
"25496","320335 MARILANDIA",0,0,2,110,2,114,"2014"
"25497","320340 MIMOSO DO SUL",0,0,2,298,2,302,"2014"
"25498","320350 MONTANHA",0,3,1,270,2,276,"2014"
"25499","320360 MUCURICI",0,2,0,91,1,94,"2014"
"25500","320370 MUNIZ FREIRE",2,0,1,243,2,248,"2014"
"25501","320380 MUQUI",0,0,3,192,1,196,"2014"
"25502","320390 NOVA VENECIA",1,2,6,666,0,675,"2014"
"25503","320400 PANCAS",0,1,2,219,2,224,"2014"
"25504","320405 PEDRO CANARIO",0,3,2,381,1,387,"2014"
"25505","320410 PINHEIROS",0,0,0,66,301,367,"2014"
"25506","320420 PIUMA",1,3,4,318,0,326,"2014"
"25507","320425 PONTO BELO",0,1,1,85,1,88,"2014"
"25508","320430 PRESIDENTE KENNEDY",0,0,0,142,0,142,"2014"
"25509","320435 RIO BANANAL",0,0,3,240,2,245,"2014"
"25510","320440 RIO NOVO DO SUL",0,0,3,148,0,151,"2014"
"25511","320450 SANTA LEOPOLDINA",0,0,1,123,3,127,"2014"
"25512","320455 SANTA MARIA DE JETIBA",1,1,5,535,3,545,"2014"
"25513","320460 SANTA TERESA",0,1,3,279,1,284,"2014"
"25514","320465 SAO DOMINGOS DO NORTE",0,1,1,89,0,91,"2014"
"25515","320470 SAO GABRIEL DA PALHA",2,5,5,441,1,454,"2014"
"25516","320480 SAO JOSE DO CALCADO",0,2,2,153,0,157,"2014"
"25517","320490 SAO MATEUS",7,12,33,1777,7,1836,"2014"
"25518","320495 SAO ROQUE DO CANAA",1,1,1,94,0,97,"2014"
"25519","320500 SERRA",40,23,115,8061,11,8250,"2014"
"25520","320501 SOORETAMA",0,0,1,455,0,456,"2014"
"25521","320503 VARGEM ALTA",0,3,4,257,1,265,"2014"
"25522","320506 VENDA NOVA DO IMIGRANTE",1,1,4,329,0,335,"2014"
"25523","320510 VIANA",3,4,11,1096,14,1128,"2014"
"25524","320515 VILA PAVAO",0,0,1,114,0,115,"2014"
"25525","320517 VILA VALERIO",0,0,1,149,1,151,"2014"
"25526","320520 VILA VELHA",13,15,90,6312,29,6459,"2014"
"25527","320530 VITORIA",9,14,58,4704,20,4805,"2014"
"25528","MUNICIPIO IGNORADO - RJ",0,0,3,10,2,15,"2014"
"25529","330010 ANGRA DOS REIS",2,7,74,2730,25,2838,"2014"
"25530","330015 APERIBE",2,0,1,134,0,137,"2014"
"25531","330020 ARARUAMA",4,6,31,992,640,1673,"2014"
"25532","330022 AREAL",1,0,2,173,2,178,"2014"
"25533","330023 ARMACAO DOS BUZIOS",0,5,11,523,12,551,"2014"
"25534","330025 ARRAIAL DO CABO",1,0,4,243,115,363,"2014"
"25535","330030 BARRA DO PIRAI",5,3,20,1110,6,1144,"2014"
"25536","330040 BARRA MANSA",11,27,97,2266,4,2405,"2014"
"25537","330045 BELFORD ROXO",28,37,182,7351,57,7655,"2014"
"25538","330050 BOM JARDIM",0,2,5,346,0,353,"2014"
"25539","330060 BOM JESUS DO ITABAPOANA",0,2,7,433,6,448,"2014"
"25540","330070 CABO FRIO",4,17,55,3116,86,3278,"2014"
"25541","330080 CACHOEIRAS DE MACACU",4,1,13,782,8,808,"2014"
"25542","330090 CAMBUCI",0,0,1,139,3,143,"2014"
"25543","330093 CARAPEBUS",0,1,2,184,3,190,"2014"
"25544","330095 COMENDADOR LEVY GASPARIAN",3,0,1,111,0,115,"2014"
"25545","330100 CAMPOS DOS GOYTACAZES",14,36,150,5820,1871,7891,"2014"
"25546","330110 CANTAGALO",1,1,5,231,5,243,"2014"
"25547","330115 CARDOSO MOREIRA",0,0,1,104,31,136,"2014"
"25548","330120 CARMO",0,2,3,209,0,214,"2014"
"25549","330130 CASIMIRO DE ABREU",2,4,10,511,3,530,"2014"
"25550","330140 CONCEICAO DE MACABU",0,3,5,265,10,283,"2014"
"25551","330150 CORDEIRO",0,0,1,232,2,235,"2014"
"25552","330160 DUAS BARRAS",0,2,0,129,5,136,"2014"
"25553","330170 DUQUE DE CAXIAS",24,88,309,13322,62,13805,"2014"
"25554","330180 ENGENHEIRO PAULO DE FRONTIN",0,2,5,124,0,131,"2014"
"25555","330185 GUAPIMIRIM",1,2,11,739,11,764,"2014"
"25556","330187 IGUABA GRANDE",0,1,2,126,177,306,"2014"
"25557","330190 ITABORAI",9,13,58,3515,21,3616,"2014"
"25558","330200 ITAGUAI",2,14,37,1756,6,1815,"2014"
"25559","330205 ITALVA",0,0,2,171,1,174,"2014"
"25560","330210 ITAOCARA",0,0,0,287,2,289,"2014"
"25561","330220 ITAPERUNA",3,3,22,1203,3,1234,"2014"
"25562","330225 ITATIAIA",1,3,18,407,1,430,"2014"
"25563","330227 JAPERI",9,8,40,1528,31,1616,"2014"
"25564","330230 LAJE DO MURIAE",0,0,1,83,1,85,"2014"
"25565","330240 MACAE",9,20,71,4056,18,4174,"2014"
"25566","330245 MACUCO",0,2,2,84,1,89,"2014"
"25567","330250 MAGE",10,8,54,3491,6,3569,"2014"
"25568","330260 MANGARATIBA",0,2,5,517,3,527,"2014"
"25569","330270 MARICA",5,5,22,1143,648,1823,"2014"
"25570","330280 MENDES",0,2,1,234,0,237,"2014"
"25571","330285 MESQUITA",8,10,52,2533,17,2620,"2014"
"25572","330290 MIGUEL PEREIRA",0,4,14,219,42,279,"2014"
"25573","330300 MIRACEMA",0,0,1,320,0,321,"2014"
"25574","330310 NATIVIDADE",3,0,8,178,1,190,"2014"
"25575","330320 NILOPOLIS",3,16,32,2046,12,2109,"2014"
"25576","330330 NITEROI",27,43,124,6239,35,6468,"2014"
"25577","330340 NOVA FRIBURGO",6,9,41,2052,15,2123,"2014"
"25578","330350 NOVA IGUACU",44,46,237,11664,150,12141,"2014"
"25579","330360 PARACAMBI",3,1,4,503,1,512,"2014"
"25580","330370 PARAIBA DO SUL",3,1,8,553,2,567,"2014"
"25581","330380 PARATY",1,1,14,597,3,616,"2014"
"25582","330385 PATY DO ALFERES",0,2,13,295,80,390,"2014"
"25583","330390 PETROPOLIS",17,22,82,3828,23,3972,"2014"
"25584","330395 PINHEIRAL",1,1,2,339,1,344,"2014"
"25585","330400 PIRAI",0,2,8,367,0,377,"2014"
"25586","330410 PORCIUNCULA",0,1,5,198,2,206,"2014"
"25587","330411 PORTO REAL",0,3,7,340,1,351,"2014"
"25588","330412 QUATIS",0,1,8,184,0,193,"2014"
"25589","330414 QUEIMADOS",4,15,50,2364,23,2456,"2014"
"25590","330415 QUISSAMA",0,1,12,319,9,341,"2014"
"25591","330420 RESENDE",3,3,67,1730,0,1803,"2014"
"25592","330430 RIO BONITO",1,3,14,805,8,831,"2014"
"25593","330440 RIO CLARO",0,1,8,222,0,231,"2014"
"25594","330450 RIO DAS FLORES",0,0,4,111,0,115,"2014"
"25595","330452 RIO DAS OSTRAS",5,13,54,2271,17,2360,"2014"
"25596","330455 RIO DE JANEIRO",162,439,1678,86961,751,89991,"2014"
"25597","330460 SANTA MARIA MADALENA",1,0,1,118,4,124,"2014"
"25598","330470 SANTO ANTONIO DE PADUA",1,2,4,391,17,415,"2014"
"25599","330475 SAO FRANCISCO DE ITABAPOANA",0,3,18,355,187,563,"2014"
"25600","330480 SAO FIDELIS",0,4,16,391,25,436,"2014"
"25601","330490 SAO GONCALO",58,58,186,12053,52,12407,"2014"
"25602","330500 SAO JOAO DA BARRA",0,0,5,421,153,579,"2014"
"25603","330510 SAO JOAO DE MERITI",25,42,158,6735,47,7007,"2014"
"25604","330513 SAO JOSE DE UBA",0,0,4,105,0,109,"2014"
"25605","330515 SAO JOSE DO VALE DO RIO PRETO",0,2,4,247,0,253,"2014"
"25606","330520 SAO PEDRO DA ALDEIA",3,3,4,513,696,1219,"2014"
"25607","330530 SAO SEBASTIAO DO ALTO",2,0,1,98,0,101,"2014"
"25608","330540 SAPUCAIA",1,1,3,175,1,181,"2014"
"25609","330550 SAQUAREMA",1,4,8,457,536,1006,"2014"
"25610","330555 SEROPEDICA",7,6,15,1108,9,1145,"2014"
"25611","330560 SILVA JARDIM",0,3,3,303,5,314,"2014"
"25612","330570 SUMIDOURO",2,1,1,206,2,212,"2014"
"25613","330575 TANGUA",0,3,5,462,7,477,"2014"
"25614","330580 TERESOPOLIS",6,9,52,2213,11,2291,"2014"
"25615","330590 TRAJANO DE MORAES",1,2,1,107,3,114,"2014"
"25616","330600 TRES RIOS",8,5,8,1207,7,1235,"2014"
"25617","330610 VALENCA",3,1,18,840,11,873,"2014"
"25618","330615 VARRE-SAI",0,0,4,123,0,127,"2014"
"25619","330620 VASSOURAS",3,1,8,561,0,573,"2014"
"25620","330630 VOLTA REDONDA",3,12,34,3216,5,3270,"2014"
"25621","MUNICIPIO IGNORADO - SP",0,0,0,12,3,15,"2014"
"25622","350010 ADAMANTINA",0,2,8,371,0,381,"2014"
"25623","350020 ADOLFO",0,1,0,55,0,56,"2014"
"25624","350030 AGUAI",0,2,4,387,0,393,"2014"
"25625","350040 AGUAS DA PRATA",0,0,1,88,1,90,"2014"
"25626","350050 AGUAS DE LINDOIA",1,2,0,219,0,222,"2014"
"25627","350055 AGUAS DE SANTA BARBARA",1,1,4,70,0,76,"2014"
"25628","350060 AGUAS DE SAO PEDRO",0,0,0,26,0,26,"2014"
"25629","350070 AGUDOS",2,2,6,477,28,515,"2014"
"25630","350075 ALAMBARI",0,0,1,57,0,58,"2014"
"25631","350080 ALFREDO MARCONDES",0,0,0,41,0,41,"2014"
"25632","350090 ALTAIR",0,0,1,41,4,46,"2014"
"25633","350100 ALTINOPOLIS",0,0,3,172,6,181,"2014"
"25634","350110 ALTO ALEGRE",0,0,0,52,1,53,"2014"
"25635","350115 ALUMINIO",1,1,4,229,1,236,"2014"
"25636","350120 ALVARES FLORENCE",0,0,0,38,0,38,"2014"
"25637","350130 ALVARES MACHADO",0,1,6,326,0,333,"2014"
"25638","350140 ALVARO DE CARVALHO",0,0,0,43,0,43,"2014"
"25639","350150 ALVINLANDIA",0,0,1,45,0,46,"2014"
"25640","350160 AMERICANA",6,7,39,2631,4,2687,"2014"
"25641","350170 AMERICO BRASILIENSE",1,2,9,546,1,559,"2014"
"25642","350180 AMERICO DE CAMPOS",0,0,1,68,0,69,"2014"
"25643","350190 AMPARO",1,2,13,858,0,874,"2014"
"25644","350200 ANALANDIA",0,0,0,50,0,50,"2014"
"25645","350210 ANDRADINA",2,2,4,719,0,727,"2014"
"25646","350220 ANGATUBA",0,1,5,326,1,333,"2014"
"25647","350230 ANHEMBI",0,0,3,86,1,90,"2014"
"25648","350240 ANHUMAS",0,0,1,37,0,38,"2014"
"25649","350250 APARECIDA",0,4,8,505,3,520,"2014"
"25650","350260 APARECIDA D'OESTE",0,0,0,38,0,38,"2014"
"25651","350270 APIAI",1,3,11,371,0,386,"2014"
"25652","350275 ARACARIGUAMA",1,0,4,316,3,324,"2014"
"25653","350280 ARACATUBA",2,9,43,2442,0,2496,"2014"
"25654","350290 ARACOIABA DA SERRA",2,3,12,341,3,361,"2014"
"25655","350300 ARAMINA",0,1,0,76,0,77,"2014"
"25656","350310 ARANDU",1,0,2,70,0,73,"2014"
"25657","350315 ARAPEI",0,0,0,19,1,20,"2014"
"25658","350320 ARARAQUARA",4,7,18,2894,3,2926,"2014"
"25659","350330 ARARAS",4,9,21,1588,4,1626,"2014"
"25660","350335 ARCO-IRIS",0,0,0,29,0,29,"2014"
"25661","350340 AREALVA",0,1,2,79,0,82,"2014"
"25662","350350 AREIAS",0,0,1,34,0,35,"2014"
"25663","350360 AREIOPOLIS",0,0,7,147,1,155,"2014"
"25664","350370 ARIRANHA",0,0,1,95,0,96,"2014"
"25665","350380 ARTUR NOGUEIRA",0,3,12,557,2,574,"2014"
"25666","350390 ARUJA",3,6,14,1323,3,1349,"2014"
"25667","350395 ASPASIA",0,0,0,23,0,23,"2014"
"25668","350400 ASSIS",2,1,13,1313,4,1333,"2014"
"25669","350410 ATIBAIA",6,3,28,1928,6,1971,"2014"
"25670","350420 AURIFLAMA",0,0,2,183,1,186,"2014"
"25671","350430 AVAI",0,0,2,68,1,71,"2014"
"25672","350440 AVANHANDAVA",0,0,4,131,0,135,"2014"
"25673","350450 AVARE",7,5,10,1339,11,1372,"2014"
"25674","350460 BADY BASSITT",0,0,0,225,0,225,"2014"
"25675","350470 BALBINOS",0,0,1,11,0,12,"2014"
"25676","350480 BALSAMO",0,0,0,69,0,69,"2014"
"25677","350490 BANANAL",0,0,1,81,0,82,"2014"
"25678","350500 BARAO DE ANTONINA",0,0,3,49,0,52,"2014"
"25679","350510 BARBOSA",0,0,3,84,1,88,"2014"
"25680","350520 BARIRI",1,2,4,386,3,396,"2014"
"25681","350530 BARRA BONITA",1,1,2,319,3,326,"2014"
"25682","350535 BARRA DO CHAPEU",1,0,5,64,0,70,"2014"
"25683","350540 BARRA DO TURVO",0,0,1,58,4,63,"2014"
"25684","350550 BARRETOS",19,5,24,1500,1,1549,"2014"
"25685","350560 BARRINHA",1,1,7,462,5,476,"2014"
"25686","350570 BARUERI",12,21,55,5454,5,5547,"2014"
"25687","350580 BASTOS",0,2,3,261,0,266,"2014"
"25688","350590 BATATAIS",3,2,4,667,22,698,"2014"
"25689","350600 BAURU",21,18,70,4808,30,4947,"2014"
"25690","350610 BEBEDOURO",6,5,12,903,2,928,"2014"
"25691","350620 BENTO DE ABREU",0,0,1,36,1,38,"2014"
"25692","350630 BERNARDINO DE CAMPOS",0,0,2,121,0,123,"2014"
"25693","350635 BERTIOGA",2,3,10,944,2,961,"2014"
"25694","350640 BILAC",0,1,4,90,1,96,"2014"
"25695","350650 BIRIGUI",2,3,16,1508,0,1529,"2014"
"25696","350660 BIRITIBA-MIRIM",0,0,3,394,6,403,"2014"
"25697","350670 BOA ESPERANCA DO SUL",0,0,3,210,2,215,"2014"
"25698","350680 BOCAINA",0,1,1,159,5,166,"2014"
"25699","350690 BOFETE",1,1,4,106,2,114,"2014"
"25700","350700 BOITUVA",0,6,11,846,0,863,"2014"
"25701","350710 BOM JESUS DOS PERDOES",1,0,4,297,1,303,"2014"
"25702","350715 BOM SUCESSO DE ITARARE",0,2,4,72,0,78,"2014"
"25703","350720 BORA",0,0,0,16,0,16,"2014"
"25704","350730 BORACEIA",0,0,0,51,1,52,"2014"
"25705","350740 BORBOREMA",1,0,4,163,0,168,"2014"
"25706","350745 BOREBI",0,0,0,42,0,42,"2014"
"25707","350750 BOTUCATU",7,14,46,1805,5,1877,"2014"
"25708","350760 BRAGANCA PAULISTA",5,1,24,2183,1,2214,"2014"
"25709","350770 BRAUNA",0,0,2,71,1,74,"2014"
"25710","350775 BREJO ALEGRE",0,0,1,23,0,24,"2014"
"25711","350780 BRODOWSKI",0,1,4,300,3,308,"2014"
"25712","350790 BROTAS",1,2,2,277,1,283,"2014"
"25713","350800 BURI",0,5,13,280,1,299,"2014"
"25714","350810 BURITAMA",0,0,1,216,0,217,"2014"
"25715","350820 BURITIZAL",0,1,0,46,0,47,"2014"
"25716","350830 CABRALIA PAULISTA",1,0,3,58,0,62,"2014"
"25717","350840 CABREUVA",3,5,14,708,1,731,"2014"
"25718","350850 CACAPAVA",1,3,10,1288,0,1302,"2014"
"25719","350860 CACHOEIRA PAULISTA",1,1,3,337,15,357,"2014"
"25720","350870 CACONDE",0,1,6,173,1,181,"2014"
"25721","350880 CAFELANDIA",0,1,2,202,2,207,"2014"
"25722","350890 CAIABU",0,0,0,48,0,48,"2014"
"25723","350900 CAIEIRAS",1,6,27,1358,6,1398,"2014"
"25724","350910 CAIUA",0,1,2,39,1,43,"2014"
"25725","350920 CAJAMAR",2,2,19,1185,0,1208,"2014"
"25726","350925 CAJATI",0,2,3,500,1,506,"2014"
"25727","350930 CAJOBI",0,1,4,109,0,114,"2014"
"25728","350940 CAJURU",0,2,2,364,3,371,"2014"
"25729","350945 CAMPINA DO MONTE ALEGRE",0,0,0,71,0,71,"2014"
"25730","350950 CAMPINAS",45,68,176,15651,57,15997,"2014"
"25731","350960 CAMPO LIMPO PAULISTA",3,2,16,1190,1,1212,"2014"
"25732","350970 CAMPOS DO JORDAO",3,4,12,704,2,725,"2014"
"25733","350980 CAMPOS NOVOS PAULISTA",0,1,3,55,0,59,"2014"
"25734","350990 CANANEIA",2,0,2,174,5,183,"2014"
"25735","350995 CANAS",0,0,2,75,10,87,"2014"
"25736","351000 CANDIDO MOTA",0,0,1,293,3,297,"2014"
"25737","351010 CANDIDO RODRIGUES",0,0,0,19,0,19,"2014"
"25738","351015 CANITAR",0,0,0,62,0,62,"2014"
"25739","351020 CAPAO BONITO",3,0,10,698,1,712,"2014"
"25740","351030 CAPELA DO ALTO",1,1,8,253,0,263,"2014"
"25741","351040 CAPIVARI",1,5,4,700,1,711,"2014"
"25742","351050 CARAGUATATUBA",1,6,19,1589,0,1615,"2014"
"25743","351060 CARAPICUIBA",20,18,83,6947,28,7096,"2014"
"25744","351070 CARDOSO",0,0,0,122,1,123,"2014"
"25745","351080 CASA BRANCA",1,1,4,288,2,296,"2014"
"25746","351090 CASSIA DOS COQUEIROS",0,0,0,23,0,23,"2014"
"25747","351100 CASTILHO",0,1,11,255,0,267,"2014"
"25748","351110 CATANDUVA",7,7,13,1411,2,1440,"2014"
"25749","351120 CATIGUA",0,3,0,91,1,95,"2014"
"25750","351130 CEDRAL",0,1,0,81,0,82,"2014"
"25751","351140 CERQUEIRA CESAR",0,1,2,230,0,233,"2014"
"25752","351150 CERQUILHO",0,2,5,545,1,553,"2014"
"25753","351160 CESARIO LANGE",0,0,3,247,0,250,"2014"
"25754","351170 CHARQUEADA",0,0,2,204,2,208,"2014"
"25755","351190 CLEMENTINA",1,0,2,104,0,107,"2014"
"25756","351200 COLINA",2,4,5,233,1,245,"2014"
"25757","351210 COLOMBIA",3,1,1,109,1,115,"2014"
"25758","351220 CONCHAL",2,1,3,392,6,404,"2014"
"25759","351230 CONCHAS",1,1,4,212,1,219,"2014"
"25760","351240 CORDEIROPOLIS",0,1,4,293,1,299,"2014"
"25761","351250 COROADOS",0,0,1,65,0,66,"2014"
"25762","351260 CORONEL MACEDO",0,1,2,45,0,48,"2014"
"25763","351270 CORUMBATAI",0,1,0,52,0,53,"2014"
"25764","351280 COSMOPOLIS",5,3,11,813,0,832,"2014"
"25765","351290 COSMORAMA",0,0,1,74,0,75,"2014"
"25766","351300 COTIA",5,11,45,4182,16,4259,"2014"
"25767","351310 CRAVINHOS",1,2,5,398,3,409,"2014"
"25768","351320 CRISTAIS PAULISTA",0,0,1,100,0,101,"2014"
"25769","351330 CRUZALIA",0,0,0,15,0,15,"2014"
"25770","351340 CRUZEIRO",3,7,19,1039,4,1072,"2014"
"25771","351350 CUBATAO",5,12,36,1843,1,1897,"2014"
"25772","351360 CUNHA",1,1,5,220,0,227,"2014"
"25773","351370 DESCALVADO",2,1,1,364,0,368,"2014"
"25774","351380 DIADEMA",16,25,85,6243,23,6392,"2014"
"25775","351385 DIRCE REIS",0,0,0,16,0,16,"2014"
"25776","351390 DIVINOLANDIA",0,0,1,117,3,121,"2014"
"25777","351400 DOBRADA",0,0,0,128,0,128,"2014"
"25778","351410 DOIS CORREGOS",0,2,4,351,11,368,"2014"
"25779","351420 DOLCINOPOLIS",0,0,0,26,0,26,"2014"
"25780","351430 DOURADO",0,0,1,73,1,75,"2014"
"25781","351440 DRACENA",4,1,11,473,2,491,"2014"
"25782","351450 DUARTINA",0,1,0,135,2,138,"2014"
"25783","351460 DUMONT",1,0,1,98,0,100,"2014"
"25784","351470 ECHAPORA",0,0,3,64,0,67,"2014"
"25785","351480 ELDORADO",1,0,2,204,4,211,"2014"
"25786","351490 ELIAS FAUSTO",0,1,0,207,0,208,"2014"
"25787","351492 ELISIARIO",1,0,0,43,0,44,"2014"
"25788","351495 EMBAUBA",0,0,1,19,0,20,"2014"
"25789","351500 EMBU DAS ARTES",7,19,56,4482,11,4575,"2014"
"25790","351510 EMBU-GUACU",2,5,13,899,8,927,"2014"
"25791","351512 EMILIANOPOLIS",0,0,0,27,0,27,"2014"
"25792","351515 ENGENHEIRO COELHO",0,0,1,246,2,249,"2014"
"25793","351518 ESPIRITO SANTO DO PINHAL",1,3,10,473,0,487,"2014"
"25794","351519 ESPIRITO SANTO DO TURVO",0,0,0,56,0,56,"2014"
"25795","351520 ESTRELA D'OESTE",1,0,0,109,0,110,"2014"
"25796","351530 ESTRELA DO NORTE",0,0,1,27,0,28,"2014"
"25797","351535 EUCLIDES DA CUNHA PAULISTA",0,0,1,101,0,102,"2014"
"25798","351540 FARTURA",1,0,5,204,0,210,"2014"
"25799","351550 FERNANDOPOLIS",3,1,12,782,2,800,"2014"
"25800","351560 FERNANDO PRESTES",1,0,1,50,1,53,"2014"
"25801","351565 FERNAO",0,1,0,17,0,18,"2014"
"25802","351570 FERRAZ DE VASCONCELOS",7,8,41,2699,17,2772,"2014"
"25803","351580 FLORA RICA",0,0,0,22,0,22,"2014"
"25804","351590 FLOREAL",0,0,1,23,0,24,"2014"
"25805","351600 FLORIDA PAULISTA",0,0,1,118,0,119,"2014"
"25806","351610 FLORINIA",0,0,0,39,1,40,"2014"
"25807","351620 FRANCA",11,18,84,4707,10,4830,"2014"
"25808","351630 FRANCISCO MORATO",7,8,47,2991,14,3067,"2014"
"25809","351640 FRANCO DA ROCHA",2,6,29,2193,13,2243,"2014"
"25810","351650 GABRIEL MONTEIRO",0,0,0,33,0,33,"2014"
"25811","351660 GALIA",0,0,2,70,0,72,"2014"
"25812","351670 GARCA",2,6,16,520,1,545,"2014"
"25813","351680 GASTAO VIDIGAL",0,1,2,41,0,44,"2014"
"25814","351685 GAVIAO PEIXOTO",0,0,0,60,0,60,"2014"
"25815","351690 GENERAL SALGADO",0,0,1,133,0,134,"2014"
"25816","351700 GETULINA",0,0,2,110,5,117,"2014"
"25817","351710 GLICERIO",0,0,2,63,0,65,"2014"
"25818","351720 GUAICARA",3,0,4,139,10,156,"2014"
"25819","351730 GUAIMBE",1,0,2,64,2,69,"2014"
"25820","351740 GUAIRA",1,4,5,467,3,480,"2014"
"25821","351750 GUAPIACU",0,0,3,229,0,232,"2014"
"25822","351760 GUAPIARA",1,4,6,233,0,244,"2014"
"25823","351770 GUARA",0,1,2,241,7,251,"2014"
"25824","351780 GUARACAI",0,0,1,70,0,71,"2014"
"25825","351790 GUARACI",1,0,5,106,2,114,"2014"
"25826","351800 GUARANI D'OESTE",0,0,0,23,0,23,"2014"
"25827","351810 GUARANTA",1,0,1,65,1,68,"2014"
"25828","351820 GUARARAPES",1,2,9,367,2,381,"2014"
"25829","351830 GUARAREMA",0,1,6,419,0,426,"2014"
"25830","351840 GUARATINGUETA",1,9,38,1471,11,1530,"2014"
"25831","351850 GUAREI",0,2,2,159,1,164,"2014"
"25832","351860 GUARIBA",1,0,19,509,1,530,"2014"
"25833","351870 GUARUJA",17,21,54,4536,46,4674,"2014"
"25834","351880 GUARULHOS",41,90,299,21277,68,21775,"2014"
"25835","351885 GUATAPARA",0,1,2,109,2,114,"2014"
"25836","351890 GUZOLANDIA",1,0,0,58,0,59,"2014"
"25837","351900 HERCULANDIA",0,1,1,99,1,102,"2014"
"25838","351905 HOLAMBRA",0,1,1,191,0,193,"2014"
"25839","351907 HORTOLANDIA",1,12,38,2966,8,3025,"2014"
"25840","351910 IACANGA",0,1,0,149,5,155,"2014"
"25841","351920 IACRI",0,1,0,65,0,66,"2014"
"25842","351925 IARAS",0,0,1,77,0,78,"2014"
"25843","351930 IBATE",0,1,4,519,1,525,"2014"
"25844","351940 IBIRA",0,1,0,173,0,174,"2014"
"25845","351950 IBIRAREMA",0,1,1,69,1,72,"2014"
"25846","351960 IBITINGA",0,1,13,715,10,739,"2014"
"25847","351970 IBIUNA",5,6,22,986,67,1086,"2014"
"25848","351980 ICEM",0,0,0,97,0,97,"2014"
"25849","351990 IEPE",0,0,1,91,0,92,"2014"
"25850","352000 IGARACU DO TIETE",0,3,2,285,1,291,"2014"
"25851","352010 IGARAPAVA",1,0,3,306,9,319,"2014"
"25852","352020 IGARATA",0,1,4,122,1,128,"2014"
"25853","352030 IGUAPE",2,2,7,299,3,313,"2014"
"25854","352040 ILHABELA",0,1,5,443,0,449,"2014"
"25855","352042 ILHA COMPRIDA",0,0,3,132,1,136,"2014"
"25856","352044 ILHA SOLTEIRA",0,4,2,281,0,287,"2014"
"25857","352050 INDAIATUBA",6,4,13,3080,15,3118,"2014"
"25858","352060 INDIANA",0,0,0,69,0,69,"2014"
"25859","352070 INDIAPORA",0,0,1,43,0,44,"2014"
"25860","352080 INUBIA PAULISTA",0,0,1,36,0,37,"2014"
"25861","352090 IPAUSSU",1,1,3,170,4,179,"2014"
"25862","352100 IPERO",0,1,4,354,0,359,"2014"
"25863","352110 IPEUNA",0,0,2,112,0,114,"2014"
"25864","352115 IPIGUA",0,0,0,50,0,50,"2014"
"25865","352120 IPORANGA",1,0,1,71,0,73,"2014"
"25866","352130 IPUA",3,2,3,169,0,177,"2014"
"25867","352140 IRACEMAPOLIS",0,0,1,279,1,281,"2014"
"25868","352150 IRAPUA",0,0,3,96,1,100,"2014"
"25869","352160 IRAPURU",0,0,0,62,0,62,"2014"
"25870","352170 ITABERA",0,3,11,234,1,249,"2014"
"25871","352180 ITAI",1,0,6,323,2,332,"2014"
"25872","352190 ITAJOBI",0,0,3,144,1,148,"2014"
"25873","352200 ITAJU",0,0,0,31,1,32,"2014"
"25874","352210 ITANHAEM",1,6,16,1398,13,1434,"2014"
"25875","352215 ITAOCA",0,1,0,42,0,43,"2014"
"25876","352220 ITAPECERICA DA SERRA",13,12,47,2830,9,2911,"2014"
"25877","352230 ITAPETININGA",2,1,25,2101,10,2139,"2014"
"25878","352240 ITAPEVA",5,14,50,1394,2,1465,"2014"
"25879","352250 ITAPEVI",7,15,66,4217,17,4322,"2014"
"25880","352260 ITAPIRA",1,1,8,806,0,816,"2014"
"25881","352265 ITAPIRAPUA PAULISTA",0,0,3,49,1,53,"2014"
"25882","352270 ITAPOLIS",2,3,20,459,1,485,"2014"
"25883","352280 ITAPORANGA",0,2,1,188,2,193,"2014"
"25884","352290 ITAPUI",0,0,0,147,1,148,"2014"
"25885","352300 ITAPURA",0,0,1,61,0,62,"2014"
"25886","352310 ITAQUAQUECETUBA",8,26,72,5888,23,6017,"2014"
"25887","352320 ITARARE",1,6,15,626,0,648,"2014"
"25888","352330 ITARIRI",0,1,0,145,3,149,"2014"
"25889","352340 ITATIBA",3,3,10,1448,0,1464,"2014"
"25890","352350 ITATINGA",0,0,5,238,1,244,"2014"
"25891","352360 ITIRAPINA",1,1,0,176,0,178,"2014"
"25892","352370 ITIRAPUA",0,0,2,64,3,69,"2014"
"25893","352380 ITOBI",0,0,2,86,0,88,"2014"
"25894","352390 ITU",7,4,28,2418,19,2476,"2014"
"25895","352400 ITUPEVA",0,3,19,863,0,885,"2014"
"25896","352410 ITUVERAVA",0,0,5,442,1,448,"2014"
"25897","352420 JABORANDI",0,1,0,48,0,49,"2014"
"25898","352430 JABOTICABAL",3,3,9,841,0,856,"2014"
"25899","352440 JACAREI",3,15,51,3302,20,3391,"2014"
"25900","352450 JACI",0,0,1,72,0,73,"2014"
"25901","352460 JACUPIRANGA",0,1,2,253,0,256,"2014"
"25902","352470 JAGUARIUNA",2,3,7,672,0,684,"2014"
"25903","352480 JALES",0,1,4,531,0,536,"2014"
"25904","352490 JAMBEIRO",0,1,1,67,0,69,"2014"
"25905","352500 JANDIRA",3,4,29,1799,12,1847,"2014"
"25906","352510 JARDINOPOLIS",1,1,12,472,2,488,"2014"
"25907","352520 JARINU",0,1,12,450,4,467,"2014"
"25908","352530 JAU",2,4,12,1696,15,1729,"2014"
"25909","352540 JERIQUARA",0,0,1,30,0,31,"2014"
"25910","352550 JOANOPOLIS",0,0,2,128,1,131,"2014"
"25911","352560 JOAO RAMALHO",0,0,3,53,0,56,"2014"
"25912","352570 JOSE BONIFACIO",0,1,4,428,0,433,"2014"
"25913","352580 JULIO MESQUITA",0,0,4,62,0,66,"2014"
"25914","352585 JUMIRIM",0,1,1,31,1,34,"2014"
"25915","352590 JUNDIAI",9,15,55,5314,12,5405,"2014"
"25916","352600 JUNQUEIROPOLIS",0,0,1,247,0,248,"2014"
"25917","352610 JUQUIA",0,0,4,326,2,332,"2014"
"25918","352620 JUQUITIBA",4,0,6,435,4,449,"2014"
"25919","352630 LAGOINHA",0,1,1,23,0,25,"2014"
"25920","352640 LARANJAL PAULISTA",2,1,7,389,0,399,"2014"
"25921","352650 LAVINIA",0,0,1,43,0,44,"2014"
"25922","352660 LAVRINHAS",0,1,3,92,2,98,"2014"
"25923","352670 LEME",4,5,7,1184,101,1301,"2014"
"25924","352680 LENCOIS PAULISTA",0,4,12,937,2,955,"2014"
"25925","352690 LIMEIRA",5,7,25,3548,20,3605,"2014"
"25926","352700 LINDOIA",0,0,0,77,0,77,"2014"
"25927","352710 LINS",1,2,8,895,51,957,"2014"
"25928","352720 LORENA",5,1,14,1070,115,1205,"2014"
"25929","352725 LOURDES",0,0,1,27,0,28,"2014"
"25930","352730 LOUVEIRA",3,2,13,720,1,739,"2014"
"25931","352740 LUCELIA",0,1,11,197,0,209,"2014"
"25932","352750 LUCIANOPOLIS",0,0,0,23,0,23,"2014"
"25933","352760 LUIS ANTONIO",0,0,6,163,1,170,"2014"
"25934","352770 LUIZIANIA",0,0,0,86,0,86,"2014"
"25935","352780 LUPERCIO",1,1,3,61,0,66,"2014"
"25936","352790 LUTECIA",0,0,1,42,0,43,"2014"
"25937","352800 MACATUBA",1,0,3,214,0,218,"2014"
"25938","352810 MACAUBAL",0,0,0,71,0,71,"2014"
"25939","352820 MACEDONIA",0,0,0,22,0,22,"2014"
"25940","352830 MAGDA",0,0,0,39,0,39,"2014"
"25941","352840 MAIRINQUE",1,2,11,685,3,702,"2014"
"25942","352850 MAIRIPORA",5,3,9,1150,0,1167,"2014"
"25943","352860 MANDURI",0,0,0,89,0,89,"2014"
"25944","352870 MARABA PAULISTA",0,1,0,34,0,35,"2014"
"25945","352880 MARACAI",0,0,1,183,0,184,"2014"
"25946","352885 MARAPOAMA",0,2,1,27,0,30,"2014"
"25947","352890 MARIAPOLIS",0,0,0,46,0,46,"2014"
"25948","352900 MARILIA",7,23,53,2826,4,2913,"2014"
"25949","352910 MARINOPOLIS",0,1,0,23,0,24,"2014"
"25950","352920 MARTINOPOLIS",0,1,6,296,1,304,"2014"
"25951","352930 MATAO",2,6,12,1027,0,1047,"2014"
"25952","352940 MAUA",10,17,71,5698,23,5819,"2014"
"25953","352950 MENDONCA",0,0,0,59,0,59,"2014"
"25954","352960 MERIDIANO",0,0,0,48,0,48,"2014"
"25955","352965 MESOPOLIS",0,0,0,22,0,22,"2014"
"25956","352970 MIGUELOPOLIS",1,0,1,273,1,276,"2014"
"25957","352980 MINEIROS DO TIETE",1,0,3,144,1,149,"2014"
"25958","352990 MIRACATU",1,1,4,306,2,314,"2014"
"25959","353000 MIRA ESTRELA",0,1,0,36,0,37,"2014"
"25960","353010 MIRANDOPOLIS",1,1,6,305,0,313,"2014"
"25961","353020 MIRANTE DO PARANAPANEMA",0,0,5,208,27,240,"2014"
"25962","353030 MIRASSOL",0,2,8,752,0,762,"2014"
"25963","353040 MIRASSOLANDIA",0,0,1,40,0,41,"2014"
"25964","353050 MOCOCA",4,2,15,874,5,900,"2014"
"25965","353060 MOGI DAS CRUZES",6,17,64,6080,39,6206,"2014"
"25966","353070 MOGI GUACU",7,5,26,1896,0,1934,"2014"
"25967","353080 MOGI MIRIM",1,2,9,1149,6,1167,"2014"
"25968","353090 MOMBUCA",0,0,2,44,0,46,"2014"
"25969","353100 MONCOES",0,0,0,29,0,29,"2014"
"25970","353110 MONGAGUA",1,4,12,657,1,675,"2014"
"25971","353120 MONTE ALEGRE DO SUL",0,0,2,71,0,73,"2014"
"25972","353130 MONTE ALTO",1,2,11,556,1,571,"2014"
"25973","353140 MONTE APRAZIVEL",0,1,2,252,0,255,"2014"
"25974","353150 MONTE AZUL PAULISTA",0,0,1,231,0,232,"2014"
"25975","353160 MONTE CASTELO",0,0,1,58,0,59,"2014"
"25976","353170 MONTEIRO LOBATO",1,1,0,52,1,55,"2014"
"25977","353180 MONTE MOR",2,3,7,882,29,923,"2014"
"25978","353190 MORRO AGUDO",3,0,6,390,0,399,"2014"
"25979","353200 MORUNGABA",2,0,0,181,0,183,"2014"
"25980","353205 MOTUCA",0,0,0,50,1,51,"2014"
"25981","353210 MURUTINGA DO SUL",0,3,1,45,0,49,"2014"
"25982","353215 NANTES",0,0,0,38,0,38,"2014"
"25983","353220 NARANDIBA",0,0,1,91,0,92,"2014"
"25984","353230 NATIVIDADE DA SERRA",0,0,0,66,1,67,"2014"
"25985","353240 NAZARE PAULISTA",0,0,4,253,0,257,"2014"
"25986","353250 NEVES PAULISTA",0,0,0,82,0,82,"2014"
"25987","353260 NHANDEARA",0,0,1,113,0,114,"2014"
"25988","353270 NIPOA",0,0,1,68,0,69,"2014"
"25989","353280 NOVA ALIANCA",0,0,0,62,0,62,"2014"
"25990","353282 NOVA CAMPINA",0,1,5,134,0,140,"2014"
"25991","353284 NOVA CANAA PAULISTA",0,0,0,16,0,16,"2014"
"25992","353286 NOVA CASTILHO",0,0,0,12,0,12,"2014"
"25993","353290 NOVA EUROPA",0,0,0,132,0,132,"2014"
"25994","353300 NOVA GRANADA",0,0,4,279,0,283,"2014"
"25995","353310 NOVA GUATAPORANGA",0,0,0,34,0,34,"2014"
"25996","353320 NOVA INDEPENDENCIA",0,0,1,51,0,52,"2014"
"25997","353325 NOVAIS",1,1,2,56,0,60,"2014"
"25998","353330 NOVA LUZITANIA",0,0,0,43,0,43,"2014"
"25999","353340 NOVA ODESSA",0,2,6,724,0,732,"2014"
"26000","353350 NOVO HORIZONTE",0,0,2,474,0,476,"2014"
"26001","353360 NUPORANGA",0,0,0,85,0,85,"2014"
"26002","353370 OCAUCU",0,0,0,48,0,48,"2014"
"26003","353380 OLEO",0,0,0,26,0,26,"2014"
"26004","353390 OLIMPIA",2,1,10,658,11,682,"2014"
"26005","353400 ONDA VERDE",0,1,1,54,0,56,"2014"
"26006","353410 ORIENTE",0,1,2,74,0,77,"2014"
"26007","353420 ORINDIUVA",0,0,0,84,0,84,"2014"
"26008","353430 ORLANDIA",2,3,5,484,1,495,"2014"
"26009","353440 OSASCO",28,36,132,10328,54,10578,"2014"
"26010","353450 OSCAR BRESSANE",0,0,0,19,0,19,"2014"
"26011","353460 OSVALDO CRUZ",0,1,3,334,0,338,"2014"
"26012","353470 OURINHOS",6,6,20,1374,15,1421,"2014"
"26013","353475 OUROESTE",0,0,2,130,0,132,"2014"
"26014","353480 OURO VERDE",0,0,4,107,2,113,"2014"
"26015","353490 PACAEMBU",0,0,3,109,1,113,"2014"
"26016","353500 PALESTINA",0,0,0,133,0,133,"2014"
"26017","353510 PALMARES PAULISTA",1,1,0,143,0,145,"2014"
"26018","353520 PALMEIRA D'OESTE",0,0,1,83,0,84,"2014"
"26019","353530 PALMITAL",0,0,0,254,6,260,"2014"
"26020","353540 PANORAMA",0,1,12,234,0,247,"2014"
"26021","353550 PARAGUACU PAULISTA",1,2,3,581,1,588,"2014"
"26022","353560 PARAIBUNA",2,0,1,204,2,209,"2014"
"26023","353570 PARAISO",0,0,1,49,0,50,"2014"
"26024","353580 PARANAPANEMA",1,4,4,257,11,277,"2014"
"26025","353590 PARANAPUA",1,1,1,54,0,57,"2014"
"26026","353600 PARAPUA",0,1,2,119,0,122,"2014"
"26027","353610 PARDINHO",0,1,3,93,1,98,"2014"
"26028","353620 PARIQUERA-ACU",3,1,5,311,0,320,"2014"
"26029","353625 PARISI",0,0,0,21,0,21,"2014"
"26030","353630 PATROCINIO PAULISTA",0,1,12,206,5,224,"2014"
"26031","353640 PAULICEIA",0,3,1,113,0,117,"2014"
"26032","353650 PAULINIA",1,3,16,1361,7,1388,"2014"
"26033","353657 PAULISTANIA",0,0,1,24,0,25,"2014"
"26034","353660 PAULO DE FARIA",0,0,1,71,0,72,"2014"
"26035","353670 PEDERNEIRAS",5,5,6,647,4,667,"2014"
"26036","353680 PEDRA BELA",0,0,0,63,0,63,"2014"
"26037","353690 PEDRANOPOLIS",0,0,0,17,0,17,"2014"
"26038","353700 PEDREGULHO",2,1,1,216,1,221,"2014"
"26039","353710 PEDREIRA",0,3,8,441,55,507,"2014"
"26040","353715 PEDRINHAS PAULISTA",0,0,0,26,0,26,"2014"
"26041","353720 PEDRO DE TOLEDO",0,4,1,114,1,120,"2014"
"26042","353730 PENAPOLIS",2,3,16,743,3,767,"2014"
"26043","353740 PEREIRA BARRETO",0,4,8,310,0,322,"2014"
"26044","353750 PEREIRAS",0,0,1,95,0,96,"2014"
"26045","353760 PERUIBE",2,12,17,934,72,1037,"2014"
"26046","353770 PIACATU",0,1,0,60,0,61,"2014"
"26047","353780 PIEDADE",1,5,12,681,20,719,"2014"
"26048","353790 PILAR DO SUL",3,4,13,425,0,445,"2014"
"26049","353800 PINDAMONHANGABA",1,4,39,2312,61,2417,"2014"
"26050","353810 PINDORAMA",2,1,0,188,1,192,"2014"
"26051","353820 PINHALZINHO",0,0,0,155,1,156,"2014"
"26052","353830 PIQUEROBI",1,0,0,35,0,36,"2014"
"26053","353850 PIQUETE",3,0,1,147,18,169,"2014"
"26054","353860 PIRACAIA",0,1,4,294,1,300,"2014"
"26055","353870 PIRACICABA",18,22,56,5308,8,5412,"2014"
"26056","353880 PIRAJU",1,0,2,392,0,395,"2014"
"26057","353890 PIRAJUI",0,0,2,236,1,239,"2014"
"26058","353900 PIRANGI",0,0,2,121,0,123,"2014"
"26059","353910 PIRAPORA DO BOM JESUS",0,2,1,249,3,255,"2014"
"26060","353920 PIRAPOZINHO",0,2,7,294,0,303,"2014"
"26061","353930 PIRASSUNUNGA",4,2,11,846,2,865,"2014"
"26062","353940 PIRATININGA",1,2,1,164,1,169,"2014"
"26063","353950 PITANGUEIRAS",0,2,2,492,1,497,"2014"
"26064","353960 PLANALTO",0,0,1,78,0,79,"2014"
"26065","353970 PLATINA",0,0,0,50,1,51,"2014"
"26066","353980 POA",3,7,27,1699,10,1746,"2014"
"26067","353990 POLONI",0,1,1,67,0,69,"2014"
"26068","354000 POMPEIA",1,2,5,247,0,255,"2014"
"26069","354010 PONGAI",0,0,0,33,2,35,"2014"
"26070","354020 PONTAL",3,4,3,581,1,592,"2014"
"26071","354025 PONTALINDA",0,0,2,64,0,66,"2014"
"26072","354030 PONTES GESTAL",0,0,0,30,0,30,"2014"
"26073","354040 POPULINA",0,0,0,43,0,43,"2014"
"26074","354050 PORANGABA",1,0,2,74,2,79,"2014"
"26075","354060 PORTO FELIZ",1,1,10,703,0,715,"2014"
"26076","354070 PORTO FERREIRA",3,0,4,613,4,624,"2014"
"26077","354075 POTIM",2,3,5,256,1,267,"2014"
"26078","354080 POTIRENDABA",0,1,1,218,0,220,"2014"
"26079","354085 PRACINHA",0,0,0,21,0,21,"2014"
"26080","354090 PRADOPOLIS",0,0,5,221,0,226,"2014"
"26081","354100 PRAIA GRANDE",8,28,114,4215,26,4391,"2014"
"26082","354105 PRATANIA",0,1,3,87,0,91,"2014"
"26083","354110 PRESIDENTE ALVES",0,0,0,55,0,55,"2014"
"26084","354120 PRESIDENTE BERNARDES",0,0,0,137,0,137,"2014"
"26085","354130 PRESIDENTE EPITACIO",1,3,9,522,1,536,"2014"
"26086","354140 PRESIDENTE PRUDENTE",7,9,57,2806,1,2880,"2014"
"26087","354150 PRESIDENTE VENCESLAU",0,2,9,432,0,443,"2014"
"26088","354160 PROMISSAO",0,1,4,468,15,488,"2014"
"26089","354165 QUADRA",0,0,0,32,0,32,"2014"
"26090","354170 QUATA",0,0,4,184,2,190,"2014"
"26091","354180 QUEIROZ",0,0,0,33,0,33,"2014"
"26092","354190 QUELUZ",0,0,3,103,3,109,"2014"
"26093","354200 QUINTANA",1,0,2,85,0,88,"2014"
"26094","354210 RAFARD",0,1,3,112,0,116,"2014"
"26095","354220 RANCHARIA",1,1,2,386,1,391,"2014"
"26096","354230 REDENCAO DA SERRA",0,1,2,40,0,43,"2014"
"26097","354240 REGENTE FEIJO",1,2,8,248,0,259,"2014"
"26098","354250 REGINOPOLIS",0,0,1,63,1,65,"2014"
"26099","354260 REGISTRO",4,4,11,924,4,947,"2014"
"26100","354270 RESTINGA",0,0,2,112,0,114,"2014"
"26101","354280 RIBEIRA",0,1,6,40,0,47,"2014"
"26102","354290 RIBEIRAO BONITO",0,0,0,165,0,165,"2014"
"26103","354300 RIBEIRAO BRANCO",0,2,12,286,2,302,"2014"
"26104","354310 RIBEIRAO CORRENTE",0,1,2,70,1,74,"2014"
"26105","354320 RIBEIRAO DO SUL",0,0,0,56,0,56,"2014"
"26106","354323 RIBEIRAO DOS INDIOS",0,0,1,15,0,16,"2014"
"26107","354325 RIBEIRAO GRANDE",0,0,2,100,0,102,"2014"
"26108","354330 RIBEIRAO PIRES",0,4,18,1376,6,1404,"2014"
"26109","354340 RIBEIRAO PRETO",26,43,138,8374,47,8628,"2014"
"26110","354350 RIVERSUL",0,0,1,68,1,70,"2014"
"26111","354360 RIFAINA",1,0,0,42,0,43,"2014"
"26112","354370 RINCAO",0,1,0,130,0,131,"2014"
"26113","354380 RINOPOLIS",0,1,3,107,0,111,"2014"
"26114","354390 RIO CLARO",2,5,38,2489,7,2541,"2014"
"26115","354400 RIO DAS PEDRAS",0,1,4,442,0,447,"2014"
"26116","354410 RIO GRANDE DA SERRA",0,1,3,651,8,663,"2014"
"26117","354420 RIOLANDIA",0,0,1,134,0,135,"2014"
"26118","354425 ROSANA",0,0,7,232,3,242,"2014"
"26119","354430 ROSEIRA",0,0,1,124,2,127,"2014"
"26120","354440 RUBIACEA",0,0,0,47,0,47,"2014"
"26121","354450 RUBINEIA",0,0,0,34,0,34,"2014"
"26122","354460 SABINO",0,0,0,54,2,56,"2014"
"26123","354470 SAGRES",0,0,1,30,0,31,"2014"
"26124","354480 SALES",0,0,0,59,1,60,"2014"
"26125","354490 SALES OLIVEIRA",0,1,0,118,1,120,"2014"
"26126","354500 SALESOPOLIS",1,1,1,184,2,189,"2014"
"26127","354510 SALMOURAO",0,0,0,46,0,46,"2014"
"26128","354515 SALTINHO",0,0,0,85,1,86,"2014"
"26129","354520 SALTO",3,2,21,1530,6,1562,"2014"
"26130","354530 SALTO DE PIRAPORA",1,2,17,587,1,608,"2014"
"26131","354540 SALTO GRANDE",0,1,0,114,1,116,"2014"
"26132","354550 SANDOVALINA",0,0,2,59,0,61,"2014"
"26133","354560 SANTA ADELIA",0,1,3,165,1,170,"2014"
"26134","354570 SANTA ALBERTINA",0,1,1,83,0,85,"2014"
"26135","354580 SANTA BARBARA D'OESTE",9,14,28,2275,3,2329,"2014"
"26136","354600 SANTA BRANCA",0,0,6,133,0,139,"2014"
"26137","354610 SANTA CLARA D'OESTE",0,0,2,39,0,41,"2014"
"26138","354620 SANTA CRUZ DA CONCEICAO",1,0,0,33,3,37,"2014"
"26139","354625 SANTA CRUZ DA ESPERANCA",0,0,0,21,0,21,"2014"
"26140","354630 SANTA CRUZ DAS PALMEIRAS",3,2,11,368,1,385,"2014"
"26141","354640 SANTA CRUZ DO RIO PARDO",1,4,5,594,0,604,"2014"
"26142","354650 SANTA ERNESTINA",0,0,1,63,0,64,"2014"
"26143","354660 SANTA FE DO SUL",0,1,1,380,1,383,"2014"
"26144","354670 SANTA GERTRUDES",2,2,1,336,0,341,"2014"
"26145","354680 SANTA ISABEL",2,1,16,760,5,784,"2014"
"26146","354690 SANTA LUCIA",0,1,0,102,1,104,"2014"
"26147","354700 SANTA MARIA DA SERRA",0,0,0,90,0,90,"2014"
"26148","354710 SANTA MERCEDES",0,0,0,41,0,41,"2014"
"26149","354720 SANTANA DA PONTE PENSA",0,0,0,18,0,18,"2014"
"26150","354730 SANTANA DE PARNAIBA",1,6,27,2145,3,2182,"2014"
"26151","354740 SANTA RITA D'OESTE",1,0,1,21,0,23,"2014"
"26152","354750 SANTA RITA DO PASSA QUATRO",0,0,4,273,0,277,"2014"
"26153","354760 SANTA ROSA DE VITERBO",0,0,4,314,1,319,"2014"
"26154","354765 SANTA SALETE",0,0,0,10,0,10,"2014"
"26155","354770 SANTO ANASTACIO",0,1,4,220,0,225,"2014"
"26156","354780 SANTO ANDRE",26,29,119,8957,22,9153,"2014"
"26157","354790 SANTO ANTONIO DA ALEGRIA",1,0,0,54,0,55,"2014"
"26158","354800 SANTO ANTONIO DE POSSE",0,2,6,277,1,286,"2014"
"26159","354805 SANTO ANTONIO DO ARACANGUA",0,0,0,115,0,115,"2014"
"26160","354810 SANTO ANTONIO DO JARDIM",0,0,0,54,1,55,"2014"
"26161","354820 SANTO ANTONIO DO PINHAL",0,0,1,75,0,76,"2014"
"26162","354830 SANTO EXPEDITO",0,1,0,36,1,38,"2014"
"26163","354840 SANTOPOLIS DO AGUAPEI",0,1,0,54,0,55,"2014"
"26164","354850 SANTOS",11,29,95,4949,27,5111,"2014"
"26165","354860 SAO BENTO DO SAPUCAI",0,0,5,146,0,151,"2014"
"26166","354870 SAO BERNARDO DO CAMPO",25,43,156,10997,36,11257,"2014"
"26167","354880 SAO CAETANO DO SUL",2,6,23,1797,2,1830,"2014"
"26168","354890 SAO CARLOS",8,10,31,3126,8,3183,"2014"
"26169","354900 SAO FRANCISCO",0,0,0,27,0,27,"2014"
"26170","354910 SAO JOAO DA BOA VISTA",1,4,9,992,4,1010,"2014"
"26171","354920 SAO JOAO DAS DUAS PONTES",0,0,0,30,0,30,"2014"
"26172","354925 SAO JOAO DE IRACEMA",0,0,3,17,0,20,"2014"
"26173","354930 SAO JOAO DO PAU D'ALHO",0,1,0,25,0,26,"2014"
"26174","354940 SAO JOAQUIM DA BARRA",3,2,8,587,4,604,"2014"
"26175","354950 SAO JOSE DA BELA VISTA",0,0,2,103,0,105,"2014"
"26176","354960 SAO JOSE DO BARREIRO",1,1,1,37,0,40,"2014"
"26177","354970 SAO JOSE DO RIO PARDO",1,6,14,662,7,690,"2014"
"26178","354980 SAO JOSE DO RIO PRETO",6,12,36,5717,0,5771,"2014"
"26179","354990 SAO JOSE DOS CAMPOS",19,31,119,9718,50,9937,"2014"
"26180","354995 SAO LOURENCO DA SERRA",1,1,2,211,0,215,"2014"
"26181","355000 SAO LUIS DO PARAITINGA",0,2,1,110,3,116,"2014"
"26182","355010 SAO MANUEL",0,1,16,495,1,513,"2014"
"26183","355020 SAO MIGUEL ARCANJO",2,3,6,408,3,422,"2014"
"26184","355030 SAO PAULO",409,683,2308,171850,590,175840,"2014"
"26185","355040 SAO PEDRO",0,2,4,387,0,393,"2014"
"26186","355050 SAO PEDRO DO TURVO",0,1,0,85,0,86,"2014"
"26187","355060 SAO ROQUE",3,1,12,1108,6,1130,"2014"
"26188","355070 SAO SEBASTIAO",4,6,17,1296,0,1323,"2014"
"26189","355080 SAO SEBASTIAO DA GRAMA",0,0,1,123,2,126,"2014"
"26190","355090 SAO SIMAO",0,0,3,155,0,158,"2014"
"26191","355100 SAO VICENTE",10,40,136,4975,32,5193,"2014"
"26192","355110 SARAPUI",1,1,0,106,1,109,"2014"
"26193","355120 SARUTAIA",0,0,0,50,0,50,"2014"
"26194","355130 SEBASTIANOPOLIS DO SUL",0,0,1,39,0,40,"2014"
"26195","355140 SERRA AZUL",0,0,1,144,2,147,"2014"
"26196","355150 SERRANA",3,0,9,645,1,658,"2014"
"26197","355160 SERRA NEGRA",0,2,5,293,0,300,"2014"
"26198","355170 SERTAOZINHO",4,3,13,1773,3,1796,"2014"
"26199","355180 SETE BARRAS",0,0,3,188,1,192,"2014"
"26200","355190 SEVERINIA",0,0,7,201,1,209,"2014"
"26201","355200 SILVEIRAS",0,0,1,65,2,68,"2014"
"26202","355210 SOCORRO",0,0,0,405,2,407,"2014"
"26203","355220 SOROCABA",14,42,151,8853,33,9093,"2014"
"26204","355230 SUD MENNUCCI",0,0,0,101,2,103,"2014"
"26205","355240 SUMARE",9,16,43,3815,14,3897,"2014"
"26206","355250 SUZANO",4,26,81,4418,22,4551,"2014"
"26207","355255 SUZANAPOLIS",0,1,0,36,0,37,"2014"
"26208","355260 TABAPUA",0,1,3,145,0,149,"2014"
"26209","355270 TABATINGA",2,0,1,182,0,185,"2014"
"26210","355280 TABOAO DA SERRA",12,12,58,4650,23,4755,"2014"
"26211","355290 TACIBA",0,0,1,72,0,73,"2014"
"26212","355300 TAGUAI",0,1,2,163,1,167,"2014"
"26213","355310 TAIACU",0,0,0,74,0,74,"2014"
"26214","355320 TAIUVA",2,0,1,56,0,59,"2014"
"26215","355330 TAMBAU",0,0,1,300,1,302,"2014"
"26216","355340 TANABI",0,1,2,298,0,301,"2014"
"26217","355350 TAPIRAI",0,0,2,87,0,89,"2014"
"26218","355360 TAPIRATIBA",0,0,0,134,4,138,"2014"
"26219","355365 TAQUARAL",1,0,0,29,0,30,"2014"
"26220","355370 TAQUARITINGA",5,1,4,672,0,682,"2014"
"26221","355380 TAQUARITUBA",0,0,4,277,1,282,"2014"
"26222","355385 TAQUARIVAI",0,2,2,72,0,76,"2014"
"26223","355390 TARABAI",2,0,2,86,1,91,"2014"
"26224","355395 TARUMA",0,1,2,210,0,213,"2014"
"26225","355400 TATUI",5,4,18,1763,3,1793,"2014"
"26226","355410 TAUBATE",9,20,65,4048,48,4190,"2014"
"26227","355420 TEJUPA",0,0,0,63,0,63,"2014"
"26228","355430 TEODORO SAMPAIO",2,1,7,343,3,356,"2014"
"26229","355440 TERRA ROXA",0,0,2,65,36,103,"2014"
"26230","355450 TIETE",0,2,3,455,0,460,"2014"
"26231","355460 TIMBURI",0,0,0,30,0,30,"2014"
"26232","355465 TORRE DE PEDRA",0,0,1,26,0,27,"2014"
"26233","355470 TORRINHA",0,1,3,93,0,97,"2014"
"26234","355475 TRABIJU",0,0,1,17,0,18,"2014"
"26235","355480 TREMEMBE",1,4,9,550,16,580,"2014"
"26236","355490 TRES FRONTEIRAS",2,0,0,78,0,80,"2014"
"26237","355495 TUIUTI",0,0,1,74,0,75,"2014"
"26238","355500 TUPA",0,2,6,774,0,782,"2014"
"26239","355510 TUPI PAULISTA",1,2,2,191,0,196,"2014"
"26240","355520 TURIUBA",0,0,0,13,0,13,"2014"
"26241","355530 TURMALINA",0,0,0,10,0,10,"2014"
"26242","355535 UBARANA",0,0,1,80,0,81,"2014"
"26243","355540 UBATUBA",2,5,9,1148,6,1170,"2014"
"26244","355550 UBIRAJARA",0,1,4,64,0,69,"2014"
"26245","355560 UCHOA",0,0,0,122,0,122,"2014"
"26246","355570 UNIAO PAULISTA",0,0,0,21,0,21,"2014"
"26247","355580 URANIA",0,0,0,112,0,112,"2014"
"26248","355590 URU",0,0,0,14,0,14,"2014"
"26249","355600 URUPES",1,0,0,134,0,135,"2014"
"26250","355610 VALENTIM GENTIL",1,0,1,166,0,168,"2014"
"26251","355620 VALINHOS",52,6,7,1341,10,1416,"2014"
"26252","355630 VALPARAISO",1,2,3,350,1,357,"2014"
"26253","355635 VARGEM",0,0,3,103,1,107,"2014"
"26254","355640 VARGEM GRANDE DO SUL",0,0,6,572,2,580,"2014"
"26255","355645 VARGEM GRANDE PAULISTA",2,2,8,726,0,738,"2014"
"26256","355650 VARZEA PAULISTA",8,7,25,1710,3,1753,"2014"
"26257","355660 VERA CRUZ",0,1,2,130,0,133,"2014"
"26258","355670 VINHEDO",25,2,8,912,6,953,"2014"
"26259","355680 VIRADOURO",0,0,3,254,0,257,"2014"
"26260","355690 VISTA ALEGRE DO ALTO",0,0,1,79,0,80,"2014"
"26261","355695 VITORIA BRASIL",0,0,0,24,0,24,"2014"
"26262","355700 VOTORANTIM",1,13,24,1647,3,1688,"2014"
"26263","355710 VOTUPORANGA",0,2,6,1077,0,1085,"2014"
"26264","355715 ZACARIAS",0,0,0,28,0,28,"2014"
"26265","355720 CHAVANTES",0,1,2,176,1,180,"2014"
"26266","355730 ESTIVA GERBI",0,0,3,121,0,124,"2014"
"26267","MUNICIPIO IGNORADO - PR",0,0,0,2,0,2,"2014"
"26268","410010 ABATIA",0,0,0,94,0,94,"2014"
"26269","410020 ADRIANOPOLIS",2,1,2,63,1,69,"2014"
"26270","410030 AGUDOS DO SUL",0,2,0,110,1,113,"2014"
"26271","410040 ALMIRANTE TAMANDARE",20,7,29,1850,8,1914,"2014"
"26272","410045 ALTAMIRA DO PARANA",0,0,2,53,0,55,"2014"
"26273","410050 ALTONIA",0,2,4,250,0,256,"2014"
"26274","410060 ALTO PARANA",1,2,0,182,0,185,"2014"
"26275","410070 ALTO PIQUIRI",2,0,11,135,1,149,"2014"
"26276","410080 ALVORADA DO SUL",0,2,3,113,1,119,"2014"
"26277","410090 AMAPORA",0,0,0,84,1,85,"2014"
"26278","410100 AMPERE",0,0,9,269,1,279,"2014"
"26279","410105 ANAHY",0,0,0,27,0,27,"2014"
"26280","410110 ANDIRA",0,1,1,214,0,216,"2014"
"26281","410115 ANGULO",0,0,2,47,0,49,"2014"
"26282","410120 ANTONINA",1,0,4,297,1,303,"2014"
"26283","410130 ANTONIO OLINTO",0,1,2,62,1,66,"2014"
"26284","410140 APUCARANA",12,7,8,1774,3,1804,"2014"
"26285","410150 ARAPONGAS",4,7,8,1637,0,1656,"2014"
"26286","410160 ARAPOTI",2,2,9,343,1,357,"2014"
"26287","410165 ARAPUA",0,0,0,34,0,34,"2014"
"26288","410170 ARARUNA",0,1,1,192,0,194,"2014"
"26289","410180 ARAUCARIA",7,14,33,2401,10,2465,"2014"
"26290","410185 ARIRANHA DO IVAI",0,0,3,29,0,32,"2014"
"26291","410190 ASSAI",3,4,4,239,0,250,"2014"
"26292","410200 ASSIS CHATEAUBRIAND",0,1,7,389,0,397,"2014"
"26293","410210 ASTORGA",0,1,7,313,0,321,"2014"
"26294","410220 ATALAIA",0,0,0,40,0,40,"2014"
"26295","410230 BALSA NOVA",0,0,3,181,2,186,"2014"
"26296","410240 BANDEIRANTES",2,1,12,406,0,421,"2014"
"26297","410250 BARBOSA FERRAZ",1,1,2,133,0,137,"2014"
"26298","410260 BARRACAO",1,1,2,106,0,110,"2014"
"26299","410270 BARRA DO JACARE",0,0,0,36,0,36,"2014"
"26300","410275 BELA VISTA DA CAROBA",0,0,0,34,1,35,"2014"
"26301","410280 BELA VISTA DO PARAISO",0,3,3,197,0,203,"2014"
"26302","410290 BITURUNA",1,2,2,238,1,244,"2014"
"26303","410300 BOA ESPERANCA",1,0,0,53,1,55,"2014"
"26304","410302 BOA ESPERANCA DO IGUACU",0,0,0,39,0,39,"2014"
"26305","410304 BOA VENTURA DE SAO ROQUE",1,0,0,82,0,83,"2014"
"26306","410305 BOA VISTA DA APARECIDA",0,2,2,121,0,125,"2014"
"26307","410310 BOCAIUVA DO SUL",0,2,2,183,1,188,"2014"
"26308","410315 BOM JESUS DO SUL",1,0,2,54,0,57,"2014"
"26309","410320 BOM SUCESSO",0,3,12,95,0,110,"2014"
"26310","410322 BOM SUCESSO DO SUL",0,0,0,39,0,39,"2014"
"26311","410330 BORRAZOPOLIS",0,0,8,76,0,84,"2014"
"26312","410335 BRAGANEY",0,0,0,65,0,65,"2014"
"26313","410337 BRASILANDIA DO SUL",0,0,1,47,0,48,"2014"
"26314","410340 CAFEARA",0,1,0,26,0,27,"2014"
"26315","410345 CAFELANDIA",0,2,2,264,0,268,"2014"
"26316","410347 CAFEZAL DO SUL",0,0,0,37,0,37,"2014"
"26317","410350 CALIFORNIA",0,0,3,134,0,137,"2014"
"26318","410360 CAMBARA",0,2,4,304,0,310,"2014"
"26319","410370 CAMBE",2,2,19,1288,0,1311,"2014"
"26320","410380 CAMBIRA",0,0,2,87,0,89,"2014"
"26321","410390 CAMPINA DA LAGOA",0,0,2,228,0,230,"2014"
"26322","410395 CAMPINA DO SIMAO",1,0,2,70,0,73,"2014"
"26323","410400 CAMPINA GRANDE DO SUL",1,3,11,828,1,844,"2014"
"26324","410405 CAMPO BONITO",0,2,1,75,0,78,"2014"
"26325","410410 CAMPO DO TENENTE",0,1,2,123,2,128,"2014"
"26326","410420 CAMPO LARGO",4,5,23,1762,13,1807,"2014"
"26327","410425 CAMPO MAGRO",5,2,1,396,4,408,"2014"
"26328","410430 CAMPO MOURAO",1,8,12,1359,7,1387,"2014"
"26329","410440 CANDIDO DE ABREU",0,0,0,239,1,240,"2014"
"26330","410442 CANDOI",0,4,3,242,0,249,"2014"
"26331","410445 CANTAGALO",0,1,8,164,0,173,"2014"
"26332","410450 CAPANEMA",0,1,3,208,0,212,"2014"
"26333","410460 CAPITAO LEONIDAS MARQUES",1,1,2,207,0,211,"2014"
"26334","410465 CARAMBEI",3,3,10,372,0,388,"2014"
"26335","410470 CARLOPOLIS",0,0,3,178,1,182,"2014"
"26336","410480 CASCAVEL",9,19,87,4774,11,4900,"2014"
"26337","410490 CASTRO",3,14,31,1123,7,1178,"2014"
"26338","410500 CATANDUVAS",0,2,5,129,0,136,"2014"
"26339","410510 CENTENARIO DO SUL",0,0,1,115,0,116,"2014"
"26340","410520 CERRO AZUL",2,3,2,234,1,242,"2014"
"26341","410530 CEU AZUL",0,0,1,138,0,139,"2014"
"26342","410540 CHOPINZINHO",0,1,5,262,1,269,"2014"
"26343","410550 CIANORTE",1,1,8,1010,0,1020,"2014"
"26344","410560 CIDADE GAUCHA",0,1,1,171,0,173,"2014"
"26345","410570 CLEVELANDIA",1,0,10,281,0,292,"2014"
"26346","410580 COLOMBO",6,13,45,3748,8,3820,"2014"
"26347","410590 COLORADO",0,1,4,272,0,277,"2014"
"26348","410600 CONGONHINHAS",0,1,2,116,0,119,"2014"
"26349","410610 CONSELHEIRO MAIRINCK",1,0,1,52,1,55,"2014"
"26350","410620 CONTENDA",2,1,2,242,1,248,"2014"
"26351","410630 CORBELIA",0,1,7,246,0,254,"2014"
"26352","410640 CORNELIO PROCOPIO",1,4,3,534,1,543,"2014"
"26353","410645 CORONEL DOMINGOS SOARES",1,0,0,104,0,105,"2014"
"26354","410650 CORONEL VIVIDA",1,2,6,306,0,315,"2014"
"26355","410655 CORUMBATAI DO SUL",0,0,1,33,0,34,"2014"
"26356","410657 CRUZEIRO DO IGUACU",0,0,2,57,0,59,"2014"
"26357","410660 CRUZEIRO DO OESTE",1,2,5,279,0,287,"2014"
"26358","410670 CRUZEIRO DO SUL",0,0,0,80,0,80,"2014"
"26359","410680 CRUZ MACHADO",0,0,8,241,1,250,"2014"
"26360","410685 CRUZMALTINA",0,1,0,41,0,42,"2014"
"26361","410690 CURITIBA",76,112,344,24210,73,24815,"2014"
"26362","410700 CURIUVA",0,1,0,139,0,140,"2014"
"26363","410710 DIAMANTE DO NORTE",0,0,0,50,0,50,"2014"
"26364","410712 DIAMANTE DO SUL",0,0,1,48,0,49,"2014"
"26365","410715 DIAMANTE D'OESTE",0,1,0,75,0,76,"2014"
"26366","410720 DOIS VIZINHOS",3,1,9,574,6,593,"2014"
"26367","410725 DOURADINA",0,0,1,114,0,115,"2014"
"26368","410730 DOUTOR CAMARGO",0,0,2,58,0,60,"2014"
"26369","410740 ENEAS MARQUES",0,0,2,73,0,75,"2014"
"26370","410750 ENGENHEIRO BELTRAO",0,0,2,189,0,191,"2014"
"26371","410752 ESPERANCA NOVA",0,0,1,34,0,35,"2014"
"26372","410753 ENTRE RIOS DO OESTE",0,0,0,51,0,51,"2014"
"26373","410754 ESPIGAO ALTO DO IGUACU",0,0,1,62,0,63,"2014"
"26374","410755 FAROL",0,0,1,50,0,51,"2014"
"26375","410760 FAXINAL",0,1,1,274,3,279,"2014"
"26376","410765 FAZENDA RIO GRANDE",2,10,19,1752,2,1785,"2014"
"26377","410770 FENIX",0,1,1,60,0,62,"2014"
"26378","410773 FERNANDES PINHEIRO",1,1,0,72,0,74,"2014"
"26379","410775 FIGUEIRA",0,0,0,93,0,93,"2014"
"26380","410780 FLORAI",0,0,0,56,0,56,"2014"
"26381","410785 FLOR DA SERRA DO SUL",1,0,3,62,0,66,"2014"
"26382","410790 FLORESTA",0,0,0,91,0,91,"2014"
"26383","410800 FLORESTOPOLIS",0,0,0,171,0,171,"2014"
"26384","410810 FLORIDA",1,0,0,31,0,32,"2014"
"26385","410820 FORMOSA DO OESTE",0,1,2,83,0,86,"2014"
"26386","410830 FOZ DO IGUACU",4,13,59,4406,19,4501,"2014"
"26387","410832 FRANCISCO ALVES",0,0,1,95,1,97,"2014"
"26388","410840 FRANCISCO BELTRAO",2,3,18,1202,0,1225,"2014"
"26389","410845 FOZ DO JORDAO",1,0,3,79,0,83,"2014"
"26390","410850 GENERAL CARNEIRO",0,0,3,224,1,228,"2014"
"26391","410855 GODOY MOREIRA",0,0,0,31,0,31,"2014"
"26392","410860 GOIOERE",0,4,5,372,2,383,"2014"
"26393","410865 GOIOXIM",2,1,1,83,0,87,"2014"
"26394","410870 GRANDES RIOS",0,0,1,101,0,102,"2014"
"26395","410880 GUAIRA",1,1,10,456,1,469,"2014"
"26396","410890 GUAIRACA",1,1,2,81,0,85,"2014"
"26397","410895 GUAMIRANGA",0,0,0,119,0,119,"2014"
"26398","410900 GUAPIRAMA",0,2,1,46,1,50,"2014"
"26399","410910 GUAPOREMA",0,0,1,20,0,21,"2014"
"26400","410920 GUARACI",0,0,4,53,0,57,"2014"
"26401","410930 GUARANIACU",0,0,4,168,0,172,"2014"
"26402","410940 GUARAPUAVA",39,13,36,2836,0,2924,"2014"
"26403","410950 GUARAQUECABA",1,1,2,74,0,78,"2014"
"26404","410960 GUARATUBA",2,4,17,535,4,562,"2014"
"26405","410965 HONORIO SERPA",0,0,0,83,0,83,"2014"
"26406","410970 IBAITI",1,6,17,342,0,366,"2014"
"26407","410975 IBEMA",1,0,2,95,0,98,"2014"
"26408","410980 IBIPORA",3,5,10,668,0,686,"2014"
"26409","410990 ICARAIMA",0,0,1,104,0,105,"2014"
"26410","411000 IGUARACU",2,0,1,75,0,78,"2014"
"26411","411005 IGUATU",0,0,0,34,0,34,"2014"
"26412","411007 IMBAU",0,0,4,193,1,198,"2014"
"26413","411010 IMBITUVA",1,1,8,452,0,462,"2014"
"26414","411020 INACIO MARTINS",0,0,1,150,0,151,"2014"
"26415","411030 INAJA",0,0,0,36,0,36,"2014"
"26416","411040 INDIANOPOLIS",0,0,0,46,0,46,"2014"
"26417","411050 IPIRANGA",0,1,6,192,0,199,"2014"
"26418","411060 IPORA",0,0,1,184,0,185,"2014"
"26419","411065 IRACEMA DO OESTE",0,1,2,22,0,25,"2014"
"26420","411070 IRATI",1,4,7,820,1,833,"2014"
"26421","411080 IRETAMA",0,0,0,133,0,133,"2014"
"26422","411090 ITAGUAJE",0,0,1,70,0,71,"2014"
"26423","411095 ITAIPULANDIA",0,0,2,144,0,146,"2014"
"26424","411100 ITAMBARACA",0,0,1,71,0,72,"2014"
"26425","411110 ITAMBE",0,0,0,76,0,76,"2014"
"26426","411120 ITAPEJARA D'OESTE",0,0,0,146,0,146,"2014"
"26427","411125 ITAPERUCU",4,2,6,523,2,537,"2014"
"26428","411130 ITAUNA DO SUL",0,0,1,58,0,59,"2014"
"26429","411140 IVAI",1,1,2,185,1,190,"2014"
"26430","411150 IVAIPORA",1,2,6,411,0,420,"2014"
"26431","411155 IVATE",0,1,2,106,0,109,"2014"
"26432","411160 IVATUBA",0,0,0,31,0,31,"2014"
"26433","411170 JABOTI",0,0,0,46,0,46,"2014"
"26434","411180 JACAREZINHO",3,3,11,571,0,588,"2014"
"26435","411190 JAGUAPITA",1,2,5,156,0,164,"2014"
"26436","411200 JAGUARIAIVA",0,2,16,599,2,619,"2014"
"26437","411210 JANDAIA DO SUL",0,2,8,245,0,255,"2014"
"26438","411220 JANIOPOLIS",0,0,3,76,0,79,"2014"
"26439","411230 JAPIRA",0,0,0,61,0,61,"2014"
"26440","411240 JAPURA",0,0,0,101,0,101,"2014"
"26441","411250 JARDIM ALEGRE",0,0,5,156,0,161,"2014"
"26442","411260 JARDIM OLINDA",0,0,0,19,0,19,"2014"
"26443","411270 JATAIZINHO",1,1,6,197,1,206,"2014"
"26444","411275 JESUITAS",1,0,4,104,0,109,"2014"
"26445","411280 JOAQUIM TAVORA",0,1,4,178,1,184,"2014"
"26446","411290 JUNDIAI DO SUL",0,0,0,41,0,41,"2014"
"26447","411295 JURANDA",0,0,1,90,0,91,"2014"
"26448","411300 JUSSARA",0,1,1,90,0,92,"2014"
"26449","411310 KALORE",0,1,4,44,0,49,"2014"
"26450","411320 LAPA",2,4,13,617,1,637,"2014"
"26451","411325 LARANJAL",0,0,0,87,0,87,"2014"
"26452","411330 LARANJEIRAS DO SUL",1,1,4,529,0,535,"2014"
"26453","411340 LEOPOLIS",0,0,1,51,0,52,"2014"
"26454","411342 LIDIANOPOLIS",0,0,2,44,0,46,"2014"
"26455","411345 LINDOESTE",0,0,3,70,0,73,"2014"
"26456","411350 LOANDA",0,3,5,321,0,329,"2014"
"26457","411360 LOBATO",0,0,1,56,0,57,"2014"
"26458","411370 LONDRINA",11,34,81,7110,22,7258,"2014"
"26459","411373 LUIZIANA",1,0,2,88,3,94,"2014"
"26460","411375 LUNARDELLI",0,0,1,58,0,59,"2014"
"26461","411380 LUPIONOPOLIS",0,1,0,51,0,52,"2014"
"26462","411390 MALLET",0,2,2,159,0,163,"2014"
"26463","411400 MAMBORE",0,3,3,181,0,187,"2014"
"26464","411410 MANDAGUACU",0,1,6,287,1,295,"2014"
"26465","411420 MANDAGUARI",0,3,6,446,0,455,"2014"
"26466","411430 MANDIRITUBA",2,2,5,390,6,405,"2014"
"26467","411435 MANFRINOPOLIS",0,0,1,37,0,38,"2014"
"26468","411440 MANGUEIRINHA",0,5,10,255,0,270,"2014"
"26469","411450 MANOEL RIBAS",0,1,4,187,0,192,"2014"
"26470","411460 MARECHAL CANDIDO RONDON",0,1,14,639,0,654,"2014"
"26471","411470 MARIA HELENA",0,1,1,81,3,86,"2014"
"26472","411480 MARIALVA",2,2,5,445,0,454,"2014"
"26473","411490 MARILANDIA DO SUL",0,0,6,120,2,128,"2014"
"26474","411500 MARILENA",1,1,1,121,1,125,"2014"
"26475","411510 MARILUZ",0,2,1,155,1,159,"2014"
"26476","411520 MARINGA",14,21,73,4813,1,4922,"2014"
"26477","411530 MARIOPOLIS",0,1,4,85,0,90,"2014"
"26478","411535 MARIPA",0,0,0,61,0,61,"2014"
"26479","411540 MARMELEIRO",0,0,2,171,2,175,"2014"
"26480","411545 MARQUINHO",0,0,2,70,0,72,"2014"
"26481","411550 MARUMBI",0,0,1,65,0,66,"2014"
"26482","411560 MATELANDIA",0,1,2,249,0,252,"2014"
"26483","411570 MATINHOS",3,2,10,453,2,470,"2014"
"26484","411573 MATO RICO",0,0,3,33,0,36,"2014"
"26485","411575 MAUA DA SERRA",0,0,0,180,1,181,"2014"
"26486","411580 MEDIANEIRA",0,2,12,673,0,687,"2014"
"26487","411585 MERCEDES",0,0,2,62,0,64,"2014"
"26488","411590 MIRADOR",0,0,0,26,0,26,"2014"
"26489","411600 MIRASELVA",0,0,1,24,0,25,"2014"
"26490","411605 MISSAL",0,0,1,140,0,141,"2014"
"26491","411610 MOREIRA SALES",0,1,1,132,1,135,"2014"
"26492","411620 MORRETES",0,1,3,235,2,241,"2014"
"26493","411630 MUNHOZ DE MELO",0,1,0,65,0,66,"2014"
"26494","411640 NOSSA SENHORA DAS GRACAS",1,0,0,45,0,46,"2014"
"26495","411650 NOVA ALIANCA DO IVAI",0,0,0,21,0,21,"2014"
"26496","411660 NOVA AMERICA DA COLINA",0,0,1,43,0,44,"2014"
"26497","411670 NOVA AURORA",1,1,1,163,0,166,"2014"
"26498","411680 NOVA CANTU",0,0,0,79,0,79,"2014"
"26499","411690 NOVA ESPERANCA",2,1,4,323,0,330,"2014"
"26500","411695 NOVA ESPERANCA DO SUDOESTE",1,0,1,55,0,57,"2014"
"26501","411700 NOVA FATIMA",0,1,1,107,1,110,"2014"
"26502","411705 NOVA LARANJEIRAS",0,3,2,174,3,182,"2014"
"26503","411710 NOVA LONDRINA",1,0,2,179,0,182,"2014"
"26504","411720 NOVA OLIMPIA",1,0,0,89,0,90,"2014"
"26505","411721 NOVA SANTA BARBARA",0,0,4,64,0,68,"2014"
"26506","411722 NOVA SANTA ROSA",1,1,1,97,0,100,"2014"
"26507","411725 NOVA PRATA DO IGUACU",1,2,2,142,0,147,"2014"
"26508","411727 NOVA TEBAS",0,3,0,99,0,102,"2014"
"26509","411729 NOVO ITACOLOMI",1,0,0,29,0,30,"2014"
"26510","411730 ORTIGUEIRA",0,0,3,289,3,295,"2014"
"26511","411740 OURIZONA",0,0,1,42,0,43,"2014"
"26512","411745 OURO VERDE DO OESTE",0,1,1,65,1,68,"2014"
"26513","411750 PAICANDU",1,0,8,561,2,572,"2014"
"26514","411760 PALMAS",2,5,7,837,3,854,"2014"
"26515","411770 PALMEIRA",2,3,6,465,3,479,"2014"
"26516","411780 PALMITAL",0,1,8,243,0,252,"2014"
"26517","411790 PALOTINA",0,3,4,471,1,479,"2014"
"26518","411800 PARAISO DO NORTE",0,0,0,204,0,204,"2014"
"26519","411810 PARANACITY",0,1,0,158,0,159,"2014"
"26520","411820 PARANAGUA",6,14,29,2346,6,2401,"2014"
"26521","411830 PARANAPOEMA",0,0,1,37,0,38,"2014"
"26522","411840 PARANAVAI",0,2,5,1235,0,1242,"2014"
"26523","411845 PATO BRAGADO",0,1,2,68,0,71,"2014"
"26524","411850 PATO BRANCO",3,5,21,1267,2,1298,"2014"
"26525","411860 PAULA FREITAS",0,0,0,66,0,66,"2014"
"26526","411870 PAULO FRONTIN",0,0,1,54,0,55,"2014"
"26527","411880 PEABIRU",1,0,5,161,1,168,"2014"
"26528","411885 PEROBAL",0,0,1,90,0,91,"2014"
"26529","411890 PEROLA",0,0,4,160,0,164,"2014"
"26530","411900 PEROLA D'OESTE",0,0,0,64,0,64,"2014"
"26531","411910 PIEN",2,0,0,190,0,192,"2014"
"26532","411915 PINHAIS",8,11,32,2057,9,2117,"2014"
"26533","411920 PINHALAO",0,0,0,102,0,102,"2014"
"26534","411925 PINHAL DE SAO BENTO",1,0,0,35,0,36,"2014"
"26535","411930 PINHAO",1,2,8,547,2,560,"2014"
"26536","411940 PIRAI DO SUL",0,1,8,388,3,400,"2014"
"26537","411950 PIRAQUARA",2,13,32,1610,14,1671,"2014"
"26538","411960 PITANGA",0,0,17,471,0,488,"2014"
"26539","411965 PITANGUEIRAS",0,0,0,32,0,32,"2014"
"26540","411970 PLANALTINA DO PARANA",0,0,0,68,0,68,"2014"
"26541","411980 PLANALTO",0,1,1,125,0,127,"2014"
"26542","411990 PONTA GROSSA",19,23,113,5397,17,5569,"2014"
"26543","411995 PONTAL DO PARANA",1,1,3,347,3,355,"2014"
"26544","412000 PORECATU",1,0,0,186,0,187,"2014"
"26545","412010 PORTO AMAZONAS",0,0,2,49,0,51,"2014"
"26546","412015 PORTO BARREIRO",0,0,1,44,0,45,"2014"
"26547","412020 PORTO RICO",1,0,1,28,0,30,"2014"
"26548","412030 PORTO VITORIA",1,0,0,48,0,49,"2014"
"26549","412033 PRADO FERREIRA",0,0,0,44,0,44,"2014"
"26550","412035 PRANCHITA",0,0,0,64,0,64,"2014"
"26551","412040 PRESIDENTE CASTELO BRANCO",1,0,0,65,0,66,"2014"
"26552","412050 PRIMEIRO DE MAIO",2,0,2,112,0,116,"2014"
"26553","412060 PRUDENTOPOLIS",4,1,11,730,0,746,"2014"
"26554","412065 QUARTO CENTENARIO",0,1,0,62,0,63,"2014"
"26555","412070 QUATIGUA",0,0,2,92,0,94,"2014"
"26556","412080 QUATRO BARRAS",0,2,1,364,1,368,"2014"
"26557","412085 QUATRO PONTES",0,0,0,43,0,43,"2014"
"26558","412090 QUEDAS DO IGUACU",1,1,8,424,0,434,"2014"
"26559","412100 QUERENCIA DO NORTE",0,1,1,168,1,171,"2014"
"26560","412110 QUINTA DO SOL",1,0,1,60,0,62,"2014"
"26561","412120 QUITANDINHA",1,0,2,180,2,185,"2014"
"26562","412125 RAMILANDIA",0,0,1,47,0,48,"2014"
"26563","412130 RANCHO ALEGRE",0,0,1,42,0,43,"2014"
"26564","412135 RANCHO ALEGRE D'OESTE",0,1,0,34,0,35,"2014"
"26565","412140 REALEZA",0,1,0,192,2,195,"2014"
"26566","412150 REBOUCAS",0,1,0,207,1,209,"2014"
"26567","412160 RENASCENCA",1,1,2,96,0,100,"2014"
"26568","412170 RESERVA",2,3,3,399,0,407,"2014"
"26569","412175 RESERVA DO IGUACU",1,0,5,124,0,130,"2014"
"26570","412180 RIBEIRAO CLARO",0,1,2,145,2,150,"2014"
"26571","412190 RIBEIRAO DO PINHAL",0,1,2,177,1,181,"2014"
"26572","412200 RIO AZUL",0,2,1,166,1,170,"2014"
"26573","412210 RIO BOM",0,0,0,28,0,28,"2014"
"26574","412215 RIO BONITO DO IGUACU",0,2,3,242,0,247,"2014"
"26575","412217 RIO BRANCO DO IVAI",0,0,0,43,0,43,"2014"
"26576","412220 RIO BRANCO DO SUL",1,5,6,598,3,613,"2014"
"26577","412230 RIO NEGRO",1,1,8,322,1,333,"2014"
"26578","412240 ROLANDIA",2,6,3,886,0,897,"2014"
"26579","412250 RONCADOR",0,1,2,138,1,142,"2014"
"26580","412260 RONDON",0,1,3,142,0,146,"2014"
"26581","412265 ROSARIO DO IVAI",0,0,0,69,0,69,"2014"
"26582","412270 SABAUDIA",0,0,2,91,0,93,"2014"
"26583","412280 SALGADO FILHO",0,1,1,54,0,56,"2014"
"26584","412290 SALTO DO ITARARE",0,1,1,54,0,56,"2014"
"26585","412300 SALTO DO LONTRA",0,2,1,195,0,198,"2014"
"26586","412310 SANTA AMELIA",0,0,2,54,0,56,"2014"
"26587","412320 SANTA CECILIA DO PAVAO",0,0,0,46,0,46,"2014"
"26588","412330 SANTA CRUZ DE MONTE CASTELO",0,0,0,124,0,124,"2014"
"26589","412340 SANTA FE",1,1,0,138,0,140,"2014"
"26590","412350 SANTA HELENA",1,2,5,332,0,340,"2014"
"26591","412360 SANTA INES",0,0,0,23,0,23,"2014"
"26592","412370 SANTA ISABEL DO IVAI",0,1,3,122,0,126,"2014"
"26593","412380 SANTA IZABEL DO OESTE",1,0,1,163,0,165,"2014"
"26594","412382 SANTA LUCIA",0,0,0,41,0,41,"2014"
"26595","412385 SANTA MARIA DO OESTE",0,1,1,151,0,153,"2014"
"26596","412390 SANTA MARIANA",1,0,1,142,0,144,"2014"
"26597","412395 SANTA MONICA",0,1,1,48,0,50,"2014"
"26598","412400 SANTANA DO ITARARE",0,1,2,47,1,51,"2014"
"26599","412402 SANTA TEREZA DO OESTE",0,0,6,175,2,183,"2014"
"26600","412405 SANTA TEREZINHA DE ITAIPU",2,1,4,300,4,311,"2014"
"26601","412410 SANTO ANTONIO DA PLATINA",2,2,9,574,0,587,"2014"
"26602","412420 SANTO ANTONIO DO CAIUA",0,0,1,37,0,38,"2014"
"26603","412430 SANTO ANTONIO DO PARAISO",0,1,0,20,0,21,"2014"
"26604","412440 SANTO ANTONIO DO SUDOESTE",0,0,1,259,2,262,"2014"
"26605","412450 SANTO INACIO",0,0,0,79,0,79,"2014"
"26606","412460 SAO CARLOS DO IVAI",0,0,2,94,0,96,"2014"
"26607","412470 SAO JERONIMO DA SERRA",0,0,2,149,0,151,"2014"
"26608","412480 SAO JOAO",1,1,4,131,0,137,"2014"
"26609","412490 SAO JOAO DO CAIUA",0,0,0,79,0,79,"2014"
"26610","412500 SAO JOAO DO IVAI",1,0,1,132,0,134,"2014"
"26611","412510 SAO JOAO DO TRIUNFO",0,4,5,157,0,166,"2014"
"26612","412520 SAO JORGE D'OESTE",0,0,2,138,0,140,"2014"
"26613","412530 SAO JORGE DO IVAI",0,1,2,53,0,56,"2014"
"26614","412535 SAO JORGE DO PATROCINIO",0,0,0,87,0,87,"2014"
"26615","412540 SAO JOSE DA BOA VISTA",0,0,1,64,0,65,"2014"
"26616","412545 SAO JOSE DAS PALMEIRAS",0,0,1,60,0,61,"2014"
"26617","412550 SAO JOSE DOS PINHAIS",8,24,98,5011,16,5157,"2014"
"26618","412555 SAO MANOEL DO PARANA",0,0,0,19,1,20,"2014"
"26619","412560 SAO MATEUS DO SUL",2,3,8,624,1,638,"2014"
"26620","412570 SAO MIGUEL DO IGUACU",1,1,2,420,4,428,"2014"
"26621","412575 SAO PEDRO DO IGUACU",0,0,1,74,0,75,"2014"
"26622","412580 SAO PEDRO DO IVAI",0,1,2,131,0,134,"2014"
"26623","412590 SAO PEDRO DO PARANA",0,0,0,27,0,27,"2014"
"26624","412600 SAO SEBASTIAO DA AMOREIRA",1,0,1,110,0,112,"2014"
"26625","412610 SAO TOME",0,0,0,80,0,80,"2014"
"26626","412620 SAPOPEMA",0,0,1,86,2,89,"2014"
"26627","412625 SARANDI",8,4,14,1376,0,1402,"2014"
"26628","412627 SAUDADE DO IGUACU",0,0,2,65,0,67,"2014"
"26629","412630 SENGES",0,1,9,276,2,288,"2014"
"26630","412635 SERRANOPOLIS DO IGUACU",0,0,0,58,0,58,"2014"
"26631","412640 SERTANEJA",0,0,1,76,0,77,"2014"
"26632","412650 SERTANOPOLIS",0,0,5,188,1,194,"2014"
"26633","412660 SIQUEIRA CAMPOS",0,0,3,241,1,245,"2014"
"26634","412665 SULINA",0,1,1,40,0,42,"2014"
"26635","412667 TAMARANA",0,1,1,165,0,167,"2014"
"26636","412670 TAMBOARA",0,0,1,53,0,54,"2014"
"26637","412680 TAPEJARA",0,1,5,229,0,235,"2014"
"26638","412690 TAPIRA",1,2,3,79,0,85,"2014"
"26639","412700 TEIXEIRA SOARES",0,0,4,140,0,144,"2014"
"26640","412710 TELEMACO BORBA",1,6,12,1081,3,1103,"2014"
"26641","412720 TERRA BOA",2,3,6,208,1,220,"2014"
"26642","412730 TERRA RICA",0,1,3,275,0,279,"2014"
"26643","412740 TERRA ROXA",1,1,7,222,0,231,"2014"
"26644","412750 TIBAGI",2,1,5,289,0,297,"2014"
"26645","412760 TIJUCAS DO SUL",0,2,2,243,2,249,"2014"
"26646","412770 TOLEDO",1,5,27,1961,1,1995,"2014"
"26647","412780 TOMAZINA",1,0,0,118,0,119,"2014"
"26648","412785 TRES BARRAS DO PARANA",0,0,2,168,0,170,"2014"
"26649","412788 TUNAS DO PARANA",1,0,1,144,4,150,"2014"
"26650","412790 TUNEIRAS DO OESTE",0,0,0,118,0,118,"2014"
"26651","412795 TUPASSI",0,0,0,81,0,81,"2014"
"26652","412796 TURVO",0,1,7,197,0,205,"2014"
"26653","412800 UBIRATA",0,0,3,269,1,273,"2014"
"26654","412810 UMUARAMA",3,5,30,1535,2,1575,"2014"
"26655","412820 UNIAO DA VITORIA",2,3,12,804,0,821,"2014"
"26656","412830 UNIFLOR",0,1,0,27,0,28,"2014"
"26657","412840 URAI",0,0,2,118,0,120,"2014"
"26658","412850 WENCESLAU BRAZ",0,4,4,273,1,282,"2014"
"26659","412853 VENTANIA",2,0,1,131,1,135,"2014"
"26660","412855 VERA CRUZ DO OESTE",0,0,2,111,0,113,"2014"
"26661","412860 VERE",2,2,2,113,0,119,"2014"
"26662","412862 ALTO PARAISO",1,0,0,54,0,55,"2014"
"26663","412863 DOUTOR ULYSSES",0,0,0,65,0,65,"2014"
"26664","412865 VIRMOND",0,0,0,53,0,53,"2014"
"26665","412870 VITORINO",0,0,0,104,0,104,"2014"
"26666","412880 XAMBRE",2,0,0,71,0,73,"2014"
"26667","420005 ABDON BATISTA",0,0,0,33,0,33,"2014"
"26668","420010 ABELARDO LUZ",0,1,10,286,2,299,"2014"
"26669","420020 AGROLANDIA",0,0,1,123,1,125,"2014"
"26670","420030 AGRONOMICA",0,0,1,53,0,54,"2014"
"26671","420040 AGUA DOCE",0,0,0,89,0,89,"2014"
"26672","420050 AGUAS DE CHAPECO",1,0,2,61,0,64,"2014"
"26673","420055 AGUAS FRIAS",0,0,0,28,0,28,"2014"
"26674","420060 AGUAS MORNAS",1,0,1,57,1,60,"2014"
"26675","420070 ALFREDO WAGNER",0,0,3,125,0,128,"2014"
"26676","420075 ALTO BELA VISTA",0,0,0,16,0,16,"2014"
"26677","420080 ANCHIETA",1,0,1,78,0,80,"2014"
"26678","420090 ANGELINA",0,0,2,55,0,57,"2014"
"26679","420100 ANITA GARIBALDI",1,1,3,104,0,109,"2014"
"26680","420110 ANITAPOLIS",0,0,1,28,0,29,"2014"
"26681","420120 ANTONIO CARLOS",0,0,0,116,0,116,"2014"
"26682","420125 APIUNA",0,0,1,155,0,156,"2014"
"26683","420127 ARABUTA",0,0,0,42,0,42,"2014"
"26684","420130 ARAQUARI",0,6,4,482,2,494,"2014"
"26685","420140 ARARANGUA",2,4,9,876,2,893,"2014"
"26686","420150 ARMAZEM",0,0,3,103,1,107,"2014"
"26687","420160 ARROIO TRINTA",0,0,3,31,0,34,"2014"
"26688","420165 ARVOREDO",0,0,0,28,0,28,"2014"
"26689","420170 ASCURRA",0,0,0,99,0,99,"2014"
"26690","420180 ATALANTA",0,0,1,47,0,48,"2014"
"26691","420190 AURORA",0,0,2,67,1,70,"2014"
"26692","420195 BALNEARIO ARROIO DO SILVA",3,0,3,132,0,138,"2014"
"26693","420200 BALNEARIO CAMBORIU",3,2,19,1512,0,1536,"2014"
"26694","420205 BALNEARIO BARRA DO SUL",0,0,3,134,2,139,"2014"
"26695","420207 BALNEARIO GAIVOTA",1,0,2,127,0,130,"2014"
"26696","420208 BANDEIRANTE",0,0,1,34,0,35,"2014"
"26697","420209 BARRA BONITA",0,0,1,20,0,21,"2014"
"26698","420210 BARRA VELHA",3,2,8,401,3,417,"2014"
"26699","420213 BELA VISTA DO TOLDO",1,1,3,73,0,78,"2014"
"26700","420215 BELMONTE",0,0,0,32,0,32,"2014"
"26701","420220 BENEDITO NOVO",0,1,0,98,0,99,"2014"
"26702","420230 BIGUACU",2,3,18,930,12,965,"2014"
"26703","420240 BLUMENAU",10,8,59,4403,0,4480,"2014"
"26704","420243 BOCAINA DO SUL",0,2,4,47,0,53,"2014"
"26705","420245 BOMBINHAS",0,0,6,246,1,253,"2014"
"26706","420250 BOM JARDIM DA SERRA",0,1,3,46,1,51,"2014"
"26707","420253 BOM JESUS",1,0,0,48,0,49,"2014"
"26708","420257 BOM JESUS DO OESTE",0,0,1,21,0,22,"2014"
"26709","420260 BOM RETIRO",0,1,6,100,1,108,"2014"
"26710","420270 BOTUVERA",0,0,0,45,0,45,"2014"
"26711","420280 BRACO DO NORTE",0,0,3,450,0,453,"2014"
"26712","420285 BRACO DO TROMBUDO",0,1,0,49,0,50,"2014"
"26713","420287 BRUNOPOLIS",0,0,0,30,0,30,"2014"
"26714","420290 BRUSQUE",7,5,14,1630,1,1657,"2014"
"26715","420300 CACADOR",4,5,23,1189,0,1221,"2014"
"26716","420310 CAIBI",0,1,0,60,0,61,"2014"
"26717","420315 CALMON",0,0,1,62,0,63,"2014"
"26718","420320 CAMBORIU",0,6,16,1156,8,1186,"2014"
"26719","420325 CAPAO ALTO",0,0,4,26,0,30,"2014"
"26720","420330 CAMPO ALEGRE",0,0,0,117,0,117,"2014"
"26721","420340 CAMPO BELO DO SUL",0,3,4,81,1,89,"2014"
"26722","420350 CAMPO ERE",0,0,5,141,0,146,"2014"
"26723","420360 CAMPOS NOVOS",1,1,1,540,0,543,"2014"
"26724","420370 CANELINHA",0,0,1,139,0,140,"2014"
"26725","420380 CANOINHAS",1,1,19,779,2,802,"2014"
"26726","420390 CAPINZAL",0,0,4,274,2,280,"2014"
"26727","420395 CAPIVARI DE BAIXO",1,2,0,307,0,310,"2014"
"26728","420400 CATANDUVAS",0,0,0,124,0,124,"2014"
"26729","420410 CAXAMBU DO SUL",0,0,1,57,0,58,"2014"
"26730","420415 CELSO RAMOS",0,0,0,23,0,23,"2014"
"26731","420417 CERRO NEGRO",0,0,2,46,0,48,"2014"
"26732","420419 CHAPADAO DO LAGEADO",0,0,1,27,0,28,"2014"
"26733","420420 CHAPECO",5,12,66,3183,7,3273,"2014"
"26734","420425 COCAL DO SUL",0,1,2,213,0,216,"2014"
"26735","420430 CONCORDIA",0,3,28,977,1,1009,"2014"
"26736","420435 CORDILHEIRA ALTA",0,0,1,49,0,50,"2014"
"26737","420440 CORONEL FREITAS",0,1,1,110,0,112,"2014"
"26738","420445 CORONEL MARTINS",0,0,0,26,0,26,"2014"
"26739","420450 CORUPA",0,0,7,168,0,175,"2014"
"26740","420455 CORREIA PINTO",1,3,11,207,1,223,"2014"
"26741","420460 CRICIUMA",11,6,24,2824,3,2868,"2014"
"26742","420470 CUNHA PORA",0,0,1,143,0,144,"2014"
"26743","420475 CUNHATAI",0,0,2,19,0,21,"2014"
"26744","420480 CURITIBANOS",5,2,11,641,1,660,"2014"
"26745","420490 DESCANSO",0,0,0,94,0,94,"2014"
"26746","420500 DIONISIO CERQUEIRA",0,0,1,257,1,259,"2014"
"26747","420510 DONA EMMA",0,0,1,38,0,39,"2014"
"26748","420515 DOUTOR PEDRINHO",0,0,0,41,1,42,"2014"
"26749","420517 ENTRE RIOS",0,0,1,62,0,63,"2014"
"26750","420519 ERMO",0,0,0,32,0,32,"2014"
"26751","420520 ERVAL VELHO",0,0,1,64,0,65,"2014"
"26752","420530 FAXINAL DOS GUEDES",0,0,2,137,1,140,"2014"
"26753","420535 FLOR DO SERTAO",0,0,0,21,1,22,"2014"
"26754","420540 FLORIANOPOLIS",20,17,90,5665,21,5813,"2014"
"26755","420543 FORMOSA DO SUL",0,0,0,27,0,27,"2014"
"26756","420545 FORQUILHINHA",0,0,4,405,2,411,"2014"
"26757","420550 FRAIBURGO",1,2,3,556,0,562,"2014"
"26758","420555 FREI ROGERIO",0,0,1,25,0,26,"2014"
"26759","420560 GALVAO",0,0,1,43,0,44,"2014"
"26760","420570 GAROPABA",0,1,4,247,3,255,"2014"
"26761","420580 GARUVA",1,1,6,304,2,314,"2014"
"26762","420590 GASPAR",1,3,9,809,1,823,"2014"
"26763","420600 GOVERNADOR CELSO RAMOS",0,1,1,160,1,163,"2014"
"26764","420610 GRAO PARA",0,0,1,84,0,85,"2014"
"26765","420620 GRAVATAL",0,0,1,120,1,122,"2014"
"26766","420630 GUABIRUBA",0,0,1,266,0,267,"2014"
"26767","420640 GUARACIABA",0,0,1,106,1,108,"2014"
"26768","420650 GUARAMIRIM",0,1,6,532,0,539,"2014"
"26769","420660 GUARUJA DO SUL",0,0,0,45,0,45,"2014"
"26770","420665 GUATAMBU",0,0,2,89,0,91,"2014"
"26771","420670 HERVAL D'OESTE",0,1,5,297,0,303,"2014"
"26772","420675 IBIAM",0,1,1,18,0,20,"2014"
"26773","420680 IBICARE",0,0,0,26,0,26,"2014"
"26774","420690 IBIRAMA",0,1,0,265,0,266,"2014"
"26775","420700 ICARA",1,1,3,703,0,708,"2014"
"26776","420710 ILHOTA",0,0,1,180,0,181,"2014"
"26777","420720 IMARUI",0,0,1,107,1,109,"2014"
"26778","420730 IMBITUBA",1,2,8,489,4,504,"2014"
"26779","420740 IMBUIA",0,1,0,74,0,75,"2014"
"26780","420750 INDAIAL",1,4,4,814,0,823,"2014"
"26781","420757 IOMERE",0,1,0,16,0,17,"2014"
"26782","420760 IPIRA",0,0,2,48,0,50,"2014"
"26783","420765 IPORA DO OESTE",1,0,2,116,0,119,"2014"
"26784","420768 IPUACU",1,1,3,112,1,118,"2014"
"26785","420770 IPUMIRIM",0,0,2,92,0,94,"2014"
"26786","420775 IRACEMINHA",0,1,1,29,0,31,"2014"
"26787","420780 IRANI",1,0,1,126,0,128,"2014"
"26788","420785 IRATI",0,0,0,22,0,22,"2014"
"26789","420790 IRINEOPOLIS",1,0,3,134,0,138,"2014"
"26790","420800 ITA",0,0,2,56,0,58,"2014"
"26791","420810 ITAIOPOLIS",1,1,1,287,1,291,"2014"
"26792","420820 ITAJAI",12,23,93,3190,1,3319,"2014"
"26793","420830 ITAPEMA",0,3,16,732,0,751,"2014"
"26794","420840 ITAPIRANGA",2,1,2,174,0,179,"2014"
"26795","420845 ITAPOA",2,0,2,238,2,244,"2014"
"26796","420850 ITUPORANGA",0,0,8,364,0,372,"2014"
"26797","420860 JABORA",0,0,0,44,0,44,"2014"
"26798","420870 JACINTO MACHADO",0,0,1,122,0,123,"2014"
"26799","420880 JAGUARUNA",0,1,0,209,0,210,"2014"
"26800","420890 JARAGUA DO SUL",3,3,41,2361,0,2408,"2014"
"26801","420895 JARDINOPOLIS",0,0,0,26,0,26,"2014"
"26802","420900 JOACABA",1,1,1,349,0,352,"2014"
"26803","420910 JOINVILLE",7,40,131,7879,6,8063,"2014"
"26804","420915 JOSE BOITEUX",0,1,0,97,0,98,"2014"
"26805","420917 JUPIA",0,0,0,20,0,20,"2014"
"26806","420920 LACERDOPOLIS",0,0,0,29,0,29,"2014"
"26807","420930 LAGES",4,24,114,2256,8,2406,"2014"
"26808","420940 LAGUNA",0,1,5,503,2,511,"2014"
"26809","420945 LAJEADO GRANDE",1,0,0,20,0,21,"2014"
"26810","420950 LAURENTINO",0,0,3,95,0,98,"2014"
"26811","420960 LAURO MULLER",0,0,3,211,0,214,"2014"
"26812","420970 LEBON REGIS",1,0,2,158,1,162,"2014"
"26813","420980 LEOBERTO LEAL",0,0,0,33,0,33,"2014"
"26814","420985 LINDOIA DO SUL",0,2,1,52,0,55,"2014"
"26815","420990 LONTRAS",0,0,3,162,1,166,"2014"
"26816","421000 LUIZ ALVES",3,1,2,180,0,186,"2014"
"26817","421003 LUZERNA",0,0,1,59,0,60,"2014"
"26818","421005 MACIEIRA",0,0,0,22,0,22,"2014"
"26819","421010 MAFRA",3,1,14,780,0,798,"2014"
"26820","421020 MAJOR GERCINO",0,0,0,33,3,36,"2014"
"26821","421030 MAJOR VIEIRA",0,0,0,74,2,76,"2014"
"26822","421040 MARACAJA",2,1,0,111,2,116,"2014"
"26823","421050 MARAVILHA",0,0,3,374,0,377,"2014"
"26824","421055 MAREMA",0,0,0,17,0,17,"2014"
"26825","421060 MASSARANDUBA",0,0,4,178,0,182,"2014"
"26826","421070 MATOS COSTA",0,0,0,33,0,33,"2014"
"26827","421080 MELEIRO",0,0,0,86,0,86,"2014"
"26828","421085 MIRIM DOCE",0,0,0,34,2,36,"2014"
"26829","421090 MODELO",0,0,0,52,0,52,"2014"
"26830","421100 MONDAI",0,0,4,108,0,112,"2014"
"26831","421105 MONTE CARLO",1,0,2,123,0,126,"2014"
"26832","421110 MONTE CASTELO",0,0,2,126,0,128,"2014"
"26833","421120 MORRO DA FUMACA",0,1,3,239,2,245,"2014"
"26834","421125 MORRO GRANDE",0,0,0,32,0,32,"2014"
"26835","421130 NAVEGANTES",3,4,21,1355,1,1384,"2014"
"26836","421140 NOVA ERECHIM",0,1,0,49,0,50,"2014"
"26837","421145 NOVA ITABERABA",0,0,0,47,0,47,"2014"
"26838","421150 NOVA TRENTO",1,0,5,137,0,143,"2014"
"26839","421160 NOVA VENEZA",4,0,1,181,0,186,"2014"
"26840","421165 NOVO HORIZONTE",0,0,0,24,0,24,"2014"
"26841","421170 ORLEANS",0,1,4,247,0,252,"2014"
"26842","421175 OTACILIO COSTA",1,0,9,228,1,239,"2014"
"26843","421180 OURO",0,0,1,78,0,79,"2014"
"26844","421185 OURO VERDE",0,0,0,26,0,26,"2014"
"26845","421187 PAIAL",0,0,1,18,0,19,"2014"
"26846","421189 PAINEL",0,1,1,27,0,29,"2014"
"26847","421190 PALHOCA",0,8,30,2425,6,2469,"2014"
"26848","421200 PALMA SOLA",0,4,0,123,0,127,"2014"
"26849","421205 PALMEIRA",0,0,3,29,0,32,"2014"
"26850","421210 PALMITOS",0,1,1,175,0,177,"2014"
"26851","421220 PAPANDUVA",0,4,3,234,0,241,"2014"
"26852","421223 PARAISO",0,0,0,39,0,39,"2014"
"26853","421225 PASSO DE TORRES",1,0,1,94,0,96,"2014"
"26854","421227 PASSOS MAIA",0,0,1,69,0,70,"2014"
"26855","421230 PAULO LOPES",1,0,1,76,0,78,"2014"
"26856","421240 PEDRAS GRANDES",0,0,0,46,0,46,"2014"
"26857","421250 PENHA",0,4,5,367,0,376,"2014"
"26858","421260 PERITIBA",0,0,0,42,0,42,"2014"
"26859","421265 PESCARIA BRAVA",0,0,1,99,0,100,"2014"
"26860","421270 PETROLANDIA",0,0,3,56,0,59,"2014"
"26861","421280 BALNEARIO PICARRAS",4,0,4,271,2,281,"2014"
"26862","421290 PINHALZINHO",0,3,2,261,0,266,"2014"
"26863","421300 PINHEIRO PRETO",0,0,0,38,1,39,"2014"
"26864","421310 PIRATUBA",0,0,1,68,2,71,"2014"
"26865","421315 PLANALTO ALEGRE",0,0,1,32,0,33,"2014"
"26866","421320 POMERODE",2,2,7,367,0,378,"2014"
"26867","421330 PONTE ALTA",1,0,4,60,0,65,"2014"
"26868","421335 PONTE ALTA DO NORTE",0,0,1,41,1,43,"2014"
"26869","421340 PONTE SERRADA",0,1,2,169,0,172,"2014"
"26870","421350 PORTO BELO",0,1,3,231,0,235,"2014"
"26871","421360 PORTO UNIAO",1,0,8,425,1,435,"2014"
"26872","421370 POUSO REDONDO",1,1,2,231,0,235,"2014"
"26873","421380 PRAIA GRANDE",2,1,2,68,0,73,"2014"
"26874","421390 PRESIDENTE CASTELLO BRANCO",0,0,0,17,0,17,"2014"
"26875","421400 PRESIDENTE GETULIO",1,0,2,200,0,203,"2014"
"26876","421410 PRESIDENTE NEREU",0,0,1,29,0,30,"2014"
"26877","421415 PRINCESA",0,0,1,27,0,28,"2014"
"26878","421420 QUILOMBO",1,1,1,123,0,126,"2014"
"26879","421430 RANCHO QUEIMADO",0,1,0,24,0,25,"2014"
"26880","421440 RIO DAS ANTAS",0,0,4,81,0,85,"2014"
"26881","421450 RIO DO CAMPO",0,0,0,82,0,82,"2014"
"26882","421460 RIO DO OESTE",0,1,2,82,0,85,"2014"
"26883","421470 RIO DOS CEDROS",0,1,1,125,0,127,"2014"
"26884","421480 RIO DO SUL",2,2,12,851,1,868,"2014"
"26885","421490 RIO FORTUNA",0,0,0,42,0,42,"2014"
"26886","421500 RIO NEGRINHO",0,1,12,572,0,585,"2014"
"26887","421505 RIO RUFINO",0,0,5,28,0,33,"2014"
"26888","421507 RIQUEZA",0,1,0,53,0,54,"2014"
"26889","421510 RODEIO",0,0,1,108,1,110,"2014"
"26890","421520 ROMELANDIA",0,0,0,45,1,46,"2014"
"26891","421530 SALETE",0,0,1,85,0,86,"2014"
"26892","421535 SALTINHO",0,0,0,54,0,54,"2014"
"26893","421540 SALTO VELOSO",0,0,0,53,0,53,"2014"
"26894","421545 SANGAO",1,0,0,210,0,211,"2014"
"26895","421550 SANTA CECILIA",1,0,5,245,0,251,"2014"
"26896","421555 SANTA HELENA",0,0,0,18,0,18,"2014"
"26897","421560 SANTA ROSA DE LIMA",0,0,0,19,0,19,"2014"
"26898","421565 SANTA ROSA DO SUL",0,0,1,93,0,94,"2014"
"26899","421567 SANTA TEREZINHA",1,0,0,89,0,90,"2014"
"26900","421568 SANTA TEREZINHA DO PROGRESSO",0,0,0,34,0,34,"2014"
"26901","421569 SANTIAGO DO SUL",0,0,0,26,0,26,"2014"
"26902","421570 SANTO AMARO DA IMPERATRIZ",1,0,5,284,0,290,"2014"
"26903","421575 SAO BERNARDINO",0,0,0,37,0,37,"2014"
"26904","421580 SAO BENTO DO SUL",6,6,12,1157,4,1185,"2014"
"26905","421590 SAO BONIFACIO",1,0,0,23,0,24,"2014"
"26906","421600 SAO CARLOS",0,0,0,128,0,128,"2014"
"26907","421605 SAO CRISTOVAO DO SUL",0,0,2,76,1,79,"2014"
"26908","421610 SAO DOMINGOS",0,0,3,114,0,117,"2014"
"26909","421620 SAO FRANCISCO DO SUL",3,5,6,619,8,641,"2014"
"26910","421625 SAO JOAO DO OESTE",0,0,0,55,0,55,"2014"
"26911","421630 SAO JOAO BATISTA",2,2,6,420,0,430,"2014"
"26912","421635 SAO JOAO DO ITAPERIU",0,1,1,40,0,42,"2014"
"26913","421640 SAO JOAO DO SUL",4,0,1,82,0,87,"2014"
"26914","421650 SAO JOAQUIM",0,3,11,354,1,369,"2014"
"26915","421660 SAO JOSE",8,11,49,3094,4,3166,"2014"
"26916","421670 SAO JOSE DO CEDRO",0,0,3,170,0,173,"2014"
"26917","421680 SAO JOSE DO CERRITO",1,0,3,81,0,85,"2014"
"26918","421690 SAO LOURENCO DO OESTE",1,0,7,301,0,309,"2014"
"26919","421700 SAO LUDGERO",0,0,2,155,0,157,"2014"
"26920","421710 SAO MARTINHO",0,0,1,36,0,37,"2014"
"26921","421715 SAO MIGUEL DA BOA VISTA",0,0,0,20,0,20,"2014"
"26922","421720 SAO MIGUEL DO OESTE",3,2,8,517,0,530,"2014"
"26923","421725 SAO PEDRO DE ALCANTARA",0,0,1,34,1,36,"2014"
"26924","421730 SAUDADES",0,0,2,106,0,108,"2014"
"26925","421740 SCHROEDER",0,1,5,263,0,269,"2014"
"26926","421750 SEARA",0,0,3,213,0,216,"2014"
"26927","421755 SERRA ALTA",0,0,0,29,0,29,"2014"
"26928","421760 SIDEROPOLIS",1,1,0,157,0,159,"2014"
"26929","421770 SOMBRIO",0,2,5,429,3,439,"2014"
"26930","421775 SUL BRASIL",0,0,0,31,0,31,"2014"
"26931","421780 TAIO",0,0,4,192,0,196,"2014"
"26932","421790 TANGARA",0,0,3,90,2,95,"2014"
"26933","421795 TIGRINHOS",0,0,2,15,0,17,"2014"
"26934","421800 TIJUCAS",2,1,8,551,2,564,"2014"
"26935","421810 TIMBE DO SUL",0,0,0,57,0,57,"2014"
"26936","421820 TIMBO",1,1,2,501,0,505,"2014"
"26937","421825 TIMBO GRANDE",0,0,0,101,0,101,"2014"
"26938","421830 TRES BARRAS",0,1,11,307,2,321,"2014"
"26939","421835 TREVISO",0,0,0,39,0,39,"2014"
"26940","421840 TREZE DE MAIO",0,0,0,78,0,78,"2014"
"26941","421850 TREZE TILIAS",0,1,1,101,0,103,"2014"
"26942","421860 TROMBUDO CENTRAL",1,0,1,93,0,95,"2014"
"26943","421870 TUBARAO",3,2,11,1305,3,1324,"2014"
"26944","421875 TUNAPOLIS",0,0,1,53,0,54,"2014"
"26945","421880 TURVO",0,0,2,147,2,151,"2014"
"26946","421885 UNIAO DO OESTE",0,0,0,22,0,22,"2014"
"26947","421890 URUBICI",0,1,4,135,0,140,"2014"
"26948","421895 URUPEMA",0,0,0,25,0,25,"2014"
"26949","421900 URUSSANGA",0,2,2,224,1,229,"2014"
"26950","421910 VARGEAO",0,0,1,45,0,46,"2014"
"26951","421915 VARGEM",0,0,0,34,0,34,"2014"
"26952","421917 VARGEM BONITA",0,0,0,65,1,66,"2014"
"26953","421920 VIDAL RAMOS",0,0,2,66,0,68,"2014"
"26954","421930 VIDEIRA",3,1,9,720,0,733,"2014"
"26955","421935 VITOR MEIRELES",0,0,1,66,1,68,"2014"
"26956","421940 WITMARSUM",0,0,0,61,0,61,"2014"
"26957","421950 XANXERE",0,4,9,609,0,622,"2014"
"26958","421960 XAVANTINA",0,0,0,27,1,28,"2014"
"26959","421970 XAXIM",1,0,1,367,0,369,"2014"
"26960","421985 ZORTEA",0,0,1,33,0,34,"2014"
"26961","422000 BALNEARIO RINCAO",0,1,1,198,0,200,"2014"
"26962","430003 ACEGUA",0,1,0,72,0,73,"2014"
"26963","430005 AGUA SANTA",0,0,1,47,0,48,"2014"
"26964","430010 AGUDO",0,1,4,157,0,162,"2014"
"26965","430020 AJURICABA",0,0,2,59,0,61,"2014"
"26966","430030 ALECRIM",0,1,3,55,0,59,"2014"
"26967","430040 ALEGRETE",1,3,10,907,4,925,"2014"
"26968","430045 ALEGRIA",0,0,0,37,0,37,"2014"
"26969","430047 ALMIRANTE TAMANDARE DO SUL",0,0,0,22,0,22,"2014"
"26970","430050 ALPESTRE",0,0,0,72,0,72,"2014"
"26971","430055 ALTO ALEGRE",0,0,0,14,0,14,"2014"
"26972","430057 ALTO FELIZ",0,0,0,26,0,26,"2014"
"26973","430060 ALVORADA",3,15,66,3329,6,3419,"2014"
"26974","430063 AMARAL FERRADOR",0,0,1,60,0,61,"2014"
"26975","430064 AMETISTA DO SUL",0,0,0,73,0,73,"2014"
"26976","430066 ANDRE DA ROCHA",0,0,0,11,0,11,"2014"
"26977","430070 ANTA GORDA",0,0,0,41,0,41,"2014"
"26978","430080 ANTONIO PRADO",0,0,0,144,0,144,"2014"
"26979","430085 ARAMBARE",0,0,0,26,0,26,"2014"
"26980","430087 ARARICA",0,1,0,107,0,108,"2014"
"26981","430090 ARATIBA",0,0,0,54,0,54,"2014"
"26982","430100 ARROIO DO MEIO",0,2,4,267,0,273,"2014"
"26983","430105 ARROIO DO SAL",0,1,1,100,1,103,"2014"
"26984","430107 ARROIO DO PADRE",0,0,1,15,0,16,"2014"
"26985","430110 ARROIO DOS RATOS",0,0,3,173,1,177,"2014"
"26986","430120 ARROIO DO TIGRE",0,0,0,139,0,139,"2014"
"26987","430130 ARROIO GRANDE",0,1,10,190,0,201,"2014"
"26988","430140 ARVOREZINHA",0,0,4,106,0,110,"2014"
"26989","430150 AUGUSTO PESTANA",0,0,3,59,0,62,"2014"
"26990","430155 AUREA",0,1,0,32,1,34,"2014"
"26991","430160 BAGE",5,7,10,1566,3,1591,"2014"
"26992","430163 BALNEARIO PINHAL",0,3,1,134,0,138,"2014"
"26993","430165 BARAO",0,0,0,64,0,64,"2014"
"26994","430170 BARAO DE COTEGIPE",0,0,0,67,0,67,"2014"
"26995","430175 BARAO DO TRIUNFO",0,0,2,65,1,68,"2014"
"26996","430180 BARRACAO",1,1,0,40,0,42,"2014"
"26997","430185 BARRA DO GUARITA",0,0,2,35,0,37,"2014"
"26998","430187 BARRA DO QUARAI",0,0,0,19,19,38,"2014"
"26999","430190 BARRA DO RIBEIRO",0,0,2,107,12,121,"2014"
"27000","430192 BARRA DO RIO AZUL",0,0,1,9,0,10,"2014"
"27001","430195 BARRA FUNDA",0,0,0,36,0,36,"2014"
"27002","430200 BARROS CASSAL",0,0,2,105,2,109,"2014"
"27003","430205 BENJAMIN CONSTANT DO SUL",0,0,0,37,0,37,"2014"
"27004","430210 BENTO GONCALVES",3,4,31,1574,2,1614,"2014"
"27005","430215 BOA VISTA DAS MISSOES",1,1,0,22,0,24,"2014"
"27006","430220 BOA VISTA DO BURICA",0,0,0,70,0,70,"2014"
"27007","430222 BOA VISTA DO CADEADO",0,0,1,22,0,23,"2014"
"27008","430223 BOA VISTA DO INCRA",1,0,0,25,0,26,"2014"
"27009","430225 BOA VISTA DO SUL",0,0,0,26,0,26,"2014"
"27010","430230 BOM JESUS",0,0,0,130,3,133,"2014"
"27011","430235 BOM PRINCIPIO",0,0,3,161,0,164,"2014"
"27012","430237 BOM PROGRESSO",0,0,0,34,0,34,"2014"
"27013","430240 BOM RETIRO DO SUL",1,1,3,132,0,137,"2014"
"27014","430245 BOQUEIRAO DO LEAO",0,0,2,82,0,84,"2014"
"27015","430250 BOSSOROCA",0,1,0,49,0,50,"2014"
"27016","430258 BOZANO",0,1,0,16,0,17,"2014"
"27017","430260 BRAGA",0,0,0,34,0,34,"2014"
"27018","430265 BROCHIER",0,0,2,43,0,45,"2014"
"27019","430270 BUTIA",0,2,5,306,0,313,"2014"
"27020","430280 CACAPAVA DO SUL",1,3,5,386,3,398,"2014"
"27021","430290 CACEQUI",0,1,0,100,3,104,"2014"
"27022","430300 CACHOEIRA DO SUL",4,1,16,950,4,975,"2014"
"27023","430310 CACHOEIRINHA",8,10,30,2054,4,2106,"2014"
"27024","430320 CACIQUE DOBLE",0,0,1,66,0,67,"2014"
"27025","430330 CAIBATE",1,0,1,54,0,56,"2014"
"27026","430340 CAICARA",0,0,0,29,0,29,"2014"
"27027","430350 CAMAQUA",1,6,10,836,9,862,"2014"
"27028","430355 CAMARGO",0,0,1,22,0,23,"2014"
"27029","430360 CAMBARA DO SUL",0,1,0,65,0,66,"2014"
"27030","430367 CAMPESTRE DA SERRA",0,1,0,23,0,24,"2014"
"27031","430370 CAMPINA DAS MISSOES",0,0,0,47,0,47,"2014"
"27032","430380 CAMPINAS DO SUL",0,0,0,43,0,43,"2014"
"27033","430390 CAMPO BOM",3,3,18,821,0,845,"2014"
"27034","430400 CAMPO NOVO",0,0,1,87,0,88,"2014"
"27035","430410 CAMPOS BORGES",0,0,0,32,0,32,"2014"
"27036","430420 CANDELARIA",4,2,2,309,1,318,"2014"
"27037","430430 CANDIDO GODOI",1,0,3,55,0,59,"2014"
"27038","430435 CANDIOTA",0,1,2,130,0,133,"2014"
"27039","430440 CANELA",2,2,8,662,2,676,"2014"
"27040","430450 CANGUCU",1,0,3,569,1,574,"2014"
"27041","430460 CANOAS",14,24,123,5150,17,5328,"2014"
"27042","430461 CANUDOS DO VALE",1,0,0,11,0,12,"2014"
"27043","430462 CAPAO BONITO DO SUL",0,0,0,22,1,23,"2014"
"27044","430463 CAPAO DA CANOA",0,3,20,771,1,795,"2014"
"27045","430465 CAPAO DO CIPO",0,0,0,25,0,25,"2014"
"27046","430466 CAPAO DO LEAO",0,0,8,372,0,380,"2014"
"27047","430467 CAPIVARI DO SUL",0,0,1,47,0,48,"2014"
"27048","430468 CAPELA DE SANTANA",0,0,0,129,1,130,"2014"
"27049","430469 CAPITAO",0,0,1,31,0,32,"2014"
"27050","430470 CARAZINHO",0,4,9,856,2,871,"2014"
"27051","430471 CARAA",0,0,1,69,2,72,"2014"
"27052","430480 CARLOS BARBOSA",0,1,3,315,0,319,"2014"
"27053","430485 CARLOS GOMES",0,0,0,8,0,8,"2014"
"27054","430490 CASCA",0,0,1,92,0,93,"2014"
"27055","430495 CASEIROS",0,0,0,36,0,36,"2014"
"27056","430500 CATUIPE",1,0,4,86,0,91,"2014"
"27057","430510 CAXIAS DO SUL",11,32,119,6244,15,6421,"2014"
"27058","430511 CENTENARIO",0,1,1,31,0,33,"2014"
"27059","430512 CERRITO",0,0,1,60,0,61,"2014"
"27060","430513 CERRO BRANCO",0,0,0,39,0,39,"2014"
"27061","430515 CERRO GRANDE",0,0,1,29,0,30,"2014"
"27062","430517 CERRO GRANDE DO SUL",0,0,4,115,0,119,"2014"
"27063","430520 CERRO LARGO",0,1,0,149,0,150,"2014"
"27064","430530 CHAPADA",0,1,0,68,0,69,"2014"
"27065","430535 CHARQUEADAS",2,1,4,423,2,432,"2014"
"27066","430537 CHARRUA",0,0,2,31,0,33,"2014"
"27067","430540 CHIAPETTA",0,0,1,45,0,46,"2014"
"27068","430543 CHUI",0,0,4,54,0,58,"2014"
"27069","430544 CHUVISCA",0,0,1,66,0,67,"2014"
"27070","430545 CIDREIRA",1,3,5,165,0,174,"2014"
"27071","430550 CIRIACO",0,0,0,45,2,47,"2014"
"27072","430558 COLINAS",0,0,1,21,0,22,"2014"
"27073","430560 COLORADO",0,0,0,22,2,24,"2014"
"27074","430570 CONDOR",0,0,1,36,0,37,"2014"
"27075","430580 CONSTANTINA",0,1,4,110,0,115,"2014"
"27076","430583 COQUEIRO BAIXO",0,0,0,9,0,9,"2014"
"27077","430585 COQUEIROS DO SUL",0,0,0,15,0,15,"2014"
"27078","430587 CORONEL BARROS",0,0,0,26,0,26,"2014"
"27079","430590 CORONEL BICACO",0,0,2,91,1,94,"2014"
"27080","430593 CORONEL PILAR",0,0,0,8,0,8,"2014"
"27081","430595 COTIPORA",0,0,1,16,0,17,"2014"
"27082","430597 COXILHA",0,0,0,32,0,32,"2014"
"27083","430600 CRISSIUMAL",0,0,0,156,0,156,"2014"
"27084","430605 CRISTAL",0,1,0,94,0,95,"2014"
"27085","430607 CRISTAL DO SUL",0,0,0,28,0,28,"2014"
"27086","430610 CRUZ ALTA",1,2,18,886,0,907,"2014"
"27087","430613 CRUZALTENSE",0,0,1,15,0,16,"2014"
"27088","430620 CRUZEIRO DO SUL",0,0,0,103,0,103,"2014"
"27089","430630 DAVID CANABARRO",0,0,0,37,0,37,"2014"
"27090","430632 DERRUBADAS",0,0,0,19,0,19,"2014"
"27091","430635 DEZESSEIS DE NOVEMBRO",0,0,0,22,0,22,"2014"
"27092","430637 DILERMANDO DE AGUIAR",0,0,0,34,0,34,"2014"
"27093","430640 DOIS IRMAOS",0,1,4,358,0,363,"2014"
"27094","430642 DOIS IRMAOS DAS MISSOES",1,0,0,26,0,27,"2014"
"27095","430645 DOIS LAJEADOS",0,2,0,24,0,26,"2014"
"27096","430650 DOM FELICIANO",0,0,0,163,0,163,"2014"
"27097","430655 DOM PEDRO DE ALCANTARA",0,0,0,19,0,19,"2014"
"27098","430660 DOM PEDRITO",1,1,4,458,2,466,"2014"
"27099","430670 DONA FRANCISCA",0,0,0,33,0,33,"2014"
"27100","430673 DOUTOR MAURICIO CARDOSO",0,1,0,41,0,42,"2014"
"27101","430675 DOUTOR RICARDO",0,0,0,15,0,15,"2014"
"27102","430676 ELDORADO DO SUL",1,1,11,576,4,593,"2014"
"27103","430680 ENCANTADO",2,2,1,268,1,274,"2014"
"27104","430690 ENCRUZILHADA DO SUL",1,1,3,263,0,268,"2014"
"27105","430692 ENGENHO VELHO",0,0,1,19,1,21,"2014"
"27106","430693 ENTRE-IJUIS",1,0,0,99,0,100,"2014"
"27107","430695 ENTRE RIOS DO SUL",0,0,2,38,0,40,"2014"
"27108","430697 EREBANGO",0,0,1,53,1,55,"2014"
"27109","430700 ERECHIM",1,3,18,1330,1,1353,"2014"
"27110","430705 ERNESTINA",0,1,1,38,0,40,"2014"
"27111","430710 HERVAL",0,1,0,68,2,71,"2014"
"27112","430720 ERVAL GRANDE",0,0,0,62,1,63,"2014"
"27113","430730 ERVAL SECO",0,0,2,77,0,79,"2014"
"27114","430740 ESMERALDA",0,0,3,38,1,42,"2014"
"27115","430745 ESPERANCA DO SUL",0,0,0,40,0,40,"2014"
"27116","430750 ESPUMOSO",0,0,1,185,0,186,"2014"
"27117","430755 ESTACAO",1,0,1,65,0,67,"2014"
"27118","430760 ESTANCIA VELHA",1,1,6,636,0,644,"2014"
"27119","430770 ESTEIO",1,2,23,1044,1,1071,"2014"
"27120","430780 ESTRELA",0,8,10,402,0,420,"2014"
"27121","430781 ESTRELA VELHA",0,0,1,32,0,33,"2014"
"27122","430783 EUGENIO DE CASTRO",0,0,0,26,0,26,"2014"
"27123","430786 FAGUNDES VARELA",0,0,0,24,0,24,"2014"
"27124","430790 FARROUPILHA",0,3,15,888,0,906,"2014"
"27125","430800 FAXINAL DO SOTURNO",0,0,1,51,0,52,"2014"
"27126","430805 FAXINALZINHO",0,0,0,27,1,28,"2014"
"27127","430807 FAZENDA VILANOVA",0,2,3,58,0,63,"2014"
"27128","430810 FELIZ",0,1,2,156,0,159,"2014"
"27129","430820 FLORES DA CUNHA",0,0,2,368,2,372,"2014"
"27130","430825 FLORIANO PEIXOTO",0,0,0,7,0,7,"2014"
"27131","430830 FONTOURA XAVIER",1,3,2,118,0,124,"2014"
"27132","430840 FORMIGUEIRO",0,0,0,55,1,56,"2014"
"27133","430843 FORQUETINHA",0,0,0,17,0,17,"2014"
"27134","430845 FORTALEZA DOS VALOS",0,0,1,54,0,55,"2014"
"27135","430850 FREDERICO WESTPHALEN",0,0,6,401,1,408,"2014"
"27136","430860 GARIBALDI",2,1,5,358,0,366,"2014"
"27137","430865 GARRUCHOS",0,0,0,28,0,28,"2014"
"27138","430870 GAURAMA",1,1,0,48,0,50,"2014"
"27139","430880 GENERAL CAMARA",0,1,1,83,1,86,"2014"
"27140","430885 GENTIL",0,0,0,22,0,22,"2014"
"27141","430890 GETULIO VARGAS",0,1,5,181,0,187,"2014"
"27142","430900 GIRUA",1,0,3,189,0,193,"2014"
"27143","430905 GLORINHA",0,1,2,72,1,76,"2014"
"27144","430910 GRAMADO",2,1,4,529,0,536,"2014"
"27145","430912 GRAMADO DOS LOUREIROS",0,0,0,27,1,28,"2014"
"27146","430915 GRAMADO XAVIER",0,1,0,31,2,34,"2014"
"27147","430920 GRAVATAI",8,11,54,3512,3,3588,"2014"
"27148","430925 GUABIJU",0,0,0,18,0,18,"2014"
"27149","430930 GUAIBA",0,5,27,1274,11,1317,"2014"
"27150","430940 GUAPORE",1,0,4,302,0,307,"2014"
"27151","430950 GUARANI DAS MISSOES",0,0,0,80,0,80,"2014"
"27152","430955 HARMONIA",0,1,0,41,1,43,"2014"
"27153","430957 HERVEIRAS",0,0,0,35,0,35,"2014"
"27154","430960 HORIZONTINA",1,1,2,217,0,221,"2014"
"27155","430965 HULHA NEGRA",0,0,2,76,0,78,"2014"
"27156","430970 HUMAITA",0,0,0,38,0,38,"2014"
"27157","430975 IBARAMA",1,0,0,38,0,39,"2014"
"27158","430980 IBIACA",0,0,1,35,1,37,"2014"
"27159","430990 IBIRAIARAS",0,1,1,71,0,73,"2014"
"27160","430995 IBIRAPUITA",0,1,0,33,0,34,"2014"
"27161","431000 IBIRUBA",0,2,3,250,2,257,"2014"
"27162","431010 IGREJINHA",0,2,4,461,3,470,"2014"
"27163","431020 IJUI",2,1,18,1086,0,1107,"2014"
"27164","431030 ILOPOLIS",0,0,0,34,0,34,"2014"
"27165","431033 IMBE",0,3,3,277,0,283,"2014"
"27166","431036 IMIGRANTE",0,0,1,19,0,20,"2014"
"27167","431040 INDEPENDENCIA",0,0,0,78,0,78,"2014"
"27168","431041 INHACORA",0,0,2,33,0,35,"2014"
"27169","431043 IPE",1,0,0,49,0,50,"2014"
"27170","431046 IPIRANGA DO SUL",0,0,0,17,0,17,"2014"
"27171","431050 IRAI",0,2,2,117,0,121,"2014"
"27172","431053 ITAARA",0,0,2,66,2,70,"2014"
"27173","431055 ITACURUBI",0,0,0,29,0,29,"2014"
"27174","431057 ITAPUCA",0,0,0,16,0,16,"2014"
"27175","431060 ITAQUI",1,1,11,516,1,530,"2014"
"27176","431065 ITATI",0,0,0,30,0,30,"2014"
"27177","431070 ITATIBA DO SUL",0,0,2,36,0,38,"2014"
"27178","431075 IVORA",0,0,0,13,0,13,"2014"
"27179","431080 IVOTI",0,2,1,275,0,278,"2014"
"27180","431085 JABOTICABA",0,0,0,41,0,41,"2014"
"27181","431087 JACUIZINHO",0,0,0,22,0,22,"2014"
"27182","431090 JACUTINGA",0,0,0,33,0,33,"2014"
"27183","431100 JAGUARAO",1,1,5,342,0,349,"2014"
"27184","431110 JAGUARI",0,0,0,83,0,83,"2014"
"27185","431112 JAQUIRANA",0,1,0,49,0,50,"2014"
"27186","431113 JARI",0,1,2,27,0,30,"2014"
"27187","431115 JOIA",0,0,0,87,0,87,"2014"
"27188","431120 JULIO DE CASTILHOS",1,0,4,245,0,250,"2014"
"27189","431123 LAGOA BONITA DO SUL",0,0,0,31,0,31,"2014"
"27190","431125 LAGOAO",0,1,2,71,0,74,"2014"
"27191","431127 LAGOA DOS TRES CANTOS",0,0,0,12,0,12,"2014"
"27192","431130 LAGOA VERMELHA",2,0,4,341,0,347,"2014"
"27193","431140 LAJEADO",0,5,12,1102,0,1119,"2014"
"27194","431142 LAJEADO DO BUGRE",0,0,1,24,0,25,"2014"
"27195","431150 LAVRAS DO SUL",0,0,1,68,0,69,"2014"
"27196","431160 LIBERATO SALZANO",0,0,1,67,0,68,"2014"
"27197","431162 LINDOLFO COLLOR",1,0,0,91,0,92,"2014"
"27198","431164 LINHA NOVA",0,0,0,8,0,8,"2014"
"27199","431170 MACHADINHO",0,1,2,52,0,55,"2014"
"27200","431171 MACAMBARA",0,0,0,37,0,37,"2014"
"27201","431173 MAMPITUBA",0,0,0,19,0,19,"2014"
"27202","431175 MANOEL VIANA",0,1,2,62,0,65,"2014"
"27203","431177 MAQUINE",0,0,1,86,1,88,"2014"
"27204","431179 MARATA",0,0,0,12,0,12,"2014"
"27205","431180 MARAU",1,2,9,515,0,527,"2014"
"27206","431190 MARCELINO RAMOS",0,1,0,47,0,48,"2014"
"27207","431198 MARIANA PIMENTEL",0,0,4,25,0,29,"2014"
"27208","431200 MARIANO MORO",0,0,0,18,0,18,"2014"
"27209","431205 MARQUES DE SOUZA",0,0,0,46,0,46,"2014"
"27210","431210 MATA",0,1,1,42,0,44,"2014"
"27211","431213 MATO CASTELHANO",0,0,0,35,0,35,"2014"
"27212","431215 MATO LEITAO",0,0,0,56,0,56,"2014"
"27213","431217 MATO QUEIMADO",0,0,0,22,0,22,"2014"
"27214","431220 MAXIMILIANO DE ALMEIDA",0,0,0,36,0,36,"2014"
"27215","431225 MINAS DO LEAO",0,0,2,112,0,114,"2014"
"27216","431230 MIRAGUAI",0,0,1,55,0,56,"2014"
"27217","431235 MONTAURI",0,0,0,13,0,13,"2014"
"27218","431237 MONTE ALEGRE DOS CAMPOS",0,0,0,34,0,34,"2014"
"27219","431238 MONTE BELO DO SUL",0,0,0,17,0,17,"2014"
"27220","431240 MONTENEGRO",3,2,6,898,1,910,"2014"
"27221","431242 MORMACO",0,1,1,33,0,35,"2014"
"27222","431244 MORRINHOS DO SUL",0,0,0,23,0,23,"2014"
"27223","431245 MORRO REDONDO",0,0,0,52,0,52,"2014"
"27224","431247 MORRO REUTER",0,0,2,75,0,77,"2014"
"27225","431250 MOSTARDAS",0,0,3,119,0,122,"2014"
"27226","431260 MUCUM",0,0,1,48,0,49,"2014"
"27227","431261 MUITOS CAPOES",0,1,1,34,3,39,"2014"
"27228","431262 MULITERNO",0,0,0,21,1,22,"2014"
"27229","431265 NAO-ME-TOQUE",0,1,8,213,0,222,"2014"
"27230","431267 NICOLAU VERGUEIRO",0,0,1,17,0,18,"2014"
"27231","431270 NONOAI",0,1,1,171,1,174,"2014"
"27232","431275 NOVA ALVORADA",0,0,0,39,0,39,"2014"
"27233","431280 NOVA ARACA",0,0,2,52,0,54,"2014"
"27234","431290 NOVA BASSANO",0,0,2,83,0,85,"2014"
"27235","431295 NOVA BOA VISTA",0,0,0,21,0,21,"2014"
"27236","431300 NOVA BRESCIA",0,0,1,35,0,36,"2014"
"27237","431301 NOVA CANDELARIA",0,0,1,26,0,27,"2014"
"27238","431303 NOVA ESPERANCA DO SUL",0,0,0,53,0,53,"2014"
"27239","431306 NOVA HARTZ",0,0,7,233,0,240,"2014"
"27240","431308 NOVA PADUA",0,0,0,15,0,15,"2014"
"27241","431310 NOVA PALMA",0,0,0,68,1,69,"2014"
"27242","431320 NOVA PETROPOLIS",1,1,3,239,1,245,"2014"
"27243","431330 NOVA PRATA",1,1,2,317,2,323,"2014"
"27244","431333 NOVA RAMADA",0,0,0,18,0,18,"2014"
"27245","431335 NOVA ROMA DO SUL",0,0,0,28,0,28,"2014"
"27246","431337 NOVA SANTA RITA",1,2,4,374,0,381,"2014"
"27247","431339 NOVO CABRAIS",0,0,1,41,0,42,"2014"
"27248","431340 NOVO HAMBURGO",3,9,74,3114,6,3206,"2014"
"27249","431342 NOVO MACHADO",0,0,0,21,0,21,"2014"
"27250","431344 NOVO TIRADENTES",0,0,0,24,0,24,"2014"
"27251","431346 NOVO XINGU",0,0,1,19,0,20,"2014"
"27252","431349 NOVO BARREIRO",0,0,0,52,1,53,"2014"
"27253","431350 OSORIO",1,1,13,577,1,593,"2014"
"27254","431360 PAIM FILHO",0,0,0,32,0,32,"2014"
"27255","431365 PALMARES DO SUL",0,1,1,133,0,135,"2014"
"27256","431370 PALMEIRA DAS MISSOES",1,2,9,475,0,487,"2014"
"27257","431380 PALMITINHO",1,1,3,88,0,93,"2014"
"27258","431390 PANAMBI",3,4,3,572,0,582,"2014"
"27259","431395 PANTANO GRANDE",0,0,2,99,0,101,"2014"
"27260","431400 PARAI",0,1,0,66,0,67,"2014"
"27261","431402 PARAISO DO SUL",0,1,2,55,0,58,"2014"
"27262","431403 PARECI NOVO",0,0,1,47,0,48,"2014"
"27263","431405 PAROBE",3,2,12,776,1,794,"2014"
"27264","431406 PASSA SETE",0,0,1,43,0,44,"2014"
"27265","431407 PASSO DO SOBRADO",0,0,0,44,0,44,"2014"
"27266","431410 PASSO FUNDO",6,27,41,2844,1,2919,"2014"
"27267","431413 PAULO BENTO",0,0,0,14,0,14,"2014"
"27268","431415 PAVERAMA",0,1,1,79,0,81,"2014"
"27269","431417 PEDRAS ALTAS",0,0,0,10,0,10,"2014"
"27270","431420 PEDRO OSORIO",0,0,1,94,0,95,"2014"
"27271","431430 PEJUCARA",0,0,0,30,0,30,"2014"
"27272","431440 PELOTAS",15,40,75,4210,13,4353,"2014"
"27273","431442 PICADA CAFE",0,0,0,56,0,56,"2014"
"27274","431445 PINHAL",0,0,1,27,0,28,"2014"
"27275","431446 PINHAL DA SERRA",0,1,1,19,3,24,"2014"
"27276","431447 PINHAL GRANDE",0,2,0,38,1,41,"2014"
"27277","431449 PINHEIRINHO DO VALE",0,0,5,39,0,44,"2014"
"27278","431450 PINHEIRO MACHADO",0,2,2,105,0,109,"2014"
"27279","431454 PINTO BANDEIRA",0,0,0,23,0,23,"2014"
"27280","431455 PIRAPO",0,0,0,22,0,22,"2014"
"27281","431460 PIRATINI",0,1,8,172,3,184,"2014"
"27282","431470 PLANALTO",0,0,2,128,0,130,"2014"
"27283","431475 POCO DAS ANTAS",0,0,0,22,0,22,"2014"
"27284","431477 PONTAO",0,0,1,34,0,35,"2014"
"27285","431478 PONTE PRETA",0,0,0,11,0,11,"2014"
"27286","431480 PORTAO",0,2,15,408,5,430,"2014"
"27287","431490 PORTO ALEGRE",44,97,361,18617,70,19189,"2014"
"27288","431500 PORTO LUCENA",0,0,1,36,0,37,"2014"
"27289","431505 PORTO MAUA",0,0,0,18,0,18,"2014"
"27290","431507 PORTO VERA CRUZ",0,0,0,11,0,11,"2014"
"27291","431510 PORTO XAVIER",1,1,2,137,0,141,"2014"
"27292","431513 POUSO NOVO",0,0,0,13,1,14,"2014"
"27293","431514 PRESIDENTE LUCENA",0,0,0,28,0,28,"2014"
"27294","431515 PROGRESSO",0,0,4,37,4,45,"2014"
"27295","431517 PROTASIO ALVES",0,0,0,12,0,12,"2014"
"27296","431520 PUTINGA",0,0,0,33,1,34,"2014"
"27297","431530 QUARAI",0,1,2,302,1,306,"2014"
"27298","431531 QUATRO IRMAOS",0,1,0,20,0,21,"2014"
"27299","431532 QUEVEDOS",0,0,0,18,1,19,"2014"
"27300","431535 QUINZE DE NOVEMBRO",0,1,0,37,0,38,"2014"
"27301","431540 REDENTORA",0,0,1,211,0,212,"2014"
"27302","431545 RELVADO",0,0,1,11,0,12,"2014"
"27303","431550 RESTINGA SECA",0,0,2,163,0,165,"2014"
"27304","431555 RIO DOS INDIOS",1,0,1,26,0,28,"2014"
"27305","431560 RIO GRANDE",8,14,111,2800,27,2960,"2014"
"27306","431570 RIO PARDO",0,1,4,404,0,409,"2014"
"27307","431575 RIOZINHO",0,1,2,40,0,43,"2014"
"27308","431580 ROCA SALES",1,2,0,101,0,104,"2014"
"27309","431590 RODEIO BONITO",0,0,0,73,0,73,"2014"
"27310","431595 ROLADOR",0,1,0,17,0,18,"2014"
"27311","431600 ROLANTE",0,0,3,271,2,276,"2014"
"27312","431610 RONDA ALTA",0,1,5,98,0,104,"2014"
"27313","431620 RONDINHA",1,0,3,56,0,60,"2014"
"27314","431630 ROQUE GONZALES",0,0,0,56,0,56,"2014"
"27315","431640 ROSARIO DO SUL",1,1,6,392,0,400,"2014"
"27316","431642 SAGRADA FAMILIA",0,0,3,24,0,27,"2014"
"27317","431643 SALDANHA MARINHO",0,0,0,27,0,27,"2014"
"27318","431645 SALTO DO JACUI",0,2,0,147,0,149,"2014"
"27319","431647 SALVADOR DAS MISSOES",0,0,0,19,0,19,"2014"
"27320","431650 SALVADOR DO SUL",0,0,1,66,0,67,"2014"
"27321","431660 SANANDUVA",0,2,4,158,0,164,"2014"
"27322","431670 SANTA BARBARA DO SUL",0,0,3,113,0,116,"2014"
"27323","431673 SANTA CECILIA DO SUL",0,0,0,21,0,21,"2014"
"27324","431675 SANTA CLARA DO SUL",0,0,0,55,0,55,"2014"
"27325","431680 SANTA CRUZ DO SUL",2,8,22,1598,2,1632,"2014"
"27326","431690 SANTA MARIA",8,13,42,3334,9,3406,"2014"
"27327","431695 SANTA MARIA DO HERVAL",0,0,2,82,0,84,"2014"
"27328","431697 SANTA MARGARIDA DO SUL",0,0,0,25,0,25,"2014"
"27329","431700 SANTANA DA BOA VISTA",1,4,4,59,0,68,"2014"
"27330","431710 SANT'ANA DO LIVRAMENTO",1,2,8,1110,5,1126,"2014"
"27331","431720 SANTA ROSA",2,1,56,913,1,973,"2014"
"27332","431725 SANTA TEREZA",0,0,0,8,0,8,"2014"
"27333","431730 SANTA VITORIA DO PALMAR",0,4,3,391,1,399,"2014"
"27334","431740 SANTIAGO",0,1,7,543,0,551,"2014"
"27335","431750 SANTO ANGELO",0,1,8,1009,1,1019,"2014"
"27336","431755 SANTO ANTONIO DO PALMA",0,0,0,12,0,12,"2014"
"27337","431760 SANTO ANTONIO DA PATRULHA",0,2,3,444,0,449,"2014"
"27338","431770 SANTO ANTONIO DAS MISSOES",1,0,0,102,0,103,"2014"
"27339","431775 SANTO ANTONIO DO PLANALTO",0,0,0,15,0,15,"2014"
"27340","431780 SANTO AUGUSTO",1,0,0,197,0,198,"2014"
"27341","431790 SANTO CRISTO",0,4,5,152,0,161,"2014"
"27342","431795 SANTO EXPEDITO DO SUL",0,0,1,27,0,28,"2014"
"27343","431800 SAO BORJA",2,3,2,725,3,735,"2014"
"27344","431805 SAO DOMINGOS DO SUL",0,0,1,22,0,23,"2014"
"27345","431810 SAO FRANCISCO DE ASSIS",0,0,0,215,0,215,"2014"
"27346","431820 SAO FRANCISCO DE PAULA",1,3,2,254,1,261,"2014"
"27347","431830 SAO GABRIEL",3,6,14,739,3,765,"2014"
"27348","431840 SAO JERONIMO",2,1,0,283,2,288,"2014"
"27349","431842 SAO JOAO DA URTIGA",0,0,2,40,0,42,"2014"
"27350","431843 SAO JOAO DO POLESINE",0,0,1,30,0,31,"2014"
"27351","431844 SAO JORGE",0,0,0,26,0,26,"2014"
"27352","431845 SAO JOSE DAS MISSOES",0,0,0,22,0,22,"2014"
"27353","431846 SAO JOSE DO HERVAL",0,0,0,18,4,22,"2014"
"27354","431848 SAO JOSE DO HORTENCIO",0,0,0,41,0,41,"2014"
"27355","431849 SAO JOSE DO INHACORA",0,0,0,24,0,24,"2014"
"27356","431850 SAO JOSE DO NORTE",0,2,7,276,5,290,"2014"
"27357","431860 SAO JOSE DO OURO",1,1,0,69,0,71,"2014"
"27358","431861 SAO JOSE DO SUL",0,0,0,18,0,18,"2014"
"27359","431862 SAO JOSE DOS AUSENTES",0,0,0,38,4,42,"2014"
"27360","431870 SAO LEOPOLDO",7,17,62,2970,7,3063,"2014"
"27361","431880 SAO LOURENCO DO SUL",3,5,9,465,1,483,"2014"
"27362","431890 SAO LUIZ GONZAGA",2,7,1,406,0,416,"2014"
"27363","431900 SAO MARCOS",1,1,4,232,0,238,"2014"
"27364","431910 SAO MARTINHO",0,1,1,44,0,46,"2014"
"27365","431912 SAO MARTINHO DA SERRA",0,0,0,30,1,31,"2014"
"27366","431915 SAO MIGUEL DAS MISSOES",1,1,2,85,0,89,"2014"
"27367","431920 SAO NICOLAU",0,0,0,47,0,47,"2014"
"27368","431930 SAO PAULO DAS MISSOES",0,0,1,46,0,47,"2014"
"27369","431935 SAO PEDRO DA SERRA",0,0,1,37,0,38,"2014"
"27370","431936 SAO PEDRO DAS MISSOES",0,0,0,24,0,24,"2014"
"27371","431937 SAO PEDRO DO BUTIA",0,0,0,34,0,34,"2014"
"27372","431940 SAO PEDRO DO SUL",0,1,2,150,0,153,"2014"
"27373","431950 SAO SEBASTIAO DO CAI",0,3,1,347,2,353,"2014"
"27374","431960 SAO SEPE",0,0,5,238,0,243,"2014"
"27375","431970 SAO VALENTIM",0,0,0,38,0,38,"2014"
"27376","431971 SAO VALENTIM DO SUL",0,0,0,20,0,20,"2014"
"27377","431973 SAO VALERIO DO SUL",0,0,1,29,0,30,"2014"
"27378","431975 SAO VENDELINO",0,0,0,21,0,21,"2014"
"27379","431980 SAO VICENTE DO SUL",0,3,2,86,0,91,"2014"
"27380","431990 SAPIRANGA",1,3,10,1184,1,1199,"2014"
"27381","432000 SAPUCAIA DO SUL",3,12,83,1912,2,2012,"2014"
"27382","432010 SARANDI",0,2,15,260,0,277,"2014"
"27383","432020 SEBERI",0,2,0,164,0,166,"2014"
"27384","432023 SEDE NOVA",0,0,1,29,1,31,"2014"
"27385","432026 SEGREDO",0,0,1,57,0,58,"2014"
"27386","432030 SELBACH",1,0,0,55,0,56,"2014"
"27387","432032 SENADOR SALGADO FILHO",0,0,0,37,0,37,"2014"
"27388","432035 SENTINELA DO SUL",0,0,2,51,1,54,"2014"
"27389","432040 SERAFINA CORREA",0,1,2,182,1,186,"2014"
"27390","432045 SERIO",0,0,1,12,0,13,"2014"
"27391","432050 SERTAO",0,0,0,47,0,47,"2014"
"27392","432055 SERTAO SANTANA",0,0,1,53,2,56,"2014"
"27393","432057 SETE DE SETEMBRO",0,0,0,19,0,19,"2014"
"27394","432060 SEVERIANO DE ALMEIDA",0,0,0,27,0,27,"2014"
"27395","432065 SILVEIRA MARTINS",0,0,0,20,0,20,"2014"
"27396","432067 SINIMBU",1,1,0,92,1,95,"2014"
"27397","432070 SOBRADINHO",2,1,3,184,1,191,"2014"
"27398","432080 SOLEDADE",0,4,3,380,0,387,"2014"
"27399","432085 TABAI",0,0,0,45,0,45,"2014"
"27400","432090 TAPEJARA",1,1,3,282,0,287,"2014"
"27401","432100 TAPERA",0,0,1,123,0,124,"2014"
"27402","432110 TAPES",0,0,3,180,0,183,"2014"
"27403","432120 TAQUARA",0,4,15,703,1,723,"2014"
"27404","432130 TAQUARI",0,2,6,347,2,357,"2014"
"27405","432132 TAQUARUCU DO SUL",0,0,1,29,0,30,"2014"
"27406","432135 TAVARES",1,0,0,35,0,36,"2014"
"27407","432140 TENENTE PORTELA",0,1,0,197,2,200,"2014"
"27408","432143 TERRA DE AREIA",0,0,2,94,0,96,"2014"
"27409","432145 TEUTONIA",0,1,5,390,0,396,"2014"
"27410","432146 TIO HUGO",0,1,0,34,0,35,"2014"
"27411","432147 TIRADENTES DO SUL",0,0,0,50,1,51,"2014"
"27412","432149 TOROPI",0,0,1,21,1,23,"2014"
"27413","432150 TORRES",1,3,2,507,1,514,"2014"
"27414","432160 TRAMANDAI",0,9,13,795,2,819,"2014"
"27415","432162 TRAVESSEIRO",0,0,0,15,0,15,"2014"
"27416","432163 TRES ARROIOS",0,0,1,11,0,12,"2014"
"27417","432166 TRES CACHOEIRAS",2,3,1,117,0,123,"2014"
"27418","432170 TRES COROAS",2,1,4,319,0,326,"2014"
"27419","432180 TRES DE MAIO",0,0,0,290,0,290,"2014"
"27420","432183 TRES FORQUILHAS",0,0,0,23,0,23,"2014"
"27421","432185 TRES PALMEIRAS",0,0,2,55,0,57,"2014"
"27422","432190 TRES PASSOS",2,4,3,302,2,313,"2014"
"27423","432195 TRINDADE DO SUL",0,0,1,91,0,92,"2014"
"27424","432200 TRIUNFO",0,1,2,329,1,333,"2014"
"27425","432210 TUCUNDUVA",1,0,1,49,1,52,"2014"
"27426","432215 TUNAS",0,1,1,37,1,40,"2014"
"27427","432218 TUPANCI DO SUL",0,0,1,17,0,18,"2014"
"27428","432220 TUPANCIRETA",0,2,13,282,0,297,"2014"
"27429","432225 TUPANDI",0,0,2,64,0,66,"2014"
"27430","432230 TUPARENDI",0,0,0,79,0,79,"2014"
"27431","432232 TURUCU",0,0,0,44,0,44,"2014"
"27432","432234 UBIRETAMA",0,0,1,17,0,18,"2014"
"27433","432235 UNIAO DA SERRA",0,0,0,4,0,4,"2014"
"27434","432237 UNISTALDA",0,0,0,28,0,28,"2014"
"27435","432240 URUGUAIANA",8,6,15,1286,536,1851,"2014"
"27436","432250 VACARIA",1,1,11,920,40,973,"2014"
"27437","432252 VALE VERDE",0,0,0,35,0,35,"2014"
"27438","432253 VALE DO SOL",0,1,0,106,0,107,"2014"
"27439","432254 VALE REAL",0,0,2,60,0,62,"2014"
"27440","432255 VANINI",0,1,0,20,0,21,"2014"
"27441","432260 VENANCIO AIRES",4,2,7,803,0,816,"2014"
"27442","432270 VERA CRUZ",0,4,3,269,2,278,"2014"
"27443","432280 VERANOPOLIS",1,2,6,266,0,275,"2014"
"27444","432285 VESPASIANO CORREA",0,0,0,11,0,11,"2014"
"27445","432290 VIADUTOS",0,1,0,47,0,48,"2014"
"27446","432300 VIAMAO",10,14,76,3321,14,3435,"2014"
"27447","432310 VICENTE DUTRA",0,0,0,57,0,57,"2014"
"27448","432320 VICTOR GRAEFF",1,0,0,30,0,31,"2014"
"27449","432330 VILA FLORES",0,0,1,32,0,33,"2014"
"27450","432335 VILA LANGARO",0,1,0,19,0,20,"2014"
"27451","432340 VILA MARIA",0,0,0,34,0,34,"2014"
"27452","432345 VILA NOVA DO SUL",0,0,0,22,0,22,"2014"
"27453","432350 VISTA ALEGRE",0,0,3,26,0,29,"2014"
"27454","432360 VISTA ALEGRE DO PRATA",0,0,0,14,0,14,"2014"
"27455","432370 VISTA GAUCHA",0,0,1,24,0,25,"2014"
"27456","432375 VITORIA DAS MISSOES",0,0,0,20,0,20,"2014"
"27457","432377 WESTFALIA",0,0,0,29,0,29,"2014"
"27458","432380 XANGRI-LA",0,0,3,220,0,223,"2014"
"27459","500020 AGUA CLARA",0,0,3,243,1,247,"2014"
"27460","500025 ALCINOPOLIS",0,0,2,47,0,49,"2014"
"27461","500060 AMAMBAI",4,9,16,737,1,767,"2014"
"27462","500070 ANASTACIO",3,1,3,430,2,439,"2014"
"27463","500080 ANAURILANDIA",0,0,1,107,0,108,"2014"
"27464","500085 ANGELICA",0,0,0,157,0,157,"2014"
"27465","500090 ANTONIO JOAO",0,0,2,163,0,165,"2014"
"27466","500100 APARECIDA DO TABOADO",0,1,4,342,0,347,"2014"
"27467","500110 AQUIDAUANA",4,4,9,730,10,757,"2014"
"27468","500124 ARAL MOREIRA",1,42,1,114,1,159,"2014"
"27469","500150 BANDEIRANTES",0,0,0,89,1,90,"2014"
"27470","500190 BATAGUASSU",1,0,4,343,2,350,"2014"
"27471","500200 BATAYPORA",0,3,0,168,0,171,"2014"
"27472","500210 BELA VISTA",1,1,3,451,3,459,"2014"
"27473","500215 BODOQUENA",0,1,0,102,0,103,"2014"
"27474","500220 BONITO",1,1,3,374,1,380,"2014"
"27475","500230 BRASILANDIA",1,0,3,151,4,159,"2014"
"27476","500240 CAARAPO",5,3,6,519,6,539,"2014"
"27477","500260 CAMAPUA",0,1,2,210,0,213,"2014"
"27478","500270 CAMPO GRANDE",23,31,117,13900,132,14203,"2014"
"27479","500280 CARACOL",1,0,3,84,0,88,"2014"
"27480","500290 CASSILANDIA",0,1,1,288,0,290,"2014"
"27481","500295 CHAPADAO DO SUL",0,1,5,421,0,427,"2014"
"27482","500310 CORGUINHO",0,1,0,37,1,39,"2014"
"27483","500315 CORONEL SAPUCAIA",1,0,4,295,13,313,"2014"
"27484","500320 CORUMBA",5,20,13,1979,15,2032,"2014"
"27485","500325 COSTA RICA",0,1,7,383,0,391,"2014"
"27486","500330 COXIM",2,3,1,556,0,562,"2014"
"27487","500345 DEODAPOLIS",0,2,4,191,1,198,"2014"
"27488","500348 DOIS IRMAOS DO BURITI",0,0,1,130,1,132,"2014"
"27489","500350 DOURADINA",0,0,3,73,0,76,"2014"
"27490","500370 DOURADOS",10,16,81,3649,28,3784,"2014"
"27491","500375 ELDORADO",0,1,71,130,0,202,"2014"
"27492","500380 FATIMA DO SUL",0,0,3,237,1,241,"2014"
"27493","500390 FIGUEIRAO",0,1,4,46,0,51,"2014"
"27494","500400 GLORIA DE DOURADOS",0,1,2,106,0,109,"2014"
"27495","500410 GUIA LOPES DA LAGUNA",0,1,2,162,3,168,"2014"
"27496","500430 IGUATEMI",1,0,2,249,0,252,"2014"
"27497","500440 INOCENCIA",0,0,0,110,1,111,"2014"
"27498","500450 ITAPORA",0,3,3,249,0,255,"2014"
"27499","500460 ITAQUIRAI",0,1,5,263,2,271,"2014"
"27500","500470 IVINHEMA",1,0,3,372,0,376,"2014"
"27501","500480 JAPORA",0,0,28,156,1,185,"2014"
"27502","500490 JARAGUARI",0,0,1,40,0,41,"2014"
"27503","500500 JARDIM",1,0,7,442,5,455,"2014"
"27504","500510 JATEI",0,0,0,45,1,46,"2014"
"27505","500515 JUTI",0,2,1,112,1,116,"2014"
"27506","500520 LADARIO",2,3,3,394,0,402,"2014"
"27507","500525 LAGUNA CARAPA",0,1,0,102,0,103,"2014"
"27508","500540 MARACAJU",1,3,17,689,4,714,"2014"
"27509","500560 MIRANDA",0,1,12,499,3,515,"2014"
"27510","500568 MUNDO NOVO",0,2,143,151,0,296,"2014"
"27511","500570 NAVIRAI",2,6,3,929,1,941,"2014"
"27512","500580 NIOAQUE",1,1,0,188,4,194,"2014"
"27513","500600 NOVA ALVORADA DO SUL",3,1,1,358,0,363,"2014"
"27514","500620 NOVA ANDRADINA",2,3,5,780,0,790,"2014"
"27515","500625 NOVO HORIZONTE DO SUL",0,1,1,101,0,103,"2014"
"27516","500627 PARAISO DAS AGUAS",0,0,0,31,0,31,"2014"
"27517","500630 PARANAIBA",2,1,11,568,0,582,"2014"
"27518","500635 PARANHOS",0,1,5,269,50,325,"2014"
"27519","500640 PEDRO GOMES",0,0,0,89,0,89,"2014"
"27520","500660 PONTA PORA",5,9,18,1491,97,1620,"2014"
"27521","500690 PORTO MURTINHO",0,0,1,246,9,256,"2014"
"27522","500710 RIBAS DO RIO PARDO",0,0,7,351,2,360,"2014"
"27523","500720 RIO BRILHANTE",0,5,7,692,1,705,"2014"
"27524","500730 RIO NEGRO",1,0,0,39,0,40,"2014"
"27525","500740 RIO VERDE DE MATO GROSSO",0,2,4,252,1,259,"2014"
"27526","500750 ROCHEDO",0,0,0,54,0,54,"2014"
"27527","500755 SANTA RITA DO PARDO",0,0,1,79,0,80,"2014"
"27528","500769 SAO GABRIEL DO OESTE",0,1,4,453,0,458,"2014"
"27529","500770 SETE QUEDAS",0,1,0,123,4,128,"2014"
"27530","500780 SELVIRIA",0,0,0,70,0,70,"2014"
"27531","500790 SIDROLANDIA",0,1,2,694,0,697,"2014"
"27532","500793 SONORA",1,1,3,249,0,254,"2014"
"27533","500795 TACURU",0,1,2,218,1,222,"2014"
"27534","500797 TAQUARUSSU",0,0,0,51,0,51,"2014"
"27535","500800 TERENOS",0,2,1,172,1,176,"2014"
"27536","500830 TRES LAGOAS",2,11,14,2006,0,2033,"2014"
"27537","500840 VICENTINA",0,1,0,73,0,74,"2014"
"27538","MUNICIPIO IGNORADO - MT",0,0,0,4,0,4,"2014"
"27539","510010 ACORIZAL",0,0,1,60,2,63,"2014"
"27540","510020 AGUA BOA",1,0,2,399,8,410,"2014"
"27541","510025 ALTA FLORESTA",1,1,12,903,0,917,"2014"
"27542","510030 ALTO ARAGUAIA",0,0,3,249,3,255,"2014"
"27543","510035 ALTO BOA VISTA",0,0,0,41,0,41,"2014"
"27544","510040 ALTO GARCAS",1,1,1,155,0,158,"2014"
"27545","510050 ALTO PARAGUAI",0,0,1,108,0,109,"2014"
"27546","510060 ALTO TAQUARI",1,0,1,161,0,163,"2014"
"27547","510080 APIACAS",0,1,1,108,1,111,"2014"
"27548","510100 ARAGUAIANA",0,0,3,33,0,36,"2014"
"27549","510120 ARAGUAINHA",0,0,0,8,0,8,"2014"
"27550","510125 ARAPUTANGA",0,2,0,277,0,279,"2014"
"27551","510130 ARENAPOLIS",1,0,0,169,0,170,"2014"
"27552","510140 ARIPUANA",0,0,4,362,1,367,"2014"
"27553","510160 BARAO DE MELGACO",0,0,0,56,2,58,"2014"
"27554","510170 BARRA DO BUGRES",3,3,9,573,2,590,"2014"
"27555","510180 BARRA DO GARCAS",2,4,14,950,23,993,"2014"
"27556","510185 BOM JESUS DO ARAGUAIA",0,0,0,74,37,111,"2014"
"27557","510190 BRASNORTE",0,0,5,235,5,245,"2014"
"27558","510250 CACERES",2,7,14,1517,0,1540,"2014"
"27559","510260 CAMPINAPOLIS",1,1,4,133,145,284,"2014"
"27560","510263 CAMPO NOVO DO PARECIS",0,3,10,601,0,614,"2014"
"27561","510267 CAMPO VERDE",1,2,10,728,2,743,"2014"
"27562","510268 CAMPOS DE JULIO",0,0,4,130,0,134,"2014"
"27563","510269 CANABRAVA DO NORTE",0,0,1,47,0,48,"2014"
"27564","510270 CANARANA",2,3,9,388,38,440,"2014"
"27565","510279 CARLINDA",0,0,2,137,0,139,"2014"
"27566","510285 CASTANHEIRA",0,0,0,113,0,113,"2014"
"27567","510300 CHAPADA DOS GUIMARAES",1,1,2,252,2,258,"2014"
"27568","510305 CLAUDIA",0,0,1,145,0,146,"2014"
"27569","510310 COCALINHO",0,0,0,91,1,92,"2014"
"27570","510320 COLIDER",1,0,9,524,0,534,"2014"
"27571","510325 COLNIZA",4,2,5,439,1,451,"2014"
"27572","510330 COMODORO",0,0,4,349,5,358,"2014"
"27573","510335 CONFRESA",1,0,2,418,4,425,"2014"
"27574","510336 CONQUISTA D'OESTE",0,0,0,49,1,50,"2014"
"27575","510337 COTRIGUACU",0,1,0,186,1,188,"2014"
"27576","510340 CUIABA",41,43,133,10471,11,10699,"2014"
"27577","510343 CURVELANDIA",0,0,1,60,0,61,"2014"
"27578","510345 DENISE",1,0,2,93,0,96,"2014"
"27579","510350 DIAMANTINO",0,0,2,323,0,325,"2014"
"27580","510360 DOM AQUINO",0,0,1,81,0,82,"2014"
"27581","510370 FELIZ NATAL",0,0,3,155,6,164,"2014"
"27582","510380 FIGUEIROPOLIS D'OESTE",1,1,1,42,0,45,"2014"
"27583","510385 GAUCHA DO NORTE",1,2,1,120,17,141,"2014"
"27584","510390 GENERAL CARNEIRO",0,0,1,104,6,111,"2014"
"27585","510395 GLORIA D'OESTE",0,0,0,29,0,29,"2014"
"27586","510410 GUARANTA DO NORTE",1,0,10,543,2,556,"2014"
"27587","510420 GUIRATINGA",0,0,0,111,1,112,"2014"
"27588","510450 INDIAVAI",0,2,0,37,0,39,"2014"
"27589","510452 IPIRANGA DO NORTE",1,0,2,101,0,104,"2014"
"27590","510454 ITANHANGA",0,1,0,106,0,107,"2014"
"27591","510455 ITAUBA",0,0,0,62,0,62,"2014"
"27592","510460 ITIQUIRA",1,0,3,168,0,172,"2014"
"27593","510480 JACIARA",0,2,1,491,1,495,"2014"
"27594","510490 JANGADA",2,0,0,96,1,99,"2014"
"27595","510500 JAURU",0,0,1,117,1,119,"2014"
"27596","510510 JUARA",2,0,1,586,6,595,"2014"
"27597","510515 JUINA",1,1,16,669,1,688,"2014"
"27598","510517 JURUENA",0,0,3,183,0,186,"2014"
"27599","510520 JUSCIMEIRA",1,0,1,159,0,161,"2014"
"27600","510523 LAMBARI D'OESTE",0,0,1,53,0,54,"2014"
"27601","510525 LUCAS DO RIO VERDE",5,5,23,1195,0,1228,"2014"
"27602","510530 LUCIARA",1,0,0,21,0,22,"2014"
"27603","510550 VILA BELA DA SANTISSIMA TRINDADE",0,3,3,253,2,261,"2014"
"27604","510558 MARCELANDIA",1,1,14,170,7,193,"2014"
"27605","510560 MATUPA",0,1,4,276,0,281,"2014"
"27606","510562 MIRASSOL D'OESTE",0,2,3,422,0,427,"2014"
"27607","510590 NOBRES",0,1,9,236,2,248,"2014"
"27608","510600 NORTELANDIA",0,2,0,103,2,107,"2014"
"27609","510610 NOSSA SENHORA DO LIVRAMENTO",0,0,1,121,1,123,"2014"
"27610","510615 NOVA BANDEIRANTES",1,2,1,152,0,156,"2014"
"27611","510617 NOVA NAZARE",0,0,0,37,0,37,"2014"
"27612","510618 NOVA LACERDA",1,0,0,72,0,73,"2014"
"27613","510619 NOVA SANTA HELENA",0,0,2,50,0,52,"2014"
"27614","510620 NOVA BRASILANDIA",1,1,1,45,0,48,"2014"
"27615","510621 NOVA CANAA DO NORTE",0,0,5,170,0,175,"2014"
"27616","510622 NOVA MUTUM",1,4,15,743,0,763,"2014"
"27617","510623 NOVA OLIMPIA",2,2,2,280,0,286,"2014"
"27618","510624 NOVA UBIRATA",0,1,0,131,0,132,"2014"
"27619","510625 NOVA XAVANTINA",0,0,7,340,1,348,"2014"
"27620","510626 NOVO MUNDO",0,0,2,84,0,86,"2014"
"27621","510627 NOVO HORIZONTE DO NORTE",0,0,0,59,0,59,"2014"
"27622","510628 NOVO SAO JOAQUIM",0,0,3,96,1,100,"2014"
"27623","510629 PARANAITA",1,1,1,158,0,161,"2014"
"27624","510630 PARANATINGA",0,1,5,413,1,420,"2014"
"27625","510631 NOVO SANTO ANTONIO",0,0,0,11,0,11,"2014"
"27626","510637 PEDRA PRETA",2,0,1,264,0,267,"2014"
"27627","510642 PEIXOTO DE AZEVEDO",2,3,18,586,0,609,"2014"
"27628","510645 PLANALTO DA SERRA",0,1,0,29,0,30,"2014"
"27629","510650 POCONE",2,3,7,513,1,526,"2014"
"27630","510665 PONTAL DO ARAGUAIA",0,0,0,69,0,69,"2014"
"27631","510670 PONTE BRANCA",0,1,1,16,0,18,"2014"
"27632","510675 PONTES E LACERDA",3,6,12,812,2,835,"2014"
"27633","510677 PORTO ALEGRE DO NORTE",1,0,0,121,0,122,"2014"
"27634","510680 PORTO DOS GAUCHOS",0,1,0,88,0,89,"2014"
"27635","510682 PORTO ESPERIDIAO",0,0,1,179,0,180,"2014"
"27636","510685 PORTO ESTRELA",2,0,0,32,0,34,"2014"
"27637","510700 POXOREO",0,0,1,242,9,252,"2014"
"27638","510704 PRIMAVERA DO LESTE",4,8,22,1246,1,1281,"2014"
"27639","510706 QUERENCIA",0,0,3,322,16,341,"2014"
"27640","510710 SAO JOSE DOS QUATRO MARCOS",0,0,0,262,0,262,"2014"
"27641","510715 RESERVA DO CABACAL",0,0,0,35,0,35,"2014"
"27642","510718 RIBEIRAO CASCALHEIRA",0,0,1,151,36,188,"2014"
"27643","510719 RIBEIRAOZINHO",0,0,1,24,0,25,"2014"
"27644","510720 RIO BRANCO",0,1,1,66,0,68,"2014"
"27645","510724 SANTA CARMEM",0,0,2,58,0,60,"2014"
"27646","510726 SANTO AFONSO",0,0,3,24,1,28,"2014"
"27647","510729 SAO JOSE DO POVO",0,1,0,14,0,15,"2014"
"27648","510730 SAO JOSE DO RIO CLARO",1,0,1,290,0,292,"2014"
"27649","510735 SAO JOSE DO XINGU",0,0,1,95,0,96,"2014"
"27650","510740 SAO PEDRO DA CIPA",0,0,1,74,0,75,"2014"
"27651","510757 RONDOLANDIA",0,0,0,35,0,35,"2014"
"27652","510760 RONDONOPOLIS",20,19,53,3938,7,4037,"2014"
"27653","510770 ROSARIO OESTE",0,0,4,184,1,189,"2014"
"27654","510774 SANTA CRUZ DO XINGU",0,0,0,23,0,23,"2014"
"27655","510775 SALTO DO CEU",0,0,0,54,0,54,"2014"
"27656","510776 SANTA RITA DO TRIVELATO",0,0,1,37,0,38,"2014"
"27657","510777 SANTA TEREZINHA",0,0,0,115,5,120,"2014"
"27658","510779 SANTO ANTONIO DO LESTE",0,0,1,48,4,53,"2014"
"27659","510780 SANTO ANTONIO DO LEVERGER",3,0,4,224,0,231,"2014"
"27660","510785 SAO FELIX DO ARAGUAIA",0,0,0,104,5,109,"2014"
"27661","510787 SAPEZAL",0,0,5,435,1,441,"2014"
"27662","510788 SERRA NOVA DOURADA",0,0,0,20,0,20,"2014"
"27663","510790 SINOP",2,3,16,2723,8,2752,"2014"
"27664","510792 SORRISO",6,4,17,1680,2,1709,"2014"
"27665","510794 TABAPORA",0,0,6,134,1,141,"2014"
"27666","510795 TANGARA DA SERRA",4,3,30,1459,5,1501,"2014"
"27667","510800 TAPURAH",1,3,4,190,0,198,"2014"
"27668","510805 TERRA NOVA DO NORTE",0,0,2,141,0,143,"2014"
"27669","510810 TESOURO",0,1,0,24,0,25,"2014"
"27670","510820 TORIXOREU",0,0,1,41,0,42,"2014"
"27671","510830 UNIAO DO SUL",0,0,2,60,1,63,"2014"
"27672","510835 VALE DE SAO DOMINGOS",0,0,0,34,0,34,"2014"
"27673","510840 VARZEA GRANDE",21,24,66,5114,15,5240,"2014"
"27674","510850 VERA",0,1,1,152,0,154,"2014"
"27675","510860 VILA RICA",0,1,2,263,2,268,"2014"
"27676","510880 NOVA GUARITA",1,0,2,65,0,68,"2014"
"27677","510885 NOVA MARILANDIA",0,0,1,53,0,54,"2014"
"27678","510890 NOVA MARINGA",0,0,1,101,0,102,"2014"
"27679","510895 NOVA MONTE VERDE",1,0,2,111,0,114,"2014"
"27680","MUNICIPIO IGNORADO - GO",0,0,0,11,0,11,"2014"
"27681","520005 ABADIA DE GOIAS",0,1,1,150,1,153,"2014"
"27682","520010 ABADIANIA",1,0,3,201,1,206,"2014"
"27683","520013 ACREUNA",5,1,80,207,0,293,"2014"
"27684","520015 ADELANDIA",0,0,0,21,0,21,"2014"
"27685","520017 AGUA FRIA DE GOIAS",0,3,0,51,1,55,"2014"
"27686","520020 AGUA LIMPA",0,0,0,23,0,23,"2014"
"27687","520025 AGUAS LINDAS DE GOIAS",10,18,71,2703,229,3031,"2014"
"27688","520030 ALEXANIA",2,0,5,389,4,400,"2014"
"27689","520050 ALOANDIA",0,1,0,29,2,32,"2014"
"27690","520055 ALTO HORIZONTE",1,1,4,89,0,95,"2014"
"27691","520060 ALTO PARAISO DE GOIAS",1,2,3,82,2,90,"2014"
"27692","520080 ALVORADA DO NORTE",0,1,3,129,1,134,"2014"
"27693","520082 AMARALINA",0,0,0,22,0,22,"2014"
"27694","520085 AMERICANO DO BRASIL",0,0,0,79,1,80,"2014"
"27695","520090 AMORINOPOLIS",0,0,3,38,0,41,"2014"
"27696","520110 ANAPOLIS",10,26,91,5986,20,6133,"2014"
"27697","520120 ANHANGUERA",0,0,0,8,0,8,"2014"
"27698","520130 ANICUNS",2,1,7,207,0,217,"2014"
"27699","520140 APARECIDA DE GOIANIA",11,24,88,8108,24,8255,"2014"
"27700","520145 APARECIDA DO RIO DOCE",0,0,0,39,1,40,"2014"
"27701","520150 APORE",0,0,0,71,0,71,"2014"
"27702","520160 ARACU",0,0,1,45,0,46,"2014"
"27703","520170 ARAGARCAS",1,3,8,295,1,308,"2014"
"27704","520180 ARAGOIANIA",0,1,2,110,0,113,"2014"
"27705","520215 ARAGUAPAZ",0,0,1,45,1,47,"2014"
"27706","520235 ARENOPOLIS",0,1,0,42,0,43,"2014"
"27707","520250 ARUANA",0,0,1,141,0,142,"2014"
"27708","520260 AURILANDIA",0,0,0,35,0,35,"2014"
"27709","520280 AVELINOPOLIS",0,0,0,19,0,19,"2014"
"27710","520310 BALIZA",0,0,0,25,0,25,"2014"
"27711","520320 BARRO ALTO",1,0,2,117,1,121,"2014"
"27712","520330 BELA VISTA DE GOIAS",1,2,2,358,2,365,"2014"
"27713","520340 BOM JARDIM DE GOIAS",0,0,3,68,1,72,"2014"
"27714","520350 BOM JESUS DE GOIAS",0,1,4,329,2,336,"2014"
"27715","520355 BONFINOPOLIS",0,1,1,111,0,113,"2014"
"27716","520357 BONOPOLIS",1,0,0,38,0,39,"2014"
"27717","520360 BRAZABRANTES",0,0,1,44,0,45,"2014"
"27718","520380 BRITANIA",0,0,2,63,2,67,"2014"
"27719","520390 BURITI ALEGRE",0,0,1,105,1,107,"2014"
"27720","520393 BURITI DE GOIAS",0,0,2,33,0,35,"2014"
"27721","520396 BURITINOPOLIS",0,0,0,27,0,27,"2014"
"27722","520400 CABECEIRAS",1,1,3,114,0,119,"2014"
"27723","520410 CACHOEIRA ALTA",0,0,1,131,0,132,"2014"
"27724","520420 CACHOEIRA DE GOIAS",0,0,1,12,0,13,"2014"
"27725","520425 CACHOEIRA DOURADA",0,1,3,131,3,138,"2014"
"27726","520430 CACU",0,1,2,166,0,169,"2014"
"27727","520440 CAIAPONIA",0,0,15,171,0,186,"2014"
"27728","520450 CALDAS NOVAS",1,7,16,1278,1,1303,"2014"
"27729","520455 CALDAZINHA",0,0,1,48,0,49,"2014"
"27730","520460 CAMPESTRE DE GOIAS",0,0,0,50,0,50,"2014"
"27731","520465 CAMPINACU",0,0,1,42,0,43,"2014"
"27732","520470 CAMPINORTE",0,1,7,153,1,162,"2014"
"27733","520480 CAMPO ALEGRE DE GOIAS",0,0,0,61,1,62,"2014"
"27734","520485 CAMPO LIMPO DE GOIAS",0,1,2,107,1,111,"2014"
"27735","520490 CAMPOS BELOS",1,0,7,334,1,343,"2014"
"27736","520495 CAMPOS VERDES",0,0,0,54,0,54,"2014"
"27737","520500 CARMO DO RIO VERDE",0,0,2,129,0,131,"2014"
"27738","520505 CASTELANDIA",1,0,0,27,0,28,"2014"
"27739","520510 CATALAO",3,1,12,1426,3,1445,"2014"
"27740","520520 CATURAI",0,0,0,52,1,53,"2014"
"27741","520530 CAVALCANTE",0,2,1,119,1,123,"2014"
"27742","520540 CERES",0,0,5,276,0,281,"2014"
"27743","520545 CEZARINA",1,0,4,119,0,124,"2014"
"27744","520547 CHAPADAO DO CEU",0,1,2,164,0,167,"2014"
"27745","520549 CIDADE OCIDENTAL",7,4,14,1144,16,1185,"2014"
"27746","520551 COCALZINHO DE GOIAS",0,2,6,204,16,228,"2014"
"27747","520552 COLINAS DO SUL",0,0,1,35,2,38,"2014"
"27748","520570 CORREGO DO OURO",0,0,0,34,0,34,"2014"
"27749","520580 CORUMBA DE GOIAS",1,0,3,97,3,104,"2014"
"27750","520590 CORUMBAIBA",1,1,0,100,0,102,"2014"
"27751","520620 CRISTALINA",1,2,12,829,4,848,"2014"
"27752","520630 CRISTIANOPOLIS",0,0,0,38,0,38,"2014"
"27753","520640 CRIXAS",1,3,4,232,0,240,"2014"
"27754","520650 CROMINIA",0,0,0,35,1,36,"2014"
"27755","520660 CUMARI",0,0,0,37,0,37,"2014"
"27756","520670 DAMIANOPOLIS",0,0,0,52,0,52,"2014"
"27757","520680 DAMOLANDIA",0,0,2,23,0,25,"2014"
"27758","520690 DAVINOPOLIS",0,0,0,11,0,11,"2014"
"27759","520710 DIORAMA",0,0,0,29,0,29,"2014"
"27760","520725 DOVERLANDIA",0,0,3,95,0,98,"2014"
"27761","520735 EDEALINA",0,0,0,39,0,39,"2014"
"27762","520740 EDEIA",0,0,1,123,0,124,"2014"
"27763","520750 ESTRELA DO NORTE",0,0,2,43,0,45,"2014"
"27764","520753 FAINA",0,0,3,58,0,61,"2014"
"27765","520760 FAZENDA NOVA",0,0,1,48,0,49,"2014"
"27766","520780 FIRMINOPOLIS",0,0,2,91,0,93,"2014"
"27767","520790 FLORES DE GOIAS",0,3,0,89,0,92,"2014"
"27768","520800 FORMOSA",10,6,15,1742,3,1776,"2014"
"27769","520810 FORMOSO",0,0,1,55,0,56,"2014"
"27770","520815 GAMELEIRA DE GOIAS",0,0,0,34,1,35,"2014"
"27771","520830 DIVINOPOLIS DE GOIAS",0,0,1,86,1,88,"2014"
"27772","520840 GOIANAPOLIS",0,2,3,165,1,171,"2014"
"27773","520850 GOIANDIRA",0,0,0,38,0,38,"2014"
"27774","520860 GOIANESIA",1,2,30,901,2,936,"2014"
"27775","520870 GOIANIA",67,80,259,22455,110,22971,"2014"
"27776","520880 GOIANIRA",2,2,15,723,4,746,"2014"
"27777","520890 GOIAS",0,2,7,301,2,312,"2014"
"27778","520910 GOIATUBA",2,0,8,415,1,426,"2014"
"27779","520915 GOUVELANDIA",1,1,1,67,0,70,"2014"
"27780","520920 GUAPO",1,1,3,188,0,193,"2014"
"27781","520929 GUARAITA",0,0,0,18,0,18,"2014"
"27782","520940 GUARANI DE GOIAS",0,1,1,50,0,52,"2014"
"27783","520945 GUARINOS",1,0,0,25,0,26,"2014"
"27784","520960 HEITORAI",0,0,0,36,0,36,"2014"
"27785","520970 HIDROLANDIA",1,2,1,306,0,310,"2014"
"27786","520980 HIDROLINA",0,1,1,37,0,39,"2014"
"27787","520990 IACIARA",0,1,3,183,0,187,"2014"
"27788","520993 INACIOLANDIA",0,0,0,78,0,78,"2014"
"27789","520995 INDIARA",0,1,7,242,0,250,"2014"
"27790","521000 INHUMAS",1,3,18,678,1,701,"2014"
"27791","521010 IPAMERI",2,2,3,307,0,314,"2014"
"27792","521015 IPIRANGA DE GOIAS",0,0,1,28,0,29,"2014"
"27793","521020 IPORA",1,1,3,397,1,403,"2014"
"27794","521030 ISRAELANDIA",0,0,0,25,0,25,"2014"
"27795","521040 ITABERAI",1,2,6,515,0,524,"2014"
"27796","521056 ITAGUARI",0,0,1,48,0,49,"2014"
"27797","521060 ITAGUARU",0,1,0,50,1,52,"2014"
"27798","521080 ITAJA",0,0,0,66,0,66,"2014"
"27799","521090 ITAPACI",0,0,7,313,0,320,"2014"
"27800","521100 ITAPIRAPUA",0,0,0,86,0,86,"2014"
"27801","521120 ITAPURANGA",1,1,4,329,0,335,"2014"
"27802","521130 ITARUMA",0,0,0,105,0,105,"2014"
"27803","521140 ITAUCU",0,1,3,79,0,83,"2014"
"27804","521150 ITUMBIARA",1,3,16,1420,4,1444,"2014"
"27805","521160 IVOLANDIA",2,0,0,23,0,25,"2014"
"27806","521170 JANDAIA",0,1,2,61,0,64,"2014"
"27807","521180 JARAGUA",2,5,10,653,5,675,"2014"
"27808","521190 JATAI",6,4,38,1448,0,1496,"2014"
"27809","521200 JAUPACI",0,0,0,35,0,35,"2014"
"27810","521205 JESUPOLIS",0,0,0,24,0,24,"2014"
"27811","521210 JOVIANIA",0,0,0,82,0,82,"2014"
"27812","521220 JUSSARA",0,1,5,260,4,270,"2014"
"27813","521225 LAGOA SANTA",0,0,0,18,0,18,"2014"
"27814","521230 LEOPOLDO DE BULHOES",0,0,0,102,0,102,"2014"
"27815","521250 LUZIANIA",8,18,53,2919,42,3040,"2014"
"27816","521260 MAIRIPOTABA",0,0,0,25,0,25,"2014"
"27817","521270 MAMBAI",0,0,1,112,0,113,"2014"
"27818","521280 MARA ROSA",0,0,2,127,1,130,"2014"
"27819","521290 MARZAGAO",0,0,0,30,0,30,"2014"
"27820","521295 MATRINCHA",0,0,1,47,0,48,"2014"
"27821","521300 MAURILANDIA",0,0,4,194,0,198,"2014"
"27822","521305 MIMOSO DE GOIAS",0,1,0,16,3,20,"2014"
"27823","521308 MINACU",0,1,11,437,0,449,"2014"
"27824","521310 MINEIROS",7,2,8,1100,1,1118,"2014"
"27825","521340 MOIPORA",0,0,0,16,0,16,"2014"
"27826","521350 MONTE ALEGRE DE GOIAS",0,1,3,117,3,124,"2014"
"27827","521370 MONTES CLAROS DE GOIAS",0,0,2,93,0,95,"2014"
"27828","521375 MONTIVIDIU",1,3,9,183,0,196,"2014"
"27829","521377 MONTIVIDIU DO NORTE",0,1,0,30,0,31,"2014"
"27830","521380 MORRINHOS",7,3,5,630,3,648,"2014"
"27831","521385 MORRO AGUDO DE GOIAS",0,0,0,24,0,24,"2014"
"27832","521390 MOSSAMEDES",0,0,1,44,0,45,"2014"
"27833","521400 MOZARLANDIA",0,0,2,191,0,193,"2014"
"27834","521405 MUNDO NOVO",0,0,0,72,1,73,"2014"
"27835","521410 MUTUNOPOLIS",0,0,0,54,0,54,"2014"
"27836","521440 NAZARIO",0,0,1,94,0,95,"2014"
"27837","521450 NEROPOLIS",0,1,9,446,0,456,"2014"
"27838","521460 NIQUELANDIA",2,4,8,503,1,518,"2014"
"27839","521470 NOVA AMERICA",0,0,1,26,0,27,"2014"
"27840","521480 NOVA AURORA",0,0,0,17,0,17,"2014"
"27841","521483 NOVA CRIXAS",5,0,3,148,0,156,"2014"
"27842","521486 NOVA GLORIA",0,1,2,90,0,93,"2014"
"27843","521487 NOVA IGUACU DE GOIAS",0,1,2,34,0,37,"2014"
"27844","521490 NOVA ROMA",0,0,0,15,0,15,"2014"
"27845","521500 NOVA VENEZA",1,1,2,99,0,103,"2014"
"27846","521520 NOVO BRASIL",0,0,0,47,2,49,"2014"
"27847","521523 NOVO GAMA",6,3,30,1548,24,1611,"2014"
"27848","521525 NOVO PLANALTO",0,0,1,32,0,33,"2014"
"27849","521530 ORIZONA",0,0,0,171,0,171,"2014"
"27850","521540 OURO VERDE DE GOIAS",1,0,0,58,1,60,"2014"
"27851","521550 OUVIDOR",0,0,0,68,0,68,"2014"
"27852","521560 PADRE BERNARDO",3,0,11,320,114,448,"2014"
"27853","521565 PALESTINA DE GOIAS",0,0,0,44,0,44,"2014"
"27854","521570 PALMEIRAS DE GOIAS",0,1,3,369,0,373,"2014"
"27855","521580 PALMELO",0,0,1,12,0,13,"2014"
"27856","521590 PALMINOPOLIS",0,0,1,43,0,44,"2014"
"27857","521600 PANAMA",0,0,1,39,0,40,"2014"
"27858","521630 PARANAIGUARA",0,0,3,121,0,124,"2014"
"27859","521640 PARAUNA",0,0,4,142,0,146,"2014"
"27860","521645 PEROLANDIA",1,0,0,45,0,46,"2014"
"27861","521680 PETROLINA DE GOIAS",0,0,1,84,0,85,"2014"
"27862","521690 PILAR DE GOIAS",1,0,0,37,0,38,"2014"
"27863","521710 PIRACANJUBA",0,0,3,223,1,227,"2014"
"27864","521720 PIRANHAS",1,0,2,132,1,136,"2014"
"27865","521730 PIRENOPOLIS",2,1,4,268,1,276,"2014"
"27866","521740 PIRES DO RIO",2,2,3,348,0,355,"2014"
"27867","521760 PLANALTINA",7,8,26,1516,9,1566,"2014"
"27868","521770 PONTALINA",0,0,2,204,0,206,"2014"
"27869","521800 PORANGATU",1,4,11,595,1,612,"2014"
"27870","521805 PORTEIRAO",0,0,0,38,0,38,"2014"
"27871","521810 PORTELANDIA",0,1,1,63,0,65,"2014"
"27872","521830 POSSE",4,3,24,619,4,654,"2014"
"27873","521839 PROFESSOR JAMIL",0,0,0,28,0,28,"2014"
"27874","521850 QUIRINOPOLIS",0,0,5,697,0,702,"2014"
"27875","521860 RIALMA",0,0,2,148,0,150,"2014"
"27876","521870 RIANAPOLIS",0,0,1,66,0,67,"2014"
"27877","521878 RIO QUENTE",0,0,0,44,0,44,"2014"
"27878","521880 RIO VERDE",5,5,35,3452,0,3497,"2014"
"27879","521890 RUBIATABA",0,1,4,215,1,221,"2014"
"27880","521900 SANCLERLANDIA",0,1,0,77,0,78,"2014"
"27881","521910 SANTA BARBARA DE GOIAS",0,0,0,114,0,114,"2014"
"27882","521920 SANTA CRUZ DE GOIAS",0,0,1,25,0,26,"2014"
"27883","521925 SANTA FE DE GOIAS",0,0,2,78,0,80,"2014"
"27884","521930 SANTA HELENA DE GOIAS",0,3,5,567,2,577,"2014"
"27885","521935 SANTA ISABEL",0,0,3,30,0,33,"2014"
"27886","521940 SANTA RITA DO ARAGUAIA",0,2,1,93,0,96,"2014"
"27887","521945 SANTA RITA DO NOVO DESTINO",0,0,0,16,0,16,"2014"
"27888","521950 SANTA ROSA DE GOIAS",0,1,0,27,0,28,"2014"
"27889","521960 SANTA TEREZA DE GOIAS",0,0,0,49,0,49,"2014"
"27890","521970 SANTA TEREZINHA DE GOIAS",0,0,2,139,0,141,"2014"
"27891","521971 SANTO ANTONIO DA BARRA",1,0,2,45,0,48,"2014"
"27892","521973 SANTO ANTONIO DE GOIAS",1,0,2,101,2,106,"2014"
"27893","521975 SANTO ANTONIO DO DESCOBERTO",5,3,18,1120,10,1156,"2014"
"27894","521980 SAO DOMINGOS",0,1,2,108,0,111,"2014"
"27895","521990 SAO FRANCISCO DE GOIAS",1,0,2,71,1,75,"2014"
"27896","522000 SAO JOAO D'ALIANCA",0,0,2,109,1,112,"2014"
"27897","522005 SAO JOAO DA PARAUNA",0,0,0,21,0,21,"2014"
"27898","522010 SAO LUIS DE MONTES BELOS",0,1,3,363,0,367,"2014"
"27899","522015 SAO LUIZ DO NORTE",0,0,1,70,0,71,"2014"
"27900","522020 SAO MIGUEL DO ARAGUAIA",1,1,6,320,1,329,"2014"
"27901","522026 SAO MIGUEL DO PASSA QUATRO",0,0,0,36,0,36,"2014"
"27902","522028 SAO PATRICIO",0,0,0,25,0,25,"2014"
"27903","522040 SAO SIMAO",0,2,4,274,0,280,"2014"
"27904","522045 SENADOR CANEDO",3,7,16,2186,3,2215,"2014"
"27905","522050 SERRANOPOLIS",0,0,3,86,0,89,"2014"
"27906","522060 SILVANIA",0,2,2,236,1,241,"2014"
"27907","522068 SIMOLANDIA",0,0,0,93,0,93,"2014"
"27908","522070 SITIO D'ABADIA",0,0,0,22,0,22,"2014"
"27909","522100 TAQUARAL DE GOIAS",0,0,1,37,0,38,"2014"
"27910","522108 TERESINA DE GOIAS",0,0,1,35,0,36,"2014"
"27911","522119 TEREZOPOLIS DE GOIAS",0,1,1,91,1,94,"2014"
"27912","522130 TRES RANCHOS",0,0,0,38,0,38,"2014"
"27913","522140 TRINDADE",7,5,22,1771,12,1817,"2014"
"27914","522145 TROMBAS",0,0,0,25,0,25,"2014"
"27915","522150 TURVANIA",0,1,0,58,0,59,"2014"
"27916","522155 TURVELANDIA",0,0,1,74,0,75,"2014"
"27917","522157 UIRAPURU",0,0,0,37,0,37,"2014"
"27918","522160 URUACU",2,6,65,517,0,590,"2014"
"27919","522170 URUANA",0,4,4,121,0,129,"2014"
"27920","522180 URUTAI",0,0,0,26,0,26,"2014"
"27921","522185 VALPARAISO DE GOIAS",7,8,39,2645,35,2734,"2014"
"27922","522190 VARJAO",0,0,1,48,0,49,"2014"
"27923","522200 VIANOPOLIS",0,0,1,183,1,185,"2014"
"27924","522205 VICENTINOPOLIS",1,0,2,125,0,128,"2014"
"27925","522220 VILA BOA",0,0,0,70,0,70,"2014"
"27926","522230 VILA PROPICIO",0,0,6,50,2,58,"2014"
"27927","530010 BRASILIA",186,159,709,43079,588,44721,"2014"
"27928","TOTAL",7882,12506,47518,2870425,79337,3017668,"2015"
"27929","MUNICIPIO IGNORADO - RO",0,0,0,4,0,4,"2015"
"27930","110001 ALTA FLORESTA D'OESTE",2,1,4,365,1,373,"2015"
"27931","110002 ARIQUEMES",3,3,10,1765,2,1783,"2015"
"27932","110003 CABIXI",0,0,3,83,0,86,"2015"
"27933","110004 CACOAL",0,2,12,1340,6,1360,"2015"
"27934","110005 CEREJEIRAS",1,0,4,271,1,277,"2015"
"27935","110006 COLORADO DO OESTE",0,0,1,250,0,251,"2015"
"27936","110007 CORUMBIARA",0,0,0,111,0,111,"2015"
"27937","110008 COSTA MARQUES",0,5,8,231,1,245,"2015"
"27938","110009 ESPIGAO D'OESTE",1,1,11,533,2,548,"2015"
"27939","110010 GUAJARA-MIRIM",2,3,15,787,24,831,"2015"
"27940","110011 JARU",1,0,6,780,1,788,"2015"
"27941","110012 JI-PARANA",3,3,24,2061,3,2094,"2015"
"27942","110013 MACHADINHO D'OESTE",0,2,6,469,3,480,"2015"
"27943","110014 NOVA BRASILANDIA D'OESTE",0,1,12,243,0,256,"2015"
"27944","110015 OURO PRETO DO OESTE",0,0,23,743,1,767,"2015"
"27945","110018 PIMENTA BUENO",4,0,18,572,0,594,"2015"
"27946","110020 PORTO VELHO",10,23,101,8858,101,9093,"2015"
"27947","110025 PRESIDENTE MEDICI",0,3,4,255,0,262,"2015"
"27948","110026 RIO CRESPO",0,0,0,36,0,36,"2015"
"27949","110028 ROLIM DE MOURA",2,2,14,917,1,936,"2015"
"27950","110029 SANTA LUZIA D'OESTE",0,0,1,108,0,109,"2015"
"27951","110030 VILHENA",5,3,13,1509,5,1535,"2015"
"27952","110032 SAO MIGUEL DO GUAPORE",0,3,6,302,0,311,"2015"
"27953","110033 NOVA MAMORE",0,0,5,389,10,404,"2015"
"27954","110034 ALVORADA D'OESTE",0,0,3,196,1,200,"2015"
"27955","110037 ALTO ALEGRE DOS PARECIS",0,0,0,147,2,149,"2015"
"27956","110040 ALTO PARAISO",0,0,1,245,1,247,"2015"
"27957","110045 BURITIS",3,2,6,595,2,608,"2015"
"27958","110050 NOVO HORIZONTE DO OESTE",0,0,1,108,0,109,"2015"
"27959","110060 CACAULANDIA",0,0,1,71,0,72,"2015"
"27960","110070 CAMPO NOVO DE RONDONIA",0,0,0,155,1,156,"2015"
"27961","110080 CANDEIAS DO JAMARI",0,1,6,308,8,323,"2015"
"27962","110090 CASTANHEIRAS",0,1,1,50,0,52,"2015"
"27963","110092 CHUPINGUAIA",0,0,5,149,0,154,"2015"
"27964","110094 CUJUBIM",0,0,0,271,3,274,"2015"
"27965","110100 GOVERNADOR JORGE TEIXEIRA",0,0,1,130,1,132,"2015"
"27966","110110 ITAPUA DO OESTE",0,0,0,105,7,112,"2015"
"27967","110120 MINISTRO ANDREAZZA",1,0,2,90,0,93,"2015"
"27968","110130 MIRANTE DA SERRA",0,0,5,172,2,179,"2015"
"27969","110140 MONTE NEGRO",1,4,3,231,1,240,"2015"
"27970","110143 NOVA UNIAO",0,0,2,70,1,73,"2015"
"27971","110145 PARECIS",0,0,0,53,1,54,"2015"
"27972","110146 PIMENTEIRAS DO OESTE",0,0,0,51,1,52,"2015"
"27973","110147 PRIMAVERA DE RONDONIA",0,0,0,40,0,40,"2015"
"27974","110148 SAO FELIPE D'OESTE",0,0,1,72,0,73,"2015"
"27975","110149 SAO FRANCISCO DO GUAPORE",0,2,13,304,0,319,"2015"
"27976","110150 SERINGUEIRAS",0,0,10,178,0,188,"2015"
"27977","110155 TEIXEIROPOLIS",0,1,2,68,0,71,"2015"
"27978","110160 THEOBROMA",0,0,0,107,0,107,"2015"
"27979","110170 URUPA",0,1,2,134,1,138,"2015"
"27980","110175 VALE DO ANARI",1,0,3,100,2,106,"2015"
"27981","110180 VALE DO PARAISO",1,0,1,61,0,63,"2015"
"27982","120001 ACRELANDIA",0,4,5,187,21,217,"2015"
"27983","120005 ASSIS BRASIL",0,1,2,204,31,238,"2015"
"27984","120010 BRASILEIA",2,2,8,500,19,531,"2015"
"27985","120013 BUJARI",0,1,2,234,11,248,"2015"
"27986","120017 CAPIXABA",0,0,2,203,14,219,"2015"
"27987","120020 CRUZEIRO DO SUL",5,6,18,1739,71,1839,"2015"
"27988","120025 EPITACIOLANDIA",0,1,2,268,8,279,"2015"
"27989","120030 FEIJO",2,2,6,644,118,772,"2015"
"27990","120032 JORDAO",1,1,2,121,148,273,"2015"
"27991","120033 MANCIO LIMA",0,0,2,375,18,395,"2015"
"27992","120034 MANOEL URBANO",0,0,5,249,12,266,"2015"
"27993","120035 MARECHAL THAUMATURGO",0,0,5,326,114,445,"2015"
"27994","120038 PLACIDO DE CASTRO",0,4,8,323,15,350,"2015"
"27995","120039 PORTO WALTER",0,2,6,228,26,262,"2015"
"27996","120040 RIO BRANCO",6,20,94,6400,445,6965,"2015"
"27997","120042 RODRIGUES ALVES",1,2,4,357,32,396,"2015"
"27998","120043 SANTA ROSA DO PURUS",0,1,0,92,57,150,"2015"
"27999","120045 SENADOR GUIOMARD",0,1,7,418,17,443,"2015"
"28000","120050 SENA MADUREIRA",0,3,7,789,48,847,"2015"
"28001","120060 TARAUACA",4,9,21,1023,108,1165,"2015"
"28002","120070 XAPURI",4,1,6,295,16,322,"2015"
"28003","120080 PORTO ACRE",1,0,9,332,16,358,"2015"
"28004","MUNICIPIO IGNORADO - AM",1,0,0,17,0,18,"2015"
"28005","130002 ALVARAES",1,2,8,329,2,342,"2015"
"28006","130006 AMATURA",0,2,4,175,33,214,"2015"
"28007","130008 ANAMA",0,0,2,156,5,163,"2015"
"28008","130010 ANORI",0,0,1,249,5,255,"2015"
"28009","130014 APUI",0,2,10,191,1,204,"2015"
"28010","130020 ATALAIA DO NORTE",0,3,6,259,171,439,"2015"
"28011","130030 AUTAZES",2,3,10,718,96,829,"2015"
"28012","130040 BARCELOS",2,2,2,295,204,505,"2015"
"28013","130050 BARREIRINHA",1,1,13,649,151,815,"2015"
"28014","130060 BENJAMIN CONSTANT",2,3,31,844,88,968,"2015"
"28015","130063 BERURI",1,0,3,399,86,489,"2015"
"28016","130068 BOA VISTA DO RAMOS",0,0,6,362,1,369,"2015"
"28017","130070 BOCA DO ACRE",1,3,6,671,14,695,"2015"
"28018","130080 BORBA",1,1,2,656,65,725,"2015"
"28019","130083 CAAPIRANGA",0,2,3,156,12,173,"2015"
"28020","130090 CANUTAMA",0,1,2,215,1,219,"2015"
"28021","130100 CARAUARI",2,0,2,364,260,628,"2015"
"28022","130110 CAREIRO",1,2,5,373,38,419,"2015"
"28023","130115 CAREIRO DA VARZEA",0,0,1,186,28,215,"2015"
"28024","130120 COARI",5,6,5,1727,1,1744,"2015"
"28025","130130 CODAJAS",1,1,2,425,5,434,"2015"
"28026","130140 EIRUNEPE",2,4,16,696,107,825,"2015"
"28027","130150 ENVIRA",0,2,4,365,41,412,"2015"
"28028","130160 FONTE BOA",5,1,5,658,1,670,"2015"
"28029","130165 GUAJARA",2,0,3,307,22,334,"2015"
"28030","130170 HUMAITA",1,1,16,920,3,941,"2015"
"28031","130180 IPIXUNA",2,0,0,313,126,441,"2015"
"28032","130185 IRANDUBA",4,2,8,847,6,867,"2015"
"28033","130190 ITACOATIARA",0,8,12,1991,67,2078,"2015"
"28034","130195 ITAMARATI",0,0,5,230,58,293,"2015"
"28035","130200 ITAPIRANGA",0,0,0,145,3,148,"2015"
"28036","130210 JAPURA",1,0,8,143,17,169,"2015"
"28037","130220 JURUA",0,1,1,194,21,217,"2015"
"28038","130230 JUTAI",0,1,3,485,144,633,"2015"
"28039","130240 LABREA",1,4,42,595,17,659,"2015"
"28040","130250 MANACAPURU",5,3,9,2044,9,2070,"2015"
"28041","130255 MANAQUIRI",4,2,1,225,2,234,"2015"
"28042","130260 MANAUS",133,155,366,41398,290,42342,"2015"
"28043","130270 MANICORE",2,6,12,752,158,930,"2015"
"28044","130280 MARAA",0,1,2,282,38,323,"2015"
"28045","130290 MAUES",7,6,17,1031,274,1335,"2015"
"28046","130300 NHAMUNDA",1,3,6,305,41,356,"2015"
"28047","130310 NOVA OLINDA DO NORTE",0,1,10,518,64,593,"2015"
"28048","130320 NOVO AIRAO",2,1,1,287,25,316,"2015"
"28049","130330 NOVO ARIPUANA",0,3,6,368,32,409,"2015"
"28050","130340 PARINTINS",5,5,24,1862,99,1995,"2015"
"28051","130350 PAUINI",0,1,1,370,2,374,"2015"
"28052","130353 PRESIDENTE FIGUEIREDO",2,0,4,547,5,558,"2015"
"28053","130356 RIO PRETO DA EVA",0,0,4,387,0,391,"2015"
"28054","130360 SANTA ISABEL DO RIO NEGRO",1,2,37,107,154,301,"2015"
"28055","130370 SANTO ANTONIO DO ICA",2,3,5,577,131,718,"2015"
"28056","130380 SAO GABRIEL DA CACHOEIRA",6,8,22,614,470,1120,"2015"
"28057","130390 SAO PAULO DE OLIVENCA",3,4,5,520,221,753,"2015"
"28058","130395 SAO SEBASTIAO DO UATUMA",0,0,4,176,0,180,"2015"
"28059","130400 SILVES",0,0,0,193,9,202,"2015"
"28060","130406 TABATINGA",0,6,17,1180,412,1615,"2015"
"28061","130410 TAPAUA",1,0,2,417,19,439,"2015"
"28062","130420 TEFE",9,3,15,1673,54,1754,"2015"
"28063","130423 TONANTINS",0,2,4,367,18,391,"2015"
"28064","130426 UARINI",0,3,20,259,13,295,"2015"
"28065","130430 URUCARA",2,2,14,250,4,272,"2015"
"28066","130440 URUCURITUBA",1,0,1,230,50,282,"2015"
"28067","MUNICIPIO IGNORADO - RR",0,0,0,3,0,3,"2015"
"28068","140002 AMAJARI",9,0,3,165,162,339,"2015"
"28069","140005 ALTO ALEGRE",5,0,1,176,368,550,"2015"
"28070","140010 BOA VISTA",65,15,78,6549,12,6719,"2015"
"28071","140015 BONFIM",7,3,0,271,74,355,"2015"
"28072","140017 CANTA",9,1,2,293,22,327,"2015"
"28073","140020 CARACARAI",5,2,3,345,59,414,"2015"
"28074","140023 CAROEBE",1,2,3,128,5,139,"2015"
"28075","140028 IRACEMA",0,0,0,124,45,169,"2015"
"28076","140030 MUCAJAI",1,2,7,300,31,341,"2015"
"28077","140040 NORMANDIA",5,1,1,332,103,442,"2015"
"28078","140045 PACARAIMA",9,1,4,284,63,361,"2015"
"28079","140047 RORAINOPOLIS",0,1,4,518,4,527,"2015"
"28080","140050 SAO JOAO DA BALIZA",2,0,0,112,3,117,"2015"
"28081","140060 SAO LUIZ",0,0,2,88,1,91,"2015"
"28082","140070 UIRAMUTA",16,1,3,282,216,518,"2015"
"28083","MUNICIPIO IGNORADO - PA",0,0,0,2,0,2,"2015"
"28084","150010 ABAETETUBA",6,8,40,2587,19,2660,"2015"
"28085","150013 ABEL FIGUEIREDO",0,0,1,142,0,143,"2015"
"28086","150020 ACARA",0,9,13,885,29,936,"2015"
"28087","150030 AFUA",3,7,15,838,8,871,"2015"
"28088","150034 AGUA AZUL DO NORTE",0,0,0,199,0,199,"2015"
"28089","150040 ALENQUER",8,5,5,1085,30,1133,"2015"
"28090","150050 ALMEIRIM",3,6,15,747,26,797,"2015"
"28091","150060 ALTAMIRA",16,12,51,2875,37,2991,"2015"
"28092","150070 ANAJAS",0,17,47,616,62,742,"2015"
"28093","150080 ANANINDEUA",9,20,105,8206,57,8397,"2015"
"28094","150085 ANAPU",1,3,5,587,4,600,"2015"
"28095","150090 AUGUSTO CORREA",2,4,22,822,104,954,"2015"
"28096","150095 AURORA DO PARA",1,4,10,424,1,440,"2015"
"28097","150100 AVEIRO",0,2,5,161,30,198,"2015"
"28098","150110 BAGRE",2,2,9,251,292,556,"2015"
"28099","150120 BAIAO",0,5,12,525,33,575,"2015"
"28100","150125 BANNACH",0,0,1,42,2,45,"2015"
"28101","150130 BARCARENA",1,13,27,2029,28,2098,"2015"
"28102","150140 BELEM",42,68,221,20801,118,21250,"2015"
"28103","150145 BELTERRA",1,3,20,247,2,273,"2015"
"28104","150150 BENEVIDES",0,5,17,978,8,1008,"2015"
"28105","150157 BOM JESUS DO TOCANTINS",0,0,2,251,0,253,"2015"
"28106","150160 BONITO",0,0,2,208,2,212,"2015"
"28107","150170 BRAGANCA",1,9,30,2081,71,2192,"2015"
"28108","150172 BRASIL NOVO",1,0,1,252,1,255,"2015"
"28109","150175 BREJO GRANDE DO ARAGUAIA",0,0,0,100,3,103,"2015"
"28110","150178 BREU BRANCO",2,5,15,689,121,832,"2015"
"28111","150180 BREVES",13,23,112,2429,11,2588,"2015"
"28112","150190 BUJARU",4,0,16,429,33,482,"2015"
"28113","150195 CACHOEIRA DO PIRIA",1,0,3,264,36,304,"2015"
"28114","150200 CACHOEIRA DO ARARI",6,3,6,303,1,319,"2015"
"28115","150210 CAMETA",5,12,63,2183,182,2445,"2015"
"28116","150215 CANAA DOS CARAJAS",1,4,18,1302,7,1332,"2015"
"28117","150220 CAPANEMA",3,1,6,1121,7,1138,"2015"
"28118","150230 CAPITAO POCO",16,0,6,829,8,859,"2015"
"28119","150240 CASTANHAL",8,13,27,3248,4,3300,"2015"
"28120","150250 CHAVES",2,0,2,315,36,355,"2015"
"28121","150260 COLARES",1,1,2,169,11,184,"2015"
"28122","150270 CONCEICAO DO ARAGUAIA",3,4,9,771,0,787,"2015"
"28123","150275 CONCORDIA DO PARA",3,9,13,507,4,536,"2015"
"28124","150276 CUMARU DO NORTE",1,0,2,127,8,138,"2015"
"28125","150277 CURIONOPOLIS",0,2,5,393,0,400,"2015"
"28126","150280 CURRALINHO",3,4,17,599,58,681,"2015"
"28127","150285 CURUA",0,1,6,150,51,208,"2015"
"28128","150290 CURUCA",0,1,3,509,13,526,"2015"
"28129","150293 DOM ELISEU",0,5,15,740,2,762,"2015"
"28130","150295 ELDORADO DOS CARAJAS",0,4,7,490,3,504,"2015"
"28131","150300 FARO",1,2,4,113,4,124,"2015"
"28132","150304 FLORESTA DO ARAGUAIA",0,0,0,325,2,327,"2015"
"28133","150307 GARRAFAO DO NORTE",9,1,2,390,29,431,"2015"
"28134","150309 GOIANESIA DO PARA",0,2,12,475,35,524,"2015"
"28135","150310 GURUPA",3,5,14,584,85,691,"2015"
"28136","150320 IGARAPE-ACU",0,0,3,560,4,567,"2015"
"28137","150330 IGARAPE-MIRI",3,4,37,1002,68,1114,"2015"
"28138","150340 INHANGAPI",1,3,0,172,1,177,"2015"
"28139","150345 IPIXUNA DO PARA",9,5,13,532,17,576,"2015"
"28140","150350 IRITUIA",0,0,4,434,24,462,"2015"
"28141","150360 ITAITUBA",5,11,55,1869,10,1950,"2015"
"28142","150370 ITUPIRANGA",3,2,6,867,21,899,"2015"
"28143","150375 JACAREACANGA",1,1,4,385,223,614,"2015"
"28144","150380 JACUNDA",1,5,16,847,13,882,"2015"
"28145","150390 JURUTI",5,9,37,926,86,1063,"2015"
"28146","150400 LIMOEIRO DO AJURU",1,7,23,379,35,445,"2015"
"28147","150405 MAE DO RIO",1,2,7,615,10,635,"2015"
"28148","150410 MAGALHAES BARATA",0,1,0,106,5,112,"2015"
"28149","150420 MARABA",12,17,52,5049,43,5173,"2015"
"28150","150430 MARACANA",0,1,6,404,16,427,"2015"
"28151","150440 MARAPANIM",0,0,3,319,8,330,"2015"
"28152","150442 MARITUBA",4,7,17,1825,10,1863,"2015"
"28153","150445 MEDICILANDIA",1,0,3,426,0,430,"2015"
"28154","150450 MELGACO",3,3,16,377,197,596,"2015"
"28155","150460 MOCAJUBA",1,1,5,471,4,482,"2015"
"28156","150470 MOJU",9,5,13,1166,56,1249,"2015"
"28157","150475 MOJUI DOS CAMPOS",1,2,3,137,7,150,"2015"
"28158","150480 MONTE ALEGRE",2,8,58,1083,0,1151,"2015"
"28159","150490 MUANA",2,4,8,587,0,601,"2015"
"28160","150495 NOVA ESPERANCA DO PIRIA",4,3,54,388,0,449,"2015"
"28161","150497 NOVA IPIXUNA",1,0,7,190,1,199,"2015"
"28162","150500 NOVA TIMBOTEUA",0,0,1,150,2,153,"2015"
"28163","150503 NOVO PROGRESSO",1,5,3,602,9,620,"2015"
"28164","150506 NOVO REPARTIMENTO",1,0,4,1315,14,1334,"2015"
"28165","150510 OBIDOS",0,7,16,835,125,983,"2015"
"28166","150520 OEIRAS DO PARA",7,1,15,646,62,731,"2015"
"28167","150530 ORIXIMINA",4,16,32,1290,55,1397,"2015"
"28168","150540 OUREM",4,2,4,292,20,322,"2015"
"28169","150543 OURILANDIA DO NORTE",0,0,2,636,0,638,"2015"
"28170","150548 PACAJA",3,4,7,657,15,686,"2015"
"28171","150549 PALESTINA DO PARA",1,0,0,99,6,106,"2015"
"28172","150550 PARAGOMINAS",2,10,21,1990,10,2033,"2015"
"28173","150553 PARAUAPEBAS",8,12,56,4934,9,5019,"2015"
"28174","150555 PAU D'ARCO",0,0,0,142,0,142,"2015"
"28175","150560 PEIXE-BOI",1,1,2,93,1,98,"2015"
"28176","150563 PICARRA",1,1,10,133,3,148,"2015"
"28177","150565 PLACAS",0,1,5,266,1,273,"2015"
"28178","150570 PONTA DE PEDRAS",1,0,5,336,3,345,"2015"
"28179","150580 PORTEL",4,3,18,1161,410,1596,"2015"
"28180","150590 PORTO DE MOZ",1,1,8,652,49,711,"2015"
"28181","150600 PRAINHA",3,4,11,550,98,666,"2015"
"28182","150610 PRIMAVERA",0,1,0,139,45,185,"2015"
"28183","150611 QUATIPURU",0,2,0,153,3,158,"2015"
"28184","150613 REDENCAO",7,7,9,1676,2,1701,"2015"
"28185","150616 RIO MARIA",0,3,6,302,0,311,"2015"
"28186","150618 RONDON DO PARA",2,3,24,696,4,729,"2015"
"28187","150619 RUROPOLIS",0,2,16,364,1,383,"2015"
"28188","150620 SALINOPOLIS",1,2,0,628,1,632,"2015"
"28189","150630 SALVATERRA",1,3,5,368,0,377,"2015"
"28190","150635 SANTA BARBARA DO PARA",1,1,2,280,1,285,"2015"
"28191","150640 SANTA CRUZ DO ARARI",0,0,2,85,16,103,"2015"
"28192","150650 SANTA IZABEL DO PARA",3,5,14,1018,4,1044,"2015"
"28193","150655 SANTA LUZIA DO PARA",0,1,9,331,4,345,"2015"
"28194","150658 SANTA MARIA DAS BARREIRAS",0,2,4,191,0,197,"2015"
"28195","150660 SANTA MARIA DO PARA",0,1,1,364,1,367,"2015"
"28196","150670 SANTANA DO ARAGUAIA",3,4,5,572,0,584,"2015"
"28197","150680 SANTAREM",14,54,203,6038,447,6756,"2015"
"28198","150690 SANTAREM NOVO",0,0,0,83,0,83,"2015"
"28199","150700 SANTO ANTONIO DO TAUA",0,2,2,494,11,509,"2015"
"28200","150710 SAO CAETANO DE ODIVELAS",1,2,3,220,7,233,"2015"
"28201","150715 SAO DOMINGOS DO ARAGUAIA",0,0,3,378,1,382,"2015"
"28202","150720 SAO DOMINGOS DO CAPIM",2,2,7,466,16,493,"2015"
"28203","150730 SAO FELIX DO XINGU",0,1,5,1002,6,1014,"2015"
"28204","150740 SAO FRANCISCO DO PARA",0,1,0,195,0,196,"2015"
"28205","150745 SAO GERALDO DO ARAGUAIA",2,5,4,484,2,497,"2015"
"28206","150746 SAO JOAO DA PONTA",0,0,0,77,6,83,"2015"
"28207","150747 SAO JOAO DE PIRABAS",2,2,4,324,3,335,"2015"
"28208","150750 SAO JOAO DO ARAGUAIA",0,1,4,218,3,226,"2015"
"28209","150760 SAO MIGUEL DO GUAMA",2,5,10,950,6,973,"2015"
"28210","150770 SAO SEBASTIAO DA BOA VISTA",0,8,26,516,3,553,"2015"
"28211","150775 SAPUCAIA",1,1,0,91,0,93,"2015"
"28212","150780 SENADOR JOSE PORFIRIO",0,1,4,292,5,302,"2015"
"28213","150790 SOURE",4,2,2,422,2,432,"2015"
"28214","150795 TAILANDIA",1,14,27,1636,10,1688,"2015"
"28215","150796 TERRA ALTA",0,0,3,202,2,207,"2015"
"28216","150797 TERRA SANTA",2,1,8,253,3,267,"2015"
"28217","150800 TOME-ACU",5,7,16,1424,18,1470,"2015"
"28218","150803 TRACUATEUA",0,5,6,544,10,565,"2015"
"28219","150805 TRAIRAO",0,2,3,203,1,209,"2015"
"28220","150808 TUCUMA",1,2,10,689,2,704,"2015"
"28221","150810 TUCURUI",3,4,26,1528,570,2131,"2015"
"28222","150812 ULIANOPOLIS",3,1,9,454,0,467,"2015"
"28223","150815 URUARA",6,6,16,793,3,824,"2015"
"28224","150820 VIGIA",1,2,12,750,7,772,"2015"
"28225","150830 VISEU",9,4,15,909,314,1251,"2015"
"28226","150835 VITORIA DO XINGU",3,0,7,341,2,353,"2015"
"28227","150840 XINGUARA",0,3,7,918,3,931,"2015"
"28228","MUNICIPIO IGNORADO - AP",0,0,0,3,0,3,"2015"
"28229","160005 SERRA DO NAVIO",1,0,2,58,2,63,"2015"
"28230","160010 AMAPA",2,1,1,149,8,161,"2015"
"28231","160015 PEDRA BRANCA DO AMAPARI",0,2,4,199,39,244,"2015"
"28232","160020 CALCOENE",1,0,3,190,4,198,"2015"
"28233","160021 CUTIAS",0,0,1,83,1,85,"2015"
"28234","160023 FERREIRA GOMES",1,2,0,187,2,192,"2015"
"28235","160025 ITAUBAL",0,0,0,91,18,109,"2015"
"28236","160027 LARANJAL DO JARI",5,8,27,883,0,923,"2015"
"28237","160030 MACAPA",41,23,92,9202,134,9492,"2015"
"28238","160040 MAZAGAO",4,0,4,408,50,466,"2015"
"28239","160050 OIAPOQUE",1,4,10,379,75,469,"2015"
"28240","160053 PORTO GRANDE",1,6,3,400,4,414,"2015"
"28241","160055 PRACUUBA",0,0,1,52,31,84,"2015"
"28242","160060 SANTANA",24,7,32,2200,4,2267,"2015"
"28243","160070 TARTARUGALZINHO",1,2,4,228,67,302,"2015"
"28244","160080 VITORIA DO JARI",0,1,10,264,3,278,"2015"
"28245","MUNICIPIO IGNORADO - TO",0,0,0,4,0,4,"2015"
"28246","170025 ABREULANDIA",0,0,1,29,0,30,"2015"
"28247","170030 AGUIARNOPOLIS",0,0,2,75,0,77,"2015"
"28248","170035 ALIANCA DO TOCANTINS",1,0,2,68,0,71,"2015"
"28249","170040 ALMAS",1,1,4,101,1,108,"2015"
"28250","170070 ALVORADA",2,0,2,118,0,122,"2015"
"28251","170100 ANANAS",1,3,1,170,0,175,"2015"
"28252","170105 ANGICO",0,0,2,42,1,45,"2015"
"28253","170110 APARECIDA DO RIO NEGRO",1,0,4,75,1,81,"2015"
"28254","170130 ARAGOMINAS",0,0,2,66,0,68,"2015"
"28255","170190 ARAGUACEMA",0,1,2,81,0,84,"2015"
"28256","170200 ARAGUACU",1,0,6,92,0,99,"2015"
"28257","170210 ARAGUAINA",6,7,58,3084,26,3181,"2015"
"28258","170215 ARAGUANA",0,0,1,91,0,92,"2015"
"28259","170220 ARAGUATINS",1,4,11,529,54,599,"2015"
"28260","170230 ARAPOEMA",0,0,1,91,3,95,"2015"
"28261","170240 ARRAIAS",1,1,3,171,0,176,"2015"
"28262","170255 AUGUSTINOPOLIS",2,0,8,286,33,329,"2015"
"28263","170270 AURORA DO TOCANTINS",1,0,0,30,0,31,"2015"
"28264","170290 AXIXA DO TOCANTINS",0,0,4,175,15,194,"2015"
"28265","170300 BABACULANDIA",0,1,4,92,3,100,"2015"
"28266","170305 BANDEIRANTES DO TOCANTINS",0,1,0,42,2,45,"2015"
"28267","170307 BARRA DO OURO",0,3,2,77,6,88,"2015"
"28268","170310 BARROLANDIA",0,0,1,65,0,66,"2015"
"28269","170320 BERNARDO SAYAO",1,0,2,49,1,53,"2015"
"28270","170330 BOM JESUS DO TOCANTINS",1,0,1,71,0,73,"2015"
"28271","170360 BRASILANDIA DO TOCANTINS",0,0,0,25,4,29,"2015"
"28272","170370 BREJINHO DE NAZARE",0,0,1,88,1,90,"2015"
"28273","170380 BURITI DO TOCANTINS",1,1,4,139,20,165,"2015"
"28274","170382 CACHOEIRINHA",0,0,1,24,1,26,"2015"
"28275","170384 CAMPOS LINDOS",1,1,1,134,26,163,"2015"
"28276","170386 CARIRI DO TOCANTINS",0,0,0,49,0,49,"2015"
"28277","170388 CARMOLANDIA",0,0,1,29,0,30,"2015"
"28278","170389 CARRASCO BONITO",0,1,2,39,5,47,"2015"
"28279","170390 CASEARA",0,0,1,70,0,71,"2015"
"28280","170410 CENTENARIO",0,0,3,21,0,24,"2015"
"28281","170460 CHAPADA DE AREIA",0,0,0,21,0,21,"2015"
"28282","170510 CHAPADA DA NATIVIDADE",0,0,1,43,0,44,"2015"
"28283","170550 COLINAS DO TOCANTINS",0,2,9,510,58,579,"2015"
"28284","170555 COMBINADO",0,0,3,75,1,79,"2015"
"28285","170560 CONCEICAO DO TOCANTINS",1,1,1,40,5,48,"2015"
"28286","170600 COUTO MAGALHAES",0,0,1,76,2,79,"2015"
"28287","170610 CRISTALANDIA",0,0,0,68,2,70,"2015"
"28288","170625 CRIXAS DO TOCANTINS",0,0,0,24,0,24,"2015"
"28289","170650 DARCINOPOLIS",0,0,4,104,1,109,"2015"
"28290","170700 DIANOPOLIS",0,2,5,320,4,331,"2015"
"28291","170710 DIVINOPOLIS DO TOCANTINS",0,0,1,95,1,97,"2015"
"28292","170720 DOIS IRMAOS DO TOCANTINS",1,0,1,51,1,54,"2015"
"28293","170730 DUERE",1,0,3,61,0,65,"2015"
"28294","170740 ESPERANTINA",0,2,4,146,14,166,"2015"
"28295","170755 FATIMA",0,0,0,39,0,39,"2015"
"28296","170765 FIGUEIROPOLIS",2,0,0,71,1,74,"2015"
"28297","170770 FILADELFIA",0,0,1,105,3,109,"2015"
"28298","170820 FORMOSO DO ARAGUAIA",2,4,5,249,3,263,"2015"
"28299","170825 FORTALEZA DO TABOCAO",0,0,0,61,1,62,"2015"
"28300","170830 GOIANORTE",0,0,1,74,0,75,"2015"
"28301","170900 GOIATINS",0,1,3,241,13,258,"2015"
"28302","170930 GUARAI",0,0,8,392,1,401,"2015"
"28303","170950 GURUPI",5,7,18,1360,6,1396,"2015"
"28304","170980 IPUEIRAS",0,0,0,28,0,28,"2015"
"28305","171050 ITACAJA",1,0,7,146,1,155,"2015"
"28306","171070 ITAGUATINS",0,0,2,63,4,69,"2015"
"28307","171090 ITAPIRATINS",0,0,0,44,0,44,"2015"
"28308","171110 ITAPORA DO TOCANTINS",0,0,0,36,0,36,"2015"
"28309","171150 JAU DO TOCANTINS",0,1,0,48,0,49,"2015"
"28310","171180 JUARINA",0,0,0,24,2,26,"2015"
"28311","171190 LAGOA DA CONFUSAO",0,0,3,232,3,238,"2015"
"28312","171195 LAGOA DO TOCANTINS",0,0,1,54,4,59,"2015"
"28313","171200 LAJEADO",0,1,0,50,1,52,"2015"
"28314","171215 LAVANDEIRA",0,0,2,26,0,28,"2015"
"28315","171240 LIZARDA",0,0,2,37,1,40,"2015"
"28316","171245 LUZINOPOLIS",0,0,0,28,1,29,"2015"
"28317","171250 MARIANOPOLIS DO TOCANTINS",1,0,0,68,0,69,"2015"
"28318","171270 MATEIROS",0,0,0,32,3,35,"2015"
"28319","171280 MAURILANDIA DO TOCANTINS",0,1,1,24,6,32,"2015"
"28320","171320 MIRACEMA DO TOCANTINS",1,0,2,350,1,354,"2015"
"28321","171330 MIRANORTE",1,2,3,161,2,169,"2015"
"28322","171360 MONTE DO CARMO",0,0,0,97,1,98,"2015"
"28323","171370 MONTE SANTO DO TOCANTINS",0,0,0,38,0,38,"2015"
"28324","171380 PALMEIRAS DO TOCANTINS",0,0,1,70,0,71,"2015"
"28325","171395 MURICILANDIA",0,0,1,45,0,46,"2015"
"28326","171420 NATIVIDADE",0,1,0,126,0,127,"2015"
"28327","171430 NAZARE",0,0,3,42,2,47,"2015"
"28328","171488 NOVA OLINDA",0,1,4,210,4,219,"2015"
"28329","171500 NOVA ROSALANDIA",0,1,0,54,0,55,"2015"
"28330","171510 NOVO ACORDO",0,0,1,72,1,74,"2015"
"28331","171515 NOVO ALEGRE",0,0,0,20,0,20,"2015"
"28332","171525 NOVO JARDIM",0,0,0,35,0,35,"2015"
"28333","171550 OLIVEIRA DE FATIMA",0,0,0,17,0,17,"2015"
"28334","171570 PALMEIRANTE",0,0,0,45,3,48,"2015"
"28335","171575 PALMEIROPOLIS",0,0,1,78,0,79,"2015"
"28336","171610 PARAISO DO TOCANTINS",2,2,10,842,4,860,"2015"
"28337","171620 PARANA",0,1,2,146,4,153,"2015"
"28338","171630 PAU D'ARCO",0,0,0,58,1,59,"2015"
"28339","171650 PEDRO AFONSO",0,0,8,271,0,279,"2015"
"28340","171660 PEIXE",1,0,3,124,0,128,"2015"
"28341","171665 PEQUIZEIRO",0,0,3,58,0,61,"2015"
"28342","171670 COLMEIA",0,0,7,108,1,116,"2015"
"28343","171700 PINDORAMA DO TOCANTINS",1,0,0,67,0,68,"2015"
"28344","171720 PIRAQUE",0,1,0,30,1,32,"2015"
"28345","171750 PIUM",0,0,0,74,0,74,"2015"
"28346","171780 PONTE ALTA DO BOM JESUS",0,0,1,55,0,56,"2015"
"28347","171790 PONTE ALTA DO TOCANTINS",0,0,1,109,2,112,"2015"
"28348","171800 PORTO ALEGRE DO TOCANTINS",0,1,0,46,0,47,"2015"
"28349","171820 PORTO NACIONAL",1,2,19,1095,2,1119,"2015"
"28350","171830 PRAIA NORTE",1,0,6,120,5,132,"2015"
"28351","171840 PRESIDENTE KENNEDY",2,0,0,50,0,52,"2015"
"28352","171845 PUGMIL",0,0,0,35,0,35,"2015"
"28353","171850 RECURSOLANDIA",1,1,2,63,1,68,"2015"
"28354","171855 RIACHINHO",0,0,0,68,0,68,"2015"
"28355","171865 RIO DA CONCEICAO",0,0,0,34,0,34,"2015"
"28356","171870 RIO DOS BOIS",0,0,0,24,1,25,"2015"
"28357","171875 RIO SONO",1,1,0,49,0,51,"2015"
"28358","171880 SAMPAIO",0,0,1,73,12,86,"2015"
"28359","171884 SANDOLANDIA",1,0,0,38,0,39,"2015"
"28360","171886 SANTA FE DO ARAGUAIA",1,0,3,126,2,132,"2015"
"28361","171888 SANTA MARIA DO TOCANTINS",0,0,1,35,0,36,"2015"
"28362","171889 SANTA RITA DO TOCANTINS",0,0,1,28,0,29,"2015"
"28363","171890 SANTA ROSA DO TOCANTINS",0,1,1,80,3,85,"2015"
"28364","171900 SANTA TEREZA DO TOCANTINS",0,1,0,45,1,47,"2015"
"28365","172000 SANTA TEREZINHA DO TOCANTINS",0,0,0,34,1,35,"2015"
"28366","172010 SAO BENTO DO TOCANTINS",0,0,1,84,10,95,"2015"
"28367","172015 SAO FELIX DO TOCANTINS",0,0,1,16,0,17,"2015"
"28368","172020 SAO MIGUEL DO TOCANTINS",1,0,3,160,1,165,"2015"
"28369","172025 SAO SALVADOR DO TOCANTINS",0,2,1,32,0,35,"2015"
"28370","172030 SAO SEBASTIAO DO TOCANTINS",1,0,0,75,7,83,"2015"
"28371","172049 SAO VALERIO",1,0,0,58,0,59,"2015"
"28372","172065 SILVANOPOLIS",2,0,0,90,1,93,"2015"
"28373","172080 SITIO NOVO DO TOCANTINS",0,1,4,137,1,143,"2015"
"28374","172085 SUCUPIRA",1,0,1,21,1,24,"2015"
"28375","172090 TAGUATINGA",2,2,3,178,1,186,"2015"
"28376","172093 TAIPAS DO TOCANTINS",0,0,0,24,0,24,"2015"
"28377","172097 TALISMA",0,0,0,39,0,39,"2015"
"28378","172100 PALMAS",14,4,68,5081,31,5198,"2015"
"28379","172110 TOCANTINIA",1,0,5,204,2,212,"2015"
"28380","172120 TOCANTINOPOLIS",1,1,7,464,8,481,"2015"
"28381","172125 TUPIRAMA",0,0,0,32,0,32,"2015"
"28382","172130 TUPIRATINS",0,0,0,17,1,18,"2015"
"28383","172208 WANDERLANDIA",0,0,2,141,1,144,"2015"
"28384","172210 XAMBIOA",0,2,7,226,0,235,"2015"
"28385","MUNICIPIO IGNORADO - MA",0,0,0,8,0,8,"2015"
"28386","210005 ACAILANDIA",4,12,73,1964,32,2085,"2015"
"28387","210010 AFONSO CUNHA",0,1,3,95,3,102,"2015"
"28388","210015 AGUA DOCE DO MARANHAO",0,1,3,160,6,170,"2015"
"28389","210020 ALCANTARA",1,3,7,110,39,160,"2015"
"28390","210030 ALDEIAS ALTAS",0,0,8,422,3,433,"2015"
"28391","210040 ALTAMIRA DO MARANHAO",1,0,2,99,0,102,"2015"
"28392","210043 ALTO ALEGRE DO MARANHAO",1,0,15,445,8,469,"2015"
"28393","210047 ALTO ALEGRE DO PINDARE",3,3,3,441,42,492,"2015"
"28394","210050 ALTO PARNAIBA",1,1,4,166,17,189,"2015"
"28395","210055 AMAPA DO MARANHAO",0,0,3,116,5,124,"2015"
"28396","210060 AMARANTE DO MARANHAO",2,2,7,728,68,807,"2015"
"28397","210070 ANAJATUBA",4,5,22,221,115,367,"2015"
"28398","210080 ANAPURUS",0,2,10,254,3,269,"2015"
"28399","210083 APICUM-ACU",1,1,0,22,275,299,"2015"
"28400","210087 ARAGUANA",0,1,8,171,6,186,"2015"
"28401","210090 ARAIOSES",0,4,10,505,26,545,"2015"
"28402","210095 ARAME",0,3,14,536,4,557,"2015"
"28403","210100 ARARI",0,3,17,415,39,474,"2015"
"28404","210110 AXIXA",0,0,2,189,4,195,"2015"
"28405","210120 BACABAL",7,20,46,1648,13,1734,"2015"
"28406","210125 BACABEIRA",1,1,3,302,5,312,"2015"
"28407","210130 BACURI",2,0,0,25,229,256,"2015"
"28408","210135 BACURITUBA",0,0,0,61,4,65,"2015"
"28409","210140 BALSAS",3,2,5,100,1993,2103,"2015"
"28410","210150 BARAO DE GRAJAU",2,1,4,241,1,249,"2015"
"28411","210160 BARRA DO CORDA",2,2,7,1618,47,1676,"2015"
"28412","210170 BARREIRINHAS",3,3,6,1134,59,1205,"2015"
"28413","210173 BELAGUA",0,1,2,43,150,196,"2015"
"28414","210177 BELA VISTA DO MARANHAO",0,1,7,213,0,221,"2015"
"28415","210180 BENEDITO LEITE",0,0,0,28,43,71,"2015"
"28416","210190 BEQUIMAO",0,0,6,63,209,278,"2015"
"28417","210193 BERNARDO DO MEARIM",0,0,1,68,0,69,"2015"
"28418","210197 BOA VISTA DO GURUPI",1,1,1,144,2,149,"2015"
"28419","210200 BOM JARDIM",3,3,10,493,127,636,"2015"
"28420","210203 BOM JESUS DAS SELVAS",2,5,12,544,7,570,"2015"
"28421","210207 BOM LUGAR",1,1,1,149,0,152,"2015"
"28422","210210 BREJO",1,0,2,541,1,545,"2015"
"28423","210215 BREJO DE AREIA",1,1,3,111,7,123,"2015"
"28424","210220 BURITI",1,10,17,545,6,579,"2015"
"28425","210230 BURITI BRAVO",11,0,1,394,9,415,"2015"
"28426","210232 BURITICUPU",3,6,21,1335,13,1378,"2015"
"28427","210235 BURITIRANA",0,1,7,194,8,210,"2015"
"28428","210237 CACHOEIRA GRANDE",0,0,1,147,22,170,"2015"
"28429","210240 CAJAPIO",0,0,0,8,143,151,"2015"
"28430","210250 CAJARI",1,0,1,153,135,290,"2015"
"28431","210255 CAMPESTRE DO MARANHAO",0,0,3,229,3,235,"2015"
"28432","210260 CANDIDO MENDES",0,0,1,278,31,310,"2015"
"28433","210270 CANTANHEDE",0,5,2,209,76,292,"2015"
"28434","210275 CAPINZAL DO NORTE",2,0,4,161,13,180,"2015"
"28435","210280 CAROLINA",0,8,12,318,4,342,"2015"
"28436","210290 CARUTAPERA",0,0,0,504,1,505,"2015"
"28437","210300 CAXIAS",6,1,30,2649,14,2700,"2015"
"28438","210310 CEDRAL",2,0,2,91,27,122,"2015"
"28439","210312 CENTRAL DO MARANHAO",0,0,1,18,84,103,"2015"
"28440","210315 CENTRO DO GUILHERME",1,2,2,177,6,188,"2015"
"28441","210317 CENTRO NOVO DO MARANHAO",1,1,1,330,23,356,"2015"
"28442","210320 CHAPADINHA",6,15,58,1493,20,1592,"2015"
"28443","210325 CIDELANDIA",0,0,3,158,13,174,"2015"
"28444","210330 CODO",15,21,76,1970,59,2141,"2015"
"28445","210340 COELHO NETO",2,22,37,829,2,892,"2015"
"28446","210350 COLINAS",5,1,14,759,10,789,"2015"
"28447","210355 CONCEICAO DO LAGO-ACU",1,4,5,218,26,254,"2015"
"28448","210360 COROATA",0,9,16,1114,30,1169,"2015"
"28449","210370 CURURUPU",1,0,1,101,373,476,"2015"
"28450","210375 DAVINOPOLIS",0,2,5,276,1,284,"2015"
"28451","210380 DOM PEDRO",0,0,4,348,24,376,"2015"
"28452","210390 DUQUE BACELAR",1,1,10,164,12,188,"2015"
"28453","210400 ESPERANTINOPOLIS",0,1,2,308,2,313,"2015"
"28454","210405 ESTREITO",0,5,14,612,0,631,"2015"
"28455","210407 FEIRA NOVA DO MARANHAO",0,0,1,10,96,107,"2015"
"28456","210408 FERNANDO FALCAO",0,1,0,127,85,213,"2015"
"28457","210409 FORMOSA DA SERRA NEGRA",1,0,1,206,79,287,"2015"
"28458","210410 FORTALEZA DOS NOGUEIRAS",0,0,1,127,82,210,"2015"
"28459","210420 FORTUNA",0,0,4,279,4,287,"2015"
"28460","210430 GODOFREDO VIANA",0,0,1,143,5,149,"2015"
"28461","210440 GONCALVES DIAS",1,0,1,85,171,258,"2015"
"28462","210450 GOVERNADOR ARCHER",0,0,1,171,8,180,"2015"
"28463","210455 GOVERNADOR EDISON LOBAO",1,3,8,296,4,312,"2015"
"28464","210460 GOVERNADOR EUGENIO BARROS",0,2,3,221,3,229,"2015"
"28465","210462 GOVERNADOR LUIZ ROCHA",0,0,5,120,4,129,"2015"
"28466","210465 GOVERNADOR NEWTON BELLO",3,2,5,153,4,167,"2015"
"28467","210467 GOVERNADOR NUNES FREIRE",2,3,9,530,9,553,"2015"
"28468","210470 GRACA ARANHA",0,0,0,58,6,64,"2015"
"28469","210480 GRAJAU",3,5,34,1666,77,1785,"2015"
"28470","210490 GUIMARAES",0,12,0,25,100,137,"2015"
"28471","210500 HUMBERTO DE CAMPOS",0,0,3,458,82,543,"2015"
"28472","210510 ICATU",2,1,10,329,51,393,"2015"
"28473","210515 IGARAPE DO MEIO",0,2,4,218,5,229,"2015"
"28474","210520 IGARAPE GRANDE",3,0,4,159,0,166,"2015"
"28475","210530 IMPERATRIZ",11,21,146,5041,29,5248,"2015"
"28476","210535 ITAIPAVA DO GRAJAU",0,2,8,244,12,266,"2015"
"28477","210540 ITAPECURU MIRIM",3,3,3,200,1053,1262,"2015"
"28478","210542 ITINGA DO MARANHAO",2,0,19,342,0,363,"2015"
"28479","210545 JATOBA",0,0,2,150,0,152,"2015"
"28480","210547 JENIPAPO DOS VIEIRAS",0,0,0,277,97,374,"2015"
"28481","210550 JOAO LISBOA",3,1,17,506,4,531,"2015"
"28482","210560 JOSELANDIA",2,1,3,241,23,270,"2015"
"28483","210565 JUNCO DO MARANHAO",0,2,3,126,7,138,"2015"
"28484","210570 LAGO DA PEDRA",2,2,15,798,1,818,"2015"
"28485","210580 LAGO DO JUNCO",0,3,4,181,2,190,"2015"
"28486","210590 LAGO VERDE",0,3,7,228,2,240,"2015"
"28487","210592 LAGOA DO MATO",0,0,0,152,2,154,"2015"
"28488","210594 LAGO DOS RODRIGUES",0,0,1,132,0,133,"2015"
"28489","210596 LAGOA GRANDE DO MARANHAO",0,0,5,188,8,201,"2015"
"28490","210598 LAJEADO NOVO",0,1,2,91,0,94,"2015"
"28491","210600 LIMA CAMPOS",0,2,2,186,1,191,"2015"
"28492","210610 LORETO",0,0,1,5,173,179,"2015"
"28493","210620 LUIS DOMINGUES",0,0,0,97,24,121,"2015"
"28494","210630 MAGALHAES DE ALMEIDA",0,1,10,230,1,242,"2015"
"28495","210632 MARACACUME",0,0,7,380,4,391,"2015"
"28496","210635 MARAJA DO SENA",0,1,4,102,13,120,"2015"
"28497","210637 MARANHAOZINHO",1,2,2,177,21,203,"2015"
"28498","210640 MATA ROMA",0,1,6,312,16,335,"2015"
"28499","210650 MATINHA",1,1,1,55,340,398,"2015"
"28500","210660 MATOES",1,1,6,485,47,540,"2015"
"28501","210663 MATOES DO NORTE",1,0,0,66,47,114,"2015"
"28502","210667 MILAGRES DO MARANHAO",0,0,7,85,1,93,"2015"
"28503","210670 MIRADOR",1,1,6,315,6,329,"2015"
"28504","210675 MIRANDA DO NORTE",0,2,3,267,69,341,"2015"
"28505","210680 MIRINZAL",0,2,0,13,220,235,"2015"
"28506","210690 MONCAO",0,1,4,636,37,678,"2015"
"28507","210700 MONTES ALTOS",0,1,6,169,4,180,"2015"
"28508","210710 MORROS",3,4,4,325,48,384,"2015"
"28509","210720 NINA RODRIGUES",0,2,0,103,101,206,"2015"
"28510","210725 NOVA COLINAS",0,0,1,65,41,107,"2015"
"28511","210730 NOVA IORQUE",0,1,0,19,19,39,"2015"
"28512","210735 NOVA OLINDA DO MARANHAO",0,1,19,285,5,310,"2015"
"28513","210740 OLHO D'AGUA DAS CUNHAS",0,1,3,254,22,280,"2015"
"28514","210745 OLINDA NOVA DO MARANHAO",0,1,3,32,160,196,"2015"
"28515","210750 PACO DO LUMIAR",4,7,27,1706,31,1775,"2015"
"28516","210760 PALMEIRANDIA",1,3,6,247,52,309,"2015"
"28517","210770 PARAIBANO",3,2,2,335,2,344,"2015"
"28518","210780 PARNARAMA",0,1,8,371,106,486,"2015"
"28519","210790 PASSAGEM FRANCA",1,0,1,352,0,354,"2015"
"28520","210800 PASTOS BONS",0,1,0,26,278,305,"2015"
"28521","210805 PAULINO NEVES",0,1,8,259,30,298,"2015"
"28522","210810 PAULO RAMOS",2,4,2,366,9,383,"2015"
"28523","210820 PEDREIRAS",1,3,10,601,3,618,"2015"
"28524","210825 PEDRO DO ROSARIO",1,3,9,180,44,237,"2015"
"28525","210830 PENALVA",1,2,12,621,67,703,"2015"
"28526","210840 PERI MIRIM",1,0,5,131,4,141,"2015"
"28527","210845 PERITORO",0,2,6,358,3,369,"2015"
"28528","210850 PINDARE-MIRIM",0,1,6,531,6,544,"2015"
"28529","210860 PINHEIRO",1,11,39,1367,80,1498,"2015"
"28530","210870 PIO XII",1,3,4,476,5,489,"2015"
"28531","210880 PIRAPEMAS",1,2,7,277,44,331,"2015"
"28532","210890 POCAO DE PEDRAS",1,0,4,268,0,273,"2015"
"28533","210900 PORTO FRANCO",1,2,8,406,1,418,"2015"
"28534","210905 PORTO RICO DO MARANHAO",0,0,0,46,19,65,"2015"
"28535","210910 PRESIDENTE DUTRA",2,5,14,848,3,872,"2015"
"28536","210920 PRESIDENTE JUSCELINO",1,1,4,138,55,199,"2015"
"28537","210923 PRESIDENTE MEDICI",0,0,0,112,5,117,"2015"
"28538","210927 PRESIDENTE SARNEY",3,0,10,284,80,377,"2015"
"28539","210930 PRESIDENTE VARGAS",0,1,17,108,105,231,"2015"
"28540","210940 PRIMEIRA CRUZ",0,0,5,145,25,175,"2015"
"28541","210945 RAPOSA",1,1,12,416,8,438,"2015"
"28542","210950 RIACHAO",3,0,3,313,37,356,"2015"
"28543","210955 RIBAMAR FIQUENE",1,0,7,134,4,146,"2015"
"28544","210960 ROSARIO",2,0,29,586,14,631,"2015"
"28545","210970 SAMBAIBA",0,0,2,31,34,67,"2015"
"28546","210975 SANTA FILOMENA DO MARANHAO",0,0,0,61,0,61,"2015"
"28547","210980 SANTA HELENA",0,1,14,369,136,520,"2015"
"28548","210990 SANTA INES",13,4,31,1537,2,1587,"2015"
"28549","211000 SANTA LUZIA",0,2,14,1156,108,1280,"2015"
"28550","211003 SANTA LUZIA DO PARUA",0,1,10,435,1,447,"2015"
"28551","211010 SANTA QUITERIA DO MARANHAO",1,0,8,477,3,489,"2015"
"28552","211020 SANTA RITA",3,6,41,562,13,625,"2015"
"28553","211023 SANTANA DO MARANHAO",0,1,3,121,8,133,"2015"
"28554","211027 SANTO AMARO DO MARANHAO",0,1,3,107,48,159,"2015"
"28555","211030 SANTO ANTONIO DOS LOPES",1,0,1,56,187,245,"2015"
"28556","211040 SAO BENEDITO DO RIO PRETO",0,0,6,58,323,387,"2015"
"28557","211050 SAO BENTO",1,0,2,498,15,516,"2015"
"28558","211060 SAO BERNARDO",2,2,8,449,4,465,"2015"
"28559","211065 SAO DOMINGOS DO AZEITAO",0,0,1,33,99,133,"2015"
"28560","211070 SAO DOMINGOS DO MARANHAO",1,3,17,582,6,609,"2015"
"28561","211080 SAO FELIX DE BALSAS",0,0,1,4,43,48,"2015"
"28562","211085 SAO FRANCISCO DO BREJAO",0,0,4,132,3,139,"2015"
"28563","211090 SAO FRANCISCO DO MARANHAO",0,1,6,138,7,152,"2015"
"28564","211100 SAO JOAO BATISTA",3,6,38,195,27,269,"2015"
"28565","211102 SAO JOAO DO CARU",0,8,15,197,2,222,"2015"
"28566","211105 SAO JOAO DO PARAISO",0,0,5,141,14,160,"2015"
"28567","211107 SAO JOAO DO SOTER",1,0,4,268,9,282,"2015"
"28568","211110 SAO JOAO DOS PATOS",4,4,10,397,3,418,"2015"
"28569","211120 SAO JOSE DE RIBAMAR",8,20,53,3187,30,3298,"2015"
"28570","211125 SAO JOSE DOS BASILIOS",0,1,1,80,0,82,"2015"
"28571","211130 SAO LUIS",75,80,312,16288,243,16998,"2015"
"28572","211140 SAO LUIS GONZAGA DO MARANHAO",1,0,5,327,1,334,"2015"
"28573","211150 SAO MATEUS DO MARANHAO",0,5,8,659,8,680,"2015"
"28574","211153 SAO PEDRO DA AGUA BRANCA",0,1,7,164,0,172,"2015"
"28575","211157 SAO PEDRO DOS CRENTES",0,0,0,72,0,72,"2015"
"28576","211160 SAO RAIMUNDO DAS MANGABEIRAS",0,0,1,11,307,319,"2015"
"28577","211163 SAO RAIMUNDO DO DOCA BEZERRA",0,0,1,76,1,78,"2015"
"28578","211167 SAO ROBERTO",0,1,1,85,1,88,"2015"
"28579","211170 SAO VICENTE FERRER",0,12,4,50,253,319,"2015"
"28580","211172 SATUBINHA",0,1,1,106,1,109,"2015"
"28581","211174 SENADOR ALEXANDRE COSTA",0,0,1,185,0,186,"2015"
"28582","211176 SENADOR LA ROCQUE",0,1,10,296,8,315,"2015"
"28583","211178 SERRANO DO MARANHAO",0,0,0,33,144,177,"2015"
"28584","211180 SITIO NOVO",0,3,7,277,3,290,"2015"
"28585","211190 SUCUPIRA DO NORTE",1,2,5,155,4,167,"2015"
"28586","211195 SUCUPIRA DO RIACHAO",0,0,1,83,0,84,"2015"
"28587","211200 TASSO FRAGOSO",0,2,1,63,86,152,"2015"
"28588","211210 TIMBIRAS",4,0,8,566,3,581,"2015"
"28589","211220 TIMON",7,9,23,2743,14,2796,"2015"
"28590","211223 TRIZIDELA DO VALE",0,1,2,355,0,358,"2015"
"28591","211227 TUFILANDIA",1,0,3,101,2,107,"2015"
"28592","211230 TUNTUM",3,4,14,570,1,592,"2015"
"28593","211240 TURIACU",0,1,3,41,612,657,"2015"
"28594","211245 TURILANDIA",1,1,9,272,115,398,"2015"
"28595","211250 TUTOIA",2,6,18,961,59,1046,"2015"
"28596","211260 URBANO SANTOS",0,1,5,128,550,684,"2015"
"28597","211270 VARGEM GRANDE",0,11,39,825,57,932,"2015"
"28598","211280 VIANA",9,8,16,926,112,1071,"2015"
"28599","211285 VILA NOVA DOS MARTIRIOS",0,2,1,161,3,167,"2015"
"28600","211290 VITORIA DO MEARIM",0,0,1,66,503,570,"2015"
"28601","211300 VITORINO FREIRE",0,1,6,512,2,521,"2015"
"28602","211400 ZE DOCA",5,3,26,735,8,777,"2015"
"28603","MUNICIPIO IGNORADO - PI",0,0,0,1,0,1,"2015"
"28604","220005 ACAUA",0,1,1,58,27,87,"2015"
"28605","220010 AGRICOLANDIA",0,1,2,78,3,84,"2015"
"28606","220020 AGUA BRANCA",0,0,3,277,14,294,"2015"
"28607","220025 ALAGOINHA DO PIAUI",0,1,1,83,0,85,"2015"
"28608","220027 ALEGRETE DO PIAUI",1,0,5,65,0,71,"2015"
"28609","220030 ALTO LONGA",0,1,2,123,3,129,"2015"
"28610","220040 ALTOS",1,0,4,580,41,626,"2015"
"28611","220045 ALVORADA DO GURGUEIA",3,0,0,45,36,84,"2015"
"28612","220050 AMARANTE",1,1,9,296,2,309,"2015"
"28613","220060 ANGICAL DO PIAUI",0,1,0,83,6,90,"2015"
"28614","220070 ANISIO DE ABREU",0,0,1,119,24,144,"2015"
"28615","220080 ANTONIO ALMEIDA",0,0,0,29,6,35,"2015"
"28616","220090 AROAZES",0,0,0,73,2,75,"2015"
"28617","220095 AROEIRAS DO ITAIM",0,0,6,36,0,42,"2015"
"28618","220100 ARRAIAL",1,1,1,51,0,54,"2015"
"28619","220105 ASSUNCAO DO PIAUI",0,0,1,135,15,151,"2015"
"28620","220110 AVELINO LOPES",0,0,0,118,41,159,"2015"
"28621","220115 BAIXA GRANDE DO RIBEIRO",2,0,4,234,43,283,"2015"
"28622","220117 BARRA D'ALCANTARA",0,0,0,43,1,44,"2015"
"28623","220120 BARRAS",28,4,8,724,16,780,"2015"
"28624","220130 BARREIRAS DO PIAUI",0,0,0,12,22,34,"2015"
"28625","220140 BARRO DURO",0,1,0,89,2,92,"2015"
"28626","220150 BATALHA",1,3,8,362,4,378,"2015"
"28627","220155 BELA VISTA DO PIAUI",0,0,1,48,1,50,"2015"
"28628","220157 BELEM DO PIAUI",0,0,6,29,1,36,"2015"
"28629","220160 BENEDITINOS",0,0,2,125,16,143,"2015"
"28630","220170 BERTOLINIA",5,1,1,74,2,83,"2015"
"28631","220173 BETANIA DO PIAUI",1,0,2,75,39,117,"2015"
"28632","220177 BOA HORA",0,0,2,46,50,98,"2015"
"28633","220180 BOCAINA",0,0,10,28,0,38,"2015"
"28634","220190 BOM JESUS",1,1,2,276,202,482,"2015"
"28635","220191 BOM PRINCIPIO DO PIAUI",0,1,1,93,2,97,"2015"
"28636","220192 BONFIM DO PIAUI",1,0,0,60,18,79,"2015"
"28637","220194 BOQUEIRAO DO PIAUI",0,0,1,31,90,122,"2015"
"28638","220196 BRASILEIRA",0,1,0,112,0,113,"2015"
"28639","220198 BREJO DO PIAUI",0,0,2,41,4,47,"2015"
"28640","220200 BURITI DOS LOPES",0,5,6,323,14,348,"2015"
"28641","220202 BURITI DOS MONTES",1,0,3,55,28,87,"2015"
"28642","220205 CABECEIRAS DO PIAUI",0,0,2,50,88,140,"2015"
"28643","220207 CAJAZEIRAS DO PIAUI",0,0,1,40,0,41,"2015"
"28644","220208 CAJUEIRO DA PRAIA",0,1,4,83,5,93,"2015"
"28645","220209 CALDEIRAO GRANDE DO PIAUI",0,1,1,73,1,76,"2015"
"28646","220210 CAMPINAS DO PIAUI",0,0,1,56,0,57,"2015"
"28647","220211 CAMPO ALEGRE DO FIDALGO",0,0,2,65,0,67,"2015"
"28648","220213 CAMPO GRANDE DO PIAUI",0,0,12,86,1,99,"2015"
"28649","220217 CAMPO LARGO DO PIAUI",1,0,3,135,5,144,"2015"
"28650","220220 CAMPO MAIOR",2,0,4,193,430,629,"2015"
"28651","220225 CANAVIEIRA",0,0,1,42,1,44,"2015"
"28652","220230 CANTO DO BURITI",2,0,3,265,19,289,"2015"
"28653","220240 CAPITAO DE CAMPOS",1,0,0,88,56,145,"2015"
"28654","220245 CAPITAO GERVASIO OLIVEIRA",0,0,0,49,0,49,"2015"
"28655","220250 CARACOL",0,0,1,130,46,177,"2015"
"28656","220253 CARAUBAS DO PIAUI",1,1,0,57,1,60,"2015"
"28657","220255 CARIDADE DO PIAUI",1,0,2,76,2,81,"2015"
"28658","220260 CASTELO DO PIAUI",2,1,3,163,117,286,"2015"
"28659","220265 CAXINGO",0,1,1,79,5,86,"2015"
"28660","220270 COCAL",2,4,10,394,15,425,"2015"
"28661","220271 COCAL DE TELHA",0,1,1,25,38,65,"2015"
"28662","220272 COCAL DOS ALVES",0,2,2,52,0,56,"2015"
"28663","220273 COIVARAS",0,0,0,39,8,47,"2015"
"28664","220275 COLONIA DO GURGUEIA",7,1,1,61,8,78,"2015"
"28665","220277 COLONIA DO PIAUI",0,0,0,98,0,98,"2015"
"28666","220280 CONCEICAO DO CANINDE",1,0,3,61,2,67,"2015"
"28667","220285 CORONEL JOSE DIAS",0,0,0,52,4,56,"2015"
"28668","220290 CORRENTE",0,0,2,121,318,441,"2015"
"28669","220300 CRISTALANDIA DO PIAUI",0,1,1,34,66,102,"2015"
"28670","220310 CRISTINO CASTRO",1,2,0,107,64,174,"2015"
"28671","220320 CURIMATA",0,0,1,156,35,192,"2015"
"28672","220323 CURRAIS",0,0,0,52,41,93,"2015"
"28673","220325 CURRALINHOS",0,0,2,72,1,75,"2015"
"28674","220327 CURRAL NOVO DO PIAUI",0,0,0,60,9,69,"2015"
"28675","220330 DEMERVAL LOBAO",1,1,3,200,4,209,"2015"
"28676","220335 DIRCEU ARCOVERDE",0,0,2,76,23,101,"2015"
"28677","220340 DOM EXPEDITO LOPES",0,0,2,73,0,75,"2015"
"28678","220342 DOMINGOS MOURAO",0,0,1,49,4,54,"2015"
"28679","220345 DOM INOCENCIO",0,1,1,66,24,92,"2015"
"28680","220350 ELESBAO VELOSO",2,1,0,158,4,165,"2015"
"28681","220360 ELISEU MARTINS",14,0,0,35,1,50,"2015"
"28682","220370 ESPERANTINA",2,4,14,614,1,635,"2015"
"28683","220375 FARTURA DO PIAUI",0,0,1,51,13,65,"2015"
"28684","220380 FLORES DO PIAUI",0,1,0,55,0,56,"2015"
"28685","220385 FLORESTA DO PIAUI",0,0,0,19,0,19,"2015"
"28686","220390 FLORIANO",7,4,27,966,7,1011,"2015"
"28687","220400 FRANCINOPOLIS",0,0,0,58,0,58,"2015"
"28688","220410 FRANCISCO AYRES",0,1,1,56,0,58,"2015"
"28689","220415 FRANCISCO MACEDO",0,1,7,31,0,39,"2015"
"28690","220420 FRANCISCO SANTOS",1,1,18,107,0,127,"2015"
"28691","220430 FRONTEIRAS",0,1,3,170,0,174,"2015"
"28692","220435 GEMINIANO",1,0,6,80,0,87,"2015"
"28693","220440 GILBUES",1,1,2,85,79,168,"2015"
"28694","220450 GUADALUPE",1,2,2,149,2,156,"2015"
"28695","220455 GUARIBAS",0,0,2,61,24,87,"2015"
"28696","220460 HUGO NAPOLEAO",0,0,0,53,3,56,"2015"
"28697","220465 ILHA GRANDE",0,1,3,127,2,133,"2015"
"28698","220470 INHUMA",0,1,1,216,1,219,"2015"
"28699","220480 IPIRANGA DO PIAUI",0,1,2,129,0,132,"2015"
"28700","220490 ISAIAS COELHO",0,2,6,117,1,126,"2015"
"28701","220500 ITAINOPOLIS",0,0,11,122,0,133,"2015"
"28702","220510 ITAUEIRA",1,0,6,125,2,134,"2015"
"28703","220515 JACOBINA DO PIAUI",0,1,2,36,43,82,"2015"
"28704","220520 JAICOS",0,1,11,225,1,238,"2015"
"28705","220525 JARDIM DO MULATO",0,0,1,39,2,42,"2015"
"28706","220527 JATOBA DO PIAUI",0,0,0,19,31,50,"2015"
"28707","220530 JERUMENHA",2,0,0,48,0,50,"2015"
"28708","220535 JOAO COSTA",0,0,0,38,1,39,"2015"
"28709","220540 JOAQUIM PIRES",0,1,5,177,5,188,"2015"
"28710","220545 JOCA MARQUES",0,1,3,70,7,81,"2015"
"28711","220550 JOSE DE FREITAS",3,4,5,609,12,633,"2015"
"28712","220551 JUAZEIRO DO PIAUI",0,0,1,25,33,59,"2015"
"28713","220552 JULIO BORGES",0,0,0,55,16,71,"2015"
"28714","220553 JUREMA",0,0,1,55,13,69,"2015"
"28715","220554 LAGOINHA DO PIAUI",0,0,0,44,0,44,"2015"
"28716","220555 LAGOA ALEGRE",0,0,0,95,25,120,"2015"
"28717","220556 LAGOA DO BARRO DO PIAUI",0,0,6,59,13,78,"2015"
"28718","220557 LAGOA DE SAO FRANCISCO",0,0,1,69,8,78,"2015"
"28719","220558 LAGOA DO PIAUI",0,1,1,49,3,54,"2015"
"28720","220559 LAGOA DO SITIO",0,1,0,62,0,63,"2015"
"28721","220560 LANDRI SALES",0,0,0,57,2,59,"2015"
"28722","220570 LUIS CORREIA",0,4,6,416,11,437,"2015"
"28723","220580 LUZILANDIA",1,2,8,358,31,400,"2015"
"28724","220585 MADEIRO",0,2,3,142,6,153,"2015"
"28725","220590 MANOEL EMIDIO",48,0,0,20,0,68,"2015"
"28726","220595 MARCOLANDIA",0,0,9,117,0,126,"2015"
"28727","220600 MARCOS PARENTE",0,1,1,75,0,77,"2015"
"28728","220605 MASSAPE DO PIAUI",1,1,4,59,0,65,"2015"
"28729","220610 MATIAS OLIMPIO",1,0,5,181,3,190,"2015"
"28730","220620 MIGUEL ALVES",3,2,7,510,37,559,"2015"
"28731","220630 MIGUEL LEAO",0,0,0,25,0,25,"2015"
"28732","220635 MILTON BRANDAO",0,0,1,31,13,45,"2015"
"28733","220640 MONSENHOR GIL",0,1,2,123,2,128,"2015"
"28734","220650 MONSENHOR HIPOLITO",0,0,4,98,0,102,"2015"
"28735","220660 MONTE ALEGRE DO PIAUI",0,1,0,85,78,164,"2015"
"28736","220665 MORRO CABECA NO TEMPO",0,0,0,37,5,42,"2015"
"28737","220667 MORRO DO CHAPEU DO PIAUI",1,0,5,108,0,114,"2015"
"28738","220669 MURICI DOS PORTELAS",0,0,1,113,1,115,"2015"
"28739","220670 NAZARE DO PIAUI",0,0,0,74,1,75,"2015"
"28740","220672 NAZARIA",1,1,1,166,3,172,"2015"
"28741","220675 NOSSA SENHORA DE NAZARE",0,1,0,11,46,58,"2015"
"28742","220680 NOSSA SENHORA DOS REMEDIOS",5,1,2,121,5,134,"2015"
"28743","220690 NOVO ORIENTE DO PIAUI",1,2,1,76,0,80,"2015"
"28744","220695 NOVO SANTO ANTONIO",0,0,0,27,2,29,"2015"
"28745","220700 OEIRAS",1,3,18,443,8,473,"2015"
"28746","220710 OLHO D'AGUA DO PIAUI",0,0,1,33,0,34,"2015"
"28747","220720 PADRE MARCOS",0,2,13,72,8,95,"2015"
"28748","220730 PAES LANDIM",0,0,1,58,2,61,"2015"
"28749","220735 PAJEU DO PIAUI",0,1,1,24,1,27,"2015"
"28750","220740 PALMEIRA DO PIAUI",0,0,0,38,26,64,"2015"
"28751","220750 PALMEIRAIS",0,0,3,149,43,195,"2015"
"28752","220755 PAQUETA",0,0,0,31,1,32,"2015"
"28753","220760 PARNAGUA",0,0,0,30,110,140,"2015"
"28754","220770 PARNAIBA",14,11,39,2321,49,2434,"2015"
"28755","220775 PASSAGEM FRANCA DO PIAUI",0,0,0,66,5,71,"2015"
"28756","220777 PATOS DO PIAUI",1,0,4,37,5,47,"2015"
"28757","220779 PAU D'ARCO DO PIAUI",0,0,0,47,4,51,"2015"
"28758","220780 PAULISTANA",0,2,8,187,155,352,"2015"
"28759","220785 PAVUSSU",1,2,3,37,0,43,"2015"
"28760","220790 PEDRO II",1,4,7,339,260,611,"2015"
"28761","220793 PEDRO LAURENTINO",0,1,0,30,0,31,"2015"
"28762","220795 NOVA SANTA RITA",0,1,2,65,0,68,"2015"
"28763","220800 PICOS",7,8,49,1084,1,1149,"2015"
"28764","220810 PIMENTEIRAS",4,0,3,118,5,130,"2015"
"28765","220820 PIO IX",0,1,11,255,1,268,"2015"
"28766","220830 PIRACURUCA",0,3,2,434,0,439,"2015"
"28767","220840 PIRIPIRI",1,5,14,948,34,1002,"2015"
"28768","220850 PORTO",5,1,3,198,2,209,"2015"
"28769","220855 PORTO ALEGRE DO PIAUI",0,0,2,37,0,39,"2015"
"28770","220860 PRATA DO PIAUI",0,0,1,38,0,39,"2015"
"28771","220865 QUEIMADA NOVA",0,0,1,50,44,95,"2015"
"28772","220870 REDENCAO DO GURGUEIA",0,0,0,67,66,133,"2015"
"28773","220880 REGENERACAO",0,0,10,277,2,289,"2015"
"28774","220885 RIACHO FRIO",0,0,0,14,61,75,"2015"
"28775","220887 RIBEIRA DO PIAUI",0,0,1,41,2,44,"2015"
"28776","220890 RIBEIRO GONCALVES",0,0,0,18,77,95,"2015"
"28777","220900 RIO GRANDE DO PIAUI",0,0,2,86,2,90,"2015"
"28778","220910 SANTA CRUZ DO PIAUI",0,0,3,63,2,68,"2015"
"28779","220915 SANTA CRUZ DOS MILAGRES",2,0,0,37,1,40,"2015"
"28780","220920 SANTA FILOMENA",0,0,5,109,7,121,"2015"
"28781","220930 SANTA LUZ",0,0,0,41,33,74,"2015"
"28782","220935 SANTANA DO PIAUI",0,0,0,42,0,42,"2015"
"28783","220937 SANTA ROSA DO PIAUI",0,0,2,58,0,60,"2015"
"28784","220940 SANTO ANTONIO DE LISBOA",0,0,3,72,0,75,"2015"
"28785","220945 SANTO ANTONIO DOS MILAGRES",0,0,0,39,3,42,"2015"
"28786","220950 SANTO INACIO DO PIAUI",0,0,1,39,2,42,"2015"
"28787","220955 SAO BRAZ DO PIAUI",0,0,0,57,14,71,"2015"
"28788","220960 SAO FELIX DO PIAUI",1,0,0,27,0,28,"2015"
"28789","220965 SAO FRANCISCO DE ASSIS DO PIAUI",0,0,3,49,3,55,"2015"
"28790","220970 SAO FRANCISCO DO PIAUI",0,1,3,86,0,90,"2015"
"28791","220975 SAO GONCALO DO GURGUEIA",0,0,0,9,16,25,"2015"
"28792","220980 SAO GONCALO DO PIAUI",0,0,0,78,3,81,"2015"
"28793","220985 SAO JOAO DA CANABRAVA",0,1,2,49,0,52,"2015"
"28794","220987 SAO JOAO DA FRONTEIRA",0,0,1,89,0,90,"2015"
"28795","220990 SAO JOAO DA SERRA",0,1,0,37,18,56,"2015"
"28796","220995 SAO JOAO DA VARJOTA",0,0,2,71,0,73,"2015"
"28797","220997 SAO JOAO DO ARRAIAL",0,0,7,138,2,147,"2015"
"28798","221000 SAO JOAO DO PIAUI",0,0,6,337,3,346,"2015"
"28799","221005 SAO JOSE DO DIVINO",1,0,0,80,0,81,"2015"
"28800","221010 SAO JOSE DO PEIXE",0,0,3,37,0,40,"2015"
"28801","221020 SAO JOSE DO PIAUI",0,2,2,87,0,91,"2015"
"28802","221030 SAO JULIAO",0,1,7,78,0,86,"2015"
"28803","221035 SAO LOURENCO DO PIAUI",0,0,0,39,6,45,"2015"
"28804","221037 SAO LUIS DO PIAUI",1,0,3,24,1,29,"2015"
"28805","221038 SAO MIGUEL DA BAIXA GRANDE",0,0,1,24,0,25,"2015"
"28806","221039 SAO MIGUEL DO FIDALGO",0,0,2,35,0,37,"2015"
"28807","221040 SAO MIGUEL DO TAPUIO",2,0,4,239,27,272,"2015"
"28808","221050 SAO PEDRO DO PIAUI",1,3,2,198,19,223,"2015"
"28809","221060 SAO RAIMUNDO NONATO",1,0,10,390,172,573,"2015"
"28810","221062 SEBASTIAO BARROS",0,1,0,13,47,61,"2015"
"28811","221063 SEBASTIAO LEAL",0,0,1,51,6,58,"2015"
"28812","221065 SIGEFREDO PACHECO",3,0,0,51,56,110,"2015"
"28813","221070 SIMOES",1,0,3,230,1,235,"2015"
"28814","221080 SIMPLICIO MENDES",1,2,5,164,2,174,"2015"
"28815","221090 SOCORRO DO PIAUI",0,0,0,50,0,50,"2015"
"28816","221093 SUSSUAPARA",0,0,3,74,0,77,"2015"
"28817","221095 TAMBORIL DO PIAUI",0,0,1,20,8,29,"2015"
"28818","221097 TANQUE DO PIAUI",0,1,1,42,0,44,"2015"
"28819","221100 TERESINA",39,39,134,13682,82,13976,"2015"
"28820","221110 UNIAO",1,0,7,514,236,758,"2015"
"28821","221120 URUCUI",2,0,3,145,357,507,"2015"
"28822","221130 VALENCA DO PIAUI",4,0,0,269,1,274,"2015"
"28823","221135 VARZEA BRANCA",0,0,1,62,18,81,"2015"
"28824","221140 VARZEA GRANDE",0,0,1,44,0,45,"2015"
"28825","221150 VERA MENDES",1,0,2,43,0,46,"2015"
"28826","221160 VILA NOVA DO PIAUI",0,1,0,36,0,37,"2015"
"28827","221170 WALL FERRAZ",0,0,2,35,2,39,"2015"
"28828","MUNICIPIO IGNORADO - CE",0,0,0,1,0,1,"2015"
"28829","230010 ABAIARA",2,1,2,133,1,139,"2015"
"28830","230015 ACARAPE",0,0,2,221,1,224,"2015"
"28831","230020 ACARAU",1,8,20,1009,1,1039,"2015"
"28832","230030 ACOPIARA",2,2,42,583,0,629,"2015"
"28833","230040 AIUABA",1,0,13,151,4,169,"2015"
"28834","230050 ALCANTARAS",0,0,0,125,1,126,"2015"
"28835","230060 ALTANEIRA",2,1,4,104,0,111,"2015"
"28836","230070 ALTO SANTO",0,2,2,213,0,217,"2015"
"28837","230075 AMONTADA",1,2,34,661,9,707,"2015"
"28838","230080 ANTONINA DO NORTE",0,0,5,71,0,76,"2015"
"28839","230090 APUIARES",0,1,3,146,2,152,"2015"
"28840","230100 AQUIRAZ",1,2,25,1213,5,1246,"2015"
"28841","230110 ARACATI",4,8,21,983,4,1020,"2015"
"28842","230120 ARACOIABA",1,3,9,349,1,363,"2015"
"28843","230125 ARARENDA",2,2,4,93,0,101,"2015"
"28844","230130 ARARIPE",1,3,18,335,2,359,"2015"
"28845","230140 ARATUBA",0,1,3,167,1,172,"2015"
"28846","230150 ARNEIROZ",0,1,5,97,0,103,"2015"
"28847","230160 ASSARE",3,2,13,285,2,305,"2015"
"28848","230170 AURORA",0,1,5,344,0,350,"2015"
"28849","230180 BAIXIO",0,1,6,73,1,81,"2015"
"28850","230185 BANABUIU",0,0,7,257,5,269,"2015"
"28851","230190 BARBALHA",0,8,23,1020,101,1152,"2015"
"28852","230195 BARREIRA",0,1,7,310,1,319,"2015"
"28853","230200 BARRO",1,1,5,212,0,219,"2015"
"28854","230205 BARROQUINHA",1,0,3,229,0,233,"2015"
"28855","230210 BATURITE",1,2,6,530,1,540,"2015"
"28856","230220 BEBERIBE",0,3,12,678,3,696,"2015"
"28857","230230 BELA CRUZ",0,6,7,438,0,451,"2015"
"28858","230240 BOA VIAGEM",3,2,10,662,3,680,"2015"
"28859","230250 BREJO SANTO",0,7,19,775,2,803,"2015"
"28860","230260 CAMOCIM",2,6,15,887,3,913,"2015"
"28861","230270 CAMPOS SALES",0,3,16,358,2,379,"2015"
"28862","230280 CANINDE",2,4,19,1128,7,1160,"2015"
"28863","230290 CAPISTRANO",0,1,5,288,0,294,"2015"
"28864","230300 CARIDADE",0,0,4,249,0,253,"2015"
"28865","230310 CARIRE",0,5,1,190,2,198,"2015"
"28866","230320 CARIRIACU",0,4,24,342,3,373,"2015"
"28867","230330 CARIUS",0,4,4,201,0,209,"2015"
"28868","230340 CARNAUBAL",0,3,11,223,0,237,"2015"
"28869","230350 CASCAVEL",2,4,14,988,6,1014,"2015"
"28870","230360 CATARINA",0,0,8,148,1,157,"2015"
"28871","230365 CATUNDA",1,2,4,89,0,96,"2015"
"28872","230370 CAUCAIA",14,14,81,5246,41,5396,"2015"
"28873","230380 CEDRO",0,0,17,260,1,278,"2015"
"28874","230390 CHAVAL",0,0,7,182,11,200,"2015"
"28875","230393 CHORO",2,2,3,185,4,196,"2015"
"28876","230395 CHOROZINHO",1,0,6,283,1,291,"2015"
"28877","230400 COREAU",0,1,7,238,2,248,"2015"
"28878","230410 CRATEUS",3,3,24,1049,16,1095,"2015"
"28879","230420 CRATO",9,10,64,2074,11,2168,"2015"
"28880","230423 CROATA",1,3,1,239,0,244,"2015"
"28881","230425 CRUZ",3,1,6,373,1,384,"2015"
"28882","230426 DEPUTADO IRAPUAN PINHEIRO",1,1,3,84,0,89,"2015"
"28883","230427 ERERE",1,0,1,28,0,30,"2015"
"28884","230428 EUSEBIO",1,6,16,1232,3,1258,"2015"
"28885","230430 FARIAS BRITO",1,2,9,290,2,304,"2015"
"28886","230435 FORQUILHA",0,1,5,237,1,244,"2015"
"28887","230440 FORTALEZA",102,162,620,38407,221,39512,"2015"
"28888","230445 FORTIM",0,3,1,207,1,212,"2015"
"28889","230450 FRECHEIRINHA",0,2,4,188,0,194,"2015"
"28890","230460 GENERAL SAMPAIO",0,1,4,78,3,86,"2015"
"28891","230465 GRACA",0,0,2,135,0,137,"2015"
"28892","230470 GRANJA",1,10,23,803,4,841,"2015"
"28893","230480 GRANJEIRO",0,1,2,55,0,58,"2015"
"28894","230490 GROAIRAS",0,0,0,98,0,98,"2015"
"28895","230495 GUAIUBA",0,0,5,311,3,319,"2015"
"28896","230500 GUARACIABA DO NORTE",0,3,23,579,2,607,"2015"
"28897","230510 GUARAMIRANGA",0,0,0,72,1,73,"2015"
"28898","230520 HIDROLANDIA",0,1,3,199,1,204,"2015"
"28899","230523 HORIZONTE",2,1,32,1248,5,1288,"2015"
"28900","230526 IBARETAMA",2,1,3,197,1,204,"2015"
"28901","230530 IBIAPINA",2,2,6,355,3,368,"2015"
"28902","230533 IBICUITINGA",0,0,6,152,0,158,"2015"
"28903","230535 ICAPUI",0,2,3,260,3,268,"2015"
"28904","230540 ICO",4,5,13,877,4,903,"2015"
"28905","230550 IGUATU",5,8,78,1291,9,1391,"2015"
"28906","230560 INDEPENDENCIA",0,0,5,282,5,292,"2015"
"28907","230565 IPAPORANGA",0,1,4,155,0,160,"2015"
"28908","230570 IPAUMIRIM",0,0,4,130,1,135,"2015"
"28909","230580 IPU",1,5,7,556,1,570,"2015"
"28910","230590 IPUEIRAS",0,3,12,463,4,482,"2015"
"28911","230600 IRACEMA",1,0,5,183,0,189,"2015"
"28912","230610 IRAUCUBA",0,1,5,291,0,297,"2015"
"28913","230620 ITAICABA",1,0,1,93,1,96,"2015"
"28914","230625 ITAITINGA",0,2,12,553,3,570,"2015"
"28915","230630 ITAPAGE",3,3,8,745,1,760,"2015"
"28916","230640 ITAPIPOCA",4,9,81,2056,13,2163,"2015"
"28917","230650 ITAPIUNA",2,3,3,271,1,280,"2015"
"28918","230655 ITAREMA",1,1,11,649,9,671,"2015"
"28919","230660 ITATIRA",0,2,4,320,1,327,"2015"
"28920","230670 JAGUARETAMA",1,1,4,189,0,195,"2015"
"28921","230680 JAGUARIBARA",0,2,2,154,1,159,"2015"
"28922","230690 JAGUARIBE",3,3,13,457,4,480,"2015"
"28923","230700 JAGUARUANA",0,2,14,399,3,418,"2015"
"28924","230710 JARDIM",0,4,11,459,19,493,"2015"
"28925","230720 JATI",1,0,5,124,0,130,"2015"
"28926","230725 JIJOCA DE JERICOACOARA",2,3,5,268,0,278,"2015"
"28927","230730 JUAZEIRO DO NORTE",7,23,146,3943,58,4177,"2015"
"28928","230740 JUCAS",1,3,29,307,2,342,"2015"
"28929","230750 LAVRAS DA MANGABEIRA",0,4,6,371,6,387,"2015"
"28930","230760 LIMOEIRO DO NORTE",2,8,21,816,0,847,"2015"
"28931","230763 MADALENA",0,1,7,200,0,208,"2015"
"28932","230765 MARACANAU",12,22,55,4559,24,4672,"2015"
"28933","230770 MARANGUAPE",4,7,16,1485,6,1518,"2015"
"28934","230780 MARCO",1,2,13,481,1,498,"2015"
"28935","230790 MARTINOPOLE",1,3,4,139,3,150,"2015"
"28936","230800 MASSAPE",1,3,8,410,0,422,"2015"
"28937","230810 MAURITI",1,1,13,720,4,739,"2015"
"28938","230820 MERUOCA",1,0,3,169,1,174,"2015"
"28939","230830 MILAGRES",0,3,10,372,7,392,"2015"
"28940","230835 MILHA",0,1,10,158,3,172,"2015"
"28941","230837 MIRAIMA",0,0,7,203,1,211,"2015"
"28942","230840 MISSAO VELHA",0,3,19,566,46,634,"2015"
"28943","230850 MOMBACA",4,2,15,517,3,541,"2015"
"28944","230860 MONSENHOR TABOSA",0,1,8,180,3,192,"2015"
"28945","230870 MORADA NOVA",0,1,6,754,1,762,"2015"
"28946","230880 MORAUJO",1,0,3,101,0,105,"2015"
"28947","230890 MORRINHOS",0,0,5,239,0,244,"2015"
"28948","230900 MUCAMBO",0,2,8,130,0,140,"2015"
"28949","230910 MULUNGU",0,0,2,143,2,147,"2015"
"28950","230920 NOVA OLINDA",1,2,11,272,0,286,"2015"
"28951","230930 NOVA RUSSAS",0,2,8,374,1,385,"2015"
"28952","230940 NOVO ORIENTE",0,2,10,350,3,365,"2015"
"28953","230945 OCARA",1,5,4,320,0,330,"2015"
"28954","230950 OROS",1,2,9,273,0,285,"2015"
"28955","230960 PACAJUS",4,1,22,984,0,1011,"2015"
"28956","230970 PACATUBA",2,4,11,935,2,954,"2015"
"28957","230980 PACOTI",1,1,2,168,1,173,"2015"
"28958","230990 PACUJA",0,0,3,70,0,73,"2015"
"28959","231000 PALHANO",0,0,3,115,0,118,"2015"
"28960","231010 PALMACIA",0,1,3,103,0,107,"2015"
"28961","231020 PARACURU",4,1,7,562,5,579,"2015"
"28962","231025 PARAIPABA",1,6,6,462,4,479,"2015"
"28963","231030 PARAMBU",1,2,14,404,1,422,"2015"
"28964","231040 PARAMOTI",1,0,0,138,2,141,"2015"
"28965","231050 PEDRA BRANCA",0,7,16,481,0,504,"2015"
"28966","231060 PENAFORTE",0,0,4,166,1,171,"2015"
"28967","231070 PENTECOSTE",0,3,12,558,2,575,"2015"
"28968","231080 PEREIRO",1,2,2,186,1,192,"2015"
"28969","231085 PINDORETAMA",1,0,7,289,0,297,"2015"
"28970","231090 PIQUET CARNEIRO",0,0,11,150,1,162,"2015"
"28971","231095 PIRES FERREIRA",0,0,3,97,1,101,"2015"
"28972","231100 PORANGA",1,0,7,158,1,167,"2015"
"28973","231110 PORTEIRAS",0,1,10,229,0,240,"2015"
"28974","231120 POTENGI",1,1,1,133,1,137,"2015"
"28975","231123 POTIRETAMA",1,1,0,72,0,74,"2015"
"28976","231126 QUITERIANOPOLIS",1,2,11,242,3,259,"2015"
"28977","231130 QUIXADA",2,4,20,1238,10,1274,"2015"
"28978","231135 QUIXELO",1,0,10,213,0,224,"2015"
"28979","231140 QUIXERAMOBIM",3,4,54,1116,7,1184,"2015"
"28980","231150 QUIXERE",1,4,2,313,0,320,"2015"
"28981","231160 REDENCAO",1,4,7,436,5,453,"2015"
"28982","231170 RERIUTABA",0,1,2,198,0,201,"2015"
"28983","231180 RUSSAS",3,5,33,1034,4,1079,"2015"
"28984","231190 SABOEIRO",0,3,14,176,1,194,"2015"
"28985","231195 SALITRE",2,2,9,256,1,270,"2015"
"28986","231200 SANTANA DO ACARAU",0,0,5,351,1,357,"2015"
"28987","231210 SANTANA DO CARIRI",0,3,8,223,3,237,"2015"
"28988","231220 SANTA QUITERIA",1,0,4,369,1,375,"2015"
"28989","231230 SAO BENEDITO",2,5,24,749,1,781,"2015"
"28990","231240 SAO GONCALO DO AMARANTE",1,3,20,901,6,931,"2015"
"28991","231250 SAO JOAO DO JAGUARIBE",0,2,2,69,0,73,"2015"
"28992","231260 SAO LUIS DO CURU",1,0,3,171,4,179,"2015"
"28993","231270 SENADOR POMPEU",0,0,9,300,1,310,"2015"
"28994","231280 SENADOR SA",0,0,2,63,3,68,"2015"
"28995","231290 SOBRAL",12,12,63,3368,13,3468,"2015"
"28996","231300 SOLONOPOLE",1,2,3,190,0,196,"2015"
"28997","231310 TABULEIRO DO NORTE",1,3,11,386,1,402,"2015"
"28998","231320 TAMBORIL",1,5,8,324,1,339,"2015"
"28999","231325 TARRAFAS",0,0,1,85,0,86,"2015"
"29000","231330 TAUA",0,5,44,659,6,714,"2015"
"29001","231335 TEJUCUOCA",1,1,2,243,1,248,"2015"
"29002","231340 TIANGUA",4,5,32,1324,7,1372,"2015"
"29003","231350 TRAIRI",1,4,23,682,1,711,"2015"
"29004","231355 TURURU",0,2,11,291,2,306,"2015"
"29005","231360 UBAJARA",2,9,14,445,1,471,"2015"
"29006","231370 UMARI",0,1,2,93,0,96,"2015"
"29007","231375 UMIRIM",0,0,12,288,0,300,"2015"
"29008","231380 URUBURETAMA",0,7,8,345,1,361,"2015"
"29009","231390 URUOCA",0,2,4,120,0,126,"2015"
"29010","231395 VARJOTA",0,0,1,206,1,208,"2015"
"29011","231400 VARZEA ALEGRE",0,3,11,530,2,546,"2015"
"29012","231410 VICOSA DO CEARA",2,5,27,928,7,969,"2015"
"29013","240010 ACARI",0,1,6,142,1,150,"2015"
"29014","240020 ACU",4,4,7,775,3,793,"2015"
"29015","240030 AFONSO BEZERRA",0,1,2,129,2,134,"2015"
"29016","240040 AGUA NOVA",0,0,0,42,0,42,"2015"
"29017","240050 ALEXANDRIA",0,1,1,157,0,159,"2015"
"29018","240060 ALMINO AFONSO",0,0,0,65,0,65,"2015"
"29019","240070 ALTO DO RODRIGUES",0,0,7,187,0,194,"2015"
"29020","240080 ANGICOS",0,1,1,143,2,147,"2015"
"29021","240090 ANTONIO MARTINS",0,0,1,109,0,110,"2015"
"29022","240100 APODI",1,2,4,431,0,438,"2015"
"29023","240110 AREIA BRANCA",0,3,6,400,5,414,"2015"
"29024","240120 ARES",0,2,4,196,0,202,"2015"
"29025","240130 AUGUSTO SEVERO",0,1,5,111,2,119,"2015"
"29026","240140 BAIA FORMOSA",1,1,5,106,2,115,"2015"
"29027","240145 BARAUNA",1,3,3,428,2,437,"2015"
"29028","240150 BARCELONA",1,0,3,41,1,46,"2015"
"29029","240160 BENTO FERNANDES",0,0,1,61,1,63,"2015"
"29030","240165 BODO",0,0,5,43,1,49,"2015"
"29031","240170 BOM JESUS",0,0,4,108,1,113,"2015"
"29032","240180 BREJINHO",1,1,3,173,1,179,"2015"
"29033","240185 CAICARA DO NORTE",0,2,2,84,4,92,"2015"
"29034","240190 CAICARA DO RIO DO VENTO",0,0,1,54,0,55,"2015"
"29035","240200 CAICO",0,8,31,707,1,747,"2015"
"29036","240210 CAMPO REDONDO",2,0,2,141,0,145,"2015"
"29037","240220 CANGUARETAMA",3,2,9,533,2,549,"2015"
"29038","240230 CARAUBAS",0,2,6,252,2,262,"2015"
"29039","240240 CARNAUBA DOS DANTAS",0,0,5,91,0,96,"2015"
"29040","240250 CARNAUBAIS",0,0,0,141,0,141,"2015"
"29041","240260 CEARA-MIRIM",3,5,25,1194,7,1234,"2015"
"29042","240270 CERRO CORA",1,1,4,118,2,126,"2015"
"29043","240280 CORONEL EZEQUIEL",1,0,2,92,1,96,"2015"
"29044","240290 CORONEL JOAO PESSOA",1,0,0,60,0,61,"2015"
"29045","240300 CRUZETA",0,0,7,88,0,95,"2015"
"29046","240310 CURRAIS NOVOS",0,2,34,485,0,521,"2015"
"29047","240320 DOUTOR SEVERIANO",0,0,0,96,0,96,"2015"
"29048","240325 PARNAMIRIM",13,12,55,4058,11,4149,"2015"
"29049","240330 ENCANTO",1,1,0,79,0,81,"2015"
"29050","240340 EQUADOR",0,1,2,64,0,67,"2015"
"29051","240350 ESPIRITO SANTO",1,0,1,108,0,110,"2015"
"29052","240360 EXTREMOZ",3,5,18,541,1,568,"2015"
"29053","240370 FELIPE GUERRA",0,0,1,74,0,75,"2015"
"29054","240375 FERNANDO PEDROZA",0,0,1,43,1,45,"2015"
"29055","240380 FLORANIA",0,0,8,109,2,119,"2015"
"29056","240390 FRANCISCO DANTAS",3,0,0,24,0,27,"2015"
"29057","240400 FRUTUOSO GOMES",0,0,0,57,0,57,"2015"
"29058","240410 GALINHOS",0,0,0,39,0,39,"2015"
"29059","240420 GOIANINHA",0,1,9,482,5,497,"2015"
"29060","240430 GOVERNADOR DIX-SEPT ROSADO",0,0,1,162,1,164,"2015"
"29061","240440 GROSSOS",1,0,2,124,3,130,"2015"
"29062","240450 GUAMARE",2,2,10,283,1,298,"2015"
"29063","240460 IELMO MARINHO",0,1,0,137,1,139,"2015"
"29064","240470 IPANGUACU",0,0,3,235,0,238,"2015"
"29065","240480 IPUEIRA",0,0,0,21,0,21,"2015"
"29066","240485 ITAJA",0,0,2,112,0,114,"2015"
"29067","240490 ITAU",0,0,2,63,0,65,"2015"
"29068","240500 JACANA",0,0,1,111,1,113,"2015"
"29069","240510 JANDAIRA",0,0,0,99,2,101,"2015"
"29070","240520 JANDUIS",0,0,2,59,1,62,"2015"
"29071","240530 JANUARIO CICCO",1,1,2,112,1,117,"2015"
"29072","240540 JAPI",0,0,3,93,0,96,"2015"
"29073","240550 JARDIM DE ANGICOS",0,0,0,25,1,26,"2015"
"29074","240560 JARDIM DE PIRANHAS",0,3,15,163,0,181,"2015"
"29075","240570 JARDIM DO SERIDO",1,1,2,118,0,122,"2015"
"29076","240580 JOAO CAMARA",0,5,5,506,6,522,"2015"
"29077","240590 JOAO DIAS",1,0,1,22,0,24,"2015"
"29078","240600 JOSE DA PENHA",0,0,1,68,0,69,"2015"
"29079","240610 JUCURUTU",2,0,7,251,3,263,"2015"
"29080","240615 JUNDIA",0,0,2,27,1,30,"2015"
"29081","240620 LAGOA D'ANTA",0,0,2,76,3,81,"2015"
"29082","240630 LAGOA DE PEDRAS",1,1,1,100,0,103,"2015"
"29083","240640 LAGOA DE VELHOS",0,0,1,33,0,34,"2015"
"29084","240650 LAGOA NOVA",0,2,20,227,0,249,"2015"
"29085","240660 LAGOA SALGADA",0,1,4,135,0,140,"2015"
"29086","240670 LAJES",0,1,3,138,3,145,"2015"
"29087","240680 LAJES PINTADAS",0,0,1,66,2,69,"2015"
"29088","240690 LUCRECIA",0,0,1,46,2,49,"2015"
"29089","240700 LUIS GOMES",0,0,2,169,1,172,"2015"
"29090","240710 MACAIBA",1,5,22,942,12,982,"2015"
"29091","240720 MACAU",2,0,6,415,3,426,"2015"
"29092","240725 MAJOR SALES",0,0,0,54,0,54,"2015"
"29093","240730 MARCELINO VIEIRA",1,0,0,105,0,106,"2015"
"29094","240740 MARTINS",0,0,0,76,0,76,"2015"
"29095","240750 MAXARANGUAPE",1,0,2,150,3,156,"2015"
"29096","240760 MESSIAS TARGINO",0,0,0,52,0,52,"2015"
"29097","240770 MONTANHAS",4,0,3,165,3,175,"2015"
"29098","240780 MONTE ALEGRE",2,3,2,267,3,277,"2015"
"29099","240790 MONTE DAS GAMELEIRAS",0,0,1,40,1,42,"2015"
"29100","240800 MOSSORO",7,18,31,3976,24,4056,"2015"
"29101","240810 NATAL",40,46,150,11967,36,12239,"2015"
"29102","240820 NISIA FLORESTA",0,0,14,376,3,393,"2015"
"29103","240830 NOVA CRUZ",1,0,10,477,4,492,"2015"
"29104","240840 OLHO-D'AGUA DO BORGES",0,0,1,41,0,42,"2015"
"29105","240850 OURO BRANCO",0,0,3,56,0,59,"2015"
"29106","240860 PARANA",0,0,1,70,0,71,"2015"
"29107","240870 PARAU",1,0,0,41,2,44,"2015"
"29108","240880 PARAZINHO",0,0,2,61,1,64,"2015"
"29109","240890 PARELHAS",1,1,12,347,1,362,"2015"
"29110","240895 RIO DO FOGO",1,0,6,154,1,162,"2015"
"29111","240910 PASSA E FICA",0,0,4,160,2,166,"2015"
"29112","240920 PASSAGEM",0,0,0,42,0,42,"2015"
"29113","240930 PATU",0,1,0,142,0,143,"2015"
"29114","240933 SANTA MARIA",0,0,3,86,0,89,"2015"
"29115","240940 PAU DOS FERROS",2,3,2,468,0,475,"2015"
"29116","240950 PEDRA GRANDE",0,0,0,59,0,59,"2015"
"29117","240960 PEDRA PRETA",0,1,1,30,0,32,"2015"
"29118","240970 PEDRO AVELINO",1,2,2,74,5,84,"2015"
"29119","240980 PEDRO VELHO",2,0,3,218,2,225,"2015"
"29120","240990 PENDENCIAS",3,0,2,197,3,205,"2015"
"29121","241000 PILOES",0,0,0,51,0,51,"2015"
"29122","241010 POCO BRANCO",0,0,9,159,2,170,"2015"
"29123","241020 PORTALEGRE",0,0,0,90,0,90,"2015"
"29124","241025 PORTO DO MANGUE",0,0,1,87,0,88,"2015"
"29125","241030 SERRA CAIADA",1,0,9,151,4,165,"2015"
"29126","241040 PUREZA",0,1,1,118,3,123,"2015"
"29127","241050 RAFAEL FERNANDES",1,0,0,51,0,52,"2015"
"29128","241060 RAFAEL GODEIRO",0,0,0,44,1,45,"2015"
"29129","241070 RIACHO DA CRUZ",0,0,0,31,1,32,"2015"
"29130","241080 RIACHO DE SANTANA",0,0,0,60,0,60,"2015"
"29131","241090 RIACHUELO",0,0,5,107,1,113,"2015"
"29132","241100 RODOLFO FERNANDES",0,0,2,85,0,87,"2015"
"29133","241105 TIBAU",0,1,1,61,0,63,"2015"
"29134","241110 RUY BARBOSA",0,0,1,27,0,28,"2015"
"29135","241120 SANTA CRUZ",1,9,8,577,2,597,"2015"
"29136","241140 SANTANA DO MATOS",0,0,1,135,2,138,"2015"
"29137","241142 SANTANA DO SERIDO",0,0,0,29,0,29,"2015"
"29138","241150 SANTO ANTONIO",4,0,8,332,5,349,"2015"
"29139","241160 SAO BENTO DO NORTE",0,0,1,43,0,44,"2015"
"29140","241170 SAO BENTO DO TRAIRI",1,1,2,71,1,76,"2015"
"29141","241180 SAO FERNANDO",0,1,2,29,2,34,"2015"
"29142","241190 SAO FRANCISCO DO OESTE",0,0,0,63,0,63,"2015"
"29143","241200 SAO GONCALO DO AMARANTE",1,7,26,1685,5,1724,"2015"
"29144","241210 SAO JOAO DO SABUGI",0,0,4,65,0,69,"2015"
"29145","241220 SAO JOSE DE MIPIBU",8,5,5,783,1,802,"2015"
"29146","241230 SAO JOSE DO CAMPESTRE",3,1,1,173,4,182,"2015"
"29147","241240 SAO JOSE DO SERIDO",0,0,2,54,1,57,"2015"
"29148","241250 SAO MIGUEL",1,2,1,354,0,358,"2015"
"29149","241255 SAO MIGUEL DO GOSTOSO",0,0,4,82,2,88,"2015"
"29150","241260 SAO PAULO DO POTENGI",0,0,5,190,2,197,"2015"
"29151","241270 SAO PEDRO",0,0,1,89,1,91,"2015"
"29152","241280 SAO RAFAEL",0,0,0,82,0,82,"2015"
"29153","241290 SAO TOME",0,2,1,121,0,124,"2015"
"29154","241300 SAO VICENTE",1,2,3,63,0,69,"2015"
"29155","241310 SENADOR ELOI DE SOUZA",0,0,2,71,1,74,"2015"
"29156","241320 SENADOR GEORGINO AVELINO",0,0,1,67,1,69,"2015"
"29157","241330 SERRA DE SAO BENTO",1,1,2,72,1,77,"2015"
"29158","241335 SERRA DO MEL",0,0,0,189,0,189,"2015"
"29159","241340 SERRA NEGRA DO NORTE",0,0,4,71,0,75,"2015"
"29160","241350 SERRINHA",1,0,3,91,0,95,"2015"
"29161","241355 SERRINHA DOS PINTOS",0,0,0,47,0,47,"2015"
"29162","241360 SEVERIANO MELO",1,0,1,79,1,82,"2015"
"29163","241370 SITIO NOVO",0,0,2,53,0,55,"2015"
"29164","241380 TABOLEIRO GRANDE",0,0,0,30,0,30,"2015"
"29165","241390 TAIPU",0,1,2,161,1,165,"2015"
"29166","241400 TANGARA",0,1,6,226,3,236,"2015"
"29167","241410 TENENTE ANANIAS",2,0,2,146,0,150,"2015"
"29168","241415 TENENTE LAURENTINO CRUZ",0,0,4,84,0,88,"2015"
"29169","241420 TIBAU DO SUL",1,0,3,214,2,220,"2015"
"29170","241430 TIMBAUBA DOS BATISTAS",0,0,0,19,0,19,"2015"
"29171","241440 TOUROS",0,4,8,457,1,470,"2015"
"29172","241445 TRIUNFO POTIGUAR",0,0,0,53,0,53,"2015"
"29173","241450 UMARIZAL",0,0,1,105,2,108,"2015"
"29174","241460 UPANEMA",0,2,3,184,3,192,"2015"
"29175","241470 VARZEA",0,0,0,66,0,66,"2015"
"29176","241475 VENHA-VER",0,1,0,52,0,53,"2015"
"29177","241480 VERA CRUZ",2,1,3,159,0,165,"2015"
"29178","241490 VICOSA",0,0,0,28,0,28,"2015"
"29179","241500 VILA FLOR",0,0,0,47,0,47,"2015"
"29180","250010 AGUA BRANCA",1,3,4,98,5,111,"2015"
"29181","250020 AGUIAR",0,0,1,63,6,70,"2015"
"29182","250030 ALAGOA GRANDE",2,1,5,357,2,367,"2015"
"29183","250040 ALAGOA NOVA",0,2,5,329,3,339,"2015"
"29184","250050 ALAGOINHA",0,2,4,236,2,244,"2015"
"29185","250053 ALCANTIL",0,0,1,103,6,110,"2015"
"29186","250057 ALGODAO DE JANDAIRA",0,0,0,50,1,51,"2015"
"29187","250060 ALHANDRA",2,2,11,394,3,412,"2015"
"29188","250070 SAO JOAO DO RIO DO PEIXE",0,2,4,169,0,175,"2015"
"29189","250073 AMPARO",0,0,0,43,1,44,"2015"
"29190","250077 APARECIDA",0,1,2,121,3,127,"2015"
"29191","250080 ARACAGI",0,0,3,198,3,204,"2015"
"29192","250090 ARARA",0,1,2,162,0,165,"2015"
"29193","250100 ARARUNA",1,1,4,185,3,194,"2015"
"29194","250110 AREIA",0,4,10,368,1,383,"2015"
"29195","250115 AREIA DE BARAUNAS",0,0,2,24,1,27,"2015"
"29196","250120 AREIAL",0,0,4,104,0,108,"2015"
"29197","250130 AROEIRAS",0,0,4,263,4,271,"2015"
"29198","250135 ASSUNCAO",1,0,1,76,0,78,"2015"
"29199","250140 BAIA DA TRAICAO",0,0,2,165,1,168,"2015"
"29200","250150 BANANEIRAS",2,1,1,265,1,270,"2015"
"29201","250153 BARAUNA",0,1,1,51,0,53,"2015"
"29202","250157 BARRA DE SANTANA",0,2,2,89,2,95,"2015"
"29203","250160 BARRA DE SANTA ROSA",0,0,3,145,0,148,"2015"
"29204","250170 BARRA DE SAO MIGUEL",1,0,2,86,2,91,"2015"
"29205","250180 BAYEUX",4,8,26,1354,2,1394,"2015"
"29206","250190 BELEM",1,1,10,223,0,235,"2015"
"29207","250200 BELEM DO BREJO DO CRUZ",0,1,0,99,0,100,"2015"
"29208","250205 BERNARDINO BATISTA",0,1,1,54,1,57,"2015"
"29209","250210 BOA VENTURA",0,0,1,69,1,71,"2015"
"29210","250215 BOA VISTA",1,0,1,88,0,90,"2015"
"29211","250220 BOM JESUS",0,0,0,37,0,37,"2015"
"29212","250230 BOM SUCESSO",0,0,1,44,0,45,"2015"
"29213","250240 BONITO DE SANTA FE",0,1,3,147,1,152,"2015"
"29214","250250 BOQUEIRAO",1,1,7,281,1,291,"2015"
"29215","250260 IGARACY",1,1,2,72,7,83,"2015"
"29216","250270 BORBOREMA",0,0,1,84,0,85,"2015"
"29217","250280 BREJO DO CRUZ",2,0,5,199,1,207,"2015"
"29218","250290 BREJO DOS SANTOS",0,0,0,83,0,83,"2015"
"29219","250300 CAAPORA",0,2,9,438,1,450,"2015"
"29220","250310 CABACEIRAS",0,0,2,49,1,52,"2015"
"29221","250320 CABEDELO",0,3,16,918,0,937,"2015"
"29222","250330 CACHOEIRA DOS INDIOS",0,1,3,146,1,151,"2015"
"29223","250340 CACIMBA DE AREIA",0,0,3,63,1,67,"2015"
"29224","250350 CACIMBA DE DENTRO",2,1,6,214,1,224,"2015"
"29225","250355 CACIMBAS",1,2,5,112,11,131,"2015"
"29226","250360 CAICARA",0,1,0,92,1,94,"2015"
"29227","250370 CAJAZEIRAS",4,7,19,943,2,975,"2015"
"29228","250375 CAJAZEIRINHAS",0,0,0,48,1,49,"2015"
"29229","250380 CALDAS BRANDAO",0,1,1,107,1,110,"2015"
"29230","250390 CAMALAU",0,2,0,95,0,97,"2015"
"29231","250400 CAMPINA GRANDE",23,17,103,6461,6,6610,"2015"
"29232","250403 CAPIM",0,0,1,94,1,96,"2015"
"29233","250407 CARAUBAS",0,0,0,57,1,58,"2015"
"29234","250410 CARRAPATEIRA",0,1,2,20,0,23,"2015"
"29235","250415 CASSERENGUE",0,1,2,76,0,79,"2015"
"29236","250420 CATINGUEIRA",0,1,4,67,5,77,"2015"
"29237","250430 CATOLE DO ROCHA",2,1,8,392,2,405,"2015"
"29238","250435 CATURITE",1,1,1,74,0,77,"2015"
"29239","250440 CONCEICAO",0,1,6,236,3,246,"2015"
"29240","250450 CONDADO",0,1,1,71,5,78,"2015"
"29241","250460 CONDE",0,2,8,479,1,490,"2015"
"29242","250470 CONGO",1,1,0,74,0,76,"2015"
"29243","250480 COREMAS",1,2,9,199,12,223,"2015"
"29244","250485 COXIXOLA",0,0,0,22,0,22,"2015"
"29245","250490 CRUZ DO ESPIRITO SANTO",1,0,8,247,0,256,"2015"
"29246","250500 CUBATI",0,0,2,108,0,110,"2015"
"29247","250510 CUITE",0,1,6,293,1,301,"2015"
"29248","250520 CUITEGI",0,1,1,101,0,103,"2015"
"29249","250523 CUITE DE MAMANGUAPE",0,1,3,75,0,79,"2015"
"29250","250527 CURRAL DE CIMA",0,1,0,67,0,68,"2015"
"29251","250530 CURRAL VELHO",0,0,0,26,0,26,"2015"
"29252","250535 DAMIAO",0,3,1,69,0,73,"2015"
"29253","250540 DESTERRO",0,1,2,119,4,126,"2015"
"29254","250550 VISTA SERRANA",0,0,0,35,3,38,"2015"
"29255","250560 DIAMANTE",0,0,1,92,2,95,"2015"
"29256","250570 DONA INES",0,1,4,144,1,150,"2015"
"29257","250580 DUAS ESTRADAS",0,1,0,56,0,57,"2015"
"29258","250590 EMAS",1,0,0,40,1,42,"2015"
"29259","250600 ESPERANCA",0,4,6,513,2,525,"2015"
"29260","250610 FAGUNDES",0,1,2,153,1,157,"2015"
"29261","250620 FREI MARTINHO",0,0,0,28,0,28,"2015"
"29262","250625 GADO BRAVO",0,0,2,147,0,149,"2015"
"29263","250630 GUARABIRA",1,4,10,885,3,903,"2015"
"29264","250640 GURINHEM",1,1,6,210,8,226,"2015"
"29265","250650 GURJAO",0,0,1,53,0,54,"2015"
"29266","250660 IBIARA",0,0,1,66,0,67,"2015"
"29267","250670 IMACULADA",0,6,6,123,5,140,"2015"
"29268","250680 INGA",2,2,5,240,0,249,"2015"
"29269","250690 ITABAIANA",0,1,11,363,6,381,"2015"
"29270","250700 ITAPORANGA",0,2,10,339,7,358,"2015"
"29271","250710 ITAPOROROCA",0,2,4,206,9,221,"2015"
"29272","250720 ITATUBA",0,0,3,171,1,175,"2015"
"29273","250730 JACARAU",0,1,4,209,1,215,"2015"
"29274","250740 JERICO",0,1,2,83,1,87,"2015"
"29275","250750 JOAO PESSOA",18,57,186,12008,30,12299,"2015"
"29276","250760 JUAREZ TAVORA",1,0,4,115,0,120,"2015"
"29277","250770 JUAZEIRINHO",0,1,2,311,1,315,"2015"
"29278","250780 JUNCO DO SERIDO",1,0,0,85,0,86,"2015"
"29279","250790 JURIPIRANGA",0,0,5,193,7,205,"2015"
"29280","250800 JURU",0,0,4,139,0,143,"2015"
"29281","250810 LAGOA",0,0,0,58,0,58,"2015"
"29282","250820 LAGOA DE DENTRO",0,1,3,122,1,127,"2015"
"29283","250830 LAGOA SECA",1,0,6,419,0,426,"2015"
"29284","250840 LASTRO",0,0,2,45,1,48,"2015"
"29285","250850 LIVRAMENTO",0,2,3,86,1,92,"2015"
"29286","250855 LOGRADOURO",0,0,3,62,3,68,"2015"
"29287","250860 LUCENA",0,0,0,201,2,203,"2015"
"29288","250870 MAE D'AGUA",0,1,0,51,0,52,"2015"
"29289","250880 MALTA",0,1,3,70,3,77,"2015"
"29290","250890 MAMANGUAPE",0,6,12,768,8,794,"2015"
"29291","250900 MANAIRA",1,1,2,155,2,161,"2015"
"29292","250905 MARCACAO",4,0,1,152,5,162,"2015"
"29293","250910 MARI",0,1,2,244,0,247,"2015"
"29294","250915 MARIZOPOLIS",0,0,3,91,0,94,"2015"
"29295","250920 MASSARANDUBA",1,1,3,175,0,180,"2015"
"29296","250930 MATARACA",2,0,3,156,0,161,"2015"
"29297","250933 MATINHAS",0,2,2,79,0,83,"2015"
"29298","250937 MATO GROSSO",0,0,2,30,0,32,"2015"
"29299","250939 MATUREIA",0,2,3,99,5,109,"2015"
"29300","250940 MOGEIRO",1,1,3,216,3,224,"2015"
"29301","250950 MONTADAS",0,0,2,74,0,76,"2015"
"29302","250960 MONTE HOREBE",2,1,0,62,0,65,"2015"
"29303","250970 MONTEIRO",0,4,9,484,0,497,"2015"
"29304","250980 MULUNGU",0,1,1,116,1,119,"2015"
"29305","250990 NATUBA",0,0,2,96,0,98,"2015"
"29306","251000 NAZAREZINHO",0,0,0,99,1,100,"2015"
"29307","251010 NOVA FLORESTA",0,0,2,144,0,146,"2015"
"29308","251020 NOVA OLINDA",0,0,2,88,6,96,"2015"
"29309","251030 NOVA PALMEIRA",0,0,1,40,0,41,"2015"
"29310","251040 OLHO D'AGUA",0,1,3,79,6,89,"2015"
"29311","251050 OLIVEDOS",0,0,1,47,0,48,"2015"
"29312","251060 OURO VELHO",0,1,0,38,0,39,"2015"
"29313","251065 PARARI",0,0,0,18,0,18,"2015"
"29314","251070 PASSAGEM",0,1,0,29,2,32,"2015"
"29315","251080 PATOS",4,11,41,1494,40,1590,"2015"
"29316","251090 PAULISTA",0,0,1,134,1,136,"2015"
"29317","251100 PEDRA BRANCA",0,0,0,55,3,58,"2015"
"29318","251110 PEDRA LAVRADA",0,1,2,82,0,85,"2015"
"29319","251120 PEDRAS DE FOGO",2,3,7,470,0,482,"2015"
"29320","251130 PIANCO",1,2,3,186,16,208,"2015"
"29321","251140 PICUI",0,1,5,266,0,272,"2015"
"29322","251150 PILAR",0,1,4,162,4,171,"2015"
"29323","251160 PILOES",1,0,2,147,3,153,"2015"
"29324","251170 PILOEZINHOS",0,0,3,72,1,76,"2015"
"29325","251180 PIRPIRITUBA",1,2,3,131,1,138,"2015"
"29326","251190 PITIMBU",1,0,8,284,0,293,"2015"
"29327","251200 POCINHOS",0,5,3,299,1,308,"2015"
"29328","251203 POCO DANTAS",0,2,2,74,0,78,"2015"
"29329","251207 POCO DE JOSE DE MOURA",0,0,1,41,0,42,"2015"
"29330","251210 POMBAL",0,2,4,453,1,460,"2015"
"29331","251220 PRATA",1,0,0,57,0,58,"2015"
"29332","251230 PRINCESA ISABEL",0,2,10,245,2,259,"2015"
"29333","251240 PUXINANA",0,0,3,158,1,162,"2015"
"29334","251250 QUEIMADAS",0,4,15,697,17,733,"2015"
"29335","251260 QUIXABA",0,1,3,31,1,36,"2015"
"29336","251270 REMIGIO",0,0,5,263,0,268,"2015"
"29337","251272 PEDRO REGIS",0,1,3,55,2,61,"2015"
"29338","251274 RIACHAO",0,0,3,58,0,61,"2015"
"29339","251275 RIACHAO DO BACAMARTE",0,0,2,75,0,77,"2015"
"29340","251276 RIACHAO DO POCO",0,0,2,65,2,69,"2015"
"29341","251278 RIACHO DE SANTO ANTONIO",0,0,0,41,0,41,"2015"
"29342","251280 RIACHO DOS CAVALOS",0,0,3,127,0,130,"2015"
"29343","251290 RIO TINTO",0,1,2,319,1,323,"2015"
"29344","251300 SALGADINHO",0,0,0,44,1,45,"2015"
"29345","251310 SALGADO DE SAO FELIX",0,1,1,111,3,116,"2015"
"29346","251315 SANTA CECILIA",0,0,1,84,0,85,"2015"
"29347","251320 SANTA CRUZ",0,0,1,71,0,72,"2015"
"29348","251330 SANTA HELENA",1,1,0,68,0,70,"2015"
"29349","251335 SANTA INES",0,0,0,43,1,44,"2015"
"29350","251340 SANTA LUZIA",0,1,5,224,3,233,"2015"
"29351","251350 SANTANA DE MANGUEIRA",0,0,0,60,1,61,"2015"
"29352","251360 SANTANA DOS GARROTES",1,1,2,68,10,82,"2015"
"29353","251365 JOCA CLAUDINO",0,0,0,20,0,20,"2015"
"29354","251370 SANTA RITA",3,5,51,2077,5,2141,"2015"
"29355","251380 SANTA TERESINHA",0,0,1,58,0,59,"2015"
"29356","251385 SANTO ANDRE",0,0,0,28,0,28,"2015"
"29357","251390 SAO BENTO",0,2,6,454,1,463,"2015"
"29358","251392 SAO BENTINHO",0,0,1,66,0,67,"2015"
"29359","251394 SAO DOMINGOS DO CARIRI",0,0,0,34,1,35,"2015"
"29360","251396 SAO DOMINGOS",0,0,0,34,1,35,"2015"
"29361","251398 SAO FRANCISCO",1,0,0,46,0,47,"2015"
"29362","251400 SAO JOAO DO CARIRI",0,0,2,49,1,52,"2015"
"29363","251410 SAO JOAO DO TIGRE",1,1,0,49,0,51,"2015"
"29364","251420 SAO JOSE DA LAGOA TAPADA",0,2,0,110,2,114,"2015"
"29365","251430 SAO JOSE DE CAIANA",0,0,2,86,1,89,"2015"
"29366","251440 SAO JOSE DE ESPINHARAS",0,0,1,48,1,50,"2015"
"29367","251445 SAO JOSE DOS RAMOS",0,0,2,74,2,78,"2015"
"29368","251450 SAO JOSE DE PIRANHAS",0,1,3,301,2,307,"2015"
"29369","251455 SAO JOSE DE PRINCESA",0,1,1,28,0,30,"2015"
"29370","251460 SAO JOSE DO BONFIM",0,0,2,42,2,46,"2015"
"29371","251465 SAO JOSE DO BREJO DO CRUZ",1,0,1,25,0,27,"2015"
"29372","251470 SAO JOSE DO SABUGI",0,1,0,40,2,43,"2015"
"29373","251480 SAO JOSE DOS CORDEIROS",0,1,1,43,0,45,"2015"
"29374","251490 SAO MAMEDE",1,3,3,94,3,104,"2015"
"29375","251500 SAO MIGUEL DE TAIPU",0,0,1,83,0,84,"2015"
"29376","251510 SAO SEBASTIAO DE LAGOA DE ROCA",0,0,1,167,1,169,"2015"
"29377","251520 SAO SEBASTIAO DO UMBUZEIRO",0,0,0,43,0,43,"2015"
"29378","251530 SAPE",1,3,8,591,0,603,"2015"
"29379","251540 SAO VICENTE DO SERIDO",0,0,2,170,1,173,"2015"
"29380","251550 SERRA BRANCA",0,0,3,154,1,158,"2015"
"29381","251560 SERRA DA RAIZ",0,0,0,47,1,48,"2015"
"29382","251570 SERRA GRANDE",0,0,3,43,0,46,"2015"
"29383","251580 SERRA REDONDA",0,1,2,102,0,105,"2015"
"29384","251590 SERRARIA",0,0,1,70,1,72,"2015"
"29385","251593 SERTAOZINHO",0,0,3,73,0,76,"2015"
"29386","251597 SOBRADO",0,0,5,96,0,101,"2015"
"29387","251600 SOLANEA",1,0,3,369,3,376,"2015"
"29388","251610 SOLEDADE",2,0,1,234,1,238,"2015"
"29389","251615 SOSSEGO",0,0,0,46,0,46,"2015"
"29390","251620 SOUSA",2,5,17,944,6,974,"2015"
"29391","251630 SUME",0,1,0,235,2,238,"2015"
"29392","251640 TACIMA",1,0,2,88,0,91,"2015"
"29393","251650 TAPEROA",1,5,8,216,6,236,"2015"
"29394","251660 TAVARES",1,2,4,195,4,206,"2015"
"29395","251670 TEIXEIRA",0,3,7,230,11,251,"2015"
"29396","251675 TENORIO",0,0,0,41,0,41,"2015"
"29397","251680 TRIUNFO",0,2,2,98,0,102,"2015"
"29398","251690 UIRAUNA",0,2,2,173,0,177,"2015"
"29399","251700 UMBUZEIRO",0,1,1,111,5,118,"2015"
"29400","251710 VARZEA",1,0,2,31,0,34,"2015"
"29401","251720 VIEIROPOLIS",0,0,5,52,1,58,"2015"
"29402","251740 ZABELE",0,0,0,37,0,37,"2015"
"29403","MUNICIPIO IGNORADO - PE",0,0,0,2,0,2,"2015"
"29404","260005 ABREU E LIMA",9,5,14,1588,12,1628,"2015"
"29405","260010 AFOGADOS DA INGAZEIRA",2,2,5,657,0,666,"2015"
"29406","260020 AFRANIO",0,4,5,135,125,269,"2015"
"29407","260030 AGRESTINA",1,0,2,354,0,357,"2015"
"29408","260040 AGUA PRETA",10,1,5,525,5,546,"2015"
"29409","260050 AGUAS BELAS",3,4,18,745,4,774,"2015"
"29410","260060 ALAGOINHA",0,0,2,175,2,179,"2015"
"29411","260070 ALIANCA",3,5,12,545,5,570,"2015"
"29412","260080 ALTINHO",0,1,7,246,0,254,"2015"
"29413","260090 AMARAJI",1,8,9,320,1,339,"2015"
"29414","260100 ANGELIM",0,0,1,160,3,164,"2015"
"29415","260105 ARACOIABA",0,1,6,333,2,342,"2015"
"29416","260110 ARARIPINA",4,7,26,1588,0,1625,"2015"
"29417","260120 ARCOVERDE",9,8,11,1077,5,1110,"2015"
"29418","260130 BARRA DE GUABIRABA",1,0,0,185,0,186,"2015"
"29419","260140 BARREIROS",11,0,11,755,2,779,"2015"
"29420","260150 BELEM DE MARIA",1,0,2,166,0,169,"2015"
"29421","260160 BELEM DE SAO FRANCISCO",5,0,11,297,1,314,"2015"
"29422","260170 BELO JARDIM",4,6,19,1021,13,1063,"2015"
"29423","260180 BETANIA",1,3,12,160,1,177,"2015"
"29424","260190 BEZERROS",2,5,15,763,2,787,"2015"
"29425","260200 BODOCO",1,1,7,529,7,545,"2015"
"29426","260210 BOM CONSELHO",4,1,11,628,8,652,"2015"
"29427","260220 BOM JARDIM",4,0,5,481,6,496,"2015"
"29428","260230 BONITO",0,4,9,585,4,602,"2015"
"29429","260240 BREJAO",1,2,3,194,3,203,"2015"
"29430","260250 BREJINHO",0,0,0,89,1,90,"2015"
"29431","260260 BREJO DA MADRE DE DEUS",2,3,4,663,0,672,"2015"
"29432","260270 BUENOS AIRES",1,3,4,205,2,215,"2015"
"29433","260280 BUIQUE",3,9,9,879,3,903,"2015"
"29434","260290 CABO DE SANTO AGOSTINHO",11,15,51,3217,19,3313,"2015"
"29435","260300 CABROBO",2,4,11,563,4,584,"2015"
"29436","260310 CACHOEIRINHA",0,1,6,286,0,293,"2015"
"29437","260320 CAETES",2,3,4,431,5,445,"2015"
"29438","260330 CALCADO",0,0,0,127,0,127,"2015"
"29439","260340 CALUMBI",1,0,5,90,1,97,"2015"
"29440","260345 CAMARAGIBE",9,14,27,2414,20,2484,"2015"
"29441","260350 CAMOCIM DE SAO FELIX",1,1,4,189,1,196,"2015"
"29442","260360 CAMUTANGA",1,1,0,106,0,108,"2015"
"29443","260370 CANHOTINHO",1,5,10,370,0,386,"2015"
"29444","260380 CAPOEIRAS",0,1,6,270,1,278,"2015"
"29445","260390 CARNAIBA",0,2,4,288,0,294,"2015"
"29446","260392 CARNAUBEIRA DA PENHA",1,1,3,284,2,291,"2015"
"29447","260400 CARPINA",2,3,16,1138,15,1174,"2015"
"29448","260410 CARUARU",17,20,66,5739,29,5871,"2015"
"29449","260415 CASINHAS",0,0,1,184,1,186,"2015"
"29450","260420 CATENDE",2,1,3,552,1,559,"2015"
"29451","260430 CEDRO",1,1,4,182,1,189,"2015"
"29452","260440 CHA DE ALEGRIA",0,2,1,230,0,233,"2015"
"29453","260450 CHA GRANDE",0,2,4,330,1,337,"2015"
"29454","260460 CONDADO",1,2,9,424,2,438,"2015"
"29455","260470 CORRENTES",1,3,5,257,4,270,"2015"
"29456","260480 CORTES",1,1,2,235,0,239,"2015"
"29457","260490 CUMARU",0,1,4,179,0,184,"2015"
"29458","260500 CUPIRA",0,3,5,381,4,393,"2015"
"29459","260510 CUSTODIA",7,2,4,561,1,575,"2015"
"29460","260515 DORMENTES",0,1,2,230,17,250,"2015"
"29461","260520 ESCADA",3,9,19,1114,2,1147,"2015"
"29462","260530 EXU",0,5,5,489,5,504,"2015"
"29463","260540 FEIRA NOVA",1,1,16,320,3,341,"2015"
"29464","260545 FERNANDO DE NORONHA",0,0,0,19,0,19,"2015"
"29465","260550 FERREIROS",0,0,0,147,0,147,"2015"
"29466","260560 FLORES",2,0,8,263,2,275,"2015"
"29467","260570 FLORESTA",2,4,9,454,2,471,"2015"
"29468","260580 FREI MIGUELINHO",0,0,4,139,0,143,"2015"
"29469","260590 GAMELEIRA",3,4,10,383,1,401,"2015"
"29470","260600 GARANHUNS",2,11,35,2440,1,2489,"2015"
"29471","260610 GLORIA DO GOITA",0,1,6,417,0,424,"2015"
"29472","260620 GOIANA",6,9,24,1214,10,1263,"2015"
"29473","260630 GRANITO",1,0,3,96,3,103,"2015"
"29474","260640 GRAVATA",3,1,10,1143,2,1159,"2015"
"29475","260650 IATI",0,2,5,305,1,313,"2015"
"29476","260660 IBIMIRIM",0,2,3,459,4,468,"2015"
"29477","260670 IBIRAJUBA",0,0,4,84,1,89,"2015"
"29478","260680 IGARASSU",7,10,21,1686,10,1734,"2015"
"29479","260690 IGUARACY",2,1,2,165,1,171,"2015"
"29480","260700 INAJA",0,2,10,254,16,282,"2015"
"29481","260710 INGAZEIRA",0,0,2,54,0,56,"2015"
"29482","260720 IPOJUCA",6,13,24,1644,10,1697,"2015"
"29483","260730 IPUBI",1,5,8,518,1,533,"2015"
"29484","260740 ITACURUBA",0,0,1,76,0,77,"2015"
"29485","260750 ITAIBA",1,3,5,352,12,373,"2015"
"29486","260760 ILHA DE ITAMARACA",0,0,3,331,5,339,"2015"
"29487","260765 ITAMBE",0,6,9,479,7,501,"2015"
"29488","260770 ITAPETIM",0,1,1,190,1,193,"2015"
"29489","260775 ITAPISSUMA",1,1,9,424,6,441,"2015"
"29490","260780 ITAQUITINGA",1,1,2,284,1,289,"2015"
"29491","260790 JABOATAO DOS GUARARAPES",34,44,155,9768,50,10051,"2015"
"29492","260795 JAQUEIRA",1,1,2,182,2,188,"2015"
"29493","260800 JATAUBA",0,1,5,286,2,294,"2015"
"29494","260805 JATOBA",2,3,1,210,3,219,"2015"
"29495","260810 JOAO ALFREDO",0,2,6,370,0,378,"2015"
"29496","260820 JOAQUIM NABUCO",2,0,2,325,2,331,"2015"
"29497","260825 JUCATI",0,1,5,204,1,211,"2015"
"29498","260830 JUPI",0,0,3,317,0,320,"2015"
"29499","260840 JUREMA",2,0,4,196,1,203,"2015"
"29500","260845 LAGOA DO CARRO",2,1,4,247,0,254,"2015"
"29501","260850 LAGOA DE ITAENGA",0,0,4,369,1,374,"2015"
"29502","260860 LAGOA DO OURO",0,1,3,204,1,209,"2015"
"29503","260870 LAGOA DOS GATOS",0,1,4,214,1,220,"2015"
"29504","260875 LAGOA GRANDE",2,4,5,371,5,387,"2015"
"29505","260880 LAJEDO",0,3,11,690,6,710,"2015"
"29506","260890 LIMOEIRO",3,0,8,819,0,830,"2015"
"29507","260900 MACAPARANA",3,1,7,395,1,407,"2015"
"29508","260910 MACHADOS",0,2,5,195,2,204,"2015"
"29509","260915 MANARI",3,5,7,254,9,278,"2015"
"29510","260920 MARAIAL",1,0,2,203,3,209,"2015"
"29511","260930 MIRANDIBA",1,0,8,250,2,261,"2015"
"29512","260940 MORENO",2,2,15,795,4,818,"2015"
"29513","260950 NAZARE DA MATA",5,0,5,456,3,469,"2015"
"29514","260960 OLINDA",21,25,66,6021,24,6157,"2015"
"29515","260970 OROBO",1,1,4,250,0,256,"2015"
"29516","260980 OROCO",0,1,8,278,3,290,"2015"
"29517","260990 OURICURI",5,3,21,1147,10,1186,"2015"
"29518","261000 PALMARES",4,6,15,1813,4,1842,"2015"
"29519","261010 PALMEIRINA",1,2,0,106,1,110,"2015"
"29520","261020 PANELAS",1,0,3,396,4,404,"2015"
"29521","261030 PARANATAMA",1,0,4,206,0,211,"2015"
"29522","261040 PARNAMIRIM",1,1,2,309,1,314,"2015"
"29523","261050 PASSIRA",0,2,4,384,2,392,"2015"
"29524","261060 PAUDALHO",2,3,17,837,6,865,"2015"
"29525","261070 PAULISTA",13,20,79,4180,18,4310,"2015"
"29526","261080 PEDRA",2,0,6,318,1,327,"2015"
"29527","261090 PESQUEIRA",1,3,6,1030,4,1044,"2015"
"29528","261100 PETROLANDIA",2,5,10,686,1,704,"2015"
"29529","261110 PETROLINA",30,40,105,6326,91,6592,"2015"
"29530","261120 POCAO",0,0,3,181,0,184,"2015"
"29531","261130 POMBOS",0,2,10,366,1,379,"2015"
"29532","261140 PRIMAVERA",1,0,0,184,4,189,"2015"
"29533","261150 QUIPAPA",0,0,6,332,0,338,"2015"
"29534","261153 QUIXABA",0,0,1,84,1,86,"2015"
"29535","261160 RECIFE",77,103,301,23040,143,23664,"2015"
"29536","261170 RIACHO DAS ALMAS",0,1,5,286,1,293,"2015"
"29537","261180 RIBEIRAO",2,4,6,606,1,619,"2015"
"29538","261190 RIO FORMOSO",3,4,6,339,2,354,"2015"
"29539","261200 SAIRE",0,1,2,139,0,142,"2015"
"29540","261210 SALGADINHO",0,0,0,72,0,72,"2015"
"29541","261220 SALGUEIRO",1,6,35,1082,1,1125,"2015"
"29542","261230 SALOA",0,2,4,226,1,233,"2015"
"29543","261240 SANHARO",0,2,5,324,3,334,"2015"
"29544","261245 SANTA CRUZ",0,3,5,294,1,303,"2015"
"29545","261247 SANTA CRUZ DA BAIXA VERDE",1,0,14,156,0,171,"2015"
"29546","261250 SANTA CRUZ DO CAPIBARIBE",2,7,10,1434,0,1453,"2015"
"29547","261255 SANTA FILOMENA",2,4,4,178,3,191,"2015"
"29548","261260 SANTA MARIA DA BOA VISTA",6,7,20,694,4,731,"2015"
"29549","261270 SANTA MARIA DO CAMBUCA",1,0,1,184,1,187,"2015"
"29550","261280 SANTA TEREZINHA",2,2,4,166,0,174,"2015"
"29551","261290 SAO BENEDITO DO SUL",0,1,1,158,1,161,"2015"
"29552","261300 SAO BENTO DO UNA",5,0,9,724,3,741,"2015"
"29553","261310 SAO CAITANO",1,1,8,557,1,568,"2015"
"29554","261320 SAO JOAO",0,1,8,312,1,322,"2015"
"29555","261330 SAO JOAQUIM DO MONTE",0,1,1,356,1,359,"2015"
"29556","261340 SAO JOSE DA COROA GRANDE",1,0,5,318,4,328,"2015"
"29557","261350 SAO JOSE DO BELMONTE",2,1,12,542,3,560,"2015"
"29558","261360 SAO JOSE DO EGITO",2,1,4,414,0,421,"2015"
"29559","261370 SAO LOURENCO DA MATA",4,5,28,1753,13,1803,"2015"
"29560","261380 SAO VICENTE FERRER",0,1,0,256,3,260,"2015"
"29561","261390 SERRA TALHADA",5,14,69,1406,5,1499,"2015"
"29562","261400 SERRITA",2,1,8,292,0,303,"2015"
"29563","261410 SERTANIA",4,4,5,447,1,461,"2015"
"29564","261420 SIRINHAEM",1,6,13,660,4,684,"2015"
"29565","261430 MOREILANDIA",0,1,1,166,0,168,"2015"
"29566","261440 SOLIDAO",0,0,1,92,0,93,"2015"
"29567","261450 SURUBIM",2,1,7,847,6,863,"2015"
"29568","261460 TABIRA",4,2,5,427,0,438,"2015"
"29569","261470 TACAIMBO",0,1,1,180,0,182,"2015"
"29570","261480 TACARATU",0,1,4,331,6,342,"2015"
"29571","261485 TAMANDARE",2,2,2,362,0,368,"2015"
"29572","261500 TAQUARITINGA DO NORTE",1,1,3,314,1,320,"2015"
"29573","261510 TEREZINHA",0,0,2,103,0,105,"2015"
"29574","261520 TERRA NOVA",0,0,4,137,1,142,"2015"
"29575","261530 TIMBAUBA",4,3,11,766,4,788,"2015"
"29576","261540 TORITAMA",3,2,4,602,0,611,"2015"
"29577","261550 TRACUNHAEM",0,1,1,217,1,220,"2015"
"29578","261560 TRINDADE",1,8,8,575,0,592,"2015"
"29579","261570 TRIUNFO",0,1,11,197,0,209,"2015"
"29580","261580 TUPANATINGA",3,2,3,310,2,320,"2015"
"29581","261590 TUPARETAMA",1,0,1,127,1,130,"2015"
"29582","261600 VENTUROSA",0,2,2,258,1,263,"2015"
"29583","261610 VERDEJANTE",1,1,1,152,0,155,"2015"
"29584","261618 VERTENTE DO LERIO",0,0,0,92,1,93,"2015"
"29585","261620 VERTENTES",0,2,2,362,0,366,"2015"
"29586","261630 VICENCIA",0,0,4,443,0,447,"2015"
"29587","261640 VITORIA DE SANTO ANTAO",5,11,27,2043,4,2090,"2015"
"29588","261650 XEXEU",1,0,6,275,2,284,"2015"
"29589","270010 AGUA BRANCA",0,3,4,186,142,335,"2015"
"29590","270020 ANADIA",0,0,7,208,12,227,"2015"
"29591","270030 ARAPIRACA",9,23,42,4118,12,4204,"2015"
"29592","270040 ATALAIA",0,2,2,426,299,729,"2015"
"29593","270050 BARRA DE SANTO ANTONIO",0,2,5,276,14,297,"2015"
"29594","270060 BARRA DE SAO MIGUEL",0,0,3,160,3,166,"2015"
"29595","270070 BATALHA",0,0,0,271,0,271,"2015"
"29596","270080 BELEM",0,0,0,71,0,71,"2015"
"29597","270090 BELO MONTE",0,1,1,110,0,112,"2015"
"29598","270100 BOCA DA MATA",1,6,23,372,7,409,"2015"
"29599","270110 BRANQUINHA",0,0,1,198,6,205,"2015"
"29600","270120 CACIMBINHAS",0,0,5,152,0,157,"2015"
"29601","270130 CAJUEIRO",0,1,3,167,146,317,"2015"
"29602","270135 CAMPESTRE",0,0,1,66,3,70,"2015"
"29603","270140 CAMPO ALEGRE",3,3,8,461,9,484,"2015"
"29604","270150 CAMPO GRANDE",0,1,0,150,1,152,"2015"
"29605","270160 CANAPI",0,1,3,266,35,305,"2015"
"29606","270170 CAPELA",0,0,1,235,32,268,"2015"
"29607","270180 CARNEIROS",0,0,4,176,3,183,"2015"
"29608","270190 CHA PRETA",0,1,2,97,12,112,"2015"
"29609","270200 COITE DO NOIA",0,0,0,152,1,153,"2015"
"29610","270210 COLONIA LEOPOLDINA",1,0,3,240,9,253,"2015"
"29611","270220 COQUEIRO SECO",0,0,0,77,0,77,"2015"
"29612","270230 CORURIPE",1,1,7,814,49,872,"2015"
"29613","270235 CRAIBAS",0,2,6,400,26,434,"2015"
"29614","270240 DELMIRO GOUVEIA",1,3,10,344,578,936,"2015"
"29615","270250 DOIS RIACHOS",0,0,1,124,2,127,"2015"
"29616","270255 ESTRELA DE ALAGOAS",0,1,2,219,0,222,"2015"
"29617","270260 FEIRA GRANDE",2,3,4,370,1,380,"2015"
"29618","270270 FELIZ DESERTO",0,0,0,66,3,69,"2015"
"29619","270280 FLEXEIRAS",1,0,2,188,11,202,"2015"
"29620","270290 GIRAU DO PONCIANO",2,5,9,560,3,579,"2015"
"29621","270300 IBATEGUARA",0,2,0,253,7,262,"2015"
"29622","270310 IGACI",0,3,5,335,2,345,"2015"
"29623","270320 IGREJA NOVA",1,1,4,361,29,396,"2015"
"29624","270330 INHAPI",0,3,4,211,84,302,"2015"
"29625","270340 JACARE DOS HOMENS",0,1,1,105,1,108,"2015"
"29626","270350 JACUIPE",0,0,0,51,0,51,"2015"
"29627","270360 JAPARATINGA",0,1,2,121,1,125,"2015"
"29628","270370 JARAMATAIA",0,1,2,91,0,94,"2015"
"29629","270375 JEQUIA DA PRAIA",0,0,3,141,11,155,"2015"
"29630","270380 JOAQUIM GOMES",1,6,2,362,21,392,"2015"
"29631","270390 JUNDIA",0,0,0,45,2,47,"2015"
"29632","270400 JUNQUEIRO",1,1,8,354,7,371,"2015"
"29633","270410 LAGOA DA CANOA",0,1,2,347,4,354,"2015"
"29634","270420 LIMOEIRO DE ANADIA",3,1,5,350,2,361,"2015"
"29635","270430 MACEIO",22,44,145,14849,498,15558,"2015"
"29636","270440 MAJOR ISIDORO",0,1,7,214,50,272,"2015"
"29637","270450 MARAGOGI",0,1,4,498,5,508,"2015"
"29638","270460 MARAVILHA",0,0,2,158,3,163,"2015"
"29639","270470 MARECHAL DEODORO",3,3,8,825,15,854,"2015"
"29640","270480 MARIBONDO",0,0,0,209,3,212,"2015"
"29641","270490 MAR VERMELHO",0,0,0,31,1,32,"2015"
"29642","270500 MATA GRANDE",0,1,3,289,48,341,"2015"
"29643","270510 MATRIZ DE CAMARAGIBE",1,3,9,448,12,473,"2015"
"29644","270520 MESSIAS",0,0,4,268,13,285,"2015"
"29645","270530 MINADOR DO NEGRAO",0,0,2,76,0,78,"2015"
"29646","270540 MONTEIROPOLIS",0,0,2,127,1,130,"2015"
"29647","270550 MURICI",2,0,6,359,156,523,"2015"
"29648","270560 NOVO LINO",0,0,1,128,5,134,"2015"
"29649","270570 OLHO D'AGUA DAS FLORES",1,0,1,295,0,297,"2015"
"29650","270580 OLHO D'AGUA DO CASADO",0,0,1,94,48,143,"2015"
"29651","270590 OLHO D'AGUA GRANDE",2,1,0,96,1,100,"2015"
"29652","270600 OLIVENCA",0,0,0,201,0,201,"2015"
"29653","270610 OURO BRANCO",0,1,2,152,0,155,"2015"
"29654","270620 PALESTINA",0,5,1,67,2,75,"2015"
"29655","270630 PALMEIRA DOS INDIOS",0,3,13,1254,0,1270,"2015"
"29656","270640 PAO DE ACUCAR",2,0,5,392,2,401,"2015"
"29657","270642 PARICONHA",0,2,2,101,85,190,"2015"
"29658","270644 PARIPUEIRA",0,2,1,191,7,201,"2015"
"29659","270650 PASSO DE CAMARAGIBE",0,1,0,221,8,230,"2015"
"29660","270660 PAULO JACINTO",0,0,1,103,6,110,"2015"
"29661","270670 PENEDO",0,0,8,863,108,979,"2015"
"29662","270680 PIACABUCU",2,0,3,274,26,305,"2015"
"29663","270690 PILAR",0,1,5,529,71,606,"2015"
"29664","270700 PINDOBA",0,0,0,25,6,31,"2015"
"29665","270710 PIRANHAS",1,1,4,393,31,430,"2015"
"29666","270720 POCO DAS TRINCHEIRAS",0,2,1,241,5,249,"2015"
"29667","270730 PORTO CALVO",0,1,4,408,11,424,"2015"
"29668","270740 PORTO DE PEDRAS",0,0,0,109,6,115,"2015"
"29669","270750 PORTO REAL DO COLEGIO",1,0,2,306,19,328,"2015"
"29670","270760 QUEBRANGULO",1,1,7,191,4,204,"2015"
"29671","270770 RIO LARGO",0,2,12,949,58,1021,"2015"
"29672","270780 ROTEIRO",0,0,1,138,5,144,"2015"
"29673","270790 SANTA LUZIA DO NORTE",0,0,1,122,4,127,"2015"
"29674","270800 SANTANA DO IPANEMA",2,2,7,824,5,840,"2015"
"29675","270810 SANTANA DO MUNDAU",0,0,0,189,4,193,"2015"
"29676","270820 SAO BRAS",0,1,0,97,6,104,"2015"
"29677","270830 SAO JOSE DA LAJE",0,1,0,360,9,370,"2015"
"29678","270840 SAO JOSE DA TAPERA",0,1,4,581,13,599,"2015"
"29679","270850 SAO LUIS DO QUITUNDE",0,4,4,570,17,595,"2015"
"29680","270860 SAO MIGUEL DOS CAMPOS",5,3,14,904,11,937,"2015"
"29681","270870 SAO MIGUEL DOS MILAGRES",1,0,0,119,2,122,"2015"
"29682","270880 SAO SEBASTIAO",0,1,7,534,1,543,"2015"
"29683","270890 SATUBA",0,1,1,185,8,195,"2015"
"29684","270895 SENADOR RUI PALMEIRA",0,0,2,222,9,233,"2015"
"29685","270900 TANQUE D'ARCA",0,1,1,72,1,75,"2015"
"29686","270910 TAQUARANA",1,3,1,309,1,315,"2015"
"29687","270915 TEOTONIO VILELA",4,4,6,636,9,659,"2015"
"29688","270920 TRAIPU",0,1,1,323,1,326,"2015"
"29689","270930 UNIAO DOS PALMARES",0,4,4,1095,19,1122,"2015"
"29690","270940 VICOSA",0,1,6,312,70,389,"2015"
"29691","280010 AMPARO DE SAO FRANCISCO",0,0,0,29,0,29,"2015"
"29692","280020 AQUIDABA",0,1,6,268,10,285,"2015"
"29693","280030 ARACAJU",21,43,204,9275,119,9662,"2015"
"29694","280040 ARAUA",2,0,1,153,0,156,"2015"
"29695","280050 AREIA BRANCA",0,2,8,281,11,302,"2015"
"29696","280060 BARRA DOS COQUEIROS",3,5,9,544,3,564,"2015"
"29697","280067 BOQUIM",1,0,2,300,3,306,"2015"
"29698","280070 BREJO GRANDE",1,1,2,116,5,125,"2015"
"29699","280100 CAMPO DO BRITO",1,1,5,252,7,266,"2015"
"29700","280110 CANHOBA",0,0,0,58,5,63,"2015"
"29701","280120 CANINDE DE SAO FRANCISCO",2,4,15,563,29,613,"2015"
"29702","280130 CAPELA",1,3,15,520,26,565,"2015"
"29703","280140 CARIRA",0,1,7,314,17,339,"2015"
"29704","280150 CARMOPOLIS",1,1,8,275,12,297,"2015"
"29705","280160 CEDRO DE SAO JOAO",0,0,1,88,1,90,"2015"
"29706","280170 CRISTINAPOLIS",0,3,4,294,3,304,"2015"
"29707","280190 CUMBE",0,0,0,51,6,57,"2015"
"29708","280200 DIVINA PASTORA",0,0,2,67,4,73,"2015"
"29709","280210 ESTANCIA",7,5,10,1057,9,1088,"2015"
"29710","280220 FEIRA NOVA",0,0,1,103,6,110,"2015"
"29711","280230 FREI PAULO",0,0,9,198,4,211,"2015"
"29712","280240 GARARU",2,1,4,121,20,148,"2015"
"29713","280250 GENERAL MAYNARD",0,0,0,36,0,36,"2015"
"29714","280260 GRACHO CARDOSO",1,0,3,71,8,83,"2015"
"29715","280270 ILHA DAS FLORES",1,0,6,141,8,156,"2015"
"29716","280280 INDIAROBA",0,2,1,265,3,271,"2015"
"29717","280290 ITABAIANA",3,6,37,1317,27,1390,"2015"
"29718","280300 ITABAIANINHA",3,1,9,611,14,638,"2015"
"29719","280310 ITABI",1,0,1,55,5,62,"2015"
"29720","280320 ITAPORANGA D'AJUDA",2,0,10,501,17,530,"2015"
"29721","280330 JAPARATUBA",2,2,13,259,8,284,"2015"
"29722","280340 JAPOATA",0,2,2,222,8,234,"2015"
"29723","280350 LAGARTO",5,6,28,1431,17,1487,"2015"
"29724","280360 LARANJEIRAS",0,1,16,438,10,465,"2015"
"29725","280370 MACAMBIRA",1,0,1,119,4,125,"2015"
"29726","280380 MALHADA DOS BOIS",0,1,2,80,2,85,"2015"
"29727","280390 MALHADOR",0,0,3,191,5,199,"2015"
"29728","280400 MARUIM",0,3,7,280,5,295,"2015"
"29729","280410 MOITA BONITA",1,0,2,128,1,132,"2015"
"29730","280420 MONTE ALEGRE DE SERGIPE",1,0,2,213,17,233,"2015"
"29731","280430 MURIBECA",0,1,1,101,3,106,"2015"
"29732","280440 NEOPOLIS",2,1,3,277,25,308,"2015"
"29733","280445 NOSSA SENHORA APARECIDA",1,0,4,90,2,97,"2015"
"29734","280450 NOSSA SENHORA DA GLORIA",1,0,13,501,62,577,"2015"
"29735","280460 NOSSA SENHORA DAS DORES",3,1,7,357,28,396,"2015"
"29736","280470 NOSSA SENHORA DE LOURDES",0,0,1,76,4,81,"2015"
"29737","280480 NOSSA SENHORA DO SOCORRO",8,18,102,3035,54,3217,"2015"
"29738","280490 PACATUBA",0,1,3,220,10,234,"2015"
"29739","280500 PEDRA MOLE",0,0,0,49,2,51,"2015"
"29740","280510 PEDRINHAS",1,3,2,114,5,125,"2015"
"29741","280520 PINHAO",0,1,2,83,3,89,"2015"
"29742","280530 PIRAMBU",0,0,3,146,1,150,"2015"
"29743","280540 POCO REDONDO",0,3,10,461,44,518,"2015"
"29744","280550 POCO VERDE",0,2,3,261,7,273,"2015"
"29745","280560 PORTO DA FOLHA",0,0,7,381,28,416,"2015"
"29746","280570 PROPRIA",1,2,13,412,10,438,"2015"
"29747","280580 RIACHAO DO DANTAS",0,1,2,259,4,266,"2015"
"29748","280590 RIACHUELO",1,0,7,193,6,207,"2015"
"29749","280600 RIBEIROPOLIS",1,2,4,200,5,212,"2015"
"29750","280610 ROSARIO DO CATETE",0,0,3,145,10,158,"2015"
"29751","280620 SALGADO",1,0,7,268,2,278,"2015"
"29752","280630 SANTA LUZIA DO ITANHY",1,0,4,195,5,205,"2015"
"29753","280640 SANTANA DO SAO FRANCISCO",0,0,3,107,11,121,"2015"
"29754","280650 SANTA ROSA DE LIMA",0,0,0,59,2,61,"2015"
"29755","280660 SANTO AMARO DAS BROTAS",1,0,4,176,1,182,"2015"
"29756","280670 SAO CRISTOVAO",13,6,32,1431,32,1514,"2015"
"29757","280680 SAO DOMINGOS",1,0,6,150,3,160,"2015"
"29758","280690 SAO FRANCISCO",0,1,0,48,4,53,"2015"
"29759","280700 SAO MIGUEL DO ALEIXO",0,0,0,49,3,52,"2015"
"29760","280710 SIMAO DIAS",1,3,9,606,6,625,"2015"
"29761","280720 SIRIRI",1,0,8,114,5,128,"2015"
"29762","280730 TELHA",0,0,1,45,0,46,"2015"
"29763","280740 TOBIAS BARRETO",2,3,12,628,14,659,"2015"
"29764","280750 TOMAR DO GERU",0,0,1,191,0,192,"2015"
"29765","280760 UMBAUBA",2,0,6,354,2,364,"2015"
"29766","MUNICIPIO IGNORADO - BA",0,0,0,12,0,12,"2015"
"29767","290010 ABAIRA",0,1,0,62,1,64,"2015"
"29768","290020 ABARE",0,1,7,272,2,282,"2015"
"29769","290030 ACAJUTIBA",1,2,4,171,4,182,"2015"
"29770","290035 ADUSTINA",1,1,3,143,1,149,"2015"
"29771","290040 AGUA FRIA",0,1,3,142,44,190,"2015"
"29772","290050 ERICO CARDOSO",1,0,0,33,61,95,"2015"
"29773","290060 AIQUARA",0,3,1,44,2,50,"2015"
"29774","290070 ALAGOINHAS",10,14,34,2302,80,2440,"2015"
"29775","290080 ALCOBACA",0,1,0,273,9,283,"2015"
"29776","290090 ALMADINA",0,0,0,73,1,74,"2015"
"29777","290100 AMARGOSA",3,3,13,325,82,426,"2015"
"29778","290110 AMELIA RODRIGUES",0,0,2,192,76,270,"2015"
"29779","290115 AMERICA DOURADA",1,1,4,210,1,217,"2015"
"29780","290120 ANAGE",1,1,5,236,7,250,"2015"
"29781","290130 ANDARAI",0,2,4,175,3,184,"2015"
"29782","290135 ANDORINHA",0,3,2,146,9,160,"2015"
"29783","290140 ANGICAL",1,1,3,179,5,189,"2015"
"29784","290150 ANGUERA",0,0,1,63,31,95,"2015"
"29785","290160 ANTAS",0,0,3,120,3,126,"2015"
"29786","290170 ANTONIO CARDOSO",0,1,1,81,57,140,"2015"
"29787","290180 ANTONIO GONCALVES",0,0,0,17,80,97,"2015"
"29788","290190 APORA",0,1,2,225,2,230,"2015"
"29789","290195 APUAREMA",0,1,1,89,1,92,"2015"
"29790","290200 ARACATU",0,0,0,151,7,158,"2015"
"29791","290205 ARACAS",2,1,3,167,3,176,"2015"
"29792","290210 ARACI",2,5,18,602,38,665,"2015"
"29793","290220 ARAMARI",0,1,3,120,8,132,"2015"
"29794","290225 ARATACA",1,0,0,120,3,124,"2015"
"29795","290230 ARATUIPE",1,0,3,88,29,121,"2015"
"29796","290240 AURELINO LEAL",0,0,3,163,28,194,"2015"
"29797","290250 BAIANOPOLIS",0,1,3,184,0,188,"2015"
"29798","290260 BAIXA GRANDE",0,1,1,197,8,207,"2015"
"29799","290265 BANZAE",0,0,1,17,160,178,"2015"
"29800","290270 BARRA",3,1,10,961,6,981,"2015"
"29801","290280 BARRA DA ESTIVA",1,2,5,383,7,398,"2015"
"29802","290290 BARRA DO CHOCA",0,4,17,586,13,620,"2015"
"29803","290300 BARRA DO MENDES",0,3,5,188,0,196,"2015"
"29804","290310 BARRA DO ROCHA",0,0,3,72,0,75,"2015"
"29805","290320 BARREIRAS",13,8,59,2558,11,2649,"2015"
"29806","290323 BARRO ALTO",0,1,4,150,0,155,"2015"
"29807","290327 BARROCAS",1,1,5,227,9,243,"2015"
"29808","290330 BARRO PRETO",1,0,5,74,0,80,"2015"
"29809","290340 BELMONTE",1,2,6,300,10,319,"2015"
"29810","290350 BELO CAMPO",0,1,7,208,2,218,"2015"
"29811","290360 BIRITINGA",1,1,3,187,14,206,"2015"
"29812","290370 BOA NOVA",0,1,6,158,5,170,"2015"
"29813","290380 BOA VISTA DO TUPIM",1,0,5,226,8,240,"2015"
"29814","290390 BOM JESUS DA LAPA",2,8,15,1079,6,1110,"2015"
"29815","290395 BOM JESUS DA SERRA",2,2,2,102,5,113,"2015"
"29816","290400 BONINAL",1,1,8,144,8,162,"2015"
"29817","290405 BONITO",2,1,8,243,2,256,"2015"
"29818","290410 BOQUIRA",0,2,2,228,46,278,"2015"
"29819","290420 BOTUPORA",0,0,1,100,24,125,"2015"
"29820","290430 BREJOES",0,2,6,165,4,177,"2015"
"29821","290440 BREJOLANDIA",0,2,1,45,1,49,"2015"
"29822","290450 BROTAS DE MACAUBAS",0,1,1,129,4,135,"2015"
"29823","290460 BRUMADO",1,1,17,834,129,982,"2015"
"29824","290470 BUERAREMA",2,4,8,211,0,225,"2015"
"29825","290475 BURITIRAMA",0,1,1,286,2,290,"2015"
"29826","290480 CAATIBA",0,0,1,82,14,97,"2015"
"29827","290485 CABACEIRAS DO PARAGUACU",0,0,5,138,98,241,"2015"
"29828","290490 CACHOEIRA",0,5,2,204,181,392,"2015"
"29829","290500 CACULE",0,3,1,333,5,342,"2015"
"29830","290510 CAEM",1,2,2,124,1,130,"2015"
"29831","290515 CAETANOS",1,2,5,139,6,153,"2015"
"29832","290520 CAETITE",2,2,11,737,17,769,"2015"
"29833","290530 CAFARNAUM",0,2,9,276,1,288,"2015"
"29834","290540 CAIRU",0,3,53,222,3,281,"2015"
"29835","290550 CALDEIRAO GRANDE",0,0,3,175,1,179,"2015"
"29836","290560 CAMACAN",1,2,6,397,1,407,"2015"
"29837","290570 CAMACARI",24,19,76,4413,47,4579,"2015"
"29838","290580 CAMAMU",1,3,16,577,14,611,"2015"
"29839","290590 CAMPO ALEGRE DE LOURDES",2,1,1,511,16,531,"2015"
"29840","290600 CAMPO FORMOSO",0,2,9,198,952,1161,"2015"
"29841","290610 CANAPOLIS",0,0,1,128,1,130,"2015"
"29842","290620 CANARANA",2,2,14,362,2,382,"2015"
"29843","290630 CANAVIEIRAS",0,1,10,394,52,457,"2015"
"29844","290640 CANDEAL",0,1,1,39,50,91,"2015"
"29845","290650 CANDEIAS",3,9,19,1057,8,1096,"2015"
"29846","290660 CANDIBA",0,0,0,160,4,164,"2015"
"29847","290670 CANDIDO SALES",0,3,8,330,4,345,"2015"
"29848","290680 CANSANCAO",0,5,7,464,4,480,"2015"
"29849","290682 CANUDOS",1,1,10,200,21,233,"2015"
"29850","290685 CAPELA DO ALTO ALEGRE",0,1,0,87,11,99,"2015"
"29851","290687 CAPIM GROSSO",2,3,5,462,5,477,"2015"
"29852","290689 CARAIBAS",0,0,0,104,3,107,"2015"
"29853","290690 CARAVELAS",0,3,2,253,4,262,"2015"
"29854","290700 CARDEAL DA SILVA",3,1,2,126,9,141,"2015"
"29855","290710 CARINHANHA",3,3,6,395,4,411,"2015"
"29856","290720 CASA NOVA",4,4,12,1067,11,1098,"2015"
"29857","290730 CASTRO ALVES",0,0,0,325,15,340,"2015"
"29858","290740 CATOLANDIA",0,1,1,63,0,65,"2015"
"29859","290750 CATU",4,7,13,644,4,672,"2015"
"29860","290755 CATURAMA",0,0,0,33,53,86,"2015"
"29861","290760 CENTRAL",0,4,8,199,0,211,"2015"
"29862","290770 CHORROCHO",0,0,1,159,0,160,"2015"
"29863","290780 CICERO DANTAS",0,0,5,276,29,310,"2015"
"29864","290790 CIPO",1,2,2,174,77,256,"2015"
"29865","290800 COARACI",1,4,6,256,9,276,"2015"
"29866","290810 COCOS",0,0,6,64,191,261,"2015"
"29867","290820 CONCEICAO DA FEIRA",2,0,0,80,160,242,"2015"
"29868","290830 CONCEICAO DO ALMEIDA",1,1,0,117,44,163,"2015"
"29869","290840 CONCEICAO DO COITE",0,6,18,1052,20,1096,"2015"
"29870","290850 CONCEICAO DO JACUIPE",0,2,5,253,150,410,"2015"
"29871","290860 CONDE",1,3,6,344,4,358,"2015"
"29872","290870 CONDEUBA",0,1,4,193,1,199,"2015"
"29873","290880 CONTENDAS DO SINCORA",1,1,0,33,6,41,"2015"
"29874","290890 CORACAO DE MARIA",0,1,2,171,106,280,"2015"
"29875","290900 CORDEIROS",0,0,1,75,0,76,"2015"
"29876","290910 CORIBE",0,0,1,158,4,163,"2015"
"29877","290920 CORONEL JOAO SA",0,2,5,173,6,186,"2015"
"29878","290930 CORRENTINA",2,2,7,258,201,470,"2015"
"29879","290940 COTEGIPE",1,3,8,156,2,170,"2015"
"29880","290950 CRAVOLANDIA",0,0,0,56,2,58,"2015"
"29881","290960 CRISOPOLIS",1,1,5,270,8,285,"2015"
"29882","290970 CRISTOPOLIS",1,2,3,173,0,179,"2015"
"29883","290980 CRUZ DAS ALMAS",3,4,9,754,68,838,"2015"
"29884","290990 CURACA",3,5,14,472,1,495,"2015"
"29885","291000 DARIO MEIRA",1,0,3,136,4,144,"2015"
"29886","291005 DIAS D'AVILA",4,8,26,1057,1,1096,"2015"
"29887","291010 DOM BASILIO",0,0,2,115,3,120,"2015"
"29888","291020 DOM MACEDO COSTA",0,0,0,21,25,46,"2015"
"29889","291030 ELISIO MEDRADO",1,0,4,41,41,87,"2015"
"29890","291040 ENCRUZILHADA",2,6,8,272,6,294,"2015"
"29891","291050 ENTRE RIOS",2,8,14,506,7,537,"2015"
"29892","291060 ESPLANADA",0,3,12,446,7,468,"2015"
"29893","291070 EUCLIDES DA CUNHA",1,3,14,691,60,769,"2015"
"29894","291072 EUNAPOLIS",3,9,48,1731,4,1795,"2015"
"29895","291075 FATIMA",0,0,7,147,12,166,"2015"
"29896","291077 FEIRA DA MATA",0,0,0,27,21,48,"2015"
"29897","291080 FEIRA DE SANTANA",23,29,60,6322,3916,10350,"2015"
"29898","291085 FILADELFIA",1,4,15,223,5,248,"2015"
"29899","291090 FIRMINO ALVES",0,0,3,66,10,79,"2015"
"29900","291100 FLORESTA AZUL",1,0,6,95,1,103,"2015"
"29901","291110 FORMOSA DO RIO PRETO",1,1,7,307,20,336,"2015"
"29902","291120 GANDU",2,5,6,388,15,416,"2015"
"29903","291125 GAVIAO",0,0,1,43,1,45,"2015"
"29904","291130 GENTIO DO OURO",2,1,2,124,0,129,"2015"
"29905","291140 GLORIA",1,0,8,242,1,252,"2015"
"29906","291150 GONGOGI",0,0,5,100,0,105,"2015"
"29907","291160 GOVERNADOR MANGABEIRA",2,0,2,106,131,241,"2015"
"29908","291165 GUAJERU",1,0,2,72,11,86,"2015"
"29909","291170 GUANAMBI",6,2,20,1183,62,1273,"2015"
"29910","291180 GUARATINGA",1,2,5,227,3,238,"2015"
"29911","291185 HELIOPOLIS",0,0,3,91,14,108,"2015"
"29912","291190 IACU",0,2,19,388,1,410,"2015"
"29913","291200 IBIASSUCE",0,0,0,123,0,123,"2015"
"29914","291210 IBICARAI",0,2,13,284,3,302,"2015"
"29915","291220 IBICOARA",2,4,4,292,13,315,"2015"
"29916","291230 IBICUI",0,2,3,149,0,154,"2015"
"29917","291240 IBIPEBA",1,2,2,229,0,234,"2015"
"29918","291250 IBIPITANGA",0,2,0,66,79,147,"2015"
"29919","291260 IBIQUERA",1,1,1,55,2,60,"2015"
"29920","291270 IBIRAPITANGA",3,4,15,361,6,389,"2015"
"29921","291280 IBIRAPUA",1,0,5,110,0,116,"2015"
"29922","291290 IBIRATAIA",1,4,6,305,0,316,"2015"
"29923","291300 IBITIARA",1,2,7,172,4,186,"2015"
"29924","291310 IBITITA",0,2,3,214,0,219,"2015"
"29925","291320 IBOTIRAMA",0,2,25,419,19,465,"2015"
"29926","291330 ICHU",1,0,3,56,10,70,"2015"
"29927","291340 IGAPORA",0,0,1,207,5,213,"2015"
"29928","291345 IGRAPIUNA",0,1,16,183,9,209,"2015"
"29929","291350 IGUAI",3,2,4,316,7,332,"2015"
"29930","291360 ILHEUS",5,15,20,1688,785,2513,"2015"
"29931","291370 INHAMBUPE",2,1,11,395,18,427,"2015"
"29932","291380 IPECAETA",0,0,2,100,45,147,"2015"
"29933","291390 IPIAU",0,5,12,703,2,722,"2015"
"29934","291400 IPIRA",3,5,13,761,25,807,"2015"
"29935","291410 IPUPIARA",0,0,1,104,1,106,"2015"
"29936","291420 IRAJUBA",0,0,2,92,1,95,"2015"
"29937","291430 IRAMAIA",0,0,3,112,2,117,"2015"
"29938","291440 IRAQUARA",0,1,3,367,0,371,"2015"
"29939","291450 IRARA",0,1,11,226,109,347,"2015"
"29940","291460 IRECE",12,6,26,1209,2,1255,"2015"
"29941","291465 ITABELA",3,4,4,481,2,494,"2015"
"29942","291470 ITABERABA",4,5,11,938,8,966,"2015"
"29943","291480 ITABUNA",18,15,70,3020,3,3126,"2015"
"29944","291490 ITACARE",1,1,9,223,86,320,"2015"
"29945","291500 ITAETE",1,3,8,174,3,189,"2015"
"29946","291510 ITAGI",2,2,4,182,3,193,"2015"
"29947","291520 ITAGIBA",0,1,2,179,2,184,"2015"
"29948","291530 ITAGIMIRIM",0,0,2,112,2,116,"2015"
"29949","291535 ITAGUACU DA BAHIA",0,3,1,190,1,195,"2015"
"29950","291540 ITAJU DO COLONIA",0,1,0,86,0,87,"2015"
"29951","291550 ITAJUIPE",2,0,11,287,1,301,"2015"
"29952","291560 ITAMARAJU",3,6,19,979,18,1025,"2015"
"29953","291570 ITAMARI",0,0,2,69,1,72,"2015"
"29954","291580 ITAMBE",0,1,4,295,10,310,"2015"
"29955","291590 ITANAGRA",0,0,5,61,0,66,"2015"
"29956","291600 ITANHEM",0,1,7,214,2,224,"2015"
"29957","291610 ITAPARICA",1,4,9,245,16,275,"2015"
"29958","291620 ITAPE",0,1,5,124,0,130,"2015"
"29959","291630 ITAPEBI",0,1,2,132,5,140,"2015"
"29960","291640 ITAPETINGA",4,8,17,727,356,1112,"2015"
"29961","291650 ITAPICURU",0,3,6,326,15,350,"2015"
"29962","291660 ITAPITANGA",0,1,4,80,1,86,"2015"
"29963","291670 ITAQUARA",1,0,1,83,1,86,"2015"
"29964","291680 ITARANTIM",1,2,4,151,39,197,"2015"
"29965","291685 ITATIM",0,1,3,164,30,198,"2015"
"29966","291690 ITIRUCU",1,1,4,136,0,142,"2015"
"29967","291700 ITIUBA",0,1,7,447,20,475,"2015"
"29968","291710 ITORORO",1,0,3,88,101,193,"2015"
"29969","291720 ITUACU",2,3,5,203,14,227,"2015"
"29970","291730 ITUBERA",0,3,31,370,2,406,"2015"
"29971","291733 IUIU",0,2,1,108,6,117,"2015"
"29972","291735 JABORANDI",0,0,2,120,2,124,"2015"
"29973","291740 JACARACI",0,0,2,119,1,122,"2015"
"29974","291750 JACOBINA",4,9,29,1260,8,1310,"2015"
"29975","291760 JAGUAQUARA",2,2,10,755,7,776,"2015"
"29976","291770 JAGUARARI",1,4,3,451,15,474,"2015"
"29977","291780 JAGUARIPE",2,2,7,115,54,180,"2015"
"29978","291790 JANDAIRA",0,0,1,159,0,160,"2015"
"29979","291800 JEQUIE",13,16,33,2513,19,2594,"2015"
"29980","291810 JEREMOABO",0,3,13,397,8,421,"2015"
"29981","291820 JIQUIRICA",1,0,4,99,43,147,"2015"
"29982","291830 JITAUNA",4,3,2,153,2,164,"2015"
"29983","291835 JOAO DOURADO",1,3,16,375,0,395,"2015"
"29984","291840 JUAZEIRO",14,27,85,4263,36,4425,"2015"
"29985","291845 JUCURUCU",0,2,1,92,2,97,"2015"
"29986","291850 JUSSARA",3,5,9,273,0,290,"2015"
"29987","291855 JUSSARI",0,0,1,67,0,68,"2015"
"29988","291860 JUSSIAPE",0,0,0,58,1,59,"2015"
"29989","291870 LAFAIETE COUTINHO",0,0,0,37,0,37,"2015"
"29990","291875 LAGOA REAL",0,0,2,143,5,150,"2015"
"29991","291880 LAJE",1,1,10,168,118,298,"2015"
"29992","291890 LAJEDAO",1,1,2,59,0,63,"2015"
"29993","291900 LAJEDINHO",0,0,0,41,1,42,"2015"
"29994","291905 LAJEDO DO TABOCAL",0,1,2,98,3,104,"2015"
"29995","291910 LAMARAO",0,3,8,70,9,90,"2015"
"29996","291915 LAPAO",2,2,9,390,0,403,"2015"
"29997","291920 LAURO DE FREITAS",15,13,44,3195,38,3305,"2015"
"29998","291930 LENCOIS",1,0,2,112,3,118,"2015"
"29999","291940 LICINIO DE ALMEIDA",0,0,1,141,1,143,"2015"
"30000","291950 LIVRAMENTO DE NOSSA SENHORA",0,0,8,534,13,555,"2015"
"30001","291955 LUIS EDUARDO MAGALHAES",4,8,29,1795,6,1842,"2015"
"30002","291960 MACAJUBA",0,1,3,124,2,130,"2015"
"30003","291970 MACARANI",0,2,5,204,37,248,"2015"
"30004","291980 MACAUBAS",6,2,4,460,21,493,"2015"
"30005","291990 MACURURE",0,2,3,109,1,115,"2015"
"30006","291992 MADRE DE DEUS",1,2,6,332,1,342,"2015"
"30007","291995 MAETINGA",0,1,1,83,1,86,"2015"
"30008","292000 MAIQUINIQUE",0,0,3,94,22,119,"2015"
"30009","292010 MAIRI",1,1,3,180,9,194,"2015"
"30010","292020 MALHADA",0,0,4,211,13,228,"2015"
"30011","292030 MALHADA DE PEDRAS",1,1,1,96,8,107,"2015"
"30012","292040 MANOEL VITORINO",0,1,4,172,7,184,"2015"
"30013","292045 MANSIDAO",0,1,0,64,0,65,"2015"
"30014","292050 MARACAS",2,2,14,362,4,384,"2015"
"30015","292060 MARAGOGIPE",1,4,8,218,252,483,"2015"
"30016","292070 MARAU",0,2,1,156,41,200,"2015"
"30017","292080 MARCIONILIO SOUZA",0,1,2,130,4,137,"2015"
"30018","292090 MASCOTE",1,1,1,169,1,173,"2015"
"30019","292100 MATA DE SAO JOAO",1,5,22,611,8,647,"2015"
"30020","292105 MATINA",1,2,0,137,1,141,"2015"
"30021","292110 MEDEIROS NETO",4,0,20,303,0,327,"2015"
"30022","292120 MIGUEL CALMON",2,5,6,370,2,385,"2015"
"30023","292130 MILAGRES",0,2,3,104,32,141,"2015"
"30024","292140 MIRANGABA",1,2,8,182,2,195,"2015"
"30025","292145 MIRANTE",1,0,1,91,3,96,"2015"
"30026","292150 MONTE SANTO",0,2,8,659,46,715,"2015"
"30027","292160 MORPARA",0,1,1,97,2,101,"2015"
"30028","292170 MORRO DO CHAPEU",2,5,15,536,1,559,"2015"
"30029","292180 MORTUGABA",0,0,3,105,3,111,"2015"
"30030","292190 MUCUGE",0,0,1,45,134,180,"2015"
"30031","292200 MUCURI",1,5,11,597,1,615,"2015"
"30032","292205 MULUNGU DO MORRO",0,3,7,181,0,191,"2015"
"30033","292210 MUNDO NOVO",0,0,6,213,17,236,"2015"
"30034","292220 MUNIZ FERREIRA",0,0,0,40,40,80,"2015"
"30035","292225 MUQUEM DE SAO FRANCISCO",0,2,12,169,4,187,"2015"
"30036","292230 MURITIBA",6,2,1,180,114,303,"2015"
"30037","292240 MUTUIPE",2,3,12,173,69,259,"2015"
"30038","292250 NAZARE",0,2,15,238,87,342,"2015"
"30039","292260 NILO PECANHA",2,7,34,157,4,204,"2015"
"30040","292265 NORDESTINA",0,0,1,168,3,172,"2015"
"30041","292270 NOVA CANAA",0,2,2,168,6,178,"2015"
"30042","292273 NOVA FATIMA",0,0,1,86,7,94,"2015"
"30043","292275 NOVA IBIA",2,0,2,68,2,74,"2015"
"30044","292280 NOVA ITARANA",0,0,2,100,1,103,"2015"
"30045","292285 NOVA REDENCAO",0,0,6,78,1,85,"2015"
"30046","292290 NOVA SOURE",0,3,3,242,31,279,"2015"
"30047","292300 NOVA VICOSA",4,2,14,674,4,698,"2015"
"30048","292303 NOVO HORIZONTE",0,0,8,113,3,124,"2015"
"30049","292305 NOVO TRIUNFO",0,0,1,76,5,82,"2015"
"30050","292310 OLINDINA",0,2,3,259,35,299,"2015"
"30051","292320 OLIVEIRA DOS BREJINHOS",2,1,6,215,3,227,"2015"
"30052","292330 OURICANGAS",0,0,1,99,7,107,"2015"
"30053","292335 OUROLANDIA",0,3,8,262,1,274,"2015"
"30054","292340 PALMAS DE MONTE ALTO",1,0,9,234,23,267,"2015"
"30055","292350 PALMEIRAS",0,1,2,140,9,152,"2015"
"30056","292360 PARAMIRIM",0,0,1,62,153,216,"2015"
"30057","292370 PARATINGA",0,5,13,407,6,431,"2015"
"30058","292380 PARIPIRANGA",3,1,3,281,2,290,"2015"
"30059","292390 PAU BRASIL",1,0,4,156,1,162,"2015"
"30060","292400 PAULO AFONSO",5,13,70,1892,8,1988,"2015"
"30061","292405 PE DE SERRA",0,0,1,159,10,170,"2015"
"30062","292410 PEDRAO",0,1,0,68,5,74,"2015"
"30063","292420 PEDRO ALEXANDRE",1,1,4,170,4,180,"2015"
"30064","292430 PIATA",2,1,6,299,1,309,"2015"
"30065","292440 PILAO ARCADO",2,2,16,570,3,593,"2015"
"30066","292450 PINDAI",0,1,2,162,2,167,"2015"
"30067","292460 PINDOBACU",3,0,4,236,10,253,"2015"
"30068","292465 PINTADAS",0,0,0,73,12,85,"2015"
"30069","292467 PIRAI DO NORTE",0,2,7,103,6,118,"2015"
"30070","292470 PIRIPA",0,1,4,87,1,93,"2015"
"30071","292480 PIRITIBA",1,1,11,216,6,235,"2015"
"30072","292490 PLANALTINO",1,1,2,80,1,85,"2015"
"30073","292500 PLANALTO",1,3,10,343,6,363,"2015"
"30074","292510 POCOES",5,4,12,632,9,662,"2015"
"30075","292520 POJUCA",3,5,6,456,1,471,"2015"
"30076","292525 PONTO NOVO",1,5,15,258,24,303,"2015"
"30077","292530 PORTO SEGURO",4,17,45,2512,78,2656,"2015"
"30078","292540 POTIRAGUA",0,1,4,122,7,134,"2015"
"30079","292550 PRADO",1,3,2,438,9,453,"2015"
"30080","292560 PRESIDENTE DUTRA",1,1,1,156,0,159,"2015"
"30081","292570 PRESIDENTE JANIO QUADROS",2,1,6,113,3,125,"2015"
"30082","292575 PRESIDENTE TANCREDO NEVES",0,0,23,250,62,335,"2015"
"30083","292580 QUEIMADAS",0,0,6,312,2,320,"2015"
"30084","292590 QUIJINGUE",4,3,3,239,17,266,"2015"
"30085","292593 QUIXABEIRA",0,2,2,97,3,104,"2015"
"30086","292595 RAFAEL JAMBEIRO",1,6,5,228,41,281,"2015"
"30087","292600 REMANSO",0,0,6,692,5,703,"2015"
"30088","292610 RETIROLANDIA",0,3,4,161,14,182,"2015"
"30089","292620 RIACHAO DAS NEVES",1,1,7,306,0,315,"2015"
"30090","292630 RIACHAO DO JACUIPE",0,0,10,371,13,394,"2015"
"30091","292640 RIACHO DE SANTANA",1,1,6,394,12,414,"2015"
"30092","292650 RIBEIRA DO AMPARO",0,0,1,61,104,166,"2015"
"30093","292660 RIBEIRA DO POMBAL",1,0,1,60,656,718,"2015"
"30094","292665 RIBEIRAO DO LARGO",0,0,2,71,4,77,"2015"
"30095","292670 RIO DE CONTAS",1,0,1,148,6,156,"2015"
"30096","292680 RIO DO ANTONIO",1,0,4,119,10,134,"2015"
"30097","292690 RIO DO PIRES",0,1,0,27,53,81,"2015"
"30098","292700 RIO REAL",1,1,10,465,8,485,"2015"
"30099","292710 RODELAS",0,0,4,177,1,182,"2015"
"30100","292720 RUY BARBOSA",2,5,17,454,4,482,"2015"
"30101","292730 SALINAS DA MARGARIDA",0,1,5,141,21,168,"2015"
"30102","292740 SALVADOR",212,195,671,35309,250,36637,"2015"
"30103","292750 SANTA BARBARA",0,0,0,148,93,241,"2015"
"30104","292760 SANTA BRIGIDA",2,2,9,214,1,228,"2015"
"30105","292770 SANTA CRUZ CABRALIA",0,4,7,422,2,435,"2015"
"30106","292780 SANTA CRUZ DA VITORIA",0,0,2,57,17,76,"2015"
"30107","292790 SANTA INES",1,0,1,131,2,135,"2015"
"30108","292800 SANTALUZ",3,6,12,478,25,524,"2015"
"30109","292805 SANTA LUZIA",0,1,5,177,10,193,"2015"
"30110","292810 SANTA MARIA DA VITORIA",0,1,3,479,33,516,"2015"
"30111","292820 SANTANA",0,1,2,304,2,309,"2015"
"30112","292830 SANTANOPOLIS",0,0,3,63,27,93,"2015"
"30113","292840 SANTA RITA DE CASSIA",5,6,8,415,12,446,"2015"
"30114","292850 SANTA TERESINHA",0,0,3,118,8,129,"2015"
"30115","292860 SANTO AMARO",5,6,28,589,43,671,"2015"
"30116","292870 SANTO ANTONIO DE JESUS",4,4,5,741,772,1526,"2015"
"30117","292880 SANTO ESTEVAO",2,0,7,475,277,761,"2015"
"30118","292890 SAO DESIDERIO",0,4,13,468,1,486,"2015"
"30119","292895 SAO DOMINGOS",0,1,2,92,6,101,"2015"
"30120","292900 SAO FELIX",0,0,2,34,134,170,"2015"
"30121","292905 SAO FELIX DO CORIBE",2,0,6,197,9,214,"2015"
"30122","292910 SAO FELIPE",0,1,0,140,70,211,"2015"
"30123","292920 SAO FRANCISCO DO CONDE",4,2,10,638,3,657,"2015"
"30124","292925 SAO GABRIEL",1,5,9,241,1,257,"2015"
"30125","292930 SAO GONCALO DOS CAMPOS",0,1,2,264,153,420,"2015"
"30126","292935 SAO JOSE DA VITORIA",1,1,5,100,0,107,"2015"
"30127","292937 SAO JOSE DO JACUIPE",0,1,3,104,3,111,"2015"
"30128","292940 SAO MIGUEL DAS MATAS",1,0,1,61,62,125,"2015"
"30129","292950 SAO SEBASTIAO DO PASSE",4,2,12,546,6,570,"2015"
"30130","292960 SAPEACU",0,0,4,194,20,218,"2015"
"30131","292970 SATIRO DIAS",1,2,8,180,6,197,"2015"
"30132","292975 SAUBARA",0,1,1,89,3,94,"2015"
"30133","292980 SAUDE",0,0,4,127,6,137,"2015"
"30134","292990 SEABRA",2,1,8,534,19,564,"2015"
"30135","293000 SEBASTIAO LARANJEIRAS",0,0,3,99,4,106,"2015"
"30136","293010 SENHOR DO BONFIM",2,8,22,1029,46,1107,"2015"
"30137","293015 SERRA DO RAMALHO",2,2,7,555,5,571,"2015"
"30138","293020 SENTO SE",1,1,10,467,3,482,"2015"
"30139","293030 SERRA DOURADA",3,0,2,238,1,244,"2015"
"30140","293040 SERRA PRETA",5,1,0,86,64,156,"2015"
"30141","293050 SERRINHA",1,9,66,1052,38,1166,"2015"
"30142","293060 SERROLANDIA",1,0,5,138,2,146,"2015"
"30143","293070 SIMOES FILHO",9,11,22,1790,8,1840,"2015"
"30144","293075 SITIO DO MATO",0,0,1,159,7,167,"2015"
"30145","293076 SITIO DO QUINTO",0,0,4,105,4,113,"2015"
"30146","293077 SOBRADINHO",2,0,10,371,7,390,"2015"
"30147","293080 SOUTO SOARES",0,2,11,253,0,266,"2015"
"30148","293090 TABOCAS DO BREJO VELHO",1,1,2,92,0,96,"2015"
"30149","293100 TANHACU",2,2,1,225,23,253,"2015"
"30150","293105 TANQUE NOVO",0,0,3,123,49,175,"2015"
"30151","293110 TANQUINHO",0,0,0,27,40,67,"2015"
"30152","293120 TAPEROA",0,2,34,231,7,274,"2015"
"30153","293130 TAPIRAMUTA",0,3,2,192,8,205,"2015"
"30154","293135 TEIXEIRA DE FREITAS",6,7,24,2635,16,2688,"2015"
"30155","293140 TEODORO SAMPAIO",0,0,0,28,34,62,"2015"
"30156","293150 TEOFILANDIA",2,1,20,272,14,309,"2015"
"30157","293160 TEOLANDIA",0,1,11,160,5,177,"2015"
"30158","293170 TERRA NOVA",0,1,1,116,19,137,"2015"
"30159","293180 TREMEDAL",1,0,3,173,2,179,"2015"
"30160","293190 TUCANO",3,4,7,399,165,578,"2015"
"30161","293200 UAUA",1,1,6,281,3,292,"2015"
"30162","293210 UBAIRA",0,3,1,215,35,254,"2015"
"30163","293220 UBAITABA",0,5,7,241,48,301,"2015"
"30164","293230 UBATA",2,1,4,224,0,231,"2015"
"30165","293240 UIBAI",2,2,7,158,0,169,"2015"
"30166","293245 UMBURANAS",0,3,18,137,6,164,"2015"
"30167","293250 UNA",0,1,3,104,142,250,"2015"
"30168","293260 URANDI",0,0,0,230,4,234,"2015"
"30169","293270 URUCUCA",2,1,6,197,110,316,"2015"
"30170","293280 UTINGA",2,2,3,231,9,247,"2015"
"30171","293290 VALENCA",3,28,253,1228,15,1527,"2015"
"30172","293300 VALENTE",1,2,7,226,24,260,"2015"
"30173","293305 VARZEA DA ROCA",1,0,2,135,3,141,"2015"
"30174","293310 VARZEA DO POCO",0,0,5,89,1,95,"2015"
"30175","293315 VARZEA NOVA",0,0,3,167,2,172,"2015"
"30176","293317 VARZEDO",1,0,2,58,55,116,"2015"
"30177","293320 VERA CRUZ",2,2,15,427,33,479,"2015"
"30178","293325 VEREDA",0,0,4,86,0,90,"2015"
"30179","293330 VITORIA DA CONQUISTA",17,14,91,5365,51,5538,"2015"
"30180","293340 WAGNER",0,0,1,117,10,128,"2015"
"30181","293345 WANDERLEY",0,2,6,170,1,179,"2015"
"30182","293350 WENCESLAU GUIMARAES",0,6,18,338,15,377,"2015"
"30183","293360 XIQUE-XIQUE",2,7,19,777,45,850,"2015"
"30184","MUNICIPIO IGNORADO - MG",0,0,0,14,0,14,"2015"
"30185","310010 ABADIA DOS DOURADOS",0,0,1,52,0,53,"2015"
"30186","310020 ABAETE",0,1,0,237,0,238,"2015"
"30187","310030 ABRE CAMPO",0,1,1,110,36,148,"2015"
"30188","310040 ACAIACA",0,1,0,37,0,38,"2015"
"30189","310050 ACUCENA",0,0,1,112,2,115,"2015"
"30190","310060 AGUA BOA",1,0,3,173,2,179,"2015"
"30191","310070 AGUA COMPRIDA",0,0,0,25,0,25,"2015"
"30192","310080 AGUANIL",0,0,3,48,0,51,"2015"
"30193","310090 AGUAS FORMOSAS",1,0,4,266,2,273,"2015"
"30194","310100 AGUAS VERMELHAS",1,0,3,163,4,171,"2015"
"30195","310110 AIMORES",1,0,6,272,0,279,"2015"
"30196","310120 AIURUOCA",0,0,3,41,0,44,"2015"
"30197","310130 ALAGOA",0,0,1,18,0,19,"2015"
"30198","310140 ALBERTINA",0,0,1,17,0,18,"2015"
"30199","310150 ALEM PARAIBA",1,4,7,450,1,463,"2015"
"30200","310160 ALFENAS",0,3,8,1000,2,1013,"2015"
"30201","310163 ALFREDO VASCONCELOS",0,0,1,57,0,58,"2015"
"30202","310170 ALMENARA",4,7,17,571,6,605,"2015"
"30203","310180 ALPERCATA",0,0,0,70,22,92,"2015"
"30204","310190 ALPINOPOLIS",2,0,3,263,1,269,"2015"
"30205","310200 ALTEROSA",0,1,2,172,3,178,"2015"
"30206","310205 ALTO CAPARAO",0,2,1,62,17,82,"2015"
"30207","310210 ALTO RIO DOCE",0,0,2,107,0,109,"2015"
"30208","310220 ALVARENGA",0,0,2,41,11,54,"2015"
"30209","310230 ALVINOPOLIS",0,2,5,132,0,139,"2015"
"30210","310240 ALVORADA DE MINAS",0,0,1,52,1,54,"2015"
"30211","310250 AMPARO DO SERRA",0,0,1,42,0,43,"2015"
"30212","310260 ANDRADAS",1,1,2,476,0,480,"2015"
"30213","310270 CACHOEIRA DE PAJEU",0,1,5,102,3,111,"2015"
"30214","310280 ANDRELANDIA",0,0,3,127,0,130,"2015"
"30215","310285 ANGELANDIA",0,3,0,94,2,99,"2015"
"30216","310290 ANTONIO CARLOS",0,0,0,124,0,124,"2015"
"30217","310300 ANTONIO DIAS",2,0,0,132,1,135,"2015"
"30218","310310 ANTONIO PRADO DE MINAS",0,0,0,7,0,7,"2015"
"30219","310320 ARACAI",0,0,0,25,0,25,"2015"
"30220","310330 ARACITABA",0,0,1,15,0,16,"2015"
"30221","310340 ARACUAI",2,2,4,409,3,420,"2015"
"30222","310350 ARAGUARI",4,2,17,1451,10,1484,"2015"
"30223","310360 ARANTINA",0,1,0,39,0,40,"2015"
"30224","310370 ARAPONGA",0,0,2,73,7,82,"2015"
"30225","310375 ARAPORA",0,0,1,116,2,119,"2015"
"30226","310380 ARAPUA",0,0,0,15,0,15,"2015"
"30227","310390 ARAUJOS",0,0,2,124,1,127,"2015"
"30228","310400 ARAXA",6,4,17,1535,8,1570,"2015"
"30229","310410 ARCEBURGO",0,0,3,101,0,104,"2015"
"30230","310420 ARCOS",1,1,11,493,1,507,"2015"
"30231","310430 AREADO",0,0,1,173,0,174,"2015"
"30232","310440 ARGIRITA",0,0,0,28,0,28,"2015"
"30233","310445 ARICANDUVA",0,0,1,35,1,37,"2015"
"30234","310450 ARINOS",1,0,2,188,4,195,"2015"
"30235","310460 ASTOLFO DUTRA",0,3,4,118,0,125,"2015"
"30236","310470 ATALEIA",0,1,3,133,3,140,"2015"
"30237","310480 AUGUSTO DE LIMA",0,0,4,48,1,53,"2015"
"30238","310490 BAEPENDI",0,0,1,194,1,196,"2015"
"30239","310500 BALDIM",0,0,1,84,1,86,"2015"
"30240","310510 BAMBUI",2,0,2,199,0,203,"2015"
"30241","310520 BANDEIRA",0,1,0,32,0,33,"2015"
"30242","310530 BANDEIRA DO SUL",0,0,1,61,1,63,"2015"
"30243","310540 BARAO DE COCAIS",3,0,5,441,4,453,"2015"
"30244","310550 BARAO DE MONTE ALTO",0,1,0,57,2,60,"2015"
"30245","310560 BARBACENA",3,4,23,1470,2,1502,"2015"
"30246","310570 BARRA LONGA",0,0,0,36,0,36,"2015"
"30247","310590 BARROSO",0,0,2,256,1,259,"2015"
"30248","310600 BELA VISTA DE MINAS",1,0,1,127,1,130,"2015"
"30249","310610 BELMIRO BRAGA",0,0,0,31,0,31,"2015"
"30250","310620 BELO HORIZONTE",102,128,496,31240,114,32080,"2015"
"30251","310630 BELO ORIENTE",0,0,6,331,8,345,"2015"
"30252","310640 BELO VALE",0,0,1,91,0,92,"2015"
"30253","310650 BERILO",0,0,0,88,1,89,"2015"
"30254","310660 BERTOPOLIS",0,1,1,71,20,93,"2015"
"30255","310665 BERIZAL",1,0,0,59,2,62,"2015"
"30256","310670 BETIM",17,26,97,6282,32,6454,"2015"
"30257","310680 BIAS FORTES",0,1,1,21,1,24,"2015"
"30258","310690 BICAS",0,1,5,164,1,171,"2015"
"30259","310700 BIQUINHAS",0,0,0,24,0,24,"2015"
"30260","310710 BOA ESPERANCA",1,0,5,518,6,530,"2015"
"30261","310720 BOCAINA DE MINAS",0,0,0,43,0,43,"2015"
"30262","310730 BOCAIUVA",8,3,6,647,8,672,"2015"
"30263","310740 BOM DESPACHO",1,6,12,642,0,661,"2015"
"30264","310750 BOM JARDIM DE MINAS",0,0,3,73,3,79,"2015"
"30265","310760 BOM JESUS DA PENHA",0,0,0,43,0,43,"2015"
"30266","310770 BOM JESUS DO AMPARO",0,0,0,64,1,65,"2015"
"30267","310780 BOM JESUS DO GALHO",0,1,8,179,1,189,"2015"
"30268","310790 BOM REPOUSO",1,1,1,133,0,136,"2015"
"30269","310800 BOM SUCESSO",0,0,4,187,2,193,"2015"
"30270","310810 BONFIM",0,0,1,47,0,48,"2015"
"30271","310820 BONFINOPOLIS DE MINAS",0,0,0,65,4,69,"2015"
"30272","310825 BONITO DE MINAS",0,1,3,136,7,147,"2015"
"30273","310830 BORDA DA MATA",1,1,2,164,1,169,"2015"
"30274","310840 BOTELHOS",0,0,4,147,2,153,"2015"
"30275","310850 BOTUMIRIM",0,0,0,54,0,54,"2015"
"30276","310855 BRASILANDIA DE MINAS",0,1,1,228,26,256,"2015"
"30277","310860 BRASILIA DE MINAS",0,2,7,434,2,445,"2015"
"30278","310870 BRAS PIRES",0,0,1,44,1,46,"2015"
"30279","310880 BRAUNAS",0,1,0,36,0,37,"2015"
"30280","310890 BRAZOPOLIS",1,0,1,160,0,162,"2015"
"30281","310900 BRUMADINHO",6,1,6,494,1,508,"2015"
"30282","310910 BUENO BRANDAO",0,0,0,83,0,83,"2015"
"30283","310920 BUENOPOLIS",0,2,5,113,1,121,"2015"
"30284","310925 BUGRE",1,0,0,55,0,56,"2015"
"30285","310930 BURITIS",3,1,2,341,4,351,"2015"
"30286","310940 BURITIZEIRO",1,1,6,332,1,341,"2015"
"30287","310945 CABECEIRA GRANDE",0,0,0,56,2,58,"2015"
"30288","310950 CABO VERDE",0,1,1,135,0,137,"2015"
"30289","310960 CACHOEIRA DA PRATA",0,0,0,27,0,27,"2015"
"30290","310970 CACHOEIRA DE MINAS",0,0,1,112,0,113,"2015"
"30291","310980 CACHOEIRA DOURADA",0,0,0,29,0,29,"2015"
"30292","310990 CAETANOPOLIS",1,1,1,126,0,129,"2015"
"30293","311000 CAETE",2,1,10,479,10,502,"2015"
"30294","311010 CAIANA",0,0,0,68,0,68,"2015"
"30295","311020 CAJURI",1,1,1,42,3,48,"2015"
"30296","311030 CALDAS",0,0,2,120,2,124,"2015"
"30297","311040 CAMACHO",0,0,0,30,0,30,"2015"
"30298","311050 CAMANDUCAIA",0,2,5,270,4,281,"2015"
"30299","311060 CAMBUI",1,1,3,313,0,318,"2015"
"30300","311070 CAMBUQUIRA",0,3,0,156,0,159,"2015"
"30301","311080 CAMPANARIO",0,0,1,40,0,41,"2015"
"30302","311090 CAMPANHA",1,1,5,182,1,190,"2015"
"30303","311100 CAMPESTRE",0,1,7,215,0,223,"2015"
"30304","311110 CAMPINA VERDE",0,2,0,180,0,182,"2015"
"30305","311115 CAMPO AZUL",0,2,1,42,0,45,"2015"
"30306","311120 CAMPO BELO",1,1,14,558,1,575,"2015"
"30307","311130 CAMPO DO MEIO",0,0,3,118,1,122,"2015"
"30308","311140 CAMPO FLORIDO",2,1,1,120,1,125,"2015"
"30309","311150 CAMPOS ALTOS",0,0,6,238,0,244,"2015"
"30310","311160 CAMPOS GERAIS",0,0,2,317,3,322,"2015"
"30311","311170 CANAA",0,1,0,68,1,70,"2015"
"30312","311180 CANAPOLIS",0,0,0,126,13,139,"2015"
"30313","311190 CANA VERDE",1,0,0,62,0,63,"2015"
"30314","311200 CANDEIAS",1,0,6,130,0,137,"2015"
"30315","311205 CANTAGALO",0,0,0,47,0,47,"2015"
"30316","311210 CAPARAO",0,0,2,69,0,71,"2015"
"30317","311220 CAPELA NOVA",0,0,0,51,0,51,"2015"
"30318","311230 CAPELINHA",0,1,7,467,1,476,"2015"
"30319","311240 CAPETINGA",0,0,2,84,1,87,"2015"
"30320","311250 CAPIM BRANCO",0,1,1,131,1,134,"2015"
"30321","311260 CAPINOPOLIS",0,0,1,149,4,154,"2015"
"30322","311265 CAPITAO ANDRADE",0,0,1,50,6,57,"2015"
"30323","311270 CAPITAO ENEAS",0,3,5,176,1,185,"2015"
"30324","311280 CAPITOLIO",0,1,1,85,1,88,"2015"
"30325","311290 CAPUTIRA",0,0,0,9,114,123,"2015"
"30326","311300 CARAI",2,1,4,246,4,257,"2015"
"30327","311310 CARANAIBA",0,0,0,25,0,25,"2015"
"30328","311320 CARANDAI",1,0,4,310,0,315,"2015"
"30329","311330 CARANGOLA",1,3,7,414,0,425,"2015"
"30330","311340 CARATINGA",2,6,12,1128,22,1170,"2015"
"30331","311350 CARBONITA",0,0,2,91,0,93,"2015"
"30332","311360 CAREACU",0,0,2,71,0,73,"2015"
"30333","311370 CARLOS CHAGAS",1,1,2,234,2,240,"2015"
"30334","311380 CARMESIA",1,0,1,36,1,39,"2015"
"30335","311390 CARMO DA CACHOEIRA",0,0,6,123,0,129,"2015"
"30336","311400 CARMO DA MATA",0,0,0,88,0,88,"2015"
"30337","311410 CARMO DE MINAS",1,0,2,153,2,158,"2015"
"30338","311420 CARMO DO CAJURU",1,1,2,282,1,287,"2015"
"30339","311430 CARMO DO PARANAIBA",0,0,2,378,0,380,"2015"
"30340","311440 CARMO DO RIO CLARO",2,1,4,219,0,226,"2015"
"30341","311450 CARMOPOLIS DE MINAS",0,0,1,240,6,247,"2015"
"30342","311455 CARNEIRINHO",0,1,1,119,0,121,"2015"
"30343","311460 CARRANCAS",0,0,1,34,0,35,"2015"
"30344","311470 CARVALHOPOLIS",0,0,0,37,0,37,"2015"
"30345","311480 CARVALHOS",0,0,1,35,1,37,"2015"
"30346","311490 CASA GRANDE",0,0,0,30,0,30,"2015"
"30347","311500 CASCALHO RICO",0,0,0,24,0,24,"2015"
"30348","311510 CASSIA",1,1,14,212,1,229,"2015"
"30349","311520 CONCEICAO DA BARRA DE MINAS",0,0,0,29,0,29,"2015"
"30350","311530 CATAGUASES",2,7,35,733,2,779,"2015"
"30351","311535 CATAS ALTAS",0,0,1,60,0,61,"2015"
"30352","311540 CATAS ALTAS DA NORUEGA",0,0,1,30,0,31,"2015"
"30353","311545 CATUJI",1,0,3,139,1,144,"2015"
"30354","311547 CATUTI",0,0,1,29,15,45,"2015"
"30355","311550 CAXAMBU",0,0,2,209,65,276,"2015"
"30356","311560 CEDRO DO ABAETE",0,0,0,14,0,14,"2015"
"30357","311570 CENTRAL DE MINAS",0,0,1,88,7,96,"2015"
"30358","311580 CENTRALINA",0,0,0,101,6,107,"2015"
"30359","311590 CHACARA",0,1,0,29,0,30,"2015"
"30360","311600 CHALE",0,0,0,51,33,84,"2015"
"30361","311610 CHAPADA DO NORTE",0,0,0,100,2,102,"2015"
"30362","311615 CHAPADA GAUCHA",0,0,4,187,1,192,"2015"
"30363","311620 CHIADOR",0,0,0,28,0,28,"2015"
"30364","311630 CIPOTANEA",1,0,3,50,1,55,"2015"
"30365","311640 CLARAVAL",0,0,0,9,0,9,"2015"
"30366","311650 CLARO DOS POCOES",0,0,2,82,1,85,"2015"
"30367","311660 CLAUDIO",2,1,3,384,1,391,"2015"
"30368","311670 COIMBRA",1,1,0,62,2,66,"2015"
"30369","311680 COLUNA",0,3,0,88,0,91,"2015"
"30370","311690 COMENDADOR GOMES",0,0,0,28,0,28,"2015"
"30371","311700 COMERCINHO",0,1,4,71,4,80,"2015"
"30372","311710 CONCEICAO DA APARECIDA",0,1,1,103,0,105,"2015"
"30373","311720 CONCEICAO DAS PEDRAS",0,0,0,26,0,26,"2015"
"30374","311730 CONCEICAO DAS ALAGOAS",0,0,8,401,3,412,"2015"
"30375","311740 CONCEICAO DE IPANEMA",0,0,0,11,17,28,"2015"
"30376","311750 CONCEICAO DO MATO DENTRO",1,2,2,260,0,265,"2015"
"30377","311760 CONCEICAO DO PARA",1,1,0,55,10,67,"2015"
"30378","311770 CONCEICAO DO RIO VERDE",1,0,2,163,1,167,"2015"
"30379","311780 CONCEICAO DOS OUROS",0,0,0,130,1,131,"2015"
"30380","311783 CONEGO MARINHO",0,1,2,95,1,99,"2015"
"30381","311787 CONFINS",0,1,0,94,3,98,"2015"
"30382","311790 CONGONHAL",1,0,3,123,1,128,"2015"
"30383","311800 CONGONHAS",1,1,8,750,1,761,"2015"
"30384","311810 CONGONHAS DO NORTE",0,0,3,52,0,55,"2015"
"30385","311820 CONQUISTA",1,0,1,66,1,69,"2015"
"30386","311830 CONSELHEIRO LAFAIETE",3,4,12,1748,1,1768,"2015"
"30387","311840 CONSELHEIRO PENA",0,0,2,244,20,266,"2015"
"30388","311850 CONSOLACAO",0,0,0,15,0,15,"2015"
"30389","311860 CONTAGEM",20,43,163,8697,37,8960,"2015"
"30390","311870 COQUEIRAL",0,1,0,80,10,91,"2015"
"30391","311880 CORACAO DE JESUS",1,1,3,307,7,319,"2015"
"30392","311890 CORDISBURGO",2,3,0,69,1,75,"2015"
"30393","311900 CORDISLANDIA",0,0,0,40,0,40,"2015"
"30394","311910 CORINTO",2,2,7,262,2,275,"2015"
"30395","311920 COROACI",0,0,1,56,11,68,"2015"
"30396","311930 COROMANDEL",0,0,4,296,0,300,"2015"
"30397","311940 CORONEL FABRICIANO",1,7,20,1384,25,1437,"2015"
"30398","311950 CORONEL MURTA",1,1,2,81,7,92,"2015"
"30399","311960 CORONEL PACHECO",0,1,0,23,0,24,"2015"
"30400","311970 CORONEL XAVIER CHAVES",0,0,0,29,0,29,"2015"
"30401","311980 CORREGO DANTA",0,0,0,18,0,18,"2015"
"30402","311990 CORREGO DO BOM JESUS",0,0,0,18,0,18,"2015"
"30403","311995 CORREGO FUNDO",0,0,0,63,0,63,"2015"
"30404","312000 CORREGO NOVO",0,0,0,30,0,30,"2015"
"30405","312010 COUTO DE MAGALHAES DE MINAS",0,0,1,51,0,52,"2015"
"30406","312015 CRISOLITA",1,0,0,71,2,74,"2015"
"30407","312020 CRISTAIS",0,1,2,108,0,111,"2015"
"30408","312030 CRISTALIA",0,1,1,58,1,61,"2015"
"30409","312040 CRISTIANO OTONI",0,0,1,54,0,55,"2015"
"30410","312050 CRISTINA",0,0,2,91,0,93,"2015"
"30411","312060 CRUCILANDIA",0,0,2,61,1,64,"2015"
"30412","312070 CRUZEIRO DA FORTALEZA",0,0,0,46,0,46,"2015"
"30413","312080 CRUZILIA",1,0,1,201,0,203,"2015"
"30414","312083 CUPARAQUE",0,0,1,62,6,69,"2015"
"30415","312087 CURRAL DE DENTRO",0,1,0,105,5,111,"2015"
"30416","312090 CURVELO",9,3,37,960,6,1015,"2015"
"30417","312100 DATAS",0,0,1,78,0,79,"2015"
"30418","312110 DELFIM MOREIRA",0,2,2,71,0,75,"2015"
"30419","312120 DELFINOPOLIS",0,0,1,67,0,68,"2015"
"30420","312125 DELTA",3,1,4,146,3,157,"2015"
"30421","312130 DESCOBERTO",1,0,0,39,0,40,"2015"
"30422","312140 DESTERRO DE ENTRE RIOS",0,0,1,66,0,67,"2015"
"30423","312150 DESTERRO DO MELO",0,1,0,30,0,31,"2015"
"30424","312160 DIAMANTINA",2,5,18,673,3,701,"2015"
"30425","312170 DIOGO DE VASCONCELOS",0,0,1,35,0,36,"2015"
"30426","312180 DIONISIO",0,1,0,58,1,60,"2015"
"30427","312190 DIVINESIA",0,0,2,49,0,51,"2015"
"30428","312200 DIVINO",2,1,1,267,1,272,"2015"
"30429","312210 DIVINO DAS LARANJEIRAS",0,0,2,39,11,52,"2015"
"30430","312220 DIVINOLANDIA DE MINAS",1,0,0,82,6,89,"2015"
"30431","312230 DIVINOPOLIS",6,16,45,2589,7,2663,"2015"
"30432","312235 DIVISA ALEGRE",0,1,2,106,1,110,"2015"
"30433","312240 DIVISA NOVA",0,0,0,80,0,80,"2015"
"30434","312245 DIVISOPOLIS",0,0,3,83,0,86,"2015"
"30435","312247 DOM BOSCO",0,0,0,37,1,38,"2015"
"30436","312250 DOM CAVATI",0,0,2,57,2,61,"2015"
"30437","312260 DOM JOAQUIM",0,1,0,46,0,47,"2015"
"30438","312270 DOM SILVERIO",0,0,0,38,0,38,"2015"
"30439","312280 DOM VICOSO",0,0,1,28,0,29,"2015"
"30440","312290 DONA EUSEBIA",0,1,6,59,0,66,"2015"
"30441","312300 DORES DE CAMPOS",0,0,3,99,1,103,"2015"
"30442","312310 DORES DE GUANHAES",0,0,0,57,1,58,"2015"
"30443","312320 DORES DO INDAIA",1,0,0,114,0,115,"2015"
"30444","312330 DORES DO TURVO",0,0,0,41,1,42,"2015"
"30445","312340 DORESOPOLIS",0,0,0,18,0,18,"2015"
"30446","312350 DOURADOQUARA",0,0,0,13,0,13,"2015"
"30447","312352 DURANDE",0,0,0,18,80,98,"2015"
"30448","312360 ELOI MENDES",1,2,1,333,2,339,"2015"
"30449","312370 ENGENHEIRO CALDAS",0,0,2,114,21,137,"2015"
"30450","312380 ENGENHEIRO NAVARRO",0,0,1,65,0,66,"2015"
"30451","312385 ENTRE FOLHAS",1,0,0,82,1,84,"2015"
"30452","312390 ENTRE RIOS DE MINAS",0,1,5,157,1,164,"2015"
"30453","312400 ERVALIA",0,1,7,174,5,187,"2015"
"30454","312410 ESMERALDAS",4,2,16,1080,17,1119,"2015"
"30455","312420 ESPERA FELIZ",0,0,5,311,1,317,"2015"
"30456","312430 ESPINOSA",0,1,6,407,24,438,"2015"
"30457","312440 ESPIRITO SANTO DO DOURADO",0,0,1,50,1,52,"2015"
"30458","312450 ESTIVA",0,1,2,109,1,113,"2015"
"30459","312460 ESTRELA DALVA",0,0,0,23,0,23,"2015"
"30460","312470 ESTRELA DO INDAIA",0,0,1,22,0,23,"2015"
"30461","312480 ESTRELA DO SUL",0,0,1,60,0,61,"2015"
"30462","312490 EUGENOPOLIS",0,2,1,82,2,87,"2015"
"30463","312500 EWBANK DA CAMARA",0,0,1,48,1,50,"2015"
"30464","312510 EXTREMA",1,1,12,474,1,489,"2015"
"30465","312520 FAMA",0,0,0,16,0,16,"2015"
"30466","312530 FARIA LEMOS",0,1,0,49,0,50,"2015"
"30467","312540 FELICIO DOS SANTOS",0,0,1,58,0,59,"2015"
"30468","312550 SAO GONCALO DO RIO PRETO",0,0,0,29,0,29,"2015"
"30469","312560 FELISBURGO",1,3,2,97,0,103,"2015"
"30470","312570 FELIXLANDIA",0,1,4,117,1,123,"2015"
"30471","312580 FERNANDES TOURINHO",0,0,0,28,6,34,"2015"
"30472","312590 FERROS",2,0,0,90,4,96,"2015"
"30473","312595 FERVEDOURO",0,3,0,127,0,130,"2015"
"30474","312600 FLORESTAL",0,1,0,93,0,94,"2015"
"30475","312610 FORMIGA",2,2,8,706,2,720,"2015"
"30476","312620 FORMOSO",0,0,2,64,0,66,"2015"
"30477","312630 FORTALEZA DE MINAS",0,0,0,32,0,32,"2015"
"30478","312640 FORTUNA DE MINAS",0,0,1,29,0,30,"2015"
"30479","312650 FRANCISCO BADARO",1,0,0,46,0,47,"2015"
"30480","312660 FRANCISCO DUMONT",1,0,0,52,3,56,"2015"
"30481","312670 FRANCISCO SA",0,3,14,264,2,283,"2015"
"30482","312675 FRANCISCOPOLIS",0,0,1,53,1,55,"2015"
"30483","312680 FREI GASPAR",0,0,2,74,1,77,"2015"
"30484","312690 FREI INOCENCIO",1,0,0,84,34,119,"2015"
"30485","312695 FREI LAGONEGRO",0,0,0,31,0,31,"2015"
"30486","312700 FRONTEIRA",0,0,1,158,1,160,"2015"
"30487","312705 FRONTEIRA DOS VALES",0,0,1,42,1,44,"2015"
"30488","312707 FRUTA DE LEITE",0,0,1,3,59,63,"2015"
"30489","312710 FRUTAL",1,4,5,725,3,738,"2015"
"30490","312720 FUNILANDIA",0,0,2,43,0,45,"2015"
"30491","312730 GALILEIA",1,0,0,62,15,78,"2015"
"30492","312733 GAMELEIRAS",0,0,2,20,26,48,"2015"
"30493","312735 GLAUCILANDIA",0,2,0,16,0,18,"2015"
"30494","312737 GOIABEIRA",0,0,1,33,2,36,"2015"
"30495","312738 GOIANA",0,0,0,28,0,28,"2015"
"30496","312740 GONCALVES",0,1,0,41,0,42,"2015"
"30497","312750 GONZAGA",0,0,1,75,20,96,"2015"
"30498","312760 GOUVEIA",1,0,4,121,0,126,"2015"
"30499","312770 GOVERNADOR VALADARES",8,3,38,3212,762,4023,"2015"
"30500","312780 GRAO MOGOL",2,1,5,163,15,186,"2015"
"30501","312790 GRUPIARA",0,0,0,15,0,15,"2015"
"30502","312800 GUANHAES",2,3,12,416,2,435,"2015"
"30503","312810 GUAPE",1,1,6,121,0,129,"2015"
"30504","312820 GUARACIABA",1,0,1,83,0,85,"2015"
"30505","312825 GUARACIAMA",1,0,1,63,0,65,"2015"
"30506","312830 GUARANESIA",0,1,2,190,17,210,"2015"
"30507","312840 GUARANI",1,0,0,85,1,87,"2015"
"30508","312850 GUARARA",0,1,0,41,1,43,"2015"
"30509","312860 GUARDA-MOR",0,0,3,80,0,83,"2015"
"30510","312870 GUAXUPE",1,4,25,595,2,627,"2015"
"30511","312880 GUIDOVAL",1,1,2,78,0,82,"2015"
"30512","312890 GUIMARANIA",0,0,1,89,0,90,"2015"
"30513","312900 GUIRICEMA",0,0,0,59,0,59,"2015"
"30514","312910 GURINHATA",0,0,1,29,2,32,"2015"
"30515","312920 HELIODORA",0,0,0,53,0,53,"2015"
"30516","312930 IAPU",1,0,0,114,0,115,"2015"
"30517","312940 IBERTIOGA",0,0,0,52,0,52,"2015"
"30518","312950 IBIA",0,4,6,256,0,266,"2015"
"30519","312960 IBIAI",0,0,1,108,4,113,"2015"
"30520","312965 IBIRACATU",0,0,2,78,0,80,"2015"
"30521","312970 IBIRACI",2,1,5,119,1,128,"2015"
"30522","312980 IBIRITE",9,13,46,2664,11,2743,"2015"
"30523","312990 IBITIURA DE MINAS",0,0,0,35,0,35,"2015"
"30524","313000 IBITURUNA",0,0,0,27,1,28,"2015"
"30525","313005 ICARAI DE MINAS",0,0,0,109,1,110,"2015"
"30526","313010 IGARAPE",2,3,19,602,5,631,"2015"
"30527","313020 IGARATINGA",2,0,2,109,2,115,"2015"
"30528","313030 IGUATAMA",0,1,0,71,1,73,"2015"
"30529","313040 IJACI",0,0,2,73,0,75,"2015"
"30530","313050 ILICINEA",0,0,2,139,1,142,"2015"
"30531","313055 IMBE DE MINAS",0,0,3,75,3,81,"2015"
"30532","313060 INCONFIDENTES",1,1,0,53,0,55,"2015"
"30533","313065 INDAIABIRA",0,0,0,80,0,80,"2015"
"30534","313070 INDIANOPOLIS",0,1,3,70,2,76,"2015"
"30535","313080 INGAI",0,1,1,25,0,27,"2015"
"30536","313090 INHAPIM",1,0,7,238,5,251,"2015"
"30537","313100 INHAUMA",0,0,1,76,0,77,"2015"
"30538","313110 INIMUTABA",1,1,5,70,0,77,"2015"
"30539","313115 IPABA",1,0,1,260,3,265,"2015"
"30540","313120 IPANEMA",2,0,2,248,21,273,"2015"
"30541","313130 IPATINGA",7,8,25,3262,62,3364,"2015"
"30542","313140 IPIACU",0,0,0,31,2,33,"2015"
"30543","313150 IPUIUNA",1,0,2,113,1,117,"2015"
"30544","313160 IRAI DE MINAS",1,0,1,75,1,78,"2015"
"30545","313170 ITABIRA",19,2,10,1709,21,1761,"2015"
"30546","313180 ITABIRINHA",0,0,0,126,9,135,"2015"
"30547","313190 ITABIRITO",2,3,13,735,1,754,"2015"
"30548","313200 ITACAMBIRA",0,0,0,47,1,48,"2015"
"30549","313210 ITACARAMBI",0,0,2,273,12,287,"2015"
"30550","313220 ITAGUARA",1,1,1,177,2,182,"2015"
"30551","313230 ITAIPE",2,0,5,183,0,190,"2015"
"30552","313240 ITAJUBA",4,5,4,1222,0,1235,"2015"
"30553","313250 ITAMARANDIBA",1,0,4,462,2,469,"2015"
"30554","313260 ITAMARATI DE MINAS",0,0,2,29,0,31,"2015"
"30555","313270 ITAMBACURI",1,4,2,359,6,372,"2015"
"30556","313280 ITAMBE DO MATO DENTRO",2,0,0,17,1,20,"2015"
"30557","313290 ITAMOGI",1,1,3,133,0,138,"2015"
"30558","313300 ITAMONTE",2,0,2,163,1,168,"2015"
"30559","313310 ITANHANDU",0,1,5,183,1,190,"2015"
"30560","313320 ITANHOMI",0,0,1,139,8,148,"2015"
"30561","313330 ITAOBIM",0,3,3,273,0,279,"2015"
"30562","313340 ITAPAGIPE",0,1,0,102,0,103,"2015"
"30563","313350 ITAPECERICA",1,0,2,184,0,187,"2015"
"30564","313360 ITAPEVA",0,0,3,97,0,100,"2015"
"30565","313370 ITATIAIUCU",1,0,3,149,0,153,"2015"
"30566","313375 ITAU DE MINAS",3,0,2,185,1,191,"2015"
"30567","313380 ITAUNA",0,2,7,1050,0,1059,"2015"
"30568","313390 ITAVERAVA",0,1,0,57,0,58,"2015"
"30569","313400 ITINGA",0,0,1,177,1,179,"2015"
"30570","313410 ITUETA",1,0,1,82,1,85,"2015"
"30571","313420 ITUIUTABA",9,5,7,1235,17,1273,"2015"
"30572","313430 ITUMIRIM",0,0,2,73,0,75,"2015"
"30573","313440 ITURAMA",0,0,3,518,3,524,"2015"
"30574","313450 ITUTINGA",0,0,0,46,0,46,"2015"
"30575","313460 JABOTICATUBAS",0,3,1,182,4,190,"2015"
"30576","313470 JACINTO",1,0,13,116,1,131,"2015"
"30577","313480 JACUI",0,0,0,76,0,76,"2015"
"30578","313490 JACUTINGA",0,0,2,243,5,250,"2015"
"30579","313500 JAGUARACU",0,1,0,32,0,33,"2015"
"30580","313505 JAIBA",2,4,13,525,60,604,"2015"
"30581","313507 JAMPRUCA",0,0,1,42,21,64,"2015"
"30582","313510 JANAUBA",3,5,25,1025,9,1067,"2015"
"30583","313520 JANUARIA",4,2,7,911,28,952,"2015"
"30584","313530 JAPARAIBA",0,0,1,41,0,42,"2015"
"30585","313535 JAPONVAR",1,1,2,87,0,91,"2015"
"30586","313540 JECEABA",0,1,1,75,0,77,"2015"
"30587","313545 JENIPAPO DE MINAS",0,2,2,88,1,93,"2015"
"30588","313550 JEQUERI",0,0,3,119,0,122,"2015"
"30589","313560 JEQUITAI",3,0,0,81,1,85,"2015"
"30590","313570 JEQUITIBA",0,0,1,65,0,66,"2015"
"30591","313580 JEQUITINHONHA",0,1,4,277,2,284,"2015"
"30592","313590 JESUANIA",0,0,0,61,0,61,"2015"
"30593","313600 JOAIMA",0,0,2,213,1,216,"2015"
"30594","313610 JOANESIA",0,0,1,37,0,38,"2015"
"30595","313620 JOAO MONLEVADE",3,1,9,954,6,973,"2015"
"30596","313630 JOAO PINHEIRO",0,2,9,646,53,710,"2015"
"30597","313640 JOAQUIM FELICIO",0,0,0,35,0,35,"2015"
"30598","313650 JORDANIA",0,0,3,103,4,110,"2015"
"30599","313652 JOSE GONCALVES DE MINAS",0,0,1,42,0,43,"2015"
"30600","313655 JOSE RAYDAN",0,1,4,52,1,58,"2015"
"30601","313657 JOSENOPOLIS",0,0,0,11,30,41,"2015"
"30602","313660 NOVA UNIAO",0,0,0,66,2,68,"2015"
"30603","313665 JUATUBA",0,1,2,417,2,422,"2015"
"30604","313670 JUIZ DE FORA",25,24,95,6554,24,6722,"2015"
"30605","313680 JURAMENTO",0,0,0,41,0,41,"2015"
"30606","313690 JURUAIA",0,0,2,152,1,155,"2015"
"30607","313695 JUVENILIA",0,0,0,29,43,72,"2015"
"30608","313700 LADAINHA",0,1,3,189,4,197,"2015"
"30609","313710 LAGAMAR",0,0,0,59,0,59,"2015"
"30610","313720 LAGOA DA PRATA",0,3,3,609,6,621,"2015"
"30611","313730 LAGOA DOS PATOS",1,1,3,54,1,60,"2015"
"30612","313740 LAGOA DOURADA",0,0,4,146,0,150,"2015"
"30613","313750 LAGOA FORMOSA",0,2,0,176,0,178,"2015"
"30614","313753 LAGOA GRANDE",0,2,2,100,3,107,"2015"
"30615","313760 LAGOA SANTA",4,2,10,824,7,847,"2015"
"30616","313770 LAJINHA",2,1,2,199,92,296,"2015"
"30617","313780 LAMBARI",1,3,3,221,1,229,"2015"
"30618","313790 LAMIM",0,0,0,38,0,38,"2015"
"30619","313800 LARANJAL",0,0,1,45,0,46,"2015"
"30620","313810 LASSANCE",0,0,1,91,1,93,"2015"
"30621","313820 LAVRAS",3,4,18,1363,7,1395,"2015"
"30622","313830 LEANDRO FERREIRA",0,0,0,30,2,32,"2015"
"30623","313835 LEME DO PRADO",0,0,0,54,0,54,"2015"
"30624","313840 LEOPOLDINA",0,0,4,620,0,624,"2015"
"30625","313850 LIBERDADE",0,0,1,59,0,60,"2015"
"30626","313860 LIMA DUARTE",1,1,1,177,0,180,"2015"
"30627","313862 LIMEIRA DO OESTE",0,0,0,105,0,105,"2015"
"30628","313865 LONTRA",0,0,3,116,1,120,"2015"
"30629","313867 LUISBURGO",0,0,0,10,77,87,"2015"
"30630","313868 LUISLANDIA",0,2,2,75,0,79,"2015"
"30631","313870 LUMINARIAS",0,0,1,61,0,62,"2015"
"30632","313880 LUZ",1,2,3,174,1,181,"2015"
"30633","313890 MACHACALIS",0,0,0,81,0,81,"2015"
"30634","313900 MACHADO",1,1,7,422,0,431,"2015"
"30635","313910 MADRE DE DEUS DE MINAS",0,0,1,42,0,43,"2015"
"30636","313920 MALACACHETA",0,3,5,240,2,250,"2015"
"30637","313925 MAMONAS",0,0,3,19,40,62,"2015"
"30638","313930 MANGA",0,0,2,117,189,308,"2015"
"30639","313940 MANHUACU",6,0,0,55,1272,1333,"2015"
"30640","313950 MANHUMIRIM",0,3,1,134,150,288,"2015"
"30641","313960 MANTENA",0,2,3,340,8,353,"2015"
"30642","313970 MARAVILHAS",1,1,1,69,2,74,"2015"
"30643","313980 MAR DE ESPANHA",1,0,2,134,1,138,"2015"
"30644","313990 MARIA DA FE",0,1,1,183,0,185,"2015"
"30645","314000 MARIANA",5,5,23,932,8,973,"2015"
"30646","314010 MARILAC",0,0,2,39,9,50,"2015"
"30647","314015 MARIO CAMPOS",0,2,5,236,0,243,"2015"
"30648","314020 MARIPA DE MINAS",0,0,1,35,1,37,"2015"
"30649","314030 MARLIERIA",0,0,1,56,0,57,"2015"
"30650","314040 MARMELOPOLIS",0,0,0,34,0,34,"2015"
"30651","314050 MARTINHO CAMPOS",3,1,1,121,4,130,"2015"
"30652","314053 MARTINS SOARES",1,0,0,17,87,105,"2015"
"30653","314055 MATA VERDE",1,2,2,79,0,84,"2015"
"30654","314060 MATERLANDIA",0,1,0,42,0,43,"2015"
"30655","314070 MATEUS LEME",0,1,7,468,1,477,"2015"
"30656","314080 MATIAS BARBOSA",0,1,4,161,2,168,"2015"
"30657","314085 MATIAS CARDOSO",0,0,3,109,14,126,"2015"
"30658","314090 MATIPO",1,1,3,75,207,287,"2015"
"30659","314100 MATO VERDE",0,0,2,112,20,134,"2015"
"30660","314110 MATOZINHOS",1,2,5,526,15,549,"2015"
"30661","314120 MATUTINA",0,0,0,34,0,34,"2015"
"30662","314130 MEDEIROS",0,0,0,48,1,49,"2015"
"30663","314140 MEDINA",0,1,11,247,2,261,"2015"
"30664","314150 MENDES PIMENTEL",0,0,0,58,4,62,"2015"
"30665","314160 MERCES",0,0,0,79,4,83,"2015"
"30666","314170 MESQUITA",0,1,1,62,0,64,"2015"
"30667","314180 MINAS NOVAS",1,1,3,334,9,348,"2015"
"30668","314190 MINDURI",0,0,0,41,2,43,"2015"
"30669","314200 MIRABELA",0,0,3,173,0,176,"2015"
"30670","314210 MIRADOURO",0,0,1,75,2,78,"2015"
"30671","314220 MIRAI",0,2,1,124,4,131,"2015"
"30672","314225 MIRAVANIA",0,0,0,27,22,49,"2015"
"30673","314230 MOEDA",1,0,1,52,0,54,"2015"
"30674","314240 MOEMA",0,0,2,73,0,75,"2015"
"30675","314250 MONJOLOS",0,0,0,26,0,26,"2015"
"30676","314260 MONSENHOR PAULO",0,0,1,91,0,92,"2015"
"30677","314270 MONTALVANIA",0,0,0,39,156,195,"2015"
"30678","314280 MONTE ALEGRE DE MINAS",1,0,1,105,97,204,"2015"
"30679","314290 MONTE AZUL",0,0,8,60,241,309,"2015"
"30680","314300 MONTE BELO",2,0,0,138,5,145,"2015"
"30681","314310 MONTE CARMELO",4,1,3,565,0,573,"2015"
"30682","314315 MONTE FORMOSO",1,0,1,66,0,68,"2015"
"30683","314320 MONTE SANTO DE MINAS",3,0,3,215,2,223,"2015"
"30684","314330 MONTES CLAROS",19,35,120,6140,12,6326,"2015"
"30685","314340 MONTE SIAO",2,0,2,219,1,224,"2015"
"30686","314345 MONTEZUMA",0,0,1,79,3,83,"2015"
"30687","314350 MORADA NOVA DE MINAS",0,1,2,104,1,108,"2015"
"30688","314360 MORRO DA GARCA",0,1,3,31,0,35,"2015"
"30689","314370 MORRO DO PILAR",0,0,0,40,0,40,"2015"
"30690","314380 MUNHOZ",0,0,2,60,2,64,"2015"
"30691","314390 MURIAE",3,6,14,1342,27,1392,"2015"
"30692","314400 MUTUM",0,0,1,317,45,363,"2015"
"30693","314410 MUZAMBINHO",0,1,4,224,0,229,"2015"
"30694","314420 NACIP RAYDAN",0,0,0,25,3,28,"2015"
"30695","314430 NANUQUE",0,4,17,514,1,536,"2015"
"30696","314435 NAQUE",0,0,0,113,0,113,"2015"
"30697","314437 NATALANDIA",0,0,0,38,2,40,"2015"
"30698","314440 NATERCIA",0,0,0,31,0,31,"2015"
"30699","314450 NAZARENO",0,1,1,80,0,82,"2015"
"30700","314460 NEPOMUCENO",1,0,6,290,2,299,"2015"
"30701","314465 NINHEIRA",0,1,1,83,26,111,"2015"
"30702","314467 NOVA BELEM",0,0,0,53,1,54,"2015"
"30703","314470 NOVA ERA",4,2,3,228,0,237,"2015"
"30704","314480 NOVA LIMA",5,4,22,1475,6,1512,"2015"
"30705","314490 NOVA MODICA",1,0,1,44,1,47,"2015"
"30706","314500 NOVA PONTE",1,0,3,190,0,194,"2015"
"30707","314505 NOVA PORTEIRINHA",1,0,3,68,1,73,"2015"
"30708","314510 NOVA RESENDE",0,0,1,225,1,227,"2015"
"30709","314520 NOVA SERRANA",4,5,12,1413,27,1461,"2015"
"30710","314530 NOVO CRUZEIRO",0,1,0,347,5,353,"2015"
"30711","314535 NOVO ORIENTE DE MINAS",2,1,4,121,6,134,"2015"
"30712","314537 NOVORIZONTE",0,0,0,18,44,62,"2015"
"30713","314540 OLARIA",0,0,0,12,0,12,"2015"
"30714","314545 OLHOS-D'AGUA",1,0,0,78,0,79,"2015"
"30715","314550 OLIMPIO NORONHA",0,0,1,24,0,25,"2015"
"30716","314560 OLIVEIRA",1,0,4,425,1,431,"2015"
"30717","314570 OLIVEIRA FORTES",0,0,0,12,0,12,"2015"
"30718","314580 ONCA DE PITANGUI",0,0,0,29,1,30,"2015"
"30719","314585 ORATORIOS",0,1,1,77,1,80,"2015"
"30720","314587 ORIZANIA",0,0,2,111,2,115,"2015"
"30721","314590 OURO BRANCO",0,3,10,526,4,543,"2015"
"30722","314600 OURO FINO",1,1,3,301,0,306,"2015"
"30723","314610 OURO PRETO",2,2,26,866,15,911,"2015"
"30724","314620 OURO VERDE DE MINAS",0,0,4,105,2,111,"2015"
"30725","314625 PADRE CARVALHO",0,0,0,28,52,80,"2015"
"30726","314630 PADRE PARAISO",11,2,4,235,4,256,"2015"
"30727","314640 PAINEIRAS",0,0,1,34,0,35,"2015"
"30728","314650 PAINS",0,0,1,76,0,77,"2015"
"30729","314655 PAI PEDRO",0,0,1,63,4,68,"2015"
"30730","314660 PAIVA",0,0,0,12,0,12,"2015"
"30731","314670 PALMA",0,1,0,57,0,58,"2015"
"30732","314675 PALMOPOLIS",0,2,2,67,0,71,"2015"
"30733","314690 PAPAGAIOS",2,1,6,183,1,193,"2015"
"30734","314700 PARACATU",4,3,24,1352,1,1384,"2015"
"30735","314710 PARA DE MINAS",2,3,16,1133,42,1196,"2015"
"30736","314720 PARAGUACU",0,2,3,238,3,246,"2015"
"30737","314730 PARAISOPOLIS",0,0,1,189,1,191,"2015"
"30738","314740 PARAOPEBA",1,0,6,320,0,327,"2015"
"30739","314750 PASSABEM",0,0,0,15,0,15,"2015"
"30740","314760 PASSA QUATRO",1,0,3,187,2,193,"2015"
"30741","314770 PASSA TEMPO",0,0,2,58,1,61,"2015"
"30742","314780 PASSA-VINTE",0,0,0,19,0,19,"2015"
"30743","314790 PASSOS",2,8,26,1375,6,1417,"2015"
"30744","314795 PATIS",0,0,1,56,0,57,"2015"
"30745","314800 PATOS DE MINAS",4,8,15,1877,0,1904,"2015"
"30746","314810 PATROCINIO",3,4,8,1233,4,1252,"2015"
"30747","314820 PATROCINIO DO MURIAE",0,0,0,47,1,48,"2015"
"30748","314830 PAULA CANDIDO",0,0,2,81,4,87,"2015"
"30749","314840 PAULISTAS",0,0,0,56,0,56,"2015"
"30750","314850 PAVAO",0,0,2,77,1,80,"2015"
"30751","314860 PECANHA",0,0,1,211,0,212,"2015"
"30752","314870 PEDRA AZUL",0,10,15,334,1,360,"2015"
"30753","314875 PEDRA BONITA",0,0,0,78,13,91,"2015"
"30754","314880 PEDRA DO ANTA",0,1,1,27,1,30,"2015"
"30755","314890 PEDRA DO INDAIA",0,1,0,37,0,38,"2015"
"30756","314900 PEDRA DOURADA",0,0,0,39,0,39,"2015"
"30757","314910 PEDRALVA",0,0,2,120,0,122,"2015"
"30758","314915 PEDRAS DE MARIA DA CRUZ",1,1,1,113,2,118,"2015"
"30759","314920 PEDRINOPOLIS",0,0,1,26,0,27,"2015"
"30760","314930 PEDRO LEOPOLDO",3,3,6,819,20,851,"2015"
"30761","314940 PEDRO TEIXEIRA",0,0,0,17,0,17,"2015"
"30762","314950 PEQUERI",0,0,1,49,0,50,"2015"
"30763","314960 PEQUI",0,0,0,54,0,54,"2015"
"30764","314970 PERDIGAO",0,2,4,132,7,145,"2015"
"30765","314980 PERDIZES",1,0,1,176,0,178,"2015"
"30766","314990 PERDOES",1,2,3,212,0,218,"2015"
"30767","314995 PERIQUITO",0,0,1,87,12,100,"2015"
"30768","315000 PESCADOR",0,0,1,43,5,49,"2015"
"30769","315010 PIAU",0,0,0,27,0,27,"2015"
"30770","315015 PIEDADE DE CARATINGA",2,0,2,121,5,130,"2015"
"30771","315020 PIEDADE DE PONTE NOVA",0,0,1,48,0,49,"2015"
"30772","315030 PIEDADE DO RIO GRANDE",0,0,0,35,0,35,"2015"
"30773","315040 PIEDADE DOS GERAIS",0,0,0,52,1,53,"2015"
"30774","315050 PIMENTA",0,0,0,69,0,69,"2015"
"30775","315053 PINGO-D'AGUA",0,0,1,58,1,60,"2015"
"30776","315057 PINTOPOLIS",0,1,2,94,0,97,"2015"
"30777","315060 PIRACEMA",0,0,2,47,0,49,"2015"
"30778","315070 PIRAJUBA",0,1,2,78,1,82,"2015"
"30779","315080 PIRANGA",1,2,2,144,1,150,"2015"
"30780","315090 PIRANGUCU",0,0,1,63,0,64,"2015"
"30781","315100 PIRANGUINHO",0,0,1,105,0,106,"2015"
"30782","315110 PIRAPETINGA",0,1,2,143,0,146,"2015"
"30783","315120 PIRAPORA",2,4,15,851,3,875,"2015"
"30784","315130 PIRAUBA",0,1,2,122,2,127,"2015"
"30785","315140 PITANGUI",1,1,2,281,80,365,"2015"
"30786","315150 PIUMHI",1,0,3,395,0,399,"2015"
"30787","315160 PLANURA",0,0,2,149,1,152,"2015"
"30788","315170 POCO FUNDO",0,0,0,153,0,153,"2015"
"30789","315180 POCOS DE CALDAS",4,10,64,1986,5,2069,"2015"
"30790","315190 POCRANE",1,0,2,98,6,107,"2015"
"30791","315200 POMPEU",1,2,2,430,1,436,"2015"
"30792","315210 PONTE NOVA",1,2,8,681,3,695,"2015"
"30793","315213 PONTO CHIQUE",0,1,1,60,0,62,"2015"
"30794","315217 PONTO DOS VOLANTES",1,1,5,149,0,156,"2015"
"30795","315220 PORTEIRINHA",0,2,16,414,4,436,"2015"
"30796","315230 PORTO FIRME",1,0,0,101,3,105,"2015"
"30797","315240 POTE",1,0,1,156,3,161,"2015"
"30798","315250 POUSO ALEGRE",8,3,21,1992,5,2029,"2015"
"30799","315260 POUSO ALTO",0,0,0,65,1,66,"2015"
"30800","315270 PRADOS",0,0,0,93,0,93,"2015"
"30801","315280 PRATA",0,0,2,379,1,382,"2015"
"30802","315290 PRATAPOLIS",0,1,3,82,0,86,"2015"
"30803","315300 PRATINHA",0,0,1,37,0,38,"2015"
"30804","315310 PRESIDENTE BERNARDES",0,0,1,55,2,58,"2015"
"30805","315320 PRESIDENTE JUSCELINO",0,0,1,32,0,33,"2015"
"30806","315330 PRESIDENTE KUBITSCHEK",0,0,3,42,0,45,"2015"
"30807","315340 PRESIDENTE OLEGARIO",1,1,2,195,1,200,"2015"
"30808","315350 ALTO JEQUITIBA",1,1,0,63,38,103,"2015"
"30809","315360 PRUDENTE DE MORAIS",0,3,2,175,2,182,"2015"
"30810","315370 QUARTEL GERAL",0,0,1,34,0,35,"2015"
"30811","315380 QUELUZITO",0,0,0,13,0,13,"2015"
"30812","315390 RAPOSOS",0,0,8,169,3,180,"2015"
"30813","315400 RAUL SOARES",0,0,2,256,2,260,"2015"
"30814","315410 RECREIO",0,0,0,104,0,104,"2015"
"30815","315415 REDUTO",0,0,0,3,78,81,"2015"
"30816","315420 RESENDE COSTA",0,1,0,126,1,128,"2015"
"30817","315430 RESPLENDOR",0,2,7,207,3,219,"2015"
"30818","315440 RESSAQUINHA",0,0,0,52,0,52,"2015"
"30819","315445 RIACHINHO",0,0,1,77,3,81,"2015"
"30820","315450 RIACHO DOS MACHADOS",0,0,1,113,4,118,"2015"
"30821","315460 RIBEIRAO DAS NEVES",12,23,94,5047,44,5220,"2015"
"30822","315470 RIBEIRAO VERMELHO",0,0,0,38,0,38,"2015"
"30823","315480 RIO ACIMA",0,0,2,119,1,122,"2015"
"30824","315490 RIO CASCA",0,0,2,156,1,159,"2015"
"30825","315500 RIO DOCE",0,0,0,14,1,15,"2015"
"30826","315510 RIO DO PRADO",1,0,2,54,0,57,"2015"
"30827","315520 RIO ESPERA",0,0,1,36,0,37,"2015"
"30828","315530 RIO MANSO",0,1,0,50,1,52,"2015"
"30829","315540 RIO NOVO",0,0,0,80,0,80,"2015"
"30830","315550 RIO PARANAIBA",0,0,1,137,0,138,"2015"
"30831","315560 RIO PARDO DE MINAS",1,1,9,394,3,408,"2015"
"30832","315570 RIO PIRACICABA",1,0,0,160,1,162,"2015"
"30833","315580 RIO POMBA",0,1,4,208,4,217,"2015"
"30834","315590 RIO PRETO",0,0,1,53,1,55,"2015"
"30835","315600 RIO VERMELHO",0,2,4,134,3,143,"2015"
"30836","315610 RITAPOLIS",0,0,0,39,0,39,"2015"
"30837","315620 ROCHEDO DE MINAS",0,0,0,30,1,31,"2015"
"30838","315630 RODEIRO",1,2,2,128,1,134,"2015"
"30839","315640 ROMARIA",0,0,0,38,0,38,"2015"
"30840","315645 ROSARIO DA LIMEIRA",0,1,0,42,1,44,"2015"
"30841","315650 RUBELITA",0,0,0,11,71,82,"2015"
"30842","315660 RUBIM",0,2,2,75,2,81,"2015"
"30843","315670 SABARA",7,6,27,1755,14,1809,"2015"
"30844","315680 SABINOPOLIS",2,3,2,149,1,157,"2015"
"30845","315690 SACRAMENTO",0,2,1,306,1,310,"2015"
"30846","315700 SALINAS",0,0,1,105,444,550,"2015"
"30847","315710 SALTO DA DIVISA",1,0,5,65,2,73,"2015"
"30848","315720 SANTA BARBARA",0,1,10,454,3,468,"2015"
"30849","315725 SANTA BARBARA DO LESTE",0,1,3,87,3,94,"2015"
"30850","315727 SANTA BARBARA DO MONTE VERDE",1,0,0,18,1,20,"2015"
"30851","315730 SANTA BARBARA DO TUGURIO",1,0,1,40,0,42,"2015"
"30852","315733 SANTA CRUZ DE MINAS",0,0,1,80,0,81,"2015"
"30853","315737 SANTA CRUZ DE SALINAS",0,0,0,20,25,45,"2015"
"30854","315740 SANTA CRUZ DO ESCALVADO",0,0,1,38,0,39,"2015"
"30855","315750 SANTA EFIGENIA DE MINAS",0,0,0,44,16,60,"2015"
"30856","315760 SANTA FE DE MINAS",0,0,0,35,1,36,"2015"
"30857","315765 SANTA HELENA DE MINAS",0,0,2,78,14,94,"2015"
"30858","315770 SANTA JULIANA",1,1,2,188,0,192,"2015"
"30859","315780 SANTA LUZIA",8,17,58,3065,13,3161,"2015"
"30860","315790 SANTA MARGARIDA",2,1,1,129,106,239,"2015"
"30861","315800 SANTA MARIA DE ITABIRA",2,1,1,147,1,152,"2015"
"30862","315810 SANTA MARIA DO SALTO",0,0,2,35,0,37,"2015"
"30863","315820 SANTA MARIA DO SUACUI",2,1,0,143,4,150,"2015"
"30864","315830 SANTANA DA VARGEM",0,2,0,72,10,84,"2015"
"30865","315840 SANTANA DE CATAGUASES",0,0,0,23,0,23,"2015"
"30866","315850 SANTANA DE PIRAPAMA",0,1,3,58,0,62,"2015"
"30867","315860 SANTANA DO DESERTO",0,0,0,45,0,45,"2015"
"30868","315870 SANTANA DO GARAMBEU",0,1,0,23,0,24,"2015"
"30869","315880 SANTANA DO JACARE",0,0,3,53,0,56,"2015"
"30870","315890 SANTANA DO MANHUACU",0,0,0,1,109,110,"2015"
"30871","315895 SANTANA DO PARAISO",1,1,7,578,8,595,"2015"
"30872","315900 SANTANA DO RIACHO",0,0,1,57,1,59,"2015"
"30873","315910 SANTANA DOS MONTES",1,0,0,35,0,36,"2015"
"30874","315920 SANTA RITA DE CALDAS",1,0,0,67,0,68,"2015"
"30875","315930 SANTA RITA DE JACUTINGA",0,0,0,47,2,49,"2015"
"30876","315935 SANTA RITA DE MINAS",0,1,3,98,0,102,"2015"
"30877","315940 SANTA RITA DE IBITIPOCA",0,0,2,33,0,35,"2015"
"30878","315950 SANTA RITA DO ITUETO",1,1,4,80,1,87,"2015"
"30879","315960 SANTA RITA DO SAPUCAI",0,1,7,485,5,498,"2015"
"30880","315970 SANTA ROSA DA SERRA",0,0,2,30,0,32,"2015"
"30881","315980 SANTA VITORIA",0,2,0,278,0,280,"2015"
"30882","315990 SANTO ANTONIO DO AMPARO",1,3,1,193,1,199,"2015"
"30883","316000 SANTO ANTONIO DO AVENTUREIRO",0,0,1,16,0,17,"2015"
"30884","316010 SANTO ANTONIO DO GRAMA",0,0,1,59,0,60,"2015"
"30885","316020 SANTO ANTONIO DO ITAMBE",0,0,3,38,0,41,"2015"
"30886","316030 SANTO ANTONIO DO JACINTO",0,0,5,107,1,113,"2015"
"30887","316040 SANTO ANTONIO DO MONTE",0,1,8,346,0,355,"2015"
"30888","316045 SANTO ANTONIO DO RETIRO",0,2,1,69,7,79,"2015"
"30889","316050 SANTO ANTONIO DO RIO ABAIXO",0,0,0,22,0,22,"2015"
"30890","316060 SANTO HIPOLITO",0,0,1,22,0,23,"2015"
"30891","316070 SANTOS DUMONT",0,1,11,475,4,491,"2015"
"30892","316080 SAO BENTO ABADE",0,0,0,66,1,67,"2015"
"30893","316090 SAO BRAS DO SUACUI",0,0,1,49,0,50,"2015"
"30894","316095 SAO DOMINGOS DAS DORES",0,0,4,84,1,89,"2015"
"30895","316100 SAO DOMINGOS DO PRATA",0,0,0,189,1,190,"2015"
"30896","316105 SAO FELIX DE MINAS",0,1,1,32,2,36,"2015"
"30897","316110 SAO FRANCISCO",1,1,7,919,11,939,"2015"
"30898","316120 SAO FRANCISCO DE PAULA",0,1,0,64,0,65,"2015"
"30899","316130 SAO FRANCISCO DE SALES",0,0,0,72,0,72,"2015"
"30900","316140 SAO FRANCISCO DO GLORIA",0,0,1,52,3,56,"2015"
"30901","316150 SAO GERALDO",0,0,0,97,0,97,"2015"
"30902","316160 SAO GERALDO DA PIEDADE",0,0,0,31,9,40,"2015"
"30903","316165 SAO GERALDO DO BAIXIO",0,0,0,27,11,38,"2015"
"30904","316170 SAO GONCALO DO ABAETE",1,1,0,73,0,75,"2015"
"30905","316180 SAO GONCALO DO PARA",0,2,1,138,0,141,"2015"
"30906","316190 SAO GONCALO DO RIO ABAIXO",0,1,2,144,1,148,"2015"
"30907","316200 SAO GONCALO DO SAPUCAI",0,1,3,325,3,332,"2015"
"30908","316210 SAO GOTARDO",1,1,0,625,1,628,"2015"
"30909","316220 SAO JOAO BATISTA DO GLORIA",0,0,3,76,0,79,"2015"
"30910","316225 SAO JOAO DA LAGOA",0,0,3,40,1,44,"2015"
"30911","316230 SAO JOAO DA MATA",0,0,1,28,0,29,"2015"
"30912","316240 SAO JOAO DA PONTE",0,2,3,240,2,247,"2015"
"30913","316245 SAO JOAO DAS MISSOES",0,1,5,143,129,278,"2015"
"30914","316250 SAO JOAO DEL REI",3,4,10,975,1,993,"2015"
"30915","316255 SAO JOAO DO MANHUACU",0,1,0,81,117,199,"2015"
"30916","316257 SAO JOAO DO MANTENINHA",0,0,2,82,0,84,"2015"
"30917","316260 SAO JOAO DO ORIENTE",0,0,3,101,2,106,"2015"
"30918","316265 SAO JOAO DO PACUI",0,0,0,49,0,49,"2015"
"30919","316270 SAO JOAO DO PARAISO",0,1,2,179,96,278,"2015"
"30920","316280 SAO JOAO EVANGELISTA",0,1,1,192,2,196,"2015"
"30921","316290 SAO JOAO NEPOMUCENO",0,1,4,318,1,324,"2015"
"30922","316292 SAO JOAQUIM DE BICAS",1,2,6,382,2,393,"2015"
"30923","316294 SAO JOSE DA BARRA",0,0,2,84,1,87,"2015"
"30924","316295 SAO JOSE DA LAPA",0,0,7,342,4,353,"2015"
"30925","316300 SAO JOSE DA SAFIRA",0,0,1,52,13,66,"2015"
"30926","316310 SAO JOSE DA VARGINHA",0,0,0,64,1,65,"2015"
"30927","316320 SAO JOSE DO ALEGRE",0,0,1,50,0,51,"2015"
"30928","316330 SAO JOSE DO DIVINO",0,1,0,37,2,40,"2015"
"30929","316340 SAO JOSE DO GOIABAL",0,0,1,58,2,61,"2015"
"30930","316350 SAO JOSE DO JACURI",0,1,1,67,0,69,"2015"
"30931","316360 SAO JOSE DO MANTIMENTO",0,0,0,15,22,37,"2015"
"30932","316370 SAO LOURENCO",2,0,4,562,0,568,"2015"
"30933","316380 SAO MIGUEL DO ANTA",0,0,2,60,0,62,"2015"
"30934","316390 SAO PEDRO DA UNIAO",1,0,0,39,0,40,"2015"
"30935","316400 SAO PEDRO DOS FERROS",0,1,1,76,0,78,"2015"
"30936","316410 SAO PEDRO DO SUACUI",0,0,0,64,0,64,"2015"
"30937","316420 SAO ROMAO",1,0,8,126,0,135,"2015"
"30938","316430 SAO ROQUE DE MINAS",0,0,0,67,0,67,"2015"
"30939","316440 SAO SEBASTIAO DA BELA VISTA",0,0,2,79,0,81,"2015"
"30940","316443 SAO SEBASTIAO DA VARGEM ALEGRE",0,0,0,33,0,33,"2015"
"30941","316447 SAO SEBASTIAO DO ANTA",0,0,4,79,2,85,"2015"
"30942","316450 SAO SEBASTIAO DO MARANHAO",0,1,0,98,0,99,"2015"
"30943","316460 SAO SEBASTIAO DO OESTE",0,2,3,107,1,113,"2015"
"30944","316470 SAO SEBASTIAO DO PARAISO",8,1,13,926,6,954,"2015"
"30945","316480 SAO SEBASTIAO DO RIO PRETO",0,0,0,16,1,17,"2015"
"30946","316490 SAO SEBASTIAO DO RIO VERDE",0,0,0,16,0,16,"2015"
"30947","316500 SAO TIAGO",3,0,1,125,0,129,"2015"
"30948","316510 SAO TOMAS DE AQUINO",0,0,0,93,2,95,"2015"
"30949","316520 SAO THOME DAS LETRAS",0,0,2,63,3,68,"2015"
"30950","316530 SAO VICENTE DE MINAS",0,0,0,77,0,77,"2015"
"30951","316540 SAPUCAI-MIRIM",0,0,0,76,0,76,"2015"
"30952","316550 SARDOA",0,0,1,59,14,74,"2015"
"30953","316553 SARZEDO",1,6,9,565,1,582,"2015"
"30954","316555 SETUBINHA",0,1,2,154,14,171,"2015"
"30955","316556 SEM-PEIXE",0,0,1,13,0,14,"2015"
"30956","316557 SENADOR AMARAL",0,0,1,93,0,94,"2015"
"30957","316560 SENADOR CORTES",0,0,0,31,1,32,"2015"
"30958","316570 SENADOR FIRMINO",0,0,1,81,3,85,"2015"
"30959","316580 SENADOR JOSE BENTO",0,0,1,14,0,15,"2015"
"30960","316590 SENADOR MODESTINO GONCALVES",0,0,0,34,0,34,"2015"
"30961","316600 SENHORA DE OLIVEIRA",0,1,0,71,0,72,"2015"
"30962","316610 SENHORA DO PORTO",0,3,2,40,0,45,"2015"
"30963","316620 SENHORA DOS REMEDIOS",0,0,1,81,1,83,"2015"
"30964","316630 SERICITA",0,1,0,100,5,106,"2015"
"30965","316640 SERITINGA",0,0,0,15,0,15,"2015"
"30966","316650 SERRA AZUL DE MINAS",0,0,2,53,1,56,"2015"
"30967","316660 SERRA DA SAUDADE",0,1,0,3,0,4,"2015"
"30968","316670 SERRA DOS AIMORES",0,0,3,80,0,83,"2015"
"30969","316680 SERRA DO SALITRE",1,0,2,166,0,169,"2015"
"30970","316690 SERRANIA",0,0,1,108,0,109,"2015"
"30971","316695 SERRANOPOLIS DE MINAS",0,0,2,48,0,50,"2015"
"30972","316700 SERRANOS",0,0,0,12,0,12,"2015"
"30973","316710 SERRO",0,2,4,264,0,270,"2015"
"30974","316720 SETE LAGOAS",4,6,31,2943,1,2985,"2015"
"30975","316730 SILVEIRANIA",0,0,0,23,0,23,"2015"
"30976","316740 SILVIANOPOLIS",0,0,0,58,1,59,"2015"
"30977","316750 SIMAO PEREIRA",0,0,0,34,1,35,"2015"
"30978","316760 SIMONESIA",1,1,1,32,246,281,"2015"
"30979","316770 SOBRALIA",0,0,1,35,25,61,"2015"
"30980","316780 SOLEDADE DE MINAS",1,0,0,66,0,67,"2015"
"30981","316790 TABULEIRO",0,0,0,33,2,35,"2015"
"30982","316800 TAIOBEIRAS",0,0,3,439,5,447,"2015"
"30983","316805 TAPARUBA",0,0,0,51,0,51,"2015"
"30984","316810 TAPIRA",1,0,0,43,1,45,"2015"
"30985","316820 TAPIRAI",0,0,0,12,0,12,"2015"
"30986","316830 TAQUARACU DE MINAS",0,0,0,34,0,34,"2015"
"30987","316840 TARUMIRIM",1,0,2,119,37,159,"2015"
"30988","316850 TEIXEIRAS",0,1,0,123,2,126,"2015"
"30989","316860 TEOFILO OTONI",2,8,28,1863,22,1923,"2015"
"30990","316870 TIMOTEO",0,5,18,1066,17,1106,"2015"
"30991","316880 TIRADENTES",0,0,1,82,1,84,"2015"
"30992","316890 TIROS",0,1,1,69,0,71,"2015"
"30993","316900 TOCANTINS",1,1,3,190,1,196,"2015"
"30994","316905 TOCOS DO MOJI",0,0,0,28,0,28,"2015"
"30995","316910 TOLEDO",0,0,1,47,0,48,"2015"
"30996","316920 TOMBOS",0,0,0,100,0,100,"2015"
"30997","316930 TRES CORACOES",3,2,14,1040,9,1068,"2015"
"30998","316935 TRES MARIAS",1,0,4,389,5,399,"2015"
"30999","316940 TRES PONTAS",0,4,7,620,121,752,"2015"
"31000","316950 TUMIRITINGA",0,0,0,63,26,89,"2015"
"31001","316960 TUPACIGUARA",3,0,3,247,2,255,"2015"
"31002","316970 TURMALINA",1,0,1,209,1,212,"2015"
"31003","316980 TURVOLANDIA",0,1,0,63,0,64,"2015"
"31004","316990 UBA",6,3,22,1358,16,1405,"2015"
"31005","317000 UBAI",1,1,4,138,3,147,"2015"
"31006","317005 UBAPORANGA",0,1,7,168,1,177,"2015"
"31007","317010 UBERABA",23,9,61,4292,58,4443,"2015"
"31008","317020 UBERLANDIA",34,24,89,9497,43,9687,"2015"
"31009","317030 UMBURATIBA",0,1,2,38,0,41,"2015"
"31010","317040 UNAI",2,2,12,1089,29,1134,"2015"
"31011","317043 UNIAO DE MINAS",0,0,1,51,0,52,"2015"
"31012","317047 URUANA DE MINAS",0,0,0,43,0,43,"2015"
"31013","317050 URUCANIA",0,0,1,123,0,124,"2015"
"31014","317052 URUCUIA",1,3,1,139,1,145,"2015"
"31015","317057 VARGEM ALEGRE",0,1,0,66,2,69,"2015"
"31016","317060 VARGEM BONITA",0,0,0,23,0,23,"2015"
"31017","317065 VARGEM GRANDE DO RIO PARDO",1,0,0,56,1,58,"2015"
"31018","317070 VARGINHA",4,4,17,1692,9,1726,"2015"
"31019","317075 VARJAO DE MINAS",1,0,0,102,2,105,"2015"
"31020","317080 VARZEA DA PALMA",0,3,6,420,1,430,"2015"
"31021","317090 VARZELANDIA",0,0,6,251,2,259,"2015"
"31022","317100 VAZANTE",0,0,3,242,1,246,"2015"
"31023","317103 VERDELANDIA",0,1,5,123,1,130,"2015"
"31024","317107 VEREDINHA",0,1,1,35,0,37,"2015"
"31025","317110 VERISSIMO",0,0,0,28,0,28,"2015"
"31026","317115 VERMELHO NOVO",0,1,0,50,3,54,"2015"
"31027","317120 VESPASIANO",4,8,37,2001,8,2058,"2015"
"31028","317130 VICOSA",4,4,13,888,21,930,"2015"
"31029","317140 VIEIRAS",0,1,0,21,0,22,"2015"
"31030","317150 MATHIAS LOBATO",0,0,1,31,15,47,"2015"
"31031","317160 VIRGEM DA LAPA",0,1,2,137,10,150,"2015"
"31032","317170 VIRGINIA",0,0,0,91,1,92,"2015"
"31033","317180 VIRGINOPOLIS",0,0,1,141,0,142,"2015"
"31034","317190 VIRGOLANDIA",1,0,0,52,9,62,"2015"
"31035","317200 VISCONDE DO RIO BRANCO",0,2,4,530,3,539,"2015"
"31036","317210 VOLTA GRANDE",0,0,3,58,0,61,"2015"
"31037","317220 WENCESLAU BRAZ",0,0,0,25,0,25,"2015"
"31038","320010 AFONSO CLAUDIO",1,11,5,389,0,406,"2015"
"31039","320013 AGUIA BRANCA",0,2,0,117,6,125,"2015"
"31040","320016 AGUA DOCE DO NORTE",0,0,1,159,3,163,"2015"
"31041","320020 ALEGRE",1,2,4,393,0,400,"2015"
"31042","320030 ALFREDO CHAVES",2,1,7,122,0,132,"2015"
"31043","320035 ALTO RIO NOVO",0,0,0,96,6,102,"2015"
"31044","320040 ANCHIETA",0,1,5,425,2,433,"2015"
"31045","320050 APIACA",0,0,0,57,1,58,"2015"
"31046","320060 ARACRUZ",2,1,17,1388,1,1409,"2015"
"31047","320070 ATILIO VIVACQUA",0,0,2,154,0,156,"2015"
"31048","320080 BAIXO GUANDU",4,1,4,412,0,421,"2015"
"31049","320090 BARRA DE SAO FRANCISCO",4,3,6,675,0,688,"2015"
"31050","320100 BOA ESPERANCA",0,0,4,204,7,215,"2015"
"31051","320110 BOM JESUS DO NORTE",0,0,3,101,0,104,"2015"
"31052","320115 BREJETUBA",1,0,3,168,1,173,"2015"
"31053","320120 CACHOEIRO DE ITAPEMIRIM",2,5,41,2915,10,2973,"2015"
"31054","320130 CARIACICA",7,16,78,6122,35,6258,"2015"
"31055","320140 CASTELO",2,1,4,428,2,437,"2015"
"31056","320150 COLATINA",5,5,23,1553,84,1670,"2015"
"31057","320160 CONCEICAO DA BARRA",0,3,5,400,3,411,"2015"
"31058","320170 CONCEICAO DO CASTELO",1,1,4,177,0,183,"2015"
"31059","320180 DIVINO DE SAO LOURENCO",0,0,3,47,0,50,"2015"
"31060","320190 DOMINGOS MARTINS",2,1,5,462,3,473,"2015"
"31061","320200 DORES DO RIO PRETO",0,0,3,63,0,66,"2015"
"31062","320210 ECOPORANGA",1,2,3,335,1,342,"2015"
"31063","320220 FUNDAO",0,1,8,250,1,260,"2015"
"31064","320225 GOVERNADOR LINDENBERG",0,0,0,123,11,134,"2015"
"31065","320230 GUACUI",0,3,11,412,0,426,"2015"
"31066","320240 GUARAPARI",1,8,36,1827,8,1880,"2015"
"31067","320245 IBATIBA",0,0,2,330,12,344,"2015"
"31068","320250 IBIRACU",0,0,2,168,0,170,"2015"
"31069","320255 IBITIRAMA",0,0,1,125,1,127,"2015"
"31070","320260 ICONHA",0,0,1,130,0,131,"2015"
"31071","320265 IRUPI",0,0,3,150,24,177,"2015"
"31072","320270 ITAGUACU",1,1,3,118,1,124,"2015"
"31073","320280 ITAPEMIRIM",2,2,9,564,1,578,"2015"
"31074","320290 ITARANA",1,1,1,101,0,104,"2015"
"31075","320300 IUNA",0,1,1,369,40,411,"2015"
"31076","320305 JAGUARE",0,4,11,490,2,507,"2015"
"31077","320310 JERONIMO MONTEIRO",0,0,2,164,1,167,"2015"
"31078","320313 JOAO NEIVA",0,0,3,199,2,204,"2015"
"31079","320316 LARANJA DA TERRA",1,1,1,100,0,103,"2015"
"31080","320320 LINHARES",2,5,20,2640,2,2669,"2015"
"31081","320330 MANTENOPOLIS",0,2,2,169,1,174,"2015"
"31082","320332 MARATAIZES",1,2,10,542,1,556,"2015"
"31083","320334 MARECHAL FLORIANO",0,2,4,239,1,246,"2015"
"31084","320335 MARILANDIA",1,0,2,146,4,153,"2015"
"31085","320340 MIMOSO DO SUL",0,0,3,250,0,253,"2015"
"31086","320350 MONTANHA",0,0,11,242,10,263,"2015"
"31087","320360 MUCURICI",0,0,6,79,3,88,"2015"
"31088","320370 MUNIZ FREIRE",1,0,2,220,0,223,"2015"
"31089","320380 MUQUI",0,0,6,160,1,167,"2015"
"31090","320390 NOVA VENECIA",2,0,9,693,7,711,"2015"
"31091","320400 PANCAS",1,2,3,220,21,247,"2015"
"31092","320405 PEDRO CANARIO",0,2,2,352,4,360,"2015"
"31093","320410 PINHEIROS",0,0,3,93,285,381,"2015"
"31094","320420 PIUMA",1,1,9,302,2,315,"2015"
"31095","320425 PONTO BELO",0,0,0,87,2,89,"2015"
"31096","320430 PRESIDENTE KENNEDY",0,0,2,164,0,166,"2015"
"31097","320435 RIO BANANAL",1,1,1,229,0,232,"2015"
"31098","320440 RIO NOVO DO SUL",0,0,4,129,1,134,"2015"
"31099","320450 SANTA LEOPOLDINA",0,1,2,136,1,140,"2015"
"31100","320455 SANTA MARIA DE JETIBA",0,2,4,565,0,571,"2015"
"31101","320460 SANTA TERESA",1,0,5,249,2,257,"2015"
"31102","320465 SAO DOMINGOS DO NORTE",1,1,3,120,3,128,"2015"
"31103","320470 SAO GABRIEL DA PALHA",4,2,7,425,4,442,"2015"
"31104","320480 SAO JOSE DO CALCADO",0,0,0,155,1,156,"2015"
"31105","320490 SAO MATEUS",7,4,16,1807,8,1842,"2015"
"31106","320495 SAO ROQUE DO CANAA",1,1,1,95,3,101,"2015"
"31107","320500 SERRA",38,23,97,8097,14,8269,"2015"
"31108","320501 SOORETAMA",1,5,4,502,2,514,"2015"
"31109","320503 VARGEM ALTA",0,0,7,248,0,255,"2015"
"31110","320506 VENDA NOVA DO IMIGRANTE",0,1,4,282,1,288,"2015"
"31111","320510 VIANA",1,3,14,1158,10,1186,"2015"
"31112","320515 VILA PAVAO",0,1,0,106,0,107,"2015"
"31113","320517 VILA VALERIO",0,1,1,193,3,198,"2015"
"31114","320520 VILA VELHA",12,18,83,6541,24,6678,"2015"
"31115","320530 VITORIA",5,10,56,4588,28,4687,"2015"
"31116","MUNICIPIO IGNORADO - RJ",0,0,1,11,2,14,"2015"
"31117","330010 ANGRA DOS REIS",5,7,57,2777,26,2872,"2015"
"31118","330015 APERIBE",0,1,5,131,2,139,"2015"
"31119","330020 ARARUAMA",1,5,18,543,1155,1722,"2015"
"31120","330022 AREAL",0,0,4,160,1,165,"2015"
"31121","330023 ARMACAO DOS BUZIOS",0,4,25,658,7,694,"2015"
"31122","330025 ARRAIAL DO CABO",0,2,10,238,100,350,"2015"
"31123","330030 BARRA DO PIRAI",1,7,31,1156,9,1204,"2015"
"31124","330040 BARRA MANSA",8,11,90,2265,2,2376,"2015"
"31125","330045 BELFORD ROXO",20,35,170,7550,74,7849,"2015"
"31126","330050 BOM JARDIM",2,1,6,354,2,365,"2015"
"31127","330060 BOM JESUS DO ITABAPOANA",1,4,5,502,4,516,"2015"
"31128","330070 CABO FRIO",13,22,64,2941,55,3095,"2015"
"31129","330080 CACHOEIRAS DE MACACU",3,3,8,867,4,885,"2015"
"31130","330090 CAMBUCI",0,2,2,149,5,158,"2015"
"31131","330093 CARAPEBUS",0,1,4,172,9,186,"2015"
"31132","330095 COMENDADOR LEVY GASPARIAN",0,0,2,114,1,117,"2015"
"31133","330100 CAMPOS DOS GOYTACAZES",11,22,93,4057,4046,8229,"2015"
"31134","330110 CANTAGALO",0,4,6,269,1,280,"2015"
"31135","330115 CARDOSO MOREIRA",0,1,2,95,51,149,"2015"
"31136","330120 CARMO",0,4,0,224,1,229,"2015"
"31137","330130 CASIMIRO DE ABREU",2,4,7,598,5,616,"2015"
"31138","330140 CONCEICAO DE MACABU",1,3,6,267,9,286,"2015"
"31139","330150 CORDEIRO",1,0,3,235,4,243,"2015"
"31140","330160 DUAS BARRAS",0,0,1,142,2,145,"2015"
"31141","330170 DUQUE DE CAXIAS",22,65,310,13878,69,14344,"2015"
"31142","330180 ENGENHEIRO PAULO DE FRONTIN",0,2,2,139,0,143,"2015"
"31143","330185 GUAPIMIRIM",1,5,17,706,4,733,"2015"
"31144","330187 IGUABA GRANDE",1,3,6,282,28,320,"2015"
"31145","330190 ITABORAI",9,16,65,3336,23,3449,"2015"
"31146","330200 ITAGUAI",1,14,38,1857,7,1917,"2015"
"31147","330205 ITALVA",0,0,1,175,1,177,"2015"
"31148","330210 ITAOCARA",1,3,5,303,1,313,"2015"
"31149","330220 ITAPERUNA",3,7,15,1166,3,1194,"2015"
"31150","330225 ITATIAIA",1,3,19,400,0,423,"2015"
"31151","330227 JAPERI",1,10,28,1576,31,1646,"2015"
"31152","330230 LAJE DO MURIAE",0,0,1,95,0,96,"2015"
"31153","330240 MACAE",9,29,62,4127,19,4246,"2015"
"31154","330245 MACUCO",1,2,3,117,0,123,"2015"
"31155","330250 MAGE",7,12,68,3550,7,3644,"2015"
"31156","330260 MANGARATIBA",1,4,5,516,3,529,"2015"
"31157","330270 MARICA",2,7,22,1225,628,1884,"2015"
"31158","330280 MENDES",0,1,3,216,0,220,"2015"
"31159","330285 MESQUITA",5,18,45,2550,21,2639,"2015"
"31160","330290 MIGUEL PEREIRA",2,2,10,249,38,301,"2015"
"31161","330300 MIRACEMA",3,1,3,347,0,354,"2015"
"31162","330310 NATIVIDADE",1,0,3,165,1,170,"2015"
"31163","330320 NILOPOLIS",5,8,48,2043,18,2122,"2015"
"31164","330330 NITEROI",13,21,91,6295,36,6456,"2015"
"31165","330340 NOVA FRIBURGO",5,7,35,2161,9,2217,"2015"
"31166","330350 NOVA IGUACU",37,67,231,12086,129,12550,"2015"
"31167","330360 PARACAMBI",1,2,2,550,3,558,"2015"
"31168","330370 PARAIBA DO SUL",3,2,4,542,3,554,"2015"
"31169","330380 PARATY",3,2,8,642,1,656,"2015"
"31170","330385 PATY DO ALFERES",0,1,10,335,43,389,"2015"
"31171","330390 PETROPOLIS",7,19,80,3822,30,3958,"2015"
"31172","330395 PINHEIRAL",0,1,2,286,3,292,"2015"
"31173","330400 PIRAI",0,0,4,340,0,344,"2015"
"31174","330410 PORCIUNCULA",0,3,3,206,2,214,"2015"
"31175","330411 PORTO REAL",0,2,7,299,0,308,"2015"
"31176","330412 QUATIS",0,0,4,183,1,188,"2015"
"31177","330414 QUEIMADOS",6,8,52,2287,53,2406,"2015"
"31178","330415 QUISSAMA",1,2,12,367,28,410,"2015"
"31179","330420 RESENDE",5,5,78,1721,3,1812,"2015"
"31180","330430 RIO BONITO",0,4,5,763,10,782,"2015"
"31181","330440 RIO CLARO",0,4,6,201,2,213,"2015"
"31182","330450 RIO DAS FLORES",1,1,5,100,1,108,"2015"
"31183","330452 RIO DAS OSTRAS",4,12,54,2298,20,2388,"2015"
"31184","330455 RIO DE JANEIRO",146,425,1696,87696,731,90694,"2015"
"31185","330460 SANTA MARIA MADALENA",0,0,1,77,2,80,"2015"
"31186","330470 SANTO ANTONIO DE PADUA",1,1,3,447,4,456,"2015"
"31187","330475 SAO FRANCISCO DE ITABAPOANA",0,2,11,253,291,557,"2015"
"31188","330480 SAO FIDELIS",1,1,11,407,40,460,"2015"
"31189","330490 SAO GONCALO",38,48,201,12068,33,12388,"2015"
"31190","330500 SAO JOAO DA BARRA",0,1,9,327,230,567,"2015"
"31191","330510 SAO JOAO DE MERITI",20,32,139,6763,55,7009,"2015"
"31192","330513 SAO JOSE DE UBA",0,0,1,114,0,115,"2015"
"31193","330515 SAO JOSE DO VALE DO RIO PRETO",0,1,4,233,0,238,"2015"
"31194","330520 SAO PEDRO DA ALDEIA",2,6,13,884,422,1327,"2015"
"31195","330530 SAO SEBASTIAO DO ALTO",2,0,1,108,0,111,"2015"
"31196","330540 SAPUCAIA",1,1,2,185,2,191,"2015"
"31197","330550 SAQUAREMA",1,8,23,1139,62,1233,"2015"
"31198","330555 SEROPEDICA",4,7,14,1116,8,1149,"2015"
"31199","330560 SILVA JARDIM",2,4,6,279,8,299,"2015"
"31200","330570 SUMIDOURO",1,2,6,190,17,216,"2015"
"31201","330575 TANGUA",3,3,11,483,4,504,"2015"
"31202","330580 TERESOPOLIS",1,10,32,2307,9,2359,"2015"
"31203","330590 TRAJANO DE MORAES",0,2,1,119,1,123,"2015"
"31204","330600 TRES RIOS",4,8,18,1184,7,1221,"2015"
"31205","330610 VALENCA",2,5,25,858,4,894,"2015"
"31206","330615 VARRE-SAI",1,1,2,139,0,143,"2015"
"31207","330620 VASSOURAS",2,2,5,503,1,513,"2015"
"31208","330630 VOLTA REDONDA",5,9,49,3372,4,3439,"2015"
"31209","MUNICIPIO IGNORADO - SP",0,0,1,3,5,9,"2015"
"31210","350010 ADAMANTINA",1,2,5,347,2,357,"2015"
"31211","350020 ADOLFO",0,0,1,51,0,52,"2015"
"31212","350030 AGUAI",0,1,5,401,6,413,"2015"
"31213","350040 AGUAS DA PRATA",0,0,0,80,1,81,"2015"
"31214","350050 AGUAS DE LINDOIA",0,0,2,215,0,217,"2015"
"31215","350055 AGUAS DE SANTA BARBARA",0,1,3,80,2,86,"2015"
"31216","350060 AGUAS DE SAO PEDRO",0,0,0,26,0,26,"2015"
"31217","350070 AGUDOS",4,4,7,473,0,488,"2015"
"31218","350075 ALAMBARI",0,0,1,61,1,63,"2015"
"31219","350080 ALFREDO MARCONDES",0,2,1,43,0,46,"2015"
"31220","350090 ALTAIR",1,1,1,38,0,41,"2015"
"31221","350100 ALTINOPOLIS",0,0,2,193,3,198,"2015"
"31222","350110 ALTO ALEGRE",0,0,0,30,0,30,"2015"
"31223","350115 ALUMINIO",0,1,4,220,4,229,"2015"
"31224","350120 ALVARES FLORENCE",0,0,0,29,0,29,"2015"
"31225","350130 ALVARES MACHADO",0,0,7,352,0,359,"2015"
"31226","350140 ALVARO DE CARVALHO",1,1,8,47,0,57,"2015"
"31227","350150 ALVINLANDIA",0,1,1,43,0,45,"2015"
"31228","350160 AMERICANA",4,11,34,2818,1,2868,"2015"
"31229","350170 AMERICO BRASILIENSE",1,0,4,530,2,537,"2015"
"31230","350180 AMERICO DE CAMPOS",0,0,2,56,0,58,"2015"
"31231","350190 AMPARO",1,1,14,892,1,909,"2015"
"31232","350200 ANALANDIA",0,1,2,49,0,52,"2015"
"31233","350210 ANDRADINA",2,2,9,736,4,753,"2015"
"31234","350220 ANGATUBA",0,2,6,333,0,341,"2015"
"31235","350230 ANHEMBI",0,0,0,64,7,71,"2015"
"31236","350240 ANHUMAS",0,0,2,46,0,48,"2015"
"31237","350250 APARECIDA",0,2,6,462,5,475,"2015"
"31238","350260 APARECIDA D'OESTE",0,0,0,51,0,51,"2015"
"31239","350270 APIAI",3,2,8,377,3,393,"2015"
"31240","350275 ARACARIGUAMA",2,1,2,300,0,305,"2015"
"31241","350280 ARACATUBA",4,10,42,2414,1,2471,"2015"
"31242","350290 ARACOIABA DA SERRA",0,4,8,439,3,454,"2015"
"31243","350300 ARAMINA",0,0,0,68,1,69,"2015"
"31244","350310 ARANDU",0,1,0,74,0,75,"2015"
"31245","350315 ARAPEI",0,0,0,14,0,14,"2015"
"31246","350320 ARARAQUARA",6,12,28,2902,8,2956,"2015"
"31247","350330 ARARAS",4,0,15,1584,0,1603,"2015"
"31248","350335 ARCO-IRIS",0,0,0,30,0,30,"2015"
"31249","350340 AREALVA",0,0,0,76,2,78,"2015"
"31250","350350 AREIAS",0,0,2,40,8,50,"2015"
"31251","350360 AREIOPOLIS",1,1,1,144,1,148,"2015"
"31252","350370 ARIRANHA",1,1,2,99,0,103,"2015"
"31253","350380 ARTUR NOGUEIRA",4,1,8,605,6,624,"2015"
"31254","350390 ARUJA",3,1,19,1451,3,1477,"2015"
"31255","350395 ASPASIA",0,0,0,24,0,24,"2015"
"31256","350400 ASSIS",3,4,9,1295,3,1314,"2015"
"31257","350410 ATIBAIA",7,10,21,2047,5,2090,"2015"
"31258","350420 AURIFLAMA",2,1,4,155,14,176,"2015"
"31259","350430 AVAI",0,0,1,69,0,70,"2015"
"31260","350440 AVANHANDAVA",0,1,1,150,1,153,"2015"
"31261","350450 AVARE",4,4,10,1356,0,1374,"2015"
"31262","350460 BADY BASSITT",0,0,1,239,0,240,"2015"
"31263","350470 BALBINOS",0,0,0,15,0,15,"2015"
"31264","350480 BALSAMO",0,0,0,95,0,95,"2015"
"31265","350490 BANANAL",0,0,1,85,4,90,"2015"
"31266","350500 BARAO DE ANTONINA",0,1,0,40,3,44,"2015"
"31267","350510 BARBOSA",0,2,3,95,0,100,"2015"
"31268","350520 BARIRI",0,0,3,399,5,407,"2015"
"31269","350530 BARRA BONITA",0,1,1,327,5,334,"2015"
"31270","350535 BARRA DO CHAPEU",0,1,1,70,0,72,"2015"
"31271","350540 BARRA DO TURVO",0,0,0,82,1,83,"2015"
"31272","350550 BARRETOS",9,10,35,1565,4,1623,"2015"
"31273","350560 BARRINHA",1,2,9,482,4,498,"2015"
"31274","350570 BARUERI",13,14,60,5565,14,5666,"2015"
"31275","350580 BASTOS",1,0,6,320,0,327,"2015"
"31276","350590 BATATAIS",2,5,1,740,5,753,"2015"
"31277","350600 BAURU",18,19,68,4901,29,5035,"2015"
"31278","350610 BEBEDOURO",1,9,9,929,0,948,"2015"
"31279","350620 BENTO DE ABREU",0,0,1,35,1,37,"2015"
"31280","350630 BERNARDINO DE CAMPOS",0,1,1,145,1,148,"2015"
"31281","350635 BERTIOGA",0,6,15,958,2,981,"2015"
"31282","350640 BILAC",0,0,2,103,0,105,"2015"
"31283","350650 BIRIGUI",4,4,12,1520,0,1540,"2015"
"31284","350660 BIRITIBA-MIRIM",0,2,4,335,2,343,"2015"
"31285","350670 BOA ESPERANCA DO SUL",1,2,1,168,2,174,"2015"
"31286","350680 BOCAINA",0,0,0,141,0,141,"2015"
"31287","350690 BOFETE",1,1,4,128,1,135,"2015"
"31288","350700 BOITUVA",2,2,13,830,1,848,"2015"
"31289","350710 BOM JESUS DOS PERDOES",0,0,2,322,2,326,"2015"
"31290","350715 BOM SUCESSO DE ITARARE",0,0,2,78,1,81,"2015"
"31291","350720 BORA",0,0,0,11,0,11,"2015"
"31292","350730 BORACEIA",0,1,0,57,0,58,"2015"
"31293","350740 BORBOREMA",1,2,0,138,0,141,"2015"
"31294","350745 BOREBI",0,0,0,45,0,45,"2015"
"31295","350750 BOTUCATU",4,9,44,1835,9,1901,"2015"
"31296","350760 BRAGANCA PAULISTA",2,12,15,2223,6,2258,"2015"
"31297","350770 BRAUNA",0,0,2,63,1,66,"2015"
"31298","350775 BREJO ALEGRE",0,1,1,35,0,37,"2015"
"31299","350780 BRODOWSKI",2,2,9,266,6,285,"2015"
"31300","350790 BROTAS",1,1,3,316,9,330,"2015"
"31301","350800 BURI",2,0,20,301,1,324,"2015"
"31302","350810 BURITAMA",0,1,9,206,1,217,"2015"
"31303","350820 BURITIZAL",0,2,1,51,0,54,"2015"
"31304","350830 CABRALIA PAULISTA",0,0,0,52,0,52,"2015"
"31305","350840 CABREUVA",2,4,13,797,1,817,"2015"
"31306","350850 CACAPAVA",1,10,5,1314,0,1330,"2015"
"31307","350860 CACHOEIRA PAULISTA",2,2,5,350,29,388,"2015"
"31308","350870 CACONDE",1,0,4,192,2,199,"2015"
"31309","350880 CAFELANDIA",0,1,3,230,1,235,"2015"
"31310","350890 CAIABU",0,0,0,34,1,35,"2015"
"31311","350900 CAIEIRAS",3,7,16,1395,5,1426,"2015"
"31312","350910 CAIUA",0,0,0,38,0,38,"2015"
"31313","350920 CAJAMAR",5,5,21,1269,4,1304,"2015"
"31314","350925 CAJATI",4,1,6,458,1,470,"2015"
"31315","350930 CAJOBI",2,0,0,134,1,137,"2015"
"31316","350940 CAJURU",0,0,3,349,28,380,"2015"
"31317","350945 CAMPINA DO MONTE ALEGRE",0,0,2,73,0,75,"2015"
"31318","350950 CAMPINAS",30,69,188,15817,92,16196,"2015"
"31319","350960 CAMPO LIMPO PAULISTA",5,5,22,1191,1,1224,"2015"
"31320","350970 CAMPOS DO JORDAO",1,2,12,743,0,758,"2015"
"31321","350980 CAMPOS NOVOS PAULISTA",0,1,0,54,0,55,"2015"
"31322","350990 CANANEIA",0,1,2,206,3,212,"2015"
"31323","350995 CANAS",3,0,2,72,4,81,"2015"
"31324","351000 CANDIDO MOTA",1,1,3,324,5,334,"2015"
"31325","351010 CANDIDO RODRIGUES",0,0,1,20,0,21,"2015"
"31326","351015 CANITAR",0,0,1,64,0,65,"2015"
"31327","351020 CAPAO BONITO",0,2,4,655,1,662,"2015"
"31328","351030 CAPELA DO ALTO",0,3,2,252,1,258,"2015"
"31329","351040 CAPIVARI",1,1,4,706,1,713,"2015"
"31330","351050 CARAGUATATUBA",8,3,20,1734,5,1770,"2015"
"31331","351060 CARAPICUIBA",13,17,64,7126,32,7252,"2015"
"31332","351070 CARDOSO",0,0,4,114,0,118,"2015"
"31333","351080 CASA BRANCA",2,1,6,310,4,323,"2015"
"31334","351090 CASSIA DOS COQUEIROS",0,1,0,23,0,24,"2015"
"31335","351100 CASTILHO",0,2,3,227,7,239,"2015"
"31336","351110 CATANDUVA",5,4,11,1394,3,1417,"2015"
"31337","351120 CATIGUA",0,0,0,95,0,95,"2015"
"31338","351130 CEDRAL",0,0,3,111,1,115,"2015"
"31339","351140 CERQUEIRA CESAR",2,4,2,253,0,261,"2015"
"31340","351150 CERQUILHO",4,1,9,544,2,560,"2015"
"31341","351160 CESARIO LANGE",1,1,5,236,0,243,"2015"
"31342","351170 CHARQUEADA",1,1,0,226,0,228,"2015"
"31343","351190 CLEMENTINA",0,0,2,115,0,117,"2015"
"31344","351200 COLINA",1,1,1,257,1,261,"2015"
"31345","351210 COLOMBIA",1,0,1,104,0,106,"2015"
"31346","351220 CONCHAL",1,1,5,388,3,398,"2015"
"31347","351230 CONCHAS",0,3,4,199,1,207,"2015"
"31348","351240 CORDEIROPOLIS",1,2,4,286,0,293,"2015"
"31349","351250 COROADOS",0,0,0,65,0,65,"2015"
"31350","351260 CORONEL MACEDO",0,0,1,46,2,49,"2015"
"31351","351270 CORUMBATAI",0,0,0,52,0,52,"2015"
"31352","351280 COSMOPOLIS",0,4,10,759,1,774,"2015"
"31353","351290 COSMORAMA",0,0,1,87,0,88,"2015"
"31354","351300 COTIA",7,10,44,4376,13,4450,"2015"
"31355","351310 CRAVINHOS",0,1,11,436,1,449,"2015"
"31356","351320 CRISTAIS PAULISTA",0,0,2,116,1,119,"2015"
"31357","351330 CRUZALIA",0,0,0,23,0,23,"2015"
"31358","351340 CRUZEIRO",4,4,16,896,120,1040,"2015"
"31359","351350 CUBATAO",6,12,45,1846,5,1914,"2015"
"31360","351360 CUNHA",0,1,4,214,2,221,"2015"
"31361","351370 DESCALVADO",0,4,5,372,0,381,"2015"
"31362","351380 DIADEMA",21,25,79,6154,13,6292,"2015"
"31363","351385 DIRCE REIS",0,0,0,13,0,13,"2015"
"31364","351390 DIVINOLANDIA",0,0,0,127,0,127,"2015"
"31365","351400 DOBRADA",0,0,0,121,0,121,"2015"
"31366","351410 DOIS CORREGOS",1,1,5,335,8,350,"2015"
"31367","351420 DOLCINOPOLIS",0,1,0,18,0,19,"2015"
"31368","351430 DOURADO",0,0,0,99,1,100,"2015"
"31369","351440 DRACENA",1,0,1,481,1,484,"2015"
"31370","351450 DUARTINA",0,1,3,134,0,138,"2015"
"31371","351460 DUMONT",1,2,2,114,0,119,"2015"
"31372","351470 ECHAPORA",0,0,0,82,0,82,"2015"
"31373","351480 ELDORADO",0,2,1,227,2,232,"2015"
"31374","351490 ELIAS FAUSTO",0,0,2,227,1,230,"2015"
"31375","351492 ELISIARIO",0,0,0,43,0,43,"2015"
"31376","351495 EMBAUBA",0,0,0,18,0,18,"2015"
"31377","351500 EMBU DAS ARTES",9,20,47,4463,15,4554,"2015"
"31378","351510 EMBU-GUACU",2,5,15,981,2,1005,"2015"
"31379","351512 EMILIANOPOLIS",0,0,0,40,0,40,"2015"
"31380","351515 ENGENHEIRO COELHO",2,2,2,279,1,286,"2015"
"31381","351518 ESPIRITO SANTO DO PINHAL",1,3,12,434,2,452,"2015"
"31382","351519 ESPIRITO SANTO DO TURVO",0,1,0,64,1,66,"2015"
"31383","351520 ESTRELA D'OESTE",0,0,0,93,0,93,"2015"
"31384","351530 ESTRELA DO NORTE",0,0,1,49,0,50,"2015"
"31385","351535 EUCLIDES DA CUNHA PAULISTA",0,1,1,118,0,120,"2015"
"31386","351540 FARTURA",1,1,2,221,0,225,"2015"
"31387","351550 FERNANDOPOLIS",0,4,18,843,0,865,"2015"
"31388","351560 FERNANDO PRESTES",0,3,3,48,0,54,"2015"
"31389","351565 FERNAO",0,0,1,13,0,14,"2015"
"31390","351570 FERRAZ DE VASCONCELOS",11,17,51,3090,28,3197,"2015"
"31391","351580 FLORA RICA",0,0,0,13,0,13,"2015"
"31392","351590 FLOREAL",0,0,0,33,0,33,"2015"
"31393","351600 FLORIDA PAULISTA",0,3,0,121,1,125,"2015"
"31394","351610 FLORINIA",0,1,0,39,0,40,"2015"
"31395","351620 FRANCA",10,11,54,4829,7,4911,"2015"
"31396","351630 FRANCISCO MORATO",9,8,43,3036,18,3114,"2015"
"31397","351640 FRANCO DA ROCHA",4,10,32,2311,11,2368,"2015"
"31398","351650 GABRIEL MONTEIRO",0,0,1,31,0,32,"2015"
"31399","351660 GALIA",0,0,1,66,0,67,"2015"
"31400","351670 GARCA",1,5,16,530,1,553,"2015"
"31401","351680 GASTAO VIDIGAL",0,1,0,43,0,44,"2015"
"31402","351685 GAVIAO PEIXOTO",0,0,0,67,0,67,"2015"
"31403","351690 GENERAL SALGADO",0,1,1,96,4,102,"2015"
"31404","351700 GETULINA",0,1,1,120,1,123,"2015"
"31405","351710 GLICERIO",0,0,1,62,0,63,"2015"
"31406","351720 GUAICARA",0,0,2,131,2,135,"2015"
"31407","351730 GUAIMBE",0,0,0,69,0,69,"2015"
"31408","351740 GUAIRA",2,3,4,433,0,442,"2015"
"31409","351750 GUAPIACU",0,0,3,242,1,246,"2015"
"31410","351760 GUAPIARA",0,3,3,252,0,258,"2015"
"31411","351770 GUARA",0,2,0,264,1,267,"2015"
"31412","351780 GUARACAI",0,0,2,71,4,77,"2015"
"31413","351790 GUARACI",0,2,3,108,0,113,"2015"
"31414","351800 GUARANI D'OESTE",0,0,1,19,0,20,"2015"
"31415","351810 GUARANTA",0,0,3,71,0,74,"2015"
"31416","351820 GUARARAPES",0,5,7,413,0,425,"2015"
"31417","351830 GUARAREMA",0,3,4,422,0,429,"2015"
"31418","351840 GUARATINGUETA",2,6,36,1356,61,1461,"2015"
"31419","351850 GUAREI",1,1,1,118,2,123,"2015"
"31420","351860 GUARIBA",0,5,20,454,7,486,"2015"
"31421","351870 GUARUJA",3,20,57,4566,106,4752,"2015"
"31422","351880 GUARULHOS",33,111,328,21770,73,22315,"2015"
"31423","351885 GUATAPARA",0,3,3,101,1,108,"2015"
"31424","351890 GUZOLANDIA",0,0,1,57,6,64,"2015"
"31425","351900 HERCULANDIA",1,1,0,106,0,108,"2015"
"31426","351905 HOLAMBRA",0,0,1,225,0,226,"2015"
"31427","351907 HORTOLANDIA",4,20,45,3098,3,3170,"2015"
"31428","351910 IACANGA",1,1,5,149,10,166,"2015"
"31429","351920 IACRI",1,0,0,58,0,59,"2015"
"31430","351925 IARAS",1,0,1,72,0,74,"2015"
"31431","351930 IBATE",0,0,6,474,1,481,"2015"
"31432","351940 IBIRA",1,1,0,130,0,132,"2015"
"31433","351950 IBIRAREMA",0,1,1,71,1,74,"2015"
"31434","351960 IBITINGA",2,0,7,777,4,790,"2015"
"31435","351970 IBIUNA",9,0,10,1061,26,1106,"2015"
"31436","351980 ICEM",0,0,0,113,0,113,"2015"
"31437","351990 IEPE",1,0,0,113,0,114,"2015"
"31438","352000 IGARACU DO TIETE",0,0,2,269,0,271,"2015"
"31439","352010 IGARAPAVA",1,1,5,320,2,329,"2015"
"31440","352020 IGARATA",1,1,1,127,0,130,"2015"
"31441","352030 IGUAPE",0,2,3,388,1,394,"2015"
"31442","352040 ILHABELA",0,1,10,458,1,470,"2015"
"31443","352042 ILHA COMPRIDA",0,0,2,152,2,156,"2015"
"31444","352044 ILHA SOLTEIRA",0,0,0,269,6,275,"2015"
"31445","352050 INDAIATUBA",8,4,29,3076,4,3121,"2015"
"31446","352060 INDIANA",1,0,0,61,1,63,"2015"
"31447","352070 INDIAPORA",0,1,2,46,0,49,"2015"
"31448","352080 INUBIA PAULISTA",0,0,0,36,0,36,"2015"
"31449","352090 IPAUSSU",0,0,2,146,0,148,"2015"
"31450","352100 IPERO",1,2,8,404,1,416,"2015"
"31451","352110 IPEUNA",0,0,1,97,1,99,"2015"
"31452","352115 IPIGUA",0,0,1,69,0,70,"2015"
"31453","352120 IPORANGA",0,0,1,51,1,53,"2015"
"31454","352130 IPUA",0,0,2,190,1,193,"2015"
"31455","352140 IRACEMAPOLIS",1,0,5,240,1,247,"2015"
"31456","352150 IRAPUA",0,0,0,79,0,79,"2015"
"31457","352160 IRAPURU",0,0,1,69,0,70,"2015"
"31458","352170 ITABERA",0,5,17,244,2,268,"2015"
"31459","352180 ITAI",1,2,2,289,0,294,"2015"
"31460","352190 ITAJOBI",1,1,3,140,0,145,"2015"
"31461","352200 ITAJU",0,0,0,41,0,41,"2015"
"31462","352210 ITANHAEM",1,1,22,1388,11,1423,"2015"
"31463","352215 ITAOCA",0,0,3,42,1,46,"2015"
"31464","352220 ITAPECERICA DA SERRA",14,12,36,2806,4,2872,"2015"
"31465","352230 ITAPETININGA",5,11,31,2181,10,2238,"2015"
"31466","352240 ITAPEVA",7,23,61,1414,0,1505,"2015"
"31467","352250 ITAPEVI",10,12,65,4370,17,4474,"2015"
"31468","352260 ITAPIRA",0,0,6,859,0,865,"2015"
"31469","352265 ITAPIRAPUA PAULISTA",1,0,4,61,0,66,"2015"
"31470","352270 ITAPOLIS",1,0,11,438,2,452,"2015"
"31471","352280 ITAPORANGA",0,0,0,190,7,197,"2015"
"31472","352290 ITAPUI",0,1,2,157,12,172,"2015"
"31473","352300 ITAPURA",0,0,2,68,1,71,"2015"
"31474","352310 ITAQUAQUECETUBA",11,21,73,6186,46,6337,"2015"
"31475","352320 ITARARE",1,2,10,649,0,662,"2015"
"31476","352330 ITARIRI",0,0,1,149,2,152,"2015"
"31477","352340 ITATIBA",3,3,16,1462,3,1487,"2015"
"31478","352350 ITATINGA",0,0,3,280,2,285,"2015"
"31479","352360 ITIRAPINA",0,0,1,145,1,147,"2015"
"31480","352370 ITIRAPUA",2,0,1,64,1,68,"2015"
"31481","352380 ITOBI",0,0,0,86,0,86,"2015"
"31482","352390 ITU",4,9,23,2424,9,2469,"2015"
"31483","352400 ITUPEVA",0,4,10,889,0,903,"2015"
"31484","352410 ITUVERAVA",4,0,3,485,1,493,"2015"
"31485","352420 JABORANDI",0,0,0,67,0,67,"2015"
"31486","352430 JABOTICABAL",2,3,12,862,2,881,"2015"
"31487","352440 JACAREI",8,15,52,3207,26,3308,"2015"
"31488","352450 JACI",0,0,0,92,0,92,"2015"
"31489","352460 JACUPIRANGA",1,0,2,248,0,251,"2015"
"31490","352470 JAGUARIUNA",3,3,6,849,3,864,"2015"
"31491","352480 JALES",1,2,1,541,0,545,"2015"
"31492","352490 JAMBEIRO",0,1,0,75,0,76,"2015"
"31493","352500 JANDIRA",4,5,32,1871,9,1921,"2015"
"31494","352510 JARDINOPOLIS",1,5,10,558,2,576,"2015"
"31495","352520 JARINU",1,6,5,455,2,469,"2015"
"31496","352530 JAU",3,7,12,1742,15,1779,"2015"
"31497","352540 JERIQUARA",0,0,0,45,1,46,"2015"
"31498","352550 JOANOPOLIS",0,0,1,151,4,156,"2015"
"31499","352560 JOAO RAMALHO",0,1,1,83,0,85,"2015"
"31500","352570 JOSE BONIFACIO",1,1,6,448,4,460,"2015"
"31501","352580 JULIO MESQUITA",0,1,1,57,0,59,"2015"
"31502","352585 JUMIRIM",0,0,0,33,0,33,"2015"
"31503","352590 JUNDIAI",13,14,105,5678,12,5822,"2015"
"31504","352600 JUNQUEIROPOLIS",1,0,3,237,0,241,"2015"
"31505","352610 JUQUIA",1,0,0,278,8,287,"2015"
"31506","352620 JUQUITIBA",1,4,10,459,8,482,"2015"
"31507","352630 LAGOINHA",0,0,1,33,2,36,"2015"
"31508","352640 LARANJAL PAULISTA",2,3,6,347,0,358,"2015"
"31509","352650 LAVINIA",0,1,1,51,0,53,"2015"
"31510","352660 LAVRINHAS",1,0,4,96,13,114,"2015"
"31511","352670 LEME",3,4,8,1227,3,1245,"2015"
"31512","352680 LENCOIS PAULISTA",2,2,37,853,1,895,"2015"
"31513","352690 LIMEIRA",4,12,34,3551,4,3605,"2015"
"31514","352700 LINDOIA",0,1,0,75,0,76,"2015"
"31515","352710 LINS",1,2,3,906,8,920,"2015"
"31516","352720 LORENA",8,1,10,1134,122,1275,"2015"
"31517","352725 LOURDES",0,0,3,20,0,23,"2015"
"31518","352730 LOUVEIRA",1,1,11,746,2,761,"2015"
"31519","352740 LUCELIA",0,3,4,176,0,183,"2015"
"31520","352750 LUCIANOPOLIS",0,1,0,27,0,28,"2015"
"31521","352760 LUIS ANTONIO",0,1,6,186,1,194,"2015"
"31522","352770 LUIZIANIA",0,1,4,74,0,79,"2015"
"31523","352780 LUPERCIO",0,1,5,50,0,56,"2015"
"31524","352790 LUTECIA",0,0,0,22,0,22,"2015"
"31525","352800 MACATUBA",0,0,2,197,2,201,"2015"
"31526","352810 MACAUBAL",0,0,1,87,2,90,"2015"
"31527","352820 MACEDONIA",0,0,0,32,0,32,"2015"
"31528","352830 MAGDA",0,0,0,39,0,39,"2015"
"31529","352840 MAIRINQUE",4,0,9,717,2,732,"2015"
"31530","352850 MAIRIPORA",2,5,11,1152,1,1171,"2015"
"31531","352860 MANDURI",1,2,0,95,3,101,"2015"
"31532","352870 MARABA PAULISTA",0,0,1,36,0,37,"2015"
"31533","352880 MARACAI",2,0,3,189,0,194,"2015"
"31534","352885 MARAPOAMA",0,0,0,31,0,31,"2015"
"31535","352890 MARIAPOLIS",1,0,1,37,0,39,"2015"
"31536","352900 MARILIA",5,20,64,2943,10,3042,"2015"
"31537","352910 MARINOPOLIS",0,0,0,20,0,20,"2015"
"31538","352920 MARTINOPOLIS",3,3,4,297,3,310,"2015"
"31539","352930 MATAO",1,5,13,1113,2,1134,"2015"
"31540","352940 MAUA",12,24,88,5878,26,6028,"2015"
"31541","352950 MENDONCA",0,0,0,59,0,59,"2015"
"31542","352960 MERIDIANO",0,0,0,47,0,47,"2015"
"31543","352965 MESOPOLIS",1,0,0,25,0,26,"2015"
"31544","352970 MIGUELOPOLIS",0,3,3,275,3,284,"2015"
"31545","352980 MINEIROS DO TIETE",0,0,0,154,2,156,"2015"
"31546","352990 MIRACATU",1,3,6,310,3,323,"2015"
"31547","353000 MIRA ESTRELA",0,0,0,25,0,25,"2015"
"31548","353010 MIRANDOPOLIS",0,0,7,287,7,301,"2015"
"31549","353020 MIRANTE DO PARANAPANEMA",1,2,2,189,1,195,"2015"
"31550","353030 MIRASSOL",2,1,5,740,2,750,"2015"
"31551","353040 MIRASSOLANDIA",0,0,0,52,0,52,"2015"
"31552","353050 MOCOCA",1,3,19,816,7,846,"2015"
"31553","353060 MOGI DAS CRUZES",8,15,68,6452,19,6562,"2015"
"31554","353070 MOGI GUACU",4,5,32,1885,9,1935,"2015"
"31555","353080 MOGI MIRIM",5,4,7,1228,1,1245,"2015"
"31556","353090 MOMBUCA",1,0,0,60,1,62,"2015"
"31557","353100 MONCOES",0,0,0,25,0,25,"2015"
"31558","353110 MONGAGUA",4,6,15,669,2,696,"2015"
"31559","353120 MONTE ALEGRE DO SUL",0,0,1,81,0,82,"2015"
"31560","353130 MONTE ALTO",0,3,11,512,9,535,"2015"
"31561","353140 MONTE APRAZIVEL",1,0,1,215,2,219,"2015"
"31562","353150 MONTE AZUL PAULISTA",1,1,0,230,1,233,"2015"
"31563","353160 MONTE CASTELO",0,0,2,52,0,54,"2015"
"31564","353170 MONTEIRO LOBATO",0,0,0,27,1,28,"2015"
"31565","353180 MONTE MOR",4,4,14,932,21,975,"2015"
"31566","353190 MORRO AGUDO",2,3,8,394,0,407,"2015"
"31567","353200 MORUNGABA",1,0,0,156,2,159,"2015"
"31568","353205 MOTUCA",0,0,0,57,0,57,"2015"
"31569","353210 MURUTINGA DO SUL",0,1,1,37,0,39,"2015"
"31570","353215 NANTES",0,1,1,31,0,33,"2015"
"31571","353220 NARANDIBA",0,0,1,91,1,93,"2015"
"31572","353230 NATIVIDADE DA SERRA",0,0,2,63,0,65,"2015"
"31573","353240 NAZARE PAULISTA",0,0,0,230,0,230,"2015"
"31574","353250 NEVES PAULISTA",0,0,0,82,0,82,"2015"
"31575","353260 NHANDEARA",0,0,0,97,0,97,"2015"
"31576","353270 NIPOA",0,0,1,78,0,79,"2015"
"31577","353280 NOVA ALIANCA",0,1,0,80,1,82,"2015"
"31578","353282 NOVA CAMPINA",1,2,7,135,0,145,"2015"
"31579","353284 NOVA CANAA PAULISTA",0,0,0,20,0,20,"2015"
"31580","353286 NOVA CASTILHO",0,0,0,19,1,20,"2015"
"31581","353290 NOVA EUROPA",0,1,2,139,0,142,"2015"
"31582","353300 NOVA GRANADA",1,3,1,242,1,248,"2015"
"31583","353310 NOVA GUATAPORANGA",0,0,0,12,0,12,"2015"
"31584","353320 NOVA INDEPENDENCIA",0,0,0,47,0,47,"2015"
"31585","353325 NOVAIS",0,0,0,64,0,64,"2015"
"31586","353330 NOVA LUZITANIA",0,1,0,30,0,31,"2015"
"31587","353340 NOVA ODESSA",2,2,1,723,3,731,"2015"
"31588","353350 NOVO HORIZONTE",1,1,5,538,0,545,"2015"
"31589","353360 NUPORANGA",0,1,1,83,0,85,"2015"
"31590","353370 OCAUCU",0,0,3,57,0,60,"2015"
"31591","353380 OLEO",0,0,0,24,1,25,"2015"
"31592","353390 OLIMPIA",1,1,14,659,7,682,"2015"
"31593","353400 ONDA VERDE",0,0,2,69,0,71,"2015"
"31594","353410 ORIENTE",0,1,4,86,1,92,"2015"
"31595","353420 ORINDIUVA",0,0,0,66,2,68,"2015"
"31596","353430 ORLANDIA",1,2,4,515,0,522,"2015"
"31597","353440 OSASCO",20,31,142,10779,40,11012,"2015"
"31598","353450 OSCAR BRESSANE",0,0,0,24,0,24,"2015"
"31599","353460 OSVALDO CRUZ",1,0,7,284,1,293,"2015"
"31600","353470 OURINHOS",1,3,17,1377,6,1404,"2015"
"31601","353475 OUROESTE",0,0,1,138,0,139,"2015"
"31602","353480 OURO VERDE",0,1,4,95,0,100,"2015"
"31603","353490 PACAEMBU",0,1,0,95,1,97,"2015"
"31604","353500 PALESTINA",0,0,0,122,0,122,"2015"
"31605","353510 PALMARES PAULISTA",0,2,5,121,0,128,"2015"
"31606","353520 PALMEIRA D'OESTE",0,0,0,94,0,94,"2015"
"31607","353530 PALMITAL",0,0,1,252,1,254,"2015"
"31608","353540 PANORAMA",0,0,11,224,0,235,"2015"
"31609","353550 PARAGUACU PAULISTA",1,3,7,580,3,594,"2015"
"31610","353560 PARAIBUNA",0,1,5,228,1,235,"2015"
"31611","353570 PARAISO",0,0,2,58,0,60,"2015"
"31612","353580 PARANAPANEMA",0,1,2,237,6,246,"2015"
"31613","353590 PARANAPUA",0,0,0,35,0,35,"2015"
"31614","353600 PARAPUA",2,0,3,128,1,134,"2015"
"31615","353610 PARDINHO",0,0,0,91,1,92,"2015"
"31616","353620 PARIQUERA-ACU",1,1,5,311,2,320,"2015"
"31617","353625 PARISI",0,0,0,24,0,24,"2015"
"31618","353630 PATROCINIO PAULISTA",0,1,5,181,4,191,"2015"
"31619","353640 PAULICEIA",0,0,0,120,0,120,"2015"
"31620","353650 PAULINIA",2,7,20,1457,3,1489,"2015"
"31621","353657 PAULISTANIA",0,0,1,17,0,18,"2015"
"31622","353660 PAULO DE FARIA",0,1,0,76,0,77,"2015"
"31623","353670 PEDERNEIRAS",2,1,9,607,2,621,"2015"
"31624","353680 PEDRA BELA",0,0,0,58,1,59,"2015"
"31625","353690 PEDRANOPOLIS",0,0,0,16,0,16,"2015"
"31626","353700 PEDREGULHO",0,1,0,240,0,241,"2015"
"31627","353710 PEDREIRA",2,5,4,492,3,506,"2015"
"31628","353715 PEDRINHAS PAULISTA",0,0,0,26,0,26,"2015"
"31629","353720 PEDRO DE TOLEDO",0,1,1,108,4,114,"2015"
"31630","353730 PENAPOLIS",2,4,17,797,0,820,"2015"
"31631","353740 PEREIRA BARRETO",1,0,8,286,4,299,"2015"
"31632","353750 PEREIRAS",0,0,5,118,0,123,"2015"
"31633","353760 PERUIBE",0,2,18,989,2,1011,"2015"
"31634","353770 PIACATU",2,0,0,56,0,58,"2015"
"31635","353780 PIEDADE",2,2,13,754,3,774,"2015"
"31636","353790 PILAR DO SUL",2,2,11,407,0,422,"2015"
"31637","353800 PINDAMONHANGABA",1,7,36,2265,22,2331,"2015"
"31638","353810 PINDORAMA",0,0,1,144,1,146,"2015"
"31639","353820 PINHALZINHO",0,0,0,168,0,168,"2015"
"31640","353830 PIQUEROBI",0,0,0,32,0,32,"2015"
"31641","353850 PIQUETE",0,0,3,139,18,160,"2015"
"31642","353860 PIRACAIA",0,3,2,340,2,347,"2015"
"31643","353870 PIRACICABA",20,18,71,5292,10,5411,"2015"
"31644","353880 PIRAJU",1,1,1,392,0,395,"2015"
"31645","353890 PIRAJUI",2,2,3,228,2,237,"2015"
"31646","353900 PIRANGI",0,1,2,126,0,129,"2015"
"31647","353910 PIRAPORA DO BOM JESUS",0,1,7,259,0,267,"2015"
"31648","353920 PIRAPOZINHO",1,1,5,309,0,316,"2015"
"31649","353930 PIRASSUNUNGA",0,2,12,882,7,903,"2015"
"31650","353940 PIRATININGA",0,0,2,151,1,154,"2015"
"31651","353950 PITANGUEIRAS",0,1,5,483,1,490,"2015"
"31652","353960 PLANALTO",0,0,2,57,0,59,"2015"
"31653","353970 PLATINA",0,0,1,37,0,38,"2015"
"31654","353980 POA",8,8,19,1589,13,1637,"2015"
"31655","353990 POLONI",0,0,1,67,2,70,"2015"
"31656","354000 POMPEIA",0,1,3,252,0,256,"2015"
"31657","354010 PONGAI",0,1,0,34,0,35,"2015"
"31658","354020 PONTAL",2,1,3,589,1,596,"2015"
"31659","354025 PONTALINDA",0,0,0,61,0,61,"2015"
"31660","354030 PONTES GESTAL",0,0,0,37,0,37,"2015"
"31661","354040 POPULINA",1,0,0,33,1,35,"2015"
"31662","354050 PORANGABA",0,0,1,83,2,86,"2015"
"31663","354060 PORTO FELIZ",2,2,4,735,2,745,"2015"
"31664","354070 PORTO FERREIRA",1,0,1,656,0,658,"2015"
"31665","354075 POTIM",0,1,4,235,8,248,"2015"
"31666","354080 POTIRENDABA",0,1,3,208,0,212,"2015"
"31667","354085 PRACINHA",0,0,0,15,0,15,"2015"
"31668","354090 PRADOPOLIS",1,2,4,194,0,201,"2015"
"31669","354100 PRAIA GRANDE",11,39,125,4252,20,4447,"2015"
"31670","354105 PRATANIA",1,0,2,64,1,68,"2015"
"31671","354110 PRESIDENTE ALVES",0,0,0,54,0,54,"2015"
"31672","354120 PRESIDENTE BERNARDES",0,0,3,140,1,144,"2015"
"31673","354130 PRESIDENTE EPITACIO",3,1,3,549,0,556,"2015"
"31674","354140 PRESIDENTE PRUDENTE",4,6,40,2848,5,2903,"2015"
"31675","354150 PRESIDENTE VENCESLAU",4,0,5,422,0,431,"2015"
"31676","354160 PROMISSAO",1,2,3,486,6,498,"2015"
"31677","354165 QUADRA",0,0,0,43,0,43,"2015"
"31678","354170 QUATA",0,2,1,186,1,190,"2015"
"31679","354180 QUEIROZ",0,0,0,44,0,44,"2015"
"31680","354190 QUELUZ",0,1,4,100,18,123,"2015"
"31681","354200 QUINTANA",0,0,2,75,0,77,"2015"
"31682","354210 RAFARD",1,0,1,99,0,101,"2015"
"31683","354220 RANCHARIA",1,1,2,362,0,366,"2015"
"31684","354230 REDENCAO DA SERRA",0,0,0,41,0,41,"2015"
"31685","354240 REGENTE FEIJO",0,1,7,231,0,239,"2015"
"31686","354250 REGINOPOLIS",0,0,1,62,0,63,"2015"
"31687","354260 REGISTRO",1,4,10,935,4,954,"2015"
"31688","354270 RESTINGA",0,0,1,112,0,113,"2015"
"31689","354280 RIBEIRA",0,0,1,43,0,44,"2015"
"31690","354290 RIBEIRAO BONITO",0,0,0,165,1,166,"2015"
"31691","354300 RIBEIRAO BRANCO",3,7,9,281,4,304,"2015"
"31692","354310 RIBEIRAO CORRENTE",0,0,1,53,0,54,"2015"
"31693","354320 RIBEIRAO DO SUL",0,0,1,50,0,51,"2015"
"31694","354323 RIBEIRAO DOS INDIOS",0,0,0,12,0,12,"2015"
"31695","354325 RIBEIRAO GRANDE",0,2,0,86,0,88,"2015"
"31696","354330 RIBEIRAO PIRES",6,7,24,1394,10,1441,"2015"
"31697","354340 RIBEIRAO PRETO",18,46,140,8575,55,8834,"2015"
"31698","354350 RIVERSUL",0,1,3,79,0,83,"2015"
"31699","354360 RIFAINA",0,0,1,38,1,40,"2015"
"31700","354370 RINCAO",0,0,3,131,0,134,"2015"
"31701","354380 RINOPOLIS",1,1,2,106,0,110,"2015"
"31702","354390 RIO CLARO",5,12,31,2518,9,2575,"2015"
"31703","354400 RIO DAS PEDRAS",0,2,13,434,0,449,"2015"
"31704","354410 RIO GRANDE DA SERRA",0,0,10,688,8,706,"2015"
"31705","354420 RIOLANDIA",0,0,0,140,1,141,"2015"
"31706","354425 ROSANA",0,0,6,245,1,252,"2015"
"31707","354430 ROSEIRA",0,0,2,139,2,143,"2015"
"31708","354440 RUBIACEA",0,0,1,41,0,42,"2015"
"31709","354450 RUBINEIA",2,0,1,26,0,29,"2015"
"31710","354460 SABINO",0,0,0,59,0,59,"2015"
"31711","354470 SAGRES",0,0,0,30,0,30,"2015"
"31712","354480 SALES",0,0,0,70,0,70,"2015"
"31713","354490 SALES OLIVEIRA",0,1,0,118,1,120,"2015"
"31714","354500 SALESOPOLIS",0,1,1,176,3,181,"2015"
"31715","354510 SALMOURAO",0,0,0,46,0,46,"2015"
"31716","354515 SALTINHO",0,0,2,114,0,116,"2015"
"31717","354520 SALTO",2,2,21,1636,2,1663,"2015"
"31718","354530 SALTO DE PIRAPORA",2,2,13,583,0,600,"2015"
"31719","354540 SALTO GRANDE",1,0,1,118,0,120,"2015"
"31720","354550 SANDOVALINA",0,1,2,58,0,61,"2015"
"31721","354560 SANTA ADELIA",0,0,2,157,1,160,"2015"
"31722","354570 SANTA ALBERTINA",0,0,0,60,0,60,"2015"
"31723","354580 SANTA BARBARA D'OESTE",3,10,47,2367,8,2435,"2015"
"31724","354600 SANTA BRANCA",0,3,4,157,3,167,"2015"
"31725","354610 SANTA CLARA D'OESTE",0,0,1,18,0,19,"2015"
"31726","354620 SANTA CRUZ DA CONCEICAO",0,0,0,43,0,43,"2015"
"31727","354625 SANTA CRUZ DA ESPERANCA",0,0,1,20,2,23,"2015"
"31728","354630 SANTA CRUZ DAS PALMEIRAS",0,2,6,384,1,393,"2015"
"31729","354640 SANTA CRUZ DO RIO PARDO",0,2,4,579,1,586,"2015"
"31730","354650 SANTA ERNESTINA",0,0,0,44,0,44,"2015"
"31731","354660 SANTA FE DO SUL",2,3,3,424,2,434,"2015"
"31732","354670 SANTA GERTRUDES",0,1,5,360,2,368,"2015"
"31733","354680 SANTA ISABEL",1,5,19,769,1,795,"2015"
"31734","354690 SANTA LUCIA",0,0,1,128,0,129,"2015"
"31735","354700 SANTA MARIA DA SERRA",0,0,1,80,0,81,"2015"
"31736","354710 SANTA MERCEDES",1,0,1,35,0,37,"2015"
"31737","354720 SANTANA DA PONTE PENSA",0,0,0,9,0,9,"2015"
"31738","354730 SANTANA DE PARNAIBA",4,11,28,2183,6,2232,"2015"
"31739","354740 SANTA RITA D'OESTE",0,0,0,17,0,17,"2015"
"31740","354750 SANTA RITA DO PASSA QUATRO",0,0,0,250,0,250,"2015"
"31741","354760 SANTA ROSA DE VITERBO",2,1,7,274,6,290,"2015"
"31742","354765 SANTA SALETE",0,0,0,13,0,13,"2015"
"31743","354770 SANTO ANASTACIO",0,2,5,218,1,226,"2015"
"31744","354780 SANTO ANDRE",30,26,124,9014,64,9258,"2015"
"31745","354790 SANTO ANTONIO DA ALEGRIA",0,0,1,71,0,72,"2015"
"31746","354800 SANTO ANTONIO DE POSSE",0,1,9,273,1,284,"2015"
"31747","354805 SANTO ANTONIO DO ARACANGUA",0,0,1,108,7,116,"2015"
"31748","354810 SANTO ANTONIO DO JARDIM",0,0,1,49,0,50,"2015"
"31749","354820 SANTO ANTONIO DO PINHAL",0,0,1,88,1,90,"2015"
"31750","354830 SANTO EXPEDITO",0,0,0,41,0,41,"2015"
"31751","354840 SANTOPOLIS DO AGUAPEI",1,0,2,50,0,53,"2015"
"31752","354850 SANTOS",20,36,129,4684,18,4887,"2015"
"31753","354860 SAO BENTO DO SAPUCAI",0,0,0,138,0,138,"2015"
"31754","354870 SAO BERNARDO DO CAMPO",21,32,190,10958,51,11252,"2015"
"31755","354880 SAO CAETANO DO SUL",0,6,17,1794,3,1820,"2015"
"31756","354890 SAO CARLOS",5,16,25,3175,14,3235,"2015"
"31757","354900 SAO FRANCISCO",0,0,0,24,0,24,"2015"
"31758","354910 SAO JOAO DA BOA VISTA",4,6,13,1019,4,1046,"2015"
"31759","354920 SAO JOAO DAS DUAS PONTES",0,0,1,29,0,30,"2015"
"31760","354925 SAO JOAO DE IRACEMA",0,0,0,24,0,24,"2015"
"31761","354930 SAO JOAO DO PAU D'ALHO",0,0,0,25,0,25,"2015"
"31762","354940 SAO JOAQUIM DA BARRA",2,0,10,620,4,636,"2015"
"31763","354950 SAO JOSE DA BELA VISTA",0,0,0,103,1,104,"2015"
"31764","354960 SAO JOSE DO BARREIRO",0,1,1,33,6,41,"2015"
"31765","354970 SAO JOSE DO RIO PARDO",2,2,12,667,1,684,"2015"
"31766","354980 SAO JOSE DO RIO PRETO",10,15,27,5607,50,5709,"2015"
"31767","354990 SAO JOSE DOS CAMPOS",10,22,108,9633,35,9808,"2015"
"31768","354995 SAO LOURENCO DA SERRA",1,0,4,206,0,211,"2015"
"31769","355000 SAO LUIS DO PARAITINGA",0,0,7,92,1,100,"2015"
"31770","355010 SAO MANUEL",3,0,5,503,6,517,"2015"
"31771","355020 SAO MIGUEL ARCANJO",1,1,9,390,2,403,"2015"
"31772","355030 SAO PAULO",446,644,2462,172147,614,176313,"2015"
"31773","355040 SAO PEDRO",0,1,6,399,0,406,"2015"
"31774","355050 SAO PEDRO DO TURVO",0,1,1,88,3,93,"2015"
"31775","355060 SAO ROQUE",6,2,19,1124,6,1157,"2015"
"31776","355070 SAO SEBASTIAO",7,4,17,1322,8,1358,"2015"
"31777","355080 SAO SEBASTIAO DA GRAMA",0,0,0,115,1,116,"2015"
"31778","355090 SAO SIMAO",0,0,4,150,1,155,"2015"
"31779","355100 SAO VICENTE",10,35,151,4947,33,5176,"2015"
"31780","355110 SARAPUI",0,1,4,123,1,129,"2015"
"31781","355120 SARUTAIA",0,0,0,51,0,51,"2015"
"31782","355130 SEBASTIANOPOLIS DO SUL",0,0,0,30,0,30,"2015"
"31783","355140 SERRA AZUL",0,1,4,132,2,139,"2015"
"31784","355150 SERRANA",1,5,19,627,4,656,"2015"
"31785","355160 SERRA NEGRA",1,1,2,336,1,341,"2015"
"31786","355170 SERTAOZINHO",3,5,10,1715,14,1747,"2015"
"31787","355180 SETE BARRAS",1,0,4,196,0,201,"2015"
"31788","355190 SEVERINIA",1,1,2,208,3,215,"2015"
"31789","355200 SILVEIRAS",0,0,0,54,8,62,"2015"
"31790","355210 SOCORRO",0,0,1,372,1,374,"2015"
"31791","355220 SOROCABA",19,36,171,9200,20,9446,"2015"
"31792","355230 SUD MENNUCCI",3,0,0,95,1,99,"2015"
"31793","355240 SUMARE",8,12,58,3967,26,4071,"2015"
"31794","355250 SUZANO",8,37,105,4477,24,4651,"2015"
"31795","355255 SUZANAPOLIS",0,0,0,41,2,43,"2015"
"31796","355260 TABAPUA",0,0,0,141,1,142,"2015"
"31797","355270 TABATINGA",1,1,0,193,0,195,"2015"
"31798","355280 TABOAO DA SERRA",13,16,67,4590,16,4702,"2015"
"31799","355290 TACIBA",0,0,2,89,0,91,"2015"
"31800","355300 TAGUAI",1,1,1,177,0,180,"2015"
"31801","355310 TAIACU",0,1,0,86,1,88,"2015"
"31802","355320 TAIUVA",0,0,1,53,0,54,"2015"
"31803","355330 TAMBAU",0,3,1,311,0,315,"2015"
"31804","355340 TANABI",0,2,1,289,0,292,"2015"
"31805","355350 TAPIRAI",0,0,2,119,2,123,"2015"
"31806","355360 TAPIRATIBA",1,1,0,143,2,147,"2015"
"31807","355365 TAQUARAL",0,0,0,32,0,32,"2015"
"31808","355370 TAQUARITINGA",1,6,10,652,1,670,"2015"
"31809","355380 TAQUARITUBA",2,2,10,324,0,338,"2015"
"31810","355385 TAQUARIVAI",0,0,5,72,0,77,"2015"
"31811","355390 TARABAI",1,0,1,96,1,99,"2015"
"31812","355395 TARUMA",1,0,4,221,0,226,"2015"
"31813","355400 TATUI",2,6,26,1710,5,1749,"2015"
"31814","355410 TAUBATE",9,23,77,3900,22,4031,"2015"
"31815","355420 TEJUPA",0,1,0,60,0,61,"2015"
"31816","355430 TEODORO SAMPAIO",0,1,5,381,0,387,"2015"
"31817","355440 TERRA ROXA",0,0,3,64,29,96,"2015"
"31818","355450 TIETE",1,2,6,504,1,514,"2015"
"31819","355460 TIMBURI",0,0,0,19,0,19,"2015"
"31820","355465 TORRE DE PEDRA",0,0,2,23,0,25,"2015"
"31821","355470 TORRINHA",0,0,0,94,1,95,"2015"
"31822","355475 TRABIJU",0,0,0,14,0,14,"2015"
"31823","355480 TREMEMBE",1,6,9,585,7,608,"2015"
"31824","355490 TRES FRONTEIRAS",0,0,0,77,0,77,"2015"
"31825","355495 TUIUTI",0,0,0,68,0,68,"2015"
"31826","355500 TUPA",1,6,4,769,0,780,"2015"
"31827","355510 TUPI PAULISTA",0,1,4,186,2,193,"2015"
"31828","355520 TURIUBA",0,1,0,13,0,14,"2015"
"31829","355530 TURMALINA",0,0,0,11,0,11,"2015"
"31830","355535 UBARANA",0,0,1,55,0,56,"2015"
"31831","355540 UBATUBA",2,6,18,1295,2,1323,"2015"
"31832","355550 UBIRAJARA",0,0,3,68,1,72,"2015"
"31833","355560 UCHOA",0,0,1,98,0,99,"2015"
"31834","355570 UNIAO PAULISTA",0,1,2,19,0,22,"2015"
"31835","355580 URANIA",0,0,0,95,0,95,"2015"
"31836","355590 URU",0,0,0,18,0,18,"2015"
"31837","355600 URUPES",0,0,0,137,1,138,"2015"
"31838","355610 VALENTIM GENTIL",0,1,0,203,0,204,"2015"
"31839","355620 VALINHOS",4,5,11,1511,8,1539,"2015"
"31840","355630 VALPARAISO",1,1,7,328,3,340,"2015"
"31841","355635 VARGEM",0,1,0,109,2,112,"2015"
"31842","355640 VARGEM GRANDE DO SUL",1,2,4,534,1,542,"2015"
"31843","355645 VARGEM GRANDE PAULISTA",2,2,8,751,1,764,"2015"
"31844","355650 VARZEA PAULISTA",3,4,26,1817,4,1854,"2015"
"31845","355660 VERA CRUZ",0,0,2,116,0,118,"2015"
"31846","355670 VINHEDO",1,6,5,933,2,947,"2015"
"31847","355680 VIRADOURO",1,2,0,196,2,201,"2015"
"31848","355690 VISTA ALEGRE DO ALTO",0,0,2,99,0,101,"2015"
"31849","355695 VITORIA BRASIL",0,0,0,15,1,16,"2015"
"31850","355700 VOTORANTIM",1,9,33,1702,0,1745,"2015"
"31851","355710 VOTUPORANGA",0,2,6,1131,0,1139,"2015"
"31852","355715 ZACARIAS",0,0,0,33,0,33,"2015"
"31853","355720 CHAVANTES",0,1,0,215,0,216,"2015"
"31854","355730 ESTIVA GERBI",0,3,5,137,2,147,"2015"
"31855","MUNICIPIO IGNORADO - PR",0,0,0,0,1,1,"2015"
"31856","410010 ABATIA",0,2,1,98,0,101,"2015"
"31857","410020 ADRIANOPOLIS",0,0,1,75,4,80,"2015"
"31858","410030 AGUDOS DO SUL",1,1,3,103,1,109,"2015"
"31859","410040 ALMIRANTE TAMANDARE",2,6,26,1978,15,2027,"2015"
"31860","410045 ALTAMIRA DO PARANA",0,0,0,60,0,60,"2015"
"31861","410050 ALTONIA",1,0,3,264,0,268,"2015"
"31862","410060 ALTO PARANA",1,0,1,200,0,202,"2015"
"31863","410070 ALTO PIQUIRI",0,0,6,119,1,126,"2015"
"31864","410080 ALVORADA DO SUL",0,0,2,100,1,103,"2015"
"31865","410090 AMAPORA",0,0,0,79,0,79,"2015"
"31866","410100 AMPERE",0,2,2,237,1,242,"2015"
"31867","410105 ANAHY",0,1,1,29,0,31,"2015"
"31868","410110 ANDIRA",0,1,4,243,0,248,"2015"
"31869","410115 ANGULO",0,0,0,52,0,52,"2015"
"31870","410120 ANTONINA",0,4,4,251,0,259,"2015"
"31871","410130 ANTONIO OLINTO",0,0,1,71,0,72,"2015"
"31872","410140 APUCARANA",5,7,21,1760,3,1796,"2015"
"31873","410150 ARAPONGAS",6,8,12,1601,1,1628,"2015"
"31874","410160 ARAPOTI",1,2,11,339,2,355,"2015"
"31875","410165 ARAPUA",0,0,1,39,0,40,"2015"
"31876","410170 ARARUNA",0,2,0,196,0,198,"2015"
"31877","410180 ARAUCARIA",3,14,36,2397,10,2460,"2015"
"31878","410185 ARIRANHA DO IVAI",0,0,0,40,0,40,"2015"
"31879","410190 ASSAI",0,6,4,221,0,231,"2015"
"31880","410200 ASSIS CHATEAUBRIAND",0,1,3,417,1,422,"2015"
"31881","410210 ASTORGA",0,1,4,349,0,354,"2015"
"31882","410220 ATALAIA",0,1,2,40,0,43,"2015"
"31883","410230 BALSA NOVA",0,3,1,212,0,216,"2015"
"31884","410240 BANDEIRANTES",2,4,9,444,0,459,"2015"
"31885","410250 BARBOSA FERRAZ",1,3,6,127,0,137,"2015"
"31886","410260 BARRACAO",0,0,3,150,0,153,"2015"
"31887","410270 BARRA DO JACARE",0,0,0,22,0,22,"2015"
"31888","410275 BELA VISTA DA CAROBA",0,0,0,49,0,49,"2015"
"31889","410280 BELA VISTA DO PARAISO",0,1,2,209,0,212,"2015"
"31890","410290 BITURUNA",0,0,2,247,0,249,"2015"
"31891","410300 BOA ESPERANCA",1,0,0,47,0,48,"2015"
"31892","410302 BOA ESPERANCA DO IGUACU",0,0,0,42,0,42,"2015"
"31893","410304 BOA VENTURA DE SAO ROQUE",0,0,1,74,0,75,"2015"
"31894","410305 BOA VISTA DA APARECIDA",0,1,1,113,0,115,"2015"
"31895","410310 BOCAIUVA DO SUL",2,1,2,173,2,180,"2015"
"31896","410315 BOM JESUS DO SUL",0,0,0,50,1,51,"2015"
"31897","410320 BOM SUCESSO",1,1,1,122,0,125,"2015"
"31898","410322 BOM SUCESSO DO SUL",0,0,0,41,0,41,"2015"
"31899","410330 BORRAZOPOLIS",1,2,4,76,0,83,"2015"
"31900","410335 BRAGANEY",1,0,5,70,0,76,"2015"
"31901","410337 BRASILANDIA DO SUL",1,0,0,38,0,39,"2015"
"31902","410340 CAFEARA",0,0,0,41,0,41,"2015"
"31903","410345 CAFELANDIA",0,0,3,321,0,324,"2015"
"31904","410347 CAFEZAL DO SUL",0,0,0,45,1,46,"2015"
"31905","410350 CALIFORNIA",0,0,1,121,0,122,"2015"
"31906","410360 CAMBARA",0,0,2,309,1,312,"2015"
"31907","410370 CAMBE",2,5,22,1379,2,1410,"2015"
"31908","410380 CAMBIRA",1,0,3,115,0,119,"2015"
"31909","410390 CAMPINA DA LAGOA",1,0,1,205,1,208,"2015"
"31910","410395 CAMPINA DO SIMAO",0,0,0,58,0,58,"2015"
"31911","410400 CAMPINA GRANDE DO SUL",5,2,13,797,0,817,"2015"
"31912","410405 CAMPO BONITO",0,0,0,48,0,48,"2015"
"31913","410410 CAMPO DO TENENTE",0,1,4,116,0,121,"2015"
"31914","410420 CAMPO LARGO",6,4,19,1805,9,1843,"2015"
"31915","410425 CAMPO MAGRO",1,1,9,419,1,431,"2015"
"31916","410430 CAMPO MOURAO",2,5,21,1261,3,1292,"2015"
"31917","410440 CANDIDO DE ABREU",0,0,4,194,0,198,"2015"
"31918","410442 CANDOI",2,4,2,243,0,251,"2015"
"31919","410445 CANTAGALO",0,1,5,197,0,203,"2015"
"31920","410450 CAPANEMA",0,0,2,236,0,238,"2015"
"31921","410460 CAPITAO LEONIDAS MARQUES",0,0,2,214,0,216,"2015"
"31922","410465 CARAMBEI",0,1,6,359,0,366,"2015"
"31923","410470 CARLOPOLIS",0,1,4,173,0,178,"2015"
"31924","410480 CASCAVEL",8,15,93,4641,11,4768,"2015"
"31925","410490 CASTRO",5,8,42,1151,4,1210,"2015"
"31926","410500 CATANDUVAS",0,1,0,125,0,126,"2015"
"31927","410510 CENTENARIO DO SUL",0,2,1,120,0,123,"2015"
"31928","410520 CERRO AZUL",1,1,4,209,0,215,"2015"
"31929","410530 CEU AZUL",0,0,6,124,0,130,"2015"
"31930","410540 CHOPINZINHO",0,2,12,260,1,275,"2015"
"31931","410550 CIANORTE",0,2,8,1128,0,1138,"2015"
"31932","410560 CIDADE GAUCHA",0,1,2,176,0,179,"2015"
"31933","410570 CLEVELANDIA",0,4,2,266,0,272,"2015"
"31934","410580 COLOMBO",6,10,41,3784,13,3854,"2015"
"31935","410590 COLORADO",2,0,6,317,0,325,"2015"
"31936","410600 CONGONHINHAS",0,0,1,116,1,118,"2015"
"31937","410610 CONSELHEIRO MAIRINCK",0,0,3,45,0,48,"2015"
"31938","410620 CONTENDA",0,3,4,262,1,270,"2015"
"31939","410630 CORBELIA",1,0,4,241,1,247,"2015"
"31940","410640 CORNELIO PROCOPIO",1,2,5,564,0,572,"2015"
"31941","410645 CORONEL DOMINGOS SOARES",0,1,0,110,1,112,"2015"
"31942","410650 CORONEL VIVIDA",0,3,1,318,0,322,"2015"
"31943","410655 CORUMBATAI DO SUL",0,0,1,39,0,40,"2015"
"31944","410657 CRUZEIRO DO IGUACU",1,0,1,45,0,47,"2015"
"31945","410660 CRUZEIRO DO OESTE",1,1,12,300,0,314,"2015"
"31946","410670 CRUZEIRO DO SUL",0,0,3,58,0,61,"2015"
"31947","410680 CRUZ MACHADO",1,1,3,239,1,245,"2015"
"31948","410685 CRUZMALTINA",0,0,1,48,0,49,"2015"
"31949","410690 CURITIBA",47,98,333,23982,46,24506,"2015"
"31950","410700 CURIUVA",0,2,3,188,0,193,"2015"
"31951","410710 DIAMANTE DO NORTE",0,0,0,65,0,65,"2015"
"31952","410712 DIAMANTE DO SUL",0,0,3,40,0,43,"2015"
"31953","410715 DIAMANTE D'OESTE",1,0,0,70,0,71,"2015"
"31954","410720 DOIS VIZINHOS",1,1,5,596,0,603,"2015"
"31955","410725 DOURADINA",0,1,1,138,0,140,"2015"
"31956","410730 DOUTOR CAMARGO",0,0,3,59,0,62,"2015"
"31957","410740 ENEAS MARQUES",0,0,0,75,0,75,"2015"
"31958","410750 ENGENHEIRO BELTRAO",0,3,5,170,0,178,"2015"
"31959","410752 ESPERANCA NOVA",0,0,0,23,0,23,"2015"
"31960","410753 ENTRE RIOS DO OESTE",0,1,1,58,0,60,"2015"
"31961","410754 ESPIGAO ALTO DO IGUACU",0,2,1,73,0,76,"2015"
"31962","410755 FAROL",1,0,0,51,0,52,"2015"
"31963","410760 FAXINAL",0,0,3,243,3,249,"2015"
"31964","410765 FAZENDA RIO GRANDE",16,12,35,2029,7,2099,"2015"
"31965","410770 FENIX",0,0,0,43,0,43,"2015"
"31966","410773 FERNANDES PINHEIRO",0,1,0,95,0,96,"2015"
"31967","410775 FIGUEIRA",0,0,2,96,0,98,"2015"
"31968","410780 FLORAI",0,0,0,53,0,53,"2015"
"31969","410785 FLOR DA SERRA DO SUL",0,0,1,89,0,90,"2015"
"31970","410790 FLORESTA",0,0,0,90,0,90,"2015"
"31971","410800 FLORESTOPOLIS",0,1,2,188,0,191,"2015"
"31972","410810 FLORIDA",0,0,0,33,0,33,"2015"
"31973","410820 FORMOSA DO OESTE",0,0,3,90,0,93,"2015"
"31974","410830 FOZ DO IGUACU",7,11,57,4244,8,4327,"2015"
"31975","410832 FRANCISCO ALVES",1,1,0,80,0,82,"2015"
"31976","410840 FRANCISCO BELTRAO",5,2,15,1230,0,1252,"2015"
"31977","410845 FOZ DO JORDAO",1,0,1,90,0,92,"2015"
"31978","410850 GENERAL CARNEIRO",1,1,4,232,0,238,"2015"
"31979","410855 GODOY MOREIRA",0,1,1,31,0,33,"2015"
"31980","410860 GOIOERE",0,1,3,360,0,364,"2015"
"31981","410865 GOIOXIM",0,2,1,122,1,126,"2015"
"31982","410870 GRANDES RIOS",0,2,0,82,0,84,"2015"
"31983","410880 GUAIRA",0,3,5,538,1,547,"2015"
"31984","410890 GUAIRACA",0,0,1,72,0,73,"2015"
"31985","410895 GUAMIRANGA",1,0,1,87,0,89,"2015"
"31986","410900 GUAPIRAMA",0,0,0,65,0,65,"2015"
"31987","410910 GUAPOREMA",0,0,0,30,0,30,"2015"
"31988","410920 GUARACI",0,0,0,59,0,59,"2015"
"31989","410930 GUARANIACU",0,3,1,209,1,214,"2015"
"31990","410940 GUARAPUAVA",16,12,36,2918,2,2984,"2015"
"31991","410950 GUARAQUECABA",0,1,1,86,1,89,"2015"
"31992","410960 GUARATUBA",0,1,7,563,2,573,"2015"
"31993","410965 HONORIO SERPA",0,0,1,74,0,75,"2015"
"31994","410970 IBAITI",0,5,11,317,0,333,"2015"
"31995","410975 IBEMA",0,3,4,103,0,110,"2015"
"31996","410980 IBIPORA",1,5,13,693,0,712,"2015"
"31997","410990 ICARAIMA",0,2,4,107,0,113,"2015"
"31998","411000 IGUARACU",0,0,1,70,0,71,"2015"
"31999","411005 IGUATU",0,0,0,27,0,27,"2015"
"32000","411007 IMBAU",0,3,1,196,0,200,"2015"
"32001","411010 IMBITUVA",0,2,4,442,1,449,"2015"
"32002","411020 INACIO MARTINS",0,2,4,156,1,163,"2015"
"32003","411030 INAJA",1,0,0,38,0,39,"2015"
"32004","411040 INDIANOPOLIS",0,0,0,53,0,53,"2015"
"32005","411050 IPIRANGA",0,0,4,191,0,195,"2015"
"32006","411060 IPORA",0,1,3,202,0,206,"2015"
"32007","411065 IRACEMA DO OESTE",0,0,1,23,0,24,"2015"
"32008","411070 IRATI",0,5,6,846,0,857,"2015"
"32009","411080 IRETAMA",0,0,1,143,0,144,"2015"
"32010","411090 ITAGUAJE",0,0,1,71,0,72,"2015"
"32011","411095 ITAIPULANDIA",0,1,2,150,0,153,"2015"
"32012","411100 ITAMBARACA",0,0,1,59,0,60,"2015"
"32013","411110 ITAMBE",0,1,0,54,0,55,"2015"
"32014","411120 ITAPEJARA D'OESTE",0,1,1,157,0,159,"2015"
"32015","411125 ITAPERUCU",0,4,6,490,0,500,"2015"
"32016","411130 ITAUNA DO SUL",0,0,2,39,1,42,"2015"
"32017","411140 IVAI",0,1,3,200,2,206,"2015"
"32018","411150 IVAIPORA",0,4,6,393,1,404,"2015"
"32019","411155 IVATE",0,1,2,113,0,116,"2015"
"32020","411160 IVATUBA",0,0,0,24,0,24,"2015"
"32021","411170 JABOTI",0,0,1,49,0,50,"2015"
"32022","411180 JACAREZINHO",1,2,7,567,0,577,"2015"
"32023","411190 JAGUAPITA",0,0,2,180,0,182,"2015"
"32024","411200 JAGUARIAIVA",3,1,7,611,0,622,"2015"
"32025","411210 JANDAIA DO SUL",0,0,4,274,0,278,"2015"
"32026","411220 JANIOPOLIS",0,1,1,69,0,71,"2015"
"32027","411230 JAPIRA",0,1,0,80,0,81,"2015"
"32028","411240 JAPURA",0,0,1,86,0,87,"2015"
"32029","411250 JARDIM ALEGRE",0,1,3,123,1,128,"2015"
"32030","411260 JARDIM OLINDA",0,0,0,13,0,13,"2015"
"32031","411270 JATAIZINHO",1,0,4,174,0,179,"2015"
"32032","411275 JESUITAS",1,0,2,98,0,101,"2015"
"32033","411280 JOAQUIM TAVORA",0,1,3,185,0,189,"2015"
"32034","411290 JUNDIAI DO SUL",0,0,0,41,0,41,"2015"
"32035","411295 JURANDA",0,0,2,72,0,74,"2015"
"32036","411300 JUSSARA",0,0,0,91,0,91,"2015"
"32037","411310 KALORE",0,0,2,55,0,57,"2015"
"32038","411320 LAPA",0,4,11,622,0,637,"2015"
"32039","411325 LARANJAL",0,1,2,89,0,92,"2015"
"32040","411330 LARANJEIRAS DO SUL",1,2,11,554,0,568,"2015"
"32041","411340 LEOPOLIS",0,1,0,50,0,51,"2015"
"32042","411342 LIDIANOPOLIS",0,1,1,40,1,43,"2015"
"32043","411345 LINDOESTE",0,0,5,62,0,67,"2015"
"32044","411350 LOANDA",2,0,0,330,3,335,"2015"
"32045","411360 LOBATO",1,0,2,62,0,65,"2015"
"32046","411370 LONDRINA",13,42,88,7207,15,7365,"2015"
"32047","411373 LUIZIANA",2,1,1,106,0,110,"2015"
"32048","411375 LUNARDELLI",0,0,3,58,0,61,"2015"
"32049","411380 LUPIONOPOLIS",0,0,1,55,0,56,"2015"
"32050","411390 MALLET",2,4,3,155,0,164,"2015"
"32051","411400 MAMBORE",0,4,2,175,0,181,"2015"
"32052","411410 MANDAGUACU",1,0,8,296,0,305,"2015"
"32053","411420 MANDAGUARI",1,2,7,493,1,504,"2015"
"32054","411430 MANDIRITUBA",0,0,7,351,1,359,"2015"
"32055","411435 MANFRINOPOLIS",0,0,0,37,1,38,"2015"
"32056","411440 MANGUEIRINHA",0,3,21,287,0,311,"2015"
"32057","411450 MANOEL RIBAS",0,1,6,222,1,230,"2015"
"32058","411460 MARECHAL CANDIDO RONDON",2,2,14,642,0,660,"2015"
"32059","411470 MARIA HELENA",0,0,1,73,0,74,"2015"
"32060","411480 MARIALVA",4,3,10,480,1,498,"2015"
"32061","411490 MARILANDIA DO SUL",0,0,0,137,0,137,"2015"
"32062","411500 MARILENA",0,0,0,99,0,99,"2015"
"32063","411510 MARILUZ",0,1,6,176,0,183,"2015"
"32064","411520 MARINGA",5,10,90,4981,1,5087,"2015"
"32065","411530 MARIOPOLIS",0,0,2,88,0,90,"2015"
"32066","411535 MARIPA",0,0,2,68,0,70,"2015"
"32067","411540 MARMELEIRO",0,0,1,211,0,212,"2015"
"32068","411545 MARQUINHO",0,0,2,55,0,57,"2015"
"32069","411550 MARUMBI",0,0,5,55,0,60,"2015"
"32070","411560 MATELANDIA",0,2,5,247,0,254,"2015"
"32071","411570 MATINHOS",1,1,6,494,5,507,"2015"
"32072","411573 MATO RICO",0,0,1,37,1,39,"2015"
"32073","411575 MAUA DA SERRA",1,0,4,151,0,156,"2015"
"32074","411580 MEDIANEIRA",0,5,22,699,0,726,"2015"
"32075","411585 MERCEDES",0,0,1,62,0,63,"2015"
"32076","411590 MIRADOR",0,0,0,28,0,28,"2015"
"32077","411600 MIRASELVA",0,0,0,31,0,31,"2015"
"32078","411605 MISSAL",0,0,0,137,0,137,"2015"
"32079","411610 MOREIRA SALES",0,1,3,173,0,177,"2015"
"32080","411620 MORRETES",2,1,1,222,0,226,"2015"
"32081","411630 MUNHOZ DE MELO",0,1,0,50,0,51,"2015"
"32082","411640 NOSSA SENHORA DAS GRACAS",0,0,0,59,0,59,"2015"
"32083","411650 NOVA ALIANCA DO IVAI",0,0,0,30,0,30,"2015"
"32084","411660 NOVA AMERICA DA COLINA",0,1,0,48,0,49,"2015"
"32085","411670 NOVA AURORA",0,1,2,134,0,137,"2015"
"32086","411680 NOVA CANTU",0,0,0,96,1,97,"2015"
"32087","411690 NOVA ESPERANCA",0,0,5,354,0,359,"2015"
"32088","411695 NOVA ESPERANCA DO SUDOESTE",0,0,0,59,0,59,"2015"
"32089","411700 NOVA FATIMA",0,0,2,96,1,99,"2015"
"32090","411705 NOVA LARANJEIRAS",0,0,2,158,0,160,"2015"
"32091","411710 NOVA LONDRINA",1,3,2,184,0,190,"2015"
"32092","411720 NOVA OLIMPIA",1,0,0,71,0,72,"2015"
"32093","411721 NOVA SANTA BARBARA",1,1,0,47,0,49,"2015"
"32094","411722 NOVA SANTA ROSA",0,0,1,105,0,106,"2015"
"32095","411725 NOVA PRATA DO IGUACU",0,0,1,128,0,129,"2015"
"32096","411727 NOVA TEBAS",0,1,1,71,0,73,"2015"
"32097","411729 NOVO ITACOLOMI",0,0,0,29,0,29,"2015"
"32098","411730 ORTIGUEIRA",0,2,6,293,0,301,"2015"
"32099","411740 OURIZONA",0,0,1,37,0,38,"2015"
"32100","411745 OURO VERDE DO OESTE",0,0,0,77,0,77,"2015"
"32101","411750 PAICANDU",1,2,7,590,0,600,"2015"
"32102","411760 PALMAS",2,5,7,803,4,821,"2015"
"32103","411770 PALMEIRA",1,1,6,473,4,485,"2015"
"32104","411780 PALMITAL",1,1,0,208,0,210,"2015"
"32105","411790 PALOTINA",0,1,3,515,1,520,"2015"
"32106","411800 PARAISO DO NORTE",0,1,1,196,0,198,"2015"
"32107","411810 PARANACITY",0,0,2,157,1,160,"2015"
"32108","411820 PARANAGUA",5,3,29,2418,14,2469,"2015"
"32109","411830 PARANAPOEMA",0,0,0,44,0,44,"2015"
"32110","411840 PARANAVAI",2,1,4,1227,0,1234,"2015"
"32111","411845 PATO BRAGADO",0,0,2,79,0,81,"2015"
"32112","411850 PATO BRANCO",2,6,30,1286,6,1330,"2015"
"32113","411860 PAULA FREITAS",0,0,0,73,0,73,"2015"
"32114","411870 PAULO FRONTIN",0,0,0,86,0,86,"2015"
"32115","411880 PEABIRU",0,0,4,163,0,167,"2015"
"32116","411885 PEROBAL",0,0,2,100,0,102,"2015"
"32117","411890 PEROLA",0,0,3,147,0,150,"2015"
"32118","411900 PEROLA D'OESTE",0,0,0,71,0,71,"2015"
"32119","411910 PIEN",0,1,4,171,1,177,"2015"
"32120","411915 PINHAIS",5,6,26,2152,6,2195,"2015"
"32121","411920 PINHALAO",0,2,0,80,0,82,"2015"
"32122","411925 PINHAL DE SAO BENTO",0,0,0,26,0,26,"2015"
"32123","411930 PINHAO",1,4,6,517,0,528,"2015"
"32124","411940 PIRAI DO SUL",0,2,9,388,0,399,"2015"
"32125","411950 PIRAQUARA",5,7,23,1569,4,1608,"2015"
"32126","411960 PITANGA",2,2,10,464,0,478,"2015"
"32127","411965 PITANGUEIRAS",0,0,1,35,0,36,"2015"
"32128","411970 PLANALTINA DO PARANA",0,0,0,74,0,74,"2015"
"32129","411980 PLANALTO",0,0,0,123,0,123,"2015"
"32130","411990 PONTA GROSSA",4,30,124,5215,2,5375,"2015"
"32131","411995 PONTAL DO PARANA",0,3,6,321,0,330,"2015"
"32132","412000 PORECATU",3,1,0,157,0,161,"2015"
"32133","412010 PORTO AMAZONAS",0,0,2,63,2,67,"2015"
"32134","412015 PORTO BARREIRO",0,0,1,45,0,46,"2015"
"32135","412020 PORTO RICO",0,0,0,35,0,35,"2015"
"32136","412030 PORTO VITORIA",0,0,1,50,0,51,"2015"
"32137","412033 PRADO FERREIRA",0,0,0,69,0,69,"2015"
"32138","412035 PRANCHITA",0,1,1,80,0,82,"2015"
"32139","412040 PRESIDENTE CASTELO BRANCO",0,0,0,61,0,61,"2015"
"32140","412050 PRIMEIRO DE MAIO",0,0,4,94,0,98,"2015"
"32141","412060 PRUDENTOPOLIS",2,4,7,678,5,696,"2015"
"32142","412065 QUARTO CENTENARIO",0,0,0,58,0,58,"2015"
"32143","412070 QUATIGUA",0,1,0,93,0,94,"2015"
"32144","412080 QUATRO BARRAS",1,2,6,346,2,357,"2015"
"32145","412085 QUATRO PONTES",0,0,0,46,0,46,"2015"
"32146","412090 QUEDAS DO IGUACU",0,3,16,473,1,493,"2015"
"32147","412100 QUERENCIA DO NORTE",1,1,1,177,0,180,"2015"
"32148","412110 QUINTA DO SOL",1,1,1,76,0,79,"2015"
"32149","412120 QUITANDINHA",0,0,3,219,0,222,"2015"
"32150","412125 RAMILANDIA",0,0,0,55,0,55,"2015"
"32151","412130 RANCHO ALEGRE",0,0,0,51,1,52,"2015"
"32152","412135 RANCHO ALEGRE D'OESTE",0,0,0,32,0,32,"2015"
"32153","412140 REALEZA",1,0,3,232,2,238,"2015"
"32154","412150 REBOUCAS",0,0,3,227,0,230,"2015"
"32155","412160 RENASCENCA",0,0,3,87,0,90,"2015"
"32156","412170 RESERVA",3,1,4,398,1,407,"2015"
"32157","412175 RESERVA DO IGUACU",0,0,0,120,0,120,"2015"
"32158","412180 RIBEIRAO CLARO",0,0,2,144,0,146,"2015"
"32159","412190 RIBEIRAO DO PINHAL",1,1,4,172,0,178,"2015"
"32160","412200 RIO AZUL",0,2,2,196,0,200,"2015"
"32161","412210 RIO BOM",0,0,1,32,0,33,"2015"
"32162","412215 RIO BONITO DO IGUACU",4,2,1,220,0,227,"2015"
"32163","412217 RIO BRANCO DO IVAI",0,0,2,61,0,63,"2015"
"32164","412220 RIO BRANCO DO SUL",1,2,8,626,4,641,"2015"
"32165","412230 RIO NEGRO",2,0,4,398,0,404,"2015"
"32166","412240 ROLANDIA",3,6,8,894,0,911,"2015"
"32167","412250 RONCADOR",1,0,1,140,0,142,"2015"
"32168","412260 RONDON",0,1,0,123,0,124,"2015"
"32169","412265 ROSARIO DO IVAI",0,0,1,69,0,70,"2015"
"32170","412270 SABAUDIA",0,0,0,101,0,101,"2015"
"32171","412280 SALGADO FILHO",0,1,0,47,0,48,"2015"
"32172","412290 SALTO DO ITARARE",0,0,2,57,0,59,"2015"
"32173","412300 SALTO DO LONTRA",2,1,0,171,0,174,"2015"
"32174","412310 SANTA AMELIA",0,0,0,46,0,46,"2015"
"32175","412320 SANTA CECILIA DO PAVAO",0,1,0,49,0,50,"2015"
"32176","412330 SANTA CRUZ DE MONTE CASTELO",0,0,0,123,0,123,"2015"
"32177","412340 SANTA FE",0,0,5,133,0,138,"2015"
"32178","412350 SANTA HELENA",0,1,1,301,0,303,"2015"
"32179","412360 SANTA INES",1,0,0,21,0,22,"2015"
"32180","412370 SANTA ISABEL DO IVAI",0,2,2,102,0,106,"2015"
"32181","412380 SANTA IZABEL DO OESTE",0,1,1,170,0,172,"2015"
"32182","412382 SANTA LUCIA",0,0,0,45,1,46,"2015"
"32183","412385 SANTA MARIA DO OESTE",1,1,1,147,0,150,"2015"
"32184","412390 SANTA MARIANA",1,0,2,155,0,158,"2015"
"32185","412395 SANTA MONICA",0,0,3,39,0,42,"2015"
"32186","412400 SANTANA DO ITARARE",1,0,0,45,0,46,"2015"
"32187","412402 SANTA TEREZA DO OESTE",0,1,6,192,0,199,"2015"
"32188","412405 SANTA TEREZINHA DE ITAIPU",2,1,5,303,4,315,"2015"
"32189","412410 SANTO ANTONIO DA PLATINA",0,0,4,604,2,610,"2015"
"32190","412420 SANTO ANTONIO DO CAIUA",0,0,0,23,0,23,"2015"
"32191","412430 SANTO ANTONIO DO PARAISO",0,0,0,17,0,17,"2015"
"32192","412440 SANTO ANTONIO DO SUDOESTE",0,1,2,290,0,293,"2015"
"32193","412450 SANTO INACIO",0,0,0,72,0,72,"2015"
"32194","412460 SAO CARLOS DO IVAI",0,0,1,97,0,98,"2015"
"32195","412470 SAO JERONIMO DA SERRA",0,1,4,148,0,153,"2015"
"32196","412480 SAO JOAO",0,0,10,125,0,135,"2015"
"32197","412490 SAO JOAO DO CAIUA",0,1,0,75,0,76,"2015"
"32198","412500 SAO JOAO DO IVAI",2,0,5,140,0,147,"2015"
"32199","412510 SAO JOAO DO TRIUNFO",0,0,2,167,0,169,"2015"
"32200","412520 SAO JORGE D'OESTE",0,1,1,122,0,124,"2015"
"32201","412530 SAO JORGE DO IVAI",0,0,0,52,0,52,"2015"
"32202","412535 SAO JORGE DO PATROCINIO",0,0,2,77,0,79,"2015"
"32203","412540 SAO JOSE DA BOA VISTA",0,0,0,60,0,60,"2015"
"32204","412545 SAO JOSE DAS PALMEIRAS",0,0,2,57,0,59,"2015"
"32205","412550 SAO JOSE DOS PINHAIS",22,29,76,4939,12,5078,"2015"
"32206","412555 SAO MANOEL DO PARANA",0,0,0,20,0,20,"2015"
"32207","412560 SAO MATEUS DO SUL",2,1,10,603,2,618,"2015"
"32208","412570 SAO MIGUEL DO IGUACU",0,1,6,422,4,433,"2015"
"32209","412575 SAO PEDRO DO IGUACU",0,0,0,58,2,60,"2015"
"32210","412580 SAO PEDRO DO IVAI",0,1,1,100,0,102,"2015"
"32211","412590 SAO PEDRO DO PARANA",0,0,0,56,0,56,"2015"
"32212","412600 SAO SEBASTIAO DA AMOREIRA",0,0,3,111,1,115,"2015"
"32213","412610 SAO TOME",0,0,0,70,0,70,"2015"
"32214","412620 SAPOPEMA",1,1,1,86,1,90,"2015"
"32215","412625 SARANDI",3,5,25,1517,1,1551,"2015"
"32216","412627 SAUDADE DO IGUACU",0,0,3,71,0,74,"2015"
"32217","412630 SENGES",0,2,3,247,0,252,"2015"
"32218","412635 SERRANOPOLIS DO IGUACU",0,0,1,52,0,53,"2015"
"32219","412640 SERTANEJA",0,0,0,46,0,46,"2015"
"32220","412650 SERTANOPOLIS",0,0,2,176,0,178,"2015"
"32221","412660 SIQUEIRA CAMPOS",0,1,1,264,0,266,"2015"
"32222","412665 SULINA",0,0,1,32,0,33,"2015"
"32223","412667 TAMARANA",0,0,3,166,0,169,"2015"
"32224","412670 TAMBOARA",0,0,1,68,0,69,"2015"
"32225","412680 TAPEJARA",1,0,2,232,0,235,"2015"
"32226","412690 TAPIRA",0,0,1,73,0,74,"2015"
"32227","412700 TEIXEIRA SOARES",0,0,1,121,0,122,"2015"
"32228","412710 TELEMACO BORBA",4,6,10,1147,3,1170,"2015"
"32229","412720 TERRA BOA",0,0,3,208,0,211,"2015"
"32230","412730 TERRA RICA",1,0,1,236,0,238,"2015"
"32231","412740 TERRA ROXA",0,2,4,237,1,244,"2015"
"32232","412750 TIBAGI",0,1,8,327,0,336,"2015"
"32233","412760 TIJUCAS DO SUL",1,1,4,221,0,227,"2015"
"32234","412770 TOLEDO",0,4,41,1999,1,2045,"2015"
"32235","412780 TOMAZINA",1,0,1,81,0,83,"2015"
"32236","412785 TRES BARRAS DO PARANA",0,0,4,181,0,185,"2015"
"32237","412788 TUNAS DO PARANA",2,2,2,116,3,125,"2015"
"32238","412790 TUNEIRAS DO OESTE",0,0,1,103,0,104,"2015"
"32239","412795 TUPASSI",0,1,0,87,0,88,"2015"
"32240","412796 TURVO",0,2,5,228,0,235,"2015"
"32241","412800 UBIRATA",2,0,3,286,0,291,"2015"
"32242","412810 UMUARAMA",7,4,24,1458,0,1493,"2015"
"32243","412820 UNIAO DA VITORIA",0,1,10,878,0,889,"2015"
"32244","412830 UNIFLOR",0,0,0,39,0,39,"2015"
"32245","412840 URAI",1,2,1,128,0,132,"2015"
"32246","412850 WENCESLAU BRAZ",1,1,2,248,0,252,"2015"
"32247","412853 VENTANIA",1,1,1,127,1,131,"2015"
"32248","412855 VERA CRUZ DO OESTE",0,1,1,106,0,108,"2015"
"32249","412860 VERE",0,2,0,75,0,77,"2015"
"32250","412862 ALTO PARAISO",0,0,0,29,0,29,"2015"
"32251","412863 DOUTOR ULYSSES",0,0,0,74,1,75,"2015"
"32252","412865 VIRMOND",0,1,1,59,0,61,"2015"
"32253","412870 VITORINO",0,0,3,109,1,113,"2015"
"32254","412880 XAMBRE",0,0,2,81,0,83,"2015"
"32255","MUNICIPIO IGNORADO - SC",0,0,0,1,1,2,"2015"
"32256","420005 ABDON BATISTA",0,0,1,26,0,27,"2015"
"32257","420010 ABELARDO LUZ",1,3,9,277,0,290,"2015"
"32258","420020 AGROLANDIA",1,1,3,160,1,166,"2015"
"32259","420030 AGRONOMICA",0,0,0,53,0,53,"2015"
"32260","420040 AGUA DOCE",0,0,2,101,0,103,"2015"
"32261","420050 AGUAS DE CHAPECO",0,0,0,77,0,77,"2015"
"32262","420055 AGUAS FRIAS",1,0,0,37,0,38,"2015"
"32263","420060 AGUAS MORNAS",0,0,0,64,1,65,"2015"
"32264","420070 ALFREDO WAGNER",0,0,2,119,1,122,"2015"
"32265","420075 ALTO BELA VISTA",0,0,0,13,0,13,"2015"
"32266","420080 ANCHIETA",0,0,0,63,0,63,"2015"
"32267","420090 ANGELINA",0,0,1,46,0,47,"2015"
"32268","420100 ANITA GARIBALDI",0,1,1,94,1,97,"2015"
"32269","420110 ANITAPOLIS",0,0,0,30,0,30,"2015"
"32270","420120 ANTONIO CARLOS",0,0,0,123,0,123,"2015"
"32271","420125 APIUNA",0,2,3,120,2,127,"2015"
"32272","420127 ARABUTA",0,0,1,43,0,44,"2015"
"32273","420130 ARAQUARI",1,3,14,530,1,549,"2015"
"32274","420140 ARARANGUA",1,2,6,933,0,942,"2015"
"32275","420150 ARMAZEM",0,0,2,122,0,124,"2015"
"32276","420160 ARROIO TRINTA",0,0,0,26,0,26,"2015"
"32277","420165 ARVOREDO",0,0,0,24,1,25,"2015"
"32278","420170 ASCURRA",0,0,0,99,0,99,"2015"
"32279","420180 ATALANTA",0,0,1,47,0,48,"2015"
"32280","420190 AURORA",0,0,0,72,0,72,"2015"
"32281","420195 BALNEARIO ARROIO DO SILVA",1,0,6,159,0,166,"2015"
"32282","420200 BALNEARIO CAMBORIU",3,7,30,1567,0,1607,"2015"
"32283","420205 BALNEARIO BARRA DO SUL",1,0,0,132,1,134,"2015"
"32284","420207 BALNEARIO GAIVOTA",1,1,4,124,0,130,"2015"
"32285","420208 BANDEIRANTE",0,1,0,39,0,40,"2015"
"32286","420209 BARRA BONITA",0,0,0,14,0,14,"2015"
"32287","420210 BARRA VELHA",1,3,13,453,5,475,"2015"
"32288","420213 BELA VISTA DO TOLDO",0,0,1,52,0,53,"2015"
"32289","420215 BELMONTE",0,1,0,25,0,26,"2015"
"32290","420220 BENEDITO NOVO",0,0,4,115,0,119,"2015"
"32291","420230 BIGUACU",3,6,16,965,2,992,"2015"
"32292","420240 BLUMENAU",8,10,51,4441,1,4511,"2015"
"32293","420243 BOCAINA DO SUL",0,0,4,55,0,59,"2015"
"32294","420245 BOMBINHAS",0,2,1,274,0,277,"2015"
"32295","420250 BOM JARDIM DA SERRA",0,0,1,44,0,45,"2015"
"32296","420253 BOM JESUS",0,0,0,36,0,36,"2015"
"32297","420257 BOM JESUS DO OESTE",0,1,2,20,0,23,"2015"
"32298","420260 BOM RETIRO",0,1,9,140,1,151,"2015"
"32299","420270 BOTUVERA",0,0,0,65,0,65,"2015"
"32300","420280 BRACO DO NORTE",1,0,4,489,1,495,"2015"
"32301","420285 BRACO DO TROMBUDO",0,0,1,46,0,47,"2015"
"32302","420287 BRUNOPOLIS",0,0,1,22,0,23,"2015"
"32303","420290 BRUSQUE",4,4,19,1703,0,1730,"2015"
"32304","420300 CACADOR",3,4,27,1166,2,1202,"2015"
"32305","420310 CAIBI",0,3,2,66,0,71,"2015"
"32306","420315 CALMON",1,0,2,66,0,69,"2015"
"32307","420320 CAMBORIU",5,5,34,1274,4,1322,"2015"
"32308","420325 CAPAO ALTO",1,0,0,21,0,22,"2015"
"32309","420330 CAMPO ALEGRE",0,0,2,138,1,141,"2015"
"32310","420340 CAMPO BELO DO SUL",0,1,2,67,0,70,"2015"
"32311","420350 CAMPO ERE",0,1,3,159,0,163,"2015"
"32312","420360 CAMPOS NOVOS",0,0,0,502,0,502,"2015"
"32313","420370 CANELINHA",0,0,2,114,1,117,"2015"
"32314","420380 CANOINHAS",0,3,11,868,0,882,"2015"
"32315","420390 CAPINZAL",2,1,1,302,0,306,"2015"
"32316","420395 CAPIVARI DE BAIXO",3,0,1,350,0,354,"2015"
"32317","420400 CATANDUVAS",0,1,3,130,0,134,"2015"
"32318","420410 CAXAMBU DO SUL",0,2,3,65,0,70,"2015"
"32319","420415 CELSO RAMOS",0,0,0,34,1,35,"2015"
"32320","420417 CERRO NEGRO",0,1,3,45,0,49,"2015"
"32321","420419 CHAPADAO DO LAGEADO",0,0,0,41,0,41,"2015"
"32322","420420 CHAPECO",9,12,45,3373,10,3449,"2015"
"32323","420425 COCAL DO SUL",3,0,4,205,0,212,"2015"
"32324","420430 CONCORDIA",0,1,19,1035,0,1055,"2015"
"32325","420435 CORDILHEIRA ALTA",0,0,3,38,0,41,"2015"
"32326","420440 CORONEL FREITAS",0,0,2,95,0,97,"2015"
"32327","420445 CORONEL MARTINS",0,0,0,15,0,15,"2015"
"32328","420450 CORUPA",0,2,5,208,0,215,"2015"
"32329","420455 CORREIA PINTO",2,4,7,183,0,196,"2015"
"32330","420460 CRICIUMA",20,11,31,2861,2,2925,"2015"
"32331","420470 CUNHA PORA",0,0,0,138,0,138,"2015"
"32332","420475 CUNHATAI",0,1,0,23,0,24,"2015"
"32333","420480 CURITIBANOS",0,2,7,623,0,632,"2015"
"32334","420490 DESCANSO",0,1,1,92,0,94,"2015"
"32335","420500 DIONISIO CERQUEIRA",1,0,4,246,0,251,"2015"
"32336","420510 DONA EMMA",0,0,1,57,0,58,"2015"
"32337","420515 DOUTOR PEDRINHO",0,0,0,28,0,28,"2015"
"32338","420517 ENTRE RIOS",0,0,0,54,1,55,"2015"
"32339","420519 ERMO",0,0,0,27,0,27,"2015"
"32340","420520 ERVAL VELHO",0,0,1,56,0,57,"2015"
"32341","420530 FAXINAL DOS GUEDES",1,1,1,127,0,130,"2015"
"32342","420535 FLOR DO SERTAO",0,0,0,16,0,16,"2015"
"32343","420540 FLORIANOPOLIS",13,13,102,5984,23,6135,"2015"
"32344","420543 FORMOSA DO SUL",0,0,0,19,0,19,"2015"
"32345","420545 FORQUILHINHA",1,1,1,383,0,386,"2015"
"32346","420550 FRAIBURGO",0,2,3,582,0,587,"2015"
"32347","420555 FREI ROGERIO",0,0,1,31,0,32,"2015"
"32348","420560 GALVAO",0,0,0,36,0,36,"2015"
"32349","420570 GAROPABA",0,0,2,248,8,258,"2015"
"32350","420580 GARUVA",0,0,2,263,2,267,"2015"
"32351","420590 GASPAR",2,11,25,863,0,901,"2015"
"32352","420600 GOVERNADOR CELSO RAMOS",0,0,0,159,0,159,"2015"
"32353","420610 GRAO PARA",0,0,0,80,0,80,"2015"
"32354","420620 GRAVATAL",0,0,0,125,0,125,"2015"
"32355","420630 GUABIRUBA",0,1,3,246,0,250,"2015"
"32356","420640 GUARACIABA",1,0,2,109,0,112,"2015"
"32357","420650 GUARAMIRIM",0,1,9,620,0,630,"2015"
"32358","420660 GUARUJA DO SUL",0,1,0,57,0,58,"2015"
"32359","420665 GUATAMBU",0,1,1,87,0,89,"2015"
"32360","420670 HERVAL D'OESTE",1,3,1,293,0,298,"2015"
"32361","420675 IBIAM",0,0,0,20,0,20,"2015"
"32362","420680 IBICARE",1,0,0,38,0,39,"2015"
"32363","420690 IBIRAMA",1,1,1,237,0,240,"2015"
"32364","420700 ICARA",1,2,6,786,0,795,"2015"
"32365","420710 ILHOTA",2,1,5,189,0,197,"2015"
"32366","420720 IMARUI",1,0,2,106,0,109,"2015"
"32367","420730 IMBITUBA",3,1,6,510,3,523,"2015"
"32368","420740 IMBUIA",0,0,2,98,0,100,"2015"
"32369","420750 INDAIAL",0,0,4,818,0,822,"2015"
"32370","420757 IOMERE",0,0,0,26,0,26,"2015"
"32371","420760 IPIRA",0,0,1,39,0,40,"2015"
"32372","420765 IPORA DO OESTE",0,0,1,87,1,89,"2015"
"32373","420768 IPUACU",0,3,6,173,6,188,"2015"
"32374","420770 IPUMIRIM",0,1,0,113,0,114,"2015"
"32375","420775 IRACEMINHA",0,0,1,40,0,41,"2015"
"32376","420780 IRANI",1,0,2,144,1,148,"2015"
"32377","420785 IRATI",0,0,0,22,0,22,"2015"
"32378","420790 IRINEOPOLIS",0,0,2,133,0,135,"2015"
"32379","420800 ITA",0,0,4,66,0,70,"2015"
"32380","420810 ITAIOPOLIS",0,2,3,308,2,315,"2015"
"32381","420820 ITAJAI",16,22,99,3431,3,3571,"2015"
"32382","420830 ITAPEMA",3,3,14,814,0,834,"2015"
"32383","420840 ITAPIRANGA",1,0,1,216,1,219,"2015"
"32384","420845 ITAPOA",0,1,7,278,4,290,"2015"
"32385","420850 ITUPORANGA",0,1,6,393,0,400,"2015"
"32386","420860 JABORA",0,0,0,57,0,57,"2015"
"32387","420870 JACINTO MACHADO",0,0,2,92,0,94,"2015"
"32388","420880 JAGUARUNA",0,0,2,232,0,234,"2015"
"32389","420890 JARAGUA DO SUL",4,8,34,2473,0,2519,"2015"
"32390","420895 JARDINOPOLIS",0,0,0,15,0,15,"2015"
"32391","420900 JOACABA",0,0,4,402,0,406,"2015"
"32392","420910 JOINVILLE",14,24,204,8149,11,8402,"2015"
"32393","420915 JOSE BOITEUX",0,0,1,106,1,108,"2015"
"32394","420917 JUPIA",0,0,0,20,0,20,"2015"
"32395","420920 LACERDOPOLIS",0,1,1,31,0,33,"2015"
"32396","420930 LAGES",6,23,134,2263,2,2428,"2015"
"32397","420940 LAGUNA",0,4,5,492,1,502,"2015"
"32398","420945 LAJEADO GRANDE",0,0,0,21,0,21,"2015"
"32399","420950 LAURENTINO",0,1,1,104,0,106,"2015"
"32400","420960 LAURO MULLER",0,0,2,199,0,201,"2015"
"32401","420970 LEBON REGIS",0,1,10,174,0,185,"2015"
"32402","420980 LEOBERTO LEAL",0,0,1,42,0,43,"2015"
"32403","420985 LINDOIA DO SUL",0,0,0,60,0,60,"2015"
"32404","420990 LONTRAS",2,0,0,143,2,147,"2015"
"32405","421000 LUIZ ALVES",2,0,6,150,0,158,"2015"
"32406","421003 LUZERNA",0,0,0,72,2,74,"2015"
"32407","421005 MACIEIRA",0,0,0,18,0,18,"2015"
"32408","421010 MAFRA",2,1,12,761,1,777,"2015"
"32409","421020 MAJOR GERCINO",0,0,2,38,0,40,"2015"
"32410","421030 MAJOR VIEIRA",0,0,1,96,0,97,"2015"
"32411","421040 MARACAJA",1,0,0,106,0,107,"2015"
"32412","421050 MARAVILHA",0,2,6,365,0,373,"2015"
"32413","421055 MAREMA",0,0,0,26,0,26,"2015"
"32414","421060 MASSARANDUBA",0,0,2,201,0,203,"2015"
"32415","421070 MATOS COSTA",0,0,0,29,0,29,"2015"
"32416","421080 MELEIRO",1,0,3,68,0,72,"2015"
"32417","421085 MIRIM DOCE",0,0,0,28,0,28,"2015"
"32418","421090 MODELO",0,0,0,40,1,41,"2015"
"32419","421100 MONDAI",1,0,4,118,0,123,"2015"
"32420","421105 MONTE CARLO",0,0,2,159,1,162,"2015"
"32421","421110 MONTE CASTELO",0,0,0,131,0,131,"2015"
"32422","421120 MORRO DA FUMACA",1,0,1,247,0,249,"2015"
"32423","421125 MORRO GRANDE",0,0,0,34,0,34,"2015"
"32424","421130 NAVEGANTES",5,4,22,1421,0,1452,"2015"
"32425","421140 NOVA ERECHIM",0,1,2,51,0,54,"2015"
"32426","421145 NOVA ITABERABA",0,0,1,42,0,43,"2015"
"32427","421150 NOVA TRENTO",1,1,8,163,1,174,"2015"
"32428","421160 NOVA VENEZA",2,0,0,192,0,194,"2015"
"32429","421165 NOVO HORIZONTE",0,0,0,19,0,19,"2015"
"32430","421170 ORLEANS",0,0,6,269,0,275,"2015"
"32431","421175 OTACILIO COSTA",0,0,8,238,1,247,"2015"
"32432","421180 OURO",0,0,0,62,0,62,"2015"
"32433","421185 OURO VERDE",0,0,0,24,0,24,"2015"
"32434","421187 PAIAL",0,1,0,19,0,20,"2015"
"32435","421189 PAINEL",0,0,0,34,0,34,"2015"
"32436","421190 PALHOCA",3,11,44,2528,0,2586,"2015"
"32437","421200 PALMA SOLA",0,2,0,114,0,116,"2015"
"32438","421205 PALMEIRA",0,0,2,23,1,26,"2015"
"32439","421210 PALMITOS",0,1,4,159,0,164,"2015"
"32440","421220 PAPANDUVA",1,2,1,282,0,286,"2015"
"32441","421223 PARAISO",0,0,3,50,0,53,"2015"
"32442","421225 PASSO DE TORRES",0,1,2,85,0,88,"2015"
"32443","421227 PASSOS MAIA",0,0,1,67,0,68,"2015"
"32444","421230 PAULO LOPES",1,0,1,120,0,122,"2015"
"32445","421240 PEDRAS GRANDES",0,0,2,34,0,36,"2015"
"32446","421250 PENHA",1,3,12,381,0,397,"2015"
"32447","421260 PERITIBA",0,0,2,28,1,31,"2015"
"32448","421265 PESCARIA BRAVA",0,0,0,96,0,96,"2015"
"32449","421270 PETROLANDIA",0,1,1,61,0,63,"2015"
"32450","421280 BALNEARIO PICARRAS",2,1,4,318,3,328,"2015"
"32451","421290 PINHALZINHO",0,0,0,269,0,269,"2015"
"32452","421300 PINHEIRO PRETO",0,0,0,44,0,44,"2015"
"32453","421310 PIRATUBA",0,0,2,57,0,59,"2015"
"32454","421315 PLANALTO ALEGRE",0,0,1,32,1,34,"2015"
"32455","421320 POMERODE",2,3,5,366,0,376,"2015"
"32456","421330 PONTE ALTA",0,1,2,76,1,80,"2015"
"32457","421335 PONTE ALTA DO NORTE",1,0,1,63,0,65,"2015"
"32458","421340 PONTE SERRADA",1,1,2,156,0,160,"2015"
"32459","421350 PORTO BELO",0,4,3,248,0,255,"2015"
"32460","421360 PORTO UNIAO",0,1,1,472,1,475,"2015"
"32461","421370 POUSO REDONDO",0,1,2,229,2,234,"2015"
"32462","421380 PRAIA GRANDE",0,2,1,92,0,95,"2015"
"32463","421390 PRESIDENTE CASTELLO BRANCO",0,0,0,11,0,11,"2015"
"32464","421400 PRESIDENTE GETULIO",0,2,1,259,0,262,"2015"
"32465","421410 PRESIDENTE NEREU",0,0,0,25,1,26,"2015"
"32466","421415 PRINCESA",0,0,2,32,0,34,"2015"
"32467","421420 QUILOMBO",0,0,1,111,0,112,"2015"
"32468","421430 RANCHO QUEIMADO",0,0,0,30,0,30,"2015"
"32469","421440 RIO DAS ANTAS",0,1,2,72,0,75,"2015"
"32470","421450 RIO DO CAMPO",0,0,0,85,0,85,"2015"
"32471","421460 RIO DO OESTE",0,0,1,86,0,87,"2015"
"32472","421470 RIO DOS CEDROS",1,1,0,117,0,119,"2015"
"32473","421480 RIO DO SUL",1,4,17,924,5,951,"2015"
"32474","421490 RIO FORTUNA",0,0,0,75,0,75,"2015"
"32475","421500 RIO NEGRINHO",0,1,5,604,0,610,"2015"
"32476","421505 RIO RUFINO",0,1,3,29,1,34,"2015"
"32477","421507 RIQUEZA",0,0,1,59,0,60,"2015"
"32478","421510 RODEIO",0,1,2,128,0,131,"2015"
"32479","421520 ROMELANDIA",0,0,0,39,0,39,"2015"
"32480","421530 SALETE",0,0,1,84,1,86,"2015"
"32481","421535 SALTINHO",0,0,2,57,0,59,"2015"
"32482","421540 SALTO VELOSO",0,0,0,57,0,57,"2015"
"32483","421545 SANGAO",1,0,1,195,0,197,"2015"
"32484","421550 SANTA CECILIA",0,0,5,303,0,308,"2015"
"32485","421555 SANTA HELENA",0,1,0,24,0,25,"2015"
"32486","421560 SANTA ROSA DE LIMA",0,0,0,21,1,22,"2015"
"32487","421565 SANTA ROSA DO SUL",0,1,3,97,0,101,"2015"
"32488","421567 SANTA TEREZINHA",1,0,1,93,0,95,"2015"
"32489","421568 SANTA TEREZINHA DO PROGRESSO",0,0,1,31,0,32,"2015"
"32490","421569 SANTIAGO DO SUL",0,0,0,20,0,20,"2015"
"32491","421570 SANTO AMARO DA IMPERATRIZ",1,2,5,303,0,311,"2015"
"32492","421575 SAO BERNARDINO",1,0,0,49,0,50,"2015"
"32493","421580 SAO BENTO DO SUL",2,4,10,1135,3,1154,"2015"
"32494","421590 SAO BONIFACIO",0,0,0,26,0,26,"2015"
"32495","421600 SAO CARLOS",0,1,0,110,0,111,"2015"
"32496","421605 SAO CRISTOVAO DO SUL",0,0,0,74,0,74,"2015"
"32497","421610 SAO DOMINGOS",0,0,1,126,3,130,"2015"
"32498","421620 SAO FRANCISCO DO SUL",5,1,8,645,7,666,"2015"
"32499","421625 SAO JOAO DO OESTE",0,0,1,66,0,67,"2015"
"32500","421630 SAO JOAO BATISTA",0,2,8,454,1,465,"2015"
"32501","421635 SAO JOAO DO ITAPERIU",0,0,2,61,1,64,"2015"
"32502","421640 SAO JOAO DO SUL",0,0,2,79,0,81,"2015"
"32503","421650 SAO JOAQUIM",2,0,9,356,1,368,"2015"
"32504","421660 SAO JOSE",10,8,42,3284,0,3344,"2015"
"32505","421670 SAO JOSE DO CEDRO",0,1,1,173,0,175,"2015"
"32506","421680 SAO JOSE DO CERRITO",0,0,1,82,1,84,"2015"
"32507","421690 SAO LOURENCO DO OESTE",1,1,8,330,2,342,"2015"
"32508","421700 SAO LUDGERO",0,0,2,182,0,184,"2015"
"32509","421710 SAO MARTINHO",0,0,1,35,0,36,"2015"
"32510","421715 SAO MIGUEL DA BOA VISTA",0,0,0,18,0,18,"2015"
"32511","421720 SAO MIGUEL DO OESTE",3,3,8,558,0,572,"2015"
"32512","421725 SAO PEDRO DE ALCANTARA",0,0,0,37,0,37,"2015"
"32513","421730 SAUDADES",0,0,2,112,1,115,"2015"
"32514","421740 SCHROEDER",0,1,6,270,0,277,"2015"
"32515","421750 SEARA",1,2,3,197,0,203,"2015"
"32516","421755 SERRA ALTA",0,0,0,28,0,28,"2015"
"32517","421760 SIDEROPOLIS",0,0,2,151,0,153,"2015"
"32518","421770 SOMBRIO",1,3,8,425,0,437,"2015"
"32519","421775 SUL BRASIL",0,1,0,40,0,41,"2015"
"32520","421780 TAIO",0,0,1,232,0,233,"2015"
"32521","421790 TANGARA",0,0,0,86,1,87,"2015"
"32522","421795 TIGRINHOS",0,0,2,27,0,29,"2015"
"32523","421800 TIJUCAS",1,2,9,592,0,604,"2015"
"32524","421810 TIMBE DO SUL",0,0,1,51,0,52,"2015"
"32525","421820 TIMBO",0,1,2,467,0,470,"2015"
"32526","421825 TIMBO GRANDE",1,3,4,119,0,127,"2015"
"32527","421830 TRES BARRAS",1,2,8,310,0,321,"2015"
"32528","421835 TREVISO",0,0,0,31,0,31,"2015"
"32529","421840 TREZE DE MAIO",0,0,0,78,0,78,"2015"
"32530","421850 TREZE TILIAS",1,0,2,111,0,114,"2015"
"32531","421860 TROMBUDO CENTRAL",0,0,2,112,0,114,"2015"
"32532","421870 TUBARAO",2,3,10,1309,1,1325,"2015"
"32533","421875 TUNAPOLIS",0,1,1,52,0,54,"2015"
"32534","421880 TURVO",0,0,1,154,0,155,"2015"
"32535","421885 UNIAO DO OESTE",0,0,0,29,0,29,"2015"
"32536","421890 URUBICI",0,0,5,110,0,115,"2015"
"32537","421895 URUPEMA",0,0,1,25,0,26,"2015"
"32538","421900 URUSSANGA",3,1,1,185,0,190,"2015"
"32539","421910 VARGEAO",0,0,1,58,0,59,"2015"
"32540","421915 VARGEM",0,0,0,33,0,33,"2015"
"32541","421917 VARGEM BONITA",0,0,1,73,1,75,"2015"
"32542","421920 VIDAL RAMOS",0,0,2,79,0,81,"2015"
"32543","421930 VIDEIRA",2,2,13,800,0,817,"2015"
"32544","421935 VITOR MEIRELES",0,0,0,63,1,64,"2015"
"32545","421940 WITMARSUM",0,0,0,49,1,50,"2015"
"32546","421950 XANXERE",2,4,7,717,3,733,"2015"
"32547","421960 XAVANTINA",0,0,0,27,0,27,"2015"
"32548","421970 XAXIM",0,2,2,412,0,416,"2015"
"32549","421985 ZORTEA",0,0,0,27,0,27,"2015"
"32550","422000 BALNEARIO RINCAO",3,2,2,173,0,180,"2015"
"32551","430003 ACEGUA",0,0,1,54,0,55,"2015"
"32552","430005 AGUA SANTA",0,0,0,36,0,36,"2015"
"32553","430010 AGUDO",0,1,2,158,0,161,"2015"
"32554","430020 AJURICABA",1,0,2,65,0,68,"2015"
"32555","430030 ALECRIM",0,0,1,47,0,48,"2015"
"32556","430040 ALEGRETE",0,0,16,937,1,954,"2015"
"32557","430045 ALEGRIA",0,0,0,31,0,31,"2015"
"32558","430047 ALMIRANTE TAMANDARE DO SUL",0,0,0,24,0,24,"2015"
"32559","430050 ALPESTRE",0,1,0,70,0,71,"2015"
"32560","430055 ALTO ALEGRE",0,0,1,17,0,18,"2015"
"32561","430057 ALTO FELIZ",0,1,1,30,0,32,"2015"
"32562","430060 ALVORADA",7,18,65,3404,11,3505,"2015"
"32563","430063 AMARAL FERRADOR",0,0,1,55,1,57,"2015"
"32564","430064 AMETISTA DO SUL",0,0,1,93,0,94,"2015"
"32565","430066 ANDRE DA ROCHA",0,0,0,14,0,14,"2015"
"32566","430070 ANTA GORDA",0,0,0,60,0,60,"2015"
"32567","430080 ANTONIO PRADO",0,0,3,146,0,149,"2015"
"32568","430085 ARAMBARE",0,0,1,43,1,45,"2015"
"32569","430087 ARARICA",0,0,1,91,1,93,"2015"
"32570","430090 ARATIBA",0,0,0,60,0,60,"2015"
"32571","430100 ARROIO DO MEIO",0,1,4,223,0,228,"2015"
"32572","430105 ARROIO DO SAL",0,1,6,120,0,127,"2015"
"32573","430107 ARROIO DO PADRE",0,0,1,27,0,28,"2015"
"32574","430110 ARROIO DOS RATOS",0,0,2,181,0,183,"2015"
"32575","430120 ARROIO DO TIGRE",0,1,0,152,0,153,"2015"
"32576","430130 ARROIO GRANDE",2,6,11,212,1,232,"2015"
"32577","430140 ARVOREZINHA",0,0,2,110,0,112,"2015"
"32578","430150 AUGUSTO PESTANA",0,0,1,75,0,76,"2015"
"32579","430155 AUREA",0,0,0,28,0,28,"2015"
"32580","430160 BAGE",8,8,10,1583,6,1615,"2015"
"32581","430163 BALNEARIO PINHAL",1,0,5,140,0,146,"2015"
"32582","430165 BARAO",2,0,0,61,0,63,"2015"
"32583","430170 BARAO DE COTEGIPE",0,0,0,73,0,73,"2015"
"32584","430175 BARAO DO TRIUNFO",0,1,1,48,0,50,"2015"
"32585","430180 BARRACAO",0,0,0,65,0,65,"2015"
"32586","430185 BARRA DO GUARITA",0,0,1,47,0,48,"2015"
"32587","430187 BARRA DO QUARAI",0,0,0,20,14,34,"2015"
"32588","430190 BARRA DO RIBEIRO",0,0,3,150,9,162,"2015"
"32589","430192 BARRA DO RIO AZUL",0,0,0,11,0,11,"2015"
"32590","430195 BARRA FUNDA",0,0,0,30,0,30,"2015"
"32591","430200 BARROS CASSAL",0,2,3,125,0,130,"2015"
"32592","430205 BENJAMIN CONSTANT DO SUL",0,0,0,35,0,35,"2015"
"32593","430210 BENTO GONCALVES",2,6,36,1653,3,1700,"2015"
"32594","430215 BOA VISTA DAS MISSOES",0,1,0,33,0,34,"2015"
"32595","430220 BOA VISTA DO BURICA",0,0,0,73,0,73,"2015"
"32596","430222 BOA VISTA DO CADEADO",0,0,0,13,0,13,"2015"
"32597","430223 BOA VISTA DO INCRA",0,0,0,29,1,30,"2015"
"32598","430225 BOA VISTA DO SUL",0,0,0,20,0,20,"2015"
"32599","430230 BOM JESUS",0,0,3,144,7,154,"2015"
"32600","430235 BOM PRINCIPIO",0,0,3,181,0,184,"2015"
"32601","430237 BOM PROGRESSO",0,0,0,25,0,25,"2015"
"32602","430240 BOM RETIRO DO SUL",0,0,3,162,0,165,"2015"
"32603","430245 BOQUEIRAO DO LEAO",0,1,0,98,1,100,"2015"
"32604","430250 BOSSOROCA",0,0,1,56,0,57,"2015"
"32605","430258 BOZANO",0,0,0,17,0,17,"2015"
"32606","430260 BRAGA",0,0,0,42,0,42,"2015"
"32607","430265 BROCHIER",0,0,0,32,0,32,"2015"
"32608","430270 BUTIA",0,0,3,268,3,274,"2015"
"32609","430280 CACAPAVA DO SUL",4,1,4,380,1,390,"2015"
"32610","430290 CACEQUI",2,0,2,130,2,136,"2015"
"32611","430300 CACHOEIRA DO SUL",4,1,19,1045,7,1076,"2015"
"32612","430310 CACHOEIRINHA",0,9,24,1973,4,2010,"2015"
"32613","430320 CACIQUE DOBLE",0,0,1,60,0,61,"2015"
"32614","430330 CAIBATE",0,0,0,46,0,46,"2015"
"32615","430340 CAICARA",0,0,0,43,0,43,"2015"
"32616","430350 CAMAQUA",3,4,17,899,5,928,"2015"
"32617","430355 CAMARGO",0,0,1,26,0,27,"2015"
"32618","430360 CAMBARA DO SUL",1,0,1,74,0,76,"2015"
"32619","430367 CAMPESTRE DA SERRA",0,0,0,26,1,27,"2015"
"32620","430370 CAMPINA DAS MISSOES",0,2,2,55,0,59,"2015"
"32621","430380 CAMPINAS DO SUL",0,0,0,64,0,64,"2015"
"32622","430390 CAMPO BOM",0,4,12,897,0,913,"2015"
"32623","430400 CAMPO NOVO",0,0,1,66,0,67,"2015"
"32624","430410 CAMPOS BORGES",0,0,0,50,0,50,"2015"
"32625","430420 CANDELARIA",0,3,8,335,2,348,"2015"
"32626","430430 CANDIDO GODOI",0,1,2,76,0,79,"2015"
"32627","430435 CANDIOTA",1,0,1,129,0,131,"2015"
"32628","430440 CANELA",0,2,12,648,2,664,"2015"
"32629","430450 CANGUCU",1,1,3,545,3,553,"2015"
"32630","430460 CANOAS",10,25,128,5297,15,5475,"2015"
"32631","430461 CANUDOS DO VALE",0,0,0,16,0,16,"2015"
"32632","430462 CAPAO BONITO DO SUL",0,0,0,16,0,16,"2015"
"32633","430463 CAPAO DA CANOA",1,1,13,912,0,927,"2015"
"32634","430465 CAPAO DO CIPO",0,0,1,36,0,37,"2015"
"32635","430466 CAPAO DO LEAO",1,3,10,343,0,357,"2015"
"32636","430467 CAPIVARI DO SUL",0,0,0,55,0,55,"2015"
"32637","430468 CAPELA DE SANTANA",0,0,0,147,1,148,"2015"
"32638","430469 CAPITAO",0,0,1,34,0,35,"2015"
"32639","430470 CARAZINHO",2,3,20,894,2,921,"2015"
"32640","430471 CARAA",0,0,0,46,1,47,"2015"
"32641","430480 CARLOS BARBOSA",0,0,7,349,0,356,"2015"
"32642","430485 CARLOS GOMES",0,0,0,10,0,10,"2015"
"32643","430490 CASCA",1,0,0,74,2,77,"2015"
"32644","430495 CASEIROS",0,0,0,26,0,26,"2015"
"32645","430500 CATUIPE",0,0,1,82,0,83,"2015"
"32646","430510 CAXIAS DO SUL",10,37,105,6333,13,6498,"2015"
"32647","430511 CENTENARIO",0,0,2,18,0,20,"2015"
"32648","430512 CERRITO",0,0,2,50,1,53,"2015"
"32649","430513 CERRO BRANCO",0,0,0,38,0,38,"2015"
"32650","430515 CERRO GRANDE",0,0,0,28,0,28,"2015"
"32651","430517 CERRO GRANDE DO SUL",0,0,2,102,0,104,"2015"
"32652","430520 CERRO LARGO",0,0,0,140,0,140,"2015"
"32653","430530 CHAPADA",0,0,1,72,0,73,"2015"
"32654","430535 CHARQUEADAS",0,0,3,388,1,392,"2015"
"32655","430537 CHARRUA",0,0,0,29,0,29,"2015"
"32656","430540 CHIAPETTA",0,1,1,54,0,56,"2015"
"32657","430543 CHUI",0,0,0,44,0,44,"2015"
"32658","430544 CHUVISCA",0,0,1,53,0,54,"2015"
"32659","430545 CIDREIRA",0,0,3,182,0,185,"2015"
"32660","430550 CIRIACO",0,1,2,31,0,34,"2015"
"32661","430558 COLINAS",0,0,0,23,0,23,"2015"
"32662","430560 COLORADO",0,0,1,24,0,25,"2015"
"32663","430570 CONDOR",0,0,0,23,0,23,"2015"
"32664","430580 CONSTANTINA",0,2,1,121,0,124,"2015"
"32665","430583 COQUEIRO BAIXO",0,0,0,3,0,3,"2015"
"32666","430585 COQUEIROS DO SUL",0,0,1,22,0,23,"2015"
"32667","430587 CORONEL BARROS",0,1,0,26,0,27,"2015"
"32668","430590 CORONEL BICACO",0,0,1,88,0,89,"2015"
"32669","430593 CORONEL PILAR",0,0,0,8,0,8,"2015"
"32670","430595 COTIPORA",0,0,1,33,1,35,"2015"
"32671","430597 COXILHA",0,0,0,55,0,55,"2015"
"32672","430600 CRISSIUMAL",0,2,1,122,0,125,"2015"
"32673","430605 CRISTAL",0,2,3,108,0,113,"2015"
"32674","430607 CRISTAL DO SUL",0,0,0,30,0,30,"2015"
"32675","430610 CRUZ ALTA",5,5,9,890,0,909,"2015"
"32676","430613 CRUZALTENSE",0,1,0,20,0,21,"2015"
"32677","430620 CRUZEIRO DO SUL",0,0,2,114,0,116,"2015"
"32678","430630 DAVID CANABARRO",0,0,2,29,0,31,"2015"
"32679","430632 DERRUBADAS",0,0,0,39,0,39,"2015"
"32680","430635 DEZESSEIS DE NOVEMBRO",0,0,0,20,0,20,"2015"
"32681","430637 DILERMANDO DE AGUIAR",0,0,0,28,0,28,"2015"
"32682","430640 DOIS IRMAOS",0,3,6,393,1,403,"2015"
"32683","430642 DOIS IRMAOS DAS MISSOES",0,0,0,22,0,22,"2015"
"32684","430645 DOIS LAJEADOS",2,0,0,23,0,25,"2015"
"32685","430650 DOM FELICIANO",1,1,2,168,0,172,"2015"
"32686","430655 DOM PEDRO DE ALCANTARA",0,0,2,23,0,25,"2015"
"32687","430660 DOM PEDRITO",2,0,4,430,0,436,"2015"
"32688","430670 DONA FRANCISCA",0,0,0,32,0,32,"2015"
"32689","430673 DOUTOR MAURICIO CARDOSO",0,1,0,41,0,42,"2015"
"32690","430675 DOUTOR RICARDO",0,0,0,23,0,23,"2015"
"32691","430676 ELDORADO DO SUL",0,1,12,542,3,558,"2015"
"32692","430680 ENCANTADO",1,1,1,263,1,267,"2015"
"32693","430690 ENCRUZILHADA DO SUL",1,3,4,262,1,271,"2015"
"32694","430692 ENGENHO VELHO",0,0,0,17,0,17,"2015"
"32695","430693 ENTRE-IJUIS",0,0,4,116,0,120,"2015"
"32696","430695 ENTRE RIOS DO SUL",0,1,2,31,1,35,"2015"
"32697","430697 EREBANGO",0,0,1,43,0,44,"2015"
"32698","430700 ERECHIM",1,3,23,1424,1,1452,"2015"
"32699","430705 ERNESTINA",0,0,3,42,0,45,"2015"
"32700","430710 HERVAL",0,0,2,55,0,57,"2015"
"32701","430720 ERVAL GRANDE",0,0,2,42,1,45,"2015"
"32702","430730 ERVAL SECO",0,0,0,87,0,87,"2015"
"32703","430740 ESMERALDA",0,1,1,21,4,27,"2015"
"32704","430745 ESPERANCA DO SUL",0,0,0,41,0,41,"2015"
"32705","430750 ESPUMOSO",0,1,1,190,0,192,"2015"
"32706","430755 ESTACAO",1,1,0,73,0,75,"2015"
"32707","430760 ESTANCIA VELHA",0,1,7,616,1,625,"2015"
"32708","430770 ESTEIO",0,4,23,1206,0,1233,"2015"
"32709","430780 ESTRELA",1,5,11,457,0,474,"2015"
"32710","430781 ESTRELA VELHA",0,0,0,54,0,54,"2015"
"32711","430783 EUGENIO DE CASTRO",0,0,0,26,0,26,"2015"
"32712","430786 FAGUNDES VARELA",1,1,0,12,0,14,"2015"
"32713","430790 FARROUPILHA",0,4,10,902,0,916,"2015"
"32714","430800 FAXINAL DO SOTURNO",0,0,1,67,0,68,"2015"
"32715","430805 FAXINALZINHO",0,0,0,38,0,38,"2015"
"32716","430807 FAZENDA VILANOVA",0,2,1,63,0,66,"2015"
"32717","430810 FELIZ",1,0,3,151,0,155,"2015"
"32718","430820 FLORES DA CUNHA",0,1,3,375,0,379,"2015"
"32719","430825 FLORIANO PEIXOTO",0,0,0,11,0,11,"2015"
"32720","430830 FONTOURA XAVIER",0,2,2,114,1,119,"2015"
"32721","430840 FORMIGUEIRO",0,0,1,66,0,67,"2015"
"32722","430843 FORQUETINHA",0,0,0,18,0,18,"2015"
"32723","430845 FORTALEZA DOS VALOS",0,0,1,48,0,49,"2015"
"32724","430850 FREDERICO WESTPHALEN",0,1,5,424,0,430,"2015"
"32725","430860 GARIBALDI",0,2,4,407,1,414,"2015"
"32726","430865 GARRUCHOS",0,0,0,24,0,24,"2015"
"32727","430870 GAURAMA",0,0,0,56,0,56,"2015"
"32728","430880 GENERAL CAMARA",0,0,1,96,0,97,"2015"
"32729","430885 GENTIL",0,0,0,22,0,22,"2015"
"32730","430890 GETULIO VARGAS",1,1,2,186,0,190,"2015"
"32731","430900 GIRUA",0,1,5,215,0,221,"2015"
"32732","430905 GLORINHA",0,0,1,87,0,88,"2015"
"32733","430910 GRAMADO",0,1,6,584,0,591,"2015"
"32734","430912 GRAMADO DOS LOUREIROS",0,0,0,26,0,26,"2015"
"32735","430915 GRAMADO XAVIER",0,0,1,44,0,45,"2015"
"32736","430920 GRAVATAI",4,18,63,3640,9,3734,"2015"
"32737","430925 GUABIJU",0,0,0,17,0,17,"2015"
"32738","430930 GUAIBA",4,7,27,1360,13,1411,"2015"
"32739","430940 GUAPORE",0,0,7,287,0,294,"2015"
"32740","430950 GUARANI DAS MISSOES",0,0,0,74,0,74,"2015"
"32741","430955 HARMONIA",0,0,1,42,0,43,"2015"
"32742","430957 HERVEIRAS",0,0,0,31,0,31,"2015"
"32743","430960 HORIZONTINA",0,0,3,252,0,255,"2015"
"32744","430965 HULHA NEGRA",0,2,3,78,0,83,"2015"
"32745","430970 HUMAITA",0,0,0,49,0,49,"2015"
"32746","430975 IBARAMA",0,0,0,40,0,40,"2015"
"32747","430980 IBIACA",0,0,0,49,0,49,"2015"
"32748","430990 IBIRAIARAS",1,2,2,70,0,75,"2015"
"32749","430995 IBIRAPUITA",0,0,0,41,0,41,"2015"
"32750","431000 IBIRUBA",0,0,6,252,0,258,"2015"
"32751","431010 IGREJINHA",3,3,6,460,0,472,"2015"
"32752","431020 IJUI",1,8,13,1160,1,1183,"2015"
"32753","431030 ILOPOLIS",0,0,0,50,0,50,"2015"
"32754","431033 IMBE",0,0,5,296,0,301,"2015"
"32755","431036 IMIGRANTE",0,0,1,24,0,25,"2015"
"32756","431040 INDEPENDENCIA",0,0,0,68,0,68,"2015"
"32757","431041 INHACORA",0,0,0,26,0,26,"2015"
"32758","431043 IPE",1,1,1,66,0,69,"2015"
"32759","431046 IPIRANGA DO SUL",0,0,1,15,0,16,"2015"
"32760","431050 IRAI",0,1,2,101,0,104,"2015"
"32761","431053 ITAARA",0,0,0,63,1,64,"2015"
"32762","431055 ITACURUBI",0,0,0,31,0,31,"2015"
"32763","431057 ITAPUCA",0,0,0,19,0,19,"2015"
"32764","431060 ITAQUI",1,2,17,552,2,574,"2015"
"32765","431065 ITATI",0,0,0,21,0,21,"2015"
"32766","431070 ITATIBA DO SUL",0,0,0,29,0,29,"2015"
"32767","431075 IVORA",0,0,0,14,0,14,"2015"
"32768","431080 IVOTI",0,0,5,286,1,292,"2015"
"32769","431085 JABOTICABA",0,1,2,46,0,49,"2015"
"32770","431087 JACUIZINHO",0,0,0,24,0,24,"2015"
"32771","431090 JACUTINGA",0,0,0,24,0,24,"2015"
"32772","431100 JAGUARAO",1,2,8,329,2,342,"2015"
"32773","431110 JAGUARI",2,1,1,101,0,105,"2015"
"32774","431112 JAQUIRANA",1,1,2,51,3,58,"2015"
"32775","431113 JARI",0,0,0,38,1,39,"2015"
"32776","431115 JOIA",0,1,2,86,0,89,"2015"
"32777","431120 JULIO DE CASTILHOS",0,1,2,245,0,248,"2015"
"32778","431123 LAGOA BONITA DO SUL",0,0,2,32,0,34,"2015"
"32779","431125 LAGOAO",0,0,1,46,0,47,"2015"
"32780","431127 LAGOA DOS TRES CANTOS",0,0,0,21,0,21,"2015"
"32781","431130 LAGOA VERMELHA",3,3,6,413,1,426,"2015"
"32782","431140 LAJEADO",1,7,10,1194,1,1213,"2015"
"32783","431142 LAJEADO DO BUGRE",0,0,0,29,0,29,"2015"
"32784","431150 LAVRAS DO SUL",0,0,0,83,1,84,"2015"
"32785","431160 LIBERATO SALZANO",0,0,1,48,0,49,"2015"
"32786","431162 LINDOLFO COLLOR",0,0,0,83,0,83,"2015"
"32787","431164 LINHA NOVA",0,0,0,11,0,11,"2015"
"32788","431170 MACHADINHO",0,1,1,72,0,74,"2015"
"32789","431171 MACAMBARA",0,0,0,35,0,35,"2015"
"32790","431173 MAMPITUBA",0,1,1,36,1,39,"2015"
"32791","431175 MANOEL VIANA",0,0,5,70,0,75,"2015"
"32792","431177 MAQUINE",1,1,1,69,0,72,"2015"
"32793","431179 MARATA",0,0,0,25,0,25,"2015"
"32794","431180 MARAU",1,4,7,522,0,534,"2015"
"32795","431190 MARCELINO RAMOS",0,0,0,34,0,34,"2015"
"32796","431198 MARIANA PIMENTEL",0,0,0,37,2,39,"2015"
"32797","431200 MARIANO MORO",0,0,0,17,0,17,"2015"
"32798","431205 MARQUES DE SOUZA",0,1,0,45,0,46,"2015"
"32799","431210 MATA",0,0,0,41,0,41,"2015"
"32800","431213 MATO CASTELHANO",0,0,0,28,0,28,"2015"
"32801","431215 MATO LEITAO",0,0,0,54,0,54,"2015"
"32802","431217 MATO QUEIMADO",0,0,1,22,0,23,"2015"
"32803","431220 MAXIMILIANO DE ALMEIDA",0,0,0,49,0,49,"2015"
"32804","431225 MINAS DO LEAO",1,0,0,111,0,112,"2015"
"32805","431230 MIRAGUAI",0,0,0,61,0,61,"2015"
"32806","431235 MONTAURI",0,0,0,16,0,16,"2015"
"32807","431237 MONTE ALEGRE DOS CAMPOS",0,0,0,37,2,39,"2015"
"32808","431238 MONTE BELO DO SUL",0,0,1,20,0,21,"2015"
"32809","431240 MONTENEGRO",5,3,8,959,0,975,"2015"
"32810","431242 MORMACO",0,0,1,34,0,35,"2015"
"32811","431244 MORRINHOS DO SUL",0,0,2,18,0,20,"2015"
"32812","431245 MORRO REDONDO",0,0,0,62,0,62,"2015"
"32813","431247 MORRO REUTER",0,0,1,58,0,59,"2015"
"32814","431250 MOSTARDAS",0,0,3,131,1,135,"2015"
"32815","431260 MUCUM",0,1,0,46,0,47,"2015"
"32816","431261 MUITOS CAPOES",0,0,1,32,1,34,"2015"
"32817","431262 MULITERNO",0,1,0,22,0,23,"2015"
"32818","431265 NAO-ME-TOQUE",2,2,2,250,0,256,"2015"
"32819","431267 NICOLAU VERGUEIRO",0,0,0,25,0,25,"2015"
"32820","431270 NONOAI",0,1,5,184,0,190,"2015"
"32821","431275 NOVA ALVORADA",0,0,0,41,0,41,"2015"
"32822","431280 NOVA ARACA",0,0,0,77,0,77,"2015"
"32823","431290 NOVA BASSANO",0,0,1,87,0,88,"2015"
"32824","431295 NOVA BOA VISTA",0,0,0,16,0,16,"2015"
"32825","431300 NOVA BRESCIA",0,0,0,32,0,32,"2015"
"32826","431301 NOVA CANDELARIA",0,0,0,27,0,27,"2015"
"32827","431303 NOVA ESPERANCA DO SUL",0,0,0,58,0,58,"2015"
"32828","431306 NOVA HARTZ",0,0,2,254,1,257,"2015"
"32829","431308 NOVA PADUA",0,0,1,16,0,17,"2015"
"32830","431310 NOVA PALMA",0,0,0,61,0,61,"2015"
"32831","431320 NOVA PETROPOLIS",0,1,4,275,0,280,"2015"
"32832","431330 NOVA PRATA",1,4,2,321,0,328,"2015"
"32833","431333 NOVA RAMADA",0,0,0,25,0,25,"2015"
"32834","431335 NOVA ROMA DO SUL",0,0,1,27,0,28,"2015"
"32835","431337 NOVA SANTA RITA",0,0,5,421,0,426,"2015"
"32836","431339 NOVO CABRAIS",0,0,1,28,0,29,"2015"
"32837","431340 NOVO HAMBURGO",10,12,56,3420,7,3505,"2015"
"32838","431342 NOVO MACHADO",0,0,2,18,0,20,"2015"
"32839","431344 NOVO TIRADENTES",0,0,1,21,0,22,"2015"
"32840","431346 NOVO XINGU",0,0,1,22,0,23,"2015"
"32841","431349 NOVO BARREIRO",2,2,0,40,0,44,"2015"
"32842","431350 OSORIO",0,2,8,629,0,639,"2015"
"32843","431360 PAIM FILHO",0,1,0,26,0,27,"2015"
"32844","431365 PALMARES DO SUL",0,2,3,114,3,122,"2015"
"32845","431370 PALMEIRA DAS MISSOES",0,1,2,522,0,525,"2015"
"32846","431380 PALMITINHO",1,0,5,97,0,103,"2015"
"32847","431390 PANAMBI",0,1,3,597,0,601,"2015"
"32848","431395 PANTANO GRANDE",0,0,3,107,0,110,"2015"
"32849","431400 PARAI",0,0,0,72,0,72,"2015"
"32850","431402 PARAISO DO SUL",1,0,1,69,0,71,"2015"
"32851","431403 PARECI NOVO",1,0,0,45,2,48,"2015"
"32852","431405 PAROBE",2,3,12,761,0,778,"2015"
"32853","431406 PASSA SETE",0,0,0,37,0,37,"2015"
"32854","431407 PASSO DO SOBRADO",0,0,0,54,0,54,"2015"
"32855","431410 PASSO FUNDO",5,23,61,2836,0,2925,"2015"
"32856","431413 PAULO BENTO",0,0,0,16,0,16,"2015"
"32857","431415 PAVERAMA",0,0,2,91,0,93,"2015"
"32858","431417 PEDRAS ALTAS",1,1,0,23,0,25,"2015"
"32859","431420 PEDRO OSORIO",0,5,4,82,0,91,"2015"
"32860","431430 PEJUCARA",0,0,0,36,0,36,"2015"
"32861","431440 PELOTAS",23,36,88,4272,9,4428,"2015"
"32862","431442 PICADA CAFE",0,0,0,48,0,48,"2015"
"32863","431445 PINHAL",0,0,0,35,0,35,"2015"
"32864","431446 PINHAL DA SERRA",0,0,0,20,3,23,"2015"
"32865","431447 PINHAL GRANDE",0,1,1,40,0,42,"2015"
"32866","431449 PINHEIRINHO DO VALE",0,0,1,42,0,43,"2015"
"32867","431450 PINHEIRO MACHADO",0,0,2,103,2,107,"2015"
"32868","431454 PINTO BANDEIRA",0,0,0,19,0,19,"2015"
"32869","431455 PIRAPO",0,0,0,17,0,17,"2015"
"32870","431460 PIRATINI",1,3,12,162,0,178,"2015"
"32871","431470 PLANALTO",0,1,1,125,0,127,"2015"
"32872","431475 POCO DAS ANTAS",0,1,0,19,0,20,"2015"
"32873","431477 PONTAO",0,0,3,46,0,49,"2015"
"32874","431478 PONTE PRETA",0,0,0,16,0,16,"2015"
"32875","431480 PORTAO",0,3,15,420,3,441,"2015"
"32876","431490 PORTO ALEGRE",37,102,371,19136,78,19724,"2015"
"32877","431500 PORTO LUCENA",0,0,1,35,0,36,"2015"
"32878","431505 PORTO MAUA",0,0,0,20,0,20,"2015"
"32879","431507 PORTO VERA CRUZ",0,0,0,14,0,14,"2015"
"32880","431510 PORTO XAVIER",0,0,2,140,0,142,"2015"
"32881","431513 POUSO NOVO",1,0,1,19,0,21,"2015"
"32882","431514 PRESIDENTE LUCENA",0,0,1,23,0,24,"2015"
"32883","431515 PROGRESSO",0,1,0,51,0,52,"2015"
"32884","431517 PROTASIO ALVES",0,0,1,25,0,26,"2015"
"32885","431520 PUTINGA",0,0,0,28,0,28,"2015"
"32886","431530 QUARAI",1,1,6,258,0,266,"2015"
"32887","431531 QUATRO IRMAOS",0,0,0,20,0,20,"2015"
"32888","431532 QUEVEDOS",0,0,1,25,0,26,"2015"
"32889","431535 QUINZE DE NOVEMBRO",1,0,0,41,0,42,"2015"
"32890","431540 REDENTORA",0,0,3,199,2,204,"2015"
"32891","431545 RELVADO",0,0,0,13,0,13,"2015"
"32892","431550 RESTINGA SECA",0,0,5,138,1,144,"2015"
"32893","431555 RIO DOS INDIOS",0,1,1,21,0,23,"2015"
"32894","431560 RIO GRANDE",4,13,90,2938,15,3060,"2015"
"32895","431570 RIO PARDO",2,1,6,416,0,425,"2015"
"32896","431575 RIOZINHO",0,1,1,44,0,46,"2015"
"32897","431580 ROCA SALES",0,1,1,90,0,92,"2015"
"32898","431590 RODEIO BONITO",0,0,0,77,0,77,"2015"
"32899","431595 ROLADOR",0,0,0,18,0,18,"2015"
"32900","431600 ROLANTE",2,0,2,242,2,248,"2015"
"32901","431610 RONDA ALTA",0,0,1,112,0,113,"2015"
"32902","431620 RONDINHA",0,0,2,53,0,55,"2015"
"32903","431630 ROQUE GONZALES",0,0,1,58,0,59,"2015"
"32904","431640 ROSARIO DO SUL",1,2,6,442,0,451,"2015"
"32905","431642 SAGRADA FAMILIA",0,0,2,34,0,36,"2015"
"32906","431643 SALDANHA MARINHO",0,0,0,27,0,27,"2015"
"32907","431645 SALTO DO JACUI",0,0,2,117,1,120,"2015"
"32908","431647 SALVADOR DAS MISSOES",0,0,0,26,1,27,"2015"
"32909","431650 SALVADOR DO SUL",0,0,0,87,0,87,"2015"
"32910","431660 SANANDUVA",0,1,3,160,1,165,"2015"
"32911","431670 SANTA BARBARA DO SUL",0,0,4,115,2,121,"2015"
"32912","431673 SANTA CECILIA DO SUL",0,0,0,19,0,19,"2015"
"32913","431675 SANTA CLARA DO SUL",0,1,2,82,0,85,"2015"
"32914","431680 SANTA CRUZ DO SUL",2,2,15,1694,2,1715,"2015"
"32915","431690 SANTA MARIA",11,16,56,3570,13,3666,"2015"
"32916","431695 SANTA MARIA DO HERVAL",0,0,0,52,0,52,"2015"
"32917","431697 SANTA MARGARIDA DO SUL",0,0,1,29,0,30,"2015"
"32918","431700 SANTANA DA BOA VISTA",0,1,1,54,1,57,"2015"
"32919","431710 SANT'ANA DO LIVRAMENTO",2,3,4,1183,1,1193,"2015"
"32920","431720 SANTA ROSA",3,7,68,923,12,1013,"2015"
"32921","431725 SANTA TEREZA",0,0,0,8,0,8,"2015"
"32922","431730 SANTA VITORIA DO PALMAR",1,1,6,434,0,442,"2015"
"32923","431740 SANTIAGO",0,2,7,551,0,560,"2015"
"32924","431750 SANTO ANGELO",0,2,13,956,2,973,"2015"
"32925","431755 SANTO ANTONIO DO PALMA",0,0,1,15,0,16,"2015"
"32926","431760 SANTO ANTONIO DA PATRULHA",2,0,6,492,0,500,"2015"
"32927","431770 SANTO ANTONIO DAS MISSOES",0,0,0,97,0,97,"2015"
"32928","431775 SANTO ANTONIO DO PLANALTO",0,0,0,34,0,34,"2015"
"32929","431780 SANTO AUGUSTO",0,0,4,216,0,220,"2015"
"32930","431790 SANTO CRISTO",1,0,14,130,0,145,"2015"
"32931","431795 SANTO EXPEDITO DO SUL",0,0,0,21,0,21,"2015"
"32932","431800 SAO BORJA",1,2,5,798,0,806,"2015"
"32933","431805 SAO DOMINGOS DO SUL",0,0,2,20,0,22,"2015"
"32934","431810 SAO FRANCISCO DE ASSIS",0,0,3,192,1,196,"2015"
"32935","431820 SAO FRANCISCO DE PAULA",2,0,2,269,1,274,"2015"
"32936","431830 SAO GABRIEL",1,3,9,797,2,812,"2015"
"32937","431840 SAO JERONIMO",2,0,2,297,1,302,"2015"
"32938","431842 SAO JOAO DA URTIGA",0,2,1,30,0,33,"2015"
"32939","431843 SAO JOAO DO POLESINE",0,0,0,20,0,20,"2015"
"32940","431844 SAO JORGE",0,0,0,26,0,26,"2015"
"32941","431845 SAO JOSE DAS MISSOES",0,0,0,26,0,26,"2015"
"32942","431846 SAO JOSE DO HERVAL",0,0,1,21,0,22,"2015"
"32943","431848 SAO JOSE DO HORTENCIO",0,0,1,42,0,43,"2015"
"32944","431849 SAO JOSE DO INHACORA",0,0,0,22,0,22,"2015"
"32945","431850 SAO JOSE DO NORTE",0,1,9,293,0,303,"2015"
"32946","431860 SAO JOSE DO OURO",0,2,0,83,0,85,"2015"
"32947","431861 SAO JOSE DO SUL",0,0,1,21,0,22,"2015"
"32948","431862 SAO JOSE DOS AUSENTES",0,0,0,56,2,58,"2015"
"32949","431870 SAO LEOPOLDO",6,15,77,3007,4,3109,"2015"
"32950","431880 SAO LOURENCO DO SUL",1,1,7,421,0,430,"2015"
"32951","431890 SAO LUIZ GONZAGA",2,0,3,488,0,493,"2015"
"32952","431900 SAO MARCOS",0,1,2,257,0,260,"2015"
"32953","431910 SAO MARTINHO",0,0,1,61,0,62,"2015"
"32954","431912 SAO MARTINHO DA SERRA",0,0,0,28,1,29,"2015"
"32955","431915 SAO MIGUEL DAS MISSOES",0,0,1,104,1,106,"2015"
"32956","431920 SAO NICOLAU",0,0,2,54,0,56,"2015"
"32957","431930 SAO PAULO DAS MISSOES",0,3,0,38,0,41,"2015"
"32958","431935 SAO PEDRO DA SERRA",0,0,0,35,0,35,"2015"
"32959","431936 SAO PEDRO DAS MISSOES",0,0,0,22,0,22,"2015"
"32960","431937 SAO PEDRO DO BUTIA",0,0,0,24,0,24,"2015"
"32961","431940 SAO PEDRO DO SUL",1,0,0,159,2,162,"2015"
"32962","431950 SAO SEBASTIAO DO CAI",1,0,2,351,0,354,"2015"
"32963","431960 SAO SEPE",0,1,3,257,0,261,"2015"
"32964","431970 SAO VALENTIM",0,0,0,42,0,42,"2015"
"32965","431971 SAO VALENTIM DO SUL",0,0,0,22,0,22,"2015"
"32966","431973 SAO VALERIO DO SUL",0,0,0,32,0,32,"2015"
"32967","431975 SAO VENDELINO",0,0,0,25,0,25,"2015"
"32968","431980 SAO VICENTE DO SUL",0,0,2,98,1,101,"2015"
"32969","431990 SAPIRANGA",1,5,18,1189,0,1213,"2015"
"32970","432000 SAPUCAIA DO SUL",2,14,78,1961,2,2057,"2015"
"32971","432010 SARANDI",0,1,6,304,1,312,"2015"
"32972","432020 SEBERI",2,1,1,152,0,156,"2015"
"32973","432023 SEDE NOVA",0,0,0,31,0,31,"2015"
"32974","432026 SEGREDO",1,0,1,76,1,79,"2015"
"32975","432030 SELBACH",0,0,0,51,0,51,"2015"
"32976","432032 SENADOR SALGADO FILHO",0,0,1,27,0,28,"2015"
"32977","432035 SENTINELA DO SUL",0,1,0,50,1,52,"2015"
"32978","432040 SERAFINA CORREA",1,0,1,206,0,208,"2015"
"32979","432045 SERIO",1,0,0,15,0,16,"2015"
"32980","432050 SERTAO",0,0,0,50,0,50,"2015"
"32981","432055 SERTAO SANTANA",0,0,0,55,1,56,"2015"
"32982","432057 SETE DE SETEMBRO",0,0,0,21,0,21,"2015"
"32983","432060 SEVERIANO DE ALMEIDA",0,0,1,34,0,35,"2015"
"32984","432065 SILVEIRA MARTINS",0,0,0,20,1,21,"2015"
"32985","432067 SINIMBU",0,0,1,80,0,81,"2015"
"32986","432070 SOBRADINHO",0,1,1,204,0,206,"2015"
"32987","432080 SOLEDADE",1,4,10,353,0,368,"2015"
"32988","432085 TABAI",0,0,0,56,0,56,"2015"
"32989","432090 TAPEJARA",1,1,6,350,1,359,"2015"
"32990","432100 TAPERA",0,0,0,125,0,125,"2015"
"32991","432110 TAPES",0,1,5,176,0,182,"2015"
"32992","432120 TAQUARA",1,1,8,738,4,752,"2015"
"32993","432130 TAQUARI",3,0,4,324,1,332,"2015"
"32994","432132 TAQUARUCU DO SUL",0,0,0,21,2,23,"2015"
"32995","432135 TAVARES",0,1,1,46,1,49,"2015"
"32996","432140 TENENTE PORTELA",0,1,0,250,0,251,"2015"
"32997","432143 TERRA DE AREIA",0,0,3,122,0,125,"2015"
"32998","432145 TEUTONIA",0,1,5,414,0,420,"2015"
"32999","432146 TIO HUGO",0,0,1,26,0,27,"2015"
"33000","432147 TIRADENTES DO SUL",0,0,1,57,0,58,"2015"
"33001","432149 TOROPI",0,0,0,18,0,18,"2015"
"33002","432150 TORRES",0,1,13,557,1,572,"2015"
"33003","432160 TRAMANDAI",2,3,13,811,2,831,"2015"
"33004","432162 TRAVESSEIRO",0,0,0,16,0,16,"2015"
"33005","432163 TRES ARROIOS",0,0,0,10,0,10,"2015"
"33006","432166 TRES CACHOEIRAS",0,0,0,134,0,134,"2015"
"33007","432170 TRES COROAS",1,1,3,322,1,328,"2015"
"33008","432180 TRES DE MAIO",1,1,0,265,1,268,"2015"
"33009","432183 TRES FORQUILHAS",0,0,1,34,0,35,"2015"
"33010","432185 TRES PALMEIRAS",0,0,2,57,0,59,"2015"
"33011","432190 TRES PASSOS",1,0,1,308,2,312,"2015"
"33012","432195 TRINDADE DO SUL",0,0,4,79,1,84,"2015"
"33013","432200 TRIUNFO",0,1,8,350,2,361,"2015"
"33014","432210 TUCUNDUVA",0,0,1,50,0,51,"2015"
"33015","432215 TUNAS",0,0,0,51,0,51,"2015"
"33016","432218 TUPANCI DO SUL",0,0,0,7,0,7,"2015"
"33017","432220 TUPANCIRETA",0,1,9,289,0,299,"2015"
"33018","432225 TUPANDI",0,0,0,51,0,51,"2015"
"33019","432230 TUPARENDI",0,0,0,66,0,66,"2015"
"33020","432232 TURUCU",0,0,1,47,0,48,"2015"
"33021","432234 UBIRETAMA",0,0,0,20,0,20,"2015"
"33022","432235 UNIAO DA SERRA",0,0,0,4,0,4,"2015"
"33023","432237 UNISTALDA",0,0,0,25,0,25,"2015"
"33024","432240 URUGUAIANA",5,8,15,1340,586,1954,"2015"
"33025","432250 VACARIA",0,4,16,1003,52,1075,"2015"
"33026","432252 VALE VERDE",0,0,0,35,0,35,"2015"
"33027","432253 VALE DO SOL",0,0,2,104,0,106,"2015"
"33028","432254 VALE REAL",0,0,0,68,0,68,"2015"
"33029","432255 VANINI",0,0,0,18,0,18,"2015"
"33030","432260 VENANCIO AIRES",1,1,13,800,0,815,"2015"
"33031","432270 VERA CRUZ",0,0,2,282,0,284,"2015"
"33032","432280 VERANOPOLIS",2,0,6,250,0,258,"2015"
"33033","432285 VESPASIANO CORREA",0,0,0,11,0,11,"2015"
"33034","432290 VIADUTOS",0,0,0,36,0,36,"2015"
"33035","432300 VIAMAO",7,15,83,3367,17,3489,"2015"
"33036","432310 VICENTE DUTRA",0,2,1,61,0,64,"2015"
"33037","432320 VICTOR GRAEFF",1,0,1,24,0,26,"2015"
"33038","432330 VILA FLORES",1,0,0,35,0,36,"2015"
"33039","432335 VILA LANGARO",0,0,0,22,0,22,"2015"
"33040","432340 VILA MARIA",0,0,1,40,0,41,"2015"
"33041","432345 VILA NOVA DO SUL",0,0,0,27,0,27,"2015"
"33042","432350 VISTA ALEGRE",0,0,1,25,0,26,"2015"
"33043","432360 VISTA ALEGRE DO PRATA",0,0,1,9,0,10,"2015"
"33044","432370 VISTA GAUCHA",0,1,0,30,0,31,"2015"
"33045","432375 VITORIA DAS MISSOES",0,0,0,39,0,39,"2015"
"33046","432377 WESTFALIA",0,0,0,33,0,33,"2015"
"33047","432380 XANGRI-LA",1,1,4,209,0,215,"2015"
"33048","500020 AGUA CLARA",0,0,2,251,0,253,"2015"
"33049","500025 ALCINOPOLIS",0,1,1,35,1,38,"2015"
"33050","500060 AMAMBAI",0,2,3,639,2,646,"2015"
"33051","500070 ANASTACIO",0,2,6,356,6,370,"2015"
"33052","500080 ANAURILANDIA",0,0,1,117,0,118,"2015"
"33053","500085 ANGELICA",0,0,5,165,0,170,"2015"
"33054","500090 ANTONIO JOAO",0,1,3,141,1,146,"2015"
"33055","500100 APARECIDA DO TABOADO",0,2,12,354,0,368,"2015"
"33056","500110 AQUIDAUANA",2,3,15,742,19,781,"2015"
"33057","500124 ARAL MOREIRA",0,14,1,131,2,148,"2015"
"33058","500150 BANDEIRANTES",0,1,0,73,0,74,"2015"
"33059","500190 BATAGUASSU",1,2,4,341,0,348,"2015"
"33060","500200 BATAYPORA",0,1,1,165,0,167,"2015"
"33061","500210 BELA VISTA",0,1,0,431,1,433,"2015"
"33062","500215 BODOQUENA",0,0,4,104,0,108,"2015"
"33063","500220 BONITO",1,1,1,367,2,372,"2015"
"33064","500230 BRASILANDIA",0,0,9,177,0,186,"2015"
"33065","500240 CAARAPO",0,4,9,525,7,545,"2015"
"33066","500260 CAMAPUA",0,1,2,208,2,213,"2015"
"33067","500270 CAMPO GRANDE",29,40,102,14215,84,14470,"2015"
"33068","500280 CARACOL",0,0,4,77,1,82,"2015"
"33069","500290 CASSILANDIA",1,1,5,285,0,292,"2015"
"33070","500295 CHAPADAO DO SUL",1,2,6,422,0,431,"2015"
"33071","500310 CORGUINHO",0,0,0,35,1,36,"2015"
"33072","500315 CORONEL SAPUCAIA",0,4,3,243,8,258,"2015"
"33073","500320 CORUMBA",8,9,12,1943,7,1979,"2015"
"33074","500325 COSTA RICA",5,0,4,446,0,455,"2015"
"33075","500330 COXIM",2,4,3,533,0,542,"2015"
"33076","500345 DEODAPOLIS",0,0,3,197,0,200,"2015"
"33077","500348 DOIS IRMAOS DO BURITI",0,0,0,155,1,156,"2015"
"33078","500350 DOURADINA",0,0,0,77,2,79,"2015"
"33079","500370 DOURADOS",8,12,69,3837,29,3955,"2015"
"33080","500375 ELDORADO",3,0,43,129,3,178,"2015"
"33081","500380 FATIMA DO SUL",0,1,3,277,0,281,"2015"
"33082","500390 FIGUEIRAO",0,1,1,54,0,56,"2015"
"33083","500400 GLORIA DE DOURADOS",0,1,1,149,0,151,"2015"
"33084","500410 GUIA LOPES DA LAGUNA",0,0,0,134,0,134,"2015"
"33085","500430 IGUATEMI",0,0,1,235,0,236,"2015"
"33086","500440 INOCENCIA",1,1,3,135,0,140,"2015"
"33087","500450 ITAPORA",1,1,5,220,0,227,"2015"
"33088","500460 ITAQUIRAI",0,0,1,278,0,279,"2015"
"33089","500470 IVINHEMA",1,1,1,414,0,417,"2015"
"33090","500480 JAPORA",1,1,18,184,1,205,"2015"
"33091","500490 JARAGUARI",0,0,0,63,0,63,"2015"
"33092","500500 JARDIM",1,0,5,411,3,420,"2015"
"33093","500510 JATEI",0,1,0,48,0,49,"2015"
"33094","500515 JUTI",0,1,2,91,0,94,"2015"
"33095","500520 LADARIO",1,1,2,358,4,366,"2015"
"33096","500525 LAGUNA CARAPA",0,1,4,127,1,133,"2015"
"33097","500540 MARACAJU",1,5,12,701,0,719,"2015"
"33098","500560 MIRANDA",1,0,4,470,9,484,"2015"
"33099","500568 MUNDO NOVO",1,3,87,197,2,290,"2015"
"33100","500570 NAVIRAI",0,2,8,952,0,962,"2015"
"33101","500580 NIOAQUE",1,0,0,183,7,191,"2015"
"33102","500600 NOVA ALVORADA DO SUL",0,2,3,300,3,308,"2015"
"33103","500620 NOVA ANDRADINA",1,3,2,841,0,847,"2015"
"33104","500625 NOVO HORIZONTE DO SUL",0,0,0,86,0,86,"2015"
"33105","500627 PARAISO DAS AGUAS",0,0,1,38,0,39,"2015"
"33106","500630 PARANAIBA",2,5,3,545,0,555,"2015"
"33107","500635 PARANHOS",0,2,8,247,37,294,"2015"
"33108","500640 PEDRO GOMES",1,1,0,79,0,81,"2015"
"33109","500660 PONTA PORA",3,10,15,1490,34,1552,"2015"
"33110","500690 PORTO MURTINHO",1,0,1,201,5,208,"2015"
"33111","500710 RIBAS DO RIO PARDO",2,3,7,355,2,369,"2015"
"33112","500720 RIO BRILHANTE",1,3,3,675,2,684,"2015"
"33113","500730 RIO NEGRO",0,0,0,42,1,43,"2015"
"33114","500740 RIO VERDE DE MATO GROSSO",1,3,5,332,0,341,"2015"
"33115","500750 ROCHEDO",0,0,0,41,1,42,"2015"
"33116","500755 SANTA RITA DO PARDO",0,0,0,60,0,60,"2015"
"33117","500769 SAO GABRIEL DO OESTE",1,3,7,527,0,538,"2015"
"33118","500770 SETE QUEDAS",0,0,1,130,3,134,"2015"
"33119","500780 SELVIRIA",0,0,1,79,0,80,"2015"
"33120","500790 SIDROLANDIA",3,1,3,673,3,683,"2015"
"33121","500793 SONORA",3,1,2,233,0,239,"2015"
"33122","500795 TACURU",1,0,6,223,1,231,"2015"
"33123","500797 TAQUARUSSU",0,0,1,38,0,39,"2015"
"33124","500800 TERENOS",0,1,2,166,1,170,"2015"
"33125","500830 TRES LAGOAS",5,3,11,1934,0,1953,"2015"
"33126","500840 VICENTINA",0,0,0,72,0,72,"2015"
"33127","MUNICIPIO IGNORADO - MT",0,0,0,2,0,2,"2015"
"33128","510010 ACORIZAL",0,0,2,62,0,64,"2015"
"33129","510020 AGUA BOA",2,2,9,409,6,428,"2015"
"33130","510025 ALTA FLORESTA",1,5,12,876,0,894,"2015"
"33131","510030 ALTO ARAGUAIA",2,0,3,248,0,253,"2015"
"33132","510035 ALTO BOA VISTA",0,0,0,42,0,42,"2015"
"33133","510040 ALTO GARCAS",0,0,1,144,0,145,"2015"
"33134","510050 ALTO PARAGUAI",0,0,0,102,0,102,"2015"
"33135","510060 ALTO TAQUARI",1,0,1,189,0,191,"2015"
"33136","510080 APIACAS",0,0,2,127,0,129,"2015"
"33137","510100 ARAGUAIANA",0,1,0,36,0,37,"2015"
"33138","510120 ARAGUAINHA",0,1,0,9,0,10,"2015"
"33139","510125 ARAPUTANGA",0,1,0,244,0,245,"2015"
"33140","510130 ARENAPOLIS",1,2,3,133,1,140,"2015"
"33141","510140 ARIPUANA",1,1,2,341,0,345,"2015"
"33142","510160 BARAO DE MELGACO",0,0,0,52,0,52,"2015"
"33143","510170 BARRA DO BUGRES",2,1,11,503,1,518,"2015"
"33144","510180 BARRA DO GARCAS",2,2,16,1020,18,1058,"2015"
"33145","510185 BOM JESUS DO ARAGUAIA",0,0,1,109,33,143,"2015"
"33146","510190 BRASNORTE",0,3,9,279,12,303,"2015"
"33147","510250 CACERES",12,5,7,1539,0,1563,"2015"
"33148","510260 CAMPINAPOLIS",1,0,9,227,179,416,"2015"
"33149","510263 CAMPO NOVO DO PARECIS",0,7,13,669,1,690,"2015"
"33150","510267 CAMPO VERDE",3,0,2,744,1,750,"2015"
"33151","510268 CAMPOS DE JULIO",3,2,2,138,0,145,"2015"
"33152","510269 CANABRAVA DO NORTE",1,0,0,54,0,55,"2015"
"33153","510270 CANARANA",1,0,10,354,26,391,"2015"
"33154","510279 CARLINDA",0,0,0,122,0,122,"2015"
"33155","510285 CASTANHEIRA",0,0,1,92,0,93,"2015"
"33156","510300 CHAPADA DOS GUIMARAES",1,3,2,255,0,261,"2015"
"33157","510305 CLAUDIA",0,1,2,139,0,142,"2015"
"33158","510310 COCALINHO",0,0,0,78,0,78,"2015"
"33159","510320 COLIDER",0,2,3,537,1,543,"2015"
"33160","510325 COLNIZA",1,2,5,394,2,404,"2015"
"33161","510330 COMODORO",0,1,3,328,6,338,"2015"
"33162","510335 CONFRESA",1,0,0,481,5,487,"2015"
"33163","510336 CONQUISTA D'OESTE",0,1,0,55,0,56,"2015"
"33164","510337 COTRIGUACU",0,0,0,167,0,167,"2015"
"33165","510340 CUIABA",37,40,119,10489,4,10689,"2015"
"33166","510343 CURVELANDIA",0,0,0,68,0,68,"2015"
"33167","510345 DENISE",0,0,1,105,0,106,"2015"
"33168","510350 DIAMANTINO",3,1,3,336,0,343,"2015"
"33169","510360 DOM AQUINO",0,1,0,85,0,86,"2015"
"33170","510370 FELIZ NATAL",0,1,6,153,4,164,"2015"
"33171","510380 FIGUEIROPOLIS D'OESTE",0,0,0,46,0,46,"2015"
"33172","510385 GAUCHA DO NORTE",0,4,0,132,26,162,"2015"
"33173","510390 GENERAL CARNEIRO",1,0,1,104,8,114,"2015"
"33174","510395 GLORIA D'OESTE",0,0,0,24,0,24,"2015"
"33175","510410 GUARANTA DO NORTE",1,0,13,518,0,532,"2015"
"33176","510420 GUIRATINGA",1,0,0,85,0,86,"2015"
"33177","510450 INDIAVAI",0,0,0,35,0,35,"2015"
"33178","510452 IPIRANGA DO NORTE",0,0,1,93,0,94,"2015"
"33179","510454 ITANHANGA",0,0,0,75,0,75,"2015"
"33180","510455 ITAUBA",0,0,1,86,0,87,"2015"
"33181","510460 ITIQUIRA",0,0,2,209,0,211,"2015"
"33182","510480 JACIARA",1,1,6,478,0,486,"2015"
"33183","510490 JANGADA",0,0,1,122,0,123,"2015"
"33184","510500 JAURU",1,0,2,149,1,153,"2015"
"33185","510510 JUARA",0,0,3,549,4,556,"2015"
"33186","510515 JUINA",2,1,6,697,0,706,"2015"
"33187","510517 JURUENA",0,0,1,140,0,141,"2015"
"33188","510520 JUSCIMEIRA",0,0,1,142,0,143,"2015"
"33189","510523 LAMBARI D'OESTE",0,0,0,57,1,58,"2015"
"33190","510525 LUCAS DO RIO VERDE",2,4,22,1288,0,1316,"2015"
"33191","510530 LUCIARA",0,0,0,28,0,28,"2015"
"33192","510550 VILA BELA DA SANTISSIMA TRINDADE",2,0,5,246,6,259,"2015"
"33193","510558 MARCELANDIA",0,3,13,182,7,205,"2015"
"33194","510560 MATUPA",0,0,2,247,0,249,"2015"
"33195","510562 MIRASSOL D'OESTE",1,2,5,444,0,452,"2015"
"33196","510590 NOBRES",1,3,9,234,2,249,"2015"
"33197","510600 NORTELANDIA",0,2,0,109,0,111,"2015"
"33198","510610 NOSSA SENHORA DO LIVRAMENTO",0,0,2,138,0,140,"2015"
"33199","510615 NOVA BANDEIRANTES",1,0,3,153,0,157,"2015"
"33200","510617 NOVA NAZARE",0,0,0,44,1,45,"2015"
"33201","510618 NOVA LACERDA",0,1,0,76,0,77,"2015"
"33202","510619 NOVA SANTA HELENA",2,0,2,54,0,58,"2015"
"33203","510620 NOVA BRASILANDIA",0,0,3,39,0,42,"2015"
"33204","510621 NOVA CANAA DO NORTE",0,0,2,189,0,191,"2015"
"33205","510622 NOVA MUTUM",1,0,9,883,2,895,"2015"
"33206","510623 NOVA OLIMPIA",0,0,2,317,0,319,"2015"
"33207","510624 NOVA UBIRATA",0,0,1,136,1,138,"2015"
"33208","510625 NOVA XAVANTINA",0,0,0,273,0,273,"2015"
"33209","510626 NOVO MUNDO",1,0,2,63,0,66,"2015"
"33210","510627 NOVO HORIZONTE DO NORTE",0,0,1,35,0,36,"2015"
"33211","510628 NOVO SAO JOAQUIM",0,1,0,98,1,100,"2015"
"33212","510629 PARANAITA",0,0,2,194,0,196,"2015"
"33213","510630 PARANATINGA",1,3,10,342,10,366,"2015"
"33214","510631 NOVO SANTO ANTONIO",0,0,0,24,0,24,"2015"
"33215","510637 PEDRA PRETA",1,3,2,238,0,244,"2015"
"33216","510642 PEIXOTO DE AZEVEDO",1,3,5,511,0,520,"2015"
"33217","510645 PLANALTO DA SERRA",1,0,0,43,0,44,"2015"
"33218","510650 POCONE",2,1,9,486,1,499,"2015"
"33219","510665 PONTAL DO ARAGUAIA",0,0,0,90,0,90,"2015"
"33220","510670 PONTE BRANCA",0,0,1,7,0,8,"2015"
"33221","510675 PONTES E LACERDA",1,4,10,808,3,826,"2015"
"33222","510677 PORTO ALEGRE DO NORTE",0,0,2,159,2,163,"2015"
"33223","510680 PORTO DOS GAUCHOS",0,0,1,88,0,89,"2015"
"33224","510682 PORTO ESPERIDIAO",0,0,2,167,0,169,"2015"
"33225","510685 PORTO ESTRELA",2,0,0,37,1,40,"2015"
"33226","510700 POXOREO",0,1,3,255,1,260,"2015"
"33227","510704 PRIMAVERA DO LESTE",1,3,14,1280,2,1300,"2015"
"33228","510706 QUERENCIA",1,2,1,351,17,372,"2015"
"33229","510710 SAO JOSE DOS QUATRO MARCOS",0,1,0,281,0,282,"2015"
"33230","510715 RESERVA DO CABACAL",0,0,0,37,0,37,"2015"
"33231","510718 RIBEIRAO CASCALHEIRA",0,0,0,168,24,192,"2015"
"33232","510719 RIBEIRAOZINHO",0,0,2,34,0,36,"2015"
"33233","510720 RIO BRANCO",0,0,0,88,1,89,"2015"
"33234","510724 SANTA CARMEM",1,0,1,61,0,63,"2015"
"33235","510726 SANTO AFONSO",0,0,1,17,0,18,"2015"
"33236","510729 SAO JOSE DO POVO",0,1,0,23,0,24,"2015"
"33237","510730 SAO JOSE DO RIO CLARO",0,3,3,285,0,291,"2015"
"33238","510735 SAO JOSE DO XINGU",0,1,1,99,0,101,"2015"
"33239","510740 SAO PEDRO DA CIPA",1,1,0,79,0,81,"2015"
"33240","510757 RONDOLANDIA",0,0,0,29,0,29,"2015"
"33241","510760 RONDONOPOLIS",25,6,71,3920,0,4022,"2015"
"33242","510770 ROSARIO OESTE",0,1,19,166,0,186,"2015"
"33243","510774 SANTA CRUZ DO XINGU",0,0,0,29,0,29,"2015"
"33244","510775 SALTO DO CEU",0,0,0,57,0,57,"2015"
"33245","510776 SANTA RITA DO TRIVELATO",0,0,3,48,0,51,"2015"
"33246","510777 SANTA TEREZINHA",0,0,0,110,0,110,"2015"
"33247","510779 SANTO ANTONIO DO LESTE",0,0,0,56,2,58,"2015"
"33248","510780 SANTO ANTONIO DO LEVERGER",0,0,2,233,1,236,"2015"
"33249","510785 SAO FELIX DO ARAGUAIA",0,3,1,114,1,119,"2015"
"33250","510787 SAPEZAL",3,4,10,447,0,464,"2015"
"33251","510788 SERRA NOVA DOURADA",0,0,0,22,0,22,"2015"
"33252","510790 SINOP",1,6,25,2674,9,2715,"2015"
"33253","510792 SORRISO",1,3,18,1663,5,1690,"2015"
"33254","510794 TABAPORA",0,0,3,138,0,141,"2015"
"33255","510795 TANGARA DA SERRA",2,8,37,1526,6,1579,"2015"
"33256","510800 TAPURAH",1,1,0,215,0,217,"2015"
"33257","510805 TERRA NOVA DO NORTE",0,0,4,131,0,135,"2015"
"33258","510810 TESOURO",1,0,1,24,0,26,"2015"
"33259","510820 TORIXOREU",0,0,6,37,0,43,"2015"
"33260","510830 UNIAO DO SUL",0,0,0,56,0,56,"2015"
"33261","510835 VALE DE SAO DOMINGOS",1,0,1,34,0,36,"2015"
"33262","510840 VARZEA GRANDE",13,26,69,4900,5,5013,"2015"
"33263","510850 VERA",0,0,2,136,1,139,"2015"
"33264","510860 VILA RICA",1,1,1,276,0,279,"2015"
"33265","510880 NOVA GUARITA",0,0,0,57,0,57,"2015"
"33266","510885 NOVA MARILANDIA",0,0,2,43,0,45,"2015"
"33267","510890 NOVA MARINGA",0,0,1,90,1,92,"2015"
"33268","510895 NOVA MONTE VERDE",1,0,0,106,0,107,"2015"
"33269","MUNICIPIO IGNORADO - GO",0,0,0,5,0,5,"2015"
"33270","520005 ABADIA DE GOIAS",0,2,1,158,1,162,"2015"
"33271","520010 ABADIANIA",0,0,3,178,2,183,"2015"
"33272","520013 ACREUNA",0,0,83,183,0,266,"2015"
"33273","520015 ADELANDIA",0,0,0,20,0,20,"2015"
"33274","520017 AGUA FRIA DE GOIAS",0,0,1,51,0,52,"2015"
"33275","520020 AGUA LIMPA",0,0,0,20,0,20,"2015"
"33276","520025 AGUAS LINDAS DE GOIAS",13,14,56,2671,225,2979,"2015"
"33277","520030 ALEXANIA",2,1,4,405,3,415,"2015"
"33278","520050 ALOANDIA",0,1,1,29,0,31,"2015"
"33279","520055 ALTO HORIZONTE",0,1,6,97,0,104,"2015"
"33280","520060 ALTO PARAISO DE GOIAS",0,1,1,104,2,108,"2015"
"33281","520080 ALVORADA DO NORTE",1,0,4,126,1,132,"2015"
"33282","520082 AMARALINA",0,0,1,21,0,22,"2015"
"33283","520085 AMERICANO DO BRASIL",1,0,0,62,0,63,"2015"
"33284","520090 AMORINOPOLIS",0,0,0,30,0,30,"2015"
"33285","520110 ANAPOLIS",17,13,108,6183,13,6334,"2015"
"33286","520120 ANHANGUERA",0,0,0,7,0,7,"2015"
"33287","520130 ANICUNS",1,2,4,223,2,232,"2015"
"33288","520140 APARECIDA DE GOIANIA",21,36,90,8110,23,8280,"2015"
"33289","520145 APARECIDA DO RIO DOCE",0,0,0,28,0,28,"2015"
"33290","520150 APORE",0,0,0,60,1,61,"2015"
"33291","520160 ARACU",0,0,0,25,0,25,"2015"
"33292","520170 ARAGARCAS",2,3,8,253,0,266,"2015"
"33293","520180 ARAGOIANIA",0,1,2,148,1,152,"2015"
"33294","520215 ARAGUAPAZ",0,1,1,49,0,51,"2015"
"33295","520235 ARENOPOLIS",0,0,0,32,0,32,"2015"
"33296","520250 ARUANA",0,0,3,119,2,124,"2015"
"33297","520260 AURILANDIA",0,0,1,29,0,30,"2015"
"33298","520280 AVELINOPOLIS",1,0,0,28,0,29,"2015"
"33299","520310 BALIZA",0,0,3,25,0,28,"2015"
"33300","520320 BARRO ALTO",0,1,5,130,0,136,"2015"
"33301","520330 BELA VISTA DE GOIAS",2,2,3,412,2,421,"2015"
"33302","520340 BOM JARDIM DE GOIAS",0,0,0,93,1,94,"2015"
"33303","520350 BOM JESUS DE GOIAS",0,2,9,337,3,351,"2015"
"33304","520355 BONFINOPOLIS",0,1,0,118,0,119,"2015"
"33305","520357 BONOPOLIS",0,1,1,29,0,31,"2015"
"33306","520360 BRAZABRANTES",0,0,0,55,0,55,"2015"
"33307","520380 BRITANIA",0,0,5,49,0,54,"2015"
"33308","520390 BURITI ALEGRE",0,1,1,112,0,114,"2015"
"33309","520393 BURITI DE GOIAS",0,0,2,38,0,40,"2015"
"33310","520396 BURITINOPOLIS",1,0,1,37,0,39,"2015"
"33311","520400 CABECEIRAS",0,1,0,97,0,98,"2015"
"33312","520410 CACHOEIRA ALTA",0,2,0,138,0,140,"2015"
"33313","520420 CACHOEIRA DE GOIAS",0,0,0,16,0,16,"2015"
"33314","520425 CACHOEIRA DOURADA",1,0,0,106,0,107,"2015"
"33315","520430 CACU",0,0,7,152,0,159,"2015"
"33316","520440 CAIAPONIA",0,1,16,168,0,185,"2015"
"33317","520450 CALDAS NOVAS",3,2,20,1303,0,1328,"2015"
"33318","520455 CALDAZINHA",0,0,0,43,0,43,"2015"
"33319","520460 CAMPESTRE DE GOIAS",0,0,0,44,0,44,"2015"
"33320","520465 CAMPINACU",0,0,0,29,0,29,"2015"
"33321","520470 CAMPINORTE",0,0,3,182,0,185,"2015"
"33322","520480 CAMPO ALEGRE DE GOIAS",0,1,0,65,0,66,"2015"
"33323","520485 CAMPO LIMPO DE GOIAS",0,0,0,118,0,118,"2015"
"33324","520490 CAMPOS BELOS",1,1,10,343,0,355,"2015"
"33325","520495 CAMPOS VERDES",1,1,2,48,0,52,"2015"
"33326","520500 CARMO DO RIO VERDE",0,1,3,114,0,118,"2015"
"33327","520505 CASTELANDIA",0,0,0,25,0,25,"2015"
"33328","520510 CATALAO",1,1,9,1502,0,1513,"2015"
"33329","520520 CATURAI",0,0,1,26,0,27,"2015"
"33330","520530 CAVALCANTE",0,2,1,139,2,144,"2015"
"33331","520540 CERES",0,0,3,290,1,294,"2015"
"33332","520545 CEZARINA",1,2,4,138,0,145,"2015"
"33333","520547 CHAPADAO DO CEU",1,0,2,194,0,197,"2015"
"33334","520549 CIDADE OCIDENTAL",3,7,17,1057,10,1094,"2015"
"33335","520551 COCALZINHO DE GOIAS",0,1,5,221,19,246,"2015"
"33336","520552 COLINAS DO SUL",0,0,1,44,0,45,"2015"
"33337","520570 CORREGO DO OURO",0,0,0,24,0,24,"2015"
"33338","520580 CORUMBA DE GOIAS",0,1,5,93,0,99,"2015"
"33339","520590 CORUMBAIBA",0,0,1,76,0,77,"2015"
"33340","520620 CRISTALINA",0,5,8,909,8,930,"2015"
"33341","520630 CRISTIANOPOLIS",0,0,1,26,0,27,"2015"
"33342","520640 CRIXAS",2,2,3,217,1,225,"2015"
"33343","520650 CROMINIA",0,0,1,35,0,36,"2015"
"33344","520660 CUMARI",0,0,0,26,0,26,"2015"
"33345","520670 DAMIANOPOLIS",0,0,0,44,0,44,"2015"
"33346","520680 DAMOLANDIA",0,1,0,20,0,21,"2015"
"33347","520690 DAVINOPOLIS",0,0,1,23,0,24,"2015"
"33348","520710 DIORAMA",0,0,0,22,0,22,"2015"
"33349","520725 DOVERLANDIA",1,0,6,85,0,92,"2015"
"33350","520735 EDEALINA",0,0,0,55,0,55,"2015"
"33351","520740 EDEIA",1,0,4,129,0,134,"2015"
"33352","520750 ESTRELA DO NORTE",0,1,0,57,0,58,"2015"
"33353","520753 FAINA",0,0,1,52,0,53,"2015"
"33354","520760 FAZENDA NOVA",0,0,0,51,0,51,"2015"
"33355","520780 FIRMINOPOLIS",0,0,0,98,0,98,"2015"
"33356","520790 FLORES DE GOIAS",0,0,2,105,0,107,"2015"
"33357","520800 FORMOSA",5,6,19,1775,2,1807,"2015"
"33358","520810 FORMOSO",0,0,0,54,0,54,"2015"
"33359","520815 GAMELEIRA DE GOIAS",0,0,2,24,0,26,"2015"
"33360","520830 DIVINOPOLIS DE GOIAS",0,0,3,84,0,87,"2015"
"33361","520840 GOIANAPOLIS",0,0,1,185,1,187,"2015"
"33362","520850 GOIANDIRA",0,0,1,48,0,49,"2015"
"33363","520860 GOIANESIA",1,6,21,941,2,971,"2015"
"33364","520870 GOIANIA",53,65,251,22412,85,22866,"2015"
"33365","520880 GOIANIRA",3,4,6,787,7,807,"2015"
"33366","520890 GOIAS",0,1,3,284,0,288,"2015"
"33367","520910 GOIATUBA",0,1,1,461,0,463,"2015"
"33368","520915 GOUVELANDIA",0,0,0,51,0,51,"2015"
"33369","520920 GUAPO",3,3,1,171,0,178,"2015"
"33370","520929 GUARAITA",0,0,0,22,0,22,"2015"
"33371","520940 GUARANI DE GOIAS",0,0,2,44,0,46,"2015"
"33372","520945 GUARINOS",0,0,1,16,0,17,"2015"
"33373","520960 HEITORAI",0,0,0,17,0,17,"2015"
"33374","520970 HIDROLANDIA",0,2,4,321,2,329,"2015"
"33375","520980 HIDROLINA",0,0,1,51,0,52,"2015"
"33376","520990 IACIARA",0,0,2,185,0,187,"2015"
"33377","520993 INACIOLANDIA",0,0,1,48,0,49,"2015"
"33378","520995 INDIARA",2,0,4,256,0,262,"2015"
"33379","521000 INHUMAS",0,1,16,758,1,776,"2015"
"33380","521010 IPAMERI",2,3,5,321,0,331,"2015"
"33381","521015 IPIRANGA DE GOIAS",0,0,1,41,0,42,"2015"
"33382","521020 IPORA",1,3,4,400,2,410,"2015"
"33383","521030 ISRAELANDIA",0,0,0,34,0,34,"2015"
"33384","521040 ITABERAI",7,1,8,558,1,575,"2015"
"33385","521056 ITAGUARI",0,0,2,66,0,68,"2015"
"33386","521060 ITAGUARU",0,0,1,39,0,40,"2015"
"33387","521080 ITAJA",0,2,1,55,0,58,"2015"
"33388","521090 ITAPACI",0,4,6,294,0,304,"2015"
"33389","521100 ITAPIRAPUA",0,0,5,91,0,96,"2015"
"33390","521120 ITAPURANGA",0,0,1,313,0,314,"2015"
"33391","521130 ITARUMA",0,0,1,91,0,92,"2015"
"33392","521140 ITAUCU",0,1,0,76,0,77,"2015"
"33393","521150 ITUMBIARA",3,3,27,1402,2,1437,"2015"
"33394","521160 IVOLANDIA",0,0,1,22,0,23,"2015"
"33395","521170 JANDAIA",0,0,2,91,1,94,"2015"
"33396","521180 JARAGUA",1,5,16,609,1,632,"2015"
"33397","521190 JATAI",3,8,28,1374,0,1413,"2015"
"33398","521200 JAUPACI",0,0,0,32,0,32,"2015"
"33399","521205 JESUPOLIS",0,1,0,26,0,27,"2015"
"33400","521210 JOVIANIA",0,0,1,91,0,92,"2015"
"33401","521220 JUSSARA",0,0,7,238,0,245,"2015"
"33402","521225 LAGOA SANTA",0,0,0,21,0,21,"2015"
"33403","521230 LEOPOLDO DE BULHOES",1,1,1,57,0,60,"2015"
"33404","521250 LUZIANIA",8,6,62,3127,33,3236,"2015"
"33405","521260 MAIRIPOTABA",0,0,1,31,0,32,"2015"
"33406","521270 MAMBAI",1,0,3,108,0,112,"2015"
"33407","521280 MARA ROSA",0,0,2,113,1,116,"2015"
"33408","521290 MARZAGAO",0,0,1,29,0,30,"2015"
"33409","521295 MATRINCHA",0,0,0,42,0,42,"2015"
"33410","521300 MAURILANDIA",0,0,3,178,0,181,"2015"
"33411","521305 MIMOSO DE GOIAS",0,0,0,13,5,18,"2015"
"33412","521308 MINACU",0,0,6,464,0,470,"2015"
"33413","521310 MINEIROS",1,6,7,1141,0,1155,"2015"
"33414","521340 MOIPORA",0,0,0,19,0,19,"2015"
"33415","521350 MONTE ALEGRE DE GOIAS",1,3,0,133,0,137,"2015"
"33416","521370 MONTES CLAROS DE GOIAS",0,1,3,104,0,108,"2015"
"33417","521375 MONTIVIDIU",0,2,3,150,1,156,"2015"
"33418","521377 MONTIVIDIU DO NORTE",1,1,3,40,0,45,"2015"
"33419","521380 MORRINHOS",1,4,10,633,2,650,"2015"
"33420","521385 MORRO AGUDO DE GOIAS",0,0,0,28,0,28,"2015"
"33421","521390 MOSSAMEDES",0,1,3,63,0,67,"2015"
"33422","521400 MOZARLANDIA",0,3,2,232,0,237,"2015"
"33423","521405 MUNDO NOVO",0,0,3,93,3,99,"2015"
"33424","521410 MUTUNOPOLIS",0,1,2,61,0,64,"2015"
"33425","521440 NAZARIO",0,0,1,92,0,93,"2015"
"33426","521450 NEROPOLIS",2,2,9,404,1,418,"2015"
"33427","521460 NIQUELANDIA",1,2,5,492,1,501,"2015"
"33428","521470 NOVA AMERICA",0,0,1,32,0,33,"2015"
"33429","521480 NOVA AURORA",0,0,1,23,0,24,"2015"
"33430","521483 NOVA CRIXAS",2,0,2,201,0,205,"2015"
"33431","521486 NOVA GLORIA",0,0,0,110,0,110,"2015"
"33432","521487 NOVA IGUACU DE GOIAS",0,0,3,36,0,39,"2015"
"33433","521490 NOVA ROMA",0,0,0,17,0,17,"2015"
"33434","521500 NOVA VENEZA",0,0,1,108,0,109,"2015"
"33435","521520 NOVO BRASIL",0,0,1,29,0,30,"2015"
"33436","521523 NOVO GAMA",2,4,33,1582,10,1631,"2015"
"33437","521525 NOVO PLANALTO",0,0,1,55,0,56,"2015"
"33438","521530 ORIZONA",1,0,2,189,0,192,"2015"
"33439","521540 OURO VERDE DE GOIAS",0,0,0,52,0,52,"2015"
"33440","521550 OUVIDOR",0,0,1,68,0,69,"2015"
"33441","521560 PADRE BERNARDO",0,4,4,295,225,528,"2015"
"33442","521565 PALESTINA DE GOIAS",0,0,0,57,0,57,"2015"
"33443","521570 PALMEIRAS DE GOIAS",1,3,3,387,1,395,"2015"
"33444","521580 PALMELO",0,0,1,24,0,25,"2015"
"33445","521590 PALMINOPOLIS",1,0,1,34,0,36,"2015"
"33446","521600 PANAMA",0,0,0,36,0,36,"2015"
"33447","521630 PARANAIGUARA",0,1,2,115,0,118,"2015"
"33448","521640 PARAUNA",0,2,3,139,0,144,"2015"
"33449","521645 PEROLANDIA",0,1,2,35,0,38,"2015"
"33450","521680 PETROLINA DE GOIAS",1,1,4,84,0,90,"2015"
"33451","521690 PILAR DE GOIAS",0,0,0,26,0,26,"2015"
"33452","521710 PIRACANJUBA",2,4,7,239,1,253,"2015"
"33453","521720 PIRANHAS",1,1,3,145,0,150,"2015"
"33454","521730 PIRENOPOLIS",1,2,8,281,1,293,"2015"
"33455","521740 PIRES DO RIO",5,1,3,323,0,332,"2015"
"33456","521760 PLANALTINA",3,6,20,1613,12,1654,"2015"
"33457","521770 PONTALINA",1,0,2,190,1,194,"2015"
"33458","521800 PORANGATU",2,3,22,614,1,642,"2015"
"33459","521805 PORTEIRAO",0,1,0,46,1,48,"2015"
"33460","521810 PORTELANDIA",0,0,0,62,0,62,"2015"
"33461","521830 POSSE",1,5,19,615,0,640,"2015"
"33462","521839 PROFESSOR JAMIL",0,0,0,24,0,24,"2015"
"33463","521850 QUIRINOPOLIS",1,4,13,700,0,718,"2015"
"33464","521860 RIALMA",0,0,2,153,0,155,"2015"
"33465","521870 RIANAPOLIS",0,0,0,75,0,75,"2015"
"33466","521878 RIO QUENTE",0,0,1,55,0,56,"2015"
"33467","521880 RIO VERDE",9,6,24,3520,2,3561,"2015"
"33468","521890 RUBIATABA",0,0,3,247,0,250,"2015"
"33469","521900 SANCLERLANDIA",0,0,1,82,0,83,"2015"
"33470","521910 SANTA BARBARA DE GOIAS",1,2,2,114,0,119,"2015"
"33471","521920 SANTA CRUZ DE GOIAS",0,0,1,16,0,17,"2015"
"33472","521925 SANTA FE DE GOIAS",0,0,1,84,0,85,"2015"
"33473","521930 SANTA HELENA DE GOIAS",0,1,6,520,1,528,"2015"
"33474","521935 SANTA ISABEL",0,0,1,34,0,35,"2015"
"33475","521940 SANTA RITA DO ARAGUAIA",1,0,0,91,1,93,"2015"
"33476","521945 SANTA RITA DO NOVO DESTINO",0,0,0,21,0,21,"2015"
"33477","521950 SANTA ROSA DE GOIAS",0,0,0,43,0,43,"2015"
"33478","521960 SANTA TEREZA DE GOIAS",1,0,2,28,0,31,"2015"
"33479","521970 SANTA TEREZINHA DE GOIAS",0,0,4,143,0,147,"2015"
"33480","521971 SANTO ANTONIO DA BARRA",0,0,0,35,0,35,"2015"
"33481","521973 SANTO ANTONIO DE GOIAS",1,1,0,96,0,98,"2015"
"33482","521975 SANTO ANTONIO DO DESCOBERTO",2,5,10,1058,13,1088,"2015"
"33483","521980 SAO DOMINGOS",0,0,4,116,1,121,"2015"
"33484","521990 SAO FRANCISCO DE GOIAS",0,0,0,58,0,58,"2015"
"33485","522000 SAO JOAO D'ALIANCA",0,0,0,167,1,168,"2015"
"33486","522005 SAO JOAO DA PARAUNA",0,0,0,20,0,20,"2015"
"33487","522010 SAO LUIS DE MONTES BELOS",1,2,7,356,1,367,"2015"
"33488","522015 SAO LUIZ DO NORTE",0,0,2,75,0,77,"2015"
"33489","522020 SAO MIGUEL DO ARAGUAIA",0,1,7,347,0,355,"2015"
"33490","522026 SAO MIGUEL DO PASSA QUATRO",0,0,0,41,0,41,"2015"
"33491","522028 SAO PATRICIO",0,0,0,27,0,27,"2015"
"33492","522040 SAO SIMAO",0,0,1,268,0,269,"2015"
"33493","522045 SENADOR CANEDO",4,8,26,2276,4,2318,"2015"
"33494","522050 SERRANOPOLIS",0,0,4,85,0,89,"2015"
"33495","522060 SILVANIA",1,1,0,244,1,247,"2015"
"33496","522068 SIMOLANDIA",0,1,0,71,0,72,"2015"
"33497","522070 SITIO D'ABADIA",0,0,0,24,0,24,"2015"
"33498","522100 TAQUARAL DE GOIAS",0,0,0,57,1,58,"2015"
"33499","522108 TERESINA DE GOIAS",0,1,0,31,1,33,"2015"
"33500","522119 TEREZOPOLIS DE GOIAS",0,0,1,98,0,99,"2015"
"33501","522130 TRES RANCHOS",0,0,0,29,0,29,"2015"
"33502","522140 TRINDADE",2,8,28,1784,5,1827,"2015"
"33503","522145 TROMBAS",0,1,0,34,0,35,"2015"
"33504","522150 TURVANIA",0,0,1,55,0,56,"2015"
"33505","522155 TURVELANDIA",0,0,1,58,0,59,"2015"
"33506","522157 UIRAPURU",0,0,1,30,0,31,"2015"
"33507","522160 URUACU",4,5,68,471,2,550,"2015"
"33508","522170 URUANA",0,0,2,154,0,156,"2015"
"33509","522180 URUTAI",0,0,0,21,0,21,"2015"
"33510","522185 VALPARAISO DE GOIAS",6,18,67,2469,20,2580,"2015"
"33511","522190 VARJAO",0,0,2,41,0,43,"2015"
"33512","522200 VIANOPOLIS",0,1,0,185,1,187,"2015"
"33513","522205 VICENTINOPOLIS",0,1,2,102,0,105,"2015"
"33514","522220 VILA BOA",1,0,1,67,0,69,"2015"
"33515","522230 VILA PROPICIO",0,0,7,60,1,68,"2015"
"33516","530010 BRASILIA",189,163,710,44361,699,46122,"2015"
"33517","TOTAL",7900,11482,43883,2724176,70359,2857800,"2016"
"33518","MUNICIPIO IGNORADO - RO",0,0,0,2,0,2,"2016"
"33519","110001 ALTA FLORESTA D'OESTE",0,2,2,322,0,326,"2016"
"33520","110002 ARIQUEMES",25,4,16,1614,3,1662,"2016"
"33521","110003 CABIXI",0,0,1,71,1,73,"2016"
"33522","110004 CACOAL",2,3,19,1312,2,1338,"2016"
"33523","110005 CEREJEIRAS",0,0,3,260,0,263,"2016"
"33524","110006 COLORADO DO OESTE",0,1,3,218,1,223,"2016"
"33525","110007 CORUMBIARA",0,0,1,138,0,139,"2016"
"33526","110008 COSTA MARQUES",2,4,10,196,1,213,"2016"
"33527","110009 ESPIGAO D'OESTE",1,1,7,476,1,486,"2016"
"33528","110010 GUAJARA-MIRIM",1,2,5,628,248,884,"2016"
"33529","110011 JARU",1,3,4,795,4,807,"2016"
"33530","110012 JI-PARANA",2,8,36,1926,4,1976,"2016"
"33531","110013 MACHADINHO D'OESTE",4,2,5,386,1,398,"2016"
"33532","110014 NOVA BRASILANDIA D'OESTE",0,0,3,272,1,276,"2016"
"33533","110015 OURO PRETO DO OESTE",1,2,13,565,1,582,"2016"
"33534","110018 PIMENTA BUENO",1,1,15,584,0,601,"2016"
"33535","110020 PORTO VELHO",23,19,103,8388,78,8611,"2016"
"33536","110025 PRESIDENTE MEDICI",1,2,3,269,1,276,"2016"
"33537","110026 RIO CRESPO",0,0,0,35,0,35,"2016"
"33538","110028 ROLIM DE MOURA",3,1,5,846,0,855,"2016"
"33539","110029 SANTA LUZIA D'OESTE",1,0,1,112,0,114,"2016"
"33540","110030 VILHENA",3,3,10,1406,5,1427,"2016"
"33541","110032 SAO MIGUEL DO GUAPORE",1,2,6,328,0,337,"2016"
"33542","110033 NOVA MAMORE",1,1,5,331,73,411,"2016"
"33543","110034 ALVORADA D'OESTE",0,0,1,164,1,166,"2016"
"33544","110037 ALTO ALEGRE DOS PARECIS",0,1,0,167,0,168,"2016"
"33545","110040 ALTO PARAISO",0,0,3,215,2,220,"2016"
"33546","110045 BURITIS",3,2,5,613,1,624,"2016"
"33547","110050 NOVO HORIZONTE DO OESTE",0,1,1,93,0,95,"2016"
"33548","110060 CACAULANDIA",0,0,1,66,0,67,"2016"
"33549","110070 CAMPO NOVO DE RONDONIA",0,0,2,159,1,162,"2016"
"33550","110080 CANDEIAS DO JAMARI",1,0,4,358,9,372,"2016"
"33551","110090 CASTANHEIRAS",0,0,0,55,0,55,"2016"
"33552","110092 CHUPINGUAIA",1,0,1,150,1,153,"2016"
"33553","110094 CUJUBIM",1,2,1,237,0,241,"2016"
"33554","110100 GOVERNADOR JORGE TEIXEIRA",0,0,1,111,0,112,"2016"
"33555","110110 ITAPUA DO OESTE",0,0,0,127,2,129,"2016"
"33556","110120 MINISTRO ANDREAZZA",0,0,0,93,0,93,"2016"
"33557","110130 MIRANTE DA SERRA",0,0,3,143,2,148,"2016"
"33558","110140 MONTE NEGRO",3,2,1,167,0,173,"2016"
"33559","110143 NOVA UNIAO",0,0,0,88,2,90,"2016"
"33560","110145 PARECIS",0,0,0,50,0,50,"2016"
"33561","110146 PIMENTEIRAS DO OESTE",0,0,0,33,1,34,"2016"
"33562","110147 PRIMAVERA DE RONDONIA",0,0,0,56,0,56,"2016"
"33563","110148 SAO FELIPE D'OESTE",0,0,0,54,0,54,"2016"
"33564","110149 SAO FRANCISCO DO GUAPORE",1,2,19,283,0,305,"2016"
"33565","110150 SERINGUEIRAS",0,3,3,164,1,171,"2016"
"33566","110155 TEIXEIROPOLIS",0,0,1,58,0,59,"2016"
"33567","110160 THEOBROMA",0,0,0,131,0,131,"2016"
"33568","110170 URUPA",0,1,0,148,2,151,"2016"
"33569","110175 VALE DO ANARI",0,0,1,108,1,110,"2016"
"33570","110180 VALE DO PARAISO",0,0,1,97,0,98,"2016"
"33571","120001 ACRELANDIA",0,1,3,213,5,222,"2016"
"33572","120005 ASSIS BRASIL",1,2,2,171,14,190,"2016"
"33573","120010 BRASILEIA",0,6,12,461,11,490,"2016"
"33574","120013 BUJARI",0,1,1,243,3,248,"2016"
"33575","120017 CAPIXABA",1,2,4,184,3,194,"2016"
"33576","120020 CRUZEIRO DO SUL",5,7,16,1572,32,1632,"2016"
"33577","120025 EPITACIOLANDIA",0,2,8,259,1,270,"2016"
"33578","120030 FEIJO",1,4,7,667,155,834,"2016"
"33579","120032 JORDAO",0,0,2,127,134,263,"2016"
"33580","120033 MANCIO LIMA",0,1,4,312,8,325,"2016"
"33581","120034 MANOEL URBANO",2,1,3,218,12,236,"2016"
"33582","120035 MARECHAL THAUMATURGO",1,0,5,237,109,352,"2016"
"33583","120038 PLACIDO DE CASTRO",0,1,4,329,5,339,"2016"
"33584","120039 PORTO WALTER",0,0,4,223,3,230,"2016"
"33585","120040 RIO BRANCO",7,19,87,6348,153,6614,"2016"
"33586","120042 RODRIGUES ALVES",2,0,4,280,18,304,"2016"
"33587","120043 SANTA ROSA DO PURUS",1,1,0,73,20,95,"2016"
"33588","120045 SENADOR GUIOMARD",0,2,5,396,7,410,"2016"
"33589","120050 SENA MADUREIRA",3,4,9,721,25,762,"2016"
"33590","120060 TARAUACA",5,8,18,962,85,1078,"2016"
"33591","120070 XAPURI",0,1,5,319,4,329,"2016"
"33592","120080 PORTO ACRE",0,1,3,345,7,356,"2016"
"33593","MUNICIPIO IGNORADO - AM",0,0,2,22,1,25,"2016"
"33594","130002 ALVARAES",0,0,7,317,1,325,"2016"
"33595","130006 AMATURA",0,1,1,177,101,280,"2016"
"33596","130008 ANAMA",0,1,1,175,5,182,"2016"
"33597","130010 ANORI",0,2,7,249,8,266,"2016"
"33598","130014 APUI",1,0,12,197,1,211,"2016"
"33599","130020 ATALAIA DO NORTE",0,0,2,221,157,380,"2016"
"33600","130030 AUTAZES",1,6,10,764,109,890,"2016"
"33601","130040 BARCELOS",1,0,3,289,203,496,"2016"
"33602","130050 BARREIRINHA",0,2,9,644,155,810,"2016"
"33603","130060 BENJAMIN CONSTANT",3,3,28,889,98,1021,"2016"
"33604","130063 BERURI",0,3,9,414,84,510,"2016"
"33605","130068 BOA VISTA DO RAMOS",0,1,2,308,1,312,"2016"
"33606","130070 BOCA DO ACRE",4,2,6,638,3,653,"2016"
"33607","130080 BORBA",1,2,6,610,44,663,"2016"
"33608","130083 CAAPIRANGA",1,1,3,169,9,183,"2016"
"33609","130090 CANUTAMA",0,2,0,215,0,217,"2016"
"33610","130100 CARAUARI",14,0,1,378,232,625,"2016"
"33611","130110 CAREIRO",3,4,8,430,36,481,"2016"
"33612","130115 CAREIRO DA VARZEA",0,0,0,172,27,199,"2016"
"33613","130120 COARI",2,3,9,1630,2,1646,"2016"
"33614","130130 CODAJAS",3,2,3,395,1,404,"2016"
"33615","130140 EIRUNEPE",2,5,17,666,97,787,"2016"
"33616","130150 ENVIRA",0,1,3,318,47,369,"2016"
"33617","130160 FONTE BOA",3,4,8,558,0,573,"2016"
"33618","130165 GUAJARA",0,0,1,267,16,284,"2016"
"33619","130170 HUMAITA",2,3,14,956,2,977,"2016"
"33620","130180 IPIXUNA",3,0,2,292,92,389,"2016"
"33621","130185 IRANDUBA",5,3,4,897,19,928,"2016"
"33622","130190 ITACOATIARA",3,7,11,1945,62,2028,"2016"
"33623","130195 ITAMARATI",0,0,1,204,58,263,"2016"
"33624","130200 ITAPIRANGA",0,0,0,184,3,187,"2016"
"33625","130210 JAPURA",0,0,4,118,28,150,"2016"
"33626","130220 JURUA",2,1,4,138,30,175,"2016"
"33627","130230 JUTAI",0,0,0,497,107,604,"2016"
"33628","130240 LABREA",0,8,46,596,2,652,"2016"
"33629","130250 MANACAPURU",2,5,11,1773,4,1795,"2016"
"33630","130255 MANAQUIRI",1,1,1,250,0,253,"2016"
"33631","130260 MANAUS",101,105,239,38914,244,39603,"2016"
"33632","130270 MANICORE",2,2,21,752,134,911,"2016"
"33633","130280 MARAA",1,1,2,311,43,358,"2016"
"33634","130290 MAUES",5,9,16,901,342,1273,"2016"
"33635","130300 NHAMUNDA",2,2,7,278,49,338,"2016"
"33636","130310 NOVA OLINDA DO NORTE",1,2,16,486,82,587,"2016"
"33637","130320 NOVO AIRAO",0,0,2,276,11,289,"2016"
"33638","130330 NOVO ARIPUANA",0,8,7,338,33,386,"2016"
"33639","130340 PARINTINS",4,5,11,1816,96,1932,"2016"
"33640","130350 PAUINI",0,1,0,346,1,348,"2016"
"33641","130353 PRESIDENTE FIGUEIREDO",1,3,4,538,2,548,"2016"
"33642","130356 RIO PRETO DA EVA",1,3,6,400,5,415,"2016"
"33643","130360 SANTA ISABEL DO RIO NEGRO",0,3,57,87,158,305,"2016"
"33644","130370 SANTO ANTONIO DO ICA",1,0,3,544,145,693,"2016"
"33645","130380 SAO GABRIEL DA CACHOEIRA",3,6,19,669,558,1255,"2016"
"33646","130390 SAO PAULO DE OLIVENCA",0,2,10,437,422,871,"2016"
"33647","130395 SAO SEBASTIAO DO UATUMA",1,2,1,171,3,178,"2016"
"33648","130400 SILVES",0,0,1,205,2,208,"2016"
"33649","130406 TABATINGA",2,6,16,1218,511,1753,"2016"
"33650","130410 TAPAUA",1,0,2,383,3,389,"2016"
"33651","130420 TEFE",9,8,15,1587,60,1679,"2016"
"33652","130423 TONANTINS",0,0,2,340,21,363,"2016"
"33653","130426 UARINI",1,0,17,239,7,264,"2016"
"33654","130430 URUCARA",2,4,12,242,5,265,"2016"
"33655","130440 URUCURITUBA",0,3,3,249,44,299,"2016"
"33656","MUNICIPIO IGNORADO - RR",0,0,0,1,0,1,"2016"
"33657","140002 AMAJARI",8,2,0,165,156,331,"2016"
"33658","140005 ALTO ALEGRE",12,3,4,196,405,620,"2016"
"33659","140010 BOA VISTA",71,8,57,6600,13,6749,"2016"
"33660","140015 BONFIM",4,0,0,298,63,365,"2016"
"33661","140017 CANTA",8,0,1,292,14,315,"2016"
"33662","140020 CARACARAI",4,3,0,314,60,381,"2016"
"33663","140023 CAROEBE",1,0,0,140,4,145,"2016"
"33664","140028 IRACEMA",1,0,0,102,35,138,"2016"
"33665","140030 MUCAJAI",3,0,2,284,19,308,"2016"
"33666","140040 NORMANDIA",9,1,2,316,100,428,"2016"
"33667","140045 PACARAIMA",4,1,2,302,48,357,"2016"
"33668","140047 RORAINOPOLIS",3,3,5,528,3,542,"2016"
"33669","140050 SAO JOAO DA BALIZA",0,0,0,103,1,104,"2016"
"33670","140060 SAO LUIZ",0,0,3,76,4,83,"2016"
"33671","140070 UIRAMUTA",16,0,0,258,235,509,"2016"
"33672","MUNICIPIO IGNORADO - PA",0,0,0,2,0,2,"2016"
"33673","150010 ABAETETUBA",4,7,41,2466,14,2532,"2016"
"33674","150013 ABEL FIGUEIREDO",0,2,0,115,0,117,"2016"
"33675","150020 ACARA",2,7,11,920,56,996,"2016"
"33676","150030 AFUA",5,5,11,879,11,911,"2016"
"33677","150034 AGUA AZUL DO NORTE",0,3,1,157,2,163,"2016"
"33678","150040 ALENQUER",1,5,11,976,38,1031,"2016"
"33679","150050 ALMEIRIM",1,4,19,688,27,739,"2016"
"33680","150060 ALTAMIRA",21,11,30,2720,64,2846,"2016"
"33681","150070 ANAJAS",2,10,33,626,148,819,"2016"
"33682","150080 ANANINDEUA",10,19,82,7866,34,8011,"2016"
"33683","150085 ANAPU",1,2,4,562,6,575,"2016"
"33684","150090 AUGUSTO CORREA",4,6,14,806,124,954,"2016"
"33685","150095 AURORA DO PARA",0,2,17,373,3,395,"2016"
"33686","150100 AVEIRO",1,2,4,162,36,205,"2016"
"33687","150110 BAGRE",1,3,11,314,233,562,"2016"
"33688","150120 BAIAO",2,4,10,498,53,567,"2016"
"33689","150125 BANNACH",0,0,1,36,0,37,"2016"
"33690","150130 BARCARENA",1,4,25,2106,12,2148,"2016"
"33691","150140 BELEM",29,64,217,18844,96,19250,"2016"
"33692","150145 BELTERRA",0,4,8,222,7,241,"2016"
"33693","150150 BENEVIDES",1,2,12,931,4,950,"2016"
"33694","150157 BOM JESUS DO TOCANTINS",1,0,3,239,5,248,"2016"
"33695","150160 BONITO",2,0,0,179,1,182,"2016"
"33696","150170 BRAGANCA",6,15,32,2007,66,2126,"2016"
"33697","150172 BRASIL NOVO",0,2,3,263,4,272,"2016"
"33698","150175 BREJO GRANDE DO ARAGUAIA",0,0,1,76,2,79,"2016"
"33699","150178 BREU BRANCO",3,2,10,601,150,766,"2016"
"33700","150180 BREVES",7,14,96,2420,4,2541,"2016"
"33701","150190 BUJARU",1,1,15,470,17,504,"2016"
"33702","150195 CACHOEIRA DO PIRIA",0,2,2,301,39,344,"2016"
"33703","150200 CACHOEIRA DO ARARI",1,5,6,327,0,339,"2016"
"33704","150210 CAMETA",7,16,60,2210,113,2406,"2016"
"33705","150215 CANAA DOS CARAJAS",0,7,22,1344,7,1380,"2016"
"33706","150220 CAPANEMA",6,2,10,1027,5,1050,"2016"
"33707","150230 CAPITAO POCO",14,1,3,778,11,807,"2016"
"33708","150240 CASTANHAL",11,8,20,3084,6,3129,"2016"
"33709","150250 CHAVES",0,0,3,313,54,370,"2016"
"33710","150260 COLARES",1,2,2,184,10,199,"2016"
"33711","150270 CONCEICAO DO ARAGUAIA",3,4,8,742,1,758,"2016"
"33712","150275 CONCORDIA DO PARA",0,3,10,482,5,500,"2016"
"33713","150276 CUMARU DO NORTE",1,3,1,153,0,158,"2016"
"33714","150277 CURIONOPOLIS",1,0,9,318,0,328,"2016"
"33715","150280 CURRALINHO",4,3,14,625,52,698,"2016"
"33716","150285 CURUA",1,0,1,161,45,208,"2016"
"33717","150290 CURUCA",3,1,5,506,12,527,"2016"
"33718","150293 DOM ELISEU",3,5,18,665,1,692,"2016"
"33719","150295 ELDORADO DOS CARAJAS",0,1,10,398,0,409,"2016"
"33720","150300 FARO",1,3,4,109,4,121,"2016"
"33721","150304 FLORESTA DO ARAGUAIA",1,0,4,321,1,327,"2016"
"33722","150307 GARRAFAO DO NORTE",1,1,2,378,29,411,"2016"
"33723","150309 GOIANESIA DO PARA",2,0,8,412,41,463,"2016"
"33724","150310 GURUPA",2,7,8,633,86,736,"2016"
"33725","150320 IGARAPE-ACU",0,1,8,535,6,550,"2016"
"33726","150330 IGARAPE-MIRI",2,4,21,976,52,1055,"2016"
"33727","150340 INHANGAPI",2,1,1,156,2,162,"2016"
"33728","150345 IPIXUNA DO PARA",3,4,10,565,14,596,"2016"
"33729","150350 IRITUIA",2,1,2,406,26,437,"2016"
"33730","150360 ITAITUBA",7,18,55,1905,18,2003,"2016"
"33731","150370 ITUPIRANGA",2,0,3,819,16,840,"2016"
"33732","150375 JACAREACANGA",0,1,1,321,264,587,"2016"
"33733","150380 JACUNDA",1,0,18,761,14,794,"2016"
"33734","150390 JURUTI",7,12,37,997,87,1140,"2016"
"33735","150400 LIMOEIRO DO AJURU",3,4,8,402,39,456,"2016"
"33736","150405 MAE DO RIO",1,3,13,572,2,591,"2016"
"33737","150410 MAGALHAES BARATA",1,0,0,94,2,97,"2016"
"33738","150420 MARABA",12,19,33,4629,58,4751,"2016"
"33739","150430 MARACANA",1,1,3,368,10,383,"2016"
"33740","150440 MARAPANIM",0,0,8,309,12,329,"2016"
"33741","150442 MARITUBA",3,9,19,1756,7,1794,"2016"
"33742","150445 MEDICILANDIA",2,1,6,422,1,432,"2016"
"33743","150450 MELGACO",1,3,12,327,194,537,"2016"
"33744","150460 MOCAJUBA",0,6,1,491,8,506,"2016"
"33745","150470 MOJU",35,5,22,1127,15,1204,"2016"
"33746","150475 MOJUI DOS CAMPOS",0,3,6,211,5,225,"2016"
"33747","150480 MONTE ALEGRE",0,6,42,1089,1,1138,"2016"
"33748","150490 MUANA",2,7,10,586,0,605,"2016"
"33749","150495 NOVA ESPERANCA DO PIRIA",3,1,49,390,2,445,"2016"
"33750","150497 NOVA IPIXUNA",1,2,6,207,1,217,"2016"
"33751","150500 NOVA TIMBOTEUA",0,1,0,162,2,165,"2016"
"33752","150503 NOVO PROGRESSO",2,1,11,539,0,553,"2016"
"33753","150506 NOVO REPARTIMENTO",8,2,8,1183,10,1211,"2016"
"33754","150510 OBIDOS",3,4,12,835,131,985,"2016"
"33755","150520 OEIRAS DO PARA",3,5,20,583,38,649,"2016"
"33756","150530 ORIXIMINA",5,16,30,1296,52,1399,"2016"
"33757","150540 OUREM",1,2,2,262,14,281,"2016"
"33758","150543 OURILANDIA DO NORTE",0,2,6,622,0,630,"2016"
"33759","150548 PACAJA",2,0,8,729,13,752,"2016"
"33760","150549 PALESTINA DO PARA",0,1,0,86,2,89,"2016"
"33761","150550 PARAGOMINAS",6,8,9,1966,12,2001,"2016"
"33762","150553 PARAUAPEBAS",8,13,45,4571,7,4644,"2016"
"33763","150555 PAU D'ARCO",0,1,5,115,0,121,"2016"
"33764","150560 PEIXE-BOI",0,0,0,103,0,103,"2016"
"33765","150563 PICARRA",0,1,2,136,2,141,"2016"
"33766","150565 PLACAS",1,1,4,279,0,285,"2016"
"33767","150570 PONTA DE PEDRAS",0,1,4,344,3,352,"2016"
"33768","150580 PORTEL",2,1,18,1095,345,1461,"2016"
"33769","150590 PORTO DE MOZ",1,0,9,690,43,743,"2016"
"33770","150600 PRAINHA",7,4,11,581,119,722,"2016"
"33771","150610 PRIMAVERA",0,0,2,101,69,172,"2016"
"33772","150611 QUATIPURU",1,0,2,160,5,168,"2016"
"33773","150613 REDENCAO",3,10,23,1587,4,1627,"2016"
"33774","150616 RIO MARIA",2,1,4,267,0,274,"2016"
"33775","150618 RONDON DO PARA",1,5,16,651,3,676,"2016"
"33776","150619 RUROPOLIS",1,4,4,359,1,369,"2016"
"33777","150620 SALINOPOLIS",1,1,1,651,1,655,"2016"
"33778","150630 SALVATERRA",2,4,6,367,2,381,"2016"
"33779","150635 SANTA BARBARA DO PARA",0,1,5,344,4,354,"2016"
"33780","150640 SANTA CRUZ DO ARARI",0,0,0,63,15,78,"2016"
"33781","150650 SANTA IZABEL DO PARA",0,2,9,979,6,996,"2016"
"33782","150655 SANTA LUZIA DO PARA",2,1,5,360,8,376,"2016"
"33783","150658 SANTA MARIA DAS BARREIRAS",0,0,2,140,1,143,"2016"
"33784","150660 SANTA MARIA DO PARA",0,1,4,365,2,372,"2016"
"33785","150670 SANTANA DO ARAGUAIA",1,2,12,557,0,572,"2016"
"33786","150680 SANTAREM",25,42,205,5748,471,6491,"2016"
"33787","150690 SANTAREM NOVO",0,0,2,102,1,105,"2016"
"33788","150700 SANTO ANTONIO DO TAUA",1,3,4,422,14,444,"2016"
"33789","150710 SAO CAETANO DE ODIVELAS",0,0,5,215,6,226,"2016"
"33790","150715 SAO DOMINGOS DO ARAGUAIA",0,0,4,332,3,339,"2016"
"33791","150720 SAO DOMINGOS DO CAPIM",2,3,7,479,20,511,"2016"
"33792","150730 SAO FELIX DO XINGU",7,7,11,1018,3,1046,"2016"
"33793","150740 SAO FRANCISCO DO PARA",0,0,2,225,0,227,"2016"
"33794","150745 SAO GERALDO DO ARAGUAIA",1,1,5,456,0,463,"2016"
"33795","150746 SAO JOAO DA PONTA",0,1,0,75,5,81,"2016"
"33796","150747 SAO JOAO DE PIRABAS",1,2,3,328,6,340,"2016"
"33797","150750 SAO JOAO DO ARAGUAIA",2,4,5,204,1,216,"2016"
"33798","150760 SAO MIGUEL DO GUAMA",3,1,9,908,11,932,"2016"
"33799","150770 SAO SEBASTIAO DA BOA VISTA",1,3,17,528,2,551,"2016"
"33800","150775 SAPUCAIA",1,1,0,84,0,86,"2016"
"33801","150780 SENADOR JOSE PORFIRIO",1,0,1,250,5,257,"2016"
"33802","150790 SOURE",3,0,1,377,1,382,"2016"
"33803","150795 TAILANDIA",2,4,14,1539,3,1562,"2016"
"33804","150796 TERRA ALTA",1,1,2,169,1,174,"2016"
"33805","150797 TERRA SANTA",1,2,14,256,0,273,"2016"
"33806","150800 TOME-ACU",2,12,35,1459,10,1518,"2016"
"33807","150803 TRACUATEUA",3,2,11,511,10,537,"2016"
"33808","150805 TRAIRAO",0,4,8,201,14,227,"2016"
"33809","150808 TUCUMA",1,2,6,620,2,631,"2016"
"33810","150810 TUCURUI",3,5,34,1219,858,2119,"2016"
"33811","150812 ULIANOPOLIS",2,1,9,480,1,493,"2016"
"33812","150815 URUARA",3,5,13,708,7,736,"2016"
"33813","150820 VIGIA",2,5,8,736,2,753,"2016"
"33814","150830 VISEU",5,3,7,876,267,1158,"2016"
"33815","150835 VITORIA DO XINGU",0,0,8,388,0,396,"2016"
"33816","150840 XINGUARA",0,3,15,885,1,904,"2016"
"33817","160005 SERRA DO NAVIO",0,0,0,66,1,67,"2016"
"33818","160010 AMAPA",0,1,3,125,4,133,"2016"
"33819","160015 PEDRA BRANCA DO AMAPARI",0,1,2,203,46,252,"2016"
"33820","160020 CALCOENE",1,0,3,168,4,176,"2016"
"33821","160021 CUTIAS",1,1,1,85,1,89,"2016"
"33822","160023 FERREIRA GOMES",0,1,4,172,3,180,"2016"
"33823","160025 ITAUBAL",1,0,1,85,12,99,"2016"
"33824","160027 LARANJAL DO JARI",2,6,25,750,0,783,"2016"
"33825","160030 MACAPA",25,42,115,9130,166,9478,"2016"
"33826","160040 MAZAGAO",1,3,9,386,61,460,"2016"
"33827","160050 OIAPOQUE",2,3,15,462,77,559,"2016"
"33828","160053 PORTO GRANDE",0,3,1,361,4,369,"2016"
"33829","160055 PRACUUBA",2,0,0,34,30,66,"2016"
"33830","160060 SANTANA",17,15,34,2186,1,2253,"2016"
"33831","160070 TARTARUGALZINHO",0,0,2,208,101,311,"2016"
"33832","160080 VITORIA DO JARI",0,2,6,234,4,246,"2016"
"33833","MUNICIPIO IGNORADO - TO",0,0,0,1,0,1,"2016"
"33834","170025 ABREULANDIA",0,0,0,36,0,36,"2016"
"33835","170030 AGUIARNOPOLIS",0,1,1,83,0,85,"2016"
"33836","170035 ALIANCA DO TOCANTINS",1,0,3,63,1,68,"2016"
"33837","170040 ALMAS",0,1,0,112,0,113,"2016"
"33838","170070 ALVORADA",0,1,1,93,3,98,"2016"
"33839","170100 ANANAS",0,1,4,151,0,156,"2016"
"33840","170105 ANGICO",0,0,1,47,0,48,"2016"
"33841","170110 APARECIDA DO RIO NEGRO",0,0,0,66,3,69,"2016"
"33842","170130 ARAGOMINAS",0,0,1,65,1,67,"2016"
"33843","170190 ARAGUACEMA",0,2,0,92,1,95,"2016"
"33844","170200 ARAGUACU",0,1,3,89,0,93,"2016"
"33845","170210 ARAGUAINA",3,14,66,2991,12,3086,"2016"
"33846","170215 ARAGUANA",0,0,4,83,0,87,"2016"
"33847","170220 ARAGUATINS",0,1,10,446,81,538,"2016"
"33848","170230 ARAPOEMA",0,1,0,96,0,97,"2016"
"33849","170240 ARRAIAS",0,1,4,151,0,156,"2016"
"33850","170255 AUGUSTINOPOLIS",2,0,7,249,58,316,"2016"
"33851","170270 AURORA DO TOCANTINS",2,0,0,39,0,41,"2016"
"33852","170290 AXIXA DO TOCANTINS",0,1,7,163,21,192,"2016"
"33853","170300 BABACULANDIA",0,0,2,104,2,108,"2016"
"33854","170305 BANDEIRANTES DO TOCANTINS",0,0,0,34,0,34,"2016"
"33855","170307 BARRA DO OURO",1,0,2,87,3,93,"2016"
"33856","170310 BARROLANDIA",0,0,0,71,1,72,"2016"
"33857","170320 BERNARDO SAYAO",0,0,2,64,1,67,"2016"
"33858","170330 BOM JESUS DO TOCANTINS",0,0,0,77,0,77,"2016"
"33859","170360 BRASILANDIA DO TOCANTINS",0,0,1,25,0,26,"2016"
"33860","170370 BREJINHO DE NAZARE",0,0,1,80,0,81,"2016"
"33861","170380 BURITI DO TOCANTINS",0,0,7,106,19,132,"2016"
"33862","170382 CACHOEIRINHA",0,0,1,23,1,25,"2016"
"33863","170384 CAMPOS LINDOS",2,1,2,135,10,150,"2016"
"33864","170386 CARIRI DO TOCANTINS",0,0,0,57,0,57,"2016"
"33865","170388 CARMOLANDIA",0,0,2,30,0,32,"2016"
"33866","170389 CARRASCO BONITO",0,0,1,57,7,65,"2016"
"33867","170390 CASEARA",0,0,2,76,1,79,"2016"
"33868","170410 CENTENARIO",0,0,0,28,0,28,"2016"
"33869","170460 CHAPADA DE AREIA",0,0,0,13,0,13,"2016"
"33870","170510 CHAPADA DA NATIVIDADE",0,0,0,37,0,37,"2016"
"33871","170550 COLINAS DO TOCANTINS",2,1,11,533,29,576,"2016"
"33872","170555 COMBINADO",0,1,1,43,0,45,"2016"
"33873","170560 CONCEICAO DO TOCANTINS",1,0,3,48,1,53,"2016"
"33874","170600 COUTO MAGALHAES",1,0,2,69,0,72,"2016"
"33875","170610 CRISTALANDIA",0,0,0,80,2,82,"2016"
"33876","170625 CRIXAS DO TOCANTINS",0,0,0,23,0,23,"2016"
"33877","170650 DARCINOPOLIS",0,1,1,75,1,78,"2016"
"33878","170700 DIANOPOLIS",0,1,5,277,3,286,"2016"
"33879","170710 DIVINOPOLIS DO TOCANTINS",0,0,1,107,2,110,"2016"
"33880","170720 DOIS IRMAOS DO TOCANTINS",0,1,1,69,1,72,"2016"
"33881","170730 DUERE",0,0,1,49,1,51,"2016"
"33882","170740 ESPERANTINA",0,0,1,116,24,141,"2016"
"33883","170755 FATIMA",0,0,0,62,2,64,"2016"
"33884","170765 FIGUEIROPOLIS",0,0,0,71,0,71,"2016"
"33885","170770 FILADELFIA",0,0,3,110,3,116,"2016"
"33886","170820 FORMOSO DO ARAGUAIA",1,0,4,253,2,260,"2016"
"33887","170825 FORTALEZA DO TABOCAO",0,0,0,49,0,49,"2016"
"33888","170830 GOIANORTE",0,0,0,39,1,40,"2016"
"33889","170900 GOIATINS",2,1,4,245,7,259,"2016"
"33890","170930 GUARAI",0,1,7,368,1,377,"2016"
"33891","170950 GURUPI",7,2,14,1266,5,1294,"2016"
"33892","170980 IPUEIRAS",0,1,0,30,0,31,"2016"
"33893","171050 ITACAJA",1,0,3,115,5,124,"2016"
"33894","171070 ITAGUATINS",0,0,2,54,13,69,"2016"
"33895","171090 ITAPIRATINS",0,0,1,51,0,52,"2016"
"33896","171110 ITAPORA DO TOCANTINS",0,0,2,36,0,38,"2016"
"33897","171150 JAU DO TOCANTINS",0,1,1,31,0,33,"2016"
"33898","171180 JUARINA",0,0,0,40,0,40,"2016"
"33899","171190 LAGOA DA CONFUSAO",1,2,1,215,3,222,"2016"
"33900","171195 LAGOA DO TOCANTINS",1,0,0,59,4,64,"2016"
"33901","171200 LAJEADO",0,0,1,54,1,56,"2016"
"33902","171215 LAVANDEIRA",1,0,1,17,0,19,"2016"
"33903","171240 LIZARDA",0,1,2,38,0,41,"2016"
"33904","171245 LUZINOPOLIS",1,1,2,39,7,50,"2016"
"33905","171250 MARIANOPOLIS DO TOCANTINS",0,0,1,54,1,56,"2016"
"33906","171270 MATEIROS",0,0,2,34,2,38,"2016"
"33907","171280 MAURILANDIA DO TOCANTINS",0,0,0,22,3,25,"2016"
"33908","171320 MIRACEMA DO TOCANTINS",0,2,2,304,3,311,"2016"
"33909","171330 MIRANORTE",0,4,2,186,2,194,"2016"
"33910","171360 MONTE DO CARMO",1,0,2,84,0,87,"2016"
"33911","171370 MONTE SANTO DO TOCANTINS",0,0,0,28,0,28,"2016"
"33912","171380 PALMEIRAS DO TOCANTINS",0,0,0,82,0,82,"2016"
"33913","171395 MURICILANDIA",0,0,1,45,0,46,"2016"
"33914","171420 NATIVIDADE",1,0,2,113,1,117,"2016"
"33915","171430 NAZARE",1,0,1,45,1,48,"2016"
"33916","171488 NOVA OLINDA",1,0,1,175,2,179,"2016"
"33917","171500 NOVA ROSALANDIA",0,0,0,41,0,41,"2016"
"33918","171510 NOVO ACORDO",1,0,0,65,4,70,"2016"
"33919","171515 NOVO ALEGRE",1,0,0,19,0,20,"2016"
"33920","171525 NOVO JARDIM",0,0,1,33,0,34,"2016"
"33921","171550 OLIVEIRA DE FATIMA",0,0,0,26,0,26,"2016"
"33922","171570 PALMEIRANTE",0,0,2,62,1,65,"2016"
"33923","171575 PALMEIROPOLIS",0,0,0,79,0,79,"2016"
"33924","171610 PARAISO DO TOCANTINS",1,2,9,835,4,851,"2016"
"33925","171620 PARANA",0,2,3,141,0,146,"2016"
"33926","171630 PAU D'ARCO",0,0,0,69,0,69,"2016"
"33927","171650 PEDRO AFONSO",0,2,1,249,0,252,"2016"
"33928","171660 PEIXE",1,0,1,128,0,130,"2016"
"33929","171665 PEQUIZEIRO",0,0,1,67,0,68,"2016"
"33930","171670 COLMEIA",2,0,2,97,1,102,"2016"
"33931","171700 PINDORAMA DO TOCANTINS",0,0,2,41,0,43,"2016"
"33932","171720 PIRAQUE",0,0,1,31,0,32,"2016"
"33933","171750 PIUM",0,0,2,88,1,91,"2016"
"33934","171780 PONTE ALTA DO BOM JESUS",1,0,0,57,0,58,"2016"
"33935","171790 PONTE ALTA DO TOCANTINS",0,0,0,126,0,126,"2016"
"33936","171800 PORTO ALEGRE DO TOCANTINS",0,0,1,52,1,54,"2016"
"33937","171820 PORTO NACIONAL",4,3,20,1073,3,1103,"2016"
"33938","171830 PRAIA NORTE",0,0,1,103,22,126,"2016"
"33939","171840 PRESIDENTE KENNEDY",0,0,0,51,0,51,"2016"
"33940","171845 PUGMIL",0,0,0,40,0,40,"2016"
"33941","171850 RECURSOLANDIA",0,0,0,53,0,53,"2016"
"33942","171855 RIACHINHO",0,0,2,65,0,67,"2016"
"33943","171865 RIO DA CONCEICAO",0,0,0,37,1,38,"2016"
"33944","171870 RIO DOS BOIS",0,0,2,34,0,36,"2016"
"33945","171875 RIO SONO",0,0,0,58,2,60,"2016"
"33946","171880 SAMPAIO",1,0,3,60,20,84,"2016"
"33947","171884 SANDOLANDIA",0,0,2,41,0,43,"2016"
"33948","171886 SANTA FE DO ARAGUAIA",0,0,7,107,1,115,"2016"
"33949","171888 SANTA MARIA DO TOCANTINS",0,0,1,38,0,39,"2016"
"33950","171889 SANTA RITA DO TOCANTINS",0,0,0,24,0,24,"2016"
"33951","171890 SANTA ROSA DO TOCANTINS",0,0,0,83,0,83,"2016"
"33952","171900 SANTA TEREZA DO TOCANTINS",0,0,0,38,4,42,"2016"
"33953","172000 SANTA TEREZINHA DO TOCANTINS",0,0,1,33,1,35,"2016"
"33954","172010 SAO BENTO DO TOCANTINS",0,1,0,66,7,74,"2016"
"33955","172015 SAO FELIX DO TOCANTINS",0,0,0,22,0,22,"2016"
"33956","172020 SAO MIGUEL DO TOCANTINS",0,2,1,163,1,167,"2016"
"33957","172025 SAO SALVADOR DO TOCANTINS",0,0,1,38,0,39,"2016"
"33958","172030 SAO SEBASTIAO DO TOCANTINS",0,0,2,63,13,78,"2016"
"33959","172049 SAO VALERIO",0,0,0,45,0,45,"2016"
"33960","172065 SILVANOPOLIS",0,0,1,71,1,73,"2016"
"33961","172080 SITIO NOVO DO TOCANTINS",0,0,4,136,7,147,"2016"
"33962","172085 SUCUPIRA",0,1,1,31,0,33,"2016"
"33963","172090 TAGUATINGA",0,2,3,166,2,173,"2016"
"33964","172093 TAIPAS DO TOCANTINS",0,0,0,26,0,26,"2016"
"33965","172097 TALISMA",0,0,0,30,1,31,"2016"
"33966","172100 PALMAS",13,6,56,4750,30,4855,"2016"
"33967","172110 TOCANTINIA",0,0,0,165,1,166,"2016"
"33968","172120 TOCANTINOPOLIS",3,5,4,372,8,392,"2016"
"33969","172125 TUPIRAMA",0,0,0,22,0,22,"2016"
"33970","172130 TUPIRATINS",0,0,0,29,1,30,"2016"
"33971","172208 WANDERLANDIA",0,0,4,128,0,132,"2016"
"33972","172210 XAMBIOA",0,0,9,169,4,182,"2016"
"33973","MUNICIPIO IGNORADO - MA",0,0,0,3,1,4,"2016"
"33974","210005 ACAILANDIA",2,15,44,1848,11,1920,"2016"
"33975","210010 AFONSO CUNHA",1,1,6,97,3,108,"2016"
"33976","210015 AGUA DOCE DO MARANHAO",0,0,1,148,15,164,"2016"
"33977","210020 ALCANTARA",2,3,2,114,53,174,"2016"
"33978","210030 ALDEIAS ALTAS",0,2,16,372,2,392,"2016"
"33979","210040 ALTAMIRA DO MARANHAO",0,0,0,82,1,83,"2016"
"33980","210043 ALTO ALEGRE DO MARANHAO",0,2,3,429,5,439,"2016"
"33981","210047 ALTO ALEGRE DO PINDARE",1,3,6,456,8,474,"2016"
"33982","210050 ALTO PARNAIBA",1,0,1,146,22,170,"2016"
"33983","210055 AMAPA DO MARANHAO",2,0,3,123,2,130,"2016"
"33984","210060 AMARANTE DO MARANHAO",4,1,7,692,35,739,"2016"
"33985","210070 ANAJATUBA",1,3,3,233,106,346,"2016"
"33986","210080 ANAPURUS",0,1,3,249,3,256,"2016"
"33987","210083 APICUM-ACU",6,4,0,4,294,308,"2016"
"33988","210087 ARAGUANA",0,2,2,184,0,188,"2016"
"33989","210090 ARAIOSES",1,0,10,520,24,555,"2016"
"33990","210095 ARAME",0,2,11,504,7,524,"2016"
"33991","210100 ARARI",0,1,16,414,51,482,"2016"
"33992","210110 AXIXA",2,0,2,184,2,190,"2016"
"33993","210120 BACABAL",8,15,45,1403,5,1476,"2016"
"33994","210125 BACABEIRA",1,1,5,282,3,292,"2016"
"33995","210130 BACURI",0,0,1,14,225,240,"2016"
"33996","210135 BACURITUBA",0,0,1,55,12,68,"2016"
"33997","210140 BALSAS",4,3,20,149,1822,1998,"2016"
"33998","210150 BARAO DE GRAJAU",0,1,3,267,2,273,"2016"
"33999","210160 BARRA DO CORDA",2,3,13,1379,42,1439,"2016"
"34000","210170 BARREIRINHAS",1,3,3,1234,43,1284,"2016"
"34001","210173 BELAGUA",0,0,0,37,136,173,"2016"
"34002","210177 BELA VISTA DO MARANHAO",1,1,1,191,0,194,"2016"
"34003","210180 BENEDITO LEITE",0,0,0,17,56,73,"2016"
"34004","210190 BEQUIMAO",1,1,5,71,188,266,"2016"
"34005","210193 BERNARDO DO MEARIM",0,0,0,54,0,54,"2016"
"34006","210197 BOA VISTA DO GURUPI",0,0,4,140,16,160,"2016"
"34007","210200 BOM JARDIM",1,0,8,580,51,640,"2016"
"34008","210203 BOM JESUS DAS SELVAS",0,1,20,575,4,600,"2016"
"34009","210207 BOM LUGAR",0,1,5,135,1,142,"2016"
"34010","210210 BREJO",1,0,5,461,3,470,"2016"
"34011","210215 BREJO DE AREIA",1,1,1,91,9,103,"2016"
"34012","210220 BURITI",0,3,17,484,9,513,"2016"
"34013","210230 BURITI BRAVO",18,1,3,349,5,376,"2016"
"34014","210232 BURITICUPU",3,7,31,1308,17,1366,"2016"
"34015","210235 BURITIRANA",0,0,3,185,10,198,"2016"
"34016","210237 CACHOEIRA GRANDE",1,0,1,113,24,139,"2016"
"34017","210240 CAJAPIO",0,0,0,21,155,176,"2016"
"34018","210250 CAJARI",1,0,5,155,111,272,"2016"
"34019","210255 CAMPESTRE DO MARANHAO",0,2,3,194,2,201,"2016"
"34020","210260 CANDIDO MENDES",0,1,0,265,32,298,"2016"
"34021","210270 CANTANHEDE",0,0,4,184,71,259,"2016"
"34022","210275 CAPINZAL DO NORTE",0,1,0,143,1,145,"2016"
"34023","210280 CAROLINA",1,5,14,305,2,327,"2016"
"34024","210290 CARUTAPERA",1,1,2,450,3,457,"2016"
"34025","210300 CAXIAS",6,11,75,2440,27,2559,"2016"
"34026","210310 CEDRAL",0,0,1,94,19,114,"2016"
"34027","210312 CENTRAL DO MARANHAO",0,0,1,13,79,93,"2016"
"34028","210315 CENTRO DO GUILHERME",0,0,2,181,7,190,"2016"
"34029","210317 CENTRO NOVO DO MARANHAO",0,4,5,284,3,296,"2016"
"34030","210320 CHAPADINHA",5,7,36,1314,6,1368,"2016"
"34031","210325 CIDELANDIA",1,1,1,172,11,186,"2016"
"34032","210330 CODO",8,23,73,1798,45,1947,"2016"
"34033","210340 COELHO NETO",1,14,17,684,0,716,"2016"
"34034","210350 COLINAS",2,7,16,684,10,719,"2016"
"34035","210355 CONCEICAO DO LAGO-ACU",1,0,11,201,39,252,"2016"
"34036","210360 COROATA",3,3,21,1055,19,1101,"2016"
"34037","210370 CURURUPU",1,0,2,24,393,420,"2016"
"34038","210375 DAVINOPOLIS",0,0,4,233,1,238,"2016"
"34039","210380 DOM PEDRO",0,1,8,350,5,364,"2016"
"34040","210390 DUQUE BACELAR",1,2,7,171,4,185,"2016"
"34041","210400 ESPERANTINOPOLIS",0,1,4,301,0,306,"2016"
"34042","210405 ESTREITO",1,1,21,615,2,640,"2016"
"34043","210407 FEIRA NOVA DO MARANHAO",1,0,0,22,55,78,"2016"
"34044","210408 FERNANDO FALCAO",1,0,1,129,56,187,"2016"
"34045","210409 FORMOSA DA SERRA NEGRA",0,0,3,129,129,261,"2016"
"34046","210410 FORTALEZA DOS NOGUEIRAS",0,0,1,87,105,193,"2016"
"34047","210420 FORTUNA",1,0,5,285,1,292,"2016"
"34048","210430 GODOFREDO VIANA",0,0,2,136,7,145,"2016"
"34049","210440 GONCALVES DIAS",2,0,0,74,173,249,"2016"
"34050","210450 GOVERNADOR ARCHER",1,1,6,153,3,164,"2016"
"34051","210455 GOVERNADOR EDISON LOBAO",0,1,5,295,2,303,"2016"
"34052","210460 GOVERNADOR EUGENIO BARROS",0,1,11,233,2,247,"2016"
"34053","210462 GOVERNADOR LUIZ ROCHA",1,1,0,97,6,105,"2016"
"34054","210465 GOVERNADOR NEWTON BELLO",0,2,5,134,2,143,"2016"
"34055","210467 GOVERNADOR NUNES FREIRE",1,0,7,432,5,445,"2016"
"34056","210470 GRACA ARANHA",1,1,0,54,2,58,"2016"
"34057","210480 GRAJAU",0,10,39,1477,61,1587,"2016"
"34058","210490 GUIMARAES",0,0,1,54,103,158,"2016"
"34059","210500 HUMBERTO DE CAMPOS",2,1,7,434,66,510,"2016"
"34060","210510 ICATU",2,2,10,345,37,396,"2016"
"34061","210515 IGARAPE DO MEIO",0,1,7,218,19,245,"2016"
"34062","210520 IGARAPE GRANDE",1,0,1,142,0,144,"2016"
"34063","210530 IMPERATRIZ",13,11,130,4712,28,4894,"2016"
"34064","210535 ITAIPAVA DO GRAJAU",0,1,7,235,7,250,"2016"
"34065","210540 ITAPECURU MIRIM",5,3,3,137,992,1140,"2016"
"34066","210542 ITINGA DO MARANHAO",0,1,12,332,1,346,"2016"
"34067","210545 JATOBA",0,0,3,131,0,134,"2016"
"34068","210547 JENIPAPO DOS VIEIRAS",1,0,0,287,50,338,"2016"
"34069","210550 JOAO LISBOA",0,1,10,434,3,448,"2016"
"34070","210560 JOSELANDIA",1,0,2,219,11,233,"2016"
"34071","210565 JUNCO DO MARANHAO",0,0,2,117,0,119,"2016"
"34072","210570 LAGO DA PEDRA",1,1,12,868,1,883,"2016"
"34073","210580 LAGO DO JUNCO",0,2,2,156,0,160,"2016"
"34074","210590 LAGO VERDE",2,1,15,239,6,263,"2016"
"34075","210592 LAGOA DO MATO",0,0,0,125,1,126,"2016"
"34076","210594 LAGO DOS RODRIGUES",0,1,3,126,0,130,"2016"
"34077","210596 LAGOA GRANDE DO MARANHAO",0,0,1,194,6,201,"2016"
"34078","210598 LAJEADO NOVO",1,1,0,97,0,99,"2016"
"34079","210600 LIMA CAMPOS",0,2,2,221,1,226,"2016"
"34080","210610 LORETO",2,0,1,13,149,165,"2016"
"34081","210620 LUIS DOMINGUES",0,0,0,92,9,101,"2016"
"34082","210630 MAGALHAES DE ALMEIDA",4,2,2,191,0,199,"2016"
"34083","210632 MARACACUME",0,4,0,328,4,336,"2016"
"34084","210635 MARAJA DO SENA",0,0,3,92,6,101,"2016"
"34085","210637 MARANHAOZINHO",0,2,4,169,8,183,"2016"
"34086","210640 MATA ROMA",1,2,4,312,9,328,"2016"
"34087","210650 MATINHA",0,0,3,101,278,382,"2016"
"34088","210660 MATOES",1,2,11,424,11,449,"2016"
"34089","210663 MATOES DO NORTE",0,0,2,59,55,116,"2016"
"34090","210667 MILAGRES DO MARANHAO",0,0,3,97,2,102,"2016"
"34091","210670 MIRADOR",0,1,5,307,3,316,"2016"
"34092","210675 MIRANDA DO NORTE",1,1,3,236,61,302,"2016"
"34093","210680 MIRINZAL",1,0,0,11,218,230,"2016"
"34094","210690 MONCAO",2,2,5,597,18,624,"2016"
"34095","210700 MONTES ALTOS",0,1,3,138,8,150,"2016"
"34096","210710 MORROS",3,1,1,287,34,326,"2016"
"34097","210720 NINA RODRIGUES",2,0,6,91,98,197,"2016"
"34098","210725 NOVA COLINAS",0,1,4,62,23,90,"2016"
"34099","210730 NOVA IORQUE",0,0,0,14,13,27,"2016"
"34100","210735 NOVA OLINDA DO MARANHAO",0,1,7,224,5,237,"2016"
"34101","210740 OLHO D'AGUA DAS CUNHAS",0,1,4,250,9,264,"2016"
"34102","210745 OLINDA NOVA DO MARANHAO",1,1,2,120,53,177,"2016"
"34103","210750 PACO DO LUMIAR",14,7,41,1629,19,1710,"2016"
"34104","210760 PALMEIRANDIA",2,1,9,194,105,311,"2016"
"34105","210770 PARAIBANO",2,0,4,334,1,341,"2016"
"34106","210780 PARNARAMA",1,0,4,412,67,484,"2016"
"34107","210790 PASSAGEM FRANCA",2,1,0,337,1,341,"2016"
"34108","210800 PASTOS BONS",0,0,0,30,288,318,"2016"
"34109","210805 PAULINO NEVES",1,1,8,289,13,312,"2016"
"34110","210810 PAULO RAMOS",0,1,6,365,5,377,"2016"
"34111","210820 PEDREIRAS",1,3,14,544,2,564,"2016"
"34112","210825 PEDRO DO ROSARIO",0,1,11,161,37,210,"2016"
"34113","210830 PENALVA",2,0,6,621,53,682,"2016"
"34114","210840 PERI MIRIM",0,1,5,116,9,131,"2016"
"34115","210845 PERITORO",1,4,2,360,2,369,"2016"
"34116","210850 PINDARE-MIRIM",1,1,12,547,7,568,"2016"
"34117","210860 PINHEIRO",2,10,50,1326,73,1461,"2016"
"34118","210870 PIO XII",0,1,2,419,3,425,"2016"
"34119","210880 PIRAPEMAS",1,3,3,240,33,280,"2016"
"34120","210890 POCAO DE PEDRAS",1,1,2,232,0,236,"2016"
"34121","210900 PORTO FRANCO",1,3,7,409,0,420,"2016"
"34122","210905 PORTO RICO DO MARANHAO",0,0,0,63,15,78,"2016"
"34123","210910 PRESIDENTE DUTRA",2,2,14,774,2,794,"2016"
"34124","210920 PRESIDENTE JUSCELINO",2,0,4,172,29,207,"2016"
"34125","210923 PRESIDENTE MEDICI",0,0,0,98,2,100,"2016"
"34126","210927 PRESIDENTE SARNEY",2,2,13,297,81,395,"2016"
"34127","210930 PRESIDENTE VARGAS",1,1,18,81,109,210,"2016"
"34128","210940 PRIMEIRA CRUZ",1,2,3,150,40,196,"2016"
"34129","210945 RAPOSA",2,4,8,454,10,478,"2016"
"34130","210950 RIACHAO",0,3,3,323,52,381,"2016"
"34131","210955 RIBAMAR FIQUENE",0,1,1,128,4,134,"2016"
"34132","210960 ROSARIO",1,3,20,595,15,634,"2016"
"34133","210970 SAMBAIBA",1,0,0,27,38,66,"2016"
"34134","210975 SANTA FILOMENA DO MARANHAO",0,1,1,53,0,55,"2016"
"34135","210980 SANTA HELENA",0,3,4,371,142,520,"2016"
"34136","210990 SANTA INES",8,2,31,1474,4,1519,"2016"
"34137","211000 SANTA LUZIA",2,3,21,1023,107,1156,"2016"
"34138","211003 SANTA LUZIA DO PARUA",0,2,5,372,2,381,"2016"
"34139","211010 SANTA QUITERIA DO MARANHAO",1,1,12,408,6,428,"2016"
"34140","211020 SANTA RITA",3,3,24,477,34,541,"2016"
"34141","211023 SANTANA DO MARANHAO",0,1,3,111,4,119,"2016"
"34142","211027 SANTO AMARO DO MARANHAO",0,2,2,121,50,175,"2016"
"34143","211030 SANTO ANTONIO DOS LOPES",1,1,23,217,18,260,"2016"
"34144","211040 SAO BENEDITO DO RIO PRETO",1,0,4,46,294,345,"2016"
"34145","211050 SAO BENTO",0,2,4,449,18,473,"2016"
"34146","211060 SAO BERNARDO",0,1,11,412,4,428,"2016"
"34147","211065 SAO DOMINGOS DO AZEITAO",0,0,1,8,120,129,"2016"
"34148","211070 SAO DOMINGOS DO MARANHAO",0,0,17,543,23,583,"2016"
"34149","211080 SAO FELIX DE BALSAS",0,0,0,4,35,39,"2016"
"34150","211085 SAO FRANCISCO DO BREJAO",0,0,6,146,0,152,"2016"
"34151","211090 SAO FRANCISCO DO MARANHAO",4,3,5,130,5,147,"2016"
"34152","211100 SAO JOAO BATISTA",1,0,8,198,60,267,"2016"
"34153","211102 SAO JOAO DO CARU",0,2,17,208,1,228,"2016"
"34154","211105 SAO JOAO DO PARAISO",1,0,3,153,4,161,"2016"
"34155","211107 SAO JOAO DO SOTER",0,0,9,275,10,294,"2016"
"34156","211110 SAO JOAO DOS PATOS",1,4,4,379,2,390,"2016"
"34157","211120 SAO JOSE DE RIBAMAR",21,16,62,3095,35,3229,"2016"
"34158","211125 SAO JOSE DOS BASILIOS",0,1,2,88,2,93,"2016"
"34159","211130 SAO LUIS",114,109,313,15234,160,15930,"2016"
"34160","211140 SAO LUIS GONZAGA DO MARANHAO",0,3,5,290,3,301,"2016"
"34161","211150 SAO MATEUS DO MARANHAO",5,1,8,654,5,673,"2016"
"34162","211153 SAO PEDRO DA AGUA BRANCA",0,2,0,164,2,168,"2016"
"34163","211157 SAO PEDRO DOS CRENTES",0,0,0,78,10,88,"2016"
"34164","211160 SAO RAIMUNDO DAS MANGABEIRAS",0,0,0,14,323,337,"2016"
"34165","211163 SAO RAIMUNDO DO DOCA BEZERRA",0,0,1,74,1,76,"2016"
"34166","211167 SAO ROBERTO",0,0,0,55,2,57,"2016"
"34167","211170 SAO VICENTE FERRER",0,0,0,109,143,252,"2016"
"34168","211172 SATUBINHA",0,0,0,114,1,115,"2016"
"34169","211174 SENADOR ALEXANDRE COSTA",0,0,3,173,1,177,"2016"
"34170","211176 SENADOR LA ROCQUE",0,1,12,272,2,287,"2016"
"34171","211178 SERRANO DO MARANHAO",0,0,0,6,134,140,"2016"
"34172","211180 SITIO NOVO",1,1,10,251,10,273,"2016"
"34173","211190 SUCUPIRA DO NORTE",0,1,4,145,4,154,"2016"
"34174","211195 SUCUPIRA DO RIACHAO",0,0,0,70,1,71,"2016"
"34175","211200 TASSO FRAGOSO",1,1,1,52,81,136,"2016"
"34176","211210 TIMBIRAS",4,2,7,480,1,494,"2016"
"34177","211220 TIMON",11,7,28,2737,22,2805,"2016"
"34178","211223 TRIZIDELA DO VALE",1,1,6,304,1,313,"2016"
"34179","211227 TUFILANDIA",0,0,1,108,0,109,"2016"
"34180","211230 TUNTUM",0,4,15,473,1,493,"2016"
"34181","211240 TURIACU",1,0,3,34,670,708,"2016"
"34182","211245 TURILANDIA",0,1,7,195,141,344,"2016"
"34183","211250 TUTOIA",2,4,17,845,39,907,"2016"
"34184","211260 URBANO SANTOS",1,0,3,115,502,621,"2016"
"34185","211270 VARGEM GRANDE",0,8,38,757,57,860,"2016"
"34186","211280 VIANA",4,2,15,911,86,1018,"2016"
"34187","211285 VILA NOVA DOS MARTIRIOS",1,0,2,156,2,161,"2016"
"34188","211290 VITORIA DO MEARIM",2,0,2,47,471,522,"2016"
"34189","211300 VITORINO FREIRE",2,0,3,456,0,461,"2016"
"34190","211400 ZE DOCA",1,4,28,766,4,803,"2016"
"34191","220005 ACAUA",0,0,2,78,5,85,"2016"
"34192","220010 AGRICOLANDIA",0,1,3,63,6,73,"2016"
"34193","220020 AGUA BRANCA",0,0,2,268,8,278,"2016"
"34194","220025 ALAGOINHA DO PIAUI",0,0,5,79,1,85,"2016"
"34195","220027 ALEGRETE DO PIAUI",0,0,0,54,0,54,"2016"
"34196","220030 ALTO LONGA",0,1,0,122,3,126,"2016"
"34197","220040 ALTOS",0,5,7,566,26,604,"2016"
"34198","220045 ALVORADA DO GURGUEIA",1,0,1,46,32,80,"2016"
"34199","220050 AMARANTE",1,1,8,291,3,304,"2016"
"34200","220060 ANGICAL DO PIAUI",0,1,3,103,8,115,"2016"
"34201","220070 ANISIO DE ABREU",1,1,1,117,22,142,"2016"
"34202","220080 ANTONIO ALMEIDA",0,0,0,35,10,45,"2016"
"34203","220090 AROAZES",0,1,1,83,1,86,"2016"
"34204","220095 AROEIRAS DO ITAIM",0,1,0,18,0,19,"2016"
"34205","220100 ARRAIAL",1,0,0,45,0,46,"2016"
"34206","220105 ASSUNCAO DO PIAUI",0,1,2,98,15,116,"2016"
"34207","220110 AVELINO LOPES",1,0,0,119,50,170,"2016"
"34208","220115 BAIXA GRANDE DO RIBEIRO",1,1,1,178,27,208,"2016"
"34209","220117 BARRA D'ALCANTARA",1,0,0,57,0,58,"2016"
"34210","220120 BARRAS",4,3,11,705,8,731,"2016"
"34211","220130 BARREIRAS DO PIAUI",0,0,0,9,26,35,"2016"
"34212","220140 BARRO DURO",0,0,2,91,1,94,"2016"
"34213","220150 BATALHA",2,0,14,345,4,365,"2016"
"34214","220155 BELA VISTA DO PIAUI",0,0,4,46,1,51,"2016"
"34215","220157 BELEM DO PIAUI",0,0,2,34,0,36,"2016"
"34216","220160 BENEDITINOS",0,0,3,108,16,127,"2016"
"34217","220170 BERTOLINIA",1,1,0,61,12,75,"2016"
"34218","220173 BETANIA DO PIAUI",0,1,0,74,43,118,"2016"
"34219","220177 BOA HORA",0,3,1,35,43,82,"2016"
"34220","220180 BOCAINA",0,0,2,44,0,46,"2016"
"34221","220190 BOM JESUS",0,1,0,262,225,488,"2016"
"34222","220191 BOM PRINCIPIO DO PIAUI",0,1,2,72,0,75,"2016"
"34223","220192 BONFIM DO PIAUI",0,0,0,78,25,103,"2016"
"34224","220194 BOQUEIRAO DO PIAUI",1,1,0,21,62,85,"2016"
"34225","220196 BRASILEIRA",0,0,0,100,0,100,"2016"
"34226","220198 BREJO DO PIAUI",0,1,0,44,6,51,"2016"
"34227","220200 BURITI DOS LOPES",0,0,2,281,6,289,"2016"
"34228","220202 BURITI DOS MONTES",0,0,1,49,21,71,"2016"
"34229","220205 CABECEIRAS DO PIAUI",0,1,1,47,70,119,"2016"
"34230","220207 CAJAZEIRAS DO PIAUI",0,1,0,42,0,43,"2016"
"34231","220208 CAJUEIRO DA PRAIA",0,0,1,117,0,118,"2016"
"34232","220209 CALDEIRAO GRANDE DO PIAUI",0,1,3,60,0,64,"2016"
"34233","220210 CAMPINAS DO PIAUI",0,0,1,48,0,49,"2016"
"34234","220211 CAMPO ALEGRE DO FIDALGO",0,0,2,56,0,58,"2016"
"34235","220213 CAMPO GRANDE DO PIAUI",0,0,7,87,0,94,"2016"
"34236","220217 CAMPO LARGO DO PIAUI",0,0,8,97,2,107,"2016"
"34237","220220 CAMPO MAIOR",2,1,5,163,389,560,"2016"
"34238","220225 CANAVIEIRA",0,0,0,29,2,31,"2016"
"34239","220230 CANTO DO BURITI",0,3,8,248,23,282,"2016"
"34240","220240 CAPITAO DE CAMPOS",1,1,1,97,49,149,"2016"
"34241","220245 CAPITAO GERVASIO OLIVEIRA",0,1,1,60,0,62,"2016"
"34242","220250 CARACOL",0,0,0,112,68,180,"2016"
"34243","220253 CARAUBAS DO PIAUI",0,0,0,76,4,80,"2016"
"34244","220255 CARIDADE DO PIAUI",0,0,1,59,0,60,"2016"
"34245","220260 CASTELO DO PIAUI",0,0,1,153,114,268,"2016"
"34246","220265 CAXINGO",2,1,2,93,3,101,"2016"
"34247","220270 COCAL",0,4,5,378,15,402,"2016"
"34248","220271 COCAL DE TELHA",0,0,0,27,48,75,"2016"
"34249","220272 COCAL DOS ALVES",0,0,1,61,0,62,"2016"
"34250","220273 COIVARAS",0,0,0,39,12,51,"2016"
"34251","220275 COLONIA DO GURGUEIA",3,0,2,75,12,92,"2016"
"34252","220277 COLONIA DO PIAUI",1,2,2,81,0,86,"2016"
"34253","220280 CONCEICAO DO CANINDE",0,0,0,67,2,69,"2016"
"34254","220285 CORONEL JOSE DIAS",0,0,2,47,16,65,"2016"
"34255","220290 CORRENTE",0,2,3,66,339,410,"2016"
"34256","220300 CRISTALANDIA DO PIAUI",0,1,1,29,70,101,"2016"
"34257","220310 CRISTINO CASTRO",0,1,2,87,77,167,"2016"
"34258","220320 CURIMATA",1,2,3,88,114,208,"2016"
"34259","220323 CURRAIS",0,0,1,45,34,80,"2016"
"34260","220325 CURRALINHOS",0,0,1,48,2,51,"2016"
"34261","220327 CURRAL NOVO DO PIAUI",0,0,1,59,11,71,"2016"
"34262","220330 DEMERVAL LOBAO",0,2,2,213,5,222,"2016"
"34263","220335 DIRCEU ARCOVERDE",0,0,0,67,31,98,"2016"
"34264","220340 DOM EXPEDITO LOPES",0,0,6,86,0,92,"2016"
"34265","220342 DOMINGOS MOURAO",0,0,2,49,1,52,"2016"
"34266","220345 DOM INOCENCIO",0,0,1,50,26,77,"2016"
"34267","220350 ELESBAO VELOSO",1,0,1,147,2,151,"2016"
"34268","220360 ELISEU MARTINS",1,0,0,41,8,50,"2016"
"34269","220370 ESPERANTINA",0,3,21,619,8,651,"2016"
"34270","220375 FARTURA DO PIAUI",0,1,0,52,10,63,"2016"
"34271","220380 FLORES DO PIAUI",0,0,4,66,0,70,"2016"
"34272","220385 FLORESTA DO PIAUI",1,0,0,16,0,17,"2016"
"34273","220390 FLORIANO",0,5,15,912,4,936,"2016"
"34274","220400 FRANCINOPOLIS",0,0,2,57,1,60,"2016"
"34275","220410 FRANCISCO AYRES",0,2,1,61,0,64,"2016"
"34276","220415 FRANCISCO MACEDO",0,0,5,24,0,29,"2016"
"34277","220420 FRANCISCO SANTOS",0,0,11,77,0,88,"2016"
"34278","220430 FRONTEIRAS",1,0,5,139,1,146,"2016"
"34279","220435 GEMINIANO",0,1,3,68,0,72,"2016"
"34280","220440 GILBUES",4,0,0,58,123,185,"2016"
"34281","220450 GUADALUPE",1,1,2,166,1,171,"2016"
"34282","220455 GUARIBAS",0,0,0,48,24,72,"2016"
"34283","220460 HUGO NAPOLEAO",0,0,0,45,2,47,"2016"
"34284","220465 ILHA GRANDE",0,0,1,138,0,139,"2016"
"34285","220470 INHUMA",1,0,2,187,1,191,"2016"
"34286","220480 IPIRANGA DO PIAUI",1,0,5,101,0,107,"2016"
"34287","220490 ISAIAS COELHO",0,1,3,102,5,111,"2016"
"34288","220500 ITAINOPOLIS",0,0,4,107,0,111,"2016"
"34289","220510 ITAUEIRA",2,1,4,128,1,136,"2016"
"34290","220515 JACOBINA DO PIAUI",0,0,1,47,29,77,"2016"
"34291","220520 JAICOS",3,3,12,251,1,270,"2016"
"34292","220525 JARDIM DO MULATO",0,0,0,32,7,39,"2016"
"34293","220527 JATOBA DO PIAUI",0,1,2,14,31,48,"2016"
"34294","220530 JERUMENHA",0,0,1,71,1,73,"2016"
"34295","220535 JOAO COSTA",0,0,1,40,1,42,"2016"
"34296","220540 JOAQUIM PIRES",0,0,3,184,8,195,"2016"
"34297","220545 JOCA MARQUES",1,0,2,79,1,83,"2016"
"34298","220550 JOSE DE FREITAS",5,3,6,539,5,558,"2016"
"34299","220551 JUAZEIRO DO PIAUI",1,0,1,30,25,57,"2016"
"34300","220552 JULIO BORGES",1,0,1,40,34,76,"2016"
"34301","220553 JUREMA",0,0,0,53,11,64,"2016"
"34302","220554 LAGOINHA DO PIAUI",0,1,0,46,3,50,"2016"
"34303","220555 LAGOA ALEGRE",0,2,1,83,27,113,"2016"
"34304","220556 LAGOA DO BARRO DO PIAUI",0,0,1,51,13,65,"2016"
"34305","220557 LAGOA DE SAO FRANCISCO",0,0,2,64,5,71,"2016"
"34306","220558 LAGOA DO PIAUI",0,0,4,51,1,56,"2016"
"34307","220559 LAGOA DO SITIO",1,1,1,62,1,66,"2016"
"34308","220560 LANDRI SALES",0,1,0,55,1,57,"2016"
"34309","220570 LUIS CORREIA",1,3,11,416,8,439,"2016"
"34310","220580 LUZILANDIA",0,0,7,331,5,343,"2016"
"34311","220585 MADEIRO",0,2,1,107,2,112,"2016"
"34312","220590 MANOEL EMIDIO",11,0,1,57,6,75,"2016"
"34313","220595 MARCOLANDIA",0,2,7,113,0,122,"2016"
"34314","220600 MARCOS PARENTE",0,1,3,49,0,53,"2016"
"34315","220605 MASSAPE DO PIAUI",0,1,2,68,0,71,"2016"
"34316","220610 MATIAS OLIMPIO",0,1,2,148,1,152,"2016"
"34317","220620 MIGUEL ALVES",6,4,14,461,29,514,"2016"
"34318","220630 MIGUEL LEAO",0,0,0,16,0,16,"2016"
"34319","220635 MILTON BRANDAO",0,0,1,43,11,55,"2016"
"34320","220640 MONSENHOR GIL",1,1,1,128,3,134,"2016"
"34321","220650 MONSENHOR HIPOLITO",1,0,6,75,0,82,"2016"
"34322","220660 MONTE ALEGRE DO PIAUI",5,3,4,94,66,172,"2016"
"34323","220665 MORRO CABECA NO TEMPO",0,0,0,32,39,71,"2016"
"34324","220667 MORRO DO CHAPEU DO PIAUI",0,0,1,116,0,117,"2016"
"34325","220669 MURICI DOS PORTELAS",0,0,1,105,4,110,"2016"
"34326","220670 NAZARE DO PIAUI",0,1,1,74,0,76,"2016"
"34327","220672 NAZARIA",0,1,2,153,3,159,"2016"
"34328","220675 NOSSA SENHORA DE NAZARE",0,0,0,7,40,47,"2016"
"34329","220680 NOSSA SENHORA DOS REMEDIOS",1,0,5,153,12,171,"2016"
"34330","220690 NOVO ORIENTE DO PIAUI",0,0,0,69,1,70,"2016"
"34331","220695 NOVO SANTO ANTONIO",0,0,0,33,6,39,"2016"
"34332","220700 OEIRAS",3,1,9,417,0,430,"2016"
"34333","220710 OLHO D'AGUA DO PIAUI",0,0,1,41,1,43,"2016"
"34334","220720 PADRE MARCOS",0,1,10,75,2,88,"2016"
"34335","220730 PAES LANDIM",0,0,2,75,0,77,"2016"
"34336","220735 PAJEU DO PIAUI",0,1,0,26,1,28,"2016"
"34337","220740 PALMEIRA DO PIAUI",0,0,0,42,34,76,"2016"
"34338","220750 PALMEIRAIS",1,0,5,163,36,205,"2016"
"34339","220755 PAQUETA",0,1,1,29,0,31,"2016"
"34340","220760 PARNAGUA",0,1,1,33,131,166,"2016"
"34341","220770 PARNAIBA",5,9,29,2239,37,2319,"2016"
"34342","220775 PASSAGEM FRANCA DO PIAUI",0,1,1,51,2,55,"2016"
"34343","220777 PATOS DO PIAUI",0,1,5,43,7,56,"2016"
"34344","220779 PAU D'ARCO DO PIAUI",0,0,1,43,2,46,"2016"
"34345","220780 PAULISTANA",1,1,6,170,153,331,"2016"
"34346","220785 PAVUSSU",0,1,0,41,0,42,"2016"
"34347","220790 PEDRO II",2,6,11,426,70,515,"2016"
"34348","220793 PEDRO LAURENTINO",0,0,0,24,1,25,"2016"
"34349","220795 NOVA SANTA RITA",1,1,0,58,2,62,"2016"
"34350","220800 PICOS",5,2,52,1019,0,1078,"2016"
"34351","220810 PIMENTEIRAS",0,1,1,130,0,132,"2016"
"34352","220820 PIO IX",1,2,17,217,0,237,"2016"
"34353","220830 PIRACURUCA",3,1,1,432,1,438,"2016"
"34354","220840 PIRIPIRI",3,8,13,925,6,955,"2016"
"34355","220850 PORTO",1,0,9,190,13,213,"2016"
"34356","220855 PORTO ALEGRE DO PIAUI",0,1,0,32,0,33,"2016"
"34357","220860 PRATA DO PIAUI",0,0,1,41,1,43,"2016"
"34358","220865 QUEIMADA NOVA",0,1,2,44,49,96,"2016"
"34359","220870 REDENCAO DO GURGUEIA",0,1,1,53,67,122,"2016"
"34360","220880 REGENERACAO",3,1,3,239,15,261,"2016"
"34361","220885 RIACHO FRIO",0,0,0,7,58,65,"2016"
"34362","220887 RIBEIRA DO PIAUI",0,0,2,47,1,50,"2016"
"34363","220890 RIBEIRO GONCALVES",0,1,0,29,90,120,"2016"
"34364","220900 RIO GRANDE DO PIAUI",0,0,2,67,1,70,"2016"
"34365","220910 SANTA CRUZ DO PIAUI",1,0,2,76,0,79,"2016"
"34366","220915 SANTA CRUZ DOS MILAGRES",1,2,0,54,0,57,"2016"
"34367","220920 SANTA FILOMENA",0,0,4,76,15,95,"2016"
"34368","220930 SANTA LUZ",0,0,0,36,30,66,"2016"
"34369","220935 SANTANA DO PIAUI",0,2,2,32,0,36,"2016"
"34370","220937 SANTA ROSA DO PIAUI",0,0,1,49,0,50,"2016"
"34371","220940 SANTO ANTONIO DE LISBOA",0,0,2,86,0,88,"2016"
"34372","220945 SANTO ANTONIO DOS MILAGRES",0,0,1,27,4,32,"2016"
"34373","220950 SANTO INACIO DO PIAUI",1,0,0,40,0,41,"2016"
"34374","220955 SAO BRAZ DO PIAUI",0,0,0,66,6,72,"2016"
"34375","220960 SAO FELIX DO PIAUI",0,0,0,19,3,22,"2016"
"34376","220965 SAO FRANCISCO DE ASSIS DO PIAUI",0,0,3,71,6,80,"2016"
"34377","220970 SAO FRANCISCO DO PIAUI",0,0,2,63,0,65,"2016"
"34378","220975 SAO GONCALO DO GURGUEIA",0,0,0,6,21,27,"2016"
"34379","220980 SAO GONCALO DO PIAUI",0,0,0,60,5,65,"2016"
"34380","220985 SAO JOAO DA CANABRAVA",0,0,0,47,0,47,"2016"
"34381","220987 SAO JOAO DA FRONTEIRA",0,0,1,70,1,72,"2016"
"34382","220990 SAO JOAO DA SERRA",0,0,2,48,22,72,"2016"
"34383","220995 SAO JOAO DA VARJOTA",0,0,2,55,0,57,"2016"
"34384","220997 SAO JOAO DO ARRAIAL",0,0,4,107,2,113,"2016"
"34385","221000 SAO JOAO DO PIAUI",1,2,9,314,2,328,"2016"
"34386","221005 SAO JOSE DO DIVINO",2,0,2,56,0,60,"2016"
"34387","221010 SAO JOSE DO PEIXE",0,0,1,41,0,42,"2016"
"34388","221020 SAO JOSE DO PIAUI",0,1,1,72,1,75,"2016"
"34389","221030 SAO JULIAO",0,1,6,66,0,73,"2016"
"34390","221035 SAO LOURENCO DO PIAUI",1,0,1,45,10,57,"2016"
"34391","221037 SAO LUIS DO PIAUI",0,0,0,34,0,34,"2016"
"34392","221038 SAO MIGUEL DA BAIXA GRANDE",0,0,1,21,1,23,"2016"
"34393","221039 SAO MIGUEL DO FIDALGO",0,0,1,28,0,29,"2016"
"34394","221040 SAO MIGUEL DO TAPUIO",2,0,1,192,28,223,"2016"
"34395","221050 SAO PEDRO DO PIAUI",0,0,3,172,27,202,"2016"
"34396","221060 SAO RAIMUNDO NONATO",0,1,6,401,159,567,"2016"
"34397","221062 SEBASTIAO BARROS",0,0,1,13,32,46,"2016"
"34398","221063 SEBASTIAO LEAL",0,0,1,46,6,53,"2016"
"34399","221065 SIGEFREDO PACHECO",0,1,1,35,63,100,"2016"
"34400","221070 SIMOES",0,1,4,227,0,232,"2016"
"34401","221080 SIMPLICIO MENDES",0,1,3,189,1,194,"2016"
"34402","221090 SOCORRO DO PIAUI",0,0,0,46,0,46,"2016"
"34403","221093 SUSSUAPARA",1,0,3,86,0,90,"2016"
"34404","221095 TAMBORIL DO PIAUI",0,0,0,38,8,46,"2016"
"34405","221097 TANQUE DO PIAUI",0,0,1,33,0,34,"2016"
"34406","221100 TERESINA",65,37,121,13201,50,13474,"2016"
"34407","221110 UNIAO",2,2,5,400,225,634,"2016"
"34408","221120 URUCUI",0,0,0,119,301,420,"2016"
"34409","221130 VALENCA DO PIAUI",1,1,2,321,1,326,"2016"
"34410","221135 VARZEA BRANCA",0,0,1,57,20,78,"2016"
"34411","221140 VARZEA GRANDE",1,0,0,51,0,52,"2016"
"34412","221150 VERA MENDES",0,0,1,30,0,31,"2016"
"34413","221160 VILA NOVA DO PIAUI",0,0,1,39,0,40,"2016"
"34414","221170 WALL FERRAZ",1,0,3,30,0,34,"2016"
"34415","MUNICIPIO IGNORADO - CE",0,0,0,1,0,1,"2016"
"34416","230010 ABAIARA",1,0,1,118,0,120,"2016"
"34417","230015 ACARAPE",3,2,3,215,3,226,"2016"
"34418","230020 ACARAU",0,5,17,985,3,1010,"2016"
"34419","230030 ACOPIARA",0,4,34,543,3,584,"2016"
"34420","230040 AIUABA",0,1,13,154,4,172,"2016"
"34421","230050 ALCANTARAS",0,0,3,115,0,118,"2016"
"34422","230060 ALTANEIRA",0,2,4,106,0,112,"2016"
"34423","230070 ALTO SANTO",0,0,5,212,0,217,"2016"
"34424","230075 AMONTADA",0,3,23,488,175,689,"2016"
"34425","230080 ANTONINA DO NORTE",0,0,3,76,0,79,"2016"
"34426","230090 APUIARES",1,1,3,126,2,133,"2016"
"34427","230100 AQUIRAZ",4,6,18,1092,3,1123,"2016"
"34428","230110 ARACATI",3,0,12,1026,5,1046,"2016"
"34429","230120 ARACOIABA",1,1,9,383,1,395,"2016"
"34430","230125 ARARENDA",1,2,0,111,1,115,"2016"
"34431","230130 ARARIPE",0,3,15,336,0,354,"2016"
"34432","230140 ARATUBA",0,1,4,146,1,152,"2016"
"34433","230150 ARNEIROZ",0,0,10,73,1,84,"2016"
"34434","230160 ASSARE",0,2,9,257,3,271,"2016"
"34435","230170 AURORA",0,1,9,295,1,306,"2016"
"34436","230180 BAIXIO",0,1,3,46,0,50,"2016"
"34437","230185 BANABUIU",0,1,8,277,5,291,"2016"
"34438","230190 BARBALHA",1,0,25,1018,82,1126,"2016"
"34439","230195 BARREIRA",2,1,1,295,0,299,"2016"
"34440","230200 BARRO",1,1,7,199,2,210,"2016"
"34441","230205 BARROQUINHA",0,0,6,237,0,243,"2016"
"34442","230210 BATURITE",2,1,8,467,3,481,"2016"
"34443","230220 BEBERIBE",5,2,7,653,5,672,"2016"
"34444","230230 BELA CRUZ",2,2,6,377,0,387,"2016"
"34445","230240 BOA VIAGEM",2,1,6,603,1,613,"2016"
"34446","230250 BREJO SANTO",2,9,12,673,3,699,"2016"
"34447","230260 CAMOCIM",4,11,26,900,3,944,"2016"
"34448","230270 CAMPOS SALES",1,1,9,363,5,379,"2016"
"34449","230280 CANINDE",1,1,11,1033,10,1056,"2016"
"34450","230290 CAPISTRANO",3,0,4,221,0,228,"2016"
"34451","230300 CARIDADE",1,0,3,221,1,226,"2016"
"34452","230310 CARIRE",0,2,4,201,0,207,"2016"
"34453","230320 CARIRIACU",0,3,23,363,2,391,"2016"
"34454","230330 CARIUS",2,0,7,188,1,198,"2016"
"34455","230340 CARNAUBAL",1,2,4,227,0,234,"2016"
"34456","230350 CASCAVEL",0,3,16,953,6,978,"2016"
"34457","230360 CATARINA",0,1,5,122,0,128,"2016"
"34458","230365 CATUNDA",0,0,0,78,0,78,"2016"
"34459","230370 CAUCAIA",10,17,78,4906,33,5044,"2016"
"34460","230380 CEDRO",1,0,2,271,4,278,"2016"
"34461","230390 CHAVAL",0,2,2,179,10,193,"2016"
"34462","230393 CHORO",2,0,2,186,1,191,"2016"
"34463","230395 CHOROZINHO",1,3,4,251,4,263,"2016"
"34464","230400 COREAU",0,2,6,270,2,280,"2016"
"34465","230410 CRATEUS",1,6,24,913,10,954,"2016"
"34466","230420 CRATO",9,21,67,2038,8,2143,"2016"
"34467","230423 CROATA",0,2,5,184,1,192,"2016"
"34468","230425 CRUZ",0,0,7,407,1,415,"2016"
"34469","230426 DEPUTADO IRAPUAN PINHEIRO",0,1,2,80,0,83,"2016"
"34470","230427 ERERE",0,0,1,14,0,15,"2016"
"34471","230428 EUSEBIO",1,3,23,1219,4,1250,"2016"
"34472","230430 FARIAS BRITO",1,2,5,201,1,210,"2016"
"34473","230435 FORQUILHA",0,0,4,261,0,265,"2016"
"34474","230440 FORTALEZA",89,126,530,36509,197,37451,"2016"
"34475","230445 FORTIM",0,1,0,175,1,177,"2016"
"34476","230450 FRECHEIRINHA",0,1,2,203,1,207,"2016"
"34477","230460 GENERAL SAMPAIO",2,0,1,81,4,88,"2016"
"34478","230465 GRACA",1,0,8,178,0,187,"2016"
"34479","230470 GRANJA",1,6,13,706,3,729,"2016"
"34480","230480 GRANJEIRO",0,1,4,58,0,63,"2016"
"34481","230490 GROAIRAS",1,0,3,116,0,120,"2016"
"34482","230495 GUAIUBA",0,2,3,343,5,353,"2016"
"34483","230500 GUARACIABA DO NORTE",2,2,22,598,2,626,"2016"
"34484","230510 GUARAMIRANGA",0,1,2,71,1,75,"2016"
"34485","230520 HIDROLANDIA",0,1,5,175,0,181,"2016"
"34486","230523 HORIZONTE",2,3,24,962,127,1118,"2016"
"34487","230526 IBARETAMA",0,2,7,202,2,213,"2016"
"34488","230530 IBIAPINA",3,1,7,347,2,360,"2016"
"34489","230533 IBICUITINGA",0,0,1,138,2,141,"2016"
"34490","230535 ICAPUI",1,0,5,237,1,244,"2016"
"34491","230540 ICO",1,2,14,823,1,841,"2016"
"34492","230550 IGUATU",4,13,77,1154,8,1256,"2016"
"34493","230560 INDEPENDENCIA",0,1,7,245,7,260,"2016"
"34494","230565 IPAPORANGA",0,0,3,134,3,140,"2016"
"34495","230570 IPAUMIRIM",2,0,2,120,1,125,"2016"
"34496","230580 IPU",0,1,13,538,3,555,"2016"
"34497","230590 IPUEIRAS",1,3,18,428,3,453,"2016"
"34498","230600 IRACEMA",1,1,4,176,0,182,"2016"
"34499","230610 IRAUCUBA",0,0,7,296,1,304,"2016"
"34500","230620 ITAICABA",0,1,2,94,0,97,"2016"
"34501","230625 ITAITINGA",0,0,9,613,2,624,"2016"
"34502","230630 ITAPAGE",3,5,13,681,0,702,"2016"
"34503","230640 ITAPIPOCA",2,2,53,1438,493,1988,"2016"
"34504","230650 ITAPIUNA",0,1,4,219,1,225,"2016"
"34505","230655 ITAREMA",1,5,11,607,3,627,"2016"
"34506","230660 ITATIRA",0,0,2,271,4,277,"2016"
"34507","230670 JAGUARETAMA",0,2,5,160,2,169,"2016"
"34508","230680 JAGUARIBARA",1,1,1,142,0,145,"2016"
"34509","230690 JAGUARIBE",0,2,5,383,2,392,"2016"
"34510","230700 JAGUARUANA",2,6,17,410,5,440,"2016"
"34511","230710 JARDIM",1,1,14,416,18,450,"2016"
"34512","230720 JATI",0,2,3,136,1,142,"2016"
"34513","230725 JIJOCA DE JERICOACOARA",1,1,6,295,3,306,"2016"
"34514","230730 JUAZEIRO DO NORTE",6,17,212,3915,41,4191,"2016"
"34515","230740 JUCAS",0,2,15,290,0,307,"2016"
"34516","230750 LAVRAS DA MANGABEIRA",0,2,2,365,2,371,"2016"
"34517","230760 LIMOEIRO DO NORTE",1,0,10,757,2,770,"2016"
"34518","230763 MADALENA",0,1,8,183,2,194,"2016"
"34519","230765 MARACANAU",7,15,53,4302,21,4398,"2016"
"34520","230770 MARANGUAPE",4,6,24,1521,9,1564,"2016"
"34521","230780 MARCO",4,0,10,480,2,496,"2016"
"34522","230790 MARTINOPOLE",1,1,1,140,1,144,"2016"
"34523","230800 MASSAPE",1,1,11,468,3,484,"2016"
"34524","230810 MAURITI",2,1,7,651,1,662,"2016"
"34525","230820 MERUOCA",1,2,6,165,2,176,"2016"
"34526","230830 MILAGRES",1,3,6,351,1,362,"2016"
"34527","230835 MILHA",0,2,6,151,0,159,"2016"
"34528","230837 MIRAIMA",0,0,4,130,41,175,"2016"
"34529","230840 MISSAO VELHA",1,4,16,501,25,547,"2016"
"34530","230850 MOMBACA",1,5,15,453,2,476,"2016"
"34531","230860 MONSENHOR TABOSA",0,0,7,229,3,239,"2016"
"34532","230870 MORADA NOVA",0,3,11,705,1,720,"2016"
"34533","230880 MORAUJO",0,0,3,91,0,94,"2016"
"34534","230890 MORRINHOS",1,3,6,240,1,251,"2016"
"34535","230900 MUCAMBO",1,0,6,156,0,163,"2016"
"34536","230910 MULUNGU",0,0,3,127,2,132,"2016"
"34537","230920 NOVA OLINDA",0,2,10,234,1,247,"2016"
"34538","230930 NOVA RUSSAS",1,1,6,340,3,351,"2016"
"34539","230940 NOVO ORIENTE",1,4,5,348,4,362,"2016"
"34540","230945 OCARA",0,1,5,265,4,275,"2016"
"34541","230950 OROS",0,1,7,278,1,287,"2016"
"34542","230960 PACAJUS",0,4,20,834,7,865,"2016"
"34543","230970 PACATUBA",3,3,14,936,6,962,"2016"
"34544","230980 PACOTI",0,2,5,156,0,163,"2016"
"34545","230990 PACUJA",0,0,0,64,0,64,"2016"
"34546","231000 PALHANO",0,1,3,107,0,111,"2016"
"34547","231010 PALMACIA",1,0,3,105,1,110,"2016"
"34548","231020 PARACURU",1,4,6,601,4,616,"2016"
"34549","231025 PARAIPABA",1,0,8,422,1,432,"2016"
"34550","231030 PARAMBU",0,0,8,391,1,400,"2016"
"34551","231040 PARAMOTI",0,2,6,118,3,129,"2016"
"34552","231050 PEDRA BRANCA",2,2,14,477,2,497,"2016"
"34553","231060 PENAFORTE",0,1,3,176,2,182,"2016"
"34554","231070 PENTECOSTE",1,2,1,437,2,443,"2016"
"34555","231080 PEREIRO",1,1,2,197,1,202,"2016"
"34556","231085 PINDORETAMA",1,1,6,298,0,306,"2016"
"34557","231090 PIQUET CARNEIRO",0,0,5,154,0,159,"2016"
"34558","231095 PIRES FERREIRA",0,1,3,87,0,91,"2016"
"34559","231100 PORANGA",0,1,3,176,4,184,"2016"
"34560","231110 PORTEIRAS",0,0,7,228,3,238,"2016"
"34561","231120 POTENGI",0,0,2,120,0,122,"2016"
"34562","231123 POTIRETAMA",0,1,0,65,0,66,"2016"
"34563","231126 QUITERIANOPOLIS",0,3,8,203,0,214,"2016"
"34564","231130 QUIXADA",4,5,22,1243,3,1277,"2016"
"34565","231135 QUIXELO",0,1,6,153,3,163,"2016"
"34566","231140 QUIXERAMOBIM",5,4,29,1033,3,1074,"2016"
"34567","231150 QUIXERE",0,0,6,258,0,264,"2016"
"34568","231160 REDENCAO",0,3,2,370,1,376,"2016"
"34569","231170 RERIUTABA",0,0,6,204,1,211,"2016"
"34570","231180 RUSSAS",4,8,22,880,2,916,"2016"
"34571","231190 SABOEIRO",0,1,8,184,1,194,"2016"
"34572","231195 SALITRE",2,1,11,243,0,257,"2016"
"34573","231200 SANTANA DO ACARAU",1,1,7,368,7,384,"2016"
"34574","231210 SANTANA DO CARIRI",1,0,11,214,2,228,"2016"
"34575","231220 SANTA QUITERIA",1,0,5,291,0,297,"2016"
"34576","231230 SAO BENEDITO",2,3,10,759,1,775,"2016"
"34577","231240 SAO GONCALO DO AMARANTE",5,1,12,922,3,943,"2016"
"34578","231250 SAO JOAO DO JAGUARIBE",0,0,0,81,0,81,"2016"
"34579","231260 SAO LUIS DO CURU",0,4,1,169,0,174,"2016"
"34580","231270 SENADOR POMPEU",2,4,8,289,0,303,"2016"
"34581","231280 SENADOR SA",0,0,2,96,0,98,"2016"
"34582","231290 SOBRAL",11,10,79,3179,9,3288,"2016"
"34583","231300 SOLONOPOLE",0,0,3,200,1,204,"2016"
"34584","231310 TABULEIRO DO NORTE",2,2,3,366,0,373,"2016"
"34585","231320 TAMBORIL",0,0,10,270,4,284,"2016"
"34586","231325 TARRAFAS",1,2,2,90,1,96,"2016"
"34587","231330 TAUA",0,3,31,726,0,760,"2016"
"34588","231335 TEJUCUOCA",0,1,5,264,4,274,"2016"
"34589","231340 TIANGUA",2,4,18,1392,4,1420,"2016"
"34590","231350 TRAIRI",1,4,24,617,138,784,"2016"
"34591","231355 TURURU",0,2,8,208,69,287,"2016"
"34592","231360 UBAJARA",3,6,9,526,4,548,"2016"
"34593","231370 UMARI",0,1,3,61,0,65,"2016"
"34594","231375 UMIRIM",0,1,3,210,53,267,"2016"
"34595","231380 URUBURETAMA",2,1,5,267,80,355,"2016"
"34596","231390 URUOCA",2,1,2,144,0,149,"2016"
"34597","231395 VARJOTA",0,1,3,269,0,273,"2016"
"34598","231400 VARZEA ALEGRE",1,2,15,468,0,486,"2016"
"34599","231410 VICOSA DO CEARA",1,2,16,909,3,931,"2016"
"34600","MUNICIPIO IGNORADO - RN",0,0,0,1,0,1,"2016"
"34601","240010 ACARI",1,0,4,104,0,109,"2016"
"34602","240020 ACU",1,2,8,763,2,776,"2016"
"34603","240030 AFONSO BEZERRA",1,0,1,113,1,116,"2016"
"34604","240040 AGUA NOVA",0,0,0,40,0,40,"2016"
"34605","240050 ALEXANDRIA",1,1,2,180,1,185,"2016"
"34606","240060 ALMINO AFONSO",0,0,1,63,0,64,"2016"
"34607","240070 ALTO DO RODRIGUES",0,1,2,144,0,147,"2016"
"34608","240080 ANGICOS",0,3,1,130,2,136,"2016"
"34609","240090 ANTONIO MARTINS",1,0,0,76,0,77,"2016"
"34610","240100 APODI",4,0,3,398,2,407,"2016"
"34611","240110 AREIA BRANCA",0,3,5,315,2,325,"2016"
"34612","240120 ARES",1,1,2,202,1,207,"2016"
"34613","240130 AUGUSTO SEVERO",0,0,1,80,0,81,"2016"
"34614","240140 BAIA FORMOSA",0,0,1,107,2,110,"2016"
"34615","240145 BARAUNA",0,1,7,380,6,394,"2016"
"34616","240150 BARCELONA",0,2,0,38,0,40,"2016"
"34617","240160 BENTO FERNANDES",1,0,4,62,1,68,"2016"
"34618","240165 BODO",0,0,1,31,0,32,"2016"
"34619","240170 BOM JESUS",0,0,3,106,3,112,"2016"
"34620","240180 BREJINHO",0,1,3,177,1,182,"2016"
"34621","240185 CAICARA DO NORTE",0,1,1,77,2,81,"2016"
"34622","240190 CAICARA DO RIO DO VENTO",0,0,2,57,0,59,"2016"
"34623","240200 CAICO",2,4,33,659,1,699,"2016"
"34624","240210 CAMPO REDONDO",0,1,3,133,0,137,"2016"
"34625","240220 CANGUARETAMA",3,3,7,488,4,505,"2016"
"34626","240230 CARAUBAS",0,1,6,214,2,223,"2016"
"34627","240240 CARNAUBA DOS DANTAS",0,0,0,68,0,68,"2016"
"34628","240250 CARNAUBAIS",0,1,0,101,0,102,"2016"
"34629","240260 CEARA-MIRIM",2,2,25,1022,9,1060,"2016"
"34630","240270 CERRO CORA",0,1,5,121,1,128,"2016"
"34631","240280 CORONEL EZEQUIEL",1,1,0,68,0,70,"2016"
"34632","240290 CORONEL JOAO PESSOA",0,0,0,67,0,67,"2016"
"34633","240300 CRUZETA",0,0,3,72,0,75,"2016"
"34634","240310 CURRAIS NOVOS",0,0,24,431,1,456,"2016"
"34635","240320 DOUTOR SEVERIANO",1,0,0,102,0,103,"2016"
"34636","240325 PARNAMIRIM",17,10,48,3732,4,3811,"2016"
"34637","240330 ENCANTO",0,0,1,80,0,81,"2016"
"34638","240340 EQUADOR",0,0,5,56,0,61,"2016"
"34639","240350 ESPIRITO SANTO",0,1,0,92,1,94,"2016"
"34640","240360 EXTREMOZ",1,3,8,549,3,564,"2016"
"34641","240370 FELIPE GUERRA",0,1,1,72,0,74,"2016"
"34642","240375 FERNANDO PEDROZA",0,0,1,29,0,30,"2016"
"34643","240380 FLORANIA",0,0,6,90,1,97,"2016"
"34644","240390 FRANCISCO DANTAS",0,0,0,32,0,32,"2016"
"34645","240400 FRUTUOSO GOMES",0,0,0,54,0,54,"2016"
"34646","240410 GALINHOS",0,0,1,33,0,34,"2016"
"34647","240420 GOIANINHA",0,2,8,463,4,477,"2016"
"34648","240430 GOVERNADOR DIX-SEPT ROSADO",0,2,1,134,0,137,"2016"
"34649","240440 GROSSOS",0,0,2,126,1,129,"2016"
"34650","240450 GUAMARE",0,0,3,255,0,258,"2016"
"34651","240460 IELMO MARINHO",0,1,3,142,2,148,"2016"
"34652","240470 IPANGUACU",1,0,0,203,4,208,"2016"
"34653","240480 IPUEIRA",0,0,2,13,0,15,"2016"
"34654","240485 ITAJA",0,2,1,109,1,113,"2016"
"34655","240490 ITAU",0,2,0,74,0,76,"2016"
"34656","240500 JACANA",0,0,0,112,0,112,"2016"
"34657","240510 JANDAIRA",0,1,0,85,0,86,"2016"
"34658","240520 JANDUIS",0,0,1,56,2,59,"2016"
"34659","240530 JANUARIO CICCO",0,1,4,118,1,124,"2016"
"34660","240540 JAPI",0,0,2,113,1,116,"2016"
"34661","240550 JARDIM DE ANGICOS",0,0,0,24,0,24,"2016"
"34662","240560 JARDIM DE PIRANHAS",2,1,7,158,0,168,"2016"
"34663","240570 JARDIM DO SERIDO",0,0,5,89,0,94,"2016"
"34664","240580 JOAO CAMARA",2,4,6,493,7,512,"2016"
"34665","240590 JOAO DIAS",0,0,0,26,0,26,"2016"
"34666","240600 JOSE DA PENHA",0,0,2,66,0,68,"2016"
"34667","240610 JUCURUTU",3,0,3,194,0,200,"2016"
"34668","240615 JUNDIA",0,0,0,17,0,17,"2016"
"34669","240620 LAGOA D'ANTA",0,2,2,85,2,91,"2016"
"34670","240630 LAGOA DE PEDRAS",0,2,3,100,0,105,"2016"
"34671","240640 LAGOA DE VELHOS",0,0,0,41,1,42,"2016"
"34672","240650 LAGOA NOVA",2,1,16,217,0,236,"2016"
"34673","240660 LAGOA SALGADA",2,0,2,125,3,132,"2016"
"34674","240670 LAJES",0,2,3,94,1,100,"2016"
"34675","240680 LAJES PINTADAS",0,0,1,55,0,56,"2016"
"34676","240690 LUCRECIA",0,0,1,31,1,33,"2016"
"34677","240700 LUIS GOMES",0,0,0,142,0,142,"2016"
"34678","240710 MACAIBA",2,4,13,902,8,929,"2016"
"34679","240720 MACAU",1,0,6,345,2,354,"2016"
"34680","240725 MAJOR SALES",0,0,0,56,0,56,"2016"
"34681","240730 MARCELINO VIEIRA",0,0,0,80,0,80,"2016"
"34682","240740 MARTINS",0,1,0,85,1,87,"2016"
"34683","240750 MAXARANGUAPE",1,0,5,132,1,139,"2016"
"34684","240760 MESSIAS TARGINO",0,0,0,52,0,52,"2016"
"34685","240770 MONTANHAS",2,0,0,143,1,146,"2016"
"34686","240780 MONTE ALEGRE",0,1,4,288,4,297,"2016"
"34687","240790 MONTE DAS GAMELEIRAS",0,0,2,46,0,48,"2016"
"34688","240800 MOSSORO",5,12,33,3691,19,3760,"2016"
"34689","240810 NATAL",29,41,161,11238,48,11517,"2016"
"34690","240820 NISIA FLORESTA",1,3,5,394,2,405,"2016"
"34691","240830 NOVA CRUZ",3,3,10,439,5,460,"2016"
"34692","240840 OLHO-D'AGUA DO BORGES",0,0,0,20,0,20,"2016"
"34693","240850 OURO BRANCO",0,0,5,55,0,60,"2016"
"34694","240860 PARANA",0,0,1,61,0,62,"2016"
"34695","240870 PARAU",0,0,0,37,0,37,"2016"
"34696","240880 PARAZINHO",0,1,2,88,3,94,"2016"
"34697","240890 PARELHAS",0,0,4,306,1,311,"2016"
"34698","240895 RIO DO FOGO",1,0,3,150,0,154,"2016"
"34699","240910 PASSA E FICA",0,4,6,134,2,146,"2016"
"34700","240920 PASSAGEM",1,1,0,37,1,40,"2016"
"34701","240930 PATU",0,1,3,158,0,162,"2016"
"34702","240933 SANTA MARIA",0,0,1,70,0,71,"2016"
"34703","240940 PAU DOS FERROS",0,1,1,391,0,393,"2016"
"34704","240950 PEDRA GRANDE",1,0,1,44,0,46,"2016"
"34705","240960 PEDRA PRETA",0,0,1,32,0,33,"2016"
"34706","240970 PEDRO AVELINO",0,1,0,69,2,72,"2016"
"34707","240980 PEDRO VELHO",0,1,0,196,2,199,"2016"
"34708","240990 PENDENCIAS",0,0,1,127,2,130,"2016"
"34709","241000 PILOES",0,0,0,33,0,33,"2016"
"34710","241010 POCO BRANCO",0,0,2,145,0,147,"2016"
"34711","241020 PORTALEGRE",0,0,0,109,0,109,"2016"
"34712","241025 PORTO DO MANGUE",0,1,0,82,0,83,"2016"
"34713","241030 SERRA CAIADA",0,1,1,139,0,141,"2016"
"34714","241040 PUREZA",0,0,1,101,1,103,"2016"
"34715","241050 RAFAEL FERNANDES",0,0,0,51,0,51,"2016"
"34716","241060 RAFAEL GODEIRO",0,0,0,19,0,19,"2016"
"34717","241070 RIACHO DA CRUZ",0,0,0,34,0,34,"2016"
"34718","241080 RIACHO DE SANTANA",0,0,0,48,0,48,"2016"
"34719","241090 RIACHUELO",0,2,6,93,0,101,"2016"
"34720","241100 RODOLFO FERNANDES",0,1,1,56,0,58,"2016"
"34721","241105 TIBAU",0,1,2,77,0,80,"2016"
"34722","241110 RUY BARBOSA",0,0,0,33,0,33,"2016"
"34723","241120 SANTA CRUZ",1,1,15,593,2,612,"2016"
"34724","241140 SANTANA DO MATOS",0,0,3,107,0,110,"2016"
"34725","241142 SANTANA DO SERIDO",0,0,0,26,0,26,"2016"
"34726","241150 SANTO ANTONIO",2,1,3,319,1,326,"2016"
"34727","241160 SAO BENTO DO NORTE",0,0,0,34,1,35,"2016"
"34728","241170 SAO BENTO DO TRAIRI",0,0,0,40,1,41,"2016"
"34729","241180 SAO FERNANDO",0,0,1,28,0,29,"2016"
"34730","241190 SAO FRANCISCO DO OESTE",0,0,0,82,0,82,"2016"
"34731","241200 SAO GONCALO DO AMARANTE",6,8,15,1532,5,1566,"2016"
"34732","241210 SAO JOAO DO SABUGI",0,0,4,62,0,66,"2016"
"34733","241220 SAO JOSE DE MIPIBU",0,4,7,731,3,745,"2016"
"34734","241230 SAO JOSE DO CAMPESTRE",1,1,3,132,0,137,"2016"
"34735","241240 SAO JOSE DO SERIDO",1,1,2,34,0,38,"2016"
"34736","241250 SAO MIGUEL",1,0,6,347,0,354,"2016"
"34737","241255 SAO MIGUEL DO GOSTOSO",0,0,0,70,0,70,"2016"
"34738","241260 SAO PAULO DO POTENGI",0,0,7,213,0,220,"2016"
"34739","241270 SAO PEDRO",0,0,0,65,1,66,"2016"
"34740","241280 SAO RAFAEL",0,0,1,95,0,96,"2016"
"34741","241290 SAO TOME",0,1,0,119,1,121,"2016"
"34742","241300 SAO VICENTE",0,0,4,50,0,54,"2016"
"34743","241310 SENADOR ELOI DE SOUZA",0,1,3,84,1,89,"2016"
"34744","241320 SENADOR GEORGINO AVELINO",0,1,0,64,1,66,"2016"
"34745","241330 SERRA DE SAO BENTO",0,0,2,73,1,76,"2016"
"34746","241335 SERRA DO MEL",0,2,2,162,0,166,"2016"
"34747","241340 SERRA NEGRA DO NORTE",0,2,2,75,0,79,"2016"
"34748","241350 SERRINHA",0,1,1,75,1,78,"2016"
"34749","241355 SERRINHA DOS PINTOS",0,0,0,43,0,43,"2016"
"34750","241360 SEVERIANO MELO",0,1,0,85,0,86,"2016"
"34751","241370 SITIO NOVO",0,0,0,55,1,56,"2016"
"34752","241380 TABOLEIRO GRANDE",0,0,0,27,0,27,"2016"
"34753","241390 TAIPU",0,0,4,155,0,159,"2016"
"34754","241400 TANGARA",3,0,2,209,3,217,"2016"
"34755","241410 TENENTE ANANIAS",0,0,1,123,0,124,"2016"
"34756","241415 TENENTE LAURENTINO CRUZ",0,0,4,89,0,93,"2016"
"34757","241420 TIBAU DO SUL",2,1,5,234,6,248,"2016"
"34758","241430 TIMBAUBA DOS BATISTAS",0,1,0,18,0,19,"2016"
"34759","241440 TOUROS",3,1,7,407,0,418,"2016"
"34760","241445 TRIUNFO POTIGUAR",0,1,0,47,0,48,"2016"
"34761","241450 UMARIZAL",0,0,0,94,0,94,"2016"
"34762","241460 UPANEMA",0,0,2,154,1,157,"2016"
"34763","241470 VARZEA",0,0,1,64,0,65,"2016"
"34764","241475 VENHA-VER",0,0,0,47,0,47,"2016"
"34765","241480 VERA CRUZ",0,1,5,157,2,165,"2016"
"34766","241490 VICOSA",0,0,0,26,0,26,"2016"
"34767","241500 VILA FLOR",0,0,2,46,0,48,"2016"
"34768","250010 AGUA BRANCA",3,0,4,128,1,136,"2016"
"34769","250020 AGUIAR",0,0,1,61,4,66,"2016"
"34770","250030 ALAGOA GRANDE",0,1,7,321,8,337,"2016"
"34771","250040 ALAGOA NOVA",0,1,6,318,4,329,"2016"
"34772","250050 ALAGOINHA",1,2,6,231,0,240,"2016"
"34773","250053 ALCANTIL",0,0,0,130,1,131,"2016"
"34774","250057 ALGODAO DE JANDAIRA",0,1,0,56,1,58,"2016"
"34775","250060 ALHANDRA",0,1,10,395,2,408,"2016"
"34776","250070 SAO JOAO DO RIO DO PEIXE",0,1,4,186,1,192,"2016"
"34777","250073 AMPARO",0,0,1,37,0,38,"2016"
"34778","250077 APARECIDA",0,0,1,93,1,95,"2016"
"34779","250080 ARACAGI",0,0,3,205,3,211,"2016"
"34780","250090 ARARA",0,2,2,107,1,112,"2016"
"34781","250100 ARARUNA",0,2,7,179,0,188,"2016"
"34782","250110 AREIA",0,3,6,346,0,355,"2016"
"34783","250115 AREIA DE BARAUNAS",0,0,2,28,1,31,"2016"
"34784","250120 AREIAL",1,1,7,97,0,106,"2016"
"34785","250130 AROEIRAS",0,1,4,277,0,282,"2016"
"34786","250135 ASSUNCAO",0,0,0,59,1,60,"2016"
"34787","250140 BAIA DA TRAICAO",0,1,2,132,3,138,"2016"
"34788","250150 BANANEIRAS",0,2,8,280,0,290,"2016"
"34789","250153 BARAUNA",0,0,1,46,0,47,"2016"
"34790","250157 BARRA DE SANTANA",0,2,3,109,0,114,"2016"
"34791","250160 BARRA DE SANTA ROSA",1,1,3,132,1,138,"2016"
"34792","250170 BARRA DE SAO MIGUEL",0,0,1,65,0,66,"2016"
"34793","250180 BAYEUX",2,3,32,1194,7,1238,"2016"
"34794","250190 BELEM",0,1,2,204,1,208,"2016"
"34795","250200 BELEM DO BREJO DO CRUZ",0,0,0,87,0,87,"2016"
"34796","250205 BERNARDINO BATISTA",1,1,2,49,2,55,"2016"
"34797","250210 BOA VENTURA",0,0,3,83,0,86,"2016"
"34798","250215 BOA VISTA",0,0,0,89,0,89,"2016"
"34799","250220 BOM JESUS",0,0,1,39,1,41,"2016"
"34800","250230 BOM SUCESSO",0,0,1,48,0,49,"2016"
"34801","250240 BONITO DE SANTA FE",0,0,8,126,0,134,"2016"
"34802","250250 BOQUEIRAO",0,4,2,237,2,245,"2016"
"34803","250260 IGARACY",0,0,2,61,4,67,"2016"
"34804","250270 BORBOREMA",0,1,0,56,1,58,"2016"
"34805","250280 BREJO DO CRUZ",0,2,4,166,2,174,"2016"
"34806","250290 BREJO DOS SANTOS",0,0,1,98,0,99,"2016"
"34807","250300 CAAPORA",2,3,9,424,1,439,"2016"
"34808","250310 CABACEIRAS",0,0,1,47,0,48,"2016"
"34809","250320 CABEDELO",1,5,11,928,3,948,"2016"
"34810","250330 CACHOEIRA DOS INDIOS",0,1,2,126,0,129,"2016"
"34811","250340 CACIMBA DE AREIA",0,0,4,47,1,52,"2016"
"34812","250350 CACIMBA DE DENTRO",0,2,2,204,0,208,"2016"
"34813","250355 CACIMBAS",4,3,7,108,7,129,"2016"
"34814","250360 CAICARA",0,0,2,93,1,96,"2016"
"34815","250370 CAJAZEIRAS",1,2,20,821,5,849,"2016"
"34816","250375 CAJAZEIRINHAS",1,0,0,41,0,42,"2016"
"34817","250380 CALDAS BRANDAO",0,0,0,82,1,83,"2016"
"34818","250390 CAMALAU",0,0,1,72,0,73,"2016"
"34819","250400 CAMPINA GRANDE",10,31,88,5904,37,6070,"2016"
"34820","250403 CAPIM",1,0,1,105,1,108,"2016"
"34821","250407 CARAUBAS",0,0,0,57,0,57,"2016"
"34822","250410 CARRAPATEIRA",1,0,0,17,0,18,"2016"
"34823","250415 CASSERENGUE",0,2,2,92,1,97,"2016"
"34824","250420 CATINGUEIRA",1,0,4,61,2,68,"2016"
"34825","250430 CATOLE DO ROCHA",0,4,4,390,1,399,"2016"
"34826","250435 CATURITE",0,2,0,75,0,77,"2016"
"34827","250440 CONCEICAO",10,2,6,222,2,242,"2016"
"34828","250450 CONDADO",0,0,4,74,3,81,"2016"
"34829","250460 CONDE",2,3,13,480,4,502,"2016"
"34830","250470 CONGO",0,0,1,103,0,104,"2016"
"34831","250480 COREMAS",0,1,5,198,5,209,"2016"
"34832","250485 COXIXOLA",0,0,2,18,1,21,"2016"
"34833","250490 CRUZ DO ESPIRITO SANTO",0,1,6,280,0,287,"2016"
"34834","250500 CUBATI",0,1,4,88,0,93,"2016"
"34835","250510 CUITE",2,1,1,239,0,243,"2016"
"34836","250520 CUITEGI",0,1,4,125,1,131,"2016"
"34837","250523 CUITE DE MAMANGUAPE",1,0,3,88,0,92,"2016"
"34838","250527 CURRAL DE CIMA",1,0,1,69,0,71,"2016"
"34839","250530 CURRAL VELHO",0,0,1,23,0,24,"2016"
"34840","250535 DAMIAO",1,0,2,49,0,52,"2016"
"34841","250540 DESTERRO",0,1,5,123,1,130,"2016"
"34842","250550 VISTA SERRANA",0,1,1,50,0,52,"2016"
"34843","250560 DIAMANTE",0,1,2,69,2,74,"2016"
"34844","250570 DONA INES",1,1,1,144,0,147,"2016"
"34845","250580 DUAS ESTRADAS",0,0,1,50,0,51,"2016"
"34846","250590 EMAS",0,0,1,37,2,40,"2016"
"34847","250600 ESPERANCA",1,1,8,474,5,489,"2016"
"34848","250610 FAGUNDES",0,0,4,156,3,163,"2016"
"34849","250620 FREI MARTINHO",0,0,0,21,0,21,"2016"
"34850","250625 GADO BRAVO",0,1,3,119,0,123,"2016"
"34851","250630 GUARABIRA",1,6,8,819,0,834,"2016"
"34852","250640 GURINHEM",0,0,2,195,3,200,"2016"
"34853","250650 GURJAO",0,0,3,42,0,45,"2016"
"34854","250660 IBIARA",1,0,2,66,1,70,"2016"
"34855","250670 IMACULADA",0,1,8,157,9,175,"2016"
"34856","250680 INGA",0,1,2,246,2,251,"2016"
"34857","250690 ITABAIANA",0,1,6,340,1,348,"2016"
"34858","250700 ITAPORANGA",2,2,9,295,3,311,"2016"
"34859","250710 ITAPOROROCA",0,0,5,262,0,267,"2016"
"34860","250720 ITATUBA",0,0,2,134,5,141,"2016"
"34861","250730 JACARAU",0,2,2,198,3,205,"2016"
"34862","250740 JERICO",0,0,1,87,0,88,"2016"
"34863","250750 JOAO PESSOA",22,53,162,11434,35,11706,"2016"
"34864","250760 JUAREZ TAVORA",0,1,1,86,0,88,"2016"
"34865","250770 JUAZEIRINHO",0,6,3,230,4,243,"2016"
"34866","250780 JUNCO DO SERIDO",0,0,2,90,0,92,"2016"
"34867","250790 JURIPIRANGA",1,1,2,187,0,191,"2016"
"34868","250800 JURU",0,0,6,108,3,117,"2016"
"34869","250810 LAGOA",0,1,0,43,0,44,"2016"
"34870","250820 LAGOA DE DENTRO",0,1,1,94,0,96,"2016"
"34871","250830 LAGOA SECA",1,0,5,378,6,390,"2016"
"34872","250840 LASTRO",1,0,0,47,0,48,"2016"
"34873","250850 LIVRAMENTO",0,1,1,93,2,97,"2016"
"34874","250855 LOGRADOURO",0,0,2,43,0,45,"2016"
"34875","250860 LUCENA",2,0,6,211,0,219,"2016"
"34876","250870 MAE D'AGUA",0,0,2,47,3,52,"2016"
"34877","250880 MALTA",0,0,1,66,2,69,"2016"
"34878","250890 MAMANGUAPE",0,4,12,688,2,706,"2016"
"34879","250900 MANAIRA",1,1,6,138,1,147,"2016"
"34880","250905 MARCACAO",2,1,4,153,1,161,"2016"
"34881","250910 MARI",2,1,6,258,1,268,"2016"
"34882","250915 MARIZOPOLIS",0,0,2,70,2,74,"2016"
"34883","250920 MASSARANDUBA",0,0,3,167,1,171,"2016"
"34884","250930 MATARACA",2,1,3,157,0,163,"2016"
"34885","250933 MATINHAS",0,1,0,69,0,70,"2016"
"34886","250937 MATO GROSSO",0,0,0,30,0,30,"2016"
"34887","250939 MATUREIA",0,0,6,86,1,93,"2016"
"34888","250940 MOGEIRO",0,0,4,190,0,194,"2016"
"34889","250950 MONTADAS",0,1,0,66,1,68,"2016"
"34890","250960 MONTE HOREBE",0,0,3,59,0,62,"2016"
"34891","250970 MONTEIRO",2,2,5,447,1,457,"2016"
"34892","250980 MULUNGU",0,0,1,154,0,155,"2016"
"34893","250990 NATUBA",0,2,2,92,2,98,"2016"
"34894","251000 NAZAREZINHO",0,1,1,84,1,87,"2016"
"34895","251010 NOVA FLORESTA",0,0,6,141,0,147,"2016"
"34896","251020 NOVA OLINDA",1,2,2,72,8,85,"2016"
"34897","251030 NOVA PALMEIRA",0,0,0,45,0,45,"2016"
"34898","251040 OLHO D'AGUA",1,0,8,63,3,75,"2016"
"34899","251050 OLIVEDOS",0,0,1,47,0,48,"2016"
"34900","251060 OURO VELHO",1,0,0,27,0,28,"2016"
"34901","251065 PARARI",0,0,1,14,0,15,"2016"
"34902","251070 PASSAGEM",0,1,1,27,0,29,"2016"
"34903","251080 PATOS",5,10,61,1284,23,1383,"2016"
"34904","251090 PAULISTA",0,0,1,152,3,156,"2016"
"34905","251100 PEDRA BRANCA",0,1,1,58,0,60,"2016"
"34906","251110 PEDRA LAVRADA",0,0,2,76,0,78,"2016"
"34907","251120 PEDRAS DE FOGO",0,0,10,498,1,509,"2016"
"34908","251130 PIANCO",0,0,1,136,12,149,"2016"
"34909","251140 PICUI",1,2,1,258,0,262,"2016"
"34910","251150 PILAR",2,0,3,152,0,157,"2016"
"34911","251160 PILOES",0,0,4,132,3,139,"2016"
"34912","251170 PILOEZINHOS",3,1,1,71,0,76,"2016"
"34913","251180 PIRPIRITUBA",0,1,2,112,2,117,"2016"
"34914","251190 PITIMBU",1,2,7,295,1,306,"2016"
"34915","251200 POCINHOS",1,0,0,274,2,277,"2016"
"34916","251203 POCO DANTAS",0,0,0,70,1,71,"2016"
"34917","251207 POCO DE JOSE DE MOURA",0,0,1,40,0,41,"2016"
"34918","251210 POMBAL",1,1,4,392,1,399,"2016"
"34919","251220 PRATA",0,0,0,54,0,54,"2016"
"34920","251230 PRINCESA ISABEL",1,4,9,256,0,270,"2016"
"34921","251240 PUXINANA",0,0,6,193,2,201,"2016"
"34922","251250 QUEIMADAS",2,0,12,722,5,741,"2016"
"34923","251260 QUIXABA",0,0,0,25,1,26,"2016"
"34924","251270 REMIGIO",0,1,4,269,3,277,"2016"
"34925","251272 PEDRO REGIS",0,0,1,62,1,64,"2016"
"34926","251274 RIACHAO",0,0,0,43,0,43,"2016"
"34927","251275 RIACHAO DO BACAMARTE",0,0,0,76,0,76,"2016"
"34928","251276 RIACHAO DO POCO",0,0,0,52,0,52,"2016"
"34929","251278 RIACHO DE SANTO ANTONIO",0,0,2,24,0,26,"2016"
"34930","251280 RIACHO DOS CAVALOS",1,1,0,125,0,127,"2016"
"34931","251290 RIO TINTO",0,2,5,350,1,358,"2016"
"34932","251300 SALGADINHO",0,0,2,37,0,39,"2016"
"34933","251310 SALGADO DE SAO FELIX",0,1,4,134,2,141,"2016"
"34934","251315 SANTA CECILIA",0,0,1,77,2,80,"2016"
"34935","251320 SANTA CRUZ",0,2,2,74,0,78,"2016"
"34936","251330 SANTA HELENA",0,1,1,68,1,71,"2016"
"34937","251335 SANTA INES",0,1,4,43,1,49,"2016"
"34938","251340 SANTA LUZIA",1,1,5,170,0,177,"2016"
"34939","251350 SANTANA DE MANGUEIRA",0,1,3,60,0,64,"2016"
"34940","251360 SANTANA DOS GARROTES",0,0,0,77,7,84,"2016"
"34941","251365 JOCA CLAUDINO",0,0,0,32,0,32,"2016"
"34942","251370 SANTA RITA",4,10,65,2481,1,2561,"2016"
"34943","251380 SANTA TERESINHA",0,1,2,67,0,70,"2016"
"34944","251385 SANTO ANDRE",0,0,0,23,0,23,"2016"
"34945","251390 SAO BENTO",1,1,5,373,1,381,"2016"
"34946","251392 SAO BENTINHO",0,0,1,41,0,42,"2016"
"34947","251394 SAO DOMINGOS DO CARIRI",0,0,0,34,0,34,"2016"
"34948","251396 SAO DOMINGOS",0,0,1,37,0,38,"2016"
"34949","251398 SAO FRANCISCO",0,0,0,46,0,46,"2016"
"34950","251400 SAO JOAO DO CARIRI",0,0,0,58,0,58,"2016"
"34951","251410 SAO JOAO DO TIGRE",0,0,0,56,1,57,"2016"
"34952","251420 SAO JOSE DA LAGOA TAPADA",0,0,1,87,1,89,"2016"
"34953","251430 SAO JOSE DE CAIANA",0,0,1,86,1,88,"2016"
"34954","251440 SAO JOSE DE ESPINHARAS",0,0,4,45,1,50,"2016"
"34955","251445 SAO JOSE DOS RAMOS",0,0,1,91,0,92,"2016"
"34956","251450 SAO JOSE DE PIRANHAS",1,0,10,256,1,268,"2016"
"34957","251455 SAO JOSE DE PRINCESA",0,0,1,26,0,27,"2016"
"34958","251460 SAO JOSE DO BONFIM",0,1,2,44,1,48,"2016"
"34959","251465 SAO JOSE DO BREJO DO CRUZ",0,0,0,20,0,20,"2016"
"34960","251470 SAO JOSE DO SABUGI",0,0,2,32,1,35,"2016"
"34961","251480 SAO JOSE DOS CORDEIROS",0,0,0,38,1,39,"2016"
"34962","251490 SAO MAMEDE",0,1,1,76,1,79,"2016"
"34963","251500 SAO MIGUEL DE TAIPU",0,0,3,89,0,92,"2016"
"34964","251510 SAO SEBASTIAO DE LAGOA DE ROCA",0,0,3,160,1,164,"2016"
"34965","251520 SAO SEBASTIAO DO UMBUZEIRO",0,0,0,50,0,50,"2016"
"34966","251530 SAPE",0,4,9,515,1,529,"2016"
"34967","251540 SAO VICENTE DO SERIDO",0,1,1,140,3,145,"2016"
"34968","251550 SERRA BRANCA",0,0,3,165,0,168,"2016"
"34969","251560 SERRA DA RAIZ",0,0,0,30,0,30,"2016"
"34970","251570 SERRA GRANDE",0,0,0,39,1,40,"2016"
"34971","251580 SERRA REDONDA",0,0,2,77,0,79,"2016"
"34972","251590 SERRARIA",0,0,1,68,1,70,"2016"
"34973","251593 SERTAOZINHO",1,1,1,69,0,72,"2016"
"34974","251597 SOBRADO",1,0,5,98,0,104,"2016"
"34975","251600 SOLANEA",1,4,7,377,1,390,"2016"
"34976","251610 SOLEDADE",0,1,3,161,4,169,"2016"
"34977","251615 SOSSEGO",0,0,1,50,0,51,"2016"
"34978","251620 SOUSA",1,1,14,854,13,883,"2016"
"34979","251630 SUME",2,3,3,237,1,246,"2016"
"34980","251640 TACIMA",0,3,2,84,0,89,"2016"
"34981","251650 TAPEROA",1,3,4,179,2,189,"2016"
"34982","251660 TAVARES",0,2,10,175,1,188,"2016"
"34983","251670 TEIXEIRA",1,7,13,183,4,208,"2016"
"34984","251675 TENORIO",0,0,3,39,0,42,"2016"
"34985","251680 TRIUNFO",0,0,1,82,2,85,"2016"
"34986","251690 UIRAUNA",1,2,3,163,1,170,"2016"
"34987","251700 UMBUZEIRO",2,0,0,114,1,117,"2016"
"34988","251710 VARZEA",0,1,1,26,1,29,"2016"
"34989","251720 VIEIROPOLIS",0,0,1,58,0,59,"2016"
"34990","251740 ZABELE",0,0,0,32,0,32,"2016"
"34991","MUNICIPIO IGNORADO - PE",0,0,1,5,0,6,"2016"
"34992","260005 ABREU E LIMA",5,6,27,1435,14,1487,"2016"
"34993","260010 AFOGADOS DA INGAZEIRA",5,3,8,564,0,580,"2016"
"34994","260020 AFRANIO",2,4,9,198,71,284,"2016"
"34995","260030 AGRESTINA",2,1,2,317,1,323,"2016"
"34996","260040 AGUA PRETA",3,2,7,477,2,491,"2016"
"34997","260050 AGUAS BELAS",0,6,10,650,6,672,"2016"
"34998","260060 ALAGOINHA",0,2,4,184,1,191,"2016"
"34999","260070 ALIANCA",2,1,7,445,2,457,"2016"
"35000","260080 ALTINHO",1,1,2,231,0,235,"2016"
"35001","260090 AMARAJI",0,2,1,308,1,312,"2016"
"35002","260100 ANGELIM",0,2,1,140,1,144,"2016"
"35003","260105 ARACOIABA",2,1,5,277,4,289,"2016"
"35004","260110 ARARIPINA",6,6,17,1464,4,1497,"2016"
"35005","260120 ARCOVERDE",5,4,10,990,8,1017,"2016"
"35006","260130 BARRA DE GUABIRABA",0,1,2,145,0,148,"2016"
"35007","260140 BARREIROS",7,4,9,698,3,721,"2016"
"35008","260150 BELEM DE MARIA",2,0,1,144,1,148,"2016"
"35009","260160 BELEM DE SAO FRANCISCO",0,0,8,330,0,338,"2016"
"35010","260170 BELO JARDIM",5,6,14,1011,9,1045,"2016"
"35011","260180 BETANIA",1,1,13,134,2,151,"2016"
"35012","260190 BEZERROS",6,4,2,662,3,677,"2016"
"35013","260200 BODOCO",1,2,13,531,4,551,"2016"
"35014","260210 BOM CONSELHO",2,1,10,548,3,564,"2016"
"35015","260220 BOM JARDIM",4,3,10,374,1,392,"2016"
"35016","260230 BONITO",2,0,9,586,4,601,"2016"
"35017","260240 BREJAO",0,1,3,157,0,161,"2016"
"35018","260250 BREJINHO",1,0,1,80,0,82,"2016"
"35019","260260 BREJO DA MADRE DE DEUS",1,3,11,589,3,607,"2016"
"35020","260270 BUENOS AIRES",0,1,2,171,1,175,"2016"
"35021","260280 BUIQUE",4,5,7,814,4,834,"2016"
"35022","260290 CABO DE SANTO AGOSTINHO",8,10,48,2943,15,3024,"2016"
"35023","260300 CABROBO",0,2,12,498,0,512,"2016"
"35024","260310 CACHOEIRINHA",0,2,3,223,1,229,"2016"
"35025","260320 CAETES",3,1,5,372,0,381,"2016"
"35026","260330 CALCADO",0,1,0,146,0,147,"2016"
"35027","260340 CALUMBI",2,2,4,81,0,89,"2016"
"35028","260345 CAMARAGIBE",8,11,35,2219,6,2279,"2016"
"35029","260350 CAMOCIM DE SAO FELIX",1,0,5,215,3,224,"2016"
"35030","260360 CAMUTANGA",0,1,1,98,6,106,"2016"
"35031","260370 CANHOTINHO",3,0,4,338,1,346,"2016"
"35032","260380 CAPOEIRAS",3,3,3,277,1,287,"2016"
"35033","260390 CARNAIBA",1,1,7,248,0,257,"2016"
"35034","260392 CARNAUBEIRA DA PENHA",1,0,10,266,2,279,"2016"
"35035","260400 CARPINA",3,4,14,916,12,949,"2016"
"35036","260410 CARUARU",13,12,49,4984,27,5085,"2016"
"35037","260415 CASINHAS",0,0,2,138,1,141,"2016"
"35038","260420 CATENDE",5,3,5,535,1,549,"2016"
"35039","260430 CEDRO",0,1,7,157,1,166,"2016"
"35040","260440 CHA DE ALEGRIA",1,1,4,206,0,212,"2016"
"35041","260450 CHA GRANDE",2,1,4,276,2,285,"2016"
"35042","260460 CONDADO",0,2,7,372,4,385,"2016"
"35043","260470 CORRENTES",0,1,2,216,1,220,"2016"
"35044","260480 CORTES",0,1,2,192,1,196,"2016"
"35045","260490 CUMARU",0,0,1,141,1,143,"2016"
"35046","260500 CUPIRA",0,2,8,340,4,354,"2016"
"35047","260510 CUSTODIA",3,2,3,457,3,468,"2016"
"35048","260515 DORMENTES",0,0,7,198,18,223,"2016"
"35049","260520 ESCADA",2,3,16,992,2,1015,"2016"
"35050","260530 EXU",2,5,9,415,3,434,"2016"
"35051","260540 FEIRA NOVA",5,1,8,290,0,304,"2016"
"35052","260545 FERNANDO DE NORONHA",0,0,0,25,1,26,"2016"
"35053","260550 FERREIROS",1,0,5,156,1,163,"2016"
"35054","260560 FLORES",1,2,12,211,1,227,"2016"
"35055","260570 FLORESTA",3,8,6,407,6,430,"2016"
"35056","260580 FREI MIGUELINHO",0,0,1,132,0,133,"2016"
"35057","260590 GAMELEIRA",0,0,2,359,1,362,"2016"
"35058","260600 GARANHUNS",2,8,16,2151,2,2179,"2016"
"35059","260610 GLORIA DO GOITA",0,1,6,348,1,356,"2016"
"35060","260620 GOIANA",2,9,12,1110,18,1151,"2016"
"35061","260630 GRANITO",1,0,1,104,3,109,"2016"
"35062","260640 GRAVATA",4,4,10,1038,4,1060,"2016"
"35063","260650 IATI",0,2,3,242,2,249,"2016"
"35064","260660 IBIMIRIM",1,3,7,411,1,423,"2016"
"35065","260670 IBIRAJUBA",0,0,3,78,1,82,"2016"
"35066","260680 IGARASSU",7,4,18,1508,26,1563,"2016"
"35067","260690 IGUARACY",1,1,2,128,0,132,"2016"
"35068","260700 INAJA",1,2,3,318,12,336,"2016"
"35069","260710 INGAZEIRA",0,0,0,65,0,65,"2016"
"35070","260720 IPOJUCA",6,10,18,1512,16,1562,"2016"
"35071","260730 IPUBI",1,5,8,544,5,563,"2016"
"35072","260740 ITACURUBA",1,1,2,76,0,80,"2016"
"35073","260750 ITAIBA",1,2,3,301,18,325,"2016"
"35074","260760 ILHA DE ITAMARACA",0,0,4,308,5,317,"2016"
"35075","260765 ITAMBE",2,4,4,427,0,437,"2016"
"35076","260770 ITAPETIM",2,0,0,185,0,187,"2016"
"35077","260775 ITAPISSUMA",2,2,3,357,2,366,"2016"
"35078","260780 ITAQUITINGA",0,4,7,198,0,209,"2016"
"35079","260790 JABOATAO DOS GUARARAPES",32,36,125,8635,52,8880,"2016"
"35080","260795 JAQUEIRA",0,1,2,234,1,238,"2016"
"35081","260800 JATAUBA",1,0,2,212,2,217,"2016"
"35082","260805 JATOBA",1,1,4,206,1,213,"2016"
"35083","260810 JOAO ALFREDO",3,3,3,297,0,306,"2016"
"35084","260820 JOAQUIM NABUCO",1,0,5,258,2,266,"2016"
"35085","260825 JUCATI",0,2,1,177,2,182,"2016"
"35086","260830 JUPI",0,1,4,240,1,246,"2016"
"35087","260840 JUREMA",1,2,2,210,0,215,"2016"
"35088","260845 LAGOA DO CARRO",4,1,1,208,2,216,"2016"
"35089","260850 LAGOA DE ITAENGA",2,0,5,323,4,334,"2016"
"35090","260860 LAGOA DO OURO",0,2,4,154,0,160,"2016"
"35091","260870 LAGOA DOS GATOS",0,0,0,175,1,176,"2016"
"35092","260875 LAGOA GRANDE",4,3,10,338,2,357,"2016"
"35093","260880 LAJEDO",4,3,12,618,5,642,"2016"
"35094","260890 LIMOEIRO",6,0,11,721,3,741,"2016"
"35095","260900 MACAPARANA",1,1,7,354,1,364,"2016"
"35096","260910 MACHADOS",2,1,5,167,2,177,"2016"
"35097","260915 MANARI",1,0,4,245,3,253,"2016"
"35098","260920 MARAIAL",1,0,3,170,1,175,"2016"
"35099","260930 MIRANDIBA",3,1,3,242,3,252,"2016"
"35100","260940 MORENO",4,2,6,716,5,733,"2016"
"35101","260950 NAZARE DA MATA",3,1,6,421,2,433,"2016"
"35102","260960 OLINDA",12,24,76,5464,36,5612,"2016"
"35103","260970 OROBO",2,2,3,243,3,253,"2016"
"35104","260980 OROCO",1,1,7,270,0,279,"2016"
"35105","260990 OURICURI",2,5,15,1030,7,1059,"2016"
"35106","261000 PALMARES",4,6,15,1311,3,1339,"2016"
"35107","261010 PALMEIRINA",1,1,0,107,1,110,"2016"
"35108","261020 PANELAS",4,2,6,365,2,379,"2016"
"35109","261030 PARANATAMA",0,1,6,226,1,234,"2016"
"35110","261040 PARNAMIRIM",0,0,9,326,0,335,"2016"
"35111","261050 PASSIRA",3,1,5,345,4,358,"2016"
"35112","261060 PAUDALHO",1,1,10,783,2,797,"2016"
"35113","261070 PAULISTA",13,21,43,3870,29,3976,"2016"
"35114","261080 PEDRA",0,0,3,232,1,236,"2016"
"35115","261090 PESQUEIRA",1,8,9,882,4,904,"2016"
"35116","261100 PETROLANDIA",4,6,8,651,0,669,"2016"
"35117","261110 PETROLINA",26,29,127,5978,82,6242,"2016"
"35118","261120 POCAO",1,1,2,139,0,143,"2016"
"35119","261130 POMBOS",0,0,3,352,2,357,"2016"
"35120","261140 PRIMAVERA",0,0,7,166,0,173,"2016"
"35121","261150 QUIPAPA",0,1,5,327,2,335,"2016"
"35122","261153 QUIXABA",0,0,2,89,0,91,"2016"
"35123","261160 RECIFE",72,80,265,20852,144,21413,"2016"
"35124","261170 RIACHO DAS ALMAS",0,0,3,246,1,250,"2016"
"35125","261180 RIBEIRAO",2,1,7,502,2,514,"2016"
"35126","261190 RIO FORMOSO",2,1,5,333,4,345,"2016"
"35127","261200 SAIRE",0,1,0,123,0,124,"2016"
"35128","261210 SALGADINHO",0,0,2,76,0,78,"2016"
"35129","261220 SALGUEIRO",3,5,21,961,1,991,"2016"
"35130","261230 SALOA",2,2,9,221,2,236,"2016"
"35131","261240 SANHARO",0,2,5,263,1,271,"2016"
"35132","261245 SANTA CRUZ",0,7,4,212,1,224,"2016"
"35133","261247 SANTA CRUZ DA BAIXA VERDE",0,0,24,157,0,181,"2016"
"35134","261250 SANTA CRUZ DO CAPIBARIBE",6,4,15,1196,4,1225,"2016"
"35135","261255 SANTA FILOMENA",0,1,7,180,4,192,"2016"
"35136","261260 SANTA MARIA DA BOA VISTA",1,3,21,716,6,747,"2016"
"35137","261270 SANTA MARIA DO CAMBUCA",0,1,6,196,2,205,"2016"
"35138","261280 SANTA TEREZINHA",0,0,0,139,1,140,"2016"
"35139","261290 SAO BENEDITO DO SUL",0,0,1,158,0,159,"2016"
"35140","261300 SAO BENTO DO UNA",2,2,8,613,2,627,"2016"
"35141","261310 SAO CAITANO",3,5,9,496,0,513,"2016"
"35142","261320 SAO JOAO",5,2,0,343,0,350,"2016"
"35143","261330 SAO JOAQUIM DO MONTE",2,0,3,322,0,327,"2016"
"35144","261340 SAO JOSE DA COROA GRANDE",3,1,2,347,3,356,"2016"
"35145","261350 SAO JOSE DO BELMONTE",2,2,13,448,3,468,"2016"
"35146","261360 SAO JOSE DO EGITO",1,1,5,427,0,434,"2016"
"35147","261370 SAO LOURENCO DA MATA",9,8,30,1640,8,1695,"2016"
"35148","261380 SAO VICENTE FERRER",3,1,2,274,2,282,"2016"
"35149","261390 SERRA TALHADA",2,8,107,1181,14,1312,"2016"
"35150","261400 SERRITA",1,1,6,248,2,258,"2016"
"35151","261410 SERTANIA",2,0,5,377,3,387,"2016"
"35152","261420 SIRINHAEM",5,1,12,583,3,604,"2016"
"35153","261430 MOREILANDIA",0,1,3,132,2,138,"2016"
"35154","261440 SOLIDAO",0,0,1,76,0,77,"2016"
"35155","261450 SURUBIM",3,4,6,830,4,847,"2016"
"35156","261460 TABIRA",2,5,11,371,1,390,"2016"
"35157","261470 TACAIMBO",1,0,2,140,2,145,"2016"
"35158","261480 TACARATU",1,1,12,278,0,292,"2016"
"35159","261485 TAMANDARE",1,1,4,390,0,396,"2016"
"35160","261500 TAQUARITINGA DO NORTE",1,1,4,286,0,292,"2016"
"35161","261510 TEREZINHA",0,0,1,105,0,106,"2016"
"35162","261520 TERRA NOVA",0,1,5,118,0,124,"2016"
"35163","261530 TIMBAUBA",0,3,8,694,4,709,"2016"
"35164","261540 TORITAMA",2,1,2,494,1,500,"2016"
"35165","261550 TRACUNHAEM",2,1,1,183,0,187,"2016"
"35166","261560 TRINDADE",2,4,9,512,0,527,"2016"
"35167","261570 TRIUNFO",1,1,11,158,1,172,"2016"
"35168","261580 TUPANATINGA",0,2,7,280,4,293,"2016"
"35169","261590 TUPARETAMA",2,0,3,99,0,104,"2016"
"35170","261600 VENTUROSA",0,1,2,197,0,200,"2016"
"35171","261610 VERDEJANTE",1,1,2,130,0,134,"2016"
"35172","261618 VERTENTE DO LERIO",0,1,1,111,2,115,"2016"
"35173","261620 VERTENTES",0,0,6,305,0,311,"2016"
"35174","261630 VICENCIA",0,2,7,351,0,360,"2016"
"35175","261640 VITORIA DE SANTO ANTAO",6,8,26,1913,14,1967,"2016"
"35176","261650 XEXEU",0,1,0,219,1,221,"2016"
"35177","MUNICIPIO IGNORADO - AL",0,0,0,1,0,1,"2016"
"35178","270010 AGUA BRANCA",1,3,4,186,84,278,"2016"
"35179","270020 ANADIA",0,2,3,199,6,210,"2016"
"35180","270030 ARAPIRACA",8,21,38,3707,5,3779,"2016"
"35181","270040 ATALAIA",1,1,3,347,275,627,"2016"
"35182","270050 BARRA DE SANTO ANTONIO",0,1,1,286,9,297,"2016"
"35183","270060 BARRA DE SAO MIGUEL",0,0,1,156,3,160,"2016"
"35184","270070 BATALHA",0,0,2,258,1,261,"2016"
"35185","270080 BELEM",0,0,0,83,0,83,"2016"
"35186","270090 BELO MONTE",1,0,0,94,0,95,"2016"
"35187","270100 BOCA DA MATA",0,2,13,337,4,356,"2016"
"35188","270110 BRANQUINHA",0,1,1,181,3,186,"2016"
"35189","270120 CACIMBINHAS",1,0,1,134,0,136,"2016"
"35190","270130 CAJUEIRO",0,1,2,221,124,348,"2016"
"35191","270135 CAMPESTRE",0,1,0,69,0,70,"2016"
"35192","270140 CAMPO ALEGRE",0,1,8,481,5,495,"2016"
"35193","270150 CAMPO GRANDE",0,1,2,144,0,147,"2016"
"35194","270160 CANAPI",0,1,5,216,9,231,"2016"
"35195","270170 CAPELA",0,0,1,219,20,240,"2016"
"35196","270180 CARNEIROS",0,1,4,130,0,135,"2016"
"35197","270190 CHA PRETA",0,0,1,75,8,84,"2016"
"35198","270200 COITE DO NOIA",0,0,2,145,0,147,"2016"
"35199","270210 COLONIA LEOPOLDINA",0,1,3,276,3,283,"2016"
"35200","270220 COQUEIRO SECO",0,0,0,83,1,84,"2016"
"35201","270230 CORURIPE",1,0,13,826,11,851,"2016"
"35202","270235 CRAIBAS",1,1,5,374,14,395,"2016"
"35203","270240 DELMIRO GOUVEIA",2,4,15,425,348,794,"2016"
"35204","270250 DOIS RIACHOS",1,0,1,112,0,114,"2016"
"35205","270255 ESTRELA DE ALAGOAS",1,1,3,219,0,224,"2016"
"35206","270260 FEIRA GRANDE",1,0,4,275,0,280,"2016"
"35207","270270 FELIZ DESERTO",0,0,0,75,0,75,"2016"
"35208","270280 FLEXEIRAS",1,0,2,204,3,210,"2016"
"35209","270290 GIRAU DO PONCIANO",0,3,6,498,1,508,"2016"
"35210","270300 IBATEGUARA",0,2,2,243,5,252,"2016"
"35211","270310 IGACI",1,0,3,323,1,328,"2016"
"35212","270320 IGREJA NOVA",2,1,1,320,10,334,"2016"
"35213","270330 INHAPI",1,0,5,232,73,311,"2016"
"35214","270340 JACARE DOS HOMENS",0,0,1,88,0,89,"2016"
"35215","270350 JACUIPE",1,0,0,58,0,59,"2016"
"35216","270360 JAPARATINGA",0,1,0,141,0,142,"2016"
"35217","270370 JARAMATAIA",0,0,1,80,0,81,"2016"
"35218","270375 JEQUIA DA PRAIA",0,0,0,126,1,127,"2016"
"35219","270380 JOAQUIM GOMES",0,2,3,306,9,320,"2016"
"35220","270390 JUNDIA",0,0,0,58,1,59,"2016"
"35221","270400 JUNQUEIRO",2,3,2,363,0,370,"2016"
"35222","270410 LAGOA DA CANOA",0,0,2,283,0,285,"2016"
"35223","270420 LIMOEIRO DE ANADIA",0,1,2,295,0,298,"2016"
"35224","270430 MACEIO",18,40,158,13683,208,14107,"2016"
"35225","270440 MAJOR ISIDORO",0,0,2,217,21,240,"2016"
"35226","270450 MARAGOGI",0,2,5,477,4,488,"2016"
"35227","270460 MARAVILHA",1,0,2,113,1,117,"2016"
"35228","270470 MARECHAL DEODORO",0,2,10,826,9,847,"2016"
"35229","270480 MARIBONDO",0,0,1,167,1,169,"2016"
"35230","270490 MAR VERMELHO",0,1,0,31,2,34,"2016"
"35231","270500 MATA GRANDE",2,0,1,244,50,297,"2016"
"35232","270510 MATRIZ DE CAMARAGIBE",1,1,4,390,3,399,"2016"
"35233","270520 MESSIAS",0,1,1,254,8,264,"2016"
"35234","270530 MINADOR DO NEGRAO",0,0,1,84,0,85,"2016"
"35235","270540 MONTEIROPOLIS",0,0,1,102,0,103,"2016"
"35236","270550 MURICI",1,1,8,290,148,448,"2016"
"35237","270560 NOVO LINO",0,0,1,141,4,146,"2016"
"35238","270570 OLHO D'AGUA DAS FLORES",1,0,3,340,0,344,"2016"
"35239","270580 OLHO D'AGUA DO CASADO",0,0,1,80,31,112,"2016"
"35240","270590 OLHO D'AGUA GRANDE",0,0,0,100,0,100,"2016"
"35241","270600 OLIVENCA",1,1,0,178,2,182,"2016"
"35242","270610 OURO BRANCO",0,1,2,166,0,169,"2016"
"35243","270620 PALESTINA",0,0,0,79,0,79,"2016"
"35244","270630 PALMEIRA DOS INDIOS",2,1,11,1126,2,1142,"2016"
"35245","270640 PAO DE ACUCAR",2,2,5,405,3,417,"2016"
"35246","270642 PARICONHA",0,2,3,115,45,165,"2016"
"35247","270644 PARIPUEIRA",1,1,2,227,7,238,"2016"
"35248","270650 PASSO DE CAMARAGIBE",0,1,1,208,4,214,"2016"
"35249","270660 PAULO JACINTO",0,0,1,89,2,92,"2016"
"35250","270670 PENEDO",3,0,9,922,27,961,"2016"
"35251","270680 PIACABUCU",0,0,2,286,10,298,"2016"
"35252","270690 PILAR",2,3,9,538,19,571,"2016"
"35253","270700 PINDOBA",0,0,0,31,4,35,"2016"
"35254","270710 PIRANHAS",1,0,6,398,20,425,"2016"
"35255","270720 POCO DAS TRINCHEIRAS",0,1,3,214,0,218,"2016"
"35256","270730 PORTO CALVO",0,3,3,442,4,452,"2016"
"35257","270740 PORTO DE PEDRAS",0,1,1,120,1,123,"2016"
"35258","270750 PORTO REAL DO COLEGIO",0,0,6,296,6,308,"2016"
"35259","270760 QUEBRANGULO",0,0,2,190,4,196,"2016"
"35260","270770 RIO LARGO",3,5,14,1134,46,1202,"2016"
"35261","270780 ROTEIRO",1,1,2,109,0,113,"2016"
"35262","270790 SANTA LUZIA DO NORTE",0,0,1,99,3,103,"2016"
"35263","270800 SANTANA DO IPANEMA",2,1,6,737,3,749,"2016"
"35264","270810 SANTANA DO MUNDAU",1,0,0,185,3,189,"2016"
"35265","270820 SAO BRAS",0,0,1,90,3,94,"2016"
"35266","270830 SAO JOSE DA LAJE",0,1,7,320,11,339,"2016"
"35267","270840 SAO JOSE DA TAPERA",0,3,2,493,4,502,"2016"
"35268","270850 SAO LUIS DO QUITUNDE",1,6,8,536,7,558,"2016"
"35269","270860 SAO MIGUEL DOS CAMPOS",6,4,5,795,5,815,"2016"
"35270","270870 SAO MIGUEL DOS MILAGRES",0,0,3,108,4,115,"2016"
"35271","270880 SAO SEBASTIAO",1,1,4,456,2,464,"2016"
"35272","270890 SATUBA",0,1,3,221,4,229,"2016"
"35273","270895 SENADOR RUI PALMEIRA",0,0,4,200,5,209,"2016"
"35274","270900 TANQUE D'ARCA",0,1,1,67,0,69,"2016"
"35275","270910 TAQUARANA",1,0,5,266,1,273,"2016"
"35276","270915 TEOTONIO VILELA",0,2,12,565,3,582,"2016"
"35277","270920 TRAIPU",1,2,10,343,2,358,"2016"
"35278","270930 UNIAO DOS PALMARES",3,1,10,951,9,974,"2016"
"35279","270940 VICOSA",0,1,6,349,47,403,"2016"
"35280","280010 AMPARO DE SAO FRANCISCO",0,1,2,35,1,39,"2016"
"35281","280020 AQUIDABA",0,1,7,234,11,253,"2016"
"35282","280030 ARACAJU",39,32,158,8512,126,8867,"2016"
"35283","280040 ARAUA",0,0,3,133,2,138,"2016"
"35284","280050 AREIA BRANCA",1,2,6,231,4,244,"2016"
"35285","280060 BARRA DOS COQUEIROS",1,2,9,479,4,495,"2016"
"35286","280067 BOQUIM",0,0,5,271,7,283,"2016"
"35287","280070 BREJO GRANDE",0,1,1,128,4,134,"2016"
"35288","280100 CAMPO DO BRITO",2,1,7,207,3,220,"2016"
"35289","280110 CANHOBA",1,0,1,64,5,71,"2016"
"35290","280120 CANINDE DE SAO FRANCISCO",0,3,11,521,35,570,"2016"
"35291","280130 CAPELA",1,5,10,480,21,517,"2016"
"35292","280140 CARIRA",1,1,4,230,15,251,"2016"
"35293","280150 CARMOPOLIS",4,1,10,242,5,262,"2016"
"35294","280160 CEDRO DE SAO JOAO",0,1,4,65,5,75,"2016"
"35295","280170 CRISTINAPOLIS",2,1,4,284,10,301,"2016"
"35296","280190 CUMBE",0,0,2,45,4,51,"2016"
"35297","280200 DIVINA PASTORA",0,1,1,59,1,62,"2016"
"35298","280210 ESTANCIA",4,5,13,987,18,1027,"2016"
"35299","280220 FEIRA NOVA",0,0,5,63,16,84,"2016"
"35300","280230 FREI PAULO",0,0,3,199,6,208,"2016"
"35301","280240 GARARU",1,2,2,121,13,139,"2016"
"35302","280250 GENERAL MAYNARD",0,1,2,36,2,41,"2016"
"35303","280260 GRACHO CARDOSO",0,0,1,74,13,88,"2016"
"35304","280270 ILHA DAS FLORES",1,2,2,121,5,131,"2016"
"35305","280280 INDIAROBA",2,1,2,259,8,272,"2016"
"35306","280290 ITABAIANA",4,5,16,1238,8,1271,"2016"
"35307","280300 ITABAIANINHA",3,2,11,588,4,608,"2016"
"35308","280310 ITABI",0,0,2,51,6,59,"2016"
"35309","280320 ITAPORANGA D'AJUDA",2,2,11,510,17,542,"2016"
"35310","280330 JAPARATUBA",0,1,3,207,8,219,"2016"
"35311","280340 JAPOATA",0,2,6,184,6,198,"2016"
"35312","280350 LAGARTO",6,7,23,1319,19,1374,"2016"
"35313","280360 LARANJEIRAS",1,1,12,407,7,428,"2016"
"35314","280370 MACAMBIRA",0,0,0,95,1,96,"2016"
"35315","280380 MALHADA DOS BOIS",0,1,2,66,1,70,"2016"
"35316","280390 MALHADOR",2,1,3,172,3,181,"2016"
"35317","280400 MARUIM",0,1,5,246,8,260,"2016"
"35318","280410 MOITA BONITA",0,0,2,111,3,116,"2016"
"35319","280420 MONTE ALEGRE DE SERGIPE",1,1,0,183,39,224,"2016"
"35320","280430 MURIBECA",1,1,3,81,3,89,"2016"
"35321","280440 NEOPOLIS",1,0,8,253,16,278,"2016"
"35322","280445 NOSSA SENHORA APARECIDA",0,0,0,97,7,104,"2016"
"35323","280450 NOSSA SENHORA DA GLORIA",4,1,10,453,71,539,"2016"
"35324","280460 NOSSA SENHORA DAS DORES",2,4,8,285,20,319,"2016"
"35325","280470 NOSSA SENHORA DE LOURDES",0,0,2,88,7,97,"2016"
"35326","280480 NOSSA SENHORA DO SOCORRO",12,16,67,2933,40,3068,"2016"
"35327","280490 PACATUBA",1,0,7,217,13,238,"2016"
"35328","280500 PEDRA MOLE",0,0,1,37,1,39,"2016"
"35329","280510 PEDRINHAS",1,1,3,111,1,117,"2016"
"35330","280520 PINHAO",0,0,3,69,0,72,"2016"
"35331","280530 PIRAMBU",0,1,4,143,3,151,"2016"
"35332","280540 POCO REDONDO",0,0,3,420,57,480,"2016"
"35333","280550 POCO VERDE",1,0,2,262,5,270,"2016"
"35334","280560 PORTO DA FOLHA",1,3,5,310,31,350,"2016"
"35335","280570 PROPRIA",1,4,10,444,14,473,"2016"
"35336","280580 RIACHAO DO DANTAS",0,1,4,237,8,250,"2016"
"35337","280590 RIACHUELO",0,2,1,142,4,149,"2016"
"35338","280600 RIBEIROPOLIS",1,1,3,160,1,166,"2016"
"35339","280610 ROSARIO DO CATETE",2,0,4,180,9,195,"2016"
"35340","280620 SALGADO",3,0,5,261,7,276,"2016"
"35341","280630 SANTA LUZIA DO ITANHY",1,0,1,196,1,199,"2016"
"35342","280640 SANTANA DO SAO FRANCISCO",0,0,4,93,9,106,"2016"
"35343","280650 SANTA ROSA DE LIMA",0,0,3,67,2,72,"2016"
"35344","280660 SANTO AMARO DAS BROTAS",0,3,6,161,5,175,"2016"
"35345","280670 SAO CRISTOVAO",3,6,27,1262,32,1330,"2016"
"35346","280680 SAO DOMINGOS",0,0,0,126,2,128,"2016"
"35347","280690 SAO FRANCISCO",2,0,0,39,3,44,"2016"
"35348","280700 SAO MIGUEL DO ALEIXO",0,0,1,39,3,43,"2016"
"35349","280710 SIMAO DIAS",1,3,7,585,5,601,"2016"
"35350","280720 SIRIRI",1,0,2,84,2,89,"2016"
"35351","280730 TELHA",0,0,0,32,3,35,"2016"
"35352","280740 TOBIAS BARRETO",2,1,9,602,9,623,"2016"
"35353","280750 TOMAR DO GERU",0,1,2,171,1,175,"2016"
"35354","280760 UMBAUBA",1,2,7,389,10,409,"2016"
"35355","MUNICIPIO IGNORADO - BA",0,1,0,9,4,14,"2016"
"35356","290010 ABAIRA",0,0,0,47,2,49,"2016"
"35357","290020 ABARE",2,1,4,246,5,258,"2016"
"35358","290030 ACAJUTIBA",0,1,4,166,1,172,"2016"
"35359","290035 ADUSTINA",1,0,1,137,1,140,"2016"
"35360","290040 AGUA FRIA",1,3,6,147,17,174,"2016"
"35361","290050 ERICO CARDOSO",0,2,1,95,20,118,"2016"
"35362","290060 AIQUARA",1,0,1,56,1,59,"2016"
"35363","290070 ALAGOINHAS",11,20,38,2303,56,2428,"2016"
"35364","290080 ALCOBACA",0,1,5,292,1,299,"2016"
"35365","290090 ALMADINA",1,2,3,65,2,73,"2016"
"35366","290100 AMARGOSA",0,7,9,341,105,462,"2016"
"35367","290110 AMELIA RODRIGUES",0,1,4,176,47,228,"2016"
"35368","290115 AMERICA DOURADA",1,2,11,237,1,252,"2016"
"35369","290120 ANAGE",1,1,9,215,2,228,"2016"
"35370","290130 ANDARAI",0,3,2,140,0,145,"2016"
"35371","290135 ANDORINHA",2,5,3,162,5,177,"2016"
"35372","290140 ANGICAL",2,1,4,183,3,193,"2016"
"35373","290150 ANGUERA",0,0,2,61,17,80,"2016"
"35374","290160 ANTAS",0,0,1,137,4,142,"2016"
"35375","290170 ANTONIO CARDOSO",0,0,1,96,39,136,"2016"
"35376","290180 ANTONIO GONCALVES",0,2,2,75,37,116,"2016"
"35377","290190 APORA",0,3,3,198,6,210,"2016"
"35378","290195 APUAREMA",0,0,1,79,1,81,"2016"
"35379","290200 ARACATU",1,0,2,156,0,159,"2016"
"35380","290205 ARACAS",1,1,4,178,1,185,"2016"
"35381","290210 ARACI",4,8,24,644,28,708,"2016"
"35382","290220 ARAMARI",0,0,3,133,6,142,"2016"
"35383","290225 ARATACA",1,0,5,123,2,131,"2016"
"35384","290230 ARATUIPE",0,0,5,90,32,127,"2016"
"35385","290240 AURELINO LEAL",0,1,4,174,29,208,"2016"
"35386","290250 BAIANOPOLIS",1,0,4,167,0,172,"2016"
"35387","290260 BAIXA GRANDE",0,1,4,206,10,221,"2016"
"35388","290265 BANZAE",0,0,1,63,110,174,"2016"
"35389","290270 BARRA",3,2,10,841,12,868,"2016"
"35390","290280 BARRA DA ESTIVA",1,4,12,399,1,417,"2016"
"35391","290290 BARRA DO CHOCA",1,4,8,535,12,560,"2016"
"35392","290300 BARRA DO MENDES",1,5,4,175,0,185,"2016"
"35393","290310 BARRA DO ROCHA",0,0,2,62,1,65,"2016"
"35394","290320 BARREIRAS",11,13,32,2509,5,2570,"2016"
"35395","290323 BARRO ALTO",0,1,4,158,0,163,"2016"
"35396","290327 BARROCAS",1,0,6,177,9,193,"2016"
"35397","290330 BARRO PRETO",0,0,3,92,0,95,"2016"
"35398","290340 BELMONTE",0,3,5,264,12,284,"2016"
"35399","290350 BELO CAMPO",2,0,5,209,0,216,"2016"
"35400","290360 BIRITINGA",0,2,3,186,5,196,"2016"
"35401","290370 BOA NOVA",1,0,1,155,7,164,"2016"
"35402","290380 BOA VISTA DO TUPIM",1,1,4,233,8,247,"2016"
"35403","290390 BOM JESUS DA LAPA",1,6,19,1112,4,1142,"2016"
"35404","290395 BOM JESUS DA SERRA",0,0,3,121,3,127,"2016"
"35405","290400 BONINAL",1,1,5,133,12,152,"2016"
"35406","290405 BONITO",1,3,7,222,0,233,"2016"
"35407","290410 BOQUIRA",1,0,5,234,26,266,"2016"
"35408","290420 BOTUPORA",0,1,2,128,5,136,"2016"
"35409","290430 BREJOES",0,2,4,143,1,150,"2016"
"35410","290440 BREJOLANDIA",1,0,5,72,0,78,"2016"
"35411","290450 BROTAS DE MACAUBAS",0,1,1,124,0,126,"2016"
"35412","290460 BRUMADO",1,2,12,818,16,849,"2016"
"35413","290470 BUERAREMA",0,0,4,236,5,245,"2016"
"35414","290475 BURITIRAMA",2,1,5,275,3,286,"2016"
"35415","290480 CAATIBA",1,0,3,57,23,84,"2016"
"35416","290485 CABACEIRAS DO PARAGUACU",1,1,1,130,103,236,"2016"
"35417","290490 CACHOEIRA",2,0,1,236,185,424,"2016"
"35418","290500 CACULE",1,0,3,299,0,303,"2016"
"35419","290510 CAEM",1,0,2,109,7,119,"2016"
"35420","290515 CAETANOS",0,0,2,123,7,132,"2016"
"35421","290520 CAETITE",3,5,9,665,15,697,"2016"
"35422","290530 CAFARNAUM",1,0,7,265,1,274,"2016"
"35423","290540 CAIRU",0,3,23,271,4,301,"2016"
"35424","290550 CALDEIRAO GRANDE",1,4,3,185,2,195,"2016"
"35425","290560 CAMACAN",1,1,4,372,2,380,"2016"
"35426","290570 CAMACARI",19,24,82,4067,36,4228,"2016"
"35427","290580 CAMAMU",4,7,21,509,12,553,"2016"
"35428","290590 CAMPO ALEGRE DE LOURDES",4,1,4,415,26,450,"2016"
"35429","290600 CAMPO FORMOSO",0,3,14,761,370,1148,"2016"
"35430","290610 CANAPOLIS",0,1,13,114,6,134,"2016"
"35431","290620 CANARANA",1,2,10,343,1,357,"2016"
"35432","290630 CANAVIEIRAS",1,4,6,425,60,496,"2016"
"35433","290640 CANDEAL",1,1,0,64,31,97,"2016"
"35434","290650 CANDEIAS",7,6,17,981,6,1017,"2016"
"35435","290660 CANDIBA",0,1,3,130,3,137,"2016"
"35436","290670 CANDIDO SALES",0,2,8,347,3,360,"2016"
"35437","290680 CANSANCAO",1,4,13,449,9,476,"2016"
"35438","290682 CANUDOS",0,2,2,198,7,209,"2016"
"35439","290685 CAPELA DO ALTO ALEGRE",1,1,1,91,2,96,"2016"
"35440","290687 CAPIM GROSSO",0,2,1,487,3,493,"2016"
"35441","290689 CARAIBAS",0,0,1,96,1,98,"2016"
"35442","290690 CARAVELAS",0,1,3,271,3,278,"2016"
"35443","290700 CARDEAL DA SILVA",0,1,2,108,7,118,"2016"
"35444","290710 CARINHANHA",1,1,11,414,21,448,"2016"
"35445","290720 CASA NOVA",7,2,23,950,15,997,"2016"
"35446","290730 CASTRO ALVES",0,1,3,297,17,318,"2016"
"35447","290740 CATOLANDIA",1,0,1,43,0,45,"2016"
"35448","290750 CATU",7,2,10,573,3,595,"2016"
"35449","290755 CATURAMA",0,0,0,85,28,113,"2016"
"35450","290760 CENTRAL",0,2,2,206,2,212,"2016"
"35451","290770 CHORROCHO",0,1,2,151,1,155,"2016"
"35452","290780 CICERO DANTAS",1,5,2,308,21,337,"2016"
"35453","290790 CIPO",1,0,6,213,53,273,"2016"
"35454","290800 COARACI",1,0,9,238,7,255,"2016"
"35455","290810 COCOS",1,1,3,73,153,231,"2016"
"35456","290820 CONCEICAO DA FEIRA",1,0,0,71,135,207,"2016"
"35457","290830 CONCEICAO DO ALMEIDA",0,0,2,128,50,180,"2016"
"35458","290840 CONCEICAO DO COITE",1,5,16,1013,13,1048,"2016"
"35459","290850 CONCEICAO DO JACUIPE",0,4,1,291,74,370,"2016"
"35460","290860 CONDE",2,1,7,301,7,318,"2016"
"35461","290870 CONDEUBA",1,0,4,204,3,212,"2016"
"35462","290880 CONTENDAS DO SINCORA",0,1,0,37,0,38,"2016"
"35463","290890 CORACAO DE MARIA",0,0,1,170,90,261,"2016"
"35464","290900 CORDEIROS",0,2,5,80,0,87,"2016"
"35465","290910 CORIBE",0,3,2,161,12,178,"2016"
"35466","290920 CORONEL JOAO SA",0,1,1,186,3,191,"2016"
"35467","290930 CORRENTINA",0,1,8,219,203,431,"2016"
"35468","290940 COTEGIPE",0,4,2,144,4,154,"2016"
"35469","290950 CRAVOLANDIA",0,1,1,64,1,67,"2016"
"35470","290960 CRISOPOLIS",0,1,8,260,5,274,"2016"
"35471","290970 CRISTOPOLIS",0,1,0,150,0,151,"2016"
"35472","290980 CRUZ DAS ALMAS",5,5,13,724,50,797,"2016"
"35473","290990 CURACA",2,3,6,463,3,477,"2016"
"35474","291000 DARIO MEIRA",2,2,6,156,4,170,"2016"
"35475","291005 DIAS D'AVILA",8,8,26,1145,4,1191,"2016"
"35476","291010 DOM BASILIO",0,0,0,129,4,133,"2016"
"35477","291020 DOM MACEDO COSTA",0,0,0,21,37,58,"2016"
"35478","291030 ELISIO MEDRADO",0,0,2,34,31,67,"2016"
"35479","291040 ENCRUZILHADA",0,0,7,260,8,275,"2016"
"35480","291050 ENTRE RIOS",1,4,4,537,12,558,"2016"
"35481","291060 ESPLANADA",3,3,4,443,4,457,"2016"
"35482","291070 EUCLIDES DA CUNHA",1,6,19,673,46,745,"2016"
"35483","291072 EUNAPOLIS",5,8,39,1719,15,1786,"2016"
"35484","291075 FATIMA",0,2,2,190,4,198,"2016"
"35485","291077 FEIRA DA MATA",0,1,0,23,27,51,"2016"
"35486","291080 FEIRA DE SANTANA",33,27,73,7392,2697,10222,"2016"
"35487","291085 FILADELFIA",0,3,6,242,0,251,"2016"
"35488","291090 FIRMINO ALVES",0,0,0,59,3,62,"2016"
"35489","291100 FLORESTA AZUL",0,0,5,124,1,130,"2016"
"35490","291110 FORMOSA DO RIO PRETO",0,1,8,433,17,459,"2016"
"35491","291120 GANDU",1,4,12,424,9,450,"2016"
"35492","291125 GAVIAO",0,1,2,41,1,45,"2016"
"35493","291130 GENTIO DO OURO",0,1,4,115,4,124,"2016"
"35494","291140 GLORIA",0,1,8,219,2,230,"2016"
"35495","291150 GONGOGI",0,2,0,87,0,89,"2016"
"35496","291160 GOVERNADOR MANGABEIRA",0,0,4,72,170,246,"2016"
"35497","291165 GUAJERU",1,0,0,84,4,89,"2016"
"35498","291170 GUANAMBI",5,3,11,1039,122,1180,"2016"
"35499","291180 GUARATINGA",0,3,5,193,3,204,"2016"
"35500","291185 HELIOPOLIS",0,0,1,95,16,112,"2016"
"35501","291190 IACU",1,5,15,374,5,400,"2016"
"35502","291200 IBIASSUCE",0,1,0,92,2,95,"2016"
"35503","291210 IBICARAI",1,2,4,249,5,261,"2016"
"35504","291220 IBICOARA",0,0,6,302,2,310,"2016"
"35505","291230 IBICUI",0,2,3,148,2,155,"2016"
"35506","291240 IBIPEBA",1,0,1,211,0,213,"2016"
"35507","291250 IBIPITANGA",0,0,0,125,37,162,"2016"
"35508","291260 IBIQUERA",0,0,0,61,2,63,"2016"
"35509","291270 IBIRAPITANGA",1,3,12,367,7,390,"2016"
"35510","291280 IBIRAPUA",0,0,2,127,2,131,"2016"
"35511","291290 IBIRATAIA",0,3,6,305,1,315,"2016"
"35512","291300 IBITIARA",0,1,10,163,2,176,"2016"
"35513","291310 IBITITA",1,3,4,226,0,234,"2016"
"35514","291320 IBOTIRAMA",0,1,17,401,6,425,"2016"
"35515","291330 ICHU",0,0,3,28,9,40,"2016"
"35516","291340 IGAPORA",0,0,2,164,9,175,"2016"
"35517","291345 IGRAPIUNA",1,1,14,188,4,208,"2016"
"35518","291350 IGUAI",2,1,2,317,0,322,"2016"
"35519","291360 ILHEUS",9,10,35,1667,670,2391,"2016"
"35520","291370 INHAMBUPE",2,3,6,432,9,452,"2016"
"35521","291380 IPECAETA",0,1,5,126,36,168,"2016"
"35522","291390 IPIAU",4,4,14,631,1,654,"2016"
"35523","291400 IPIRA",0,2,11,750,14,777,"2016"
"35524","291410 IPUPIARA",0,0,1,87,0,88,"2016"
"35525","291420 IRAJUBA",1,1,1,78,1,82,"2016"
"35526","291430 IRAMAIA",0,0,3,90,0,93,"2016"
"35527","291440 IRAQUARA",1,5,6,359,2,373,"2016"
"35528","291450 IRARA",1,2,6,281,70,360,"2016"
"35529","291460 IRECE",4,7,21,1245,0,1277,"2016"
"35530","291465 ITABELA",0,1,15,469,5,490,"2016"
"35531","291470 ITABERABA",4,6,14,887,3,914,"2016"
"35532","291480 ITABUNA",16,15,57,2738,20,2846,"2016"
"35533","291490 ITACARE",3,2,6,245,72,328,"2016"
"35534","291500 ITAETE",1,2,2,190,4,199,"2016"
"35535","291510 ITAGI",0,0,1,190,1,192,"2016"
"35536","291520 ITAGIBA",0,4,3,182,1,190,"2016"
"35537","291530 ITAGIMIRIM",0,0,2,72,3,77,"2016"
"35538","291535 ITAGUACU DA BAHIA",0,2,5,175,1,183,"2016"
"35539","291540 ITAJU DO COLONIA",0,0,1,82,1,84,"2016"
"35540","291550 ITAJUIPE",1,1,6,234,2,244,"2016"
"35541","291560 ITAMARAJU",2,6,16,1025,15,1064,"2016"
"35542","291570 ITAMARI",1,0,2,86,2,91,"2016"
"35543","291580 ITAMBE",1,2,4,236,7,250,"2016"
"35544","291590 ITANAGRA",0,0,0,79,0,79,"2016"
"35545","291600 ITANHEM",0,0,8,188,0,196,"2016"
"35546","291610 ITAPARICA",0,0,6,255,10,271,"2016"
"35547","291620 ITAPE",0,0,4,98,2,104,"2016"
"35548","291630 ITAPEBI",0,0,4,140,9,153,"2016"
"35549","291640 ITAPETINGA",3,3,18,479,560,1063,"2016"
"35550","291650 ITAPICURU",3,0,2,343,19,367,"2016"
"35551","291660 ITAPITANGA",0,1,2,112,2,117,"2016"
"35552","291670 ITAQUARA",0,2,2,91,6,101,"2016"
"35553","291680 ITARANTIM",0,1,1,150,58,210,"2016"
"35554","291685 ITATIM",0,0,3,189,15,207,"2016"
"35555","291690 ITIRUCU",2,1,7,124,1,135,"2016"
"35556","291700 ITIUBA",0,3,7,419,16,445,"2016"
"35557","291710 ITORORO",1,1,2,61,63,128,"2016"
"35558","291720 ITUACU",0,2,6,231,2,241,"2016"
"35559","291730 ITUBERA",1,2,12,303,2,320,"2016"
"35560","291733 IUIU",1,1,4,99,7,112,"2016"
"35561","291735 JABORANDI",1,0,3,124,0,128,"2016"
"35562","291740 JACARACI",0,0,1,127,1,129,"2016"
"35563","291750 JACOBINA",5,7,49,1200,9,1270,"2016"
"35564","291760 JAGUAQUARA",3,5,12,683,2,705,"2016"
"35565","291770 JAGUARARI",1,3,5,377,36,422,"2016"
"35566","291780 JAGUARIPE",0,1,8,138,55,202,"2016"
"35567","291790 JANDAIRA",0,0,1,134,2,137,"2016"
"35568","291800 JEQUIE",6,8,33,2310,24,2381,"2016"
"35569","291810 JEREMOABO",0,3,5,441,12,461,"2016"
"35570","291820 JIQUIRICA",1,0,2,96,42,141,"2016"
"35571","291830 JITAUNA",0,2,2,147,3,154,"2016"
"35572","291835 JOAO DOURADO",2,2,11,372,0,387,"2016"
"35573","291840 JUAZEIRO",18,19,79,3897,60,4073,"2016"
"35574","291845 JUCURUCU",1,0,1,96,2,100,"2016"
"35575","291850 JUSSARA",2,2,7,193,1,205,"2016"
"35576","291855 JUSSARI",0,1,3,87,3,94,"2016"
"35577","291860 JUSSIAPE",0,0,1,67,0,68,"2016"
"35578","291870 LAFAIETE COUTINHO",0,0,0,44,0,44,"2016"
"35579","291875 LAGOA REAL",0,1,2,133,8,144,"2016"
"35580","291880 LAJE",1,1,4,181,101,288,"2016"
"35581","291890 LAJEDAO",0,0,0,56,0,56,"2016"
"35582","291900 LAJEDINHO",0,1,0,40,1,42,"2016"
"35583","291905 LAJEDO DO TABOCAL",0,1,3,90,4,98,"2016"
"35584","291910 LAMARAO",0,1,7,64,8,80,"2016"
"35585","291915 LAPAO",3,5,5,408,0,421,"2016"
"35586","291920 LAURO DE FREITAS",17,15,50,3026,29,3137,"2016"
"35587","291930 LENCOIS",1,1,4,139,2,147,"2016"
"35588","291940 LICINIO DE ALMEIDA",0,1,2,106,7,116,"2016"
"35589","291950 LIVRAMENTO DE NOSSA SENHORA",3,2,8,540,6,559,"2016"
"35590","291955 LUIS EDUARDO MAGALHAES",1,7,32,1651,1,1692,"2016"
"35591","291960 MACAJUBA",1,1,6,172,1,181,"2016"
"35592","291970 MACARANI",2,1,2,137,65,207,"2016"
"35593","291980 MACAUBAS",0,1,6,470,10,487,"2016"
"35594","291990 MACURURE",2,0,1,92,2,97,"2016"
"35595","291992 MADRE DE DEUS",2,2,4,343,2,353,"2016"
"35596","291995 MAETINGA",0,1,0,91,0,92,"2016"
"35597","292000 MAIQUINIQUE",0,1,6,58,37,102,"2016"
"35598","292010 MAIRI",1,3,3,149,13,169,"2016"
"35599","292020 MALHADA",0,0,6,257,24,287,"2016"
"35600","292030 MALHADA DE PEDRAS",0,2,0,101,5,108,"2016"
"35601","292040 MANOEL VITORINO",0,0,3,190,7,200,"2016"
"35602","292045 MANSIDAO",0,3,2,80,1,86,"2016"
"35603","292050 MARACAS",0,4,7,349,3,363,"2016"
"35604","292060 MARAGOGIPE",1,0,4,172,292,469,"2016"
"35605","292070 MARAU",2,2,2,189,32,227,"2016"
"35606","292080 MARCIONILIO SOUZA",0,1,1,103,0,105,"2016"
"35607","292090 MASCOTE",0,0,2,172,0,174,"2016"
"35608","292100 MATA DE SAO JOAO",1,5,20,770,4,800,"2016"
"35609","292105 MATINA",0,1,3,151,7,162,"2016"
"35610","292110 MEDEIROS NETO",0,0,15,293,0,308,"2016"
"35611","292120 MIGUEL CALMON",2,2,7,325,2,338,"2016"
"35612","292130 MILAGRES",0,0,5,88,30,123,"2016"
"35613","292140 MIRANGABA",0,1,7,170,0,178,"2016"
"35614","292145 MIRANTE",0,0,2,83,1,86,"2016"
"35615","292150 MONTE SANTO",1,2,4,620,21,648,"2016"
"35616","292160 MORPARA",0,1,4,105,1,111,"2016"
"35617","292170 MORRO DO CHAPEU",0,4,11,504,5,524,"2016"
"35618","292180 MORTUGABA",0,1,1,93,5,100,"2016"
"35619","292190 MUCUGE",0,0,1,126,29,156,"2016"
"35620","292200 MUCURI",1,4,15,626,0,646,"2016"
"35621","292205 MULUNGU DO MORRO",0,5,3,190,1,199,"2016"
"35622","292210 MUNDO NOVO",0,0,6,194,7,207,"2016"
"35623","292220 MUNIZ FERREIRA",0,0,0,43,50,93,"2016"
"35624","292225 MUQUEM DE SAO FRANCISCO",2,0,6,155,2,165,"2016"
"35625","292230 MURITIBA",1,0,2,214,124,341,"2016"
"35626","292240 MUTUIPE",0,2,11,230,76,319,"2016"
"35627","292250 NAZARE",0,1,11,266,81,359,"2016"
"35628","292260 NILO PECANHA",0,3,21,153,1,178,"2016"
"35629","292265 NORDESTINA",0,1,4,171,5,181,"2016"
"35630","292270 NOVA CANAA",1,1,5,137,1,145,"2016"
"35631","292273 NOVA FATIMA",0,1,1,81,7,90,"2016"
"35632","292275 NOVA IBIA",0,0,4,69,0,73,"2016"
"35633","292280 NOVA ITARANA",2,1,3,123,3,132,"2016"
"35634","292285 NOVA REDENCAO",0,3,3,94,2,102,"2016"
"35635","292290 NOVA SOURE",1,1,9,265,34,310,"2016"
"35636","292300 NOVA VICOSA",1,7,11,629,5,653,"2016"
"35637","292303 NOVO HORIZONTE",0,0,4,108,1,113,"2016"
"35638","292305 NOVO TRIUNFO",0,0,3,107,0,110,"2016"
"35639","292310 OLINDINA",0,3,3,283,17,306,"2016"
"35640","292320 OLIVEIRA DOS BREJINHOS",4,2,10,231,7,254,"2016"
"35641","292330 OURICANGAS",0,1,1,78,3,83,"2016"
"35642","292335 OUROLANDIA",2,2,5,245,3,257,"2016"
"35643","292340 PALMAS DE MONTE ALTO",1,2,3,233,16,255,"2016"
"35644","292350 PALMEIRAS",0,0,5,129,16,150,"2016"
"35645","292360 PARAMIRIM",0,0,5,138,62,205,"2016"
"35646","292370 PARATINGA",5,6,7,432,8,458,"2016"
"35647","292380 PARIPIRANGA",3,0,5,263,2,273,"2016"
"35648","292390 PAU BRASIL",1,0,4,178,4,187,"2016"
"35649","292400 PAULO AFONSO",7,8,68,1726,4,1813,"2016"
"35650","292405 PE DE SERRA",0,0,2,157,7,166,"2016"
"35651","292410 PEDRAO",1,1,0,72,3,77,"2016"
"35652","292420 PEDRO ALEXANDRE",1,0,5,181,8,195,"2016"
"35653","292430 PIATA",2,2,2,283,1,290,"2016"
"35654","292440 PILAO ARCADO",0,0,3,550,3,556,"2016"
"35655","292450 PINDAI",0,0,0,161,4,165,"2016"
"35656","292460 PINDOBACU",1,3,4,270,3,281,"2016"
"35657","292465 PINTADAS",2,1,2,85,8,98,"2016"
"35658","292467 PIRAI DO NORTE",0,1,4,105,1,111,"2016"
"35659","292470 PIRIPA",0,2,0,100,2,104,"2016"
"35660","292480 PIRITIBA",0,2,4,227,1,234,"2016"
"35661","292490 PLANALTINO",0,1,2,99,0,102,"2016"
"35662","292500 PLANALTO",2,0,8,273,4,287,"2016"
"35663","292510 POCOES",1,4,11,607,5,628,"2016"
"35664","292520 POJUCA",0,6,11,510,0,527,"2016"
"35665","292525 PONTO NOVO",2,12,3,225,4,246,"2016"
"35666","292530 PORTO SEGURO",6,10,40,2454,63,2573,"2016"
"35667","292540 POTIRAGUA",0,1,1,100,8,110,"2016"
"35668","292550 PRADO",1,4,5,405,4,419,"2016"
"35669","292560 PRESIDENTE DUTRA",2,2,1,158,0,163,"2016"
"35670","292570 PRESIDENTE JANIO QUADROS",1,1,6,151,2,161,"2016"
"35671","292575 PRESIDENTE TANCREDO NEVES",1,1,10,267,120,399,"2016"
"35672","292580 QUEIMADAS",0,0,4,326,0,330,"2016"
"35673","292590 QUIJINGUE",0,4,1,281,26,312,"2016"
"35674","292593 QUIXABEIRA",0,0,1,107,2,110,"2016"
"35675","292595 RAFAEL JAMBEIRO",0,4,5,248,23,280,"2016"
"35676","292600 REMANSO",3,0,9,684,10,706,"2016"
"35677","292610 RETIROLANDIA",0,0,2,182,7,191,"2016"
"35678","292620 RIACHAO DAS NEVES",0,0,6,263,4,273,"2016"
"35679","292630 RIACHAO DO JACUIPE",1,0,9,379,8,397,"2016"
"35680","292640 RIACHO DE SANTANA",2,3,5,363,16,389,"2016"
"35681","292650 RIBEIRA DO AMPARO",0,1,3,112,71,187,"2016"
"35682","292660 RIBEIRA DO POMBAL",3,1,9,273,456,742,"2016"
"35683","292665 RIBEIRAO DO LARGO",0,1,0,81,2,84,"2016"
"35684","292670 RIO DE CONTAS",0,0,2,156,2,160,"2016"
"35685","292680 RIO DO ANTONIO",0,1,3,123,2,129,"2016"
"35686","292690 RIO DO PIRES",0,4,0,73,30,107,"2016"
"35687","292700 RIO REAL",3,0,10,414,3,430,"2016"
"35688","292710 RODELAS",1,0,8,163,0,172,"2016"
"35689","292720 RUY BARBOSA",0,3,9,386,2,400,"2016"
"35690","292730 SALINAS DA MARGARIDA",2,0,1,116,30,149,"2016"
"35691","292740 SALVADOR",242,209,664,33682,220,35017,"2016"
"35692","292750 SANTA BARBARA",1,0,2,139,52,194,"2016"
"35693","292760 SANTA BRIGIDA",0,2,8,188,0,198,"2016"
"35694","292770 SANTA CRUZ CABRALIA",1,3,6,362,10,382,"2016"
"35695","292780 SANTA CRUZ DA VITORIA",0,0,1,51,0,52,"2016"
"35696","292790 SANTA INES",1,0,0,134,5,140,"2016"
"35697","292800 SANTALUZ",2,2,12,467,10,493,"2016"
"35698","292805 SANTA LUZIA",0,0,4,191,4,199,"2016"
"35699","292810 SANTA MARIA DA VITORIA",0,2,6,401,26,435,"2016"
"35700","292820 SANTANA",3,0,12,281,2,298,"2016"
"35701","292830 SANTANOPOLIS",0,0,0,49,18,67,"2016"
"35702","292840 SANTA RITA DE CASSIA",3,10,7,428,14,462,"2016"
"35703","292850 SANTA TERESINHA",1,1,2,97,10,111,"2016"
"35704","292860 SANTO AMARO",1,3,6,573,35,618,"2016"
"35705","292870 SANTO ANTONIO DE JESUS",2,1,17,705,672,1397,"2016"
"35706","292880 SANTO ESTEVAO",3,7,6,553,169,738,"2016"
"35707","292890 SAO DESIDERIO",1,4,11,484,1,501,"2016"
"35708","292895 SAO DOMINGOS",0,0,3,87,3,93,"2016"
"35709","292900 SAO FELIX",0,0,1,42,136,179,"2016"
"35710","292905 SAO FELIX DO CORIBE",9,1,3,220,2,235,"2016"
"35711","292910 SAO FELIPE",0,0,4,146,54,204,"2016"
"35712","292920 SAO FRANCISCO DO CONDE",4,0,13,641,1,659,"2016"
"35713","292925 SAO GABRIEL",2,3,6,242,4,257,"2016"
"35714","292930 SAO GONCALO DOS CAMPOS",1,0,3,253,112,369,"2016"
"35715","292935 SAO JOSE DA VITORIA",1,1,5,90,1,98,"2016"
"35716","292937 SAO JOSE DO JACUIPE",0,0,1,110,0,111,"2016"
"35717","292940 SAO MIGUEL DAS MATAS",0,0,2,61,67,130,"2016"
"35718","292950 SAO SEBASTIAO DO PASSE",4,1,9,492,4,510,"2016"
"35719","292960 SAPEACU",0,0,5,230,18,253,"2016"
"35720","292970 SATIRO DIAS",0,1,5,191,8,205,"2016"
"35721","292975 SAUBARA",0,0,1,99,2,102,"2016"
"35722","292980 SAUDE",0,2,1,99,6,108,"2016"
"35723","292990 SEABRA",0,4,10,513,24,551,"2016"
"35724","293000 SEBASTIAO LARANJEIRAS",0,0,3,92,8,103,"2016"
"35725","293010 SENHOR DO BONFIM",4,11,24,1014,19,1072,"2016"
"35726","293015 SERRA DO RAMALHO",1,3,4,461,9,478,"2016"
"35727","293020 SENTO SE",3,4,13,500,4,524,"2016"
"35728","293030 SERRA DOURADA",3,0,2,209,2,216,"2016"
"35729","293040 SERRA PRETA",9,1,4,69,23,106,"2016"
"35730","293050 SERRINHA",1,9,142,956,11,1119,"2016"
"35731","293060 SERROLANDIA",0,1,1,129,0,131,"2016"
"35732","293070 SIMOES FILHO",9,10,33,1933,12,1997,"2016"
"35733","293075 SITIO DO MATO",1,0,3,163,6,173,"2016"
"35734","293076 SITIO DO QUINTO",0,1,4,107,1,113,"2016"
"35735","293077 SOBRADINHO",0,4,7,347,7,365,"2016"
"35736","293080 SOUTO SOARES",0,1,5,209,1,216,"2016"
"35737","293090 TABOCAS DO BREJO VELHO",1,0,2,138,0,141,"2016"
"35738","293100 TANHACU",0,0,1,227,4,232,"2016"
"35739","293105 TANQUE NOVO",0,2,4,163,27,196,"2016"
"35740","293110 TANQUINHO",0,0,0,38,23,61,"2016"
"35741","293120 TAPEROA",0,3,19,215,4,241,"2016"
"35742","293130 TAPIRAMUTA",0,2,7,223,5,237,"2016"
"35743","293135 TEIXEIRA DE FREITAS",5,5,31,2394,11,2446,"2016"
"35744","293140 TEODORO SAMPAIO",0,0,0,41,14,55,"2016"
"35745","293150 TEOFILANDIA",0,1,18,244,5,268,"2016"
"35746","293160 TEOLANDIA",0,1,15,173,8,197,"2016"
"35747","293170 TERRA NOVA",2,1,1,94,7,105,"2016"
"35748","293180 TREMEDAL",1,1,3,121,1,127,"2016"
"35749","293190 TUCANO",0,3,5,401,194,603,"2016"
"35750","293200 UAUA",2,2,10,292,6,312,"2016"
"35751","293210 UBAIRA",2,1,5,170,43,221,"2016"
"35752","293220 UBAITABA",2,5,7,269,16,299,"2016"
"35753","293230 UBATA",2,0,7,247,2,258,"2016"
"35754","293240 UIBAI",0,1,1,147,0,149,"2016"
"35755","293245 UMBURANAS",1,1,14,168,0,184,"2016"
"35756","293250 UNA",4,2,4,110,123,243,"2016"
"35757","293260 URANDI",0,1,2,213,3,219,"2016"
"35758","293270 URUCUCA",1,2,7,169,76,255,"2016"
"35759","293280 UTINGA",2,0,3,198,3,206,"2016"
"35760","293290 VALENCA",4,4,138,1229,21,1396,"2016"
"35761","293300 VALENTE",0,2,7,251,7,267,"2016"
"35762","293305 VARZEA DA ROCA",1,0,2,126,2,131,"2016"
"35763","293310 VARZEA DO POCO",1,1,1,78,2,83,"2016"
"35764","293315 VARZEA NOVA",1,3,6,175,3,188,"2016"
"35765","293317 VARZEDO",0,1,3,68,52,124,"2016"
"35766","293320 VERA CRUZ",2,1,16,436,35,490,"2016"
"35767","293325 VEREDA",0,1,2,66,0,69,"2016"
"35768","293330 VITORIA DA CONQUISTA",16,28,104,5338,55,5541,"2016"
"35769","293340 WAGNER",0,0,1,139,1,141,"2016"
"35770","293345 WANDERLEY",0,0,2,173,4,179,"2016"
"35771","293350 WENCESLAU GUIMARAES",2,1,13,324,20,360,"2016"
"35772","293360 XIQUE-XIQUE",1,3,20,796,31,851,"2016"
"35773","MUNICIPIO IGNORADO - MG",0,0,0,4,0,4,"2016"
"35774","310010 ABADIA DOS DOURADOS",0,0,1,58,0,59,"2016"
"35775","310020 ABAETE",0,1,3,209,0,213,"2016"
"35776","310030 ABRE CAMPO",0,0,1,114,35,150,"2016"
"35777","310040 ACAIACA",0,0,0,41,0,41,"2016"
"35778","310050 ACUCENA",0,0,1,105,3,109,"2016"
"35779","310060 AGUA BOA",1,2,0,137,5,145,"2016"
"35780","310070 AGUA COMPRIDA",0,0,1,15,0,16,"2016"
"35781","310080 AGUANIL",0,0,0,40,0,40,"2016"
"35782","310090 AGUAS FORMOSAS",1,2,6,240,0,249,"2016"
"35783","310100 AGUAS VERMELHAS",0,1,3,158,3,165,"2016"
"35784","310110 AIMORES",1,1,5,298,4,309,"2016"
"35785","310120 AIURUOCA",0,0,1,43,1,45,"2016"
"35786","310130 ALAGOA",0,0,1,17,0,18,"2016"
"35787","310140 ALBERTINA",0,0,0,31,0,31,"2016"
"35788","310150 ALEM PARAIBA",1,5,7,397,1,411,"2016"
"35789","310160 ALFENAS",4,1,12,995,0,1012,"2016"
"35790","310163 ALFREDO VASCONCELOS",1,0,0,78,0,79,"2016"
"35791","310170 ALMENARA",10,0,8,565,4,587,"2016"
"35792","310180 ALPERCATA",0,0,0,60,29,89,"2016"
"35793","310190 ALPINOPOLIS",1,2,3,213,0,219,"2016"
"35794","310200 ALTEROSA",0,0,1,147,1,149,"2016"
"35795","310205 ALTO CAPARAO",1,0,0,64,8,73,"2016"
"35796","310210 ALTO RIO DOCE",0,0,0,86,3,89,"2016"
"35797","310220 ALVARENGA",1,0,0,40,11,52,"2016"
"35798","310230 ALVINOPOLIS",0,0,6,140,0,146,"2016"
"35799","310240 ALVORADA DE MINAS",0,0,1,54,0,55,"2016"
"35800","310250 AMPARO DO SERRA",0,0,1,59,0,60,"2016"
"35801","310260 ANDRADAS",0,0,1,481,2,484,"2016"
"35802","310270 CACHOEIRA DE PAJEU",0,0,1,84,4,89,"2016"
"35803","310280 ANDRELANDIA",0,0,2,108,4,114,"2016"
"35804","310285 ANGELANDIA",0,0,1,100,3,104,"2016"
"35805","310290 ANTONIO CARLOS",0,0,2,93,1,96,"2016"
"35806","310300 ANTONIO DIAS",0,0,1,94,2,97,"2016"
"35807","310310 ANTONIO PRADO DE MINAS",0,0,0,10,0,10,"2016"
"35808","310320 ARACAI",0,0,0,20,0,20,"2016"
"35809","310330 ARACITABA",0,0,0,15,0,15,"2016"
"35810","310340 ARACUAI",1,2,12,388,6,409,"2016"
"35811","310350 ARAGUARI",1,4,24,1332,17,1378,"2016"
"35812","310360 ARANTINA",0,0,0,19,2,21,"2016"
"35813","310370 ARAPONGA",1,0,0,89,7,97,"2016"
"35814","310375 ARAPORA",0,0,0,110,2,112,"2016"
"35815","310380 ARAPUA",0,0,0,14,0,14,"2016"
"35816","310390 ARAUJOS",0,1,1,87,0,89,"2016"
"35817","310400 ARAXA",3,6,11,1517,5,1542,"2016"
"35818","310410 ARCEBURGO",0,0,1,61,0,62,"2016"
"35819","310420 ARCOS",0,0,1,456,0,457,"2016"
"35820","310430 AREADO",0,1,0,158,0,159,"2016"
"35821","310440 ARGIRITA",0,1,1,28,0,30,"2016"
"35822","310445 ARICANDUVA",1,1,0,60,0,62,"2016"
"35823","310450 ARINOS",0,0,2,185,2,189,"2016"
"35824","310460 ASTOLFO DUTRA",0,2,2,137,0,141,"2016"
"35825","310470 ATALEIA",1,1,7,120,4,133,"2016"
"35826","310480 AUGUSTO DE LIMA",0,0,2,49,0,51,"2016"
"35827","310490 BAEPENDI",0,0,0,199,2,201,"2016"
"35828","310500 BALDIM",1,0,0,94,0,95,"2016"
"35829","310510 BAMBUI",2,0,2,213,3,220,"2016"
"35830","310520 BANDEIRA",2,0,0,49,1,52,"2016"
"35831","310530 BANDEIRA DO SUL",1,0,1,47,0,49,"2016"
"35832","310540 BARAO DE COCAIS",1,0,7,396,3,407,"2016"
"35833","310550 BARAO DE MONTE ALTO",0,0,1,41,4,46,"2016"
"35834","310560 BARBACENA",0,2,17,1338,8,1365,"2016"
"35835","310570 BARRA LONGA",0,0,0,56,1,57,"2016"
"35836","310590 BARROSO",1,0,2,225,0,228,"2016"
"35837","310600 BELA VISTA DE MINAS",3,0,2,127,0,132,"2016"
"35838","310610 BELMIRO BRAGA",0,2,2,22,1,27,"2016"
"35839","310620 BELO HORIZONTE",89,124,475,28867,93,29648,"2016"
"35840","310630 BELO ORIENTE",0,3,4,309,0,316,"2016"
"35841","310640 BELO VALE",0,0,0,97,0,97,"2016"
"35842","310650 BERILO",0,1,1,83,0,85,"2016"
"35843","310660 BERTOPOLIS",1,0,1,59,12,73,"2016"
"35844","310665 BERIZAL",1,0,1,42,0,44,"2016"
"35845","310670 BETIM",16,22,101,5880,29,6048,"2016"
"35846","310680 BIAS FORTES",0,1,0,23,0,24,"2016"
"35847","310690 BICAS",0,0,1,115,0,116,"2016"
"35848","310700 BIQUINHAS",0,1,0,22,0,23,"2016"
"35849","310710 BOA ESPERANCA",2,1,8,553,3,567,"2016"
"35850","310720 BOCAINA DE MINAS",0,0,1,33,0,34,"2016"
"35851","310730 BOCAIUVA",3,2,11,633,11,660,"2016"
"35852","310740 BOM DESPACHO",7,4,10,632,2,655,"2016"
"35853","310750 BOM JARDIM DE MINAS",0,0,3,79,0,82,"2016"
"35854","310760 BOM JESUS DA PENHA",0,0,1,24,0,25,"2016"
"35855","310770 BOM JESUS DO AMPARO",1,0,0,73,1,75,"2016"
"35856","310780 BOM JESUS DO GALHO",2,1,6,152,1,162,"2016"
"35857","310790 BOM REPOUSO",1,0,0,136,4,141,"2016"
"35858","310800 BOM SUCESSO",0,0,2,155,0,157,"2016"
"35859","310810 BONFIM",0,0,0,54,0,54,"2016"
"35860","310820 BONFINOPOLIS DE MINAS",0,0,0,53,1,54,"2016"
"35861","310825 BONITO DE MINAS",0,0,1,106,29,136,"2016"
"35862","310830 BORDA DA MATA",0,0,2,152,2,156,"2016"
"35863","310840 BOTELHOS",1,1,4,116,1,123,"2016"
"35864","310850 BOTUMIRIM",0,0,0,50,0,50,"2016"
"35865","310855 BRASILANDIA DE MINAS",0,1,7,232,0,240,"2016"
"35866","310860 BRASILIA DE MINAS",0,1,2,442,0,445,"2016"
"35867","310870 BRAS PIRES",0,2,1,46,0,49,"2016"
"35868","310880 BRAUNAS",1,0,0,46,0,47,"2016"
"35869","310890 BRAZOPOLIS",0,0,0,159,0,159,"2016"
"35870","310900 BRUMADINHO",8,0,7,422,1,438,"2016"
"35871","310910 BUENO BRANDAO",0,0,1,86,0,87,"2016"
"35872","310920 BUENOPOLIS",0,1,2,96,1,100,"2016"
"35873","310925 BUGRE",0,2,2,47,0,51,"2016"
"35874","310930 BURITIS",0,1,3,300,5,309,"2016"
"35875","310940 BURITIZEIRO",0,2,10,297,3,312,"2016"
"35876","310945 CABECEIRA GRANDE",0,0,2,52,0,54,"2016"
"35877","310950 CABO VERDE",1,0,0,136,0,137,"2016"
"35878","310960 CACHOEIRA DA PRATA",0,0,0,34,0,34,"2016"
"35879","310970 CACHOEIRA DE MINAS",1,0,1,121,0,123,"2016"
"35880","310980 CACHOEIRA DOURADA",0,0,0,24,0,24,"2016"
"35881","310990 CAETANOPOLIS",0,0,1,104,1,106,"2016"
"35882","311000 CAETE",1,2,9,483,7,502,"2016"
"35883","311010 CAIANA",0,0,0,59,0,59,"2016"
"35884","311020 CAJURI",2,0,2,35,2,41,"2016"
"35885","311030 CALDAS",0,1,6,114,0,121,"2016"
"35886","311040 CAMACHO",1,0,2,25,1,29,"2016"
"35887","311050 CAMANDUCAIA",2,2,2,249,6,261,"2016"
"35888","311060 CAMBUI",0,0,4,318,3,325,"2016"
"35889","311070 CAMBUQUIRA",3,0,0,157,1,161,"2016"
"35890","311080 CAMPANARIO",0,1,0,40,2,43,"2016"
"35891","311090 CAMPANHA",0,2,3,172,1,178,"2016"
"35892","311100 CAMPESTRE",0,2,3,191,0,196,"2016"
"35893","311110 CAMPINA VERDE",2,0,0,175,1,178,"2016"
"35894","311115 CAMPO AZUL",0,0,1,42,0,43,"2016"
"35895","311120 CAMPO BELO",0,0,19,537,1,557,"2016"
"35896","311130 CAMPO DO MEIO",0,1,3,110,1,115,"2016"
"35897","311140 CAMPO FLORIDO",1,0,1,113,0,115,"2016"
"35898","311150 CAMPOS ALTOS",0,2,4,212,0,218,"2016"
"35899","311160 CAMPOS GERAIS",1,0,4,278,0,283,"2016"
"35900","311170 CANAA",0,0,1,39,3,43,"2016"
"35901","311180 CANAPOLIS",0,0,1,111,7,119,"2016"
"35902","311190 CANA VERDE",0,0,1,43,0,44,"2016"
"35903","311200 CANDEIAS",0,1,5,119,0,125,"2016"
"35904","311205 CANTAGALO",0,1,0,52,0,53,"2016"
"35905","311210 CAPARAO",0,0,0,73,0,73,"2016"
"35906","311220 CAPELA NOVA",0,0,2,40,0,42,"2016"
"35907","311230 CAPELINHA",0,1,6,582,1,590,"2016"
"35908","311240 CAPETINGA",0,0,0,70,0,70,"2016"
"35909","311250 CAPIM BRANCO",1,0,1,124,3,129,"2016"
"35910","311260 CAPINOPOLIS",1,0,1,144,4,150,"2016"
"35911","311265 CAPITAO ANDRADE",0,0,0,47,11,58,"2016"
"35912","311270 CAPITAO ENEAS",1,0,3,162,2,168,"2016"
"35913","311280 CAPITOLIO",0,1,0,96,1,98,"2016"
"35914","311290 CAPUTIRA",1,0,0,8,128,137,"2016"
"35915","311300 CARAI",1,0,7,247,3,258,"2016"
"35916","311310 CARANAIBA",0,0,0,22,0,22,"2016"
"35917","311320 CARANDAI",1,3,1,298,0,303,"2016"
"35918","311330 CARANGOLA",0,0,0,397,1,398,"2016"
"35919","311340 CARATINGA",3,3,12,1093,27,1138,"2016"
"35920","311350 CARBONITA",0,1,1,95,1,98,"2016"
"35921","311360 CAREACU",0,0,2,69,0,71,"2016"
"35922","311370 CARLOS CHAGAS",0,1,6,219,0,226,"2016"
"35923","311380 CARMESIA",0,0,1,36,1,38,"2016"
"35924","311390 CARMO DA CACHOEIRA",0,1,3,114,1,119,"2016"
"35925","311400 CARMO DA MATA",0,0,3,81,0,84,"2016"
"35926","311410 CARMO DE MINAS",1,0,2,151,2,156,"2016"
"35927","311420 CARMO DO CAJURU",0,1,4,245,2,252,"2016"
"35928","311430 CARMO DO PARANAIBA",0,0,3,363,0,366,"2016"
"35929","311440 CARMO DO RIO CLARO",1,2,1,189,0,193,"2016"
"35930","311450 CARMOPOLIS DE MINAS",0,1,3,207,0,211,"2016"
"35931","311455 CARNEIRINHO",0,0,1,101,0,102,"2016"
"35932","311460 CARRANCAS",0,0,1,45,0,46,"2016"
"35933","311470 CARVALHOPOLIS",0,0,0,39,0,39,"2016"
"35934","311480 CARVALHOS",0,1,1,37,1,40,"2016"
"35935","311490 CASA GRANDE",0,0,0,20,0,20,"2016"
"35936","311500 CASCALHO RICO",0,0,0,34,0,34,"2016"
"35937","311510 CASSIA",0,2,8,219,0,229,"2016"
"35938","311520 CONCEICAO DA BARRA DE MINAS",0,0,0,22,0,22,"2016"
"35939","311530 CATAGUASES",3,7,36,744,1,791,"2016"
"35940","311535 CATAS ALTAS",1,0,0,49,0,50,"2016"
"35941","311540 CATAS ALTAS DA NORUEGA",0,0,2,31,0,33,"2016"
"35942","311545 CATUJI",0,1,4,121,2,128,"2016"
"35943","311547 CATUTI",0,0,1,28,24,53,"2016"
"35944","311550 CAXAMBU",1,1,1,165,45,213,"2016"
"35945","311560 CEDRO DO ABAETE",0,0,1,9,0,10,"2016"
"35946","311570 CENTRAL DE MINAS",0,0,0,75,5,80,"2016"
"35947","311580 CENTRALINA",0,0,3,98,5,106,"2016"
"35948","311590 CHACARA",0,0,0,26,1,27,"2016"
"35949","311600 CHALE",0,0,0,31,34,65,"2016"
"35950","311610 CHAPADA DO NORTE",0,0,4,89,9,102,"2016"
"35951","311615 CHAPADA GAUCHA",0,1,3,167,2,173,"2016"
"35952","311620 CHIADOR",0,0,0,26,1,27,"2016"
"35953","311630 CIPOTANEA",0,0,2,52,0,54,"2016"
"35954","311640 CLARAVAL",0,0,1,11,0,12,"2016"
"35955","311650 CLARO DOS POCOES",0,0,0,79,0,79,"2016"
"35956","311660 CLAUDIO",3,0,5,349,4,361,"2016"
"35957","311670 COIMBRA",2,0,0,72,2,76,"2016"
"35958","311680 COLUNA",0,1,2,114,1,118,"2016"
"35959","311690 COMENDADOR GOMES",0,0,0,24,0,24,"2016"
"35960","311700 COMERCINHO",0,0,3,60,0,63,"2016"
"35961","311710 CONCEICAO DA APARECIDA",0,0,3,112,0,115,"2016"
"35962","311720 CONCEICAO DAS PEDRAS",0,0,0,28,0,28,"2016"
"35963","311730 CONCEICAO DAS ALAGOAS",1,1,4,358,1,365,"2016"
"35964","311740 CONCEICAO DE IPANEMA",0,0,0,14,16,30,"2016"
"35965","311750 CONCEICAO DO MATO DENTRO",1,0,6,244,1,252,"2016"
"35966","311760 CONCEICAO DO PARA",0,0,1,30,10,41,"2016"
"35967","311770 CONCEICAO DO RIO VERDE",0,1,2,141,2,146,"2016"
"35968","311780 CONCEICAO DOS OUROS",0,1,4,131,2,138,"2016"
"35969","311783 CONEGO MARINHO",0,0,0,65,10,75,"2016"
"35970","311787 CONFINS",0,0,0,81,2,83,"2016"
"35971","311790 CONGONHAL",1,0,3,123,3,130,"2016"
"35972","311800 CONGONHAS",1,2,5,750,3,761,"2016"
"35973","311810 CONGONHAS DO NORTE",0,0,2,50,0,52,"2016"
"35974","311820 CONQUISTA",1,1,2,71,2,77,"2016"
"35975","311830 CONSELHEIRO LAFAIETE",4,6,19,1646,4,1679,"2016"
"35976","311840 CONSELHEIRO PENA",0,1,4,238,15,258,"2016"
"35977","311850 CONSOLACAO",0,0,1,21,0,22,"2016"
"35978","311860 CONTAGEM",27,46,134,8031,40,8278,"2016"
"35979","311870 COQUEIRAL",1,0,1,88,2,92,"2016"
"35980","311880 CORACAO DE JESUS",1,0,2,256,3,262,"2016"
"35981","311890 CORDISBURGO",0,0,0,59,0,59,"2016"
"35982","311900 CORDISLANDIA",0,0,1,29,0,30,"2016"
"35983","311910 CORINTO",3,3,9,277,2,294,"2016"
"35984","311920 COROACI",0,0,1,61,21,83,"2016"
"35985","311930 COROMANDEL",2,0,3,314,1,320,"2016"
"35986","311940 CORONEL FABRICIANO",4,5,21,1240,7,1277,"2016"
"35987","311950 CORONEL MURTA",0,0,1,86,15,102,"2016"
"35988","311960 CORONEL PACHECO",0,0,1,24,0,25,"2016"
"35989","311970 CORONEL XAVIER CHAVES",0,0,1,36,0,37,"2016"
"35990","311980 CORREGO DANTA",0,0,0,23,0,23,"2016"
"35991","311990 CORREGO DO BOM JESUS",0,0,0,27,0,27,"2016"
"35992","311995 CORREGO FUNDO",0,0,0,57,0,57,"2016"
"35993","312000 CORREGO NOVO",0,0,0,41,1,42,"2016"
"35994","312010 COUTO DE MAGALHAES DE MINAS",1,0,1,46,2,50,"2016"
"35995","312015 CRISOLITA",1,0,1,73,1,76,"2016"
"35996","312020 CRISTAIS",1,1,5,121,0,128,"2016"
"35997","312030 CRISTALIA",2,1,1,48,0,52,"2016"
"35998","312040 CRISTIANO OTONI",1,0,0,51,0,52,"2016"
"35999","312050 CRISTINA",0,0,2,124,1,127,"2016"
"36000","312060 CRUCILANDIA",0,0,1,48,0,49,"2016"
"36001","312070 CRUZEIRO DA FORTALEZA",0,0,1,59,0,60,"2016"
"36002","312080 CRUZILIA",0,0,1,188,0,189,"2016"
"36003","312083 CUPARAQUE",0,0,0,55,4,59,"2016"
"36004","312087 CURRAL DE DENTRO",0,0,2,92,14,108,"2016"
"36005","312090 CURVELO",4,5,38,853,2,902,"2016"
"36006","312100 DATAS",0,0,1,85,2,88,"2016"
"36007","312110 DELFIM MOREIRA",1,1,1,71,0,74,"2016"
"36008","312120 DELFINOPOLIS",1,0,3,56,0,60,"2016"
"36009","312125 DELTA",1,3,4,104,1,113,"2016"
"36010","312130 DESCOBERTO",0,0,0,40,0,40,"2016"
"36011","312140 DESTERRO DE ENTRE RIOS",0,0,2,55,0,57,"2016"
"36012","312150 DESTERRO DO MELO",0,0,1,27,0,28,"2016"
"36013","312160 DIAMANTINA",1,0,14,661,14,690,"2016"
"36014","312170 DIOGO DE VASCONCELOS",0,0,2,40,0,42,"2016"
"36015","312180 DIONISIO",1,0,0,51,0,52,"2016"
"36016","312190 DIVINESIA",0,1,1,42,0,44,"2016"
"36017","312200 DIVINO",0,0,2,262,0,264,"2016"
"36018","312210 DIVINO DAS LARANJEIRAS",0,0,0,49,13,62,"2016"
"36019","312220 DIVINOLANDIA DE MINAS",0,0,0,85,8,93,"2016"
"36020","312230 DIVINOPOLIS",2,11,33,2554,12,2612,"2016"
"36021","312235 DIVISA ALEGRE",1,2,5,86,1,95,"2016"
"36022","312240 DIVISA NOVA",0,0,1,84,0,85,"2016"
"36023","312245 DIVISOPOLIS",0,1,1,80,0,82,"2016"
"36024","312247 DOM BOSCO",0,1,1,32,0,34,"2016"
"36025","312250 DOM CAVATI",0,1,1,50,0,52,"2016"
"36026","312260 DOM JOAQUIM",0,1,1,40,1,43,"2016"
"36027","312270 DOM SILVERIO",0,0,0,43,0,43,"2016"
"36028","312280 DOM VICOSO",0,0,0,23,0,23,"2016"
"36029","312290 DONA EUSEBIA",0,0,4,66,0,70,"2016"
"36030","312300 DORES DE CAMPOS",0,0,0,100,1,101,"2016"
"36031","312310 DORES DE GUANHAES",0,1,3,38,0,42,"2016"
"36032","312320 DORES DO INDAIA",0,0,2,140,0,142,"2016"
"36033","312330 DORES DO TURVO",0,1,3,49,1,54,"2016"
"36034","312340 DORESOPOLIS",0,0,0,14,0,14,"2016"
"36035","312350 DOURADOQUARA",0,0,0,15,0,15,"2016"
"36036","312352 DURANDE",1,0,0,18,90,109,"2016"
"36037","312360 ELOI MENDES",4,0,1,294,0,299,"2016"
"36038","312370 ENGENHEIRO CALDAS",0,0,3,94,34,131,"2016"
"36039","312380 ENGENHEIRO NAVARRO",0,1,1,81,1,84,"2016"
"36040","312385 ENTRE FOLHAS",0,0,1,68,2,71,"2016"
"36041","312390 ENTRE RIOS DE MINAS",0,2,2,154,0,158,"2016"
"36042","312400 ERVALIA",0,1,6,195,5,207,"2016"
"36043","312410 ESMERALDAS",6,5,24,1053,6,1094,"2016"
"36044","312420 ESPERA FELIZ",0,1,2,322,4,329,"2016"
"36045","312430 ESPINOSA",1,2,11,336,28,378,"2016"
"36046","312440 ESPIRITO SANTO DO DOURADO",0,0,0,77,0,77,"2016"
"36047","312450 ESTIVA",0,1,0,117,0,118,"2016"
"36048","312460 ESTRELA DALVA",0,0,1,18,0,19,"2016"
"36049","312470 ESTRELA DO INDAIA",0,1,0,29,0,30,"2016"
"36050","312480 ESTRELA DO SUL",1,0,0,78,0,79,"2016"
"36051","312490 EUGENOPOLIS",0,0,2,68,9,79,"2016"
"36052","312500 EWBANK DA CAMARA",0,0,0,41,0,41,"2016"
"36053","312510 EXTREMA",0,6,5,633,1,645,"2016"
"36054","312520 FAMA",0,1,0,26,0,27,"2016"
"36055","312530 FARIA LEMOS",0,0,0,43,0,43,"2016"
"36056","312540 FELICIO DOS SANTOS",0,0,1,49,1,51,"2016"
"36057","312550 SAO GONCALO DO RIO PRETO",0,0,2,27,0,29,"2016"
"36058","312560 FELISBURGO",0,0,1,109,0,110,"2016"
"36059","312570 FELIXLANDIA",1,1,5,111,0,118,"2016"
"36060","312580 FERNANDES TOURINHO",0,0,0,20,10,30,"2016"
"36061","312590 FERROS",0,0,0,87,3,90,"2016"
"36062","312595 FERVEDOURO",0,0,0,145,0,145,"2016"
"36063","312600 FLORESTAL",0,0,2,74,0,76,"2016"
"36064","312610 FORMIGA",1,4,4,675,1,685,"2016"
"36065","312620 FORMOSO",0,0,3,53,1,57,"2016"
"36066","312630 FORTALEZA DE MINAS",0,1,2,30,0,33,"2016"
"36067","312640 FORTUNA DE MINAS",0,0,1,34,0,35,"2016"
"36068","312650 FRANCISCO BADARO",0,0,3,47,1,51,"2016"
"36069","312660 FRANCISCO DUMONT",0,1,0,44,4,49,"2016"
"36070","312670 FRANCISCO SA",0,0,7,217,4,228,"2016"
"36071","312675 FRANCISCOPOLIS",0,0,1,52,1,54,"2016"
"36072","312680 FREI GASPAR",0,1,0,69,0,70,"2016"
"36073","312690 FREI INOCENCIO",0,0,0,74,35,109,"2016"
"36074","312695 FREI LAGONEGRO",0,0,0,38,0,38,"2016"
"36075","312700 FRONTEIRA",0,0,0,130,0,130,"2016"
"36076","312705 FRONTEIRA DOS VALES",0,0,1,44,0,45,"2016"
"36077","312707 FRUTA DE LEITE",0,0,0,4,47,51,"2016"
"36078","312710 FRUTAL",2,2,6,687,1,698,"2016"
"36079","312720 FUNILANDIA",0,0,0,58,0,58,"2016"
"36080","312730 GALILEIA",1,0,4,68,25,98,"2016"
"36081","312733 GAMELEIRAS",0,0,0,18,32,50,"2016"
"36082","312735 GLAUCILANDIA",0,0,1,21,0,22,"2016"
"36083","312737 GOIABEIRA",0,0,0,32,2,34,"2016"
"36084","312738 GOIANA",1,0,0,29,0,30,"2016"
"36085","312740 GONCALVES",0,0,0,30,0,30,"2016"
"36086","312750 GONZAGA",0,0,0,63,16,79,"2016"
"36087","312760 GOUVEIA",1,1,3,127,1,133,"2016"
"36088","312770 GOVERNADOR VALADARES",13,4,34,3135,718,3904,"2016"
"36089","312780 GRAO MOGOL",0,0,2,142,10,154,"2016"
"36090","312790 GRUPIARA",0,0,0,13,0,13,"2016"
"36091","312800 GUANHAES",0,4,15,429,0,448,"2016"
"36092","312810 GUAPE",0,0,5,152,0,157,"2016"
"36093","312820 GUARACIABA",0,0,4,90,1,95,"2016"
"36094","312825 GUARACIAMA",0,0,0,56,2,58,"2016"
"36095","312830 GUARANESIA",2,2,1,201,14,220,"2016"
"36096","312840 GUARANI",0,0,0,80,1,81,"2016"
"36097","312850 GUARARA",0,0,0,31,0,31,"2016"
"36098","312860 GUARDA-MOR",0,1,0,82,4,87,"2016"
"36099","312870 GUAXUPE",1,4,19,605,3,632,"2016"
"36100","312880 GUIDOVAL",0,0,2,69,0,71,"2016"
"36101","312890 GUIMARANIA",0,1,1,92,0,94,"2016"
"36102","312900 GUIRICEMA",0,0,0,53,0,53,"2016"
"36103","312910 GURINHATA",0,0,0,28,0,28,"2016"
"36104","312920 HELIODORA",0,0,0,59,0,59,"2016"
"36105","312930 IAPU",0,1,1,136,1,139,"2016"
"36106","312940 IBERTIOGA",0,0,2,69,0,71,"2016"
"36107","312950 IBIA",1,0,5,255,0,261,"2016"
"36108","312960 IBIAI",1,0,2,85,0,88,"2016"
"36109","312965 IBIRACATU",0,0,0,57,0,57,"2016"
"36110","312970 IBIRACI",0,0,6,143,0,149,"2016"
"36111","312980 IBIRITE",12,6,49,2525,9,2601,"2016"
"36112","312990 IBITIURA DE MINAS",0,0,1,28,0,29,"2016"
"36113","313000 IBITURUNA",0,0,0,19,0,19,"2016"
"36114","313005 ICARAI DE MINAS",0,0,1,112,2,115,"2016"
"36115","313010 IGARAPE",1,0,10,538,13,562,"2016"
"36116","313020 IGARATINGA",0,1,4,114,3,122,"2016"
"36117","313030 IGUATAMA",0,0,0,82,0,82,"2016"
"36118","313040 IJACI",0,0,1,77,0,78,"2016"
"36119","313050 ILICINEA",0,1,0,135,0,136,"2016"
"36120","313055 IMBE DE MINAS",0,0,0,78,1,79,"2016"
"36121","313060 INCONFIDENTES",0,1,0,76,0,77,"2016"
"36122","313065 INDAIABIRA",0,0,1,69,0,70,"2016"
"36123","313070 INDIANOPOLIS",0,0,0,62,0,62,"2016"
"36124","313080 INGAI",0,0,1,23,0,24,"2016"
"36125","313090 INHAPIM",3,1,1,230,3,238,"2016"
"36126","313100 INHAUMA",0,0,1,84,0,85,"2016"
"36127","313110 INIMUTABA",0,1,5,71,0,77,"2016"
"36128","313115 IPABA",0,1,2,213,1,217,"2016"
"36129","313120 IPANEMA",0,1,2,197,31,231,"2016"
"36130","313130 IPATINGA",3,11,25,2861,13,2913,"2016"
"36131","313140 IPIACU",0,0,0,40,0,40,"2016"
"36132","313150 IPUIUNA",0,0,3,87,0,90,"2016"
"36133","313160 IRAI DE MINAS",1,0,1,74,0,76,"2016"
"36134","313170 ITABIRA",8,3,17,1512,14,1554,"2016"
"36135","313180 ITABIRINHA",0,1,1,139,5,146,"2016"
"36136","313190 ITABIRITO",4,3,13,677,0,697,"2016"
"36137","313200 ITACAMBIRA",0,0,0,28,0,28,"2016"
"36138","313210 ITACARAMBI",2,0,1,210,53,266,"2016"
"36139","313220 ITAGUARA",1,0,2,153,0,156,"2016"
"36140","313230 ITAIPE",6,1,1,176,0,184,"2016"
"36141","313240 ITAJUBA",0,2,11,1184,1,1198,"2016"
"36142","313250 ITAMARANDIBA",2,2,3,446,2,455,"2016"
"36143","313260 ITAMARATI DE MINAS",0,0,2,38,0,40,"2016"
"36144","313270 ITAMBACURI",0,3,8,376,8,395,"2016"
"36145","313280 ITAMBE DO MATO DENTRO",2,0,0,14,0,16,"2016"
"36146","313290 ITAMOGI",3,0,0,124,0,127,"2016"
"36147","313300 ITAMONTE",1,0,2,192,0,195,"2016"
"36148","313310 ITANHANDU",1,0,2,159,1,163,"2016"
"36149","313320 ITANHOMI",0,0,3,128,22,153,"2016"
"36150","313330 ITAOBIM",0,0,0,221,0,221,"2016"
"36151","313340 ITAPAGIPE",0,0,1,115,1,117,"2016"
"36152","313350 ITAPECERICA",0,1,5,179,0,185,"2016"
"36153","313360 ITAPEVA",0,0,3,121,0,124,"2016"
"36154","313370 ITATIAIUCU",0,0,0,139,0,139,"2016"
"36155","313375 ITAU DE MINAS",0,0,3,183,1,187,"2016"
"36156","313380 ITAUNA",5,3,10,981,0,999,"2016"
"36157","313390 ITAVERAVA",0,0,1,54,0,55,"2016"
"36158","313400 ITINGA",2,0,6,154,3,165,"2016"
"36159","313410 ITUETA",0,1,0,71,0,72,"2016"
"36160","313420 ITUIUTABA",8,2,8,1219,7,1244,"2016"
"36161","313430 ITUMIRIM",1,1,1,69,0,72,"2016"
"36162","313440 ITURAMA",0,3,2,518,4,527,"2016"
"36163","313450 ITUTINGA",1,0,1,28,0,30,"2016"
"36164","313460 JABOTICATUBAS",2,1,1,201,1,206,"2016"
"36165","313470 JACINTO",2,0,21,107,3,133,"2016"
"36166","313480 JACUI",0,2,2,84,1,89,"2016"
"36167","313490 JACUTINGA",0,0,1,289,0,290,"2016"
"36168","313500 JAGUARACU",0,0,1,31,0,32,"2016"
"36169","313505 JAIBA",2,5,16,508,90,621,"2016"
"36170","313507 JAMPRUCA",2,0,1,40,20,63,"2016"
"36171","313510 JANAUBA",1,3,24,1014,8,1050,"2016"
"36172","313520 JANUARIA",2,3,7,806,194,1012,"2016"
"36173","313530 JAPARAIBA",0,0,0,42,2,44,"2016"
"36174","313535 JAPONVAR",1,1,2,89,0,93,"2016"
"36175","313540 JECEABA",0,0,0,47,0,47,"2016"
"36176","313545 JENIPAPO DE MINAS",0,0,1,59,3,63,"2016"
"36177","313550 JEQUERI",0,0,3,118,3,124,"2016"
"36178","313560 JEQUITAI",0,1,2,79,1,83,"2016"
"36179","313570 JEQUITIBA",0,0,1,53,0,54,"2016"
"36180","313580 JEQUITINHONHA",1,1,5,279,0,286,"2016"
"36181","313590 JESUANIA",0,0,0,50,0,50,"2016"
"36182","313600 JOAIMA",0,2,0,187,1,190,"2016"
"36183","313610 JOANESIA",0,0,0,44,1,45,"2016"
"36184","313620 JOAO MONLEVADE",6,3,11,878,3,901,"2016"
"36185","313630 JOAO PINHEIRO",3,2,9,661,1,676,"2016"
"36186","313640 JOAQUIM FELICIO",0,0,0,34,1,35,"2016"
"36187","313650 JORDANIA",1,0,0,91,6,98,"2016"
"36188","313652 JOSE GONCALVES DE MINAS",1,0,1,46,3,51,"2016"
"36189","313655 JOSE RAYDAN",0,0,2,49,0,51,"2016"
"36190","313657 JOSENOPOLIS",1,0,0,7,24,32,"2016"
"36191","313660 NOVA UNIAO",1,0,1,71,6,79,"2016"
"36192","313665 JUATUBA",0,1,5,376,3,385,"2016"
"36193","313670 JUIZ DE FORA",12,31,77,6124,15,6259,"2016"
"36194","313680 JURAMENTO",0,1,1,41,0,43,"2016"
"36195","313690 JURUAIA",0,1,0,146,0,147,"2016"
"36196","313695 JUVENILIA",0,0,1,13,49,63,"2016"
"36197","313700 LADAINHA",0,1,4,186,5,196,"2016"
"36198","313710 LAGAMAR",0,0,1,45,0,46,"2016"
"36199","313720 LAGOA DA PRATA",2,1,7,608,5,623,"2016"
"36200","313730 LAGOA DOS PATOS",0,0,0,27,0,27,"2016"
"36201","313740 LAGOA DOURADA",0,0,1,138,0,139,"2016"
"36202","313750 LAGOA FORMOSA",0,1,0,183,0,184,"2016"
"36203","313753 LAGOA GRANDE",0,1,0,89,0,90,"2016"
"36204","313760 LAGOA SANTA",1,3,18,777,4,803,"2016"
"36205","313770 LAJINHA",0,0,0,212,77,289,"2016"
"36206","313780 LAMBARI",1,1,3,219,0,224,"2016"
"36207","313790 LAMIM",0,1,3,30,0,34,"2016"
"36208","313800 LARANJAL",1,0,0,34,1,36,"2016"
"36209","313810 LASSANCE",0,0,2,60,1,63,"2016"
"36210","313820 LAVRAS",0,2,11,1286,1,1300,"2016"
"36211","313830 LEANDRO FERREIRA",0,1,0,24,3,28,"2016"
"36212","313835 LEME DO PRADO",0,0,0,48,1,49,"2016"
"36213","313840 LEOPOLDINA",0,4,4,607,1,616,"2016"
"36214","313850 LIBERDADE",0,0,1,33,2,36,"2016"
"36215","313860 LIMA DUARTE",0,1,5,163,1,170,"2016"
"36216","313862 LIMEIRA DO OESTE",0,0,0,98,4,102,"2016"
"36217","313865 LONTRA",0,0,0,99,0,99,"2016"
"36218","313867 LUISBURGO",0,0,0,1,99,100,"2016"
"36219","313868 LUISLANDIA",0,0,3,87,0,90,"2016"
"36220","313870 LUMINARIAS",0,0,0,53,0,53,"2016"
"36221","313880 LUZ",2,2,3,212,0,219,"2016"
"36222","313890 MACHACALIS",0,1,0,82,1,84,"2016"
"36223","313900 MACHADO",1,0,5,469,1,476,"2016"
"36224","313910 MADRE DE DEUS DE MINAS",0,0,0,50,6,56,"2016"
"36225","313920 MALACACHETA",0,1,8,231,4,244,"2016"
"36226","313925 MAMONAS",0,0,2,15,45,62,"2016"
"36227","313930 MANGA",0,0,4,93,205,302,"2016"
"36228","313940 MANHUACU",0,0,0,34,1251,1285,"2016"
"36229","313950 MANHUMIRIM",0,1,1,77,212,291,"2016"
"36230","313960 MANTENA",0,0,5,306,10,321,"2016"
"36231","313970 MARAVILHAS",0,1,2,80,2,85,"2016"
"36232","313980 MAR DE ESPANHA",1,0,2,134,0,137,"2016"
"36233","313990 MARIA DA FE",0,0,2,164,0,166,"2016"
"36234","314000 MARIANA",0,4,17,841,19,881,"2016"
"36235","314010 MARILAC",1,1,0,29,19,50,"2016"
"36236","314015 MARIO CAMPOS",0,1,2,207,2,212,"2016"
"36237","314020 MARIPA DE MINAS",0,0,0,34,0,34,"2016"
"36238","314030 MARLIERIA",0,0,0,38,0,38,"2016"
"36239","314040 MARMELOPOLIS",0,0,0,36,0,36,"2016"
"36240","314050 MARTINHO CAMPOS",0,1,3,137,12,153,"2016"
"36241","314053 MARTINS SOARES",0,0,0,18,87,105,"2016"
"36242","314055 MATA VERDE",1,0,2,78,1,82,"2016"
"36243","314060 MATERLANDIA",0,0,1,45,1,47,"2016"
"36244","314070 MATEUS LEME",0,0,5,427,3,435,"2016"
"36245","314080 MATIAS BARBOSA",1,0,1,118,0,120,"2016"
"36246","314085 MATIAS CARDOSO",0,1,2,104,19,126,"2016"
"36247","314090 MATIPO",0,1,0,55,222,278,"2016"
"36248","314100 MATO VERDE",1,0,2,113,26,142,"2016"
"36249","314110 MATOZINHOS",3,1,2,463,15,484,"2016"
"36250","314120 MATUTINA",0,0,1,29,0,30,"2016"
"36251","314130 MEDEIROS",0,2,0,39,0,41,"2016"
"36252","314140 MEDINA",0,4,7,235,1,247,"2016"
"36253","314150 MENDES PIMENTEL",0,0,0,53,3,56,"2016"
"36254","314160 MERCES",0,0,1,74,3,78,"2016"
"36255","314170 MESQUITA",0,0,1,64,1,66,"2016"
"36256","314180 MINAS NOVAS",1,0,2,292,15,310,"2016"
"36257","314190 MINDURI",0,0,1,30,0,31,"2016"
"36258","314200 MIRABELA",0,1,0,156,0,157,"2016"
"36259","314210 MIRADOURO",0,1,2,55,7,65,"2016"
"36260","314220 MIRAI",0,3,0,116,4,123,"2016"
"36261","314225 MIRAVANIA",0,0,0,22,43,65,"2016"
"36262","314230 MOEDA",0,0,1,40,0,41,"2016"
"36263","314240 MOEMA",0,0,1,81,1,83,"2016"
"36264","314250 MONJOLOS",0,1,1,25,0,27,"2016"
"36265","314260 MONSENHOR PAULO",0,0,0,82,1,83,"2016"
"36266","314270 MONTALVANIA",0,0,1,19,186,206,"2016"
"36267","314280 MONTE ALEGRE DE MINAS",0,0,2,155,108,265,"2016"
"36268","314290 MONTE AZUL",0,0,4,37,185,226,"2016"
"36269","314300 MONTE BELO",1,0,1,141,0,143,"2016"
"36270","314310 MONTE CARMELO",0,2,6,572,1,581,"2016"
"36271","314315 MONTE FORMOSO",0,0,0,65,0,65,"2016"
"36272","314320 MONTE SANTO DE MINAS",4,0,3,195,2,204,"2016"
"36273","314330 MONTES CLAROS",20,34,101,5732,29,5916,"2016"
"36274","314340 MONTE SIAO",0,0,4,237,1,242,"2016"
"36275","314345 MONTEZUMA",0,0,1,63,1,65,"2016"
"36276","314350 MORADA NOVA DE MINAS",0,0,1,80,0,81,"2016"
"36277","314360 MORRO DA GARCA",0,0,1,34,0,35,"2016"
"36278","314370 MORRO DO PILAR",0,0,1,25,0,26,"2016"
"36279","314380 MUNHOZ",0,0,1,63,0,64,"2016"
"36280","314390 MURIAE",0,11,16,1188,126,1341,"2016"
"36281","314400 MUTUM",1,0,2,292,44,339,"2016"
"36282","314410 MUZAMBINHO",1,0,8,258,0,267,"2016"
"36283","314420 NACIP RAYDAN",0,0,0,21,4,25,"2016"
"36284","314430 NANUQUE",1,2,11,454,0,468,"2016"
"36285","314435 NAQUE",1,1,1,98,1,102,"2016"
"36286","314437 NATALANDIA",0,0,0,47,0,47,"2016"
"36287","314440 NATERCIA",0,0,0,39,0,39,"2016"
"36288","314450 NAZARENO",0,0,0,74,0,74,"2016"
"36289","314460 NEPOMUCENO",2,3,2,244,0,251,"2016"
"36290","314465 NINHEIRA",0,0,3,65,16,84,"2016"
"36291","314467 NOVA BELEM",0,0,1,37,3,41,"2016"
"36292","314470 NOVA ERA",0,2,3,235,2,242,"2016"
"36293","314480 NOVA LIMA",4,6,21,1345,5,1381,"2016"
"36294","314490 NOVA MODICA",0,1,1,41,3,46,"2016"
"36295","314500 NOVA PONTE",1,0,1,168,1,171,"2016"
"36296","314505 NOVA PORTEIRINHA",0,1,3,96,0,100,"2016"
"36297","314510 NOVA RESENDE",0,0,3,204,0,207,"2016"
"36298","314520 NOVA SERRANA",3,3,18,1397,25,1446,"2016"
"36299","314530 NOVO CRUZEIRO",2,2,4,347,8,363,"2016"
"36300","314535 NOVO ORIENTE DE MINAS",2,0,2,117,6,127,"2016"
"36301","314537 NOVORIZONTE",0,0,0,15,33,48,"2016"
"36302","314540 OLARIA",0,0,0,17,0,17,"2016"
"36303","314545 OLHOS-D'AGUA",0,1,1,64,4,70,"2016"
"36304","314550 OLIMPIO NORONHA",0,0,3,28,1,32,"2016"
"36305","314560 OLIVEIRA",3,0,3,419,0,425,"2016"
"36306","314570 OLIVEIRA FORTES",1,0,1,20,0,22,"2016"
"36307","314580 ONCA DE PITANGUI",0,0,0,29,5,34,"2016"
"36308","314585 ORATORIOS",0,1,1,45,0,47,"2016"
"36309","314587 ORIZANIA",0,1,0,133,0,134,"2016"
"36310","314590 OURO BRANCO",0,2,5,555,1,563,"2016"
"36311","314600 OURO FINO",2,1,4,323,0,330,"2016"
"36312","314610 OURO PRETO",2,3,37,817,9,868,"2016"
"36313","314620 OURO VERDE DE MINAS",0,0,1,97,3,101,"2016"
"36314","314625 PADRE CARVALHO",0,0,0,20,54,74,"2016"
"36315","314630 PADRE PARAISO",16,1,2,249,5,273,"2016"
"36316","314640 PAINEIRAS",0,0,1,49,0,50,"2016"
"36317","314650 PAINS",0,0,1,88,0,89,"2016"
"36318","314655 PAI PEDRO",1,0,1,50,3,55,"2016"
"36319","314660 PAIVA",0,0,0,22,0,22,"2016"
"36320","314670 PALMA",0,1,0,53,2,56,"2016"
"36321","314675 PALMOPOLIS",1,0,1,59,0,61,"2016"
"36322","314690 PAPAGAIOS",0,0,2,160,5,167,"2016"
"36323","314700 PARACATU",1,4,21,1275,3,1304,"2016"
"36324","314710 PARA DE MINAS",2,3,12,1073,28,1118,"2016"
"36325","314720 PARAGUACU",0,0,4,242,0,246,"2016"
"36326","314730 PARAISOPOLIS",0,0,0,194,1,195,"2016"
"36327","314740 PARAOPEBA",0,0,0,272,2,274,"2016"
"36328","314750 PASSABEM",0,0,1,11,1,13,"2016"
"36329","314760 PASSA QUATRO",0,0,5,182,0,187,"2016"
"36330","314770 PASSA TEMPO",0,0,0,51,1,52,"2016"
"36331","314780 PASSA-VINTE",0,0,1,12,0,13,"2016"
"36332","314790 PASSOS",1,1,22,1385,8,1417,"2016"
"36333","314795 PATIS",0,0,0,64,0,64,"2016"
"36334","314800 PATOS DE MINAS",6,6,16,1753,0,1781,"2016"
"36335","314810 PATROCINIO",0,6,13,1183,2,1204,"2016"
"36336","314820 PATROCINIO DO MURIAE",0,1,0,45,3,49,"2016"
"36337","314830 PAULA CANDIDO",1,0,2,84,2,89,"2016"
"36338","314840 PAULISTAS",0,0,1,42,0,43,"2016"
"36339","314850 PAVAO",1,1,0,80,3,85,"2016"
"36340","314860 PECANHA",1,1,2,202,2,208,"2016"
"36341","314870 PEDRA AZUL",3,6,8,287,4,308,"2016"
"36342","314875 PEDRA BONITA",0,0,1,73,13,87,"2016"
"36343","314880 PEDRA DO ANTA",0,1,1,33,0,35,"2016"
"36344","314890 PEDRA DO INDAIA",0,0,1,33,0,34,"2016"
"36345","314900 PEDRA DOURADA",0,0,0,34,0,34,"2016"
"36346","314910 PEDRALVA",1,0,0,129,0,130,"2016"
"36347","314915 PEDRAS DE MARIA DA CRUZ",1,0,0,90,27,118,"2016"
"36348","314920 PEDRINOPOLIS",0,0,2,41,0,43,"2016"
"36349","314930 PEDRO LEOPOLDO",1,1,6,814,12,834,"2016"
"36350","314940 PEDRO TEIXEIRA",0,0,0,13,0,13,"2016"
"36351","314950 PEQUERI",0,0,0,45,1,46,"2016"
"36352","314960 PEQUI",0,0,0,42,0,42,"2016"
"36353","314970 PERDIGAO",0,0,3,149,5,157,"2016"
"36354","314980 PERDIZES",0,0,6,188,2,196,"2016"
"36355","314990 PERDOES",1,0,0,188,0,189,"2016"
"36356","314995 PERIQUITO",0,0,2,75,21,98,"2016"
"36357","315000 PESCADOR",0,0,0,51,1,52,"2016"
"36358","315010 PIAU",0,1,2,27,1,31,"2016"
"36359","315015 PIEDADE DE CARATINGA",0,1,0,144,2,147,"2016"
"36360","315020 PIEDADE DE PONTE NOVA",0,0,0,54,0,54,"2016"
"36361","315030 PIEDADE DO RIO GRANDE",0,0,1,40,1,42,"2016"
"36362","315040 PIEDADE DOS GERAIS",0,0,0,49,3,52,"2016"
"36363","315050 PIMENTA",0,0,1,68,0,69,"2016"
"36364","315053 PINGO-D'AGUA",0,0,0,54,2,56,"2016"
"36365","315057 PINTOPOLIS",1,0,1,81,2,85,"2016"
"36366","315060 PIRACEMA",0,0,0,64,1,65,"2016"
"36367","315070 PIRAJUBA",0,1,0,94,0,95,"2016"
"36368","315080 PIRANGA",0,0,2,145,2,149,"2016"
"36369","315090 PIRANGUCU",0,0,0,41,0,41,"2016"
"36370","315100 PIRANGUINHO",0,0,1,130,0,131,"2016"
"36371","315110 PIRAPETINGA",0,1,2,139,0,142,"2016"
"36372","315120 PIRAPORA",1,0,10,752,0,763,"2016"
"36373","315130 PIRAUBA",0,0,0,118,2,120,"2016"
"36374","315140 PITANGUI",0,2,5,211,112,330,"2016"
"36375","315150 PIUMHI",0,0,7,376,0,383,"2016"
"36376","315160 PLANURA",0,0,3,121,2,126,"2016"
"36377","315170 POCO FUNDO",0,0,0,178,0,178,"2016"
"36378","315180 POCOS DE CALDAS",5,5,71,1785,7,1873,"2016"
"36379","315190 POCRANE",0,2,2,62,9,75,"2016"
"36380","315200 POMPEU",2,1,6,413,0,422,"2016"
"36381","315210 PONTE NOVA",1,2,3,704,2,712,"2016"
"36382","315213 PONTO CHIQUE",0,0,1,56,0,57,"2016"
"36383","315217 PONTO DOS VOLANTES",2,0,4,133,0,139,"2016"
"36384","315220 PORTEIRINHA",0,1,16,425,4,446,"2016"
"36385","315230 PORTO FIRME",0,0,4,78,0,82,"2016"
"36386","315240 POTE",0,0,2,155,1,158,"2016"
"36387","315250 POUSO ALEGRE",0,5,16,1789,9,1819,"2016"
"36388","315260 POUSO ALTO",0,0,0,70,0,70,"2016"
"36389","315270 PRADOS",1,0,0,72,0,73,"2016"
"36390","315280 PRATA",2,1,2,366,0,371,"2016"
"36391","315290 PRATAPOLIS",0,0,1,74,2,77,"2016"
"36392","315300 PRATINHA",0,0,1,40,0,41,"2016"
"36393","315310 PRESIDENTE BERNARDES",0,1,0,39,0,40,"2016"
"36394","315320 PRESIDENTE JUSCELINO",0,0,0,28,0,28,"2016"
"36395","315330 PRESIDENTE KUBITSCHEK",0,0,2,33,2,37,"2016"
"36396","315340 PRESIDENTE OLEGARIO",1,2,1,178,0,182,"2016"
"36397","315350 ALTO JEQUITIBA",1,0,0,34,63,98,"2016"
"36398","315360 PRUDENTE DE MORAIS",1,1,1,131,2,136,"2016"
"36399","315370 QUARTEL GERAL",0,0,0,22,0,22,"2016"
"36400","315380 QUELUZITO",0,0,0,19,0,19,"2016"
"36401","315390 RAPOSOS",1,3,3,201,0,208,"2016"
"36402","315400 RAUL SOARES",0,0,0,213,0,213,"2016"
"36403","315410 RECREIO",1,0,0,82,2,85,"2016"
"36404","315415 REDUTO",0,0,0,5,90,95,"2016"
"36405","315420 RESENDE COSTA",0,0,2,110,0,112,"2016"
"36406","315430 RESPLENDOR",1,0,2,181,4,188,"2016"
"36407","315440 RESSAQUINHA",0,0,0,40,0,40,"2016"
"36408","315445 RIACHINHO",1,0,0,71,0,72,"2016"
"36409","315450 RIACHO DOS MACHADOS",0,0,2,112,0,114,"2016"
"36410","315460 RIBEIRAO DAS NEVES",18,26,89,4702,58,4893,"2016"
"36411","315470 RIBEIRAO VERMELHO",0,0,0,48,0,48,"2016"
"36412","315480 RIO ACIMA",0,0,1,135,2,138,"2016"
"36413","315490 RIO CASCA",0,0,3,140,1,144,"2016"
"36414","315500 RIO DOCE",0,0,1,22,0,23,"2016"
"36415","315510 RIO DO PRADO",0,1,0,42,0,43,"2016"
"36416","315520 RIO ESPERA",0,0,1,31,0,32,"2016"
"36417","315530 RIO MANSO",0,0,0,42,1,43,"2016"
"36418","315540 RIO NOVO",0,0,1,64,0,65,"2016"
"36419","315550 RIO PARANAIBA",0,0,1,146,0,147,"2016"
"36420","315560 RIO PARDO DE MINAS",0,1,5,390,1,397,"2016"
"36421","315570 RIO PIRACICABA",2,0,2,147,1,152,"2016"
"36422","315580 RIO POMBA",1,0,2,165,2,170,"2016"
"36423","315590 RIO PRETO",0,1,2,33,0,36,"2016"
"36424","315600 RIO VERMELHO",0,4,4,148,1,157,"2016"
"36425","315610 RITAPOLIS",0,0,0,42,0,42,"2016"
"36426","315620 ROCHEDO DE MINAS",0,0,1,27,0,28,"2016"
"36427","315630 RODEIRO",0,0,3,115,1,119,"2016"
"36428","315640 ROMARIA",0,0,0,31,0,31,"2016"
"36429","315645 ROSARIO DA LIMEIRA",0,0,0,23,6,29,"2016"
"36430","315650 RUBELITA",0,1,0,11,45,57,"2016"
"36431","315660 RUBIM",0,0,0,89,1,90,"2016"
"36432","315670 SABARA",2,8,20,1726,7,1763,"2016"
"36433","315680 SABINOPOLIS",0,0,3,167,6,176,"2016"
"36434","315690 SACRAMENTO",1,0,5,325,2,333,"2016"
"36435","315700 SALINAS",1,0,3,77,423,504,"2016"
"36436","315710 SALTO DA DIVISA",1,0,9,68,1,79,"2016"
"36437","315720 SANTA BARBARA",1,0,9,410,0,420,"2016"
"36438","315725 SANTA BARBARA DO LESTE",1,0,0,109,3,113,"2016"
"36439","315727 SANTA BARBARA DO MONTE VERDE",0,0,1,29,1,31,"2016"
"36440","315730 SANTA BARBARA DO TUGURIO",0,0,1,39,0,40,"2016"
"36441","315733 SANTA CRUZ DE MINAS",0,0,0,92,0,92,"2016"
"36442","315737 SANTA CRUZ DE SALINAS",0,0,1,14,30,45,"2016"
"36443","315740 SANTA CRUZ DO ESCALVADO",1,1,0,42,0,44,"2016"
"36444","315750 SANTA EFIGENIA DE MINAS",0,0,1,36,18,55,"2016"
"36445","315760 SANTA FE DE MINAS",0,0,2,40,1,43,"2016"
"36446","315765 SANTA HELENA DE MINAS",0,0,0,81,14,95,"2016"
"36447","315770 SANTA JULIANA",0,1,2,184,0,187,"2016"
"36448","315780 SANTA LUZIA",4,13,46,2932,14,3009,"2016"
"36449","315790 SANTA MARGARIDA",0,2,0,136,113,251,"2016"
"36450","315800 SANTA MARIA DE ITABIRA",0,0,1,139,3,143,"2016"
"36451","315810 SANTA MARIA DO SALTO",0,0,2,45,0,47,"2016"
"36452","315820 SANTA MARIA DO SUACUI",0,2,0,162,7,171,"2016"
"36453","315830 SANTANA DA VARGEM",0,0,0,68,2,70,"2016"
"36454","315840 SANTANA DE CATAGUASES",0,0,1,11,0,12,"2016"
"36455","315850 SANTANA DE PIRAPAMA",0,1,1,58,0,60,"2016"
"36456","315860 SANTANA DO DESERTO",0,0,1,41,1,43,"2016"
"36457","315870 SANTANA DO GARAMBEU",0,0,2,16,0,18,"2016"
"36458","315880 SANTANA DO JACARE",0,0,2,52,0,54,"2016"
"36459","315890 SANTANA DO MANHUACU",0,0,0,4,116,120,"2016"
"36460","315895 SANTANA DO PARAISO",5,0,10,613,2,630,"2016"
"36461","315900 SANTANA DO RIACHO",0,0,0,50,1,51,"2016"
"36462","315910 SANTANA DOS MONTES",0,0,2,33,0,35,"2016"
"36463","315920 SANTA RITA DE CALDAS",0,1,1,63,1,66,"2016"
"36464","315930 SANTA RITA DE JACUTINGA",0,0,1,38,2,41,"2016"
"36465","315935 SANTA RITA DE MINAS",0,0,1,102,0,103,"2016"
"36466","315940 SANTA RITA DE IBITIPOCA",0,0,1,21,1,23,"2016"
"36467","315950 SANTA RITA DO ITUETO",0,0,1,70,1,72,"2016"
"36468","315960 SANTA RITA DO SAPUCAI",1,0,3,462,5,471,"2016"
"36469","315970 SANTA ROSA DA SERRA",0,0,0,32,0,32,"2016"
"36470","315980 SANTA VITORIA",0,0,3,309,0,312,"2016"
"36471","315990 SANTO ANTONIO DO AMPARO",0,1,1,189,0,191,"2016"
"36472","316000 SANTO ANTONIO DO AVENTUREIRO",0,0,0,25,0,25,"2016"
"36473","316010 SANTO ANTONIO DO GRAMA",0,0,0,46,1,47,"2016"
"36474","316020 SANTO ANTONIO DO ITAMBE",0,0,1,32,1,34,"2016"
"36475","316030 SANTO ANTONIO DO JACINTO",0,1,13,125,2,141,"2016"
"36476","316040 SANTO ANTONIO DO MONTE",0,0,8,327,0,335,"2016"
"36477","316045 SANTO ANTONIO DO RETIRO",0,0,3,61,16,80,"2016"
"36478","316050 SANTO ANTONIO DO RIO ABAIXO",0,0,1,10,0,11,"2016"
"36479","316060 SANTO HIPOLITO",0,0,1,25,0,26,"2016"
"36480","316070 SANTOS DUMONT",2,5,6,493,3,509,"2016"
"36481","316080 SAO BENTO ABADE",0,0,0,69,0,69,"2016"
"36482","316090 SAO BRAS DO SUACUI",0,0,0,44,0,44,"2016"
"36483","316095 SAO DOMINGOS DAS DORES",0,0,3,82,0,85,"2016"
"36484","316100 SAO DOMINGOS DO PRATA",1,0,3,145,0,149,"2016"
"36485","316105 SAO FELIX DE MINAS",0,0,0,35,2,37,"2016"
"36486","316110 SAO FRANCISCO",0,5,13,728,8,754,"2016"
"36487","316120 SAO FRANCISCO DE PAULA",0,0,0,61,0,61,"2016"
"36488","316130 SAO FRANCISCO DE SALES",0,0,0,62,0,62,"2016"
"36489","316140 SAO FRANCISCO DO GLORIA",0,1,0,39,1,41,"2016"
"36490","316150 SAO GERALDO",0,1,2,92,0,95,"2016"
"36491","316160 SAO GERALDO DA PIEDADE",1,0,1,30,20,52,"2016"
"36492","316165 SAO GERALDO DO BAIXIO",0,0,1,25,12,38,"2016"
"36493","316170 SAO GONCALO DO ABAETE",0,0,0,55,0,55,"2016"
"36494","316180 SAO GONCALO DO PARA",0,0,1,143,0,144,"2016"
"36495","316190 SAO GONCALO DO RIO ABAIXO",1,1,1,131,3,137,"2016"
"36496","316200 SAO GONCALO DO SAPUCAI",1,0,8,368,1,378,"2016"
"36497","316210 SAO GOTARDO",1,2,8,617,3,631,"2016"
"36498","316220 SAO JOAO BATISTA DO GLORIA",1,1,1,84,0,87,"2016"
"36499","316225 SAO JOAO DA LAGOA",0,0,2,32,0,34,"2016"
"36500","316230 SAO JOAO DA MATA",0,0,1,24,0,25,"2016"
"36501","316240 SAO JOAO DA PONTE",2,1,4,229,1,237,"2016"
"36502","316245 SAO JOAO DAS MISSOES",0,1,0,133,137,271,"2016"
"36503","316250 SAO JOAO DEL REI",0,1,2,997,6,1006,"2016"
"36504","316255 SAO JOAO DO MANHUACU",0,0,1,79,80,160,"2016"
"36505","316257 SAO JOAO DO MANTENINHA",0,0,0,78,4,82,"2016"
"36506","316260 SAO JOAO DO ORIENTE",0,0,1,86,3,90,"2016"
"36507","316265 SAO JOAO DO PACUI",1,0,0,37,0,38,"2016"
"36508","316270 SAO JOAO DO PARAISO",2,0,1,159,100,262,"2016"
"36509","316280 SAO JOAO EVANGELISTA",2,0,1,198,0,201,"2016"
"36510","316290 SAO JOAO NEPOMUCENO",1,2,2,295,0,300,"2016"
"36511","316292 SAO JOAQUIM DE BICAS",2,3,1,360,5,371,"2016"
"36512","316294 SAO JOSE DA BARRA",0,1,3,76,0,80,"2016"
"36513","316295 SAO JOSE DA LAPA",2,1,4,308,5,320,"2016"
"36514","316300 SAO JOSE DA SAFIRA",0,0,0,37,16,53,"2016"
"36515","316310 SAO JOSE DA VARGINHA",0,0,0,37,1,38,"2016"
"36516","316320 SAO JOSE DO ALEGRE",0,0,1,50,0,51,"2016"
"36517","316330 SAO JOSE DO DIVINO",0,0,0,65,0,65,"2016"
"36518","316340 SAO JOSE DO GOIABAL",0,0,0,52,0,52,"2016"
"36519","316350 SAO JOSE DO JACURI",1,0,0,58,0,59,"2016"
"36520","316360 SAO JOSE DO MANTIMENTO",0,0,0,6,38,44,"2016"
"36521","316370 SAO LOURENCO",4,1,6,533,2,546,"2016"
"36522","316380 SAO MIGUEL DO ANTA",0,0,1,64,4,69,"2016"
"36523","316390 SAO PEDRO DA UNIAO",0,0,1,51,1,53,"2016"
"36524","316400 SAO PEDRO DOS FERROS",0,0,0,78,2,80,"2016"
"36525","316410 SAO PEDRO DO SUACUI",1,0,0,49,1,51,"2016"
"36526","316420 SAO ROMAO",0,0,1,109,0,110,"2016"
"36527","316430 SAO ROQUE DE MINAS",0,0,0,46,1,47,"2016"
"36528","316440 SAO SEBASTIAO DA BELA VISTA",0,0,0,60,2,62,"2016"
"36529","316443 SAO SEBASTIAO DA VARGEM ALEGRE",0,1,0,18,0,19,"2016"
"36530","316447 SAO SEBASTIAO DO ANTA",0,0,0,76,2,78,"2016"
"36531","316450 SAO SEBASTIAO DO MARANHAO",0,1,1,82,2,86,"2016"
"36532","316460 SAO SEBASTIAO DO OESTE",0,1,2,99,1,103,"2016"
"36533","316470 SAO SEBASTIAO DO PARAISO",15,0,8,796,2,821,"2016"
"36534","316480 SAO SEBASTIAO DO RIO PRETO",0,0,1,12,0,13,"2016"
"36535","316490 SAO SEBASTIAO DO RIO VERDE",0,0,0,18,0,18,"2016"
"36536","316500 SAO TIAGO",1,1,1,87,0,90,"2016"
"36537","316510 SAO TOMAS DE AQUINO",3,0,1,82,1,87,"2016"
"36538","316520 SAO THOME DAS LETRAS",0,0,0,78,0,78,"2016"
"36539","316530 SAO VICENTE DE MINAS",0,0,0,83,1,84,"2016"
"36540","316540 SAPUCAI-MIRIM",0,0,1,68,0,69,"2016"
"36541","316550 SARDOA",0,0,2,60,16,78,"2016"
"36542","316553 SARZEDO",2,5,8,509,3,527,"2016"
"36543","316555 SETUBINHA",0,0,5,125,4,134,"2016"
"36544","316556 SEM-PEIXE",0,0,0,18,0,18,"2016"
"36545","316557 SENADOR AMARAL",0,0,2,107,0,109,"2016"
"36546","316560 SENADOR CORTES",0,0,0,28,0,28,"2016"
"36547","316570 SENADOR FIRMINO",0,0,1,76,0,77,"2016"
"36548","316580 SENADOR JOSE BENTO",0,0,0,6,0,6,"2016"
"36549","316590 SENADOR MODESTINO GONCALVES",0,0,0,45,0,45,"2016"
"36550","316600 SENHORA DE OLIVEIRA",1,0,1,61,0,63,"2016"
"36551","316610 SENHORA DO PORTO",0,2,1,43,0,46,"2016"
"36552","316620 SENHORA DOS REMEDIOS",0,0,1,82,0,83,"2016"
"36553","316630 SERICITA",0,0,2,107,0,109,"2016"
"36554","316640 SERITINGA",1,0,0,15,0,16,"2016"
"36555","316650 SERRA AZUL DE MINAS",0,0,1,63,0,64,"2016"
"36556","316660 SERRA DA SAUDADE",1,0,0,5,0,6,"2016"
"36557","316670 SERRA DOS AIMORES",0,0,5,86,0,91,"2016"
"36558","316680 SERRA DO SALITRE",1,1,0,136,0,138,"2016"
"36559","316690 SERRANIA",0,0,0,88,0,88,"2016"
"36560","316695 SERRANOPOLIS DE MINAS",0,0,0,43,0,43,"2016"
"36561","316700 SERRANOS",1,0,2,24,0,27,"2016"
"36562","316710 SERRO",1,5,5,266,3,280,"2016"
"36563","316720 SETE LAGOAS",4,7,18,2570,0,2599,"2016"
"36564","316730 SILVEIRANIA",0,0,0,23,0,23,"2016"
"36565","316740 SILVIANOPOLIS",1,1,0,76,0,78,"2016"
"36566","316750 SIMAO PEREIRA",0,1,0,20,1,22,"2016"
"36567","316760 SIMONESIA",0,0,0,25,272,297,"2016"
"36568","316770 SOBRALIA",1,0,1,41,12,55,"2016"
"36569","316780 SOLEDADE DE MINAS",0,0,0,69,3,72,"2016"
"36570","316790 TABULEIRO",0,0,1,38,0,39,"2016"
"36571","316800 TAIOBEIRAS",1,1,1,439,1,443,"2016"
"36572","316805 TAPARUBA",0,1,0,40,6,47,"2016"
"36573","316810 TAPIRA",0,1,2,49,0,52,"2016"
"36574","316820 TAPIRAI",0,0,0,8,0,8,"2016"
"36575","316830 TAQUARACU DE MINAS",0,0,0,36,0,36,"2016"
"36576","316840 TARUMIRIM",0,0,0,105,33,138,"2016"
"36577","316850 TEIXEIRAS",0,1,2,97,1,101,"2016"
"36578","316860 TEOFILO OTONI",2,6,24,1775,17,1824,"2016"
"36579","316870 TIMOTEO",1,2,11,966,0,980,"2016"
"36580","316880 TIRADENTES",0,0,1,102,1,104,"2016"
"36581","316890 TIROS",0,0,0,62,0,62,"2016"
"36582","316900 TOCANTINS",1,0,4,176,1,182,"2016"
"36583","316905 TOCOS DO MOJI",0,0,0,29,0,29,"2016"
"36584","316910 TOLEDO",0,0,0,70,0,70,"2016"
"36585","316920 TOMBOS",0,0,2,93,1,96,"2016"
"36586","316930 TRES CORACOES",3,3,12,1007,1,1026,"2016"
"36587","316935 TRES MARIAS",2,1,4,359,0,366,"2016"
"36588","316940 TRES PONTAS",2,4,10,615,26,657,"2016"
"36589","316950 TUMIRITINGA",0,0,1,53,21,75,"2016"
"36590","316960 TUPACIGUARA",1,1,5,210,4,221,"2016"
"36591","316970 TURMALINA",0,0,4,217,4,225,"2016"
"36592","316980 TURVOLANDIA",0,0,1,52,0,53,"2016"
"36593","316990 UBA",2,3,22,1121,11,1159,"2016"
"36594","317000 UBAI",0,0,1,154,1,156,"2016"
"36595","317005 UBAPORANGA",0,0,2,128,3,133,"2016"
"36596","317010 UBERABA",19,6,48,4033,28,4134,"2016"
"36597","317020 UBERLANDIA",43,15,97,9023,69,9247,"2016"
"36598","317030 UMBURATIBA",0,1,0,27,0,28,"2016"
"36599","317040 UNAI",3,1,7,1053,4,1068,"2016"
"36600","317043 UNIAO DE MINAS",0,0,0,38,0,38,"2016"
"36601","317047 URUANA DE MINAS",0,0,1,25,0,26,"2016"
"36602","317050 URUCANIA",1,0,0,123,0,124,"2016"
"36603","317052 URUCUIA",0,1,1,124,1,127,"2016"
"36604","317057 VARGEM ALEGRE",1,0,0,57,0,58,"2016"
"36605","317060 VARGEM BONITA",0,0,0,13,0,13,"2016"
"36606","317065 VARGEM GRANDE DO RIO PARDO",0,0,0,53,1,54,"2016"
"36607","317070 VARGINHA",10,2,17,1700,6,1735,"2016"
"36608","317075 VARJAO DE MINAS",1,0,3,100,0,104,"2016"
"36609","317080 VARZEA DA PALMA",1,0,7,331,0,339,"2016"
"36610","317090 VARZELANDIA",0,5,1,214,0,220,"2016"
"36611","317100 VAZANTE",2,0,0,226,1,229,"2016"
"36612","317103 VERDELANDIA",1,0,2,131,5,139,"2016"
"36613","317107 VEREDINHA",0,0,1,52,0,53,"2016"
"36614","317110 VERISSIMO",0,0,0,32,0,32,"2016"
"36615","317115 VERMELHO NOVO",0,0,0,49,3,52,"2016"
"36616","317120 VESPASIANO",2,4,31,1872,11,1920,"2016"
"36617","317130 VICOSA",2,6,13,813,20,854,"2016"
"36618","317140 VIEIRAS",0,0,0,26,5,31,"2016"
"36619","317150 MATHIAS LOBATO",0,0,0,29,9,38,"2016"
"36620","317160 VIRGEM DA LAPA",0,1,2,88,7,98,"2016"
"36621","317170 VIRGINIA",0,0,2,84,0,86,"2016"
"36622","317180 VIRGINOPOLIS",0,0,2,150,0,152,"2016"
"36623","317190 VIRGOLANDIA",0,0,0,40,7,47,"2016"
"36624","317200 VISCONDE DO RIO BRANCO",0,1,5,480,0,486,"2016"
"36625","317210 VOLTA GRANDE",0,0,0,50,0,50,"2016"
"36626","317220 WENCESLAU BRAZ",0,0,1,23,0,24,"2016"
"36627","MUNICIPIO IGNORADO - ES",0,0,0,1,0,1,"2016"
"36628","320010 AFONSO CLAUDIO",1,4,5,343,0,353,"2016"
"36629","320013 AGUIA BRANCA",1,0,2,102,0,105,"2016"
"36630","320016 AGUA DOCE DO NORTE",0,0,5,154,1,160,"2016"
"36631","320020 ALEGRE",0,1,10,320,2,333,"2016"
"36632","320030 ALFREDO CHAVES",0,1,4,114,0,119,"2016"
"36633","320035 ALTO RIO NOVO",0,0,1,99,0,100,"2016"
"36634","320040 ANCHIETA",2,0,8,374,1,385,"2016"
"36635","320050 APIACA",0,0,3,66,0,69,"2016"
"36636","320060 ARACRUZ",3,5,17,1425,2,1452,"2016"
"36637","320070 ATILIO VIVACQUA",0,1,2,148,0,151,"2016"
"36638","320080 BAIXO GUANDU",0,3,3,351,0,357,"2016"
"36639","320090 BARRA DE SAO FRANCISCO",4,1,2,691,3,701,"2016"
"36640","320100 BOA ESPERANCA",0,0,1,177,6,184,"2016"
"36641","320110 BOM JESUS DO NORTE",0,2,1,102,0,105,"2016"
"36642","320115 BREJETUBA",0,1,4,188,0,193,"2016"
"36643","320120 CACHOEIRO DE ITAPEMIRIM",4,11,29,2606,4,2654,"2016"
"36644","320130 CARIACICA",13,24,65,5733,28,5863,"2016"
"36645","320140 CASTELO",0,3,8,384,2,397,"2016"
"36646","320150 COLATINA",2,4,21,1573,0,1600,"2016"
"36647","320160 CONCEICAO DA BARRA",1,1,5,392,2,401,"2016"
"36648","320170 CONCEICAO DO CASTELO",0,1,1,153,0,155,"2016"
"36649","320180 DIVINO DE SAO LOURENCO",0,0,1,46,1,48,"2016"
"36650","320190 DOMINGOS MARTINS",2,2,7,442,1,454,"2016"
"36651","320200 DORES DO RIO PRETO",0,0,0,54,0,54,"2016"
"36652","320210 ECOPORANGA",1,0,2,275,2,280,"2016"
"36653","320220 FUNDAO",3,1,6,217,1,228,"2016"
"36654","320225 GOVERNADOR LINDENBERG",0,1,4,119,0,124,"2016"
"36655","320230 GUACUI",1,3,8,384,0,396,"2016"
"36656","320240 GUARAPARI",2,5,30,1701,5,1743,"2016"
"36657","320245 IBATIBA",0,0,4,314,13,331,"2016"
"36658","320250 IBIRACU",0,0,1,135,0,136,"2016"
"36659","320255 IBITIRAMA",0,1,5,134,0,140,"2016"
"36660","320260 ICONHA",1,0,3,128,0,132,"2016"
"36661","320265 IRUPI",0,0,5,129,13,147,"2016"
"36662","320270 ITAGUACU",0,0,4,125,1,130,"2016"
"36663","320280 ITAPEMIRIM",3,1,11,571,0,586,"2016"
"36664","320290 ITARANA",0,0,1,99,0,100,"2016"
"36665","320300 IUNA",0,1,6,365,27,399,"2016"
"36666","320305 JAGUARE",1,1,7,463,0,472,"2016"
"36667","320310 JERONIMO MONTEIRO",1,2,5,134,3,145,"2016"
"36668","320313 JOAO NEIVA",1,1,1,170,0,173,"2016"
"36669","320316 LARANJA DA TERRA",0,0,2,70,0,72,"2016"
"36670","320320 LINHARES",3,4,23,2483,1,2514,"2016"
"36671","320330 MANTENOPOLIS",1,1,4,150,3,159,"2016"
"36672","320332 MARATAIZES",1,0,9,534,0,544,"2016"
"36673","320334 MARECHAL FLORIANO",0,0,3,233,0,236,"2016"
"36674","320335 MARILANDIA",2,0,3,134,0,139,"2016"
"36675","320340 MIMOSO DO SUL",2,0,3,236,2,243,"2016"
"36676","320350 MONTANHA",0,0,4,205,3,212,"2016"
"36677","320360 MUCURICI",1,0,0,88,0,89,"2016"
"36678","320370 MUNIZ FREIRE",0,1,2,214,1,218,"2016"
"36679","320380 MUQUI",0,0,2,167,0,169,"2016"
"36680","320390 NOVA VENECIA",2,0,10,674,0,686,"2016"
"36681","320400 PANCAS",1,0,3,234,0,238,"2016"
"36682","320405 PEDRO CANARIO",0,1,3,319,4,327,"2016"
"36683","320410 PINHEIROS",0,2,0,136,203,341,"2016"
"36684","320420 PIUMA",0,1,13,276,1,291,"2016"
"36685","320425 PONTO BELO",0,0,1,70,5,76,"2016"
"36686","320430 PRESIDENTE KENNEDY",0,2,0,186,1,189,"2016"
"36687","320435 RIO BANANAL",1,0,6,236,1,244,"2016"
"36688","320440 RIO NOVO DO SUL",0,0,3,134,0,137,"2016"
"36689","320450 SANTA LEOPOLDINA",0,0,2,120,0,122,"2016"
"36690","320455 SANTA MARIA DE JETIBA",2,2,4,566,1,575,"2016"
"36691","320460 SANTA TERESA",0,0,2,280,0,282,"2016"
"36692","320465 SAO DOMINGOS DO NORTE",0,0,0,110,0,110,"2016"
"36693","320470 SAO GABRIEL DA PALHA",1,2,6,386,0,395,"2016"
"36694","320480 SAO JOSE DO CALCADO",0,0,4,121,0,125,"2016"
"36695","320490 SAO MATEUS",3,5,17,1754,4,1783,"2016"
"36696","320495 SAO ROQUE DO CANAA",0,1,0,105,0,106,"2016"
"36697","320500 SERRA",50,25,100,7600,10,7785,"2016"
"36698","320501 SOORETAMA",0,0,1,455,1,457,"2016"
"36699","320503 VARGEM ALTA",1,1,2,240,2,246,"2016"
"36700","320506 VENDA NOVA DO IMIGRANTE",0,0,4,296,0,300,"2016"
"36701","320510 VIANA",5,3,7,1083,9,1107,"2016"
"36702","320515 VILA PAVAO",1,0,0,99,0,100,"2016"
"36703","320517 VILA VALERIO",0,2,4,193,0,199,"2016"
"36704","320520 VILA VELHA",15,11,72,6046,28,6172,"2016"
"36705","320530 VITORIA",9,9,53,4279,19,4369,"2016"
"36706","MUNICIPIO IGNORADO - RJ",0,0,0,4,1,5,"2016"
"36707","330010 ANGRA DOS REIS",10,8,61,2533,16,2628,"2016"
"36708","330015 APERIBE",0,0,0,148,1,149,"2016"
"36709","330020 ARARUAMA",2,6,16,669,836,1529,"2016"
"36710","330022 AREAL",0,0,6,156,1,163,"2016"
"36711","330023 ARMACAO DOS BUZIOS",2,2,19,679,1,703,"2016"
"36712","330025 ARRAIAL DO CABO",4,5,6,213,154,382,"2016"
"36713","330030 BARRA DO PIRAI",4,4,14,1102,6,1130,"2016"
"36714","330040 BARRA MANSA",5,16,38,1937,2,1998,"2016"
"36715","330045 BELFORD ROXO",30,27,132,6963,63,7215,"2016"
"36716","330050 BOM JARDIM",2,2,6,222,2,234,"2016"
"36717","330060 BOM JESUS DO ITABAPOANA",1,3,5,430,0,439,"2016"
"36718","330070 CABO FRIO",9,7,57,2506,98,2677,"2016"
"36719","330080 CACHOEIRAS DE MACACU",2,4,7,751,7,771,"2016"
"36720","330090 CAMBUCI",0,0,2,132,0,134,"2016"
"36721","330093 CARAPEBUS",1,3,0,147,0,151,"2016"
"36722","330095 COMENDADOR LEVY GASPARIAN",0,0,0,132,0,132,"2016"
"36723","330100 CAMPOS DOS GOYTACAZES",19,41,144,7307,5,7516,"2016"
"36724","330110 CANTAGALO",1,1,6,205,0,213,"2016"
"36725","330115 CARDOSO MOREIRA",1,0,2,147,0,150,"2016"
"36726","330120 CARMO",2,1,4,199,1,207,"2016"
"36727","330130 CASIMIRO DE ABREU",3,1,6,584,3,597,"2016"
"36728","330140 CONCEICAO DE MACABU",0,2,3,243,2,250,"2016"
"36729","330150 CORDEIRO",0,1,5,261,0,267,"2016"
"36730","330160 DUAS BARRAS",1,0,3,135,0,139,"2016"
"36731","330170 DUQUE DE CAXIAS",33,54,289,13137,70,13583,"2016"
"36732","330180 ENGENHEIRO PAULO DE FRONTIN",0,1,4,116,0,121,"2016"
"36733","330185 GUAPIMIRIM",2,3,10,706,4,725,"2016"
"36734","330187 IGUABA GRANDE",0,4,4,317,17,342,"2016"
"36735","330190 ITABORAI",7,18,41,2959,22,3047,"2016"
"36736","330200 ITAGUAI",3,8,35,1876,8,1930,"2016"
"36737","330205 ITALVA",0,0,0,152,0,152,"2016"
"36738","330210 ITAOCARA",1,1,12,253,2,269,"2016"
"36739","330220 ITAPERUNA",2,4,20,1097,1,1124,"2016"
"36740","330225 ITATIAIA",0,1,5,358,3,367,"2016"
"36741","330227 JAPERI",4,8,31,1397,42,1482,"2016"
"36742","330230 LAJE DO MURIAE",0,2,1,86,0,89,"2016"
"36743","330240 MACAE",7,22,49,3643,25,3746,"2016"
"36744","330245 MACUCO",2,0,2,102,0,106,"2016"
"36745","330250 MAGE",10,11,61,3416,5,3503,"2016"
"36746","330260 MANGARATIBA",1,1,11,487,3,503,"2016"
"36747","330270 MARICA",2,3,22,1157,580,1764,"2016"
"36748","330280 MENDES",0,0,1,197,1,199,"2016"
"36749","330285 MESQUITA",10,8,51,2310,23,2402,"2016"
"36750","330290 MIGUEL PEREIRA",1,3,3,255,17,279,"2016"
"36751","330300 MIRACEMA",0,1,1,362,2,366,"2016"
"36752","330310 NATIVIDADE",0,0,10,176,0,186,"2016"
"36753","330320 NILOPOLIS",6,8,29,1912,19,1974,"2016"
"36754","330330 NITEROI",14,31,105,5715,38,5903,"2016"
"36755","330340 NOVA FRIBURGO",7,10,76,2061,3,2157,"2016"
"36756","330350 NOVA IGUACU",27,49,221,11368,177,11842,"2016"
"36757","330360 PARACAMBI",0,3,7,554,2,566,"2016"
"36758","330370 PARAIBA DO SUL",3,5,1,528,4,541,"2016"
"36759","330380 PARATY",6,3,9,568,2,588,"2016"
"36760","330385 PATY DO ALFERES",0,2,1,314,34,351,"2016"
"36761","330390 PETROPOLIS",6,15,68,3726,35,3850,"2016"
"36762","330395 PINHEIRAL",0,1,3,323,1,328,"2016"
"36763","330400 PIRAI",0,3,10,366,1,380,"2016"
"36764","330410 PORCIUNCULA",0,2,9,176,1,188,"2016"
"36765","330411 PORTO REAL",1,1,4,279,0,285,"2016"
"36766","330412 QUATIS",1,0,1,136,1,139,"2016"
"36767","330414 QUEIMADOS",9,12,36,2178,43,2278,"2016"
"36768","330415 QUISSAMA",7,1,5,310,0,323,"2016"
"36769","330420 RESENDE",12,4,31,1685,0,1732,"2016"
"36770","330430 RIO BONITO",2,4,5,720,8,739,"2016"
"36771","330440 RIO CLARO",1,1,5,195,0,202,"2016"
"36772","330450 RIO DAS FLORES",0,2,5,87,0,94,"2016"
"36773","330452 RIO DAS OSTRAS",6,16,48,2113,8,2191,"2016"
"36774","330455 RIO DE JANEIRO",174,384,1466,80432,710,83166,"2016"
"36775","330460 SANTA MARIA MADALENA",0,1,0,89,1,91,"2016"
"36776","330470 SANTO ANTONIO DE PADUA",1,3,7,447,3,461,"2016"
"36777","330475 SAO FRANCISCO DE ITABAPOANA",1,3,11,525,3,543,"2016"
"36778","330480 SAO FIDELIS",1,0,21,382,4,408,"2016"
"36779","330490 SAO GONCALO",50,44,163,11077,52,11386,"2016"
"36780","330500 SAO JOAO DA BARRA",0,2,6,466,29,503,"2016"
"36781","330510 SAO JOAO DE MERITI",14,45,105,6001,46,6211,"2016"
"36782","330513 SAO JOSE DE UBA",0,0,0,87,1,88,"2016"
"36783","330515 SAO JOSE DO VALE DO RIO PRETO",0,0,2,263,0,265,"2016"
"36784","330520 SAO PEDRO DA ALDEIA",5,10,35,1247,162,1459,"2016"
"36785","330530 SAO SEBASTIAO DO ALTO",0,1,3,95,2,101,"2016"
"36786","330540 SAPUCAIA",0,2,3,185,2,192,"2016"
"36787","330550 SAQUAREMA",2,10,34,1161,51,1258,"2016"
"36788","330555 SEROPEDICA",4,5,12,1093,8,1122,"2016"
"36789","330560 SILVA JARDIM",0,2,1,262,7,272,"2016"
"36790","330570 SUMIDOURO",0,0,3,192,0,195,"2016"
"36791","330575 TANGUA",1,2,8,443,1,455,"2016"
"36792","330580 TERESOPOLIS",2,11,27,2149,9,2198,"2016"
"36793","330590 TRAJANO DE MORAES",0,0,0,106,0,106,"2016"
"36794","330600 TRES RIOS",2,3,13,1085,5,1108,"2016"
"36795","330610 VALENCA",3,3,22,762,3,793,"2016"
"36796","330615 VARRE-SAI",0,1,5,159,0,165,"2016"
"36797","330620 VASSOURAS",1,1,12,490,0,504,"2016"
"36798","330630 VOLTA REDONDA",11,18,45,3279,11,3364,"2016"
"36799","MUNICIPIO IGNORADO - SP",1,0,0,11,4,16,"2016"
"36800","350010 ADAMANTINA",0,0,11,359,0,370,"2016"
"36801","350020 ADOLFO",0,1,0,44,0,45,"2016"
"36802","350030 AGUAI",1,3,1,381,4,390,"2016"
"36803","350040 AGUAS DA PRATA",0,0,1,83,1,85,"2016"
"36804","350050 AGUAS DE LINDOIA",1,1,2,207,6,217,"2016"
"36805","350055 AGUAS DE SANTA BARBARA",0,0,1,85,0,86,"2016"
"36806","350060 AGUAS DE SAO PEDRO",0,0,0,29,0,29,"2016"
"36807","350070 AGUDOS",1,2,10,496,3,512,"2016"
"36808","350075 ALAMBARI",0,2,2,76,0,80,"2016"
"36809","350080 ALFREDO MARCONDES",1,2,0,39,0,42,"2016"
"36810","350090 ALTAIR",0,1,1,51,0,53,"2016"
"36811","350100 ALTINOPOLIS",1,0,6,171,2,180,"2016"
"36812","350110 ALTO ALEGRE",0,0,0,38,0,38,"2016"
"36813","350115 ALUMINIO",0,1,3,262,0,266,"2016"
"36814","350120 ALVARES FLORENCE",0,0,1,36,0,37,"2016"
"36815","350130 ALVARES MACHADO",1,0,6,331,1,339,"2016"
"36816","350140 ALVARO DE CARVALHO",0,0,3,43,0,46,"2016"
"36817","350150 ALVINLANDIA",0,0,1,40,1,42,"2016"
"36818","350160 AMERICANA",2,11,27,2449,6,2495,"2016"
"36819","350170 AMERICO BRASILIENSE",0,1,7,412,43,463,"2016"
"36820","350180 AMERICO DE CAMPOS",0,0,1,38,0,39,"2016"
"36821","350190 AMPARO",1,0,11,802,1,815,"2016"
"36822","350200 ANALANDIA",1,1,1,52,0,55,"2016"
"36823","350210 ANDRADINA",0,4,5,679,2,690,"2016"
"36824","350220 ANGATUBA",0,0,5,344,0,349,"2016"
"36825","350230 ANHEMBI",0,0,2,77,3,82,"2016"
"36826","350240 ANHUMAS",1,1,1,57,0,60,"2016"
"36827","350250 APARECIDA",1,5,8,489,2,505,"2016"
"36828","350260 APARECIDA D'OESTE",0,0,0,47,0,47,"2016"
"36829","350270 APIAI",0,7,8,325,2,342,"2016"
"36830","350275 ARACARIGUAMA",1,1,7,292,2,303,"2016"
"36831","350280 ARACATUBA",3,8,29,2200,1,2241,"2016"
"36832","350290 ARACOIABA DA SERRA",0,1,13,426,2,442,"2016"
"36833","350300 ARAMINA",0,0,2,56,0,58,"2016"
"36834","350310 ARANDU",0,0,0,72,0,72,"2016"
"36835","350315 ARAPEI",1,0,0,14,1,16,"2016"
"36836","350320 ARARAQUARA",4,7,40,2479,213,2743,"2016"
"36837","350330 ARARAS",6,4,14,1493,0,1517,"2016"
"36838","350335 ARCO-IRIS",0,0,0,21,0,21,"2016"
"36839","350340 AREALVA",0,1,0,91,3,95,"2016"
"36840","350350 AREIAS",1,0,1,41,0,43,"2016"
"36841","350360 AREIOPOLIS",0,0,0,127,2,129,"2016"
"36842","350370 ARIRANHA",1,0,0,79,0,80,"2016"
"36843","350380 ARTUR NOGUEIRA",1,2,4,650,7,664,"2016"
"36844","350390 ARUJA",3,7,23,1407,6,1446,"2016"
"36845","350395 ASPASIA",0,0,0,26,0,26,"2016"
"36846","350400 ASSIS",3,1,8,1217,1,1230,"2016"
"36847","350410 ATIBAIA",1,3,11,2043,3,2061,"2016"
"36848","350420 AURIFLAMA",1,1,0,144,1,147,"2016"
"36849","350430 AVAI",0,0,1,62,0,63,"2016"
"36850","350440 AVANHANDAVA",0,0,1,149,1,151,"2016"
"36851","350450 AVARE",2,2,10,1283,1,1298,"2016"
"36852","350460 BADY BASSITT",0,0,0,212,3,215,"2016"
"36853","350470 BALBINOS",0,0,0,16,0,16,"2016"
"36854","350480 BALSAMO",0,0,0,67,0,67,"2016"
"36855","350490 BANANAL",2,0,4,84,0,90,"2016"
"36856","350500 BARAO DE ANTONINA",1,0,0,49,4,54,"2016"
"36857","350510 BARBOSA",0,1,1,86,0,88,"2016"
"36858","350520 BARIRI",1,2,1,395,3,402,"2016"
"36859","350530 BARRA BONITA",0,1,2,311,1,315,"2016"
"36860","350535 BARRA DO CHAPEU",0,0,2,65,0,67,"2016"
"36861","350540 BARRA DO TURVO",0,0,1,89,1,91,"2016"
"36862","350550 BARRETOS",6,10,30,1342,3,1391,"2016"
"36863","350560 BARRINHA",1,2,6,459,4,472,"2016"
"36864","350570 BARUERI",13,15,61,5347,10,5446,"2016"
"36865","350580 BASTOS",1,2,6,270,1,280,"2016"
"36866","350590 BATATAIS",1,1,6,663,6,677,"2016"
"36867","350600 BAURU",15,20,54,4560,28,4677,"2016"
"36868","350610 BEBEDOURO",2,3,6,898,3,912,"2016"
"36869","350620 BENTO DE ABREU",0,1,0,33,0,34,"2016"
"36870","350630 BERNARDINO DE CAMPOS",0,0,3,123,0,126,"2016"
"36871","350635 BERTIOGA",3,2,19,999,2,1025,"2016"
"36872","350640 BILAC",0,0,2,70,0,72,"2016"
"36873","350650 BIRIGUI",2,9,14,1336,2,1363,"2016"
"36874","350660 BIRITIBA-MIRIM",1,2,3,386,4,396,"2016"
"36875","350670 BOA ESPERANCA DO SUL",0,0,2,131,21,154,"2016"
"36876","350680 BOCAINA",0,3,1,138,0,142,"2016"
"36877","350690 BOFETE",0,0,1,122,1,124,"2016"
"36878","350700 BOITUVA",2,3,9,789,1,804,"2016"
"36879","350710 BOM JESUS DOS PERDOES",0,0,3,324,0,327,"2016"
"36880","350715 BOM SUCESSO DE ITARARE",0,0,5,65,0,70,"2016"
"36881","350720 BORA",0,0,0,9,0,9,"2016"
"36882","350730 BORACEIA",2,0,0,53,0,55,"2016"
"36883","350740 BORBOREMA",1,1,0,149,0,151,"2016"
"36884","350745 BOREBI",0,0,2,28,0,30,"2016"
"36885","350750 BOTUCATU",7,9,31,1672,5,1724,"2016"
"36886","350760 BRAGANCA PAULISTA",4,4,19,2145,1,2173,"2016"
"36887","350770 BRAUNA",0,1,0,63,0,64,"2016"
"36888","350775 BREJO ALEGRE",0,0,0,31,0,31,"2016"
"36889","350780 BRODOWSKI",1,1,5,278,2,287,"2016"
"36890","350790 BROTAS",1,1,1,287,3,293,"2016"
"36891","350800 BURI",0,2,17,286,2,307,"2016"
"36892","350810 BURITAMA",1,1,7,168,2,179,"2016"
"36893","350820 BURITIZAL",1,0,0,52,0,53,"2016"
"36894","350830 CABRALIA PAULISTA",0,0,1,53,0,54,"2016"
"36895","350840 CABREUVA",1,1,12,776,1,791,"2016"
"36896","350850 CACAPAVA",2,1,10,1177,4,1194,"2016"
"36897","350860 CACHOEIRA PAULISTA",1,1,9,346,45,402,"2016"
"36898","350870 CACONDE",0,0,1,187,4,192,"2016"
"36899","350880 CAFELANDIA",0,0,1,222,2,225,"2016"
"36900","350890 CAIABU",0,0,1,27,0,28,"2016"
"36901","350900 CAIEIRAS",3,3,21,1381,6,1414,"2016"
"36902","350910 CAIUA",0,0,0,46,3,49,"2016"
"36903","350920 CAJAMAR",5,7,19,1269,2,1302,"2016"
"36904","350925 CAJATI",1,2,5,472,0,480,"2016"
"36905","350930 CAJOBI",0,1,1,90,0,92,"2016"
"36906","350940 CAJURU",1,1,3,356,0,361,"2016"
"36907","350945 CAMPINA DO MONTE ALEGRE",0,0,0,80,0,80,"2016"
"36908","350950 CAMPINAS",33,53,123,14739,211,15159,"2016"
"36909","350960 CAMPO LIMPO PAULISTA",1,4,20,1067,3,1095,"2016"
"36910","350970 CAMPOS DO JORDAO",0,2,8,750,2,762,"2016"
"36911","350980 CAMPOS NOVOS PAULISTA",0,1,1,51,0,53,"2016"
"36912","350990 CANANEIA",0,2,2,165,1,170,"2016"
"36913","350995 CANAS",0,0,1,64,13,78,"2016"
"36914","351000 CANDIDO MOTA",1,1,4,296,1,303,"2016"
"36915","351010 CANDIDO RODRIGUES",0,0,0,20,0,20,"2016"
"36916","351015 CANITAR",0,0,1,63,0,64,"2016"
"36917","351020 CAPAO BONITO",0,3,9,641,1,654,"2016"
"36918","351030 CAPELA DO ALTO",0,1,3,276,1,281,"2016"
"36919","351040 CAPIVARI",0,5,8,675,4,692,"2016"
"36920","351050 CARAGUATATUBA",4,10,20,1670,15,1719,"2016"
"36921","351060 CARAPICUIBA",12,21,74,6930,24,7061,"2016"
"36922","351070 CARDOSO",1,0,1,138,0,140,"2016"
"36923","351080 CASA BRANCA",3,1,4,284,0,292,"2016"
"36924","351090 CASSIA DOS COQUEIROS",0,0,1,25,0,26,"2016"
"36925","351100 CASTILHO",1,1,6,249,0,257,"2016"
"36926","351110 CATANDUVA",3,2,12,1334,2,1353,"2016"
"36927","351120 CATIGUA",0,2,0,88,0,90,"2016"
"36928","351130 CEDRAL",0,0,1,98,0,99,"2016"
"36929","351140 CERQUEIRA CESAR",1,1,1,252,1,256,"2016"
"36930","351150 CERQUILHO",0,1,7,535,2,545,"2016"
"36931","351160 CESARIO LANGE",0,2,2,247,1,252,"2016"
"36932","351170 CHARQUEADA",0,1,2,193,0,196,"2016"
"36933","351190 CLEMENTINA",0,0,0,90,0,90,"2016"
"36934","351200 COLINA",0,4,3,217,0,224,"2016"
"36935","351210 COLOMBIA",1,0,4,88,0,93,"2016"
"36936","351220 CONCHAL",3,0,7,386,1,397,"2016"
"36937","351230 CONCHAS",1,1,0,201,0,203,"2016"
"36938","351240 CORDEIROPOLIS",0,1,3,313,0,317,"2016"
"36939","351250 COROADOS",1,0,0,70,0,71,"2016"
"36940","351260 CORONEL MACEDO",0,0,1,52,1,54,"2016"
"36941","351270 CORUMBATAI",0,1,1,44,1,47,"2016"
"36942","351280 COSMOPOLIS",1,1,10,663,11,686,"2016"
"36943","351290 COSMORAMA",0,0,1,59,0,60,"2016"
"36944","351300 COTIA",13,18,54,4163,12,4260,"2016"
"36945","351310 CRAVINHOS",3,3,4,405,1,416,"2016"
"36946","351320 CRISTAIS PAULISTA",0,0,0,104,1,105,"2016"
"36947","351330 CRUZALIA",0,0,0,26,0,26,"2016"
"36948","351340 CRUZEIRO",0,3,7,922,14,946,"2016"
"36949","351350 CUBATAO",3,4,44,1626,4,1681,"2016"
"36950","351360 CUNHA",0,2,6,217,2,227,"2016"
"36951","351370 DESCALVADO",0,0,2,330,1,333,"2016"
"36952","351380 DIADEMA",23,15,62,5914,26,6040,"2016"
"36953","351385 DIRCE REIS",0,0,0,18,0,18,"2016"
"36954","351390 DIVINOLANDIA",0,0,2,115,10,127,"2016"
"36955","351400 DOBRADA",1,0,4,91,1,97,"2016"
"36956","351410 DOIS CORREGOS",1,1,3,345,4,354,"2016"
"36957","351420 DOLCINOPOLIS",0,0,0,16,0,16,"2016"
"36958","351430 DOURADO",0,2,3,96,1,102,"2016"
"36959","351440 DRACENA",2,1,3,510,1,517,"2016"
"36960","351450 DUARTINA",0,2,0,119,1,122,"2016"
"36961","351460 DUMONT",1,1,3,97,1,103,"2016"
"36962","351470 ECHAPORA",0,2,1,85,0,88,"2016"
"36963","351480 ELDORADO",0,1,1,208,3,213,"2016"
"36964","351490 ELIAS FAUSTO",0,0,0,200,0,200,"2016"
"36965","351492 ELISIARIO",0,0,1,37,0,38,"2016"
"36966","351495 EMBAUBA",0,0,0,23,0,23,"2016"
"36967","351500 EMBU DAS ARTES",9,18,53,4148,12,4240,"2016"
"36968","351510 EMBU-GUACU",2,7,18,941,4,972,"2016"
"36969","351512 EMILIANOPOLIS",0,0,0,21,0,21,"2016"
"36970","351515 ENGENHEIRO COELHO",0,1,3,250,0,254,"2016"
"36971","351518 ESPIRITO SANTO DO PINHAL",1,1,3,415,2,422,"2016"
"36972","351519 ESPIRITO SANTO DO TURVO",0,0,0,53,0,53,"2016"
"36973","351520 ESTRELA D'OESTE",0,0,1,78,0,79,"2016"
"36974","351530 ESTRELA DO NORTE",0,0,0,33,0,33,"2016"
"36975","351535 EUCLIDES DA CUNHA PAULISTA",0,0,1,103,1,105,"2016"
"36976","351540 FARTURA",0,1,3,195,1,200,"2016"
"36977","351550 FERNANDOPOLIS",1,1,10,700,1,713,"2016"
"36978","351560 FERNANDO PRESTES",1,0,2,49,1,53,"2016"
"36979","351565 FERNAO",0,0,0,20,0,20,"2016"
"36980","351570 FERRAZ DE VASCONCELOS",12,12,42,2885,20,2971,"2016"
"36981","351580 FLORA RICA",0,0,0,20,0,20,"2016"
"36982","351590 FLOREAL",0,0,0,18,0,18,"2016"
"36983","351600 FLORIDA PAULISTA",1,0,2,99,0,102,"2016"
"36984","351610 FLORINIA",0,0,0,34,0,34,"2016"
"36985","351620 FRANCA",7,19,57,4856,15,4954,"2016"
"36986","351630 FRANCISCO MORATO",9,12,48,2836,17,2922,"2016"
"36987","351640 FRANCO DA ROCHA",10,7,35,2175,12,2239,"2016"
"36988","351650 GABRIEL MONTEIRO",0,0,1,27,0,28,"2016"
"36989","351660 GALIA",0,1,7,57,0,65,"2016"
"36990","351670 GARCA",1,7,24,475,2,509,"2016"
"36991","351680 GASTAO VIDIGAL",0,0,0,49,0,49,"2016"
"36992","351685 GAVIAO PEIXOTO",1,0,1,46,7,55,"2016"
"36993","351690 GENERAL SALGADO",1,0,2,109,1,113,"2016"
"36994","351700 GETULINA",0,0,0,103,1,104,"2016"
"36995","351710 GLICERIO",0,1,0,36,0,37,"2016"
"36996","351720 GUAICARA",1,0,1,157,1,160,"2016"
"36997","351730 GUAIMBE",2,0,4,73,1,80,"2016"
"36998","351740 GUAIRA",1,4,9,425,2,441,"2016"
"36999","351750 GUAPIACU",0,1,3,252,0,256,"2016"
"37000","351760 GUAPIARA",0,0,9,213,0,222,"2016"
"37001","351770 GUARA",0,0,3,182,3,188,"2016"
"37002","351780 GUARACAI",0,0,3,79,0,82,"2016"
"37003","351790 GUARACI",0,0,7,88,0,95,"2016"
"37004","351800 GUARANI D'OESTE",0,0,0,17,0,17,"2016"
"37005","351810 GUARANTA",0,0,3,74,0,77,"2016"
"37006","351820 GUARARAPES",0,1,4,371,1,377,"2016"
"37007","351830 GUARAREMA",1,0,5,408,1,415,"2016"
"37008","351840 GUARATINGUETA",1,10,31,1322,22,1386,"2016"
"37009","351850 GUAREI",1,0,2,152,2,157,"2016"
"37010","351860 GUARIBA",2,3,17,475,1,498,"2016"
"37011","351870 GUARUJA",10,13,66,4308,47,4444,"2016"
"37012","351880 GUARULHOS",61,84,279,20464,81,20969,"2016"
"37013","351885 GUATAPARA",0,1,1,86,0,88,"2016"
"37014","351890 GUZOLANDIA",0,0,0,62,0,62,"2016"
"37015","351900 HERCULANDIA",0,0,1,102,0,103,"2016"
"37016","351905 HOLAMBRA",0,1,2,210,1,214,"2016"
"37017","351907 HORTOLANDIA",9,11,45,2976,24,3065,"2016"
"37018","351910 IACANGA",0,0,1,57,66,124,"2016"
"37019","351920 IACRI",0,0,2,47,0,49,"2016"
"37020","351925 IARAS",0,0,2,96,1,99,"2016"
"37021","351930 IBATE",0,2,2,473,2,479,"2016"
"37022","351940 IBIRA",0,1,0,144,1,146,"2016"
"37023","351950 IBIRAREMA",0,1,1,70,0,72,"2016"
"37024","351960 IBITINGA",2,0,14,688,4,708,"2016"
"37025","351970 IBIUNA",7,5,7,1120,6,1145,"2016"
"37026","351980 ICEM",1,1,0,86,1,89,"2016"
"37027","351990 IEPE",0,0,0,93,0,93,"2016"
"37028","352000 IGARACU DO TIETE",0,1,0,275,2,278,"2016"
"37029","352010 IGARAPAVA",0,1,3,291,3,298,"2016"
"37030","352020 IGARATA",0,0,2,120,0,122,"2016"
"37031","352030 IGUAPE",1,2,7,356,1,367,"2016"
"37032","352040 ILHABELA",1,2,12,473,0,488,"2016"
"37033","352042 ILHA COMPRIDA",0,1,1,148,1,151,"2016"
"37034","352044 ILHA SOLTEIRA",0,0,6,278,1,285,"2016"
"37035","352050 INDAIATUBA",5,10,26,3011,16,3068,"2016"
"37036","352060 INDIANA",1,0,0,47,2,50,"2016"
"37037","352070 INDIAPORA",0,0,0,33,0,33,"2016"
"37038","352080 INUBIA PAULISTA",0,1,1,35,0,37,"2016"
"37039","352090 IPAUSSU",0,2,5,162,0,169,"2016"
"37040","352100 IPERO",0,1,7,323,2,333,"2016"
"37041","352110 IPEUNA",0,0,3,82,2,87,"2016"
"37042","352115 IPIGUA",0,0,0,68,0,68,"2016"
"37043","352120 IPORANGA",0,0,1,54,2,57,"2016"
"37044","352130 IPUA",0,0,2,163,0,165,"2016"
"37045","352140 IRACEMAPOLIS",0,0,1,270,1,272,"2016"
"37046","352150 IRAPUA",0,0,0,82,0,82,"2016"
"37047","352160 IRAPURU",1,0,1,56,0,58,"2016"
"37048","352170 ITABERA",4,1,13,194,0,212,"2016"
"37049","352180 ITAI",1,1,6,286,2,296,"2016"
"37050","352190 ITAJOBI",0,0,4,158,0,162,"2016"
"37051","352200 ITAJU",0,0,0,41,0,41,"2016"
"37052","352210 ITANHAEM",0,6,20,1308,4,1338,"2016"
"37053","352215 ITAOCA",0,0,2,40,0,42,"2016"
"37054","352220 ITAPECERICA DA SERRA",2,11,32,2630,5,2680,"2016"
"37055","352230 ITAPETININGA",3,13,25,2032,3,2076,"2016"
"37056","352240 ITAPEVA",7,18,58,1351,2,1436,"2016"
"37057","352250 ITAPEVI",9,16,65,3983,14,4087,"2016"
"37058","352260 ITAPIRA",1,4,17,779,2,803,"2016"
"37059","352265 ITAPIRAPUA PAULISTA",0,0,1,57,0,58,"2016"
"37060","352270 ITAPOLIS",0,1,9,437,1,448,"2016"
"37061","352280 ITAPORANGA",1,0,4,188,8,201,"2016"
"37062","352290 ITAPUI",1,0,0,183,2,186,"2016"
"37063","352300 ITAPURA",0,0,1,59,0,60,"2016"
"37064","352310 ITAQUAQUECETUBA",23,34,77,5928,38,6100,"2016"
"37065","352320 ITARARE",2,3,8,632,2,647,"2016"
"37066","352330 ITARIRI",0,0,1,184,0,185,"2016"
"37067","352340 ITATIBA",1,7,11,1333,3,1355,"2016"
"37068","352350 ITATINGA",1,3,8,271,1,284,"2016"
"37069","352360 ITIRAPINA",0,3,1,148,1,153,"2016"
"37070","352370 ITIRAPUA",1,1,1,65,3,71,"2016"
"37071","352380 ITOBI",1,0,2,80,1,84,"2016"
"37072","352390 ITU",2,10,21,2240,17,2290,"2016"
"37073","352400 ITUPEVA",0,3,13,863,12,891,"2016"
"37074","352410 ITUVERAVA",2,0,6,407,3,418,"2016"
"37075","352420 JABORANDI",0,1,0,69,1,71,"2016"
"37076","352430 JABOTICABAL",3,5,12,747,1,768,"2016"
"37077","352440 JACAREI",6,9,39,3042,16,3112,"2016"
"37078","352450 JACI",0,0,0,87,0,87,"2016"
"37079","352460 JACUPIRANGA",1,1,3,261,1,267,"2016"
"37080","352470 JAGUARIUNA",0,4,3,758,5,770,"2016"
"37081","352480 JALES",2,1,3,533,1,540,"2016"
"37082","352490 JAMBEIRO",0,0,2,70,0,72,"2016"
"37083","352500 JANDIRA",4,5,33,1727,4,1773,"2016"
"37084","352510 JARDINOPOLIS",5,6,9,541,1,562,"2016"
"37085","352520 JARINU",1,2,12,373,0,388,"2016"
"37086","352530 JAU",3,0,13,1643,17,1676,"2016"
"37087","352540 JERIQUARA",0,0,1,47,0,48,"2016"
"37088","352550 JOANOPOLIS",0,0,1,133,1,135,"2016"
"37089","352560 JOAO RAMALHO",0,1,1,80,0,82,"2016"
"37090","352570 JOSE BONIFACIO",0,3,5,439,0,447,"2016"
"37091","352580 JULIO MESQUITA",2,1,0,62,1,66,"2016"
"37092","352585 JUMIRIM",0,0,1,51,0,52,"2016"
"37093","352590 JUNDIAI",11,20,62,5728,9,5830,"2016"
"37094","352600 JUNQUEIROPOLIS",0,1,3,230,0,234,"2016"
"37095","352610 JUQUIA",0,1,1,261,2,265,"2016"
"37096","352620 JUQUITIBA",2,5,6,441,5,459,"2016"
"37097","352630 LAGOINHA",0,0,1,36,1,38,"2016"
"37098","352640 LARANJAL PAULISTA",1,2,2,390,1,396,"2016"
"37099","352650 LAVINIA",0,1,3,43,0,47,"2016"
"37100","352660 LAVRINHAS",0,0,2,91,4,97,"2016"
"37101","352670 LEME",1,3,13,1173,2,1192,"2016"
"37102","352680 LENCOIS PAULISTA",0,4,26,744,1,775,"2016"
"37103","352690 LIMEIRA",4,10,25,3542,10,3591,"2016"
"37104","352700 LINDOIA",0,1,0,63,0,64,"2016"
"37105","352710 LINS",3,2,3,855,41,904,"2016"
"37106","352720 LORENA",0,3,16,1075,129,1223,"2016"
"37107","352725 LOURDES",0,0,1,21,0,22,"2016"
"37108","352730 LOUVEIRA",1,3,13,737,1,755,"2016"
"37109","352740 LUCELIA",0,1,5,187,0,193,"2016"
"37110","352750 LUCIANOPOLIS",0,0,1,26,0,27,"2016"
"37111","352760 LUIS ANTONIO",0,1,6,122,0,129,"2016"
"37112","352770 LUIZIANIA",0,0,1,56,0,57,"2016"
"37113","352780 LUPERCIO",0,0,2,56,1,59,"2016"
"37114","352790 LUTECIA",0,0,0,29,0,29,"2016"
"37115","352800 MACATUBA",0,1,3,195,1,200,"2016"
"37116","352810 MACAUBAL",0,0,2,75,1,78,"2016"
"37117","352820 MACEDONIA",0,0,0,37,0,37,"2016"
"37118","352830 MAGDA",0,0,0,31,1,32,"2016"
"37119","352840 MAIRINQUE",0,5,9,609,2,625,"2016"
"37120","352850 MAIRIPORA",3,5,19,1034,5,1066,"2016"
"37121","352860 MANDURI",1,0,0,91,2,94,"2016"
"37122","352870 MARABA PAULISTA",0,0,0,35,0,35,"2016"
"37123","352880 MARACAI",0,0,1,141,1,143,"2016"
"37124","352885 MARAPOAMA",0,0,0,33,0,33,"2016"
"37125","352890 MARIAPOLIS",0,0,2,36,0,38,"2016"
"37126","352900 MARILIA",8,20,65,2862,25,2980,"2016"
"37127","352910 MARINOPOLIS",0,0,0,15,0,15,"2016"
"37128","352920 MARTINOPOLIS",1,0,3,261,5,270,"2016"
"37129","352930 MATAO",1,3,13,858,11,886,"2016"
"37130","352940 MAUA",6,17,73,5784,28,5908,"2016"
"37131","352950 MENDONCA",0,0,1,64,1,66,"2016"
"37132","352960 MERIDIANO",0,0,0,33,0,33,"2016"
"37133","352965 MESOPOLIS",0,0,0,29,0,29,"2016"
"37134","352970 MIGUELOPOLIS",0,1,0,220,1,222,"2016"
"37135","352980 MINEIROS DO TIETE",0,1,2,116,0,119,"2016"
"37136","352990 MIRACATU",3,0,7,309,0,319,"2016"
"37137","353000 MIRA ESTRELA",0,0,2,28,0,30,"2016"
"37138","353010 MIRANDOPOLIS",0,2,7,274,0,283,"2016"
"37139","353020 MIRANTE DO PARANAPANEMA",0,1,1,178,0,180,"2016"
"37140","353030 MIRASSOL",1,6,12,690,1,710,"2016"
"37141","353040 MIRASSOLANDIA",0,0,1,49,0,50,"2016"
"37142","353050 MOCOCA",2,7,8,775,1,793,"2016"
"37143","353060 MOGI DAS CRUZES",13,8,43,6153,30,6247,"2016"
"37144","353070 MOGI GUACU",11,9,23,1854,12,1909,"2016"
"37145","353080 MOGI MIRIM",0,1,11,1086,3,1101,"2016"
"37146","353090 MOMBUCA",0,0,0,49,0,49,"2016"
"37147","353100 MONCOES",0,0,0,24,0,24,"2016"
"37148","353110 MONGAGUA",1,3,12,697,1,714,"2016"
"37149","353120 MONTE ALEGRE DO SUL",0,0,0,54,0,54,"2016"
"37150","353130 MONTE ALTO",0,0,6,513,1,520,"2016"
"37151","353140 MONTE APRAZIVEL",0,0,2,235,2,239,"2016"
"37152","353150 MONTE AZUL PAULISTA",1,0,0,207,0,208,"2016"
"37153","353160 MONTE CASTELO",0,1,0,38,0,39,"2016"
"37154","353170 MONTEIRO LOBATO",0,0,0,23,0,23,"2016"
"37155","353180 MONTE MOR",1,1,7,896,10,915,"2016"
"37156","353190 MORRO AGUDO",3,0,4,386,0,393,"2016"
"37157","353200 MORUNGABA",1,1,5,149,0,156,"2016"
"37158","353205 MOTUCA",0,1,0,61,6,68,"2016"
"37159","353210 MURUTINGA DO SUL",0,0,0,25,0,25,"2016"
"37160","353215 NANTES",0,0,0,40,0,40,"2016"
"37161","353220 NARANDIBA",0,1,2,77,0,80,"2016"
"37162","353230 NATIVIDADE DA SERRA",0,0,2,56,0,58,"2016"
"37163","353240 NAZARE PAULISTA",1,1,2,203,0,207,"2016"
"37164","353250 NEVES PAULISTA",0,0,1,91,0,92,"2016"
"37165","353260 NHANDEARA",0,0,0,91,2,93,"2016"
"37166","353270 NIPOA",0,1,0,72,1,74,"2016"
"37167","353280 NOVA ALIANCA",0,1,0,72,0,73,"2016"
"37168","353282 NOVA CAMPINA",0,1,4,144,0,149,"2016"
"37169","353284 NOVA CANAA PAULISTA",0,0,0,16,0,16,"2016"
"37170","353286 NOVA CASTILHO",0,0,0,23,0,23,"2016"
"37171","353290 NOVA EUROPA",0,0,2,119,5,126,"2016"
"37172","353300 NOVA GRANADA",0,2,0,262,0,264,"2016"
"37173","353310 NOVA GUATAPORANGA",0,0,0,23,0,23,"2016"
"37174","353320 NOVA INDEPENDENCIA",0,0,0,45,0,45,"2016"
"37175","353325 NOVAIS",0,1,2,65,0,68,"2016"
"37176","353330 NOVA LUZITANIA",0,0,0,39,1,40,"2016"
"37177","353340 NOVA ODESSA",1,2,7,700,1,711,"2016"
"37178","353350 NOVO HORIZONTE",0,0,1,481,0,482,"2016"
"37179","353360 NUPORANGA",0,0,3,71,0,74,"2016"
"37180","353370 OCAUCU",0,0,0,68,0,68,"2016"
"37181","353380 OLEO",0,0,0,31,0,31,"2016"
"37182","353390 OLIMPIA",2,7,12,617,2,640,"2016"
"37183","353400 ONDA VERDE",0,0,0,59,0,59,"2016"
"37184","353410 ORIENTE",0,0,1,73,1,75,"2016"
"37185","353420 ORINDIUVA",0,0,1,58,0,59,"2016"
"37186","353430 ORLANDIA",1,2,4,473,0,480,"2016"
"37187","353440 OSASCO",23,48,164,10036,46,10317,"2016"
"37188","353450 OSCAR BRESSANE",0,1,0,22,0,23,"2016"
"37189","353460 OSVALDO CRUZ",1,1,3,311,1,317,"2016"
"37190","353470 OURINHOS",2,7,12,1314,6,1341,"2016"
"37191","353475 OUROESTE",0,0,1,118,0,119,"2016"
"37192","353480 OURO VERDE",0,0,0,84,1,85,"2016"
"37193","353490 PACAEMBU",1,1,1,107,1,111,"2016"
"37194","353500 PALESTINA",0,0,2,110,0,112,"2016"
"37195","353510 PALMARES PAULISTA",1,1,1,122,0,125,"2016"
"37196","353520 PALMEIRA D'OESTE",0,1,1,84,1,87,"2016"
"37197","353530 PALMITAL",1,0,1,237,0,239,"2016"
"37198","353540 PANORAMA",0,1,8,236,0,245,"2016"
"37199","353550 PARAGUACU PAULISTA",5,0,9,595,3,612,"2016"
"37200","353560 PARAIBUNA",0,0,4,206,2,212,"2016"
"37201","353570 PARAISO",0,0,0,62,1,63,"2016"
"37202","353580 PARANAPANEMA",0,0,4,258,1,263,"2016"
"37203","353590 PARANAPUA",0,0,0,48,0,48,"2016"
"37204","353600 PARAPUA",0,0,2,118,0,120,"2016"
"37205","353610 PARDINHO",1,1,2,100,3,107,"2016"
"37206","353620 PARIQUERA-ACU",0,0,5,271,3,279,"2016"
"37207","353625 PARISI",0,0,0,43,0,43,"2016"
"37208","353630 PATROCINIO PAULISTA",1,3,6,200,6,216,"2016"
"37209","353640 PAULICEIA",0,1,2,123,0,126,"2016"
"37210","353650 PAULINIA",4,5,8,1417,16,1450,"2016"
"37211","353657 PAULISTANIA",0,0,1,21,0,22,"2016"
"37212","353660 PAULO DE FARIA",0,0,2,87,1,90,"2016"
"37213","353670 PEDERNEIRAS",0,1,8,545,4,558,"2016"
"37214","353680 PEDRA BELA",0,0,0,68,1,69,"2016"
"37215","353690 PEDRANOPOLIS",0,0,1,18,0,19,"2016"
"37216","353700 PEDREGULHO",0,2,2,198,1,203,"2016"
"37217","353710 PEDREIRA",0,1,2,451,2,456,"2016"
"37218","353715 PEDRINHAS PAULISTA",0,0,0,23,0,23,"2016"
"37219","353720 PEDRO DE TOLEDO",1,0,3,120,1,125,"2016"
"37220","353730 PENAPOLIS",0,3,9,770,0,782,"2016"
"37221","353740 PEREIRA BARRETO",0,0,3,268,13,284,"2016"
"37222","353750 PEREIRAS",1,0,2,115,1,119,"2016"
"37223","353760 PERUIBE",0,8,12,933,8,961,"2016"
"37224","353770 PIACATU",1,0,0,64,0,65,"2016"
"37225","353780 PIEDADE",2,1,10,679,4,696,"2016"
"37226","353790 PILAR DO SUL",1,1,8,376,0,386,"2016"
"37227","353800 PINDAMONHANGABA",0,5,38,2087,32,2162,"2016"
"37228","353810 PINDORAMA",0,0,0,151,0,151,"2016"
"37229","353820 PINHALZINHO",1,1,1,139,0,142,"2016"
"37230","353830 PIQUEROBI",0,0,0,19,0,19,"2016"
"37231","353850 PIQUETE",0,0,1,135,12,148,"2016"
"37232","353860 PIRACAIA",0,1,6,299,2,308,"2016"
"37233","353870 PIRACICABA",12,16,45,4945,10,5028,"2016"
"37234","353880 PIRAJU",1,0,5,368,0,374,"2016"
"37235","353890 PIRAJUI",1,1,3,211,4,220,"2016"
"37236","353900 PIRANGI",0,1,0,106,0,107,"2016"
"37237","353910 PIRAPORA DO BOM JESUS",1,1,4,251,0,257,"2016"
"37238","353920 PIRAPOZINHO",2,0,4,319,2,327,"2016"
"37239","353930 PIRASSUNUNGA",1,1,11,879,4,896,"2016"
"37240","353940 PIRATININGA",0,2,3,172,0,177,"2016"
"37241","353950 PITANGUEIRAS",0,2,4,440,1,447,"2016"
"37242","353960 PLANALTO",0,0,0,73,0,73,"2016"
"37243","353970 PLATINA",0,0,0,38,0,38,"2016"
"37244","353980 POA",5,8,16,1539,6,1574,"2016"
"37245","353990 POLONI",0,0,0,55,1,56,"2016"
"37246","354000 POMPEIA",4,2,3,246,1,256,"2016"
"37247","354010 PONGAI",0,0,0,28,2,30,"2016"
"37248","354020 PONTAL",2,1,4,498,21,526,"2016"
"37249","354025 PONTALINDA",0,0,0,36,1,37,"2016"
"37250","354030 PONTES GESTAL",0,0,0,18,0,18,"2016"
"37251","354040 POPULINA",0,0,0,40,0,40,"2016"
"37252","354050 PORANGABA",2,0,2,92,3,99,"2016"
"37253","354060 PORTO FELIZ",2,2,7,659,0,670,"2016"
"37254","354070 PORTO FERREIRA",0,1,1,625,0,627,"2016"
"37255","354075 POTIM",0,1,6,265,2,274,"2016"
"37256","354080 POTIRENDABA",1,0,4,237,0,242,"2016"
"37257","354085 PRACINHA",0,0,0,13,0,13,"2016"
"37258","354090 PRADOPOLIS",0,1,1,205,1,208,"2016"
"37259","354100 PRAIA GRANDE",5,28,72,4328,11,4444,"2016"
"37260","354105 PRATANIA",1,0,2,78,3,84,"2016"
"37261","354110 PRESIDENTE ALVES",0,0,0,39,0,39,"2016"
"37262","354120 PRESIDENTE BERNARDES",0,0,0,115,0,115,"2016"
"37263","354130 PRESIDENTE EPITACIO",3,1,7,561,15,587,"2016"
"37264","354140 PRESIDENTE PRUDENTE",6,11,34,2816,8,2875,"2016"
"37265","354150 PRESIDENTE VENCESLAU",0,1,5,385,10,401,"2016"
"37266","354160 PROMISSAO",0,0,1,427,11,439,"2016"
"37267","354165 QUADRA",0,0,0,59,0,59,"2016"
"37268","354170 QUATA",0,0,1,161,0,162,"2016"
"37269","354180 QUEIROZ",0,0,0,51,0,51,"2016"
"37270","354190 QUELUZ",0,0,1,131,3,135,"2016"
"37271","354200 QUINTANA",0,2,4,74,1,81,"2016"
"37272","354210 RAFARD",0,0,2,86,0,88,"2016"
"37273","354220 RANCHARIA",0,0,6,430,2,438,"2016"
"37274","354230 REDENCAO DA SERRA",0,0,3,45,0,48,"2016"
"37275","354240 REGENTE FEIJO",0,1,1,231,0,233,"2016"
"37276","354250 REGINOPOLIS",0,0,0,59,2,61,"2016"
"37277","354260 REGISTRO",5,4,7,839,1,856,"2016"
"37278","354270 RESTINGA",1,0,2,93,2,98,"2016"
"37279","354280 RIBEIRA",0,0,0,35,0,35,"2016"
"37280","354290 RIBEIRAO BONITO",0,0,0,157,2,159,"2016"
"37281","354300 RIBEIRAO BRANCO",1,0,12,245,3,261,"2016"
"37282","354310 RIBEIRAO CORRENTE",0,0,2,64,0,66,"2016"
"37283","354320 RIBEIRAO DO SUL",0,0,0,58,0,58,"2016"
"37284","354323 RIBEIRAO DOS INDIOS",0,1,1,17,0,19,"2016"
"37285","354325 RIBEIRAO GRANDE",0,1,0,98,1,100,"2016"
"37286","354330 RIBEIRAO PIRES",2,5,32,1283,5,1327,"2016"
"37287","354340 RIBEIRAO PRETO",19,45,109,7833,31,8037,"2016"
"37288","354350 RIVERSUL",0,2,6,73,1,82,"2016"
"37289","354360 RIFAINA",0,0,0,34,0,34,"2016"
"37290","354370 RINCAO",0,1,2,99,14,116,"2016"
"37291","354380 RINOPOLIS",1,0,1,87,0,89,"2016"
"37292","354390 RIO CLARO",5,11,26,2352,43,2437,"2016"
"37293","354400 RIO DAS PEDRAS",0,0,4,388,0,392,"2016"
"37294","354410 RIO GRANDE DA SERRA",0,4,7,588,2,601,"2016"
"37295","354420 RIOLANDIA",0,1,0,109,0,110,"2016"
"37296","354425 ROSANA",0,1,3,271,2,277,"2016"
"37297","354430 ROSEIRA",0,1,2,128,0,131,"2016"
"37298","354440 RUBIACEA",0,0,1,31,0,32,"2016"
"37299","354450 RUBINEIA",0,2,0,21,0,23,"2016"
"37300","354460 SABINO",0,1,0,59,1,61,"2016"
"37301","354470 SAGRES",0,0,0,25,0,25,"2016"
"37302","354480 SALES",0,0,0,57,0,57,"2016"
"37303","354490 SALES OLIVEIRA",0,2,2,117,0,121,"2016"
"37304","354500 SALESOPOLIS",0,0,3,199,2,204,"2016"
"37305","354510 SALMOURAO",0,1,0,62,0,63,"2016"
"37306","354515 SALTINHO",0,1,0,75,0,76,"2016"
"37307","354520 SALTO",3,3,18,1596,1,1621,"2016"
"37308","354530 SALTO DE PIRAPORA",1,2,16,571,3,593,"2016"
"37309","354540 SALTO GRANDE",0,0,0,106,2,108,"2016"
"37310","354550 SANDOVALINA",0,0,1,49,0,50,"2016"
"37311","354560 SANTA ADELIA",1,0,3,183,2,189,"2016"
"37312","354570 SANTA ALBERTINA",0,0,0,65,0,65,"2016"
"37313","354580 SANTA BARBARA D'OESTE",3,7,25,2358,8,2401,"2016"
"37314","354600 SANTA BRANCA",1,1,1,149,2,154,"2016"
"37315","354610 SANTA CLARA D'OESTE",0,0,0,18,0,18,"2016"
"37316","354620 SANTA CRUZ DA CONCEICAO",0,0,0,33,0,33,"2016"
"37317","354625 SANTA CRUZ DA ESPERANCA",0,0,0,28,0,28,"2016"
"37318","354630 SANTA CRUZ DAS PALMEIRAS",0,0,7,381,1,389,"2016"
"37319","354640 SANTA CRUZ DO RIO PARDO",2,0,3,558,0,563,"2016"
"37320","354650 SANTA ERNESTINA",1,0,1,57,0,59,"2016"
"37321","354660 SANTA FE DO SUL",2,0,1,350,0,353,"2016"
"37322","354670 SANTA GERTRUDES",0,0,4,325,3,332,"2016"
"37323","354680 SANTA ISABEL",1,2,9,702,2,716,"2016"
"37324","354690 SANTA LUCIA",0,0,5,103,12,120,"2016"
"37325","354700 SANTA MARIA DA SERRA",0,0,0,81,0,81,"2016"
"37326","354710 SANTA MERCEDES",0,0,0,40,0,40,"2016"
"37327","354720 SANTANA DA PONTE PENSA",0,0,0,12,0,12,"2016"
"37328","354730 SANTANA DE PARNAIBA",5,6,29,2208,6,2254,"2016"
"37329","354740 SANTA RITA D'OESTE",0,0,0,19,0,19,"2016"
"37330","354750 SANTA RITA DO PASSA QUATRO",0,2,4,257,0,263,"2016"
"37331","354760 SANTA ROSA DE VITERBO",0,1,8,234,1,244,"2016"
"37332","354765 SANTA SALETE",0,0,0,12,0,12,"2016"
"37333","354770 SANTO ANASTACIO",0,1,3,206,1,211,"2016"
"37334","354780 SANTO ANDRE",21,37,126,8563,55,8802,"2016"
"37335","354790 SANTO ANTONIO DA ALEGRIA",0,0,2,78,0,80,"2016"
"37336","354800 SANTO ANTONIO DE POSSE",0,0,6,254,2,262,"2016"
"37337","354805 SANTO ANTONIO DO ARACANGUA",0,0,2,110,0,112,"2016"
"37338","354810 SANTO ANTONIO DO JARDIM",0,0,2,49,0,51,"2016"
"37339","354820 SANTO ANTONIO DO PINHAL",1,0,2,76,0,79,"2016"
"37340","354830 SANTO EXPEDITO",0,0,0,30,0,30,"2016"
"37341","354840 SANTOPOLIS DO AGUAPEI",0,0,0,70,0,70,"2016"
"37342","354850 SANTOS",10,26,82,4382,13,4513,"2016"
"37343","354860 SAO BENTO DO SAPUCAI",1,0,1,130,2,134,"2016"
"37344","354870 SAO BERNARDO DO CAMPO",25,33,163,10502,38,10761,"2016"
"37345","354880 SAO CAETANO DO SUL",3,5,19,1747,2,1776,"2016"
"37346","354890 SAO CARLOS",2,6,29,3083,15,3135,"2016"
"37347","354900 SAO FRANCISCO",0,0,0,21,0,21,"2016"
"37348","354910 SAO JOAO DA BOA VISTA",1,2,10,1048,4,1065,"2016"
"37349","354920 SAO JOAO DAS DUAS PONTES",0,0,1,13,0,14,"2016"
"37350","354925 SAO JOAO DE IRACEMA",0,0,2,22,0,24,"2016"
"37351","354930 SAO JOAO DO PAU D'ALHO",0,0,0,18,0,18,"2016"
"37352","354940 SAO JOAQUIM DA BARRA",2,2,7,569,1,581,"2016"
"37353","354950 SAO JOSE DA BELA VISTA",1,0,1,111,2,115,"2016"
"37354","354960 SAO JOSE DO BARREIRO",0,0,0,46,3,49,"2016"
"37355","354970 SAO JOSE DO RIO PARDO",0,4,16,627,7,654,"2016"
"37356","354980 SAO JOSE DO RIO PRETO",7,8,30,5332,15,5392,"2016"
"37357","354990 SAO JOSE DOS CAMPOS",11,28,103,9384,36,9562,"2016"
"37358","354995 SAO LOURENCO DA SERRA",1,1,6,230,0,238,"2016"
"37359","355000 SAO LUIS DO PARAITINGA",0,1,2,106,0,109,"2016"
"37360","355010 SAO MANUEL",1,3,8,510,8,530,"2016"
"37361","355020 SAO MIGUEL ARCANJO",0,4,8,443,0,455,"2016"
"37362","355030 SAO PAULO",450,706,2278,163258,611,167303,"2016"
"37363","355040 SAO PEDRO",2,2,6,399,0,409,"2016"
"37364","355050 SAO PEDRO DO TURVO",0,0,1,84,0,85,"2016"
"37365","355060 SAO ROQUE",2,5,21,1093,1,1122,"2016"
"37366","355070 SAO SEBASTIAO",2,4,16,1246,2,1270,"2016"
"37367","355080 SAO SEBASTIAO DA GRAMA",0,0,1,103,1,105,"2016"
"37368","355090 SAO SIMAO",1,1,5,147,1,155,"2016"
"37369","355100 SAO VICENTE",12,27,119,4619,28,4805,"2016"
"37370","355110 SARAPUI",0,0,1,116,1,118,"2016"
"37371","355120 SARUTAIA",1,0,0,44,0,45,"2016"
"37372","355130 SEBASTIANOPOLIS DO SUL",0,0,0,32,0,32,"2016"
"37373","355140 SERRA AZUL",0,1,2,113,2,118,"2016"
"37374","355150 SERRANA",1,7,12,596,2,618,"2016"
"37375","355160 SERRA NEGRA",0,0,1,323,1,325,"2016"
"37376","355170 SERTAOZINHO",2,2,15,1515,6,1540,"2016"
"37377","355180 SETE BARRAS",3,0,4,194,1,202,"2016"
"37378","355190 SEVERINIA",2,1,4,182,0,189,"2016"
"37379","355200 SILVEIRAS",0,0,1,58,0,59,"2016"
"37380","355210 SOCORRO",1,0,2,419,0,422,"2016"
"37381","355220 SOROCABA",23,35,143,8701,33,8935,"2016"
"37382","355230 SUD MENNUCCI",0,0,1,89,0,90,"2016"
"37383","355240 SUMARE",7,10,55,3786,19,3877,"2016"
"37384","355250 SUZANO",17,31,100,4281,29,4458,"2016"
"37385","355255 SUZANAPOLIS",0,0,0,37,0,37,"2016"
"37386","355260 TABAPUA",0,0,1,111,0,112,"2016"
"37387","355270 TABATINGA",1,1,5,195,3,205,"2016"
"37388","355280 TABOAO DA SERRA",9,16,56,4234,14,4329,"2016"
"37389","355290 TACIBA",0,0,0,80,1,81,"2016"
"37390","355300 TAGUAI",0,0,2,174,0,176,"2016"
"37391","355310 TAIACU",0,1,0,53,0,54,"2016"
"37392","355320 TAIUVA",0,1,2,57,0,60,"2016"
"37393","355330 TAMBAU",0,0,0,275,1,276,"2016"
"37394","355340 TANABI",0,0,3,256,0,259,"2016"
"37395","355350 TAPIRAI",1,0,1,87,0,89,"2016"
"37396","355360 TAPIRATIBA",0,1,2,141,0,144,"2016"
"37397","355365 TAQUARAL",0,0,0,20,0,20,"2016"
"37398","355370 TAQUARITINGA",1,1,4,638,1,645,"2016"
"37399","355380 TAQUARITUBA",0,0,7,305,0,312,"2016"
"37400","355385 TAQUARIVAI",0,2,4,77,0,83,"2016"
"37401","355390 TARABAI",0,0,2,94,0,96,"2016"
"37402","355395 TARUMA",1,0,4,202,1,208,"2016"
"37403","355400 TATUI",2,7,20,1593,1,1623,"2016"
"37404","355410 TAUBATE",6,14,68,3854,9,3951,"2016"
"37405","355420 TEJUPA",0,0,0,66,0,66,"2016"
"37406","355430 TEODORO SAMPAIO",2,1,4,324,1,332,"2016"
"37407","355440 TERRA ROXA",0,0,0,54,53,107,"2016"
"37408","355450 TIETE",2,3,6,448,3,462,"2016"
"37409","355460 TIMBURI",0,0,0,23,1,24,"2016"
"37410","355465 TORRE DE PEDRA",0,0,0,27,1,28,"2016"
"37411","355470 TORRINHA",0,1,1,83,0,85,"2016"
"37412","355475 TRABIJU",0,0,0,10,1,11,"2016"
"37413","355480 TREMEMBE",1,3,12,563,3,582,"2016"
"37414","355490 TRES FRONTEIRAS",1,0,0,68,0,69,"2016"
"37415","355495 TUIUTI",0,0,0,90,0,90,"2016"
"37416","355500 TUPA",2,3,11,726,0,742,"2016"
"37417","355510 TUPI PAULISTA",0,0,4,161,0,165,"2016"
"37418","355520 TURIUBA",0,0,0,20,2,22,"2016"
"37419","355530 TURMALINA",0,0,1,13,0,14,"2016"
"37420","355535 UBARANA",0,0,2,74,0,76,"2016"
"37421","355540 UBATUBA",3,8,21,1197,4,1233,"2016"
"37422","355550 UBIRAJARA",2,1,1,76,2,82,"2016"
"37423","355560 UCHOA",1,0,0,94,0,95,"2016"
"37424","355570 UNIAO PAULISTA",0,0,0,23,0,23,"2016"
"37425","355580 URANIA",1,0,0,90,0,91,"2016"
"37426","355590 URU",1,1,0,13,0,15,"2016"
"37427","355600 URUPES",1,1,0,118,0,120,"2016"
"37428","355610 VALENTIM GENTIL",1,1,0,156,0,158,"2016"
"37429","355620 VALINHOS",4,4,15,1342,14,1379,"2016"
"37430","355630 VALPARAISO",0,0,6,326,5,337,"2016"
"37431","355635 VARGEM",0,0,3,134,0,137,"2016"
"37432","355640 VARGEM GRANDE DO SUL",0,0,1,529,6,536,"2016"
"37433","355645 VARGEM GRANDE PAULISTA",1,2,11,739,2,755,"2016"
"37434","355650 VARZEA PAULISTA",5,6,25,1445,8,1489,"2016"
"37435","355660 VERA CRUZ",3,3,3,125,1,135,"2016"
"37436","355670 VINHEDO",0,2,7,912,3,924,"2016"
"37437","355680 VIRADOURO",1,1,0,226,1,229,"2016"
"37438","355690 VISTA ALEGRE DO ALTO",0,0,3,79,0,82,"2016"
"37439","355695 VITORIA BRASIL",0,0,1,21,0,22,"2016"
"37440","355700 VOTORANTIM",4,6,27,1621,5,1663,"2016"
"37441","355710 VOTUPORANGA",1,2,8,1014,0,1025,"2016"
"37442","355715 ZACARIAS",0,0,0,28,0,28,"2016"
"37443","355720 CHAVANTES",0,1,1,158,0,160,"2016"
"37444","355730 ESTIVA GERBI",0,0,2,133,2,137,"2016"
"37445","410010 ABATIA",0,0,2,100,0,102,"2016"
"37446","410020 ADRIANOPOLIS",0,2,0,66,2,70,"2016"
"37447","410030 AGUDOS DO SUL",2,0,0,110,1,113,"2016"
"37448","410040 ALMIRANTE TAMANDARE",4,11,24,1755,17,1811,"2016"
"37449","410045 ALTAMIRA DO PARANA",0,0,0,54,0,54,"2016"
"37450","410050 ALTONIA",1,1,3,260,1,266,"2016"
"37451","410060 ALTO PARANA",4,0,3,167,0,174,"2016"
"37452","410070 ALTO PIQUIRI",0,1,4,137,0,142,"2016"
"37453","410080 ALVORADA DO SUL",0,1,3,100,1,105,"2016"
"37454","410090 AMAPORA",0,0,2,85,0,87,"2016"
"37455","410100 AMPERE",1,1,11,242,1,256,"2016"
"37456","410105 ANAHY",0,0,3,39,0,42,"2016"
"37457","410110 ANDIRA",1,2,4,252,0,259,"2016"
"37458","410115 ANGULO",0,0,3,39,0,42,"2016"
"37459","410120 ANTONINA",1,0,6,245,0,252,"2016"
"37460","410130 ANTONIO OLINTO",0,0,1,90,0,91,"2016"
"37461","410140 APUCARANA",5,5,23,1661,3,1697,"2016"
"37462","410150 ARAPONGAS",6,8,17,1532,0,1563,"2016"
"37463","410160 ARAPOTI",3,1,3,352,0,359,"2016"
"37464","410165 ARAPUA",0,0,0,62,0,62,"2016"
"37465","410170 ARARUNA",0,1,0,204,1,206,"2016"
"37466","410180 ARAUCARIA",2,8,26,2213,6,2255,"2016"
"37467","410185 ARIRANHA DO IVAI",0,0,1,30,0,31,"2016"
"37468","410190 ASSAI",0,0,1,205,0,206,"2016"
"37469","410200 ASSIS CHATEAUBRIAND",0,1,5,437,2,445,"2016"
"37470","410210 ASTORGA",1,1,4,322,0,328,"2016"
"37471","410220 ATALAIA",0,0,1,42,0,43,"2016"
"37472","410230 BALSA NOVA",0,2,4,185,0,191,"2016"
"37473","410240 BANDEIRANTES",0,0,13,419,0,432,"2016"
"37474","410250 BARBOSA FERRAZ",0,0,2,124,0,126,"2016"
"37475","410260 BARRACAO",0,0,3,143,0,146,"2016"
"37476","410270 BARRA DO JACARE",0,0,0,25,0,25,"2016"
"37477","410275 BELA VISTA DA CAROBA",0,0,0,26,0,26,"2016"
"37478","410280 BELA VISTA DO PARAISO",0,2,3,205,0,210,"2016"
"37479","410290 BITURUNA",0,0,2,268,1,271,"2016"
"37480","410300 BOA ESPERANCA",0,0,0,51,0,51,"2016"
"37481","410302 BOA ESPERANCA DO IGUACU",0,0,0,27,0,27,"2016"
"37482","410304 BOA VENTURA DE SAO ROQUE",0,0,4,87,0,91,"2016"
"37483","410305 BOA VISTA DA APARECIDA",0,0,3,98,0,101,"2016"
"37484","410310 BOCAIUVA DO SUL",1,0,3,176,1,181,"2016"
"37485","410315 BOM JESUS DO SUL",0,0,0,42,0,42,"2016"
"37486","410320 BOM SUCESSO",0,1,1,86,0,88,"2016"
"37487","410322 BOM SUCESSO DO SUL",0,0,0,35,0,35,"2016"
"37488","410330 BORRAZOPOLIS",0,0,2,101,0,103,"2016"
"37489","410335 BRAGANEY",0,0,4,69,0,73,"2016"
"37490","410337 BRASILANDIA DO SUL",0,0,0,44,0,44,"2016"
"37491","410340 CAFEARA",0,0,0,20,0,20,"2016"
"37492","410345 CAFELANDIA",0,0,4,256,0,260,"2016"
"37493","410347 CAFEZAL DO SUL",0,0,0,40,0,40,"2016"
"37494","410350 CALIFORNIA",1,1,0,134,0,136,"2016"
"37495","410360 CAMBARA",1,1,5,280,0,287,"2016"
"37496","410370 CAMBE",1,4,15,1234,2,1256,"2016"
"37497","410380 CAMBIRA",0,1,2,87,1,91,"2016"
"37498","410390 CAMPINA DA LAGOA",0,0,3,250,0,253,"2016"
"37499","410395 CAMPINA DO SIMAO",0,0,1,63,0,64,"2016"
"37500","410400 CAMPINA GRANDE DO SUL",2,4,7,772,1,786,"2016"
"37501","410405 CAMPO BONITO",0,0,0,58,0,58,"2016"
"37502","410410 CAMPO DO TENENTE",0,0,5,112,0,117,"2016"
"37503","410420 CAMPO LARGO",3,11,28,1669,9,1720,"2016"
"37504","410425 CAMPO MAGRO",1,2,3,423,2,431,"2016"
"37505","410430 CAMPO MOURAO",1,5,17,1248,3,1274,"2016"
"37506","410440 CANDIDO DE ABREU",1,1,6,218,0,226,"2016"
"37507","410442 CANDOI",1,1,4,233,0,239,"2016"
"37508","410445 CANTAGALO",0,1,6,197,0,204,"2016"
"37509","410450 CAPANEMA",1,0,4,228,1,234,"2016"
"37510","410460 CAPITAO LEONIDAS MARQUES",0,1,8,191,0,200,"2016"
"37511","410465 CARAMBEI",1,1,6,354,0,362,"2016"
"37512","410470 CARLOPOLIS",1,0,3,172,0,176,"2016"
"37513","410480 CASCAVEL",4,20,103,4577,1,4705,"2016"
"37514","410490 CASTRO",2,5,25,1079,2,1113,"2016"
"37515","410500 CATANDUVAS",0,1,0,113,0,114,"2016"
"37516","410510 CENTENARIO DO SUL",0,0,1,118,0,119,"2016"
"37517","410520 CERRO AZUL",1,2,4,208,3,218,"2016"
"37518","410530 CEU AZUL",0,1,3,140,0,144,"2016"
"37519","410540 CHOPINZINHO",1,0,13,261,0,275,"2016"
"37520","410550 CIANORTE",1,2,9,1057,0,1069,"2016"
"37521","410560 CIDADE GAUCHA",1,0,0,170,0,171,"2016"
"37522","410570 CLEVELANDIA",1,0,3,259,0,263,"2016"
"37523","410580 COLOMBO",8,9,44,3648,11,3720,"2016"
"37524","410590 COLORADO",1,2,2,288,0,293,"2016"
"37525","410600 CONGONHINHAS",0,0,2,118,0,120,"2016"
"37526","410610 CONSELHEIRO MAIRINCK",0,0,0,31,0,31,"2016"
"37527","410620 CONTENDA",2,0,6,237,3,248,"2016"
"37528","410630 CORBELIA",0,0,6,254,0,260,"2016"
"37529","410640 CORNELIO PROCOPIO",1,1,7,535,1,545,"2016"
"37530","410645 CORONEL DOMINGOS SOARES",0,0,1,86,1,88,"2016"
"37531","410650 CORONEL VIVIDA",2,0,6,344,0,352,"2016"
"37532","410655 CORUMBATAI DO SUL",0,1,1,51,0,53,"2016"
"37533","410657 CRUZEIRO DO IGUACU",0,0,0,34,1,35,"2016"
"37534","410660 CRUZEIRO DO OESTE",0,2,5,276,1,284,"2016"
"37535","410670 CRUZEIRO DO SUL",0,0,0,69,0,69,"2016"
"37536","410680 CRUZ MACHADO",0,0,0,224,0,224,"2016"
"37537","410685 CRUZMALTINA",0,0,2,39,0,41,"2016"
"37538","410690 CURITIBA",63,99,334,22651,70,23217,"2016"
"37539","410700 CURIUVA",0,1,5,180,0,186,"2016"
"37540","410710 DIAMANTE DO NORTE",2,0,0,57,0,59,"2016"
"37541","410712 DIAMANTE DO SUL",0,0,0,47,0,47,"2016"
"37542","410715 DIAMANTE D'OESTE",1,0,1,62,0,64,"2016"
"37543","410720 DOIS VIZINHOS",1,1,9,619,1,631,"2016"
"37544","410725 DOURADINA",0,0,0,122,0,122,"2016"
"37545","410730 DOUTOR CAMARGO",0,0,0,65,0,65,"2016"
"37546","410740 ENEAS MARQUES",0,1,0,66,0,67,"2016"
"37547","410750 ENGENHEIRO BELTRAO",1,0,2,168,0,171,"2016"
"37548","410752 ESPERANCA NOVA",0,0,1,25,0,26,"2016"
"37549","410753 ENTRE RIOS DO OESTE",0,1,5,62,0,68,"2016"
"37550","410754 ESPIGAO ALTO DO IGUACU",0,0,3,66,0,69,"2016"
"37551","410755 FAROL",0,0,0,42,0,42,"2016"
"37552","410760 FAXINAL",0,0,3,241,2,246,"2016"
"37553","410765 FAZENDA RIO GRANDE",4,6,36,1918,5,1969,"2016"
"37554","410770 FENIX",0,0,2,43,0,45,"2016"
"37555","410773 FERNANDES PINHEIRO",0,0,1,82,0,83,"2016"
"37556","410775 FIGUEIRA",2,0,1,87,0,90,"2016"
"37557","410780 FLORAI",0,0,1,59,0,60,"2016"
"37558","410785 FLOR DA SERRA DO SUL",0,0,0,60,0,60,"2016"
"37559","410790 FLORESTA",0,2,1,77,0,80,"2016"
"37560","410800 FLORESTOPOLIS",1,1,2,194,0,198,"2016"
"37561","410810 FLORIDA",0,0,1,27,0,28,"2016"
"37562","410820 FORMOSA DO OESTE",0,0,2,79,0,81,"2016"
"37563","410830 FOZ DO IGUACU",7,13,41,4127,10,4198,"2016"
"37564","410832 FRANCISCO ALVES",0,0,3,105,0,108,"2016"
"37565","410840 FRANCISCO BELTRAO",3,5,9,1283,1,1301,"2016"
"37566","410845 FOZ DO JORDAO",0,0,2,89,0,91,"2016"
"37567","410850 GENERAL CARNEIRO",0,5,11,215,1,232,"2016"
"37568","410855 GODOY MOREIRA",0,0,0,22,0,22,"2016"
"37569","410860 GOIOERE",0,0,3,369,1,373,"2016"
"37570","410865 GOIOXIM",0,1,1,104,0,106,"2016"
"37571","410870 GRANDES RIOS",1,0,0,84,0,85,"2016"
"37572","410880 GUAIRA",0,1,4,464,0,469,"2016"
"37573","410890 GUAIRACA",0,0,0,91,0,91,"2016"
"37574","410895 GUAMIRANGA",0,1,1,109,0,111,"2016"
"37575","410900 GUAPIRAMA",0,0,1,55,0,56,"2016"
"37576","410910 GUAPOREMA",0,0,0,21,0,21,"2016"
"37577","410920 GUARACI",0,0,0,30,1,31,"2016"
"37578","410930 GUARANIACU",2,1,2,193,0,198,"2016"
"37579","410940 GUARAPUAVA",5,16,30,2792,4,2847,"2016"
"37580","410950 GUARAQUECABA",1,0,2,99,2,104,"2016"
"37581","410960 GUARATUBA",1,5,6,507,0,519,"2016"
"37582","410965 HONORIO SERPA",0,0,0,78,0,78,"2016"
"37583","410970 IBAITI",0,2,4,345,0,351,"2016"
"37584","410975 IBEMA",0,1,2,96,0,99,"2016"
"37585","410980 IBIPORA",4,3,16,703,1,727,"2016"
"37586","410990 ICARAIMA",0,0,2,119,0,121,"2016"
"37587","411000 IGUARACU",0,0,0,63,0,63,"2016"
"37588","411005 IGUATU",0,1,2,25,0,28,"2016"
"37589","411007 IMBAU",0,1,2,219,0,222,"2016"
"37590","411010 IMBITUVA",1,2,3,496,1,503,"2016"
"37591","411020 INACIO MARTINS",0,2,1,136,0,139,"2016"
"37592","411030 INAJA",0,1,1,33,0,35,"2016"
"37593","411040 INDIANOPOLIS",1,0,0,65,0,66,"2016"
"37594","411050 IPIRANGA",0,1,2,198,1,202,"2016"
"37595","411060 IPORA",0,0,1,202,0,203,"2016"
"37596","411065 IRACEMA DO OESTE",0,0,0,23,0,23,"2016"
"37597","411070 IRATI",3,2,11,837,0,853,"2016"
"37598","411080 IRETAMA",0,1,0,145,0,146,"2016"
"37599","411090 ITAGUAJE",0,0,1,56,0,57,"2016"
"37600","411095 ITAIPULANDIA",0,0,1,141,0,142,"2016"
"37601","411100 ITAMBARACA",0,1,2,62,0,65,"2016"
"37602","411110 ITAMBE",0,0,0,66,0,66,"2016"
"37603","411120 ITAPEJARA D'OESTE",2,1,3,147,0,153,"2016"
"37604","411125 ITAPERUCU",2,5,5,484,2,498,"2016"
"37605","411130 ITAUNA DO SUL",0,0,1,47,0,48,"2016"
"37606","411140 IVAI",0,0,5,180,0,185,"2016"
"37607","411150 IVAIPORA",2,0,6,363,1,372,"2016"
"37608","411155 IVATE",0,0,1,121,0,122,"2016"
"37609","411160 IVATUBA",0,1,1,30,0,32,"2016"
"37610","411170 JABOTI",1,0,0,98,0,99,"2016"
"37611","411180 JACAREZINHO",0,2,8,528,1,539,"2016"
"37612","411190 JAGUAPITA",1,0,3,163,0,167,"2016"
"37613","411200 JAGUARIAIVA",0,3,5,573,0,581,"2016"
"37614","411210 JANDAIA DO SUL",1,2,2,261,0,266,"2016"
"37615","411220 JANIOPOLIS",0,2,0,83,1,86,"2016"
"37616","411230 JAPIRA",0,0,1,55,0,56,"2016"
"37617","411240 JAPURA",0,1,2,99,0,102,"2016"
"37618","411250 JARDIM ALEGRE",0,1,0,140,0,141,"2016"
"37619","411260 JARDIM OLINDA",0,0,1,17,0,18,"2016"
"37620","411270 JATAIZINHO",1,0,3,170,0,174,"2016"
"37621","411275 JESUITAS",0,0,1,100,0,101,"2016"
"37622","411280 JOAQUIM TAVORA",0,2,4,150,1,157,"2016"
"37623","411290 JUNDIAI DO SUL",0,0,0,42,0,42,"2016"
"37624","411295 JURANDA",0,0,3,97,0,100,"2016"
"37625","411300 JUSSARA",0,0,0,86,0,86,"2016"
"37626","411310 KALORE",0,1,2,43,1,47,"2016"
"37627","411320 LAPA",0,6,9,577,1,593,"2016"
"37628","411325 LARANJAL",0,0,3,77,0,80,"2016"
"37629","411330 LARANJEIRAS DO SUL",0,1,7,459,0,467,"2016"
"37630","411340 LEOPOLIS",0,0,1,36,0,37,"2016"
"37631","411342 LIDIANOPOLIS",0,0,4,49,0,53,"2016"
"37632","411345 LINDOESTE",0,0,0,78,0,78,"2016"
"37633","411350 LOANDA",0,2,1,263,0,266,"2016"
"37634","411360 LOBATO",0,0,3,49,0,52,"2016"
"37635","411370 LONDRINA",9,35,60,6889,19,7012,"2016"
"37636","411373 LUIZIANA",0,0,0,105,0,105,"2016"
"37637","411375 LUNARDELLI",0,0,0,51,1,52,"2016"
"37638","411380 LUPIONOPOLIS",1,0,2,49,0,52,"2016"
"37639","411390 MALLET",0,0,2,154,0,156,"2016"
"37640","411400 MAMBORE",0,1,2,159,1,163,"2016"
"37641","411410 MANDAGUACU",0,2,5,353,1,361,"2016"
"37642","411420 MANDAGUARI",0,1,9,458,0,468,"2016"
"37643","411430 MANDIRITUBA",0,1,2,324,0,327,"2016"
"37644","411435 MANFRINOPOLIS",0,0,0,42,0,42,"2016"
"37645","411440 MANGUEIRINHA",0,0,4,249,0,253,"2016"
"37646","411450 MANOEL RIBAS",0,0,5,218,0,223,"2016"
"37647","411460 MARECHAL CANDIDO RONDON",0,1,18,664,0,683,"2016"
"37648","411470 MARIA HELENA",0,1,2,48,0,51,"2016"
"37649","411480 MARIALVA",1,0,8,534,0,543,"2016"
"37650","411490 MARILANDIA DO SUL",0,0,0,124,0,124,"2016"
"37651","411500 MARILENA",0,0,3,89,0,92,"2016"
"37652","411510 MARILUZ",0,1,5,128,0,134,"2016"
"37653","411520 MARINGA",9,8,52,4722,3,4794,"2016"
"37654","411530 MARIOPOLIS",0,0,0,77,0,77,"2016"
"37655","411535 MARIPA",0,2,2,85,1,90,"2016"
"37656","411540 MARMELEIRO",1,0,4,191,0,196,"2016"
"37657","411545 MARQUINHO",0,0,1,48,0,49,"2016"
"37658","411550 MARUMBI",0,0,1,53,0,54,"2016"
"37659","411560 MATELANDIA",0,0,11,238,0,249,"2016"
"37660","411570 MATINHOS",0,2,11,460,1,474,"2016"
"37661","411573 MATO RICO",0,0,0,38,0,38,"2016"
"37662","411575 MAUA DA SERRA",0,0,2,151,1,154,"2016"
"37663","411580 MEDIANEIRA",4,4,18,654,0,680,"2016"
"37664","411585 MERCEDES",0,0,2,76,0,78,"2016"
"37665","411590 MIRADOR",0,1,1,23,0,25,"2016"
"37666","411600 MIRASELVA",0,0,0,27,0,27,"2016"
"37667","411605 MISSAL",1,1,2,125,0,129,"2016"
"37668","411610 MOREIRA SALES",1,2,3,131,0,137,"2016"
"37669","411620 MORRETES",1,0,3,221,8,233,"2016"
"37670","411630 MUNHOZ DE MELO",0,0,0,48,0,48,"2016"
"37671","411640 NOSSA SENHORA DAS GRACAS",0,0,0,61,0,61,"2016"
"37672","411650 NOVA ALIANCA DO IVAI",0,0,0,25,0,25,"2016"
"37673","411660 NOVA AMERICA DA COLINA",0,1,0,32,0,33,"2016"
"37674","411670 NOVA AURORA",0,2,2,127,0,131,"2016"
"37675","411680 NOVA CANTU",0,0,1,93,0,94,"2016"
"37676","411690 NOVA ESPERANCA",1,2,3,317,0,323,"2016"
"37677","411695 NOVA ESPERANCA DO SUDOESTE",0,0,0,68,1,69,"2016"
"37678","411700 NOVA FATIMA",0,2,0,85,0,87,"2016"
"37679","411705 NOVA LARANJEIRAS",1,2,2,154,0,159,"2016"
"37680","411710 NOVA LONDRINA",1,1,1,154,0,157,"2016"
"37681","411720 NOVA OLIMPIA",0,1,1,74,0,76,"2016"
"37682","411721 NOVA SANTA BARBARA",0,0,0,55,0,55,"2016"
"37683","411722 NOVA SANTA ROSA",0,1,2,131,0,134,"2016"
"37684","411725 NOVA PRATA DO IGUACU",1,0,1,117,0,119,"2016"
"37685","411727 NOVA TEBAS",0,0,1,80,0,81,"2016"
"37686","411729 NOVO ITACOLOMI",0,0,2,34,0,36,"2016"
"37687","411730 ORTIGUEIRA",1,3,4,363,1,372,"2016"
"37688","411740 OURIZONA",0,0,0,44,0,44,"2016"
"37689","411745 OURO VERDE DO OESTE",0,1,0,71,0,72,"2016"
"37690","411750 PAICANDU",1,2,6,615,1,625,"2016"
"37691","411760 PALMAS",0,3,9,875,3,890,"2016"
"37692","411770 PALMEIRA",1,1,11,427,2,442,"2016"
"37693","411780 PALMITAL",1,1,5,185,0,192,"2016"
"37694","411790 PALOTINA",0,0,6,446,1,453,"2016"
"37695","411800 PARAISO DO NORTE",0,0,3,164,0,167,"2016"
"37696","411810 PARANACITY",0,0,3,142,0,145,"2016"
"37697","411820 PARANAGUA",4,10,21,2108,13,2156,"2016"
"37698","411830 PARANAPOEMA",0,0,0,38,0,38,"2016"
"37699","411840 PARANAVAI",5,1,8,1255,0,1269,"2016"
"37700","411845 PATO BRAGADO",0,0,1,63,0,64,"2016"
"37701","411850 PATO BRANCO",7,1,11,1280,1,1300,"2016"
"37702","411860 PAULA FREITAS",0,0,2,74,0,76,"2016"
"37703","411870 PAULO FRONTIN",0,0,1,85,0,86,"2016"
"37704","411880 PEABIRU",0,0,1,166,0,167,"2016"
"37705","411885 PEROBAL",0,1,1,85,0,87,"2016"
"37706","411890 PEROLA",0,0,4,138,1,143,"2016"
"37707","411900 PEROLA D'OESTE",0,0,0,66,0,66,"2016"
"37708","411910 PIEN",1,1,3,157,1,163,"2016"
"37709","411915 PINHAIS",8,8,36,2037,6,2095,"2016"
"37710","411920 PINHALAO",0,0,0,108,0,108,"2016"
"37711","411925 PINHAL DE SAO BENTO",0,0,0,31,0,31,"2016"
"37712","411930 PINHAO",1,1,7,506,3,518,"2016"
"37713","411940 PIRAI DO SUL",1,2,12,350,0,365,"2016"
"37714","411950 PIRAQUARA",8,6,34,1488,7,1543,"2016"
"37715","411960 PITANGA",2,1,11,425,1,440,"2016"
"37716","411965 PITANGUEIRAS",0,0,0,32,0,32,"2016"
"37717","411970 PLANALTINA DO PARANA",0,0,0,59,0,59,"2016"
"37718","411980 PLANALTO",0,0,1,126,0,127,"2016"
"37719","411990 PONTA GROSSA",12,18,106,5200,4,5340,"2016"
"37720","411995 PONTAL DO PARANA",0,2,5,355,3,365,"2016"
"37721","412000 PORECATU",0,1,1,166,0,168,"2016"
"37722","412010 PORTO AMAZONAS",0,1,0,51,0,52,"2016"
"37723","412015 PORTO BARREIRO",0,0,2,42,0,44,"2016"
"37724","412020 PORTO RICO",0,0,1,35,0,36,"2016"
"37725","412030 PORTO VITORIA",0,0,0,44,0,44,"2016"
"37726","412033 PRADO FERREIRA",0,2,1,55,0,58,"2016"
"37727","412035 PRANCHITA",0,0,0,65,0,65,"2016"
"37728","412040 PRESIDENTE CASTELO BRANCO",0,0,1,63,0,64,"2016"
"37729","412050 PRIMEIRO DE MAIO",0,0,3,109,0,112,"2016"
"37730","412060 PRUDENTOPOLIS",2,3,6,668,2,681,"2016"
"37731","412065 QUARTO CENTENARIO",0,0,0,47,0,47,"2016"
"37732","412070 QUATIGUA",1,1,1,88,0,91,"2016"
"37733","412080 QUATRO BARRAS",2,2,2,326,0,332,"2016"
"37734","412085 QUATRO PONTES",0,0,2,49,0,51,"2016"
"37735","412090 QUEDAS DO IGUACU",0,1,13,450,0,464,"2016"
"37736","412100 QUERENCIA DO NORTE",0,0,1,179,0,180,"2016"
"37737","412110 QUINTA DO SOL",0,0,2,54,0,56,"2016"
"37738","412120 QUITANDINHA",1,1,8,220,2,232,"2016"
"37739","412125 RAMILANDIA",0,0,0,64,0,64,"2016"
"37740","412130 RANCHO ALEGRE",1,1,1,40,0,43,"2016"
"37741","412135 RANCHO ALEGRE D'OESTE",1,0,0,16,0,17,"2016"
"37742","412140 REALEZA",0,0,1,239,0,240,"2016"
"37743","412150 REBOUCAS",2,0,1,212,0,215,"2016"
"37744","412160 RENASCENCA",1,2,1,99,0,103,"2016"
"37745","412170 RESERVA",0,2,5,390,1,398,"2016"
"37746","412175 RESERVA DO IGUACU",0,0,0,106,0,106,"2016"
"37747","412180 RIBEIRAO CLARO",0,1,0,149,1,151,"2016"
"37748","412190 RIBEIRAO DO PINHAL",0,1,4,194,0,199,"2016"
"37749","412200 RIO AZUL",1,1,0,187,0,189,"2016"
"37750","412210 RIO BOM",0,0,1,34,0,35,"2016"
"37751","412215 RIO BONITO DO IGUACU",0,0,1,256,2,259,"2016"
"37752","412217 RIO BRANCO DO IVAI",0,1,1,65,0,67,"2016"
"37753","412220 RIO BRANCO DO SUL",0,3,10,585,8,606,"2016"
"37754","412230 RIO NEGRO",0,0,2,363,1,366,"2016"
"37755","412240 ROLANDIA",2,5,10,866,0,883,"2016"
"37756","412250 RONCADOR",0,0,1,161,0,162,"2016"
"37757","412260 RONDON",0,0,0,117,0,117,"2016"
"37758","412265 ROSARIO DO IVAI",0,0,2,58,0,60,"2016"
"37759","412270 SABAUDIA",1,2,1,111,0,115,"2016"
"37760","412280 SALGADO FILHO",0,0,0,60,0,60,"2016"
"37761","412290 SALTO DO ITARARE",0,0,0,51,0,51,"2016"
"37762","412300 SALTO DO LONTRA",0,0,1,165,1,167,"2016"
"37763","412310 SANTA AMELIA",0,0,0,43,1,44,"2016"
"37764","412320 SANTA CECILIA DO PAVAO",0,1,1,42,0,44,"2016"
"37765","412330 SANTA CRUZ DE MONTE CASTELO",0,0,0,107,0,107,"2016"
"37766","412340 SANTA FE",0,0,3,134,0,137,"2016"
"37767","412350 SANTA HELENA",1,1,5,318,3,328,"2016"
"37768","412360 SANTA INES",0,0,2,23,0,25,"2016"
"37769","412370 SANTA ISABEL DO IVAI",0,0,3,118,0,121,"2016"
"37770","412380 SANTA IZABEL DO OESTE",0,0,0,165,1,166,"2016"
"37771","412382 SANTA LUCIA",1,0,2,50,0,53,"2016"
"37772","412385 SANTA MARIA DO OESTE",1,0,0,137,0,138,"2016"
"37773","412390 SANTA MARIANA",0,0,0,132,0,132,"2016"
"37774","412395 SANTA MONICA",0,0,3,52,0,55,"2016"
"37775","412400 SANTANA DO ITARARE",1,0,1,56,0,58,"2016"
"37776","412402 SANTA TEREZA DO OESTE",0,0,4,188,0,192,"2016"
"37777","412405 SANTA TEREZINHA DE ITAIPU",0,1,4,292,5,302,"2016"
"37778","412410 SANTO ANTONIO DA PLATINA",3,3,13,653,1,673,"2016"
"37779","412420 SANTO ANTONIO DO CAIUA",1,0,0,30,0,31,"2016"
"37780","412430 SANTO ANTONIO DO PARAISO",0,0,1,20,0,21,"2016"
"37781","412440 SANTO ANTONIO DO SUDOESTE",0,1,0,270,0,271,"2016"
"37782","412450 SANTO INACIO",1,0,2,93,0,96,"2016"
"37783","412460 SAO CARLOS DO IVAI",0,1,2,87,1,91,"2016"
"37784","412470 SAO JERONIMO DA SERRA",0,0,1,129,0,130,"2016"
"37785","412480 SAO JOAO",1,0,2,139,0,142,"2016"
"37786","412490 SAO JOAO DO CAIUA",0,0,2,87,0,89,"2016"
"37787","412500 SAO JOAO DO IVAI",0,1,1,139,0,141,"2016"
"37788","412510 SAO JOAO DO TRIUNFO",0,0,0,177,0,177,"2016"
"37789","412520 SAO JORGE D'OESTE",0,1,0,130,0,131,"2016"
"37790","412530 SAO JORGE DO IVAI",0,1,0,49,0,50,"2016"
"37791","412535 SAO JORGE DO PATROCINIO",0,0,0,77,0,77,"2016"
"37792","412540 SAO JOSE DA BOA VISTA",0,0,0,66,0,66,"2016"
"37793","412545 SAO JOSE DAS PALMEIRAS",0,0,1,51,0,52,"2016"
"37794","412550 SAO JOSE DOS PINHAIS",48,32,85,4695,15,4875,"2016"
"37795","412555 SAO MANOEL DO PARANA",0,0,0,25,1,26,"2016"
"37796","412560 SAO MATEUS DO SUL",2,2,6,562,3,575,"2016"
"37797","412570 SAO MIGUEL DO IGUACU",1,1,5,428,2,437,"2016"
"37798","412575 SAO PEDRO DO IGUACU",0,0,1,77,0,78,"2016"
"37799","412580 SAO PEDRO DO IVAI",0,0,1,114,0,115,"2016"
"37800","412590 SAO PEDRO DO PARANA",0,0,0,29,0,29,"2016"
"37801","412600 SAO SEBASTIAO DA AMOREIRA",0,1,2,110,0,113,"2016"
"37802","412610 SAO TOME",0,0,1,80,0,81,"2016"
"37803","412620 SAPOPEMA",0,0,0,84,0,84,"2016"
"37804","412625 SARANDI",2,7,26,1485,0,1520,"2016"
"37805","412627 SAUDADE DO IGUACU",0,2,4,98,0,104,"2016"
"37806","412630 SENGES",0,6,5,238,1,250,"2016"
"37807","412635 SERRANOPOLIS DO IGUACU",0,0,0,73,0,73,"2016"
"37808","412640 SERTANEJA",0,1,2,61,0,64,"2016"
"37809","412650 SERTANOPOLIS",0,1,4,172,0,177,"2016"
"37810","412660 SIQUEIRA CAMPOS",1,0,4,277,5,287,"2016"
"37811","412665 SULINA",0,1,2,32,0,35,"2016"
"37812","412667 TAMARANA",1,0,1,192,0,194,"2016"
"37813","412670 TAMBOARA",0,0,0,58,0,58,"2016"
"37814","412680 TAPEJARA",0,1,1,192,0,194,"2016"
"37815","412690 TAPIRA",0,1,1,55,0,57,"2016"
"37816","412700 TEIXEIRA SOARES",1,0,3,117,0,121,"2016"
"37817","412710 TELEMACO BORBA",0,4,12,1178,1,1195,"2016"
"37818","412720 TERRA BOA",1,2,9,228,0,240,"2016"
"37819","412730 TERRA RICA",1,0,2,213,0,216,"2016"
"37820","412740 TERRA ROXA",0,1,4,218,0,223,"2016"
"37821","412750 TIBAGI",1,2,1,294,1,299,"2016"
"37822","412760 TIJUCAS DO SUL",1,0,8,203,2,214,"2016"
"37823","412770 TOLEDO",6,5,41,2000,4,2056,"2016"
"37824","412780 TOMAZINA",0,1,1,76,0,78,"2016"
"37825","412785 TRES BARRAS DO PARANA",0,0,1,166,1,168,"2016"
"37826","412788 TUNAS DO PARANA",0,0,2,128,2,132,"2016"
"37827","412790 TUNEIRAS DO OESTE",0,0,0,98,0,98,"2016"
"37828","412795 TUPASSI",0,0,0,81,0,81,"2016"
"37829","412796 TURVO",0,0,8,219,0,227,"2016"
"37830","412800 UBIRATA",2,0,1,282,0,285,"2016"
"37831","412810 UMUARAMA",1,6,21,1443,0,1471,"2016"
"37832","412820 UNIAO DA VITORIA",0,1,7,749,1,758,"2016"
"37833","412830 UNIFLOR",0,0,0,24,0,24,"2016"
"37834","412840 URAI",0,0,3,113,0,116,"2016"
"37835","412850 WENCESLAU BRAZ",0,2,0,246,0,248,"2016"
"37836","412853 VENTANIA",0,0,0,131,2,133,"2016"
"37837","412855 VERA CRUZ DO OESTE",1,1,2,103,0,107,"2016"
"37838","412860 VERE",0,0,2,99,1,102,"2016"
"37839","412862 ALTO PARAISO",0,0,0,50,0,50,"2016"
"37840","412863 DOUTOR ULYSSES",0,1,0,64,1,66,"2016"
"37841","412865 VIRMOND",0,0,0,60,0,60,"2016"
"37842","412870 VITORINO",0,0,3,125,0,128,"2016"
"37843","412880 XAMBRE",0,0,2,63,0,65,"2016"
"37844","MUNICIPIO IGNORADO - SC",0,0,0,1,0,1,"2016"
"37845","420005 ABDON BATISTA",0,0,0,27,0,27,"2016"
"37846","420010 ABELARDO LUZ",0,1,10,302,1,314,"2016"
"37847","420020 AGROLANDIA",0,1,2,135,0,138,"2016"
"37848","420030 AGRONOMICA",0,0,0,48,0,48,"2016"
"37849","420040 AGUA DOCE",1,0,0,73,0,74,"2016"
"37850","420050 AGUAS DE CHAPECO",1,0,1,84,0,86,"2016"
"37851","420055 AGUAS FRIAS",0,0,0,22,1,23,"2016"
"37852","420060 AGUAS MORNAS",0,2,2,73,0,77,"2016"
"37853","420070 ALFREDO WAGNER",0,0,2,108,0,110,"2016"
"37854","420075 ALTO BELA VISTA",0,0,0,21,0,21,"2016"
"37855","420080 ANCHIETA",0,1,0,63,0,64,"2016"
"37856","420090 ANGELINA",0,0,0,53,0,53,"2016"
"37857","420100 ANITA GARIBALDI",1,1,5,95,0,102,"2016"
"37858","420110 ANITAPOLIS",0,0,2,16,0,18,"2016"
"37859","420120 ANTONIO CARLOS",0,0,0,128,0,128,"2016"
"37860","420125 APIUNA",1,0,1,113,1,116,"2016"
"37861","420127 ARABUTA",0,0,1,45,0,46,"2016"
"37862","420130 ARAQUARI",0,1,16,529,3,549,"2016"
"37863","420140 ARARANGUA",1,4,8,881,1,895,"2016"
"37864","420150 ARMAZEM",0,0,3,91,0,94,"2016"
"37865","420160 ARROIO TRINTA",0,0,0,40,0,40,"2016"
"37866","420165 ARVOREDO",0,0,1,13,0,14,"2016"
"37867","420170 ASCURRA",0,0,1,101,0,102,"2016"
"37868","420180 ATALANTA",0,0,0,28,0,28,"2016"
"37869","420190 AURORA",0,0,2,61,0,63,"2016"
"37870","420195 BALNEARIO ARROIO DO SILVA",1,0,1,141,0,143,"2016"
"37871","420200 BALNEARIO CAMBORIU",1,3,34,1560,3,1601,"2016"
"37872","420205 BALNEARIO BARRA DO SUL",0,0,2,134,1,137,"2016"
"37873","420207 BALNEARIO GAIVOTA",0,1,3,135,0,139,"2016"
"37874","420208 BANDEIRANTE",0,0,1,39,0,40,"2016"
"37875","420209 BARRA BONITA",0,0,0,14,0,14,"2016"
"37876","420210 BARRA VELHA",2,1,5,499,3,510,"2016"
"37877","420213 BELA VISTA DO TOLDO",0,0,1,52,0,53,"2016"
"37878","420215 BELMONTE",0,0,0,34,0,34,"2016"
"37879","420220 BENEDITO NOVO",0,0,0,119,0,119,"2016"
"37880","420230 BIGUACU",1,3,18,924,6,952,"2016"
"37881","420240 BLUMENAU",5,14,54,4328,0,4401,"2016"
"37882","420243 BOCAINA DO SUL",0,0,3,36,0,39,"2016"
"37883","420245 BOMBINHAS",0,0,6,279,0,285,"2016"
"37884","420250 BOM JARDIM DA SERRA",1,0,0,47,0,48,"2016"
"37885","420253 BOM JESUS",0,0,0,34,0,34,"2016"
"37886","420257 BOM JESUS DO OESTE",0,0,0,21,0,21,"2016"
"37887","420260 BOM RETIRO",1,2,8,120,0,131,"2016"
"37888","420270 BOTUVERA",0,0,0,59,0,59,"2016"
"37889","420280 BRACO DO NORTE",1,1,2,465,0,469,"2016"
"37890","420285 BRACO DO TROMBUDO",0,0,1,44,0,45,"2016"
"37891","420287 BRUNOPOLIS",0,0,0,31,1,32,"2016"
"37892","420290 BRUSQUE",1,6,13,1710,1,1731,"2016"
"37893","420300 CACADOR",3,5,28,1178,2,1216,"2016"
"37894","420310 CAIBI",0,0,0,62,0,62,"2016"
"37895","420315 CALMON",1,0,2,55,0,58,"2016"
"37896","420320 CAMBORIU",4,7,30,1256,0,1297,"2016"
"37897","420325 CAPAO ALTO",0,0,1,26,0,27,"2016"
"37898","420330 CAMPO ALEGRE",0,0,2,145,0,147,"2016"
"37899","420340 CAMPO BELO DO SUL",0,0,3,86,0,89,"2016"
"37900","420350 CAMPO ERE",0,3,2,153,0,158,"2016"
"37901","420360 CAMPOS NOVOS",0,1,2,547,0,550,"2016"
"37902","420370 CANELINHA",1,0,5,115,0,121,"2016"
"37903","420380 CANOINHAS",3,4,11,827,1,846,"2016"
"37904","420390 CAPINZAL",0,1,2,315,0,318,"2016"
"37905","420395 CAPIVARI DE BAIXO",1,1,2,334,0,338,"2016"
"37906","420400 CATANDUVAS",0,1,2,140,0,143,"2016"
"37907","420410 CAXAMBU DO SUL",0,0,2,52,1,55,"2016"
"37908","420415 CELSO RAMOS",0,0,0,35,0,35,"2016"
"37909","420417 CERRO NEGRO",0,0,1,29,0,30,"2016"
"37910","420419 CHAPADAO DO LAGEADO",0,0,3,46,0,49,"2016"
"37911","420420 CHAPECO",4,17,57,3231,5,3314,"2016"
"37912","420425 COCAL DO SUL",1,0,1,193,0,195,"2016"
"37913","420430 CONCORDIA",2,0,23,1010,0,1035,"2016"
"37914","420435 CORDILHEIRA ALTA",0,0,0,54,0,54,"2016"
"37915","420440 CORONEL FREITAS",1,0,3,110,0,114,"2016"
"37916","420445 CORONEL MARTINS",0,0,0,30,0,30,"2016"
"37917","420450 CORUPA",0,0,1,211,0,212,"2016"
"37918","420455 CORREIA PINTO",1,3,10,200,0,214,"2016"
"37919","420460 CRICIUMA",6,7,24,2798,6,2841,"2016"
"37920","420470 CUNHA PORA",0,0,5,126,0,131,"2016"
"37921","420475 CUNHATAI",0,1,0,17,0,18,"2016"
"37922","420480 CURITIBANOS",2,2,6,646,3,659,"2016"
"37923","420490 DESCANSO",0,0,0,81,0,81,"2016"
"37924","420500 DIONISIO CERQUEIRA",0,2,1,237,0,240,"2016"
"37925","420510 DONA EMMA",0,0,1,50,1,52,"2016"
"37926","420515 DOUTOR PEDRINHO",0,0,1,31,0,32,"2016"
"37927","420517 ENTRE RIOS",0,0,1,49,0,50,"2016"
"37928","420519 ERMO",0,0,0,38,1,39,"2016"
"37929","420520 ERVAL VELHO",0,0,0,48,0,48,"2016"
"37930","420530 FAXINAL DOS GUEDES",0,0,1,145,0,146,"2016"
"37931","420535 FLOR DO SERTAO",0,0,0,22,0,22,"2016"
"37932","420540 FLORIANOPOLIS",15,19,85,6085,31,6235,"2016"
"37933","420543 FORMOSA DO SUL",0,0,1,23,0,24,"2016"
"37934","420545 FORQUILHINHA",1,2,2,402,2,409,"2016"
"37935","420550 FRAIBURGO",2,1,5,562,0,570,"2016"
"37936","420555 FREI ROGERIO",0,0,0,26,0,26,"2016"
"37937","420560 GALVAO",0,0,0,41,0,41,"2016"
"37938","420570 GAROPABA",1,1,4,273,1,280,"2016"
"37939","420580 GARUVA",0,1,6,254,2,263,"2016"
"37940","420590 GASPAR",1,4,15,809,0,829,"2016"
"37941","420600 GOVERNADOR CELSO RAMOS",2,0,7,164,1,174,"2016"
"37942","420610 GRAO PARA",1,0,2,70,0,73,"2016"
"37943","420620 GRAVATAL",0,1,1,141,0,143,"2016"
"37944","420630 GUABIRUBA",0,0,2,283,0,285,"2016"
"37945","420640 GUARACIABA",0,0,3,82,0,85,"2016"
"37946","420650 GUARAMIRIM",2,0,12,558,0,572,"2016"
"37947","420660 GUARUJA DO SUL",0,1,0,56,0,57,"2016"
"37948","420665 GUATAMBU",0,1,2,94,0,97,"2016"
"37949","420670 HERVAL D'OESTE",0,0,2,307,0,309,"2016"
"37950","420675 IBIAM",0,0,0,23,0,23,"2016"
"37951","420680 IBICARE",0,0,0,37,0,37,"2016"
"37952","420690 IBIRAMA",0,1,3,252,0,256,"2016"
"37953","420700 ICARA",2,1,4,762,1,770,"2016"
"37954","420710 ILHOTA",1,0,5,174,0,180,"2016"
"37955","420720 IMARUI",1,0,1,108,0,110,"2016"
"37956","420730 IMBITUBA",1,0,11,627,1,640,"2016"
"37957","420740 IMBUIA",0,0,1,74,0,75,"2016"
"37958","420750 INDAIAL",1,0,6,856,1,864,"2016"
"37959","420757 IOMERE",0,0,1,27,0,28,"2016"
"37960","420760 IPIRA",0,0,0,51,0,51,"2016"
"37961","420765 IPORA DO OESTE",0,0,3,87,0,90,"2016"
"37962","420768 IPUACU",0,0,3,160,2,165,"2016"
"37963","420770 IPUMIRIM",0,1,1,70,0,72,"2016"
"37964","420775 IRACEMINHA",0,0,2,41,0,43,"2016"
"37965","420780 IRANI",0,0,0,98,0,98,"2016"
"37966","420785 IRATI",0,0,0,22,0,22,"2016"
"37967","420790 IRINEOPOLIS",0,0,2,114,0,116,"2016"
"37968","420800 ITA",0,0,2,58,0,60,"2016"
"37969","420810 ITAIOPOLIS",0,1,2,307,2,312,"2016"
"37970","420820 ITAJAI",20,12,69,3358,6,3465,"2016"
"37971","420830 ITAPEMA",1,5,16,805,1,828,"2016"
"37972","420840 ITAPIRANGA",2,3,3,200,0,208,"2016"
"37973","420845 ITAPOA",0,0,7,246,2,255,"2016"
"37974","420850 ITUPORANGA",1,0,8,364,0,373,"2016"
"37975","420860 JABORA",0,0,0,48,0,48,"2016"
"37976","420870 JACINTO MACHADO",1,1,1,126,0,129,"2016"
"37977","420880 JAGUARUNA",0,0,1,241,0,242,"2016"
"37978","420890 JARAGUA DO SUL",7,9,39,2256,1,2312,"2016"
"37979","420895 JARDINOPOLIS",0,0,0,14,0,14,"2016"
"37980","420900 JOACABA",2,2,0,373,2,379,"2016"
"37981","420910 JOINVILLE",6,33,151,7823,17,8030,"2016"
"37982","420915 JOSE BOITEUX",0,0,0,103,3,106,"2016"
"37983","420917 JUPIA",0,0,0,13,0,13,"2016"
"37984","420920 LACERDOPOLIS",0,0,1,25,0,26,"2016"
"37985","420930 LAGES",9,29,138,2284,16,2476,"2016"
"37986","420940 LAGUNA",1,3,2,415,0,421,"2016"
"37987","420945 LAJEADO GRANDE",0,0,0,20,0,20,"2016"
"37988","420950 LAURENTINO",0,0,1,96,0,97,"2016"
"37989","420960 LAURO MULLER",0,2,3,212,0,217,"2016"
"37990","420970 LEBON REGIS",0,3,3,159,1,166,"2016"
"37991","420980 LEOBERTO LEAL",0,0,4,35,0,39,"2016"
"37992","420985 LINDOIA DO SUL",0,0,1,47,0,48,"2016"
"37993","420990 LONTRAS",0,0,1,158,0,159,"2016"
"37994","421000 LUIZ ALVES",0,0,2,166,0,168,"2016"
"37995","421003 LUZERNA",0,0,0,63,0,63,"2016"
"37996","421005 MACIEIRA",0,0,0,25,1,26,"2016"
"37997","421010 MAFRA",4,1,7,753,0,765,"2016"
"37998","421020 MAJOR GERCINO",0,1,0,24,0,25,"2016"
"37999","421030 MAJOR VIEIRA",0,1,0,120,0,121,"2016"
"38000","421040 MARACAJA",0,0,2,101,0,103,"2016"
"38001","421050 MARAVILHA",0,2,1,359,0,362,"2016"
"38002","421055 MAREMA",0,0,0,18,0,18,"2016"
"38003","421060 MASSARANDUBA",0,0,7,195,0,202,"2016"
"38004","421070 MATOS COSTA",0,0,0,36,0,36,"2016"
"38005","421080 MELEIRO",0,0,2,83,0,85,"2016"
"38006","421085 MIRIM DOCE",0,1,0,30,2,33,"2016"
"38007","421090 MODELO",1,0,1,35,0,37,"2016"
"38008","421100 MONDAI",1,1,2,122,0,126,"2016"
"38009","421105 MONTE CARLO",0,0,4,157,0,161,"2016"
"38010","421110 MONTE CASTELO",1,1,3,125,1,131,"2016"
"38011","421120 MORRO DA FUMACA",2,1,0,241,0,244,"2016"
"38012","421125 MORRO GRANDE",0,0,0,27,0,27,"2016"
"38013","421130 NAVEGANTES",1,3,16,1427,1,1448,"2016"
"38014","421140 NOVA ERECHIM",0,0,0,51,0,51,"2016"
"38015","421145 NOVA ITABERABA",0,0,0,31,0,31,"2016"
"38016","421150 NOVA TRENTO",2,0,2,138,0,142,"2016"
"38017","421160 NOVA VENEZA",1,0,3,163,1,168,"2016"
"38018","421165 NOVO HORIZONTE",0,0,1,23,0,24,"2016"
"38019","421170 ORLEANS",1,0,4,283,1,289,"2016"
"38020","421175 OTACILIO COSTA",0,4,15,276,1,296,"2016"
"38021","421180 OURO",0,0,2,73,1,76,"2016"
"38022","421185 OURO VERDE",0,0,0,17,0,17,"2016"
"38023","421187 PAIAL",0,1,2,17,0,20,"2016"
"38024","421189 PAINEL",0,0,2,28,0,30,"2016"
"38025","421190 PALHOCA",4,11,29,2513,11,2568,"2016"
"38026","421200 PALMA SOLA",0,0,4,124,0,128,"2016"
"38027","421205 PALMEIRA",0,0,0,35,0,35,"2016"
"38028","421210 PALMITOS",1,2,4,189,0,196,"2016"
"38029","421220 PAPANDUVA",0,1,4,223,0,228,"2016"
"38030","421223 PARAISO",0,0,1,57,0,58,"2016"
"38031","421225 PASSO DE TORRES",0,0,2,79,0,81,"2016"
"38032","421227 PASSOS MAIA",0,0,2,51,1,54,"2016"
"38033","421230 PAULO LOPES",0,0,1,80,0,81,"2016"
"38034","421240 PEDRAS GRANDES",0,0,0,41,0,41,"2016"
"38035","421250 PENHA",3,2,6,364,0,375,"2016"
"38036","421260 PERITIBA",0,0,0,13,0,13,"2016"
"38037","421265 PESCARIA BRAVA",0,0,3,86,0,89,"2016"
"38038","421270 PETROLANDIA",0,0,1,62,0,63,"2016"
"38039","421280 BALNEARIO PICARRAS",6,0,7,340,1,354,"2016"
"38040","421290 PINHALZINHO",2,1,2,298,0,303,"2016"
"38041","421300 PINHEIRO PRETO",0,0,1,38,0,39,"2016"
"38042","421310 PIRATUBA",0,0,1,54,0,55,"2016"
"38043","421315 PLANALTO ALEGRE",0,0,0,20,0,20,"2016"
"38044","421320 POMERODE",1,1,11,379,0,392,"2016"
"38045","421330 PONTE ALTA",0,0,1,54,1,56,"2016"
"38046","421335 PONTE ALTA DO NORTE",0,0,0,66,0,66,"2016"
"38047","421340 PONTE SERRADA",0,1,4,144,0,149,"2016"
"38048","421350 PORTO BELO",1,2,3,268,0,274,"2016"
"38049","421360 PORTO UNIAO",0,0,5,389,0,394,"2016"
"38050","421370 POUSO REDONDO",0,1,1,231,3,236,"2016"
"38051","421380 PRAIA GRANDE",1,0,0,118,0,119,"2016"
"38052","421390 PRESIDENTE CASTELLO BRANCO",0,0,0,14,0,14,"2016"
"38053","421400 PRESIDENTE GETULIO",0,0,4,227,1,232,"2016"
"38054","421410 PRESIDENTE NEREU",0,0,0,34,1,35,"2016"
"38055","421415 PRINCESA",0,0,0,33,0,33,"2016"
"38056","421420 QUILOMBO",0,1,1,135,0,137,"2016"
"38057","421430 RANCHO QUEIMADO",0,0,0,30,0,30,"2016"
"38058","421440 RIO DAS ANTAS",0,0,0,71,0,71,"2016"
"38059","421450 RIO DO CAMPO",0,2,2,77,0,81,"2016"
"38060","421460 RIO DO OESTE",0,0,3,80,1,84,"2016"
"38061","421470 RIO DOS CEDROS",0,0,2,102,0,104,"2016"
"38062","421480 RIO DO SUL",1,2,20,902,1,926,"2016"
"38063","421490 RIO FORTUNA",1,0,0,51,0,52,"2016"
"38064","421500 RIO NEGRINHO",1,1,10,603,0,615,"2016"
"38065","421505 RIO RUFINO",0,0,4,31,0,35,"2016"
"38066","421507 RIQUEZA",0,0,0,41,0,41,"2016"
"38067","421510 RODEIO",0,0,0,120,0,120,"2016"
"38068","421520 ROMELANDIA",0,0,0,46,0,46,"2016"
"38069","421530 SALETE",0,0,5,92,1,98,"2016"
"38070","421535 SALTINHO",0,0,0,40,0,40,"2016"
"38071","421540 SALTO VELOSO",0,0,0,56,0,56,"2016"
"38072","421545 SANGAO",1,1,1,199,1,203,"2016"
"38073","421550 SANTA CECILIA",1,2,5,279,0,287,"2016"
"38074","421555 SANTA HELENA",0,0,1,18,0,19,"2016"
"38075","421560 SANTA ROSA DE LIMA",0,0,1,27,0,28,"2016"
"38076","421565 SANTA ROSA DO SUL",0,0,1,121,0,122,"2016"
"38077","421567 SANTA TEREZINHA",0,0,3,90,0,93,"2016"
"38078","421568 SANTA TEREZINHA DO PROGRESSO",0,0,0,34,0,34,"2016"
"38079","421569 SANTIAGO DO SUL",0,0,0,19,0,19,"2016"
"38080","421570 SANTO AMARO DA IMPERATRIZ",1,0,2,298,1,302,"2016"
"38081","421575 SAO BERNARDINO",0,1,0,38,0,39,"2016"
"38082","421580 SAO BENTO DO SUL",2,2,10,1085,0,1099,"2016"
"38083","421590 SAO BONIFACIO",0,0,1,28,0,29,"2016"
"38084","421600 SAO CARLOS",0,1,1,118,0,120,"2016"
"38085","421605 SAO CRISTOVAO DO SUL",0,0,1,77,0,78,"2016"
"38086","421610 SAO DOMINGOS",0,0,2,102,0,104,"2016"
"38087","421620 SAO FRANCISCO DO SUL",1,0,6,628,5,640,"2016"
"38088","421625 SAO JOAO DO OESTE",0,0,1,69,0,70,"2016"
"38089","421630 SAO JOAO BATISTA",2,0,1,447,0,450,"2016"
"38090","421635 SAO JOAO DO ITAPERIU",0,0,0,56,1,57,"2016"
"38091","421640 SAO JOAO DO SUL",0,0,1,86,0,87,"2016"
"38092","421650 SAO JOAQUIM",1,4,16,334,0,355,"2016"
"38093","421660 SAO JOSE",15,4,40,3137,6,3202,"2016"
"38094","421670 SAO JOSE DO CEDRO",0,0,2,178,0,180,"2016"
"38095","421680 SAO JOSE DO CERRITO",0,0,5,95,1,101,"2016"
"38096","421690 SAO LOURENCO DO OESTE",0,0,2,299,0,301,"2016"
"38097","421700 SAO LUDGERO",0,0,3,191,0,194,"2016"
"38098","421710 SAO MARTINHO",0,0,0,36,0,36,"2016"
"38099","421715 SAO MIGUEL DA BOA VISTA",0,0,0,18,0,18,"2016"
"38100","421720 SAO MIGUEL DO OESTE",0,2,3,543,1,549,"2016"
"38101","421725 SAO PEDRO DE ALCANTARA",0,0,0,36,0,36,"2016"
"38102","421730 SAUDADES",0,0,0,127,0,127,"2016"
"38103","421740 SCHROEDER",0,0,6,277,0,283,"2016"
"38104","421750 SEARA",1,0,4,208,0,213,"2016"
"38105","421755 SERRA ALTA",0,0,1,34,0,35,"2016"
"38106","421760 SIDEROPOLIS",0,0,0,146,0,146,"2016"
"38107","421770 SOMBRIO",2,2,6,430,0,440,"2016"
"38108","421775 SUL BRASIL",0,0,1,38,0,39,"2016"
"38109","421780 TAIO",0,0,5,222,2,229,"2016"
"38110","421790 TANGARA",1,1,3,88,0,93,"2016"
"38111","421795 TIGRINHOS",0,0,2,24,0,26,"2016"
"38112","421800 TIJUCAS",3,2,8,551,5,569,"2016"
"38113","421810 TIMBE DO SUL",0,0,1,59,1,61,"2016"
"38114","421820 TIMBO",0,0,3,500,0,503,"2016"
"38115","421825 TIMBO GRANDE",1,0,2,94,0,97,"2016"
"38116","421830 TRES BARRAS",1,3,8,283,0,295,"2016"
"38117","421835 TREVISO",0,0,0,34,1,35,"2016"
"38118","421840 TREZE DE MAIO",1,1,2,79,0,83,"2016"
"38119","421850 TREZE TILIAS",0,0,2,127,0,129,"2016"
"38120","421860 TROMBUDO CENTRAL",1,0,1,88,0,90,"2016"
"38121","421870 TUBARAO",1,6,9,1324,0,1340,"2016"
"38122","421875 TUNAPOLIS",0,0,3,43,0,46,"2016"
"38123","421880 TURVO",0,3,0,164,0,167,"2016"
"38124","421885 UNIAO DO OESTE",0,0,2,25,0,27,"2016"
"38125","421890 URUBICI",0,0,6,129,1,136,"2016"
"38126","421895 URUPEMA",0,1,1,38,1,41,"2016"
"38127","421900 URUSSANGA",0,0,2,185,2,189,"2016"
"38128","421910 VARGEAO",0,0,0,45,0,45,"2016"
"38129","421915 VARGEM",0,0,0,28,0,28,"2016"
"38130","421917 VARGEM BONITA",0,0,1,77,0,78,"2016"
"38131","421920 VIDAL RAMOS",0,0,3,80,0,83,"2016"
"38132","421930 VIDEIRA",1,0,6,748,0,755,"2016"
"38133","421935 VITOR MEIRELES",0,0,0,71,1,72,"2016"
"38134","421940 WITMARSUM",0,0,0,43,0,43,"2016"
"38135","421950 XANXERE",0,1,7,672,1,681,"2016"
"38136","421960 XAVANTINA",0,0,0,19,0,19,"2016"
"38137","421970 XAXIM",1,0,8,442,1,452,"2016"
"38138","421985 ZORTEA",0,0,1,44,0,45,"2016"
"38139","422000 BALNEARIO RINCAO",0,1,0,188,1,190,"2016"
"38140","430003 ACEGUA",0,1,0,48,0,49,"2016"
"38141","430005 AGUA SANTA",0,0,2,41,0,43,"2016"
"38142","430010 AGUDO",2,0,2,161,0,165,"2016"
"38143","430020 AJURICABA",0,0,3,75,0,78,"2016"
"38144","430030 ALECRIM",0,0,2,55,0,57,"2016"
"38145","430040 ALEGRETE",1,2,11,843,1,858,"2016"
"38146","430045 ALEGRIA",0,0,0,38,0,38,"2016"
"38147","430047 ALMIRANTE TAMANDARE DO SUL",0,0,0,21,1,22,"2016"
"38148","430050 ALPESTRE",0,0,0,72,0,72,"2016"
"38149","430055 ALTO ALEGRE",0,0,0,15,0,15,"2016"
"38150","430057 ALTO FELIZ",0,0,0,32,0,32,"2016"
"38151","430060 ALVORADA",5,18,68,3227,12,3330,"2016"
"38152","430063 AMARAL FERRADOR",0,0,1,53,1,55,"2016"
"38153","430064 AMETISTA DO SUL",0,0,2,66,1,69,"2016"
"38154","430066 ANDRE DA ROCHA",0,0,1,10,0,11,"2016"
"38155","430070 ANTA GORDA",0,0,1,58,0,59,"2016"
"38156","430080 ANTONIO PRADO",0,0,3,134,0,137,"2016"
"38157","430085 ARAMBARE",0,0,1,41,0,42,"2016"
"38158","430087 ARARICA",1,0,0,94,0,95,"2016"
"38159","430090 ARATIBA",0,0,1,45,0,46,"2016"
"38160","430100 ARROIO DO MEIO",0,0,5,252,0,257,"2016"
"38161","430105 ARROIO DO SAL",0,0,5,108,0,113,"2016"
"38162","430107 ARROIO DO PADRE",0,0,2,17,0,19,"2016"
"38163","430110 ARROIO DOS RATOS",0,1,4,170,0,175,"2016"
"38164","430120 ARROIO DO TIGRE",1,0,2,134,1,138,"2016"
"38165","430130 ARROIO GRANDE",0,3,27,189,0,219,"2016"
"38166","430140 ARVOREZINHA",0,1,1,115,0,117,"2016"
"38167","430150 AUGUSTO PESTANA",1,1,1,68,0,71,"2016"
"38168","430155 AUREA",0,0,0,25,0,25,"2016"
"38169","430160 BAGE",6,1,28,1577,7,1619,"2016"
"38170","430163 BALNEARIO PINHAL",0,0,5,137,1,143,"2016"
"38171","430165 BARAO",0,0,1,51,0,52,"2016"
"38172","430170 BARAO DE COTEGIPE",0,1,1,102,0,104,"2016"
"38173","430175 BARAO DO TRIUNFO",0,0,0,61,0,61,"2016"
"38174","430180 BARRACAO",0,1,0,38,0,39,"2016"
"38175","430185 BARRA DO GUARITA",0,1,0,42,1,44,"2016"
"38176","430187 BARRA DO QUARAI",0,0,0,19,29,48,"2016"
"38177","430190 BARRA DO RIBEIRO",2,0,1,149,8,160,"2016"
"38178","430192 BARRA DO RIO AZUL",0,0,1,5,0,6,"2016"
"38179","430195 BARRA FUNDA",0,0,1,33,0,34,"2016"
"38180","430200 BARROS CASSAL",0,0,3,95,1,99,"2016"
"38181","430205 BENJAMIN CONSTANT DO SUL",0,0,1,39,0,40,"2016"
"38182","430210 BENTO GONCALVES",2,5,23,1452,1,1483,"2016"
"38183","430215 BOA VISTA DAS MISSOES",0,0,0,24,0,24,"2016"
"38184","430220 BOA VISTA DO BURICA",0,0,2,63,0,65,"2016"
"38185","430222 BOA VISTA DO CADEADO",1,0,0,20,0,21,"2016"
"38186","430223 BOA VISTA DO INCRA",0,0,0,16,0,16,"2016"
"38187","430225 BOA VISTA DO SUL",0,0,1,20,0,21,"2016"
"38188","430230 BOM JESUS",0,0,0,151,9,160,"2016"
"38189","430235 BOM PRINCIPIO",0,0,2,164,0,166,"2016"
"38190","430237 BOM PROGRESSO",0,0,0,23,0,23,"2016"
"38191","430240 BOM RETIRO DO SUL",0,0,0,146,1,147,"2016"
"38192","430245 BOQUEIRAO DO LEAO",0,0,1,75,0,76,"2016"
"38193","430250 BOSSOROCA",0,1,0,60,0,61,"2016"
"38194","430258 BOZANO",0,0,1,26,0,27,"2016"
"38195","430260 BRAGA",0,0,0,34,0,34,"2016"
"38196","430265 BROCHIER",0,0,0,41,0,41,"2016"
"38197","430270 BUTIA",0,1,3,264,1,269,"2016"
"38198","430280 CACAPAVA DO SUL",0,0,6,376,0,382,"2016"
"38199","430290 CACEQUI",0,2,4,111,0,117,"2016"
"38200","430300 CACHOEIRA DO SUL",0,0,15,967,7,989,"2016"
"38201","430310 CACHOEIRINHA",4,6,28,1895,0,1933,"2016"
"38202","430320 CACIQUE DOBLE",0,0,0,46,0,46,"2016"
"38203","430330 CAIBATE",0,0,1,45,0,46,"2016"
"38204","430340 CAICARA",0,0,0,24,0,24,"2016"
"38205","430350 CAMAQUA",0,6,10,799,6,821,"2016"
"38206","430355 CAMARGO",0,0,0,26,0,26,"2016"
"38207","430360 CAMBARA DO SUL",0,1,2,61,0,64,"2016"
"38208","430367 CAMPESTRE DA SERRA",0,0,0,21,1,22,"2016"
"38209","430370 CAMPINA DAS MISSOES",0,0,3,55,0,58,"2016"
"38210","430380 CAMPINAS DO SUL",1,0,3,50,0,54,"2016"
"38211","430390 CAMPO BOM",2,2,5,842,0,851,"2016"
"38212","430400 CAMPO NOVO",1,0,0,77,0,78,"2016"
"38213","430410 CAMPOS BORGES",0,1,2,36,0,39,"2016"
"38214","430420 CANDELARIA",2,0,6,358,0,366,"2016"
"38215","430430 CANDIDO GODOI",0,0,0,47,0,47,"2016"
"38216","430435 CANDIOTA",0,1,2,126,1,130,"2016"
"38217","430440 CANELA",0,5,9,604,4,622,"2016"
"38218","430450 CANGUCU",2,4,7,506,3,522,"2016"
"38219","430460 CANOAS",10,29,80,5070,16,5205,"2016"
"38220","430461 CANUDOS DO VALE",0,0,0,4,0,4,"2016"
"38221","430462 CAPAO BONITO DO SUL",0,0,0,21,0,21,"2016"
"38222","430463 CAPAO DA CANOA",0,6,12,905,0,923,"2016"
"38223","430465 CAPAO DO CIPO",0,0,1,41,0,42,"2016"
"38224","430466 CAPAO DO LEAO",1,1,3,333,3,341,"2016"
"38225","430467 CAPIVARI DO SUL",1,0,0,46,0,47,"2016"
"38226","430468 CAPELA DE SANTANA",0,0,0,121,0,121,"2016"
"38227","430469 CAPITAO",1,2,1,45,0,49,"2016"
"38228","430470 CARAZINHO",0,7,19,801,2,829,"2016"
"38229","430471 CARAA",0,0,0,43,1,44,"2016"
"38230","430480 CARLOS BARBOSA",1,3,4,332,2,342,"2016"
"38231","430485 CARLOS GOMES",0,0,0,9,1,10,"2016"
"38232","430490 CASCA",0,2,1,89,0,92,"2016"
"38233","430495 CASEIROS",0,0,0,15,0,15,"2016"
"38234","430500 CATUIPE",0,1,0,84,1,86,"2016"
"38235","430510 CAXIAS DO SUL",13,27,112,5913,11,6076,"2016"
"38236","430511 CENTENARIO",0,0,0,15,0,15,"2016"
"38237","430512 CERRITO",0,0,2,36,1,39,"2016"
"38238","430513 CERRO BRANCO",0,0,0,23,0,23,"2016"
"38239","430515 CERRO GRANDE",0,1,0,22,0,23,"2016"
"38240","430517 CERRO GRANDE DO SUL",0,0,1,126,1,128,"2016"
"38241","430520 CERRO LARGO",0,0,0,141,0,141,"2016"
"38242","430530 CHAPADA",0,0,1,76,0,77,"2016"
"38243","430535 CHARQUEADAS",0,0,0,379,0,379,"2016"
"38244","430537 CHARRUA",0,0,0,15,0,15,"2016"
"38245","430540 CHIAPETTA",0,0,0,48,0,48,"2016"
"38246","430543 CHUI",1,0,0,37,0,38,"2016"
"38247","430544 CHUVISCA",0,0,1,49,0,50,"2016"
"38248","430545 CIDREIRA",1,0,2,172,1,176,"2016"
"38249","430550 CIRIACO",0,0,0,39,0,39,"2016"
"38250","430558 COLINAS",0,0,1,25,0,26,"2016"
"38251","430560 COLORADO",0,0,0,24,0,24,"2016"
"38252","430570 CONDOR",0,0,1,82,0,83,"2016"
"38253","430580 CONSTANTINA",1,1,2,109,0,113,"2016"
"38254","430583 COQUEIRO BAIXO",0,0,0,7,0,7,"2016"
"38255","430585 COQUEIROS DO SUL",0,0,0,21,0,21,"2016"
"38256","430587 CORONEL BARROS",0,0,0,27,0,27,"2016"
"38257","430590 CORONEL BICACO",0,0,0,90,0,90,"2016"
"38258","430593 CORONEL PILAR",0,0,0,5,0,5,"2016"
"38259","430595 COTIPORA",0,0,0,28,0,28,"2016"
"38260","430597 COXILHA",0,0,0,46,0,46,"2016"
"38261","430600 CRISSIUMAL",0,0,1,144,0,145,"2016"
"38262","430605 CRISTAL",1,2,1,87,0,91,"2016"
"38263","430607 CRISTAL DO SUL",0,0,1,23,0,24,"2016"
"38264","430610 CRUZ ALTA",1,4,9,835,2,851,"2016"
"38265","430613 CRUZALTENSE",0,0,0,13,0,13,"2016"
"38266","430620 CRUZEIRO DO SUL",0,0,1,142,0,143,"2016"
"38267","430630 DAVID CANABARRO",0,0,4,46,0,50,"2016"
"38268","430632 DERRUBADAS",0,0,0,26,0,26,"2016"
"38269","430635 DEZESSEIS DE NOVEMBRO",0,0,0,23,0,23,"2016"
"38270","430637 DILERMANDO DE AGUIAR",0,0,1,26,0,27,"2016"
"38271","430640 DOIS IRMAOS",1,1,7,396,0,405,"2016"
"38272","430642 DOIS IRMAOS DAS MISSOES",0,0,1,27,0,28,"2016"
"38273","430645 DOIS LAJEADOS",0,0,0,28,0,28,"2016"
"38274","430650 DOM FELICIANO",0,0,0,138,0,138,"2016"
"38275","430655 DOM PEDRO DE ALCANTARA",0,0,1,20,0,21,"2016"
"38276","430660 DOM PEDRITO",0,0,1,441,1,443,"2016"
"38277","430670 DONA FRANCISCA",0,0,0,38,0,38,"2016"
"38278","430673 DOUTOR MAURICIO CARDOSO",0,0,0,39,0,39,"2016"
"38279","430675 DOUTOR RICARDO",0,0,0,14,0,14,"2016"
"38280","430676 ELDORADO DO SUL",2,1,12,559,4,578,"2016"
"38281","430680 ENCANTADO",1,1,2,260,0,264,"2016"
"38282","430690 ENCRUZILHADA DO SUL",0,3,3,288,2,296,"2016"
"38283","430692 ENGENHO VELHO",1,0,0,23,1,25,"2016"
"38284","430693 ENTRE-IJUIS",0,0,0,100,0,100,"2016"
"38285","430695 ENTRE RIOS DO SUL",0,1,0,29,0,30,"2016"
"38286","430697 EREBANGO",2,0,0,39,0,41,"2016"
"38287","430700 ERECHIM",2,7,11,1300,1,1321,"2016"
"38288","430705 ERNESTINA",1,0,0,31,0,32,"2016"
"38289","430710 HERVAL",0,0,0,68,0,68,"2016"
"38290","430720 ERVAL GRANDE",0,0,4,47,0,51,"2016"
"38291","430730 ERVAL SECO",0,0,1,89,1,91,"2016"
"38292","430740 ESMERALDA",0,0,1,31,1,33,"2016"
"38293","430745 ESPERANCA DO SUL",0,0,0,27,0,27,"2016"
"38294","430750 ESPUMOSO",0,1,5,179,0,185,"2016"
"38295","430755 ESTACAO",0,1,3,63,0,67,"2016"
"38296","430760 ESTANCIA VELHA",2,1,16,632,0,651,"2016"
"38297","430770 ESTEIO",1,3,18,1062,2,1086,"2016"
"38298","430780 ESTRELA",0,1,6,406,0,413,"2016"
"38299","430781 ESTRELA VELHA",0,0,0,33,0,33,"2016"
"38300","430783 EUGENIO DE CASTRO",0,0,0,19,1,20,"2016"
"38301","430786 FAGUNDES VARELA",0,0,0,23,0,23,"2016"
"38302","430790 FARROUPILHA",2,5,9,793,2,811,"2016"
"38303","430800 FAXINAL DO SOTURNO",1,0,1,61,0,63,"2016"
"38304","430805 FAXINALZINHO",0,0,0,15,0,15,"2016"
"38305","430807 FAZENDA VILANOVA",0,0,0,61,0,61,"2016"
"38306","430810 FELIZ",0,0,3,148,0,151,"2016"
"38307","430820 FLORES DA CUNHA",0,2,5,342,1,350,"2016"
"38308","430825 FLORIANO PEIXOTO",0,0,0,17,0,17,"2016"
"38309","430830 FONTOURA XAVIER",1,1,2,93,0,97,"2016"
"38310","430840 FORMIGUEIRO",0,0,3,70,0,73,"2016"
"38311","430843 FORQUETINHA",0,1,0,21,0,22,"2016"
"38312","430845 FORTALEZA DOS VALOS",1,0,1,47,0,49,"2016"
"38313","430850 FREDERICO WESTPHALEN",2,2,2,389,2,397,"2016"
"38314","430860 GARIBALDI",1,3,9,403,1,417,"2016"
"38315","430865 GARRUCHOS",0,0,0,18,0,18,"2016"
"38316","430870 GAURAMA",0,0,0,52,0,52,"2016"
"38317","430880 GENERAL CAMARA",0,0,0,82,0,82,"2016"
"38318","430885 GENTIL",0,0,0,34,0,34,"2016"
"38319","430890 GETULIO VARGAS",2,0,2,205,1,210,"2016"
"38320","430900 GIRUA",0,1,1,197,1,200,"2016"
"38321","430905 GLORINHA",1,0,4,89,0,94,"2016"
"38322","430910 GRAMADO",1,1,10,540,1,553,"2016"
"38323","430912 GRAMADO DOS LOUREIROS",0,0,0,34,0,34,"2016"
"38324","430915 GRAMADO XAVIER",0,1,0,36,0,37,"2016"
"38325","430920 GRAVATAI",13,12,59,3498,8,3590,"2016"
"38326","430925 GUABIJU",0,0,0,13,0,13,"2016"
"38327","430930 GUAIBA",1,4,33,1319,7,1364,"2016"
"38328","430940 GUAPORE",0,1,4,307,0,312,"2016"
"38329","430950 GUARANI DAS MISSOES",0,0,0,89,0,89,"2016"
"38330","430955 HARMONIA",0,0,0,63,0,63,"2016"
"38331","430957 HERVEIRAS",0,1,0,38,0,39,"2016"
"38332","430960 HORIZONTINA",0,2,6,209,0,217,"2016"
"38333","430965 HULHA NEGRA",0,0,0,85,0,85,"2016"
"38334","430970 HUMAITA",0,0,0,41,0,41,"2016"
"38335","430975 IBARAMA",0,0,3,54,0,57,"2016"
"38336","430980 IBIACA",0,0,0,32,0,32,"2016"
"38337","430990 IBIRAIARAS",0,1,1,68,0,70,"2016"
"38338","430995 IBIRAPUITA",0,0,1,32,0,33,"2016"
"38339","431000 IBIRUBA",0,0,0,226,0,226,"2016"
"38340","431010 IGREJINHA",1,2,3,481,0,487,"2016"
"38341","431020 IJUI",1,7,18,1184,0,1210,"2016"
"38342","431030 ILOPOLIS",0,1,1,44,0,46,"2016"
"38343","431033 IMBE",2,0,5,268,1,276,"2016"
"38344","431036 IMIGRANTE",0,2,1,13,0,16,"2016"
"38345","431040 INDEPENDENCIA",0,0,0,70,0,70,"2016"
"38346","431041 INHACORA",0,0,0,24,1,25,"2016"
"38347","431043 IPE",0,0,1,56,1,58,"2016"
"38348","431046 IPIRANGA DO SUL",0,0,0,14,0,14,"2016"
"38349","431050 IRAI",0,0,3,92,0,95,"2016"
"38350","431053 ITAARA",0,0,1,51,0,52,"2016"
"38351","431055 ITACURUBI",0,0,0,31,0,31,"2016"
"38352","431057 ITAPUCA",0,0,0,16,0,16,"2016"
"38353","431060 ITAQUI",1,1,7,548,4,561,"2016"
"38354","431065 ITATI",0,0,1,32,0,33,"2016"
"38355","431070 ITATIBA DO SUL",0,0,1,28,0,29,"2016"
"38356","431075 IVORA",0,0,0,13,0,13,"2016"
"38357","431080 IVOTI",0,0,7,276,2,285,"2016"
"38358","431085 JABOTICABA",0,0,1,26,0,27,"2016"
"38359","431087 JACUIZINHO",0,0,0,15,0,15,"2016"
"38360","431090 JACUTINGA",0,0,1,26,0,27,"2016"
"38361","431100 JAGUARAO",1,0,10,297,0,308,"2016"
"38362","431110 JAGUARI",0,0,1,70,0,71,"2016"
"38363","431112 JAQUIRANA",0,0,2,53,0,55,"2016"
"38364","431113 JARI",0,0,2,26,1,29,"2016"
"38365","431115 JOIA",0,1,2,88,0,91,"2016"
"38366","431120 JULIO DE CASTILHOS",0,1,3,199,3,206,"2016"
"38367","431123 LAGOA BONITA DO SUL",0,0,0,23,0,23,"2016"
"38368","431125 LAGOAO",0,0,2,63,0,65,"2016"
"38369","431127 LAGOA DOS TRES CANTOS",0,0,0,28,0,28,"2016"
"38370","431130 LAGOA VERMELHA",1,2,7,384,0,394,"2016"
"38371","431140 LAJEADO",2,4,10,1145,0,1161,"2016"
"38372","431142 LAJEADO DO BUGRE",0,0,0,30,0,30,"2016"
"38373","431150 LAVRAS DO SUL",0,1,2,64,0,67,"2016"
"38374","431160 LIBERATO SALZANO",0,0,0,61,0,61,"2016"
"38375","431162 LINDOLFO COLLOR",0,0,0,81,0,81,"2016"
"38376","431164 LINHA NOVA",0,0,0,11,0,11,"2016"
"38377","431170 MACHADINHO",0,0,0,60,0,60,"2016"
"38378","431171 MACAMBARA",0,1,1,59,0,61,"2016"
"38379","431173 MAMPITUBA",0,0,1,33,0,34,"2016"
"38380","431175 MANOEL VIANA",0,0,0,52,0,52,"2016"
"38381","431177 MAQUINE",0,0,0,55,0,55,"2016"
"38382","431179 MARATA",0,0,1,22,0,23,"2016"
"38383","431180 MARAU",2,2,6,476,0,486,"2016"
"38384","431190 MARCELINO RAMOS",0,0,1,38,1,40,"2016"
"38385","431198 MARIANA PIMENTEL",0,1,0,36,2,39,"2016"
"38386","431200 MARIANO MORO",0,0,0,11,0,11,"2016"
"38387","431205 MARQUES DE SOUZA",0,0,1,36,0,37,"2016"
"38388","431210 MATA",0,0,2,35,0,37,"2016"
"38389","431213 MATO CASTELHANO",0,0,0,36,0,36,"2016"
"38390","431215 MATO LEITAO",0,0,0,34,0,34,"2016"
"38391","431217 MATO QUEIMADO",0,0,0,22,0,22,"2016"
"38392","431220 MAXIMILIANO DE ALMEIDA",0,0,0,31,0,31,"2016"
"38393","431225 MINAS DO LEAO",0,0,1,100,1,102,"2016"
"38394","431230 MIRAGUAI",0,0,0,67,0,67,"2016"
"38395","431235 MONTAURI",0,1,0,10,0,11,"2016"
"38396","431237 MONTE ALEGRE DOS CAMPOS",0,0,1,44,0,45,"2016"
"38397","431238 MONTE BELO DO SUL",0,0,0,10,0,10,"2016"
"38398","431240 MONTENEGRO",1,0,8,918,1,928,"2016"
"38399","431242 MORMACO",0,0,1,21,0,22,"2016"
"38400","431244 MORRINHOS DO SUL",0,0,0,30,0,30,"2016"
"38401","431245 MORRO REDONDO",0,1,0,56,1,58,"2016"
"38402","431247 MORRO REUTER",0,0,2,56,0,58,"2016"
"38403","431250 MOSTARDAS",0,0,2,135,0,137,"2016"
"38404","431260 MUCUM",0,0,1,48,0,49,"2016"
"38405","431261 MUITOS CAPOES",0,0,0,37,2,39,"2016"
"38406","431262 MULITERNO",0,0,3,31,0,34,"2016"
"38407","431265 NAO-ME-TOQUE",0,2,2,235,0,239,"2016"
"38408","431267 NICOLAU VERGUEIRO",0,0,0,15,0,15,"2016"
"38409","431270 NONOAI",0,0,2,179,0,181,"2016"
"38410","431275 NOVA ALVORADA",0,0,0,34,0,34,"2016"
"38411","431280 NOVA ARACA",0,0,1,71,0,72,"2016"
"38412","431290 NOVA BASSANO",0,1,1,82,0,84,"2016"
"38413","431295 NOVA BOA VISTA",0,0,1,17,0,18,"2016"
"38414","431300 NOVA BRESCIA",0,0,0,15,0,15,"2016"
"38415","431301 NOVA CANDELARIA",0,0,0,30,0,30,"2016"
"38416","431303 NOVA ESPERANCA DO SUL",0,0,0,61,0,61,"2016"
"38417","431306 NOVA HARTZ",2,0,3,262,0,267,"2016"
"38418","431308 NOVA PADUA",0,0,0,13,0,13,"2016"
"38419","431310 NOVA PALMA",0,0,2,62,0,64,"2016"
"38420","431320 NOVA PETROPOLIS",0,1,5,244,0,250,"2016"
"38421","431330 NOVA PRATA",1,0,5,342,0,348,"2016"
"38422","431333 NOVA RAMADA",0,0,0,20,0,20,"2016"
"38423","431335 NOVA ROMA DO SUL",0,0,1,23,0,24,"2016"
"38424","431337 NOVA SANTA RITA",0,2,5,393,1,401,"2016"
"38425","431339 NOVO CABRAIS",0,0,0,32,0,32,"2016"
"38426","431340 NOVO HAMBURGO",4,14,46,3095,5,3164,"2016"
"38427","431342 NOVO MACHADO",0,0,0,21,0,21,"2016"
"38428","431344 NOVO TIRADENTES",0,0,0,27,0,27,"2016"
"38429","431346 NOVO XINGU",0,0,0,15,0,15,"2016"
"38430","431349 NOVO BARREIRO",0,0,3,34,1,38,"2016"
"38431","431350 OSORIO",1,3,10,661,0,675,"2016"
"38432","431360 PAIM FILHO",0,0,0,29,0,29,"2016"
"38433","431365 PALMARES DO SUL",0,1,1,154,0,156,"2016"
"38434","431370 PALMEIRA DAS MISSOES",6,5,6,464,2,483,"2016"
"38435","431380 PALMITINHO",0,2,1,92,0,95,"2016"
"38436","431390 PANAMBI",1,1,12,608,0,622,"2016"
"38437","431395 PANTANO GRANDE",0,0,4,102,1,107,"2016"
"38438","431400 PARAI",0,1,0,107,0,108,"2016"
"38439","431402 PARAISO DO SUL",0,0,2,78,0,80,"2016"
"38440","431403 PARECI NOVO",0,0,2,40,0,42,"2016"
"38441","431405 PAROBE",5,3,9,744,1,762,"2016"
"38442","431406 PASSA SETE",0,0,0,28,0,28,"2016"
"38443","431407 PASSO DO SOBRADO",0,0,1,57,0,58,"2016"
"38444","431410 PASSO FUNDO",8,12,53,2797,6,2876,"2016"
"38445","431413 PAULO BENTO",0,0,0,18,0,18,"2016"
"38446","431415 PAVERAMA",0,0,1,70,0,71,"2016"
"38447","431417 PEDRAS ALTAS",0,0,2,26,0,28,"2016"
"38448","431420 PEDRO OSORIO",0,1,2,92,0,95,"2016"
"38449","431430 PEJUCARA",0,0,0,29,0,29,"2016"
"38450","431440 PELOTAS",8,36,103,4100,12,4259,"2016"
"38451","431442 PICADA CAFE",2,0,0,46,0,48,"2016"
"38452","431445 PINHAL",0,0,0,11,0,11,"2016"
"38453","431446 PINHAL DA SERRA",0,0,0,18,0,18,"2016"
"38454","431447 PINHAL GRANDE",0,1,1,45,0,47,"2016"
"38455","431449 PINHEIRINHO DO VALE",0,0,3,49,0,52,"2016"
"38456","431450 PINHEIRO MACHADO",0,1,5,107,0,113,"2016"
"38457","431454 PINTO BANDEIRA",0,1,1,23,0,25,"2016"
"38458","431455 PIRAPO",0,0,0,17,0,17,"2016"
"38459","431460 PIRATINI",0,0,7,173,1,181,"2016"
"38460","431470 PLANALTO",0,0,0,122,0,122,"2016"
"38461","431475 POCO DAS ANTAS",0,0,0,22,0,22,"2016"
"38462","431477 PONTAO",0,1,1,41,0,43,"2016"
"38463","431478 PONTE PRETA",0,0,0,14,0,14,"2016"
"38464","431480 PORTAO",0,2,6,391,1,400,"2016"
"38465","431490 PORTO ALEGRE",30,98,360,18069,78,18635,"2016"
"38466","431500 PORTO LUCENA",0,0,0,29,0,29,"2016"
"38467","431505 PORTO MAUA",0,0,0,21,0,21,"2016"
"38468","431507 PORTO VERA CRUZ",0,0,1,11,0,12,"2016"
"38469","431510 PORTO XAVIER",0,0,2,113,0,115,"2016"
"38470","431513 POUSO NOVO",0,0,0,15,0,15,"2016"
"38471","431514 PRESIDENTE LUCENA",0,0,0,36,0,36,"2016"
"38472","431515 PROGRESSO",0,0,1,47,0,48,"2016"
"38473","431517 PROTASIO ALVES",0,0,0,18,0,18,"2016"
"38474","431520 PUTINGA",0,0,1,31,0,32,"2016"
"38475","431530 QUARAI",2,1,1,262,2,268,"2016"
"38476","431531 QUATRO IRMAOS",0,0,0,10,0,10,"2016"
"38477","431532 QUEVEDOS",0,0,1,13,0,14,"2016"
"38478","431535 QUINZE DE NOVEMBRO",0,0,0,46,0,46,"2016"
"38479","431540 REDENTORA",0,1,0,154,1,156,"2016"
"38480","431545 RELVADO",0,0,0,9,0,9,"2016"
"38481","431550 RESTINGA SECA",1,1,6,190,1,199,"2016"
"38482","431555 RIO DOS INDIOS",0,0,0,33,0,33,"2016"
"38483","431560 RIO GRANDE",6,17,95,2708,22,2848,"2016"
"38484","431570 RIO PARDO",1,0,7,443,0,451,"2016"
"38485","431575 RIOZINHO",1,0,0,38,0,39,"2016"
"38486","431580 ROCA SALES",1,1,2,123,0,127,"2016"
"38487","431590 RODEIO BONITO",0,0,1,74,1,76,"2016"
"38488","431595 ROLADOR",0,0,0,17,0,17,"2016"
"38489","431600 ROLANTE",0,1,9,234,0,244,"2016"
"38490","431610 RONDA ALTA",1,0,1,95,0,97,"2016"
"38491","431620 RONDINHA",1,0,0,43,0,44,"2016"
"38492","431630 ROQUE GONZALES",0,0,0,69,0,69,"2016"
"38493","431640 ROSARIO DO SUL",1,2,5,441,0,449,"2016"
"38494","431642 SAGRADA FAMILIA",0,0,0,23,0,23,"2016"
"38495","431643 SALDANHA MARINHO",0,0,1,32,0,33,"2016"
"38496","431645 SALTO DO JACUI",0,0,1,153,0,154,"2016"
"38497","431647 SALVADOR DAS MISSOES",2,0,0,27,0,29,"2016"
"38498","431650 SALVADOR DO SUL",0,0,1,88,0,89,"2016"
"38499","431660 SANANDUVA",2,0,4,167,0,173,"2016"
"38500","431670 SANTA BARBARA DO SUL",0,0,1,89,0,90,"2016"
"38501","431673 SANTA CECILIA DO SUL",0,0,0,11,0,11,"2016"
"38502","431675 SANTA CLARA DO SUL",0,0,2,63,0,65,"2016"
"38503","431680 SANTA CRUZ DO SUL",1,8,25,1607,0,1641,"2016"
"38504","431690 SANTA MARIA",4,9,54,3436,15,3518,"2016"
"38505","431695 SANTA MARIA DO HERVAL",0,0,2,48,0,50,"2016"
"38506","431697 SANTA MARGARIDA DO SUL",0,0,1,21,1,23,"2016"
"38507","431700 SANTANA DA BOA VISTA",0,0,0,51,2,53,"2016"
"38508","431710 SANT'ANA DO LIVRAMENTO",3,3,6,1176,1,1189,"2016"
"38509","431720 SANTA ROSA",3,2,39,952,2,998,"2016"
"38510","431725 SANTA TEREZA",1,0,1,10,0,12,"2016"
"38511","431730 SANTA VITORIA DO PALMAR",2,4,7,389,0,402,"2016"
"38512","431740 SANTIAGO",0,1,9,616,1,627,"2016"
"38513","431750 SANTO ANGELO",0,4,15,1009,2,1030,"2016"
"38514","431755 SANTO ANTONIO DO PALMA",2,0,0,14,0,16,"2016"
"38515","431760 SANTO ANTONIO DA PATRULHA",1,1,6,460,3,471,"2016"
"38516","431770 SANTO ANTONIO DAS MISSOES",0,0,0,97,1,98,"2016"
"38517","431775 SANTO ANTONIO DO PLANALTO",0,0,0,14,0,14,"2016"
"38518","431780 SANTO AUGUSTO",2,0,0,194,0,196,"2016"
"38519","431790 SANTO CRISTO",1,2,4,121,0,128,"2016"
"38520","431795 SANTO EXPEDITO DO SUL",0,0,0,24,0,24,"2016"
"38521","431800 SAO BORJA",1,2,3,800,1,807,"2016"
"38522","431805 SAO DOMINGOS DO SUL",0,0,0,22,0,22,"2016"
"38523","431810 SAO FRANCISCO DE ASSIS",0,0,2,172,0,174,"2016"
"38524","431820 SAO FRANCISCO DE PAULA",0,1,6,286,1,294,"2016"
"38525","431830 SAO GABRIEL",1,2,9,819,1,832,"2016"
"38526","431840 SAO JERONIMO",0,1,1,261,1,264,"2016"
"38527","431842 SAO JOAO DA URTIGA",0,0,0,41,0,41,"2016"
"38528","431843 SAO JOAO DO POLESINE",0,0,0,22,1,23,"2016"
"38529","431844 SAO JORGE",0,0,1,17,0,18,"2016"
"38530","431845 SAO JOSE DAS MISSOES",0,0,0,22,0,22,"2016"
"38531","431846 SAO JOSE DO HERVAL",0,0,1,16,0,17,"2016"
"38532","431848 SAO JOSE DO HORTENCIO",0,0,1,34,0,35,"2016"
"38533","431849 SAO JOSE DO INHACORA",0,0,0,19,0,19,"2016"
"38534","431850 SAO JOSE DO NORTE",4,5,14,287,2,312,"2016"
"38535","431860 SAO JOSE DO OURO",0,1,0,57,0,58,"2016"
"38536","431861 SAO JOSE DO SUL",0,0,0,31,0,31,"2016"
"38537","431862 SAO JOSE DOS AUSENTES",0,0,1,51,2,54,"2016"
"38538","431870 SAO LEOPOLDO",19,8,57,2778,7,2869,"2016"
"38539","431880 SAO LOURENCO DO SUL",2,5,12,430,0,449,"2016"
"38540","431890 SAO LUIZ GONZAGA",1,1,3,476,2,483,"2016"
"38541","431900 SAO MARCOS",0,0,5,222,0,227,"2016"
"38542","431910 SAO MARTINHO",0,0,0,67,0,67,"2016"
"38543","431912 SAO MARTINHO DA SERRA",0,0,0,36,0,36,"2016"
"38544","431915 SAO MIGUEL DAS MISSOES",1,0,3,66,2,72,"2016"
"38545","431920 SAO NICOLAU",0,0,0,57,0,57,"2016"
"38546","431930 SAO PAULO DAS MISSOES",0,0,0,49,0,49,"2016"
"38547","431935 SAO PEDRO DA SERRA",0,0,1,41,0,42,"2016"
"38548","431936 SAO PEDRO DAS MISSOES",0,0,0,28,0,28,"2016"
"38549","431937 SAO PEDRO DO BUTIA",0,0,1,19,0,20,"2016"
"38550","431940 SAO PEDRO DO SUL",1,1,1,159,0,162,"2016"
"38551","431950 SAO SEBASTIAO DO CAI",0,0,5,336,0,341,"2016"
"38552","431960 SAO SEPE",0,3,5,210,0,218,"2016"
"38553","431970 SAO VALENTIM",0,0,1,39,0,40,"2016"
"38554","431971 SAO VALENTIM DO SUL",0,0,0,18,0,18,"2016"
"38555","431973 SAO VALERIO DO SUL",0,0,1,35,0,36,"2016"
"38556","431975 SAO VENDELINO",0,0,0,20,0,20,"2016"
"38557","431980 SAO VICENTE DO SUL",0,0,3,96,0,99,"2016"
"38558","431990 SAPIRANGA",2,3,17,1125,1,1148,"2016"
"38559","432000 SAPUCAIA DO SUL",1,12,56,1836,5,1910,"2016"
"38560","432010 SARANDI",4,3,8,257,0,272,"2016"
"38561","432020 SEBERI",0,0,2,147,1,150,"2016"
"38562","432023 SEDE NOVA",0,0,0,27,0,27,"2016"
"38563","432026 SEGREDO",2,0,0,82,0,84,"2016"
"38564","432030 SELBACH",0,1,0,56,0,57,"2016"
"38565","432032 SENADOR SALGADO FILHO",0,0,0,27,0,27,"2016"
"38566","432035 SENTINELA DO SUL",0,0,1,50,0,51,"2016"
"38567","432040 SERAFINA CORREA",0,1,4,208,0,213,"2016"
"38568","432045 SERIO",0,0,0,19,0,19,"2016"
"38569","432050 SERTAO",0,0,2,52,0,54,"2016"
"38570","432055 SERTAO SANTANA",1,0,2,45,3,51,"2016"
"38571","432057 SETE DE SETEMBRO",0,0,0,18,0,18,"2016"
"38572","432060 SEVERIANO DE ALMEIDA",1,0,2,35,0,38,"2016"
"38573","432065 SILVEIRA MARTINS",0,0,0,27,0,27,"2016"
"38574","432067 SINIMBU",0,2,1,84,1,88,"2016"
"38575","432070 SOBRADINHO",2,0,2,167,0,171,"2016"
"38576","432080 SOLEDADE",0,4,7,379,1,391,"2016"
"38577","432085 TABAI",0,0,2,54,0,56,"2016"
"38578","432090 TAPEJARA",0,1,3,317,0,321,"2016"
"38579","432100 TAPERA",0,1,2,135,1,139,"2016"
"38580","432110 TAPES",0,0,3,179,0,182,"2016"
"38581","432120 TAQUARA",2,0,18,664,2,686,"2016"
"38582","432130 TAQUARI",0,1,8,313,0,322,"2016"
"38583","432132 TAQUARUCU DO SUL",0,0,1,33,0,34,"2016"
"38584","432135 TAVARES",0,0,1,36,0,37,"2016"
"38585","432140 TENENTE PORTELA",0,1,1,190,0,192,"2016"
"38586","432143 TERRA DE AREIA",0,0,1,113,0,114,"2016"
"38587","432145 TEUTONIA",0,2,5,363,0,370,"2016"
"38588","432146 TIO HUGO",0,0,1,38,0,39,"2016"
"38589","432147 TIRADENTES DO SUL",0,0,0,48,0,48,"2016"
"38590","432149 TOROPI",0,0,0,18,0,18,"2016"
"38591","432150 TORRES",1,1,10,577,1,590,"2016"
"38592","432160 TRAMANDAI",1,5,21,785,1,813,"2016"
"38593","432162 TRAVESSEIRO",0,0,1,18,0,19,"2016"
"38594","432163 TRES ARROIOS",0,0,1,13,0,14,"2016"
"38595","432166 TRES CACHOEIRAS",1,0,1,125,0,127,"2016"
"38596","432170 TRES COROAS",1,1,1,310,0,313,"2016"
"38597","432180 TRES DE MAIO",1,0,2,293,0,296,"2016"
"38598","432183 TRES FORQUILHAS",0,1,0,30,0,31,"2016"
"38599","432185 TRES PALMEIRAS",0,0,0,52,0,52,"2016"
"38600","432190 TRES PASSOS",1,0,4,299,1,305,"2016"
"38601","432195 TRINDADE DO SUL",1,0,3,89,0,93,"2016"
"38602","432200 TRIUNFO",0,0,0,350,0,350,"2016"
"38603","432210 TUCUNDUVA",0,0,0,43,0,43,"2016"
"38604","432215 TUNAS",0,0,0,40,0,40,"2016"
"38605","432218 TUPANCI DO SUL",0,0,0,9,0,9,"2016"
"38606","432220 TUPANCIRETA",0,1,0,265,0,266,"2016"
"38607","432225 TUPANDI",0,0,0,65,0,65,"2016"
"38608","432230 TUPARENDI",0,0,0,84,0,84,"2016"
"38609","432232 TURUCU",0,0,0,36,0,36,"2016"
"38610","432234 UBIRETAMA",0,0,0,13,1,14,"2016"
"38611","432235 UNIAO DA SERRA",0,0,0,10,0,10,"2016"
"38612","432237 UNISTALDA",0,0,0,21,0,21,"2016"
"38613","432240 URUGUAIANA",6,6,24,924,820,1780,"2016"
"38614","432250 VACARIA",1,7,11,915,19,953,"2016"
"38615","432252 VALE VERDE",0,0,0,37,0,37,"2016"
"38616","432253 VALE DO SOL",0,0,2,78,0,80,"2016"
"38617","432254 VALE REAL",0,0,0,62,0,62,"2016"
"38618","432255 VANINI",0,1,1,20,0,22,"2016"
"38619","432260 VENANCIO AIRES",2,3,7,780,0,792,"2016"
"38620","432270 VERA CRUZ",0,1,5,282,1,289,"2016"
"38621","432280 VERANOPOLIS",0,0,8,237,0,245,"2016"
"38622","432285 VESPASIANO CORREA",0,0,0,15,0,15,"2016"
"38623","432290 VIADUTOS",0,1,2,38,0,41,"2016"
"38624","432300 VIAMAO",9,16,67,3251,20,3363,"2016"
"38625","432310 VICENTE DUTRA",0,1,3,62,0,66,"2016"
"38626","432320 VICTOR GRAEFF",0,0,1,19,0,20,"2016"
"38627","432330 VILA FLORES",0,0,2,34,0,36,"2016"
"38628","432335 VILA LANGARO",0,0,0,18,0,18,"2016"
"38629","432340 VILA MARIA",0,0,1,33,0,34,"2016"
"38630","432345 VILA NOVA DO SUL",0,0,0,20,0,20,"2016"
"38631","432350 VISTA ALEGRE",0,1,1,21,0,23,"2016"
"38632","432360 VISTA ALEGRE DO PRATA",0,0,0,10,0,10,"2016"
"38633","432370 VISTA GAUCHA",0,2,0,17,0,19,"2016"
"38634","432375 VITORIA DAS MISSOES",0,1,1,21,0,23,"2016"
"38635","432377 WESTFALIA",0,0,0,43,0,43,"2016"
"38636","432380 XANGRI-LA",1,0,4,232,1,238,"2016"
"38637","500020 AGUA CLARA",0,0,1,255,0,256,"2016"
"38638","500025 ALCINOPOLIS",0,0,0,44,0,44,"2016"
"38639","500060 AMAMBAI",2,3,14,644,1,664,"2016"
"38640","500070 ANASTACIO",1,0,3,351,16,371,"2016"
"38641","500080 ANAURILANDIA",0,0,1,79,0,80,"2016"
"38642","500085 ANGELICA",1,0,2,186,0,189,"2016"
"38643","500090 ANTONIO JOAO",1,1,2,155,1,160,"2016"
"38644","500100 APARECIDA DO TABOADO",0,0,6,296,1,303,"2016"
"38645","500110 AQUIDAUANA",0,1,7,660,53,721,"2016"
"38646","500124 ARAL MOREIRA",0,13,7,142,11,173,"2016"
"38647","500150 BANDEIRANTES",0,1,2,68,0,71,"2016"
"38648","500190 BATAGUASSU",0,1,5,393,1,400,"2016"
"38649","500200 BATAYPORA",0,0,0,154,1,155,"2016"
"38650","500210 BELA VISTA",0,1,2,414,1,418,"2016"
"38651","500215 BODOQUENA",0,0,3,103,0,106,"2016"
"38652","500220 BONITO",1,2,2,339,3,347,"2016"
"38653","500230 BRASILANDIA",2,0,0,169,0,171,"2016"
"38654","500240 CAARAPO",0,2,6,532,2,542,"2016"
"38655","500260 CAMAPUA",0,0,1,202,0,203,"2016"
"38656","500270 CAMPO GRANDE",38,36,101,13496,57,13728,"2016"
"38657","500280 CARACOL",0,0,0,71,0,71,"2016"
"38658","500290 CASSILANDIA",0,0,8,283,0,291,"2016"
"38659","500295 CHAPADAO DO SUL",2,1,5,424,0,432,"2016"
"38660","500310 CORGUINHO",0,0,1,37,0,38,"2016"
"38661","500315 CORONEL SAPUCAIA",0,2,3,326,16,347,"2016"
"38662","500320 CORUMBA",4,8,18,1811,14,1855,"2016"
"38663","500325 COSTA RICA",1,0,2,439,0,442,"2016"
"38664","500330 COXIM",1,0,3,489,1,494,"2016"
"38665","500345 DEODAPOLIS",0,1,1,143,1,146,"2016"
"38666","500348 DOIS IRMAOS DO BURITI",0,0,0,151,0,151,"2016"
"38667","500350 DOURADINA",0,0,0,75,1,76,"2016"
"38668","500370 DOURADOS",10,23,55,3781,22,3891,"2016"
"38669","500375 ELDORADO",0,0,27,172,0,199,"2016"
"38670","500380 FATIMA DO SUL",0,1,4,285,0,290,"2016"
"38671","500390 FIGUEIRAO",0,0,1,30,0,31,"2016"
"38672","500400 GLORIA DE DOURADOS",0,2,1,130,0,133,"2016"
"38673","500410 GUIA LOPES DA LAGUNA",0,0,0,122,4,126,"2016"
"38674","500430 IGUATEMI",0,0,5,250,0,255,"2016"
"38675","500440 INOCENCIA",0,1,0,116,0,117,"2016"
"38676","500450 ITAPORA",0,0,4,243,0,247,"2016"
"38677","500460 ITAQUIRAI",1,0,3,250,0,254,"2016"
"38678","500470 IVINHEMA",0,1,5,368,0,374,"2016"
"38679","500480 JAPORA",0,2,8,154,1,165,"2016"
"38680","500490 JARAGUARI",0,0,2,54,0,56,"2016"
"38681","500500 JARDIM",0,0,3,397,1,401,"2016"
"38682","500510 JATEI",0,0,0,45,0,45,"2016"
"38683","500515 JUTI",1,0,2,112,0,115,"2016"
"38684","500520 LADARIO",0,2,1,373,2,378,"2016"
"38685","500525 LAGUNA CARAPA",0,0,2,113,1,116,"2016"
"38686","500540 MARACAJU",2,3,5,708,1,719,"2016"
"38687","500560 MIRANDA",1,2,4,508,4,519,"2016"
"38688","500568 MUNDO NOVO",3,3,50,257,0,313,"2016"
"38689","500570 NAVIRAI",1,1,6,951,0,959,"2016"
"38690","500580 NIOAQUE",0,0,5,155,1,161,"2016"
"38691","500600 NOVA ALVORADA DO SUL",2,0,3,297,0,302,"2016"
"38692","500620 NOVA ANDRADINA",2,1,2,704,0,709,"2016"
"38693","500625 NOVO HORIZONTE DO SUL",0,1,0,72,1,74,"2016"
"38694","500627 PARAISO DAS AGUAS",0,0,0,41,0,41,"2016"
"38695","500630 PARANAIBA",1,1,1,532,0,535,"2016"
"38696","500635 PARANHOS",0,1,0,221,60,282,"2016"
"38697","500640 PEDRO GOMES",0,1,2,76,0,79,"2016"
"38698","500660 PONTA PORA",6,7,25,1490,37,1565,"2016"
"38699","500690 PORTO MURTINHO",1,0,1,215,1,218,"2016"
"38700","500710 RIBAS DO RIO PARDO",1,4,5,308,2,320,"2016"
"38701","500720 RIO BRILHANTE",0,2,8,631,2,643,"2016"
"38702","500730 RIO NEGRO",0,0,0,55,0,55,"2016"
"38703","500740 RIO VERDE DE MATO GROSSO",1,2,9,283,0,295,"2016"
"38704","500750 ROCHEDO",0,1,0,44,0,45,"2016"
"38705","500755 SANTA RITA DO PARDO",0,0,0,18,1,19,"2016"
"38706","500769 SAO GABRIEL DO OESTE",1,0,2,488,0,491,"2016"
"38707","500770 SETE QUEDAS",0,2,1,116,1,120,"2016"
"38708","500780 SELVIRIA",1,0,0,49,0,50,"2016"
"38709","500790 SIDROLANDIA",1,1,8,645,3,658,"2016"
"38710","500793 SONORA",0,0,3,212,0,215,"2016"
"38711","500795 TACURU",0,0,3,175,2,180,"2016"
"38712","500797 TAQUARUSSU",0,0,1,48,0,49,"2016"
"38713","500800 TERENOS",0,0,4,193,1,198,"2016"
"38714","500830 TRES LAGOAS",3,1,17,1881,0,1902,"2016"
"38715","500840 VICENTINA",0,1,2,75,0,78,"2016"
"38716","MUNICIPIO IGNORADO - MT",0,0,0,1,0,1,"2016"
"38717","510010 ACORIZAL",0,1,1,60,0,62,"2016"
"38718","510020 AGUA BOA",2,1,9,373,11,396,"2016"
"38719","510025 ALTA FLORESTA",3,0,10,834,0,847,"2016"
"38720","510030 ALTO ARAGUAIA",1,1,4,245,0,251,"2016"
"38721","510035 ALTO BOA VISTA",1,0,0,46,7,54,"2016"
"38722","510040 ALTO GARCAS",2,2,5,133,1,143,"2016"
"38723","510050 ALTO PARAGUAI",0,0,0,77,0,77,"2016"
"38724","510060 ALTO TAQUARI",0,0,0,167,0,167,"2016"
"38725","510080 APIACAS",1,2,4,130,2,139,"2016"
"38726","510100 ARAGUAIANA",0,1,2,26,0,29,"2016"
"38727","510120 ARAGUAINHA",0,0,1,9,0,10,"2016"
"38728","510125 ARAPUTANGA",0,2,1,237,0,240,"2016"
"38729","510130 ARENAPOLIS",0,0,5,105,0,110,"2016"
"38730","510140 ARIPUANA",1,1,1,333,1,337,"2016"
"38731","510160 BARAO DE MELGACO",0,0,1,60,1,62,"2016"
"38732","510170 BARRA DO BUGRES",2,2,10,526,1,541,"2016"
"38733","510180 BARRA DO GARCAS",2,3,8,1016,12,1041,"2016"
"38734","510185 BOM JESUS DO ARAGUAIA",0,0,1,84,12,97,"2016"
"38735","510190 BRASNORTE",2,2,7,251,3,265,"2016"
"38736","510250 CACERES",6,4,18,1417,1,1446,"2016"
"38737","510260 CAMPINAPOLIS",0,1,4,200,165,370,"2016"
"38738","510263 CAMPO NOVO DO PARECIS",4,3,7,694,0,708,"2016"
"38739","510267 CAMPO VERDE",0,3,4,753,0,760,"2016"
"38740","510268 CAMPOS DE JULIO",0,1,3,119,0,123,"2016"
"38741","510269 CANABRAVA DO NORTE",0,0,0,63,0,63,"2016"
"38742","510270 CANARANA",0,2,9,332,32,375,"2016"
"38743","510279 CARLINDA",0,0,1,132,0,133,"2016"
"38744","510285 CASTANHEIRA",0,0,1,102,0,103,"2016"
"38745","510300 CHAPADA DOS GUIMARAES",1,1,2,253,2,259,"2016"
"38746","510305 CLAUDIA",0,1,1,140,0,142,"2016"
"38747","510310 COCALINHO",1,0,0,58,0,59,"2016"
"38748","510320 COLIDER",0,0,9,448,0,457,"2016"
"38749","510325 COLNIZA",0,1,10,375,0,386,"2016"
"38750","510330 COMODORO",0,0,1,357,32,390,"2016"
"38751","510335 CONFRESA",0,1,1,481,18,501,"2016"
"38752","510336 CONQUISTA D'OESTE",0,0,2,40,1,43,"2016"
"38753","510337 COTRIGUACU",0,0,1,141,0,142,"2016"
"38754","510340 CUIABA",18,45,100,9715,0,9878,"2016"
"38755","510343 CURVELANDIA",0,0,1,62,0,63,"2016"
"38756","510345 DENISE",0,0,3,99,0,102,"2016"
"38757","510350 DIAMANTINO",0,0,3,353,0,356,"2016"
"38758","510360 DOM AQUINO",0,0,2,80,0,82,"2016"
"38759","510370 FELIZ NATAL",0,1,0,175,3,179,"2016"
"38760","510380 FIGUEIROPOLIS D'OESTE",0,0,1,40,0,41,"2016"
"38761","510385 GAUCHA DO NORTE",1,3,2,140,10,156,"2016"
"38762","510390 GENERAL CARNEIRO",1,1,2,109,10,123,"2016"
"38763","510395 GLORIA D'OESTE",0,0,0,35,0,35,"2016"
"38764","510410 GUARANTA DO NORTE",0,3,8,506,1,518,"2016"
"38765","510420 GUIRATINGA",0,1,0,105,0,106,"2016"
"38766","510450 INDIAVAI",0,0,0,30,0,30,"2016"
"38767","510452 IPIRANGA DO NORTE",0,1,0,95,0,96,"2016"
"38768","510454 ITANHANGA",0,1,0,85,0,86,"2016"
"38769","510455 ITAUBA",0,0,2,86,0,88,"2016"
"38770","510460 ITIQUIRA",0,1,3,163,1,168,"2016"
"38771","510480 JACIARA",3,1,1,427,0,432,"2016"
"38772","510490 JANGADA",1,1,1,99,0,102,"2016"
"38773","510500 JAURU",0,0,1,129,0,130,"2016"
"38774","510510 JUARA",1,0,2,481,2,486,"2016"
"38775","510515 JUINA",2,0,5,624,2,633,"2016"
"38776","510517 JURUENA",0,0,0,146,0,146,"2016"
"38777","510520 JUSCIMEIRA",1,0,0,137,0,138,"2016"
"38778","510523 LAMBARI D'OESTE",0,2,0,74,0,76,"2016"
"38779","510525 LUCAS DO RIO VERDE",3,2,18,1289,0,1312,"2016"
"38780","510530 LUCIARA",0,0,0,27,0,27,"2016"
"38781","510550 VILA BELA DA SANTISSIMA TRINDADE",2,1,1,243,12,259,"2016"
"38782","510558 MARCELANDIA",3,2,7,172,7,191,"2016"
"38783","510560 MATUPA",0,2,6,277,0,285,"2016"
"38784","510562 MIRASSOL D'OESTE",3,1,3,387,1,395,"2016"
"38785","510590 NOBRES",0,1,5,216,2,224,"2016"
"38786","510600 NORTELANDIA",1,2,2,88,1,94,"2016"
"38787","510610 NOSSA SENHORA DO LIVRAMENTO",0,1,3,122,2,128,"2016"
"38788","510615 NOVA BANDEIRANTES",0,2,1,144,0,147,"2016"
"38789","510617 NOVA NAZARE",0,0,1,36,31,68,"2016"
"38790","510618 NOVA LACERDA",0,1,0,57,2,60,"2016"
"38791","510619 NOVA SANTA HELENA",0,0,0,46,0,46,"2016"
"38792","510620 NOVA BRASILANDIA",0,1,0,25,0,26,"2016"
"38793","510621 NOVA CANAA DO NORTE",0,0,1,159,1,161,"2016"
"38794","510622 NOVA MUTUM",2,7,10,928,2,949,"2016"
"38795","510623 NOVA OLIMPIA",0,1,2,255,0,258,"2016"
"38796","510624 NOVA UBIRATA",0,2,1,152,1,156,"2016"
"38797","510625 NOVA XAVANTINA",0,0,1,273,0,274,"2016"
"38798","510626 NOVO MUNDO",0,1,1,91,0,93,"2016"
"38799","510627 NOVO HORIZONTE DO NORTE",0,0,0,39,0,39,"2016"
"38800","510628 NOVO SAO JOAQUIM",0,0,1,66,1,68,"2016"
"38801","510629 PARANAITA",1,1,2,182,0,186,"2016"
"38802","510630 PARANATINGA",1,0,8,335,3,347,"2016"
"38803","510631 NOVO SANTO ANTONIO",0,0,0,23,0,23,"2016"
"38804","510637 PEDRA PRETA",3,0,6,272,0,281,"2016"
"38805","510642 PEIXOTO DE AZEVEDO",1,2,10,573,1,587,"2016"
"38806","510645 PLANALTO DA SERRA",0,0,1,50,0,51,"2016"
"38807","510650 POCONE",5,0,8,430,3,446,"2016"
"38808","510665 PONTAL DO ARAGUAIA",0,0,1,69,0,70,"2016"
"38809","510670 PONTE BRANCA",0,0,0,14,0,14,"2016"
"38810","510675 PONTES E LACERDA",0,7,12,724,1,744,"2016"
"38811","510677 PORTO ALEGRE DO NORTE",1,0,1,149,2,153,"2016"
"38812","510680 PORTO DOS GAUCHOS",0,2,3,69,0,74,"2016"
"38813","510682 PORTO ESPERIDIAO",3,0,2,161,1,167,"2016"
"38814","510685 PORTO ESTRELA",0,1,2,32,1,36,"2016"
"38815","510700 POXOREO",0,3,2,221,0,226,"2016"
"38816","510704 PRIMAVERA DO LESTE",2,2,13,1248,2,1267,"2016"
"38817","510706 QUERENCIA",1,0,3,342,18,364,"2016"
"38818","510710 SAO JOSE DOS QUATRO MARCOS",0,0,0,210,0,210,"2016"
"38819","510715 RESERVA DO CABACAL",0,0,0,17,0,17,"2016"
"38820","510718 RIBEIRAO CASCALHEIRA",1,0,1,126,26,154,"2016"
"38821","510719 RIBEIRAOZINHO",0,0,1,27,0,28,"2016"
"38822","510720 RIO BRANCO",0,0,0,55,0,55,"2016"
"38823","510724 SANTA CARMEM",0,0,1,58,0,59,"2016"
"38824","510726 SANTO AFONSO",0,0,0,27,0,27,"2016"
"38825","510729 SAO JOSE DO POVO",0,0,1,27,0,28,"2016"
"38826","510730 SAO JOSE DO RIO CLARO",3,0,0,270,0,273,"2016"
"38827","510735 SAO JOSE DO XINGU",0,0,0,106,2,108,"2016"
"38828","510740 SAO PEDRO DA CIPA",0,0,0,59,0,59,"2016"
"38829","510757 RONDOLANDIA",0,0,0,48,1,49,"2016"
"38830","510760 RONDONOPOLIS",24,17,53,3615,0,3709,"2016"
"38831","510770 ROSARIO OESTE",0,3,2,162,0,167,"2016"
"38832","510774 SANTA CRUZ DO XINGU",0,0,1,26,0,27,"2016"
"38833","510775 SALTO DO CEU",0,2,1,52,0,55,"2016"
"38834","510776 SANTA RITA DO TRIVELATO",0,0,0,48,0,48,"2016"
"38835","510777 SANTA TEREZINHA",0,0,2,126,0,128,"2016"
"38836","510779 SANTO ANTONIO DO LESTE",0,0,0,44,0,44,"2016"
"38837","510780 SANTO ANTONIO DO LEVERGER",0,2,8,210,0,220,"2016"
"38838","510785 SAO FELIX DO ARAGUAIA",0,0,0,119,3,122,"2016"
"38839","510787 SAPEZAL",0,0,41,419,0,460,"2016"
"38840","510788 SERRA NOVA DOURADA",0,0,1,16,0,17,"2016"
"38841","510790 SINOP",4,7,24,2629,4,2668,"2016"
"38842","510792 SORRISO",0,3,20,1639,1,1663,"2016"
"38843","510794 TABAPORA",0,0,2,103,0,105,"2016"
"38844","510795 TANGARA DA SERRA",3,6,44,1397,3,1453,"2016"
"38845","510800 TAPURAH",0,0,5,222,0,227,"2016"
"38846","510805 TERRA NOVA DO NORTE",1,2,1,139,0,143,"2016"
"38847","510810 TESOURO",0,0,0,13,0,13,"2016"
"38848","510820 TORIXOREU",0,0,7,41,0,48,"2016"
"38849","510830 UNIAO DO SUL",0,0,0,58,0,58,"2016"
"38850","510835 VALE DE SAO DOMINGOS",1,0,0,35,0,36,"2016"
"38851","510840 VARZEA GRANDE",12,13,60,4382,3,4470,"2016"
"38852","510850 VERA",0,0,0,130,0,130,"2016"
"38853","510860 VILA RICA",1,1,1,264,3,270,"2016"
"38854","510880 NOVA GUARITA",0,0,4,64,0,68,"2016"
"38855","510885 NOVA MARILANDIA",0,0,0,58,0,58,"2016"
"38856","510890 NOVA MARINGA",0,1,1,81,0,83,"2016"
"38857","510895 NOVA MONTE VERDE",1,0,1,97,0,99,"2016"
"38858","MUNICIPIO IGNORADO - GO",0,0,0,9,1,10,"2016"
"38859","520005 ABADIA DE GOIAS",2,3,3,190,2,200,"2016"
"38860","520010 ABADIANIA",0,0,3,189,0,192,"2016"
"38861","520013 ACREUNA",1,0,87,162,0,250,"2016"
"38862","520015 ADELANDIA",0,0,0,25,0,25,"2016"
"38863","520017 AGUA FRIA DE GOIAS",0,0,2,44,1,47,"2016"
"38864","520020 AGUA LIMPA",0,0,0,19,0,19,"2016"
"38865","520025 AGUAS LINDAS DE GOIAS",6,26,47,2283,252,2614,"2016"
"38866","520030 ALEXANIA",2,1,1,399,3,406,"2016"
"38867","520050 ALOANDIA",0,0,1,22,0,23,"2016"
"38868","520055 ALTO HORIZONTE",0,0,2,94,0,96,"2016"
"38869","520060 ALTO PARAISO DE GOIAS",1,0,1,125,5,132,"2016"
"38870","520080 ALVORADA DO NORTE",0,2,30,95,0,127,"2016"
"38871","520082 AMARALINA",0,0,0,25,0,25,"2016"
"38872","520085 AMERICANO DO BRASIL",0,0,0,48,0,48,"2016"
"38873","520090 AMORINOPOLIS",0,0,0,35,0,35,"2016"
"38874","520110 ANAPOLIS",13,23,72,5996,16,6120,"2016"
"38875","520120 ANHANGUERA",0,0,0,13,0,13,"2016"
"38876","520130 ANICUNS",2,0,0,239,1,242,"2016"
"38877","520140 APARECIDA DE GOIANIA",12,29,94,7655,32,7822,"2016"
"38878","520145 APARECIDA DO RIO DOCE",0,0,1,35,0,36,"2016"
"38879","520150 APORE",0,0,1,63,0,64,"2016"
"38880","520160 ARACU",0,0,0,33,0,33,"2016"
"38881","520170 ARAGARCAS",1,0,7,245,0,253,"2016"
"38882","520180 ARAGOIANIA",0,0,1,129,2,132,"2016"
"38883","520215 ARAGUAPAZ",1,0,2,85,0,88,"2016"
"38884","520235 ARENOPOLIS",0,0,0,35,0,35,"2016"
"38885","520250 ARUANA",0,0,0,101,0,101,"2016"
"38886","520260 AURILANDIA",0,0,0,25,0,25,"2016"
"38887","520280 AVELINOPOLIS",0,1,0,21,0,22,"2016"
"38888","520310 BALIZA",0,0,2,23,0,25,"2016"
"38889","520320 BARRO ALTO",1,0,7,139,0,147,"2016"
"38890","520330 BELA VISTA DE GOIAS",0,2,7,371,2,382,"2016"
"38891","520340 BOM JARDIM DE GOIAS",0,0,0,80,0,80,"2016"
"38892","520350 BOM JESUS DE GOIAS",1,2,3,335,2,343,"2016"
"38893","520355 BONFINOPOLIS",0,0,1,120,1,122,"2016"
"38894","520357 BONOPOLIS",0,0,2,35,0,37,"2016"
"38895","520360 BRAZABRANTES",0,0,0,50,0,50,"2016"
"38896","520380 BRITANIA",0,0,0,85,0,85,"2016"
"38897","520390 BURITI ALEGRE",0,0,0,120,1,121,"2016"
"38898","520393 BURITI DE GOIAS",0,1,0,30,0,31,"2016"
"38899","520396 BURITINOPOLIS",0,0,1,30,0,31,"2016"
"38900","520400 CABECEIRAS",0,0,0,104,0,104,"2016"
"38901","520410 CACHOEIRA ALTA",0,0,0,135,0,135,"2016"
"38902","520420 CACHOEIRA DE GOIAS",0,0,0,17,0,17,"2016"
"38903","520425 CACHOEIRA DOURADA",0,1,0,104,0,105,"2016"
"38904","520430 CACU",0,2,4,169,0,175,"2016"
"38905","520440 CAIAPONIA",0,0,17,169,0,186,"2016"
"38906","520450 CALDAS NOVAS",3,5,16,1218,1,1243,"2016"
"38907","520455 CALDAZINHA",0,0,1,37,1,39,"2016"
"38908","520460 CAMPESTRE DE GOIAS",0,0,1,46,0,47,"2016"
"38909","520465 CAMPINACU",0,0,0,40,0,40,"2016"
"38910","520470 CAMPINORTE",1,0,3,165,0,169,"2016"
"38911","520480 CAMPO ALEGRE DE GOIAS",0,0,1,66,0,67,"2016"
"38912","520485 CAMPO LIMPO DE GOIAS",0,1,2,111,0,114,"2016"
"38913","520490 CAMPOS BELOS",0,0,4,276,2,282,"2016"
"38914","520495 CAMPOS VERDES",0,0,1,27,0,28,"2016"
"38915","520500 CARMO DO RIO VERDE",0,1,3,121,0,125,"2016"
"38916","520505 CASTELANDIA",1,0,0,31,0,32,"2016"
"38917","520510 CATALAO",10,1,7,1444,2,1464,"2016"
"38918","520520 CATURAI",0,0,0,55,2,57,"2016"
"38919","520530 CAVALCANTE",0,0,5,131,4,140,"2016"
"38920","520540 CERES",1,0,4,281,1,287,"2016"
"38921","520545 CEZARINA",0,0,2,119,0,121,"2016"
"38922","520547 CHAPADAO DO CEU",0,0,0,186,1,187,"2016"
"38923","520549 CIDADE OCIDENTAL",5,1,22,988,36,1052,"2016"
"38924","520551 COCALZINHO DE GOIAS",0,1,4,189,36,230,"2016"
"38925","520552 COLINAS DO SUL",0,1,0,37,2,40,"2016"
"38926","520570 CORREGO DO OURO",0,0,1,27,0,28,"2016"
"38927","520580 CORUMBA DE GOIAS",0,0,1,87,0,88,"2016"
"38928","520590 CORUMBAIBA",0,0,0,96,0,96,"2016"
"38929","520620 CRISTALINA",2,1,9,874,14,900,"2016"
"38930","520630 CRISTIANOPOLIS",0,0,1,24,0,25,"2016"
"38931","520640 CRIXAS",0,1,4,201,1,207,"2016"
"38932","520650 CROMINIA",0,0,1,32,1,34,"2016"
"38933","520660 CUMARI",0,0,0,20,1,21,"2016"
"38934","520670 DAMIANOPOLIS",0,0,1,45,0,46,"2016"
"38935","520680 DAMOLANDIA",0,0,1,34,0,35,"2016"
"38936","520690 DAVINOPOLIS",0,0,0,16,0,16,"2016"
"38937","520710 DIORAMA",0,0,0,16,0,16,"2016"
"38938","520725 DOVERLANDIA",0,0,11,86,0,97,"2016"
"38939","520735 EDEALINA",0,0,2,47,0,49,"2016"
"38940","520740 EDEIA",1,0,2,128,0,131,"2016"
"38941","520750 ESTRELA DO NORTE",0,0,2,36,0,38,"2016"
"38942","520753 FAINA",0,1,1,59,0,61,"2016"
"38943","520760 FAZENDA NOVA",0,0,0,49,0,49,"2016"
"38944","520780 FIRMINOPOLIS",0,1,0,93,0,94,"2016"
"38945","520790 FLORES DE GOIAS",0,0,1,73,1,75,"2016"
"38946","520800 FORMOSA",2,2,14,1764,2,1784,"2016"
"38947","520810 FORMOSO",0,0,0,52,0,52,"2016"
"38948","520815 GAMELEIRA DE GOIAS",0,0,0,34,0,34,"2016"
"38949","520830 DIVINOPOLIS DE GOIAS",1,0,0,79,2,82,"2016"
"38950","520840 GOIANAPOLIS",0,2,5,189,2,198,"2016"
"38951","520850 GOIANDIRA",1,0,0,54,0,55,"2016"
"38952","520860 GOIANESIA",1,4,27,957,0,989,"2016"
"38953","520870 GOIANIA",63,76,261,20605,120,21125,"2016"
"38954","520880 GOIANIRA",2,4,10,851,8,875,"2016"
"38955","520890 GOIAS",0,0,3,279,1,283,"2016"
"38956","520910 GOIATUBA",1,1,2,433,0,437,"2016"
"38957","520915 GOUVELANDIA",0,0,0,41,0,41,"2016"
"38958","520920 GUAPO",2,0,2,199,0,203,"2016"
"38959","520929 GUARAITA",0,0,0,22,0,22,"2016"
"38960","520940 GUARANI DE GOIAS",0,0,0,31,0,31,"2016"
"38961","520945 GUARINOS",0,1,1,30,0,32,"2016"
"38962","520960 HEITORAI",0,0,0,29,0,29,"2016"
"38963","520970 HIDROLANDIA",0,0,5,336,0,341,"2016"
"38964","520980 HIDROLINA",0,0,0,44,0,44,"2016"
"38965","520990 IACIARA",1,0,3,152,1,157,"2016"
"38966","520993 INACIOLANDIA",0,0,0,68,0,68,"2016"
"38967","520995 INDIARA",1,0,4,225,3,233,"2016"
"38968","521000 INHUMAS",0,3,17,699,2,721,"2016"
"38969","521010 IPAMERI",1,1,0,338,1,341,"2016"
"38970","521015 IPIRANGA DE GOIAS",0,0,1,30,0,31,"2016"
"38971","521020 IPORA",0,1,3,420,1,425,"2016"
"38972","521030 ISRAELANDIA",0,0,0,22,0,22,"2016"
"38973","521040 ITABERAI",1,1,12,537,2,553,"2016"
"38974","521056 ITAGUARI",0,1,1,57,0,59,"2016"
"38975","521060 ITAGUARU",0,0,0,44,0,44,"2016"
"38976","521080 ITAJA",0,0,2,49,0,51,"2016"
"38977","521090 ITAPACI",0,0,8,255,0,263,"2016"
"38978","521100 ITAPIRAPUA",0,0,0,120,0,120,"2016"
"38979","521120 ITAPURANGA",3,0,3,348,0,354,"2016"
"38980","521130 ITARUMA",0,0,0,95,0,95,"2016"
"38981","521140 ITAUCU",0,1,1,69,1,72,"2016"
"38982","521150 ITUMBIARA",2,4,15,1359,4,1384,"2016"
"38983","521160 IVOLANDIA",0,0,1,26,0,27,"2016"
"38984","521170 JANDAIA",0,1,3,68,1,73,"2016"
"38985","521180 JARAGUA",0,6,6,557,2,571,"2016"
"38986","521190 JATAI",4,4,22,1435,0,1465,"2016"
"38987","521200 JAUPACI",0,0,0,25,0,25,"2016"
"38988","521205 JESUPOLIS",0,0,0,25,1,26,"2016"
"38989","521210 JOVIANIA",0,0,0,68,0,68,"2016"
"38990","521220 JUSSARA",0,0,3,259,0,262,"2016"
"38991","521225 LAGOA SANTA",0,0,0,20,0,20,"2016"
"38992","521230 LEOPOLDO DE BULHOES",0,0,1,101,1,103,"2016"
"38993","521250 LUZIANIA",5,5,52,2717,127,2906,"2016"
"38994","521260 MAIRIPOTABA",0,0,0,22,0,22,"2016"
"38995","521270 MAMBAI",0,0,4,109,0,113,"2016"
"38996","521280 MARA ROSA",1,0,4,106,1,112,"2016"
"38997","521290 MARZAGAO",0,0,0,34,0,34,"2016"
"38998","521295 MATRINCHA",1,0,0,42,0,43,"2016"
"38999","521300 MAURILANDIA",0,4,0,149,0,153,"2016"
"39000","521305 MIMOSO DE GOIAS",0,0,1,11,10,22,"2016"
"39001","521308 MINACU",0,3,4,427,0,434,"2016"
"39002","521310 MINEIROS",2,5,16,1084,3,1110,"2016"
"39003","521340 MOIPORA",0,0,0,20,0,20,"2016"
"39004","521350 MONTE ALEGRE DE GOIAS",0,0,1,114,0,115,"2016"
"39005","521370 MONTES CLAROS DE GOIAS",1,0,1,80,0,82,"2016"
"39006","521375 MONTIVIDIU",0,1,6,172,0,179,"2016"
"39007","521377 MONTIVIDIU DO NORTE",0,0,6,32,0,38,"2016"
"39008","521380 MORRINHOS",1,0,7,555,4,567,"2016"
"39009","521385 MORRO AGUDO DE GOIAS",0,0,0,27,0,27,"2016"
"39010","521390 MOSSAMEDES",0,0,3,55,1,59,"2016"
"39011","521400 MOZARLANDIA",0,2,1,174,0,177,"2016"
"39012","521405 MUNDO NOVO",0,1,0,72,0,73,"2016"
"39013","521410 MUTUNOPOLIS",0,1,2,63,0,66,"2016"
"39014","521440 NAZARIO",0,1,1,90,0,92,"2016"
"39015","521450 NEROPOLIS",0,1,8,476,1,486,"2016"
"39016","521460 NIQUELANDIA",1,3,4,419,0,427,"2016"
"39017","521470 NOVA AMERICA",0,0,0,20,0,20,"2016"
"39018","521480 NOVA AURORA",0,0,0,24,0,24,"2016"
"39019","521483 NOVA CRIXAS",0,0,0,163,0,163,"2016"
"39020","521486 NOVA GLORIA",0,0,2,96,0,98,"2016"
"39021","521487 NOVA IGUACU DE GOIAS",0,0,0,39,0,39,"2016"
"39022","521490 NOVA ROMA",1,0,1,22,0,24,"2016"
"39023","521500 NOVA VENEZA",1,0,1,95,0,97,"2016"
"39024","521520 NOVO BRASIL",0,0,1,50,1,52,"2016"
"39025","521523 NOVO GAMA",7,4,20,1446,21,1498,"2016"
"39026","521525 NOVO PLANALTO",0,1,4,27,0,32,"2016"
"39027","521530 ORIZONA",0,0,2,187,0,189,"2016"
"39028","521540 OURO VERDE DE GOIAS",0,0,0,37,0,37,"2016"
"39029","521550 OUVIDOR",1,0,0,72,0,73,"2016"
"39030","521560 PADRE BERNARDO",2,0,7,128,313,450,"2016"
"39031","521565 PALESTINA DE GOIAS",0,0,0,39,0,39,"2016"
"39032","521570 PALMEIRAS DE GOIAS",2,0,5,384,0,391,"2016"
"39033","521580 PALMELO",0,0,0,20,0,20,"2016"
"39034","521590 PALMINOPOLIS",0,0,1,41,1,43,"2016"
"39035","521600 PANAMA",0,0,0,29,0,29,"2016"
"39036","521630 PARANAIGUARA",0,1,1,108,0,110,"2016"
"39037","521640 PARAUNA",1,1,4,140,1,147,"2016"
"39038","521645 PEROLANDIA",0,0,0,37,0,37,"2016"
"39039","521680 PETROLINA DE GOIAS",0,1,2,78,0,81,"2016"
"39040","521690 PILAR DE GOIAS",0,0,1,35,0,36,"2016"
"39041","521710 PIRACANJUBA",0,0,4,206,3,213,"2016"
"39042","521720 PIRANHAS",0,2,4,128,0,134,"2016"
"39043","521730 PIRENOPOLIS",1,2,3,270,3,279,"2016"
"39044","521740 PIRES DO RIO",1,1,2,343,0,347,"2016"
"39045","521760 PLANALTINA",9,9,23,1547,8,1596,"2016"
"39046","521770 PONTALINA",0,0,1,203,0,204,"2016"
"39047","521800 PORANGATU",0,3,26,551,0,580,"2016"
"39048","521805 PORTEIRAO",0,0,0,48,0,48,"2016"
"39049","521810 PORTELANDIA",0,0,0,51,0,51,"2016"
"39050","521830 POSSE",0,1,25,527,0,553,"2016"
"39051","521839 PROFESSOR JAMIL",0,0,0,26,0,26,"2016"
"39052","521850 QUIRINOPOLIS",4,3,6,623,1,637,"2016"
"39053","521860 RIALMA",0,0,2,159,0,161,"2016"
"39054","521870 RIANAPOLIS",0,0,3,59,0,62,"2016"
"39055","521878 RIO QUENTE",0,1,1,49,0,51,"2016"
"39056","521880 RIO VERDE",7,6,28,3341,4,3386,"2016"
"39057","521890 RUBIATABA",1,1,6,252,0,260,"2016"
"39058","521900 SANCLERLANDIA",0,1,1,82,0,84,"2016"
"39059","521910 SANTA BARBARA DE GOIAS",0,0,1,103,0,104,"2016"
"39060","521920 SANTA CRUZ DE GOIAS",0,1,1,23,1,26,"2016"
"39061","521925 SANTA FE DE GOIAS",0,0,0,66,0,66,"2016"
"39062","521930 SANTA HELENA DE GOIAS",2,1,6,531,2,542,"2016"
"39063","521935 SANTA ISABEL",0,0,0,41,0,41,"2016"
"39064","521940 SANTA RITA DO ARAGUAIA",1,0,1,93,0,95,"2016"
"39065","521945 SANTA RITA DO NOVO DESTINO",0,0,1,20,1,22,"2016"
"39066","521950 SANTA ROSA DE GOIAS",0,0,1,35,1,37,"2016"
"39067","521960 SANTA TEREZA DE GOIAS",0,0,1,27,0,28,"2016"
"39068","521970 SANTA TEREZINHA DE GOIAS",0,0,1,153,0,154,"2016"
"39069","521971 SANTO ANTONIO DA BARRA",0,0,2,46,0,48,"2016"
"39070","521973 SANTO ANTONIO DE GOIAS",0,0,2,71,2,75,"2016"
"39071","521975 SANTO ANTONIO DO DESCOBERTO",2,3,11,1023,22,1061,"2016"
"39072","521980 SAO DOMINGOS",0,2,7,110,0,119,"2016"
"39073","521990 SAO FRANCISCO DE GOIAS",0,0,0,89,0,89,"2016"
"39074","522000 SAO JOAO D'ALIANCA",1,0,1,126,1,129,"2016"
"39075","522005 SAO JOAO DA PARAUNA",0,0,0,20,0,20,"2016"
"39076","522010 SAO LUIS DE MONTES BELOS",0,1,3,396,1,401,"2016"
"39077","522015 SAO LUIZ DO NORTE",0,0,1,56,0,57,"2016"
"39078","522020 SAO MIGUEL DO ARAGUAIA",1,0,2,324,0,327,"2016"
"39079","522026 SAO MIGUEL DO PASSA QUATRO",0,0,1,33,0,34,"2016"
"39080","522028 SAO PATRICIO",0,0,1,27,0,28,"2016"
"39081","522040 SAO SIMAO",0,0,1,262,0,263,"2016"
"39082","522045 SENADOR CANEDO",5,10,30,2172,6,2223,"2016"
"39083","522050 SERRANOPOLIS",0,0,5,77,1,83,"2016"
"39084","522060 SILVANIA",1,0,2,271,1,275,"2016"
"39085","522068 SIMOLANDIA",1,3,5,56,0,65,"2016"
"39086","522070 SITIO D'ABADIA",0,0,0,17,0,17,"2016"
"39087","522100 TAQUARAL DE GOIAS",0,0,0,45,0,45,"2016"
"39088","522108 TERESINA DE GOIAS",0,0,0,48,0,48,"2016"
"39089","522119 TEREZOPOLIS DE GOIAS",0,1,1,109,0,111,"2016"
"39090","522130 TRES RANCHOS",0,0,1,21,0,22,"2016"
"39091","522140 TRINDADE",1,4,28,1826,11,1870,"2016"
"39092","522145 TROMBAS",0,0,1,30,0,31,"2016"
"39093","522150 TURVANIA",0,0,0,51,0,51,"2016"
"39094","522155 TURVELANDIA",0,0,2,63,0,65,"2016"
"39095","522157 UIRAPURU",0,0,1,19,0,20,"2016"
"39096","522160 URUACU",1,7,34,514,2,558,"2016"
"39097","522170 URUANA",0,0,5,132,0,137,"2016"
"39098","522180 URUTAI",0,0,0,17,0,17,"2016"
"39099","522185 VALPARAISO DE GOIAS",4,7,34,2291,77,2413,"2016"
"39100","522190 VARJAO",0,0,0,38,0,38,"2016"
"39101","522200 VIANOPOLIS",0,1,1,163,1,166,"2016"
"39102","522205 VICENTINOPOLIS",0,0,1,105,0,106,"2016"
"39103","522220 VILA BOA",0,1,1,57,0,59,"2016"
"39104","522230 VILA PROPICIO",0,0,0,47,1,48,"2016"
"39105","530010 BRASILIA",178,160,635,41253,1114,43340,"2016"
"39106","TOTAL",7544,11674,43933,2798132,62252,2923535,"2017"
"39107","110001 ALTA FLORESTA D'OESTE",0,1,5,347,1,354,"2017"
"39108","110002 ARIQUEMES",8,6,14,1693,3,1724,"2017"
"39109","110003 CABIXI",0,1,0,66,0,67,"2017"
"39110","110004 CACOAL",4,5,15,1428,0,1452,"2017"
"39111","110005 CEREJEIRAS",0,0,3,273,1,277,"2017"
"39112","110006 COLORADO DO OESTE",1,0,2,238,2,243,"2017"
"39113","110007 CORUMBIARA",2,0,1,84,0,87,"2017"
"39114","110008 COSTA MARQUES",0,4,8,202,2,216,"2017"
"39115","110009 ESPIGAO D'OESTE",1,1,7,523,1,533,"2017"
"39116","110010 GUAJARA-MIRIM",0,0,6,710,126,842,"2017"
"39117","110011 JARU",1,4,9,832,0,846,"2017"
"39118","110012 JI-PARANA",4,10,35,1998,3,2050,"2017"
"39119","110013 MACHADINHO D'OESTE",0,3,6,439,1,449,"2017"
"39120","110014 NOVA BRASILANDIA D'OESTE",0,0,3,221,0,224,"2017"
"39121","110015 OURO PRETO DO OESTE",2,1,14,559,2,578,"2017"
"39122","110018 PIMENTA BUENO",0,2,14,599,0,615,"2017"
"39123","110020 PORTO VELHO",9,20,84,8610,77,8800,"2017"
"39124","110025 PRESIDENTE MEDICI",2,3,6,277,1,289,"2017"
"39125","110026 RIO CRESPO",0,0,0,49,0,49,"2017"
"39126","110028 ROLIM DE MOURA",1,3,4,955,0,963,"2017"
"39127","110029 SANTA LUZIA D'OESTE",0,0,1,111,0,112,"2017"
"39128","110030 VILHENA",0,2,14,1438,11,1465,"2017"
"39129","110032 SAO MIGUEL DO GUAPORE",0,1,7,363,1,372,"2017"
"39130","110033 NOVA MAMORE",1,2,3,429,52,487,"2017"
"39131","110034 ALVORADA D'OESTE",0,0,2,176,0,178,"2017"
"39132","110037 ALTO ALEGRE DOS PARECIS",0,0,1,170,1,172,"2017"
"39133","110040 ALTO PARAISO",0,1,1,240,0,242,"2017"
"39134","110045 BURITIS",1,3,8,619,1,632,"2017"
"39135","110050 NOVO HORIZONTE DO OESTE",0,1,2,88,0,91,"2017"
"39136","110060 CACAULANDIA",0,0,2,69,0,71,"2017"
"39137","110070 CAMPO NOVO DE RONDONIA",0,1,4,167,2,174,"2017"
"39138","110080 CANDEIAS DO JAMARI",0,1,3,387,6,397,"2017"
"39139","110090 CASTANHEIRAS",0,0,1,38,0,39,"2017"
"39140","110092 CHUPINGUAIA",2,1,3,161,2,169,"2017"
"39141","110094 CUJUBIM",0,0,1,205,3,209,"2017"
"39142","110100 GOVERNADOR JORGE TEIXEIRA",1,0,0,108,0,109,"2017"
"39143","110110 ITAPUA DO OESTE",0,0,2,92,1,95,"2017"
"39144","110120 MINISTRO ANDREAZZA",0,0,0,99,1,100,"2017"
"39145","110130 MIRANTE DA SERRA",0,1,0,154,1,156,"2017"
"39146","110140 MONTE NEGRO",0,1,0,199,0,200,"2017"
"39147","110143 NOVA UNIAO",0,1,4,89,0,94,"2017"
"39148","110145 PARECIS",0,1,0,50,0,51,"2017"
"39149","110146 PIMENTEIRAS DO OESTE",0,0,0,50,2,52,"2017"
"39150","110147 PRIMAVERA DE RONDONIA",0,0,1,62,0,63,"2017"
"39151","110148 SAO FELIPE D'OESTE",0,0,0,75,0,75,"2017"
"39152","110149 SAO FRANCISCO DO GUAPORE",1,0,9,323,0,333,"2017"
"39153","110150 SERINGUEIRAS",0,0,1,187,0,188,"2017"
"39154","110155 TEIXEIROPOLIS",0,0,1,57,0,58,"2017"
"39155","110160 THEOBROMA",0,0,0,146,0,146,"2017"
"39156","110170 URUPA",0,0,3,147,0,150,"2017"
"39157","110175 VALE DO ANARI",1,0,1,84,0,86,"2017"
"39158","110180 VALE DO PARAISO",0,0,2,77,0,79,"2017"
"39159","120001 ACRELANDIA",0,2,5,237,12,256,"2017"
"39160","120005 ASSIS BRASIL",1,2,3,210,32,248,"2017"
"39161","120010 BRASILEIA",1,3,9,546,11,570,"2017"
"39162","120013 BUJARI",0,0,8,290,9,307,"2017"
"39163","120017 CAPIXABA",0,1,2,225,15,243,"2017"
"39164","120020 CRUZEIRO DO SUL",3,4,22,1624,31,1684,"2017"
"39165","120025 EPITACIOLANDIA",1,1,5,279,5,291,"2017"
"39166","120030 FEIJO",3,7,9,685,129,833,"2017"
"39167","120032 JORDAO",0,2,2,131,131,266,"2017"
"39168","120033 MANCIO LIMA",0,0,3,346,9,358,"2017"
"39169","120034 MANOEL URBANO",1,1,3,241,15,261,"2017"
"39170","120035 MARECHAL THAUMATURGO",0,0,2,176,210,388,"2017"
"39171","120038 PLACIDO DE CASTRO",0,2,4,288,11,305,"2017"
"39172","120039 PORTO WALTER",0,2,4,270,6,282,"2017"
"39173","120040 RIO BRANCO",5,25,75,6139,216,6460,"2017"
"39174","120042 RODRIGUES ALVES",1,0,5,335,25,366,"2017"
"39175","120043 SANTA ROSA DO PURUS",0,1,2,84,111,198,"2017"
"39176","120045 SENADOR GUIOMARD",0,3,3,373,16,395,"2017"
"39177","120050 SENA MADUREIRA",3,2,14,735,26,780,"2017"
"39178","120060 TARAUACA",5,7,12,1033,75,1132,"2017"
"39179","120070 XAPURI",0,2,4,291,8,305,"2017"
"39180","120080 PORTO ACRE",0,2,5,403,20,430,"2017"
"39181","MUNICIPIO IGNORADO - AM",1,0,1,15,0,17,"2017"
"39182","130002 ALVARAES",3,2,3,392,1,401,"2017"
"39183","130006 AMATURA",5,1,0,169,92,267,"2017"
"39184","130008 ANAMA",2,2,5,187,0,196,"2017"
"39185","130010 ANORI",0,2,8,238,9,257,"2017"
"39186","130014 APUI",1,3,11,218,0,233,"2017"
"39187","130020 ATALAIA DO NORTE",0,1,4,243,134,382,"2017"
"39188","130030 AUTAZES",2,1,6,805,83,897,"2017"
"39189","130040 BARCELOS",1,1,1,320,201,524,"2017"
"39190","130050 BARREIRINHA",2,2,9,690,167,870,"2017"
"39191","130060 BENJAMIN CONSTANT",2,2,10,1018,7,1039,"2017"
"39192","130063 BERURI",1,2,12,483,99,597,"2017"
"39193","130068 BOA VISTA DO RAMOS",1,1,7,310,0,319,"2017"
"39194","130070 BOCA DO ACRE",1,1,10,751,8,771,"2017"
"39195","130080 BORBA",2,1,6,719,69,797,"2017"
"39196","130083 CAAPIRANGA",1,0,3,195,17,216,"2017"
"39197","130090 CANUTAMA",0,2,1,185,3,191,"2017"
"39198","130100 CARAUARI",17,1,6,377,225,626,"2017"
"39199","130110 CAREIRO",0,1,6,477,28,512,"2017"
"39200","130115 CAREIRO DA VARZEA",0,0,0,209,28,237,"2017"
"39201","130120 COARI",3,13,11,1625,4,1656,"2017"
"39202","130130 CODAJAS",1,2,1,431,4,439,"2017"
"39203","130140 EIRUNEPE",2,16,25,692,119,854,"2017"
"39204","130150 ENVIRA",0,2,0,376,46,424,"2017"
"39205","130160 FONTE BOA",5,2,5,618,0,630,"2017"
"39206","130165 GUAJARA",0,2,3,307,14,326,"2017"
"39207","130170 HUMAITA",2,3,12,982,2,1001,"2017"
"39208","130180 IPIXUNA",2,0,0,322,85,409,"2017"
"39209","130185 IRANDUBA",2,0,7,914,18,941,"2017"
"39210","130190 ITACOATIARA",13,8,16,1870,78,1985,"2017"
"39211","130195 ITAMARATI",0,0,0,180,65,245,"2017"
"39212","130200 ITAPIRANGA",0,1,1,163,0,165,"2017"
"39213","130210 JAPURA",0,2,0,132,27,161,"2017"
"39214","130220 JURUA",1,0,3,217,32,253,"2017"
"39215","130230 JUTAI",2,0,4,546,107,659,"2017"
"39216","130240 LABREA",4,7,71,633,26,741,"2017"
"39217","130250 MANACAPURU",5,3,10,1916,4,1938,"2017"
"39218","130255 MANAQUIRI",1,1,4,294,0,300,"2017"
"39219","130260 MANAUS",112,99,374,37728,185,38498,"2017"
"39220","130270 MANICORE",4,9,36,814,126,989,"2017"
"39221","130280 MARAA",0,2,5,375,36,418,"2017"
"39222","130290 MAUES",2,6,19,1210,316,1553,"2017"
"39223","130300 NHAMUNDA",1,1,8,305,43,358,"2017"
"39224","130310 NOVA OLINDA DO NORTE",1,1,14,502,74,592,"2017"
"39225","130320 NOVO AIRAO",0,0,3,322,8,333,"2017"
"39226","130330 NOVO ARIPUANA",4,4,9,363,26,406,"2017"
"39227","130340 PARINTINS",16,13,26,1971,113,2139,"2017"
"39228","130350 PAUINI",1,1,1,350,2,355,"2017"
"39229","130353 PRESIDENTE FIGUEIREDO",1,2,4,512,4,523,"2017"
"39230","130356 RIO PRETO DA EVA",1,2,4,415,0,422,"2017"
"39231","130360 SANTA ISABEL DO RIO NEGRO",0,8,51,154,157,370,"2017"
"39232","130370 SANTO ANTONIO DO ICA",2,2,0,580,140,724,"2017"
"39233","130380 SAO GABRIEL DA CACHOEIRA",3,2,17,519,673,1214,"2017"
"39234","130390 SAO PAULO DE OLIVENCA",1,0,15,425,558,999,"2017"
"39235","130395 SAO SEBASTIAO DO UATUMA",1,1,3,198,3,206,"2017"
"39236","130400 SILVES",0,0,0,234,12,246,"2017"
"39237","130406 TABATINGA",2,0,8,1221,470,1701,"2017"
"39238","130410 TAPAUA",0,5,6,379,15,405,"2017"
"39239","130420 TEFE",12,9,16,1647,79,1763,"2017"
"39240","130423 TONANTINS",3,1,4,411,39,458,"2017"
"39241","130426 UARINI",2,1,28,276,26,333,"2017"
"39242","130430 URUCARA",0,0,2,260,8,270,"2017"
"39243","130440 URUCURITUBA",3,4,5,275,28,315,"2017"
"39244","140002 AMAJARI",5,0,2,174,174,355,"2017"
"39245","140005 ALTO ALEGRE",5,0,2,191,328,526,"2017"
"39246","140010 BOA VISTA",66,14,61,6872,30,7043,"2017"
"39247","140015 BONFIM",10,3,1,318,45,377,"2017"
"39248","140017 CANTA",17,3,2,314,16,352,"2017"
"39249","140020 CARACARAI",7,2,3,345,50,407,"2017"
"39250","140023 CAROEBE",1,0,2,177,3,183,"2017"
"39251","140028 IRACEMA",1,0,2,122,29,154,"2017"
"39252","140030 MUCAJAI",1,0,2,287,19,309,"2017"
"39253","140040 NORMANDIA",11,1,1,328,74,415,"2017"
"39254","140045 PACARAIMA",5,2,0,336,37,380,"2017"
"39255","140047 RORAINOPOLIS",4,1,3,555,0,563,"2017"
"39256","140050 SAO JOAO DA BALIZA",1,0,1,120,0,122,"2017"
"39257","140060 SAO LUIZ",0,1,0,105,0,106,"2017"
"39258","140070 UIRAMUTA",10,0,1,241,193,445,"2017"
"39259","MUNICIPIO IGNORADO - PA",0,0,0,2,0,2,"2017"
"39260","150010 ABAETETUBA",2,14,33,2647,17,2713,"2017"
"39261","150013 ABEL FIGUEIREDO",0,2,2,138,0,142,"2017"
"39262","150020 ACARA",7,4,8,957,16,992,"2017"
"39263","150030 AFUA",1,4,15,940,8,968,"2017"
"39264","150034 AGUA AZUL DO NORTE",0,1,0,213,1,215,"2017"
"39265","150040 ALENQUER",6,6,10,1050,60,1132,"2017"
"39266","150050 ALMEIRIM",2,4,18,698,23,745,"2017"
"39267","150060 ALTAMIRA",30,6,26,2382,43,2487,"2017"
"39268","150070 ANAJAS",4,4,29,676,142,855,"2017"
"39269","150080 ANANINDEUA",24,16,93,7783,24,7940,"2017"
"39270","150085 ANAPU",1,2,3,621,3,630,"2017"
"39271","150090 AUGUSTO CORREA",5,4,10,813,103,935,"2017"
"39272","150095 AURORA DO PARA",1,1,26,372,1,401,"2017"
"39273","150100 AVEIRO",1,3,4,126,26,160,"2017"
"39274","150110 BAGRE",4,4,7,338,200,553,"2017"
"39275","150120 BAIAO",2,5,12,560,51,630,"2017"
"39276","150125 BANNACH",0,0,0,49,0,49,"2017"
"39277","150130 BARCARENA",1,7,22,2117,7,2154,"2017"
"39278","150140 BELEM",33,61,188,19056,71,19409,"2017"
"39279","150145 BELTERRA",1,3,11,247,10,272,"2017"
"39280","150150 BENEVIDES",1,1,9,1028,2,1041,"2017"
"39281","150157 BOM JESUS DO TOCANTINS",0,2,1,220,2,225,"2017"
"39282","150160 BONITO",0,0,3,180,1,184,"2017"
"39283","150170 BRAGANCA",2,10,24,1993,70,2099,"2017"
"39284","150172 BRASIL NOVO",2,0,6,325,0,333,"2017"
"39285","150175 BREJO GRANDE DO ARAGUAIA",1,1,0,91,0,93,"2017"
"39286","150178 BREU BRANCO",1,2,11,666,105,785,"2017"
"39287","150180 BREVES",8,19,102,2591,3,2723,"2017"
"39288","150190 BUJARU",0,2,8,438,25,473,"2017"
"39289","150195 CACHOEIRA DO PIRIA",1,1,2,276,31,311,"2017"
"39290","150200 CACHOEIRA DO ARARI",0,2,6,322,0,330,"2017"
"39291","150210 CAMETA",24,15,75,2209,94,2417,"2017"
"39292","150215 CANAA DOS CARAJAS",1,4,13,1215,1,1234,"2017"
"39293","150220 CAPANEMA",3,1,14,1010,12,1040,"2017"
"39294","150230 CAPITAO POCO",4,8,3,790,10,815,"2017"
"39295","150240 CASTANHAL",6,9,27,3149,5,3196,"2017"
"39296","150250 CHAVES",0,4,1,331,36,372,"2017"
"39297","150260 COLARES",2,0,3,158,1,164,"2017"
"39298","150270 CONCEICAO DO ARAGUAIA",2,3,6,765,1,777,"2017"
"39299","150275 CONCORDIA DO PARA",5,6,7,469,11,498,"2017"
"39300","150276 CUMARU DO NORTE",1,1,3,157,4,166,"2017"
"39301","150277 CURIONOPOLIS",2,2,5,281,0,290,"2017"
"39302","150280 CURRALINHO",3,4,19,610,97,733,"2017"
"39303","150285 CURUA",0,4,4,142,42,192,"2017"
"39304","150290 CURUCA",1,4,1,479,6,491,"2017"
"39305","150293 DOM ELISEU",1,1,22,667,1,692,"2017"
"39306","150295 ELDORADO DOS CARAJAS",1,0,4,406,2,413,"2017"
"39307","150300 FARO",0,2,2,145,4,153,"2017"
"39308","150304 FLORESTA DO ARAGUAIA",0,1,1,331,4,337,"2017"
"39309","150307 GARRAFAO DO NORTE",0,1,4,378,28,411,"2017"
"39310","150309 GOIANESIA DO PARA",3,1,8,521,12,545,"2017"
"39311","150310 GURUPA",5,2,6,670,73,756,"2017"
"39312","150320 IGARAPE-ACU",1,2,4,554,3,564,"2017"
"39313","150330 IGARAPE-MIRI",2,3,12,986,44,1047,"2017"
"39314","150340 INHANGAPI",1,0,2,168,4,175,"2017"
"39315","150345 IPIXUNA DO PARA",0,3,12,560,19,594,"2017"
"39316","150350 IRITUIA",4,2,4,398,12,420,"2017"
"39317","150360 ITAITUBA",6,23,88,2249,11,2377,"2017"
"39318","150370 ITUPIRANGA",0,0,6,758,17,781,"2017"
"39319","150375 JACAREACANGA",0,1,2,363,253,619,"2017"
"39320","150380 JACUNDA",0,3,12,715,7,737,"2017"
"39321","150390 JURUTI",3,6,31,910,92,1042,"2017"
"39322","150400 LIMOEIRO DO AJURU",2,4,7,366,23,402,"2017"
"39323","150405 MAE DO RIO",1,1,2,551,4,559,"2017"
"39324","150410 MAGALHAES BARATA",0,0,0,90,0,90,"2017"
"39325","150420 MARABA",9,10,46,4649,50,4764,"2017"
"39326","150430 MARACANA",0,0,8,347,7,362,"2017"
"39327","150440 MARAPANIM",2,2,2,308,10,324,"2017"
"39328","150442 MARITUBA",2,2,20,1761,9,1794,"2017"
"39329","150445 MEDICILANDIA",2,3,10,444,4,463,"2017"
"39330","150450 MELGACO",1,2,7,397,155,562,"2017"
"39331","150460 MOCAJUBA",0,0,5,470,10,485,"2017"
"39332","150470 MOJU",36,4,16,1165,8,1229,"2017"
"39333","150475 MOJUI DOS CAMPOS",1,0,5,215,8,229,"2017"
"39334","150480 MONTE ALEGRE",3,11,42,1050,1,1107,"2017"
"39335","150490 MUANA",3,8,16,544,1,572,"2017"
"39336","150495 NOVA ESPERANCA DO PIRIA",1,1,11,371,2,386,"2017"
"39337","150497 NOVA IPIXUNA",0,0,4,213,1,218,"2017"
"39338","150500 NOVA TIMBOTEUA",0,0,0,161,0,161,"2017"
"39339","150503 NOVO PROGRESSO",3,0,11,605,2,621,"2017"
"39340","150506 NOVO REPARTIMENTO",1,2,4,1212,33,1252,"2017"
"39341","150510 OBIDOS",8,3,11,887,110,1019,"2017"
"39342","150520 OEIRAS DO PARA",5,6,24,610,46,691,"2017"
"39343","150530 ORIXIMINA",14,2,35,1313,39,1403,"2017"
"39344","150540 OUREM",0,0,1,299,0,300,"2017"
"39345","150543 OURILANDIA DO NORTE",1,5,7,662,0,675,"2017"
"39346","150548 PACAJA",2,0,2,750,10,764,"2017"
"39347","150549 PALESTINA DO PARA",0,0,1,95,1,97,"2017"
"39348","150550 PARAGOMINAS",7,6,12,1947,5,1977,"2017"
"39349","150553 PARAUAPEBAS",17,18,64,4476,7,4582,"2017"
"39350","150555 PAU D'ARCO",0,0,1,115,0,116,"2017"
"39351","150560 PEIXE-BOI",0,0,0,114,0,114,"2017"
"39352","150563 PICARRA",1,0,1,179,1,182,"2017"
"39353","150565 PLACAS",0,1,7,282,1,291,"2017"
"39354","150570 PONTA DE PEDRAS",2,1,5,337,3,348,"2017"
"39355","150580 PORTEL",1,3,11,1169,305,1489,"2017"
"39356","150590 PORTO DE MOZ",1,2,5,677,16,701,"2017"
"39357","150600 PRAINHA",1,10,10,661,95,777,"2017"
"39358","150610 PRIMAVERA",0,1,1,139,30,171,"2017"
"39359","150611 QUATIPURU",1,0,2,164,2,169,"2017"
"39360","150613 REDENCAO",5,11,31,1688,8,1743,"2017"
"39361","150616 RIO MARIA",0,2,4,267,0,273,"2017"
"39362","150618 RONDON DO PARA",2,2,17,584,3,608,"2017"
"39363","150619 RUROPOLIS",0,2,28,377,4,411,"2017"
"39364","150620 SALINOPOLIS",1,0,0,605,1,607,"2017"
"39365","150630 SALVATERRA",1,3,4,368,2,378,"2017"
"39366","150635 SANTA BARBARA DO PARA",3,2,2,334,4,345,"2017"
"39367","150640 SANTA CRUZ DO ARARI",1,2,0,78,8,89,"2017"
"39368","150650 SANTA IZABEL DO PARA",1,3,14,941,1,960,"2017"
"39369","150655 SANTA LUZIA DO PARA",1,0,3,322,18,344,"2017"
"39370","150658 SANTA MARIA DAS BARREIRAS",1,0,3,139,0,143,"2017"
"39371","150660 SANTA MARIA DO PARA",1,0,1,426,0,428,"2017"
"39372","150670 SANTANA DO ARAGUAIA",3,4,6,555,1,569,"2017"
"39373","150680 SANTAREM",28,50,218,6024,457,6777,"2017"
"39374","150690 SANTAREM NOVO",0,0,0,107,0,107,"2017"
"39375","150700 SANTO ANTONIO DO TAUA",2,2,6,466,7,483,"2017"
"39376","150710 SAO CAETANO DE ODIVELAS",1,1,2,207,4,215,"2017"
"39377","150715 SAO DOMINGOS DO ARAGUAIA",1,1,3,340,0,345,"2017"
"39378","150720 SAO DOMINGOS DO CAPIM",4,4,14,491,12,525,"2017"
"39379","150730 SAO FELIX DO XINGU",5,3,5,1055,3,1071,"2017"
"39380","150740 SAO FRANCISCO DO PARA",0,0,1,204,1,206,"2017"
"39381","150745 SAO GERALDO DO ARAGUAIA",1,0,7,485,1,494,"2017"
"39382","150746 SAO JOAO DA PONTA",0,0,2,81,4,87,"2017"
"39383","150747 SAO JOAO DE PIRABAS",1,2,1,302,3,309,"2017"
"39384","150750 SAO JOAO DO ARAGUAIA",0,0,1,166,3,170,"2017"
"39385","150760 SAO MIGUEL DO GUAMA",3,2,12,928,12,957,"2017"
"39386","150770 SAO SEBASTIAO DA BOA VISTA",2,6,22,489,1,520,"2017"
"39387","150775 SAPUCAIA",2,0,2,91,0,95,"2017"
"39388","150780 SENADOR JOSE PORFIRIO",2,0,1,292,2,297,"2017"
"39389","150790 SOURE",1,1,2,378,0,382,"2017"
"39390","150795 TAILANDIA",3,4,16,1446,3,1472,"2017"
"39391","150796 TERRA ALTA",1,0,2,202,1,206,"2017"
"39392","150797 TERRA SANTA",0,1,5,277,0,283,"2017"
"39393","150800 TOME-ACU",2,8,32,1440,7,1489,"2017"
"39394","150803 TRACUATEUA",2,4,3,550,7,566,"2017"
"39395","150805 TRAIRAO",1,2,9,209,0,221,"2017"
"39396","150808 TUCUMA",1,1,7,692,1,702,"2017"
"39397","150810 TUCURUI",5,5,41,1622,380,2053,"2017"
"39398","150812 ULIANOPOLIS",0,2,14,414,1,431,"2017"
"39399","150815 URUARA",0,1,8,732,2,743,"2017"
"39400","150820 VIGIA",2,3,10,688,4,707,"2017"
"39401","150830 VISEU",1,2,12,886,239,1140,"2017"
"39402","150835 VITORIA DO XINGU",0,2,6,368,1,377,"2017"
"39403","150840 XINGUARA",1,8,17,853,2,881,"2017"
"39404","160005 SERRA DO NAVIO",0,0,1,59,0,60,"2017"
"39405","160010 AMAPA",0,0,3,129,9,141,"2017"
"39406","160015 PEDRA BRANCA DO AMAPARI",1,0,1,211,59,272,"2017"
"39407","160020 CALCOENE",0,0,1,207,2,210,"2017"
"39408","160021 CUTIAS",3,1,0,97,5,106,"2017"
"39409","160023 FERREIRA GOMES",1,1,5,156,1,164,"2017"
"39410","160025 ITAUBAL",0,2,0,109,9,120,"2017"
"39411","160027 LARANJAL DO JARI",2,1,14,787,9,813,"2017"
"39412","160030 MACAPA",28,31,81,9006,123,9269,"2017"
"39413","160040 MAZAGAO",4,3,6,376,61,450,"2017"
"39414","160050 OIAPOQUE",4,6,12,457,78,557,"2017"
"39415","160053 PORTO GRANDE",2,1,4,385,3,395,"2017"
"39416","160055 PRACUUBA",0,0,1,53,26,80,"2017"
"39417","160060 SANTANA",12,10,37,2121,8,2188,"2017"
"39418","160070 TARTARUGALZINHO",1,0,3,203,93,300,"2017"
"39419","160080 VITORIA DO JARI",0,8,10,254,2,274,"2017"
"39420","MUNICIPIO IGNORADO - TO",0,0,0,3,0,3,"2017"
"39421","170025 ABREULANDIA",0,0,0,27,0,27,"2017"
"39422","170030 AGUIARNOPOLIS",0,0,0,76,0,76,"2017"
"39423","170035 ALIANCA DO TOCANTINS",1,0,1,89,2,93,"2017"
"39424","170040 ALMAS",0,0,0,128,0,128,"2017"
"39425","170070 ALVORADA",1,0,4,106,0,111,"2017"
"39426","170100 ANANAS",1,0,1,159,3,164,"2017"
"39427","170105 ANGICO",0,0,1,41,1,43,"2017"
"39428","170110 APARECIDA DO RIO NEGRO",0,0,1,77,1,79,"2017"
"39429","170130 ARAGOMINAS",0,0,2,64,2,68,"2017"
"39430","170190 ARAGUACEMA",0,0,1,111,1,113,"2017"
"39431","170200 ARAGUACU",0,0,1,96,0,97,"2017"
"39432","170210 ARAGUAINA",6,15,44,3020,13,3098,"2017"
"39433","170215 ARAGUANA",0,0,2,95,0,97,"2017"
"39434","170220 ARAGUATINS",1,0,4,490,74,569,"2017"
"39435","170230 ARAPOEMA",0,1,2,99,0,102,"2017"
"39436","170240 ARRAIAS",0,0,1,167,1,169,"2017"
"39437","170255 AUGUSTINOPOLIS",1,1,6,266,38,312,"2017"
"39438","170270 AURORA DO TOCANTINS",0,0,1,40,1,42,"2017"
"39439","170290 AXIXA DO TOCANTINS",1,0,7,136,13,157,"2017"
"39440","170300 BABACULANDIA",0,1,0,105,1,107,"2017"
"39441","170305 BANDEIRANTES DO TOCANTINS",0,1,1,46,0,48,"2017"
"39442","170307 BARRA DO OURO",0,1,2,88,4,95,"2017"
"39443","170310 BARROLANDIA",0,0,1,58,0,59,"2017"
"39444","170320 BERNARDO SAYAO",0,0,0,59,1,60,"2017"
"39445","170330 BOM JESUS DO TOCANTINS",0,0,2,77,1,80,"2017"
"39446","170360 BRASILANDIA DO TOCANTINS",0,0,0,20,2,22,"2017"
"39447","170370 BREJINHO DE NAZARE",0,0,1,78,0,79,"2017"
"39448","170380 BURITI DO TOCANTINS",0,0,1,122,23,146,"2017"
"39449","170382 CACHOEIRINHA",0,0,1,26,2,29,"2017"
"39450","170384 CAMPOS LINDOS",0,0,1,125,15,141,"2017"
"39451","170386 CARIRI DO TOCANTINS",1,0,1,50,0,52,"2017"
"39452","170388 CARMOLANDIA",0,0,1,44,0,45,"2017"
"39453","170389 CARRASCO BONITO",0,0,0,60,16,76,"2017"
"39454","170390 CASEARA",0,0,0,68,1,69,"2017"
"39455","170410 CENTENARIO",0,0,0,25,0,25,"2017"
"39456","170460 CHAPADA DE AREIA",0,0,0,20,0,20,"2017"
"39457","170510 CHAPADA DA NATIVIDADE",0,0,0,37,0,37,"2017"
"39458","170550 COLINAS DO TOCANTINS",1,3,9,576,14,603,"2017"
"39459","170555 COMBINADO",0,0,1,69,1,71,"2017"
"39460","170560 CONCEICAO DO TOCANTINS",0,1,2,55,2,60,"2017"
"39461","170600 COUTO MAGALHAES",1,0,0,79,0,80,"2017"
"39462","170610 CRISTALANDIA",0,1,0,102,0,103,"2017"
"39463","170625 CRIXAS DO TOCANTINS",0,0,0,23,1,24,"2017"
"39464","170650 DARCINOPOLIS",0,0,0,108,2,110,"2017"
"39465","170700 DIANOPOLIS",0,4,6,302,0,312,"2017"
"39466","170710 DIVINOPOLIS DO TOCANTINS",0,1,1,107,0,109,"2017"
"39467","170720 DOIS IRMAOS DO TOCANTINS",0,0,0,56,3,59,"2017"
"39468","170730 DUERE",2,0,0,55,1,58,"2017"
"39469","170740 ESPERANTINA",0,0,4,130,18,152,"2017"
"39470","170755 FATIMA",0,0,0,68,1,69,"2017"
"39471","170765 FIGUEIROPOLIS",0,0,0,76,0,76,"2017"
"39472","170770 FILADELFIA",0,0,3,105,0,108,"2017"
"39473","170820 FORMOSO DO ARAGUAIA",3,2,1,287,4,297,"2017"
"39474","170825 FORTALEZA DO TABOCAO",1,0,0,48,0,49,"2017"
"39475","170830 GOIANORTE",0,1,1,66,0,68,"2017"
"39476","170900 GOIATINS",0,0,4,239,3,246,"2017"
"39477","170930 GUARAI",0,0,8,373,0,381,"2017"
"39478","170950 GURUPI",8,3,13,1317,5,1346,"2017"
"39479","170980 IPUEIRAS",0,0,0,20,0,20,"2017"
"39480","171050 ITACAJA",1,3,7,131,1,143,"2017"
"39481","171070 ITAGUATINS",0,0,0,64,6,70,"2017"
"39482","171090 ITAPIRATINS",0,0,0,62,2,64,"2017"
"39483","171110 ITAPORA DO TOCANTINS",0,0,0,38,0,38,"2017"
"39484","171150 JAU DO TOCANTINS",0,0,2,26,0,28,"2017"
"39485","171180 JUARINA",0,0,2,27,1,30,"2017"
"39486","171190 LAGOA DA CONFUSAO",0,0,3,238,1,242,"2017"
"39487","171195 LAGOA DO TOCANTINS",0,0,2,42,3,47,"2017"
"39488","171200 LAJEADO",0,0,1,60,0,61,"2017"
"39489","171215 LAVANDEIRA",0,0,0,22,0,22,"2017"
"39490","171240 LIZARDA",0,0,1,44,0,45,"2017"
"39491","171245 LUZINOPOLIS",0,0,0,31,3,34,"2017"
"39492","171250 MARIANOPOLIS DO TOCANTINS",0,0,0,65,1,66,"2017"
"39493","171270 MATEIROS",0,1,2,35,0,38,"2017"
"39494","171280 MAURILANDIA DO TOCANTINS",0,0,3,37,3,43,"2017"
"39495","171320 MIRACEMA DO TOCANTINS",2,2,1,285,0,290,"2017"
"39496","171330 MIRANORTE",1,0,2,159,2,164,"2017"
"39497","171360 MONTE DO CARMO",0,1,2,130,1,134,"2017"
"39498","171370 MONTE SANTO DO TOCANTINS",1,0,0,35,0,36,"2017"
"39499","171380 PALMEIRAS DO TOCANTINS",0,0,1,76,0,77,"2017"
"39500","171395 MURICILANDIA",0,1,0,57,2,60,"2017"
"39501","171420 NATIVIDADE",1,3,2,105,0,111,"2017"
"39502","171430 NAZARE",0,1,1,68,0,70,"2017"
"39503","171488 NOVA OLINDA",0,1,3,185,2,191,"2017"
"39504","171500 NOVA ROSALANDIA",0,0,0,52,1,53,"2017"
"39505","171510 NOVO ACORDO",0,1,2,73,4,80,"2017"
"39506","171515 NOVO ALEGRE",0,0,1,23,0,24,"2017"
"39507","171525 NOVO JARDIM",0,0,1,33,0,34,"2017"
"39508","171550 OLIVEIRA DE FATIMA",1,0,1,28,0,30,"2017"
"39509","171570 PALMEIRANTE",0,0,0,71,0,71,"2017"
"39510","171575 PALMEIROPOLIS",0,0,1,70,1,72,"2017"
"39511","171610 PARAISO DO TOCANTINS",1,0,9,855,0,865,"2017"
"39512","171620 PARANA",2,1,1,142,0,146,"2017"
"39513","171630 PAU D'ARCO",0,1,2,56,0,59,"2017"
"39514","171650 PEDRO AFONSO",0,0,10,260,0,270,"2017"
"39515","171660 PEIXE",0,0,1,123,2,126,"2017"
"39516","171665 PEQUIZEIRO",0,0,0,57,0,57,"2017"
"39517","171670 COLMEIA",0,0,0,104,0,104,"2017"
"39518","171700 PINDORAMA DO TOCANTINS",0,0,0,57,1,58,"2017"
"39519","171720 PIRAQUE",0,1,0,46,0,47,"2017"
"39520","171750 PIUM",0,0,0,95,1,96,"2017"
"39521","171780 PONTE ALTA DO BOM JESUS",0,1,0,52,0,53,"2017"
"39522","171790 PONTE ALTA DO TOCANTINS",0,0,0,117,0,117,"2017"
"39523","171800 PORTO ALEGRE DO TOCANTINS",0,0,2,37,0,39,"2017"
"39524","171820 PORTO NACIONAL",3,2,15,1189,4,1213,"2017"
"39525","171830 PRAIA NORTE",0,0,6,86,14,106,"2017"
"39526","171840 PRESIDENTE KENNEDY",0,0,0,41,0,41,"2017"
"39527","171845 PUGMIL",1,0,0,31,0,32,"2017"
"39528","171850 RECURSOLANDIA",0,0,1,52,1,54,"2017"
"39529","171855 RIACHINHO",0,0,2,57,1,60,"2017"
"39530","171865 RIO DA CONCEICAO",0,0,2,35,1,38,"2017"
"39531","171870 RIO DOS BOIS",0,0,2,40,0,42,"2017"
"39532","171875 RIO SONO",0,1,1,64,3,69,"2017"
"39533","171880 SAMPAIO",1,0,0,61,16,78,"2017"
"39534","171884 SANDOLANDIA",0,0,0,39,0,39,"2017"
"39535","171886 SANTA FE DO ARAGUAIA",0,2,1,98,0,101,"2017"
"39536","171888 SANTA MARIA DO TOCANTINS",0,0,0,41,0,41,"2017"
"39537","171889 SANTA RITA DO TOCANTINS",0,1,1,27,0,29,"2017"
"39538","171890 SANTA ROSA DO TOCANTINS",0,0,0,79,1,80,"2017"
"39539","171900 SANTA TEREZA DO TOCANTINS",0,0,1,59,4,64,"2017"
"39540","172000 SANTA TEREZINHA DO TOCANTINS",1,0,0,32,0,33,"2017"
"39541","172010 SAO BENTO DO TOCANTINS",0,0,2,71,3,76,"2017"
"39542","172015 SAO FELIX DO TOCANTINS",1,0,0,19,0,20,"2017"
"39543","172020 SAO MIGUEL DO TOCANTINS",1,0,5,164,2,172,"2017"
"39544","172025 SAO SALVADOR DO TOCANTINS",0,0,0,30,0,30,"2017"
"39545","172030 SAO SEBASTIAO DO TOCANTINS",0,0,0,54,8,62,"2017"
"39546","172049 SAO VALERIO",0,1,2,53,0,56,"2017"
"39547","172065 SILVANOPOLIS",0,1,2,80,0,83,"2017"
"39548","172080 SITIO NOVO DO TOCANTINS",0,0,1,131,3,135,"2017"
"39549","172085 SUCUPIRA",0,0,0,21,0,21,"2017"
"39550","172090 TAGUATINGA",0,1,4,197,1,203,"2017"
"39551","172093 TAIPAS DO TOCANTINS",0,0,0,16,0,16,"2017"
"39552","172097 TALISMA",0,0,2,39,1,42,"2017"
"39553","172100 PALMAS",13,3,42,5079,26,5163,"2017"
"39554","172110 TOCANTINIA",0,0,1,190,2,193,"2017"
"39555","172120 TOCANTINOPOLIS",0,4,11,474,6,495,"2017"
"39556","172125 TUPIRAMA",0,0,0,24,0,24,"2017"
"39557","172130 TUPIRATINS",0,0,1,20,0,21,"2017"
"39558","172208 WANDERLANDIA",0,0,0,131,2,133,"2017"
"39559","172210 XAMBIOA",1,1,3,221,0,226,"2017"
"39560","MUNICIPIO IGNORADO - MA",0,0,0,4,0,4,"2017"
"39561","210005 ACAILANDIA",2,10,35,1850,5,1902,"2017"
"39562","210010 AFONSO CUNHA",1,0,1,99,2,103,"2017"
"39563","210015 AGUA DOCE DO MARANHAO",0,2,4,153,9,168,"2017"
"39564","210020 ALCANTARA",0,0,6,171,52,229,"2017"
"39565","210030 ALDEIAS ALTAS",0,1,16,414,1,432,"2017"
"39566","210040 ALTAMIRA DO MARANHAO",0,0,4,83,1,88,"2017"
"39567","210043 ALTO ALEGRE DO MARANHAO",0,1,7,409,2,419,"2017"
"39568","210047 ALTO ALEGRE DO PINDARE",2,3,7,458,9,479,"2017"
"39569","210050 ALTO PARNAIBA",0,1,3,153,18,175,"2017"
"39570","210055 AMAPA DO MARANHAO",0,0,4,144,2,150,"2017"
"39571","210060 AMARANTE DO MARANHAO",1,2,16,758,44,821,"2017"
"39572","210070 ANAJATUBA",1,1,9,261,57,329,"2017"
"39573","210080 ANAPURUS",0,0,3,304,4,311,"2017"
"39574","210083 APICUM-ACU",0,2,2,51,192,247,"2017"
"39575","210087 ARAGUANA",0,1,5,185,3,194,"2017"
"39576","210090 ARAIOSES",1,3,28,458,38,528,"2017"
"39577","210095 ARAME",2,2,15,590,1,610,"2017"
"39578","210100 ARARI",1,2,16,422,38,479,"2017"
"39579","210110 AXIXA",1,0,2,164,4,171,"2017"
"39580","210120 BACABAL",5,8,36,1478,13,1540,"2017"
"39581","210125 BACABEIRA",1,2,8,265,3,279,"2017"
"39582","210130 BACURI",1,3,2,75,162,243,"2017"
"39583","210135 BACURITUBA",2,0,0,68,3,73,"2017"
"39584","210140 BALSAS",6,4,13,1376,685,2084,"2017"
"39585","210150 BARAO DE GRAJAU",1,2,6,253,0,262,"2017"
"39586","210160 BARRA DO CORDA",4,3,17,1616,41,1681,"2017"
"39587","210170 BARREIRINHAS",1,2,4,1157,23,1187,"2017"
"39588","210173 BELAGUA",0,0,3,49,130,182,"2017"
"39589","210177 BELA VISTA DO MARANHAO",0,2,2,200,1,205,"2017"
"39590","210180 BENEDITO LEITE",0,0,2,41,23,66,"2017"
"39591","210190 BEQUIMAO",1,2,4,113,170,290,"2017"
"39592","210193 BERNARDO DO MEARIM",0,1,0,65,0,66,"2017"
"39593","210197 BOA VISTA DO GURUPI",1,0,3,128,10,142,"2017"
"39594","210200 BOM JARDIM",2,1,10,579,91,683,"2017"
"39595","210203 BOM JESUS DAS SELVAS",1,1,13,520,5,540,"2017"
"39596","210207 BOM LUGAR",1,2,1,138,6,148,"2017"
"39597","210210 BREJO",0,1,5,538,1,545,"2017"
"39598","210215 BREJO DE AREIA",0,1,3,123,9,136,"2017"
"39599","210220 BURITI",1,5,18,491,14,529,"2017"
"39600","210230 BURITI BRAVO",9,4,7,394,1,415,"2017"
"39601","210232 BURITICUPU",7,8,27,1315,9,1366,"2017"
"39602","210235 BURITIRANA",0,1,7,199,8,215,"2017"
"39603","210237 CACHOEIRA GRANDE",0,0,4,151,13,168,"2017"
"39604","210240 CAJAPIO",0,0,1,25,143,169,"2017"
"39605","210250 CAJARI",0,1,1,166,86,254,"2017"
"39606","210255 CAMPESTRE DO MARANHAO",1,2,8,222,0,233,"2017"
"39607","210260 CANDIDO MENDES",0,0,6,263,38,307,"2017"
"39608","210270 CANTANHEDE",1,1,5,257,36,300,"2017"
"39609","210275 CAPINZAL DO NORTE",1,0,1,178,5,185,"2017"
"39610","210280 CAROLINA",1,2,9,316,2,330,"2017"
"39611","210290 CARUTAPERA",1,1,14,421,4,441,"2017"
"39612","210300 CAXIAS",2,4,58,2525,16,2605,"2017"
"39613","210310 CEDRAL",2,0,1,56,40,99,"2017"
"39614","210312 CENTRAL DO MARANHAO",0,1,0,99,34,134,"2017"
"39615","210315 CENTRO DO GUILHERME",3,16,9,170,4,202,"2017"
"39616","210317 CENTRO NOVO DO MARANHAO",1,0,4,267,25,297,"2017"
"39617","210320 CHAPADINHA",8,5,25,1418,14,1470,"2017"
"39618","210325 CIDELANDIA",0,0,5,196,10,211,"2017"
"39619","210330 CODO",7,17,86,1879,40,2029,"2017"
"39620","210340 COELHO NETO",1,7,24,742,1,775,"2017"
"39621","210350 COLINAS",0,2,7,654,7,670,"2017"
"39622","210355 CONCEICAO DO LAGO-ACU",1,2,10,205,18,236,"2017"
"39623","210360 COROATA",4,4,16,1056,20,1100,"2017"
"39624","210370 CURURUPU",3,4,2,175,276,460,"2017"
"39625","210375 DAVINOPOLIS",0,1,8,225,1,235,"2017"
"39626","210380 DOM PEDRO",0,2,8,323,13,346,"2017"
"39627","210390 DUQUE BACELAR",0,0,9,172,2,183,"2017"
"39628","210400 ESPERANTINOPOLIS",3,0,11,301,1,316,"2017"
"39629","210405 ESTREITO",2,4,18,599,2,625,"2017"
"39630","210407 FEIRA NOVA DO MARANHAO",0,0,1,70,24,95,"2017"
"39631","210408 FERNANDO FALCAO",0,0,2,146,101,249,"2017"
"39632","210409 FORMOSA DA SERRA NEGRA",0,0,0,104,152,256,"2017"
"39633","210410 FORTALEZA DOS NOGUEIRAS",0,1,2,209,46,258,"2017"
"39634","210420 FORTUNA",1,3,7,319,9,339,"2017"
"39635","210430 GODOFREDO VIANA",0,4,5,159,5,173,"2017"
"39636","210440 GONCALVES DIAS",1,0,1,59,204,265,"2017"
"39637","210450 GOVERNADOR ARCHER",0,0,2,161,4,167,"2017"
"39638","210455 GOVERNADOR EDISON LOBAO",0,1,4,265,2,272,"2017"
"39639","210460 GOVERNADOR EUGENIO BARROS",0,0,7,274,2,283,"2017"
"39640","210462 GOVERNADOR LUIZ ROCHA",1,3,4,92,12,112,"2017"
"39641","210465 GOVERNADOR NEWTON BELLO",1,1,9,124,0,135,"2017"
"39642","210467 GOVERNADOR NUNES FREIRE",3,3,2,436,4,448,"2017"
"39643","210470 GRACA ARANHA",0,0,2,49,1,52,"2017"
"39644","210480 GRAJAU",1,1,26,1483,59,1570,"2017"
"39645","210490 GUIMARAES",1,1,3,160,11,176,"2017"
"39646","210500 HUMBERTO DE CAMPOS",3,2,5,452,48,510,"2017"
"39647","210510 ICATU",1,2,10,348,33,394,"2017"
"39648","210515 IGARAPE DO MEIO",1,0,0,234,7,242,"2017"
"39649","210520 IGARAPE GRANDE",1,0,0,130,0,131,"2017"
"39650","210530 IMPERATRIZ",11,16,134,4858,32,5051,"2017"
"39651","210535 ITAIPAVA DO GRAJAU",2,0,4,289,8,303,"2017"
"39652","210540 ITAPECURU MIRIM",1,2,5,508,742,1258,"2017"
"39653","210542 ITINGA DO MARANHAO",0,0,8,294,0,302,"2017"
"39654","210545 JATOBA",0,0,2,127,2,131,"2017"
"39655","210547 JENIPAPO DOS VIEIRAS",3,4,2,298,54,361,"2017"
"39656","210550 JOAO LISBOA",1,1,11,458,5,476,"2017"
"39657","210560 JOSELANDIA",1,2,7,218,7,235,"2017"
"39658","210565 JUNCO DO MARANHAO",1,0,1,129,4,135,"2017"
"39659","210570 LAGO DA PEDRA",4,3,10,828,1,846,"2017"
"39660","210580 LAGO DO JUNCO",0,1,0,197,0,198,"2017"
"39661","210590 LAGO VERDE",1,1,18,248,5,273,"2017"
"39662","210592 LAGOA DO MATO",0,0,2,145,0,147,"2017"
"39663","210594 LAGO DOS RODRIGUES",1,0,1,122,1,125,"2017"
"39664","210596 LAGOA GRANDE DO MARANHAO",0,0,2,182,8,192,"2017"
"39665","210598 LAJEADO NOVO",0,0,0,87,1,88,"2017"
"39666","210600 LIMA CAMPOS",1,0,3,181,0,185,"2017"
"39667","210610 LORETO",0,1,1,30,133,165,"2017"
"39668","210620 LUIS DOMINGUES",0,0,1,68,61,130,"2017"
"39669","210630 MAGALHAES DE ALMEIDA",1,1,5,196,8,211,"2017"
"39670","210632 MARACACUME",1,4,9,356,3,373,"2017"
"39671","210635 MARAJA DO SENA",2,0,0,84,2,88,"2017"
"39672","210637 MARANHAOZINHO",1,3,6,193,7,210,"2017"
"39673","210640 MATA ROMA",1,2,5,306,7,321,"2017"
"39674","210650 MATINHA",0,0,3,54,320,377,"2017"
"39675","210660 MATOES",1,0,8,489,4,502,"2017"
"39676","210663 MATOES DO NORTE",0,1,1,78,32,112,"2017"
"39677","210667 MILAGRES DO MARANHAO",1,0,3,62,0,66,"2017"
"39678","210670 MIRADOR",0,0,4,318,5,327,"2017"
"39679","210675 MIRANDA DO NORTE",1,0,4,311,41,357,"2017"
"39680","210680 MIRINZAL",0,0,0,43,188,231,"2017"
"39681","210690 MONCAO",0,0,4,594,11,609,"2017"
"39682","210700 MONTES ALTOS",0,0,2,171,4,177,"2017"
"39683","210710 MORROS",3,2,6,347,17,375,"2017"
"39684","210720 NINA RODRIGUES",0,0,14,161,44,219,"2017"
"39685","210725 NOVA COLINAS",0,0,0,97,10,107,"2017"
"39686","210730 NOVA IORQUE",0,0,1,16,13,30,"2017"
"39687","210735 NOVA OLINDA DO MARANHAO",0,2,6,237,2,247,"2017"
"39688","210740 OLHO D'AGUA DAS CUNHAS",1,1,3,288,0,293,"2017"
"39689","210745 OLINDA NOVA DO MARANHAO",1,1,0,91,114,207,"2017"
"39690","210750 PACO DO LUMIAR",3,4,42,1638,35,1722,"2017"
"39691","210760 PALMEIRANDIA",1,2,2,186,125,316,"2017"
"39692","210770 PARAIBANO",3,1,5,316,2,327,"2017"
"39693","210780 PARNARAMA",0,3,8,449,58,518,"2017"
"39694","210790 PASSAGEM FRANCA",0,1,3,363,1,368,"2017"
"39695","210800 PASTOS BONS",0,1,1,30,292,324,"2017"
"39696","210805 PAULINO NEVES",1,1,4,321,19,346,"2017"
"39697","210810 PAULO RAMOS",3,3,8,292,0,306,"2017"
"39698","210820 PEDREIRAS",3,1,6,520,4,534,"2017"
"39699","210825 PEDRO DO ROSARIO",3,3,11,252,70,339,"2017"
"39700","210830 PENALVA",3,1,8,666,33,711,"2017"
"39701","210840 PERI MIRIM",0,0,4,108,11,123,"2017"
"39702","210845 PERITORO",1,0,7,369,2,379,"2017"
"39703","210850 PINDARE-MIRIM",0,1,9,520,3,533,"2017"
"39704","210860 PINHEIRO",2,16,42,1491,68,1619,"2017"
"39705","210870 PIO XII",2,3,4,378,4,391,"2017"
"39706","210880 PIRAPEMAS",1,1,7,244,15,268,"2017"
"39707","210890 POCAO DE PEDRAS",0,2,4,240,12,258,"2017"
"39708","210900 PORTO FRANCO",0,2,7,419,2,430,"2017"
"39709","210905 PORTO RICO DO MARANHAO",1,0,0,39,26,66,"2017"
"39710","210910 PRESIDENTE DUTRA",2,3,9,864,5,883,"2017"
"39711","210920 PRESIDENTE JUSCELINO",0,3,5,171,29,208,"2017"
"39712","210923 PRESIDENTE MEDICI",0,0,0,85,3,88,"2017"
"39713","210927 PRESIDENTE SARNEY",1,2,15,306,69,393,"2017"
"39714","210930 PRESIDENTE VARGAS",0,1,1,137,77,216,"2017"
"39715","210940 PRIMEIRA CRUZ",0,2,2,145,28,177,"2017"
"39716","210945 RAPOSA",2,1,11,482,6,502,"2017"
"39717","210950 RIACHAO",0,1,2,318,43,364,"2017"
"39718","210955 RIBAMAR FIQUENE",1,0,2,110,4,117,"2017"
"39719","210960 ROSARIO",2,2,9,542,17,572,"2017"
"39720","210970 SAMBAIBA",0,0,1,52,8,61,"2017"
"39721","210975 SANTA FILOMENA DO MARANHAO",0,0,2,86,0,88,"2017"
"39722","210980 SANTA HELENA",1,1,3,420,120,545,"2017"
"39723","210990 SANTA INES",4,6,17,1567,5,1599,"2017"
"39724","211000 SANTA LUZIA",1,2,7,1077,66,1153,"2017"
"39725","211003 SANTA LUZIA DO PARUA",1,0,4,368,3,376,"2017"
"39726","211010 SANTA QUITERIA DO MARANHAO",2,0,20,484,4,510,"2017"
"39727","211020 SANTA RITA",2,5,31,532,15,585,"2017"
"39728","211023 SANTANA DO MARANHAO",0,1,7,90,9,107,"2017"
"39729","211027 SANTO AMARO DO MARANHAO",2,0,3,130,58,193,"2017"
"39730","211030 SANTO ANTONIO DOS LOPES",0,0,14,154,67,235,"2017"
"39731","211040 SAO BENEDITO DO RIO PRETO",2,1,3,93,274,373,"2017"
"39732","211050 SAO BENTO",6,1,2,554,2,565,"2017"
"39733","211060 SAO BERNARDO",1,0,9,407,28,445,"2017"
"39734","211065 SAO DOMINGOS DO AZEITAO",1,0,3,32,98,134,"2017"
"39735","211070 SAO DOMINGOS DO MARANHAO",2,1,7,603,28,641,"2017"
"39736","211080 SAO FELIX DE BALSAS",0,1,0,17,26,44,"2017"
"39737","211085 SAO FRANCISCO DO BREJAO",0,2,0,133,2,137,"2017"
"39738","211090 SAO FRANCISCO DO MARANHAO",2,0,4,154,5,165,"2017"
"39739","211100 SAO JOAO BATISTA",2,2,3,164,70,241,"2017"
"39740","211102 SAO JOAO DO CARU",1,4,38,199,3,245,"2017"
"39741","211105 SAO JOAO DO PARAISO",0,0,3,146,0,149,"2017"
"39742","211107 SAO JOAO DO SOTER",0,1,11,240,0,252,"2017"
"39743","211110 SAO JOAO DOS PATOS",0,2,9,400,2,413,"2017"
"39744","211120 SAO JOSE DE RIBAMAR",17,9,70,3099,41,3236,"2017"
"39745","211125 SAO JOSE DOS BASILIOS",0,0,0,87,3,90,"2017"
"39746","211130 SAO LUIS",96,68,297,14921,167,15549,"2017"
"39747","211140 SAO LUIS GONZAGA DO MARANHAO",0,0,4,316,2,322,"2017"
"39748","211150 SAO MATEUS DO MARANHAO",2,4,10,665,10,691,"2017"
"39749","211153 SAO PEDRO DA AGUA BRANCA",2,0,3,137,1,143,"2017"
"39750","211157 SAO PEDRO DOS CRENTES",0,0,1,82,1,84,"2017"
"39751","211160 SAO RAIMUNDO DAS MANGABEIRAS",0,2,1,164,153,320,"2017"
"39752","211163 SAO RAIMUNDO DO DOCA BEZERRA",0,0,2,60,1,63,"2017"
"39753","211167 SAO ROBERTO",0,0,6,67,4,77,"2017"
"39754","211170 SAO VICENTE FERRER",1,0,2,148,126,277,"2017"
"39755","211172 SATUBINHA",0,0,4,100,0,104,"2017"
"39756","211174 SENADOR ALEXANDRE COSTA",0,1,4,200,1,206,"2017"
"39757","211176 SENADOR LA ROCQUE",0,1,5,254,4,264,"2017"
"39758","211178 SERRANO DO MARANHAO",1,2,0,60,115,178,"2017"
"39759","211180 SITIO NOVO",0,1,9,278,15,303,"2017"
"39760","211190 SUCUPIRA DO NORTE",0,1,1,117,5,124,"2017"
"39761","211195 SUCUPIRA DO RIACHAO",0,0,5,66,1,72,"2017"
"39762","211200 TASSO FRAGOSO",0,0,2,102,23,127,"2017"
"39763","211210 TIMBIRAS",1,4,3,523,1,532,"2017"
"39764","211220 TIMON",8,8,32,2755,7,2810,"2017"
"39765","211223 TRIZIDELA DO VALE",1,1,2,364,3,371,"2017"
"39766","211227 TUFILANDIA",0,0,3,111,0,114,"2017"
"39767","211230 TUNTUM",2,4,13,514,1,534,"2017"
"39768","211240 TURIACU",0,0,4,36,672,712,"2017"
"39769","211245 TURILANDIA",0,1,4,220,126,351,"2017"
"39770","211250 TUTOIA",2,6,16,898,36,958,"2017"
"39771","211260 URBANO SANTOS",0,1,6,176,473,656,"2017"
"39772","211270 VARGEM GRANDE",0,7,27,801,68,903,"2017"
"39773","211280 VIANA",5,4,17,900,87,1013,"2017"
"39774","211285 VILA NOVA DOS MARTIRIOS",0,0,1,167,4,172,"2017"
"39775","211290 VITORIA DO MEARIM",1,0,3,320,169,493,"2017"
"39776","211300 VITORINO FREIRE",1,1,10,489,2,503,"2017"
"39777","211400 ZE DOCA",1,8,13,689,5,716,"2017"
"39778","220005 ACAUA",0,0,0,89,16,105,"2017"
"39779","220010 AGRICOLANDIA",0,0,0,80,1,81,"2017"
"39780","220020 AGUA BRANCA",1,0,16,287,4,308,"2017"
"39781","220025 ALAGOINHA DO PIAUI",0,1,2,82,0,85,"2017"
"39782","220027 ALEGRETE DO PIAUI",0,1,1,75,0,77,"2017"
"39783","220030 ALTO LONGA",0,0,1,137,8,146,"2017"
"39784","220040 ALTOS",3,5,8,594,33,643,"2017"
"39785","220045 ALVORADA DO GURGUEIA",0,0,2,45,44,91,"2017"
"39786","220050 AMARANTE",0,4,8,257,5,274,"2017"
"39787","220060 ANGICAL DO PIAUI",0,2,0,82,1,85,"2017"
"39788","220070 ANISIO DE ABREU",0,0,2,93,29,124,"2017"
"39789","220080 ANTONIO ALMEIDA",0,0,0,32,9,41,"2017"
"39790","220090 AROAZES",0,0,1,62,0,63,"2017"
"39791","220095 AROEIRAS DO ITAIM",0,1,1,18,0,20,"2017"
"39792","220100 ARRAIAL",0,1,0,58,1,60,"2017"
"39793","220105 ASSUNCAO DO PIAUI",0,0,0,105,6,111,"2017"
"39794","220110 AVELINO LOPES",0,0,2,102,86,190,"2017"
"39795","220115 BAIXA GRANDE DO RIBEIRO",1,3,0,190,56,250,"2017"
"39796","220117 BARRA D'ALCANTARA",0,0,1,41,2,44,"2017"
"39797","220120 BARRAS",6,6,14,689,23,738,"2017"
"39798","220130 BARREIRAS DO PIAUI",0,0,1,12,26,39,"2017"
"39799","220140 BARRO DURO",0,0,3,78,0,81,"2017"
"39800","220150 BATALHA",3,3,6,340,0,352,"2017"
"39801","220155 BELA VISTA DO PIAUI",0,1,0,38,0,39,"2017"
"39802","220157 BELEM DO PIAUI",1,0,0,38,0,39,"2017"
"39803","220160 BENEDITINOS",0,1,4,102,14,121,"2017"
"39804","220170 BERTOLINIA",0,0,0,66,3,69,"2017"
"39805","220173 BETANIA DO PIAUI",1,1,0,86,16,104,"2017"
"39806","220177 BOA HORA",0,0,0,44,29,73,"2017"
"39807","220180 BOCAINA",1,1,1,36,0,39,"2017"
"39808","220190 BOM JESUS",1,1,2,257,206,467,"2017"
"39809","220191 BOM PRINCIPIO DO PIAUI",1,0,2,96,1,100,"2017"
"39810","220192 BONFIM DO PIAUI",0,0,0,65,20,85,"2017"
"39811","220194 BOQUEIRAO DO PIAUI",0,0,0,26,71,97,"2017"
"39812","220196 BRASILEIRA",0,0,0,85,0,85,"2017"
"39813","220198 BREJO DO PIAUI",0,0,1,39,4,44,"2017"
"39814","220200 BURITI DOS LOPES",1,2,5,320,0,328,"2017"
"39815","220202 BURITI DOS MONTES",0,0,0,52,26,78,"2017"
"39816","220205 CABECEIRAS DO PIAUI",1,0,0,43,57,101,"2017"
"39817","220207 CAJAZEIRAS DO PIAUI",0,0,0,38,0,38,"2017"
"39818","220208 CAJUEIRO DA PRAIA",1,1,2,103,3,110,"2017"
"39819","220209 CALDEIRAO GRANDE DO PIAUI",0,0,0,65,0,65,"2017"
"39820","220210 CAMPINAS DO PIAUI",0,0,0,56,0,56,"2017"
"39821","220211 CAMPO ALEGRE DO FIDALGO",0,0,2,58,0,60,"2017"
"39822","220213 CAMPO GRANDE DO PIAUI",0,0,5,61,0,66,"2017"
"39823","220217 CAMPO LARGO DO PIAUI",0,1,8,86,1,96,"2017"
"39824","220220 CAMPO MAIOR",2,0,7,194,402,605,"2017"
"39825","220225 CANAVIEIRA",0,0,2,42,3,47,"2017"
"39826","220230 CANTO DO BURITI",0,4,7,236,21,268,"2017"
"39827","220240 CAPITAO DE CAMPOS",0,0,1,128,39,168,"2017"
"39828","220245 CAPITAO GERVASIO OLIVEIRA",0,0,2,46,0,48,"2017"
"39829","220250 CARACOL",0,2,1,91,104,198,"2017"
"39830","220253 CARAUBAS DO PIAUI",0,0,2,75,1,78,"2017"
"39831","220255 CARIDADE DO PIAUI",0,0,4,77,1,82,"2017"
"39832","220260 CASTELO DO PIAUI",0,1,1,146,164,312,"2017"
"39833","220265 CAXINGO",1,3,4,72,2,82,"2017"
"39834","220270 COCAL",1,2,6,402,7,418,"2017"
"39835","220271 COCAL DE TELHA",0,0,1,27,29,57,"2017"
"39836","220272 COCAL DOS ALVES",0,0,2,59,0,61,"2017"
"39837","220273 COIVARAS",1,0,1,38,8,48,"2017"
"39838","220275 COLONIA DO GURGUEIA",1,0,1,71,8,81,"2017"
"39839","220277 COLONIA DO PIAUI",0,0,0,102,0,102,"2017"
"39840","220280 CONCEICAO DO CANINDE",0,1,1,74,1,77,"2017"
"39841","220285 CORONEL JOSE DIAS",0,1,1,38,9,49,"2017"
"39842","220290 CORRENTE",0,1,1,51,397,450,"2017"
"39843","220300 CRISTALANDIA DO PIAUI",0,0,1,18,78,97,"2017"
"39844","220310 CRISTINO CASTRO",0,0,1,91,69,161,"2017"
"39845","220320 CURIMATA",0,2,4,65,115,186,"2017"
"39846","220323 CURRAIS",1,0,0,22,47,70,"2017"
"39847","220325 CURRALINHOS",1,0,1,66,0,68,"2017"
"39848","220327 CURRAL NOVO DO PIAUI",0,0,0,68,5,73,"2017"
"39849","220330 DEMERVAL LOBAO",1,2,4,255,2,264,"2017"
"39850","220335 DIRCEU ARCOVERDE",0,1,0,57,38,96,"2017"
"39851","220340 DOM EXPEDITO LOPES",0,0,0,72,0,72,"2017"
"39852","220342 DOMINGOS MOURAO",0,1,2,55,1,59,"2017"
"39853","220345 DOM INOCENCIO",1,0,0,49,25,75,"2017"
"39854","220350 ELESBAO VELOSO",2,0,0,153,0,155,"2017"
"39855","220360 ELISEU MARTINS",0,1,3,40,2,46,"2017"
"39856","220370 ESPERANTINA",2,1,16,629,1,649,"2017"
"39857","220375 FARTURA DO PIAUI",1,0,1,52,23,77,"2017"
"39858","220380 FLORES DO PIAUI",0,0,2,59,1,62,"2017"
"39859","220385 FLORESTA DO PIAUI",0,0,0,28,0,28,"2017"
"39860","220390 FLORIANO",2,9,23,883,1,918,"2017"
"39861","220400 FRANCINOPOLIS",0,0,1,56,1,58,"2017"
"39862","220410 FRANCISCO AYRES",0,0,0,53,0,53,"2017"
"39863","220415 FRANCISCO MACEDO",0,0,2,33,0,35,"2017"
"39864","220420 FRANCISCO SANTOS",1,0,2,93,1,97,"2017"
"39865","220430 FRONTEIRAS",0,0,2,116,1,119,"2017"
"39866","220435 GEMINIANO",0,1,2,85,0,88,"2017"
"39867","220440 GILBUES",0,2,1,94,107,204,"2017"
"39868","220450 GUADALUPE",0,5,4,178,3,190,"2017"
"39869","220455 GUARIBAS",0,0,1,53,30,84,"2017"
"39870","220460 HUGO NAPOLEAO",0,0,1,40,0,41,"2017"
"39871","220465 ILHA GRANDE",0,3,0,161,0,164,"2017"
"39872","220470 INHUMA",0,1,1,180,2,184,"2017"
"39873","220480 IPIRANGA DO PIAUI",0,0,2,108,1,111,"2017"
"39874","220490 ISAIAS COELHO",0,1,2,120,1,124,"2017"
"39875","220500 ITAINOPOLIS",1,1,2,114,0,118,"2017"
"39876","220510 ITAUEIRA",0,1,7,131,0,139,"2017"
"39877","220515 JACOBINA DO PIAUI",0,0,1,38,16,55,"2017"
"39878","220520 JAICOS",0,1,12,256,3,272,"2017"
"39879","220525 JARDIM DO MULATO",0,1,4,49,0,54,"2017"
"39880","220527 JATOBA DO PIAUI",0,0,1,15,30,46,"2017"
"39881","220530 JERUMENHA",0,0,1,65,0,66,"2017"
"39882","220535 JOAO COSTA",0,0,2,33,1,36,"2017"
"39883","220540 JOAQUIM PIRES",0,0,4,214,4,222,"2017"
"39884","220545 JOCA MARQUES",0,0,1,81,0,82,"2017"
"39885","220550 JOSE DE FREITAS",1,4,10,592,10,617,"2017"
"39886","220551 JUAZEIRO DO PIAUI",0,0,0,17,30,47,"2017"
"39887","220552 JULIO BORGES",0,0,2,44,50,96,"2017"
"39888","220553 JUREMA",0,0,0,48,16,64,"2017"
"39889","220554 LAGOINHA DO PIAUI",0,0,4,27,0,31,"2017"
"39890","220555 LAGOA ALEGRE",0,0,0,87,29,116,"2017"
"39891","220556 LAGOA DO BARRO DO PIAUI",0,0,1,58,8,67,"2017"
"39892","220557 LAGOA DE SAO FRANCISCO",1,0,2,67,3,73,"2017"
"39893","220558 LAGOA DO PIAUI",0,0,3,64,0,67,"2017"
"39894","220559 LAGOA DO SITIO",0,0,0,53,0,53,"2017"
"39895","220560 LANDRI SALES",2,0,3,74,0,79,"2017"
"39896","220570 LUIS CORREIA",0,3,13,387,6,409,"2017"
"39897","220580 LUZILANDIA",0,2,10,380,3,395,"2017"
"39898","220585 MADEIRO",1,1,6,123,0,131,"2017"
"39899","220590 MANOEL EMIDIO",0,0,1,71,1,73,"2017"
"39900","220595 MARCOLANDIA",0,1,2,142,0,145,"2017"
"39901","220600 MARCOS PARENTE",0,1,2,66,1,70,"2017"
"39902","220605 MASSAPE DO PIAUI",1,0,1,47,0,49,"2017"
"39903","220610 MATIAS OLIMPIO",0,2,2,164,2,170,"2017"
"39904","220620 MIGUEL ALVES",5,2,9,473,25,514,"2017"
"39905","220630 MIGUEL LEAO",0,0,1,13,0,14,"2017"
"39906","220635 MILTON BRANDAO",0,4,2,67,2,75,"2017"
"39907","220640 MONSENHOR GIL",0,0,2,125,3,130,"2017"
"39908","220650 MONSENHOR HIPOLITO",0,0,1,82,0,83,"2017"
"39909","220660 MONTE ALEGRE DO PIAUI",0,1,4,110,87,202,"2017"
"39910","220665 MORRO CABECA NO TEMPO",0,0,0,37,37,74,"2017"
"39911","220667 MORRO DO CHAPEU DO PIAUI",0,2,2,120,0,124,"2017"
"39912","220669 MURICI DOS PORTELAS",0,2,3,111,3,119,"2017"
"39913","220670 NAZARE DO PIAUI",1,0,2,78,1,82,"2017"
"39914","220672 NAZARIA",0,0,4,154,3,161,"2017"
"39915","220675 NOSSA SENHORA DE NAZARE",1,0,0,12,41,54,"2017"
"39916","220680 NOSSA SENHORA DOS REMEDIOS",0,1,5,129,6,141,"2017"
"39917","220690 NOVO ORIENTE DO PIAUI",1,0,1,68,0,70,"2017"
"39918","220695 NOVO SANTO ANTONIO",0,0,0,37,8,45,"2017"
"39919","220700 OEIRAS",0,5,10,485,3,503,"2017"
"39920","220710 OLHO D'AGUA DO PIAUI",0,0,0,40,0,40,"2017"
"39921","220720 PADRE MARCOS",0,0,3,86,1,90,"2017"
"39922","220730 PAES LANDIM",0,0,1,53,0,54,"2017"
"39923","220735 PAJEU DO PIAUI",0,0,1,27,1,29,"2017"
"39924","220740 PALMEIRA DO PIAUI",0,0,0,39,24,63,"2017"
"39925","220750 PALMEIRAIS",0,1,5,126,59,191,"2017"
"39926","220755 PAQUETA",0,0,3,37,2,42,"2017"
"39927","220760 PARNAGUA",0,0,0,32,137,169,"2017"
"39928","220770 PARNAIBA",3,12,45,2310,7,2377,"2017"
"39929","220775 PASSAGEM FRANCA DO PIAUI",1,1,2,54,0,58,"2017"
"39930","220777 PATOS DO PIAUI",0,0,1,54,2,57,"2017"
"39931","220779 PAU D'ARCO DO PIAUI",1,0,1,29,0,31,"2017"
"39932","220780 PAULISTANA",1,4,3,249,88,345,"2017"
"39933","220785 PAVUSSU",0,0,3,40,5,48,"2017"
"39934","220790 PEDRO II",2,6,8,519,28,563,"2017"
"39935","220793 PEDRO LAURENTINO",0,0,1,24,0,25,"2017"
"39936","220795 NOVA SANTA RITA",0,0,0,49,2,51,"2017"
"39937","220800 PICOS",2,5,28,1053,0,1088,"2017"
"39938","220810 PIMENTEIRAS",1,1,2,135,2,141,"2017"
"39939","220820 PIO IX",0,2,3,213,0,218,"2017"
"39940","220830 PIRACURUCA",1,1,5,447,0,454,"2017"
"39941","220840 PIRIPIRI",1,4,22,978,9,1014,"2017"
"39942","220850 PORTO",0,2,6,257,5,270,"2017"
"39943","220855 PORTO ALEGRE DO PIAUI",0,1,0,27,0,28,"2017"
"39944","220860 PRATA DO PIAUI",0,0,2,45,0,47,"2017"
"39945","220865 QUEIMADA NOVA",0,0,2,64,41,107,"2017"
"39946","220870 REDENCAO DO GURGUEIA",0,0,3,63,75,141,"2017"
"39947","220880 REGENERACAO",0,3,9,252,1,265,"2017"
"39948","220885 RIACHO FRIO",0,0,0,2,64,66,"2017"
"39949","220887 RIBEIRA DO PIAUI",1,0,4,48,2,55,"2017"
"39950","220890 RIBEIRO GONCALVES",0,0,1,16,97,114,"2017"
"39951","220900 RIO GRANDE DO PIAUI",0,0,1,56,13,70,"2017"
"39952","220910 SANTA CRUZ DO PIAUI",0,0,3,59,0,62,"2017"
"39953","220915 SANTA CRUZ DOS MILAGRES",2,0,3,32,0,37,"2017"
"39954","220920 SANTA FILOMENA",1,1,2,94,1,99,"2017"
"39955","220930 SANTA LUZ",0,0,1,34,40,75,"2017"
"39956","220935 SANTANA DO PIAUI",0,1,2,43,0,46,"2017"
"39957","220937 SANTA ROSA DO PIAUI",0,0,1,70,0,71,"2017"
"39958","220940 SANTO ANTONIO DE LISBOA",0,0,1,76,1,78,"2017"
"39959","220945 SANTO ANTONIO DOS MILAGRES",0,0,2,25,0,27,"2017"
"39960","220950 SANTO INACIO DO PIAUI",0,0,0,44,0,44,"2017"
"39961","220955 SAO BRAZ DO PIAUI",0,0,0,48,6,54,"2017"
"39962","220960 SAO FELIX DO PIAUI",0,0,0,29,0,29,"2017"
"39963","220965 SAO FRANCISCO DE ASSIS DO PIAUI",0,1,3,60,1,65,"2017"
"39964","220970 SAO FRANCISCO DO PIAUI",0,0,1,94,1,96,"2017"
"39965","220975 SAO GONCALO DO GURGUEIA",0,0,1,8,31,40,"2017"
"39966","220980 SAO GONCALO DO PIAUI",0,0,1,67,2,70,"2017"
"39967","220985 SAO JOAO DA CANABRAVA",0,0,1,46,0,47,"2017"
"39968","220987 SAO JOAO DA FRONTEIRA",0,0,3,67,1,71,"2017"
"39969","220990 SAO JOAO DA SERRA",0,1,0,52,25,78,"2017"
"39970","220995 SAO JOAO DA VARJOTA",0,0,1,78,0,79,"2017"
"39971","220997 SAO JOAO DO ARRAIAL",0,2,2,145,1,150,"2017"
"39972","221000 SAO JOAO DO PIAUI",2,1,9,355,8,375,"2017"
"39973","221005 SAO JOSE DO DIVINO",0,1,3,51,0,55,"2017"
"39974","221010 SAO JOSE DO PEIXE",0,0,1,58,0,59,"2017"
"39975","221020 SAO JOSE DO PIAUI",0,0,1,68,0,69,"2017"
"39976","221030 SAO JULIAO",0,0,1,63,0,64,"2017"
"39977","221035 SAO LOURENCO DO PIAUI",0,0,0,49,12,61,"2017"
"39978","221037 SAO LUIS DO PIAUI",0,0,1,19,1,21,"2017"
"39979","221038 SAO MIGUEL DA BAIXA GRANDE",0,0,0,14,0,14,"2017"
"39980","221039 SAO MIGUEL DO FIDALGO",0,1,0,34,0,35,"2017"
"39981","221040 SAO MIGUEL DO TAPUIO",0,1,0,171,37,209,"2017"
"39982","221050 SAO PEDRO DO PIAUI",0,2,0,220,8,230,"2017"
"39983","221060 SAO RAIMUNDO NONATO",3,2,5,456,176,642,"2017"
"39984","221062 SEBASTIAO BARROS",1,1,0,12,47,61,"2017"
"39985","221063 SEBASTIAO LEAL",0,0,0,49,9,58,"2017"
"39986","221065 SIGEFREDO PACHECO",0,0,0,37,70,107,"2017"
"39987","221070 SIMOES",0,1,2,223,0,226,"2017"
"39988","221080 SIMPLICIO MENDES",0,1,3,168,3,175,"2017"
"39989","221090 SOCORRO DO PIAUI",0,0,0,48,0,48,"2017"
"39990","221093 SUSSUAPARA",0,0,3,70,0,73,"2017"
"39991","221095 TAMBORIL DO PIAUI",0,0,0,37,6,43,"2017"
"39992","221097 TANQUE DO PIAUI",0,0,1,37,0,38,"2017"
"39993","221100 TERESINA",53,56,151,13706,107,14073,"2017"
"39994","221110 UNIAO",1,4,6,470,222,703,"2017"
"39995","221120 URUCUI",0,1,6,256,156,419,"2017"
"39996","221130 VALENCA DO PIAUI",1,1,3,281,1,287,"2017"
"39997","221135 VARZEA BRANCA",0,0,0,50,19,69,"2017"
"39998","221140 VARZEA GRANDE",2,0,1,58,1,62,"2017"
"39999","221150 VERA MENDES",0,1,2,32,1,36,"2017"
"40000","221160 VILA NOVA DO PIAUI",0,1,2,33,0,36,"2017"
"40001","221170 WALL FERRAZ",0,1,1,32,0,34,"2017"
"40002","230010 ABAIARA",0,0,0,127,2,129,"2017"
"40003","230015 ACARAPE",1,2,4,198,1,206,"2017"
"40004","230020 ACARAU",5,5,21,988,2,1021,"2017"
"40005","230030 ACOPIARA",2,0,17,540,4,563,"2017"
"40006","230040 AIUABA",1,0,7,176,0,184,"2017"
"40007","230050 ALCANTARAS",0,0,4,115,2,121,"2017"
"40008","230060 ALTANEIRA",0,1,2,108,2,113,"2017"
"40009","230070 ALTO SANTO",1,2,0,177,0,180,"2017"
"40010","230075 AMONTADA",3,0,3,131,585,722,"2017"
"40011","230080 ANTONINA DO NORTE",1,4,5,85,1,96,"2017"
"40012","230090 APUIARES",0,0,3,144,5,152,"2017"
"40013","230100 AQUIRAZ",4,0,16,1053,6,1079,"2017"
"40014","230110 ARACATI",1,6,10,973,4,994,"2017"
"40015","230120 ARACOIABA",3,2,13,362,3,383,"2017"
"40016","230125 ARARENDA",0,0,5,115,1,121,"2017"
"40017","230130 ARARIPE",1,5,5,377,2,390,"2017"
"40018","230140 ARATUBA",1,0,7,154,1,163,"2017"
"40019","230150 ARNEIROZ",0,0,3,85,2,90,"2017"
"40020","230160 ASSARE",1,2,4,277,2,286,"2017"
"40021","230170 AURORA",0,4,4,290,1,299,"2017"
"40022","230180 BAIXIO",0,1,2,69,0,72,"2017"
"40023","230185 BANABUIU",1,1,4,251,5,262,"2017"
"40024","230190 BARBALHA",2,7,28,1060,82,1179,"2017"
"40025","230195 BARREIRA",0,1,10,303,3,317,"2017"
"40026","230200 BARRO",0,0,4,254,0,258,"2017"
"40027","230205 BARROQUINHA",0,1,9,214,1,225,"2017"
"40028","230210 BATURITE",1,3,9,469,3,485,"2017"
"40029","230220 BEBERIBE",1,2,15,578,3,599,"2017"
"40030","230230 BELA CRUZ",1,2,11,380,0,394,"2017"
"40031","230240 BOA VIAGEM",4,3,8,620,3,638,"2017"
"40032","230250 BREJO SANTO",2,1,13,720,2,738,"2017"
"40033","230260 CAMOCIM",3,4,21,938,1,967,"2017"
"40034","230270 CAMPOS SALES",0,2,11,345,5,363,"2017"
"40035","230280 CANINDE",0,5,20,1039,8,1072,"2017"
"40036","230290 CAPISTRANO",0,1,2,236,1,240,"2017"
"40037","230300 CARIDADE",0,0,3,235,2,240,"2017"
"40038","230310 CARIRE",1,2,5,182,0,190,"2017"
"40039","230320 CARIRIACU",0,3,24,362,2,391,"2017"
"40040","230330 CARIUS",0,2,9,198,4,213,"2017"
"40041","230340 CARNAUBAL",1,1,6,261,0,269,"2017"
"40042","230350 CASCAVEL",5,7,14,967,10,1003,"2017"
"40043","230360 CATARINA",2,0,5,128,0,135,"2017"
"40044","230365 CATUNDA",0,1,0,122,0,123,"2017"
"40045","230370 CAUCAIA",17,21,83,5261,46,5428,"2017"
"40046","230380 CEDRO",1,2,9,272,2,286,"2017"
"40047","230390 CHAVAL",0,2,6,192,2,202,"2017"
"40048","230393 CHORO",0,0,1,174,1,176,"2017"
"40049","230395 CHOROZINHO",0,1,6,227,1,235,"2017"
"40050","230400 COREAU",3,0,3,262,0,268,"2017"
"40051","230410 CRATEUS",0,8,12,885,8,913,"2017"
"40052","230420 CRATO",4,12,45,2068,9,2138,"2017"
"40053","230423 CROATA",0,0,4,181,2,187,"2017"
"40054","230425 CRUZ",3,2,11,395,1,412,"2017"
"40055","230426 DEPUTADO IRAPUAN PINHEIRO",0,0,3,85,0,88,"2017"
"40056","230427 ERERE",0,1,1,21,0,23,"2017"
"40057","230428 EUSEBIO",3,4,11,1254,1,1273,"2017"
"40058","230430 FARIAS BRITO",0,1,10,236,1,248,"2017"
"40059","230435 FORQUILHA",0,3,9,267,2,281,"2017"
"40060","230440 FORTALEZA",100,143,571,35692,212,36718,"2017"
"40061","230445 FORTIM",0,1,3,189,1,194,"2017"
"40062","230450 FRECHEIRINHA",1,0,2,239,0,242,"2017"
"40063","230460 GENERAL SAMPAIO",1,2,1,100,3,107,"2017"
"40064","230465 GRACA",0,0,3,156,0,159,"2017"
"40065","230470 GRANJA",1,3,19,778,4,805,"2017"
"40066","230480 GRANJEIRO",0,0,1,71,0,72,"2017"
"40067","230490 GROAIRAS",1,2,1,114,1,119,"2017"
"40068","230495 GUAIUBA",0,1,8,331,3,343,"2017"
"40069","230500 GUARACIABA DO NORTE",3,8,18,649,2,680,"2017"
"40070","230510 GUARAMIRANGA",1,0,3,73,0,77,"2017"
"40071","230520 HIDROLANDIA",0,3,3,198,1,205,"2017"
"40072","230523 HORIZONTE",1,4,26,1202,5,1238,"2017"
"40073","230526 IBARETAMA",2,0,6,183,2,193,"2017"
"40074","230530 IBIAPINA",3,4,11,325,3,346,"2017"
"40075","230533 IBICUITINGA",0,0,2,154,0,156,"2017"
"40076","230535 ICAPUI",0,1,3,262,3,269,"2017"
"40077","230540 ICO",1,1,15,887,0,904,"2017"
"40078","230550 IGUATU",2,15,53,1209,9,1288,"2017"
"40079","230560 INDEPENDENCIA",0,2,1,288,5,296,"2017"
"40080","230565 IPAPORANGA",0,1,3,146,1,151,"2017"
"40081","230570 IPAUMIRIM",0,0,4,154,0,158,"2017"
"40082","230580 IPU",0,2,9,573,1,585,"2017"
"40083","230590 IPUEIRAS",0,4,1,480,0,485,"2017"
"40084","230600 IRACEMA",2,2,3,147,1,155,"2017"
"40085","230610 IRAUCUBA",0,1,8,277,2,288,"2017"
"40086","230620 ITAICABA",0,1,1,84,1,87,"2017"
"40087","230625 ITAITINGA",1,4,8,594,4,611,"2017"
"40088","230630 ITAPAGE",1,5,12,701,3,722,"2017"
"40089","230640 ITAPIPOCA",2,2,10,378,1626,2018,"2017"
"40090","230650 ITAPIUNA",3,2,2,219,0,226,"2017"
"40091","230655 ITAREMA",3,6,16,695,4,724,"2017"
"40092","230660 ITATIRA",0,0,9,292,3,304,"2017"
"40093","230670 JAGUARETAMA",0,3,5,176,2,186,"2017"
"40094","230680 JAGUARIBARA",1,0,2,134,0,137,"2017"
"40095","230690 JAGUARIBE",1,1,7,477,1,487,"2017"
"40096","230700 JAGUARUANA",3,3,11,389,0,406,"2017"
"40097","230710 JARDIM",2,3,20,389,26,440,"2017"
"40098","230720 JATI",1,0,3,126,1,131,"2017"
"40099","230725 JIJOCA DE JERICOACOARA",1,0,4,349,1,355,"2017"
"40100","230730 JUAZEIRO DO NORTE",8,25,194,3859,36,4122,"2017"
"40101","230740 JUCAS",2,3,13,322,1,341,"2017"
"40102","230750 LAVRAS DA MANGABEIRA",1,1,2,328,3,335,"2017"
"40103","230760 LIMOEIRO DO NORTE",2,3,17,767,4,793,"2017"
"40104","230763 MADALENA",0,1,5,231,1,238,"2017"
"40105","230765 MARACANAU",13,10,57,4316,24,4420,"2017"
"40106","230770 MARANGUAPE",4,7,26,1475,15,1527,"2017"
"40107","230780 MARCO",1,4,9,475,1,490,"2017"
"40108","230790 MARTINOPOLE",0,0,5,145,1,151,"2017"
"40109","230800 MASSAPE",2,1,12,516,1,532,"2017"
"40110","230810 MAURITI",2,3,16,695,3,719,"2017"
"40111","230820 MERUOCA",0,1,4,207,0,212,"2017"
"40112","230830 MILAGRES",0,2,7,337,4,350,"2017"
"40113","230835 MILHA",0,0,5,147,1,153,"2017"
"40114","230837 MIRAIMA",0,0,0,27,146,173,"2017"
"40115","230840 MISSAO VELHA",2,2,17,528,35,584,"2017"
"40116","230850 MOMBACA",2,3,14,471,0,490,"2017"
"40117","230860 MONSENHOR TABOSA",1,0,7,210,6,224,"2017"
"40118","230870 MORADA NOVA",1,2,11,740,1,755,"2017"
"40119","230880 MORAUJO",0,2,2,105,0,109,"2017"
"40120","230890 MORRINHOS",0,2,3,297,13,315,"2017"
"40121","230900 MUCAMBO",0,0,5,168,0,173,"2017"
"40122","230910 MULUNGU",0,0,3,126,2,131,"2017"
"40123","230920 NOVA OLINDA",1,6,10,249,7,273,"2017"
"40124","230930 NOVA RUSSAS",0,1,6,359,1,367,"2017"
"40125","230940 NOVO ORIENTE",2,0,9,347,6,364,"2017"
"40126","230945 OCARA",0,3,5,278,0,286,"2017"
"40127","230950 OROS",0,1,10,255,0,266,"2017"
"40128","230960 PACAJUS",3,6,18,875,9,911,"2017"
"40129","230970 PACATUBA",3,3,12,980,6,1004,"2017"
"40130","230980 PACOTI",1,0,4,148,1,154,"2017"
"40131","230990 PACUJA",0,0,2,81,0,83,"2017"
"40132","231000 PALHANO",1,0,3,93,1,98,"2017"
"40133","231010 PALMACIA",0,0,0,116,1,117,"2017"
"40134","231020 PARACURU",1,2,7,636,2,648,"2017"
"40135","231025 PARAIPABA",2,3,5,402,5,417,"2017"
"40136","231030 PARAMBU",0,0,19,450,2,471,"2017"
"40137","231040 PARAMOTI",0,0,3,111,1,115,"2017"
"40138","231050 PEDRA BRANCA",0,2,13,518,1,534,"2017"
"40139","231060 PENAFORTE",1,3,4,157,1,166,"2017"
"40140","231070 PENTECOSTE",2,3,16,476,6,503,"2017"
"40141","231080 PEREIRO",0,2,5,179,0,186,"2017"
"40142","231085 PINDORETAMA",1,0,6,309,0,316,"2017"
"40143","231090 PIQUET CARNEIRO",0,2,2,139,1,144,"2017"
"40144","231095 PIRES FERREIRA",1,0,2,108,1,112,"2017"
"40145","231100 PORANGA",0,1,6,174,3,184,"2017"
"40146","231110 PORTEIRAS",0,1,3,265,1,270,"2017"
"40147","231120 POTENGI",0,1,1,123,2,127,"2017"
"40148","231123 POTIRETAMA",0,0,0,80,0,80,"2017"
"40149","231126 QUITERIANOPOLIS",0,2,4,232,4,242,"2017"
"40150","231130 QUIXADA",1,5,26,1262,13,1307,"2017"
"40151","231135 QUIXELO",0,0,9,170,1,180,"2017"
"40152","231140 QUIXERAMOBIM",3,7,31,1006,16,1063,"2017"
"40153","231150 QUIXERE",3,0,3,265,0,271,"2017"
"40154","231160 REDENCAO",0,1,7,403,2,413,"2017"
"40155","231170 RERIUTABA",2,0,10,223,0,235,"2017"
"40156","231180 RUSSAS",5,8,17,952,1,983,"2017"
"40157","231190 SABOEIRO",0,1,5,173,2,181,"2017"
"40158","231195 SALITRE",0,2,4,262,3,271,"2017"
"40159","231200 SANTANA DO ACARAU",4,0,17,389,5,415,"2017"
"40160","231210 SANTANA DO CARIRI",0,3,6,183,2,194,"2017"
"40161","231220 SANTA QUITERIA",1,5,10,475,0,491,"2017"
"40162","231230 SAO BENEDITO",1,4,18,745,1,769,"2017"
"40163","231240 SAO GONCALO DO AMARANTE",2,8,10,921,5,946,"2017"
"40164","231250 SAO JOAO DO JAGUARIBE",0,1,2,80,0,83,"2017"
"40165","231260 SAO LUIS DO CURU",0,0,1,150,7,158,"2017"
"40166","231270 SENADOR POMPEU",0,6,10,303,0,319,"2017"
"40167","231280 SENADOR SA",0,1,2,86,0,89,"2017"
"40168","231290 SOBRAL",10,5,67,3215,8,3305,"2017"
"40169","231300 SOLONOPOLE",0,2,8,198,0,208,"2017"
"40170","231310 TABULEIRO DO NORTE",2,0,6,347,0,355,"2017"
"40171","231320 TAMBORIL",0,2,4,276,4,286,"2017"
"40172","231325 TARRAFAS",2,0,2,105,2,111,"2017"
"40173","231330 TAUA",0,4,20,705,4,733,"2017"
"40174","231335 TEJUCUOCA",1,1,4,219,1,226,"2017"
"40175","231340 TIANGUA",1,11,28,1419,6,1465,"2017"
"40176","231350 TRAIRI",0,4,2,428,399,833,"2017"
"40177","231355 TURURU",0,0,0,40,227,267,"2017"
"40178","231360 UBAJARA",1,3,6,448,1,459,"2017"
"40179","231370 UMARI",0,1,1,86,0,88,"2017"
"40180","231375 UMIRIM",0,2,3,58,211,274,"2017"
"40181","231380 URUBURETAMA",0,1,0,84,258,343,"2017"
"40182","231390 URUOCA",0,1,0,158,0,159,"2017"
"40183","231395 VARJOTA",0,3,4,246,1,254,"2017"
"40184","231400 VARZEA ALEGRE",2,1,8,456,1,468,"2017"
"40185","231410 VICOSA DO CEARA",5,3,14,893,15,930,"2017"
"40186","240010 ACARI",1,1,5,98,0,105,"2017"
"40187","240020 ACU",2,2,8,728,3,743,"2017"
"40188","240030 AFONSO BEZERRA",0,0,1,109,1,111,"2017"
"40189","240040 AGUA NOVA",0,1,0,37,0,38,"2017"
"40190","240050 ALEXANDRIA",1,0,1,168,0,170,"2017"
"40191","240060 ALMINO AFONSO",0,1,0,49,0,50,"2017"
"40192","240070 ALTO DO RODRIGUES",0,1,1,176,1,179,"2017"
"40193","240080 ANGICOS",0,0,1,116,0,117,"2017"
"40194","240090 ANTONIO MARTINS",0,0,2,72,0,74,"2017"
"40195","240100 APODI",0,0,2,365,2,369,"2017"
"40196","240110 AREIA BRANCA",2,4,5,360,2,373,"2017"
"40197","240120 ARES",1,0,1,183,0,185,"2017"
"40198","240130 AUGUSTO SEVERO",1,0,2,100,0,103,"2017"
"40199","240140 BAIA FORMOSA",0,0,4,122,1,127,"2017"
"40200","240145 BARAUNA",1,5,2,386,3,397,"2017"
"40201","240150 BARCELONA",0,0,0,50,1,51,"2017"
"40202","240160 BENTO FERNANDES",1,0,2,63,0,66,"2017"
"40203","240165 BODO",0,0,2,30,0,32,"2017"
"40204","240170 BOM JESUS",1,0,0,121,2,124,"2017"
"40205","240180 BREJINHO",1,2,2,157,2,164,"2017"
"40206","240185 CAICARA DO NORTE",0,0,1,69,5,75,"2017"
"40207","240190 CAICARA DO RIO DO VENTO",0,0,1,47,0,48,"2017"
"40208","240200 CAICO",2,8,22,654,0,686,"2017"
"40209","240210 CAMPO REDONDO",0,2,4,125,4,135,"2017"
"40210","240220 CANGUARETAMA",5,1,11,518,4,539,"2017"
"40211","240230 CARAUBAS",0,0,1,241,2,244,"2017"
"40212","240240 CARNAUBA DOS DANTAS",0,0,5,83,0,88,"2017"
"40213","240250 CARNAUBAIS",0,1,1,112,0,114,"2017"
"40214","240260 CEARA-MIRIM",2,9,21,1091,8,1131,"2017"
"40215","240270 CERRO CORA",0,0,9,114,1,124,"2017"
"40216","240280 CORONEL EZEQUIEL",0,4,3,64,0,71,"2017"
"40217","240290 CORONEL JOAO PESSOA",0,0,0,52,0,52,"2017"
"40218","240300 CRUZETA",0,0,4,90,0,94,"2017"
"40219","240310 CURRAIS NOVOS",0,1,26,478,1,506,"2017"
"40220","240320 DOUTOR SEVERIANO",0,0,0,102,0,102,"2017"
"40221","240325 PARNAMIRIM",8,15,44,3822,9,3898,"2017"
"40222","240330 ENCANTO",0,0,1,96,0,97,"2017"
"40223","240340 EQUADOR",0,0,1,50,0,51,"2017"
"40224","240350 ESPIRITO SANTO",0,2,1,94,1,98,"2017"
"40225","240360 EXTREMOZ",1,4,3,556,5,569,"2017"
"40226","240370 FELIPE GUERRA",0,0,2,63,1,66,"2017"
"40227","240375 FERNANDO PEDROZA",0,0,0,40,0,40,"2017"
"40228","240380 FLORANIA",2,0,6,100,0,108,"2017"
"40229","240390 FRANCISCO DANTAS",0,0,0,45,0,45,"2017"
"40230","240400 FRUTUOSO GOMES",0,0,0,53,0,53,"2017"
"40231","240410 GALINHOS",0,0,1,33,0,34,"2017"
"40232","240420 GOIANINHA",1,2,5,487,0,495,"2017"
"40233","240430 GOVERNADOR DIX-SEPT ROSADO",0,1,0,134,2,137,"2017"
"40234","240440 GROSSOS",0,0,0,124,1,125,"2017"
"40235","240450 GUAMARE",0,1,5,277,0,283,"2017"
"40236","240460 IELMO MARINHO",0,1,0,127,4,132,"2017"
"40237","240470 IPANGUACU",0,1,4,222,3,230,"2017"
"40238","240480 IPUEIRA",0,0,0,25,0,25,"2017"
"40239","240485 ITAJA",2,0,3,92,2,99,"2017"
"40240","240490 ITAU",0,0,0,70,0,70,"2017"
"40241","240500 JACANA",0,0,3,87,0,90,"2017"
"40242","240510 JANDAIRA",0,0,3,84,1,88,"2017"
"40243","240520 JANDUIS",0,0,2,53,0,55,"2017"
"40244","240530 JANUARIO CICCO",1,0,0,141,2,144,"2017"
"40245","240540 JAPI",1,0,3,81,1,86,"2017"
"40246","240550 JARDIM DE ANGICOS",0,0,2,33,0,35,"2017"
"40247","240560 JARDIM DE PIRANHAS",1,1,7,135,0,144,"2017"
"40248","240570 JARDIM DO SERIDO",0,0,1,99,0,100,"2017"
"40249","240580 JOAO CAMARA",2,4,7,491,2,506,"2017"
"40250","240590 JOAO DIAS",0,0,0,35,0,35,"2017"
"40251","240600 JOSE DA PENHA",0,0,0,64,0,64,"2017"
"40252","240610 JUCURUTU",0,2,5,207,1,215,"2017"
"40253","240615 JUNDIA",0,0,0,21,0,21,"2017"
"40254","240620 LAGOA D'ANTA",1,0,1,86,0,88,"2017"
"40255","240630 LAGOA DE PEDRAS",1,0,2,89,2,94,"2017"
"40256","240640 LAGOA DE VELHOS",0,0,1,34,0,35,"2017"
"40257","240650 LAGOA NOVA",3,2,8,202,1,216,"2017"
"40258","240660 LAGOA SALGADA",3,0,2,123,3,131,"2017"
"40259","240670 LAJES",0,1,4,103,1,109,"2017"
"40260","240680 LAJES PINTADAS",0,2,0,81,0,83,"2017"
"40261","240690 LUCRECIA",0,0,0,27,0,27,"2017"
"40262","240700 LUIS GOMES",2,1,2,156,3,164,"2017"
"40263","240710 MACAIBA",2,8,18,1018,6,1052,"2017"
"40264","240720 MACAU",1,1,1,331,1,335,"2017"
"40265","240725 MAJOR SALES",0,0,0,44,0,44,"2017"
"40266","240730 MARCELINO VIEIRA",0,0,1,101,0,102,"2017"
"40267","240740 MARTINS",0,1,1,87,0,89,"2017"
"40268","240750 MAXARANGUAPE",1,2,1,121,3,128,"2017"
"40269","240760 MESSIAS TARGINO",1,0,1,60,0,62,"2017"
"40270","240770 MONTANHAS",0,1,1,171,1,174,"2017"
"40271","240780 MONTE ALEGRE",2,1,2,274,2,281,"2017"
"40272","240790 MONTE DAS GAMELEIRAS",0,0,1,41,0,42,"2017"
"40273","240800 MOSSORO",5,15,36,3874,11,3941,"2017"
"40274","240810 NATAL",24,55,149,11237,28,11493,"2017"
"40275","240820 NISIA FLORESTA",2,3,4,386,4,399,"2017"
"40276","240830 NOVA CRUZ",0,4,8,483,2,497,"2017"
"40277","240840 OLHO-D'AGUA DO BORGES",0,0,0,36,0,36,"2017"
"40278","240850 OURO BRANCO",0,0,2,59,0,61,"2017"
"40279","240860 PARANA",0,1,0,59,0,60,"2017"
"40280","240870 PARAU",1,0,0,41,1,43,"2017"
"40281","240880 PARAZINHO",0,0,0,83,0,83,"2017"
"40282","240890 PARELHAS",0,1,6,271,1,279,"2017"
"40283","240895 RIO DO FOGO",0,1,2,173,1,177,"2017"
"40284","240910 PASSA E FICA",2,2,3,147,1,155,"2017"
"40285","240920 PASSAGEM",0,1,1,44,0,46,"2017"
"40286","240930 PATU",0,0,0,140,0,140,"2017"
"40287","240933 SANTA MARIA",0,1,2,64,1,68,"2017"
"40288","240940 PAU DOS FERROS",1,3,2,406,1,413,"2017"
"40289","240950 PEDRA GRANDE",0,0,1,49,2,52,"2017"
"40290","240960 PEDRA PRETA",0,0,1,30,0,31,"2017"
"40291","240970 PEDRO AVELINO",0,0,0,72,1,73,"2017"
"40292","240980 PEDRO VELHO",0,1,4,177,1,183,"2017"
"40293","240990 PENDENCIAS",0,2,2,144,1,149,"2017"
"40294","241000 PILOES",0,0,0,39,0,39,"2017"
"40295","241010 POCO BRANCO",0,0,2,163,0,165,"2017"
"40296","241020 PORTALEGRE",0,2,0,98,0,100,"2017"
"40297","241025 PORTO DO MANGUE",0,0,0,89,1,90,"2017"
"40298","241030 SERRA CAIADA",0,0,2,158,0,160,"2017"
"40299","241040 PUREZA",0,2,1,132,1,136,"2017"
"40300","241050 RAFAEL FERNANDES",0,0,0,61,0,61,"2017"
"40301","241060 RAFAEL GODEIRO",0,0,0,30,0,30,"2017"
"40302","241070 RIACHO DA CRUZ",0,0,0,29,0,29,"2017"
"40303","241080 RIACHO DE SANTANA",0,0,0,54,1,55,"2017"
"40304","241090 RIACHUELO",0,0,1,92,1,94,"2017"
"40305","241100 RODOLFO FERNANDES",0,1,0,65,0,66,"2017"
"40306","241105 TIBAU",1,0,0,69,1,71,"2017"
"40307","241110 RUY BARBOSA",0,0,1,38,0,39,"2017"
"40308","241120 SANTA CRUZ",2,4,11,544,2,563,"2017"
"40309","241140 SANTANA DO MATOS",1,1,0,105,1,108,"2017"
"40310","241142 SANTANA DO SERIDO",0,0,0,28,1,29,"2017"
"40311","241150 SANTO ANTONIO",0,0,4,265,3,272,"2017"
"40312","241160 SAO BENTO DO NORTE",0,1,0,43,0,44,"2017"
"40313","241170 SAO BENTO DO TRAIRI",0,0,1,60,0,61,"2017"
"40314","241180 SAO FERNANDO",0,1,4,32,0,37,"2017"
"40315","241190 SAO FRANCISCO DO OESTE",0,2,0,54,0,56,"2017"
"40316","241200 SAO GONCALO DO AMARANTE",2,11,23,1653,4,1693,"2017"
"40317","241210 SAO JOAO DO SABUGI",0,0,1,66,0,67,"2017"
"40318","241220 SAO JOSE DE MIPIBU",3,2,11,700,5,721,"2017"
"40319","241230 SAO JOSE DO CAMPESTRE",0,0,2,143,2,147,"2017"
"40320","241240 SAO JOSE DO SERIDO",0,1,2,56,0,59,"2017"
"40321","241250 SAO MIGUEL",0,2,3,425,2,432,"2017"
"40322","241255 SAO MIGUEL DO GOSTOSO",0,0,0,53,2,55,"2017"
"40323","241260 SAO PAULO DO POTENGI",0,0,4,199,0,203,"2017"
"40324","241270 SAO PEDRO",0,0,2,75,0,77,"2017"
"40325","241280 SAO RAFAEL",0,0,2,68,0,70,"2017"
"40326","241290 SAO TOME",0,2,6,109,0,117,"2017"
"40327","241300 SAO VICENTE",0,0,4,59,0,63,"2017"
"40328","241310 SENADOR ELOI DE SOUZA",0,1,4,74,2,81,"2017"
"40329","241320 SENADOR GEORGINO AVELINO",0,0,1,66,0,67,"2017"
"40330","241330 SERRA DE SAO BENTO",0,0,2,85,0,87,"2017"
"40331","241335 SERRA DO MEL",0,0,1,164,1,166,"2017"
"40332","241340 SERRA NEGRA DO NORTE",1,0,4,77,0,82,"2017"
"40333","241350 SERRINHA",0,1,1,81,3,86,"2017"
"40334","241355 SERRINHA DOS PINTOS",0,0,0,44,0,44,"2017"
"40335","241360 SEVERIANO MELO",1,0,2,84,0,87,"2017"
"40336","241370 SITIO NOVO",1,0,0,50,0,51,"2017"
"40337","241380 TABOLEIRO GRANDE",0,0,1,36,0,37,"2017"
"40338","241390 TAIPU",0,1,3,124,4,132,"2017"
"40339","241400 TANGARA",0,2,2,203,2,209,"2017"
"40340","241410 TENENTE ANANIAS",3,0,0,129,0,132,"2017"
"40341","241415 TENENTE LAURENTINO CRUZ",0,0,2,102,0,104,"2017"
"40342","241420 TIBAU DO SUL",0,0,5,227,2,234,"2017"
"40343","241430 TIMBAUBA DOS BATISTAS",0,0,2,21,0,23,"2017"
"40344","241440 TOUROS",1,3,7,464,4,479,"2017"
"40345","241445 TRIUNFO POTIGUAR",0,0,1,51,1,53,"2017"
"40346","241450 UMARIZAL",0,0,0,108,0,108,"2017"
"40347","241460 UPANEMA",0,1,0,141,2,144,"2017"
"40348","241470 VARZEA",0,0,1,56,0,57,"2017"
"40349","241475 VENHA-VER",1,0,1,42,0,44,"2017"
"40350","241480 VERA CRUZ",0,3,0,166,0,169,"2017"
"40351","241490 VICOSA",0,0,0,15,0,15,"2017"
"40352","241500 VILA FLOR",0,0,1,61,0,62,"2017"
"40353","250010 AGUA BRANCA",0,1,7,100,0,108,"2017"
"40354","250020 AGUIAR",0,0,2,56,1,59,"2017"
"40355","250030 ALAGOA GRANDE",1,0,4,348,4,357,"2017"
"40356","250040 ALAGOA NOVA",1,0,8,316,6,331,"2017"
"40357","250050 ALAGOINHA",2,1,5,228,0,236,"2017"
"40358","250053 ALCANTIL",0,1,1,132,5,139,"2017"
"40359","250057 ALGODAO DE JANDAIRA",1,0,1,49,0,51,"2017"
"40360","250060 ALHANDRA",0,0,11,417,2,430,"2017"
"40361","250070 SAO JOAO DO RIO DO PEIXE",0,0,2,182,3,187,"2017"
"40362","250073 AMPARO",0,2,0,32,0,34,"2017"
"40363","250077 APARECIDA",0,0,0,72,0,72,"2017"
"40364","250080 ARACAGI",1,2,4,194,1,202,"2017"
"40365","250090 ARARA",0,0,3,103,1,107,"2017"
"40366","250100 ARARUNA",0,1,6,201,5,213,"2017"
"40367","250110 AREIA",1,0,6,345,6,358,"2017"
"40368","250115 AREIA DE BARAUNAS",0,0,0,36,1,37,"2017"
"40369","250120 AREIAL",1,0,4,97,4,106,"2017"
"40370","250130 AROEIRAS",1,1,4,306,5,317,"2017"
"40371","250135 ASSUNCAO",1,0,1,63,0,65,"2017"
"40372","250140 BAIA DA TRAICAO",1,0,0,170,0,171,"2017"
"40373","250150 BANANEIRAS",1,1,10,273,2,287,"2017"
"40374","250153 BARAUNA",0,0,1,63,0,64,"2017"
"40375","250157 BARRA DE SANTANA",0,1,3,94,2,100,"2017"
"40376","250160 BARRA DE SANTA ROSA",0,0,1,137,1,139,"2017"
"40377","250170 BARRA DE SAO MIGUEL",0,0,0,83,0,83,"2017"
"40378","250180 BAYEUX",2,11,31,1313,2,1359,"2017"
"40379","250190 BELEM",1,0,2,188,1,192,"2017"
"40380","250200 BELEM DO BREJO DO CRUZ",0,1,0,69,0,70,"2017"
"40381","250205 BERNARDINO BATISTA",0,0,1,47,0,48,"2017"
"40382","250210 BOA VENTURA",0,0,1,90,0,91,"2017"
"40383","250215 BOA VISTA",0,0,1,96,3,100,"2017"
"40384","250220 BOM JESUS",0,0,0,40,0,40,"2017"
"40385","250230 BOM SUCESSO",0,0,0,46,0,46,"2017"
"40386","250240 BONITO DE SANTA FE",0,1,3,124,2,130,"2017"
"40387","250250 BOQUEIRAO",0,2,3,238,4,247,"2017"
"40388","250260 IGARACY",0,0,3,48,2,53,"2017"
"40389","250270 BORBOREMA",0,0,0,71,1,72,"2017"
"40390","250280 BREJO DO CRUZ",1,2,2,146,1,152,"2017"
"40391","250290 BREJO DOS SANTOS",0,0,0,77,0,77,"2017"
"40392","250300 CAAPORA",2,0,7,385,4,398,"2017"
"40393","250310 CABACEIRAS",0,0,1,56,2,59,"2017"
"40394","250320 CABEDELO",1,4,16,902,2,925,"2017"
"40395","250330 CACHOEIRA DOS INDIOS",1,0,5,147,0,153,"2017"
"40396","250340 CACIMBA DE AREIA",0,0,1,42,0,43,"2017"
"40397","250350 CACIMBA DE DENTRO",2,2,3,214,2,223,"2017"
"40398","250355 CACIMBAS",0,0,7,147,10,164,"2017"
"40399","250360 CAICARA",0,0,0,77,0,77,"2017"
"40400","250370 CAJAZEIRAS",1,7,13,829,1,851,"2017"
"40401","250375 CAJAZEIRINHAS",0,1,2,48,0,51,"2017"
"40402","250380 CALDAS BRANDAO",0,0,1,76,1,78,"2017"
"40403","250390 CAMALAU",0,0,1,85,0,86,"2017"
"40404","250400 CAMPINA GRANDE",8,19,101,6079,65,6272,"2017"
"40405","250403 CAPIM",0,0,0,111,0,111,"2017"
"40406","250407 CARAUBAS",0,1,1,49,0,51,"2017"
"40407","250410 CARRAPATEIRA",1,0,0,30,1,32,"2017"
"40408","250415 CASSERENGUE",0,1,2,100,0,103,"2017"
"40409","250420 CATINGUEIRA",0,1,1,54,1,57,"2017"
"40410","250430 CATOLE DO ROCHA",0,0,7,379,1,387,"2017"
"40411","250435 CATURITE",0,0,1,65,1,67,"2017"
"40412","250440 CONCEICAO",3,1,9,204,5,222,"2017"
"40413","250450 CONDADO",0,2,3,77,3,85,"2017"
"40414","250460 CONDE",2,3,9,431,2,447,"2017"
"40415","250470 CONGO",0,0,0,82,1,83,"2017"
"40416","250480 COREMAS",0,0,5,204,1,210,"2017"
"40417","250485 COXIXOLA",0,0,0,23,0,23,"2017"
"40418","250490 CRUZ DO ESPIRITO SANTO",0,2,7,314,0,323,"2017"
"40419","250500 CUBATI",0,2,2,88,0,92,"2017"
"40420","250510 CUITE",0,2,6,252,3,263,"2017"
"40421","250520 CUITEGI",0,0,2,110,0,112,"2017"
"40422","250523 CUITE DE MAMANGUAPE",0,1,1,100,1,103,"2017"
"40423","250527 CURRAL DE CIMA",1,0,2,67,1,71,"2017"
"40424","250530 CURRAL VELHO",0,0,1,29,0,30,"2017"
"40425","250535 DAMIAO",0,0,2,69,1,72,"2017"
"40426","250540 DESTERRO",1,3,1,102,3,110,"2017"
"40427","250550 VISTA SERRANA",0,1,2,33,1,37,"2017"
"40428","250560 DIAMANTE",0,1,1,92,2,96,"2017"
"40429","250570 DONA INES",0,0,2,141,3,146,"2017"
"40430","250580 DUAS ESTRADAS",0,0,0,47,0,47,"2017"
"40431","250590 EMAS",0,1,1,31,2,35,"2017"
"40432","250600 ESPERANCA",0,3,9,464,2,478,"2017"
"40433","250610 FAGUNDES",0,0,2,173,6,181,"2017"
"40434","250620 FREI MARTINHO",0,0,0,23,0,23,"2017"
"40435","250625 GADO BRAVO",0,0,4,102,1,107,"2017"
"40436","250630 GUARABIRA",0,3,11,829,6,849,"2017"
"40437","250640 GURINHEM",0,0,0,181,0,181,"2017"
"40438","250650 GURJAO",0,0,0,42,1,43,"2017"
"40439","250660 IBIARA",1,1,2,63,0,67,"2017"
"40440","250670 IMACULADA",0,0,6,123,4,133,"2017"
"40441","250680 INGA",0,0,2,267,7,276,"2017"
"40442","250690 ITABAIANA",0,1,9,358,0,368,"2017"
"40443","250700 ITAPORANGA",0,1,7,344,1,353,"2017"
"40444","250710 ITAPOROROCA",0,1,9,252,0,262,"2017"
"40445","250720 ITATUBA",1,0,6,128,5,140,"2017"
"40446","250730 JACARAU",0,2,3,250,2,257,"2017"
"40447","250740 JERICO",0,0,2,102,0,104,"2017"
"40448","250750 JOAO PESSOA",28,61,196,11829,35,12149,"2017"
"40449","250760 JUAREZ TAVORA",0,0,3,104,1,108,"2017"
"40450","250770 JUAZEIRINHO",1,0,6,295,6,308,"2017"
"40451","250780 JUNCO DO SERIDO",1,0,1,93,0,95,"2017"
"40452","250790 JURIPIRANGA",0,0,2,212,1,215,"2017"
"40453","250800 JURU",0,1,4,105,0,110,"2017"
"40454","250810 LAGOA",0,0,1,47,0,48,"2017"
"40455","250820 LAGOA DE DENTRO",0,0,5,125,2,132,"2017"
"40456","250830 LAGOA SECA",1,2,3,398,3,407,"2017"
"40457","250840 LASTRO",0,0,1,54,0,55,"2017"
"40458","250850 LIVRAMENTO",1,1,2,97,3,104,"2017"
"40459","250855 LOGRADOURO",0,0,0,59,0,59,"2017"
"40460","250860 LUCENA",1,1,5,222,0,229,"2017"
"40461","250870 MAE D'AGUA",0,1,0,42,0,43,"2017"
"40462","250880 MALTA",0,0,1,65,3,69,"2017"
"40463","250890 MAMANGUAPE",0,5,15,773,2,795,"2017"
"40464","250900 MANAIRA",0,0,6,113,2,121,"2017"
"40465","250905 MARCACAO",0,1,6,163,2,172,"2017"
"40466","250910 MARI",1,2,7,271,0,281,"2017"
"40467","250915 MARIZOPOLIS",0,0,1,87,1,89,"2017"
"40468","250920 MASSARANDUBA",0,0,6,161,3,170,"2017"
"40469","250930 MATARACA",0,2,2,164,0,168,"2017"
"40470","250933 MATINHAS",0,0,3,79,4,86,"2017"
"40471","250937 MATO GROSSO",0,0,0,24,0,24,"2017"
"40472","250939 MATUREIA",1,6,4,92,1,104,"2017"
"40473","250940 MOGEIRO",0,1,4,177,3,185,"2017"
"40474","250950 MONTADAS",0,0,3,92,3,98,"2017"
"40475","250960 MONTE HOREBE",0,0,2,46,1,49,"2017"
"40476","250970 MONTEIRO",1,0,8,483,0,492,"2017"
"40477","250980 MULUNGU",1,0,8,116,1,126,"2017"
"40478","250990 NATUBA",0,0,2,85,2,89,"2017"
"40479","251000 NAZAREZINHO",0,2,1,63,0,66,"2017"
"40480","251010 NOVA FLORESTA",0,0,2,167,1,170,"2017"
"40481","251020 NOVA OLINDA",0,1,2,69,3,75,"2017"
"40482","251030 NOVA PALMEIRA",0,0,0,42,0,42,"2017"
"40483","251040 OLHO D'AGUA",0,0,9,111,3,123,"2017"
"40484","251050 OLIVEDOS",0,0,1,40,0,41,"2017"
"40485","251060 OURO VELHO",0,0,0,41,1,42,"2017"
"40486","251065 PARARI",0,0,0,22,0,22,"2017"
"40487","251070 PASSAGEM",0,0,0,40,0,40,"2017"
"40488","251080 PATOS",5,21,58,1399,21,1504,"2017"
"40489","251090 PAULISTA",2,0,0,153,0,155,"2017"
"40490","251100 PEDRA BRANCA",0,0,3,54,0,57,"2017"
"40491","251110 PEDRA LAVRADA",0,0,0,80,0,80,"2017"
"40492","251120 PEDRAS DE FOGO",1,2,14,525,0,542,"2017"
"40493","251130 PIANCO",0,3,4,167,3,177,"2017"
"40494","251140 PICUI",1,4,2,244,3,254,"2017"
"40495","251150 PILAR",1,0,6,185,0,192,"2017"
"40496","251160 PILOES",0,0,3,122,0,125,"2017"
"40497","251170 PILOEZINHOS",0,0,2,93,0,95,"2017"
"40498","251180 PIRPIRITUBA",0,0,0,130,0,130,"2017"
"40499","251190 PITIMBU",3,0,3,272,4,282,"2017"
"40500","251200 POCINHOS",1,0,6,241,3,251,"2017"
"40501","251203 POCO DANTAS",0,0,1,56,0,57,"2017"
"40502","251207 POCO DE JOSE DE MOURA",0,0,1,48,0,49,"2017"
"40503","251210 POMBAL",0,2,4,432,0,438,"2017"
"40504","251220 PRATA",0,0,1,52,0,53,"2017"
"40505","251230 PRINCESA ISABEL",0,2,2,245,3,252,"2017"
"40506","251240 PUXINANA",0,1,4,198,7,210,"2017"
"40507","251250 QUEIMADAS",0,7,14,641,10,672,"2017"
"40508","251260 QUIXABA",0,1,1,25,0,27,"2017"
"40509","251270 REMIGIO",1,2,5,269,4,281,"2017"
"40510","251272 PEDRO REGIS",0,1,2,45,0,48,"2017"
"40511","251274 RIACHAO",1,0,1,45,0,47,"2017"
"40512","251275 RIACHAO DO BACAMARTE",0,0,2,66,0,68,"2017"
"40513","251276 RIACHAO DO POCO",0,0,2,66,0,68,"2017"
"40514","251278 RIACHO DE SANTO ANTONIO",0,0,0,41,0,41,"2017"
"40515","251280 RIACHO DOS CAVALOS",1,3,5,100,1,110,"2017"
"40516","251290 RIO TINTO",1,2,5,343,0,351,"2017"
"40517","251300 SALGADINHO",0,0,3,32,2,37,"2017"
"40518","251310 SALGADO DE SAO FELIX",0,0,6,124,0,130,"2017"
"40519","251315 SANTA CECILIA",0,1,1,92,2,96,"2017"
"40520","251320 SANTA CRUZ",1,1,0,61,0,63,"2017"
"40521","251330 SANTA HELENA",0,1,0,68,2,71,"2017"
"40522","251335 SANTA INES",0,0,0,43,0,43,"2017"
"40523","251340 SANTA LUZIA",0,3,7,184,1,195,"2017"
"40524","251350 SANTANA DE MANGUEIRA",0,0,2,57,2,61,"2017"
"40525","251360 SANTANA DOS GARROTES",0,0,1,74,3,78,"2017"
"40526","251365 JOCA CLAUDINO",0,0,3,23,0,26,"2017"
"40527","251370 SANTA RITA",7,11,46,2450,1,2515,"2017"
"40528","251380 SANTA TERESINHA",0,1,2,51,1,55,"2017"
"40529","251385 SANTO ANDRE",1,0,1,29,0,31,"2017"
"40530","251390 SAO BENTO",0,1,1,410,2,414,"2017"
"40531","251392 SAO BENTINHO",0,1,0,48,0,49,"2017"
"40532","251394 SAO DOMINGOS DO CARIRI",0,0,1,27,1,29,"2017"
"40533","251396 SAO DOMINGOS",0,0,0,26,0,26,"2017"
"40534","251398 SAO FRANCISCO",0,0,0,41,1,42,"2017"
"40535","251400 SAO JOAO DO CARIRI",0,1,0,52,0,53,"2017"
"40536","251410 SAO JOAO DO TIGRE",0,1,0,44,1,46,"2017"
"40537","251420 SAO JOSE DA LAGOA TAPADA",0,0,3,88,0,91,"2017"
"40538","251430 SAO JOSE DE CAIANA",0,0,1,74,7,82,"2017"
"40539","251440 SAO JOSE DE ESPINHARAS",0,3,1,46,0,50,"2017"
"40540","251445 SAO JOSE DOS RAMOS",1,0,0,77,0,78,"2017"
"40541","251450 SAO JOSE DE PIRANHAS",1,0,5,255,1,262,"2017"
"40542","251455 SAO JOSE DE PRINCESA",0,0,3,25,0,28,"2017"
"40543","251460 SAO JOSE DO BONFIM",0,2,1,48,1,52,"2017"
"40544","251465 SAO JOSE DO BREJO DO CRUZ",0,0,0,24,0,24,"2017"
"40545","251470 SAO JOSE DO SABUGI",0,0,0,45,1,46,"2017"
"40546","251480 SAO JOSE DOS CORDEIROS",0,0,1,42,0,43,"2017"
"40547","251490 SAO MAMEDE",0,2,7,82,3,94,"2017"
"40548","251500 SAO MIGUEL DE TAIPU",0,0,3,95,0,98,"2017"
"40549","251510 SAO SEBASTIAO DE LAGOA DE ROCA",0,1,1,119,2,123,"2017"
"40550","251520 SAO SEBASTIAO DO UMBUZEIRO",0,0,1,53,0,54,"2017"
"40551","251530 SAPE",2,1,13,552,2,570,"2017"
"40552","251540 SAO VICENTE DO SERIDO",0,0,4,136,4,144,"2017"
"40553","251550 SERRA BRANCA",1,2,3,152,0,158,"2017"
"40554","251560 SERRA DA RAIZ",0,0,0,34,1,35,"2017"
"40555","251570 SERRA GRANDE",0,0,1,46,0,47,"2017"
"40556","251580 SERRA REDONDA",0,0,2,72,1,75,"2017"
"40557","251590 SERRARIA",2,1,0,64,1,68,"2017"
"40558","251593 SERTAOZINHO",0,0,1,68,0,69,"2017"
"40559","251597 SOBRADO",0,0,1,143,0,144,"2017"
"40560","251600 SOLANEA",4,0,10,373,3,390,"2017"
"40561","251610 SOLEDADE",0,2,6,179,2,189,"2017"
"40562","251615 SOSSEGO",0,1,1,45,0,47,"2017"
"40563","251620 SOUSA",3,5,10,906,0,924,"2017"
"40564","251630 SUME",0,0,3,223,0,226,"2017"
"40565","251640 TACIMA",2,0,1,89,1,93,"2017"
"40566","251650 TAPEROA",1,2,4,204,4,215,"2017"
"40567","251660 TAVARES",0,1,4,181,2,188,"2017"
"40568","251670 TEIXEIRA",0,3,8,208,10,229,"2017"
"40569","251675 TENORIO",0,0,0,36,1,37,"2017"
"40570","251680 TRIUNFO",0,0,3,111,2,116,"2017"
"40571","251690 UIRAUNA",0,1,6,163,2,172,"2017"
"40572","251700 UMBUZEIRO",0,1,1,93,2,97,"2017"
"40573","251710 VARZEA",0,0,1,24,0,25,"2017"
"40574","251720 VIEIROPOLIS",0,0,0,51,1,52,"2017"
"40575","251740 ZABELE",0,0,1,33,0,34,"2017"
"40576","MUNICIPIO IGNORADO - PE",0,0,0,24,2,26,"2017"
"40577","260005 ABREU E LIMA",5,5,22,1478,9,1519,"2017"
"40578","260010 AFOGADOS DA INGAZEIRA",2,1,2,514,3,522,"2017"
"40579","260020 AFRANIO",0,2,6,233,19,260,"2017"
"40580","260030 AGRESTINA",0,2,4,316,16,338,"2017"
"40581","260040 AGUA PRETA",1,2,5,475,3,486,"2017"
"40582","260050 AGUAS BELAS",2,6,13,684,14,719,"2017"
"40583","260060 ALAGOINHA",1,2,1,177,4,185,"2017"
"40584","260070 ALIANCA",1,2,10,511,1,525,"2017"
"40585","260080 ALTINHO",0,1,2,260,15,278,"2017"
"40586","260090 AMARAJI",2,1,6,294,1,304,"2017"
"40587","260100 ANGELIM",1,1,2,122,3,129,"2017"
"40588","260105 ARACOIABA",0,1,3,295,4,303,"2017"
"40589","260110 ARARIPINA",10,6,14,1463,8,1501,"2017"
"40590","260120 ARCOVERDE",5,5,10,1130,8,1158,"2017"
"40591","260130 BARRA DE GUABIRABA",1,3,4,166,0,174,"2017"
"40592","260140 BARREIROS",2,4,13,679,4,702,"2017"
"40593","260150 BELEM DE MARIA",1,0,1,122,0,124,"2017"
"40594","260160 BELEM DE SAO FRANCISCO",0,2,5,301,2,310,"2017"
"40595","260170 BELO JARDIM",5,5,17,1083,48,1158,"2017"
"40596","260180 BETANIA",2,1,17,155,10,185,"2017"
"40597","260190 BEZERROS",0,3,10,719,33,765,"2017"
"40598","260200 BODOCO",0,3,8,475,0,486,"2017"
"40599","260210 BOM CONSELHO",6,4,2,542,9,563,"2017"
"40600","260220 BOM JARDIM",2,1,5,473,1,482,"2017"
"40601","260230 BONITO",1,1,13,601,11,627,"2017"
"40602","260240 BREJAO",0,1,1,172,2,176,"2017"
"40603","260250 BREJINHO",0,0,0,82,1,83,"2017"
"40604","260260 BREJO DA MADRE DE DEUS",3,7,8,631,27,676,"2017"
"40605","260270 BUENOS AIRES",1,2,4,166,1,174,"2017"
"40606","260280 BUIQUE",2,4,11,840,1,858,"2017"
"40607","260290 CABO DE SANTO AGOSTINHO",4,13,48,3014,12,3091,"2017"
"40608","260300 CABROBO",2,4,6,515,4,531,"2017"
"40609","260310 CACHOEIRINHA",1,0,5,250,14,270,"2017"
"40610","260320 CAETES",0,1,5,437,3,446,"2017"
"40611","260330 CALCADO",0,0,3,129,4,136,"2017"
"40612","260340 CALUMBI",0,3,16,75,13,107,"2017"
"40613","260345 CAMARAGIBE",4,8,40,2166,19,2237,"2017"
"40614","260350 CAMOCIM DE SAO FELIX",0,2,2,208,14,226,"2017"
"40615","260360 CAMUTANGA",0,0,3,108,2,113,"2017"
"40616","260370 CANHOTINHO",0,1,8,351,0,360,"2017"
"40617","260380 CAPOEIRAS",1,1,4,227,1,234,"2017"
"40618","260390 CARNAIBA",1,1,3,258,6,269,"2017"
"40619","260392 CARNAUBEIRA DA PENHA",0,3,6,257,1,267,"2017"
"40620","260400 CARPINA",4,3,12,1060,2,1081,"2017"
"40621","260410 CARUARU",9,15,64,5464,126,5678,"2017"
"40622","260415 CASINHAS",0,1,1,165,0,167,"2017"
"40623","260420 CATENDE",3,2,4,555,2,566,"2017"
"40624","260430 CEDRO",0,1,2,138,0,141,"2017"
"40625","260440 CHA DE ALEGRIA",2,0,5,215,3,225,"2017"
"40626","260450 CHA GRANDE",2,0,4,294,0,300,"2017"
"40627","260460 CONDADO",1,1,6,331,1,340,"2017"
"40628","260470 CORRENTES",2,0,3,237,3,245,"2017"
"40629","260480 CORTES",1,0,3,188,1,193,"2017"
"40630","260490 CUMARU",0,0,3,149,1,153,"2017"
"40631","260500 CUPIRA",0,4,8,351,20,383,"2017"
"40632","260510 CUSTODIA",0,1,4,507,5,517,"2017"
"40633","260515 DORMENTES",1,0,6,220,20,247,"2017"
"40634","260520 ESCADA",6,5,13,947,10,981,"2017"
"40635","260530 EXU",0,0,14,453,0,467,"2017"
"40636","260540 FEIRA NOVA",0,3,3,327,2,335,"2017"
"40637","260545 FERNANDO DE NORONHA",0,0,0,23,0,23,"2017"
"40638","260550 FERREIROS",1,1,4,140,1,147,"2017"
"40639","260560 FLORES",0,2,10,246,4,262,"2017"
"40640","260570 FLORESTA",4,4,13,430,5,456,"2017"
"40641","260580 FREI MIGUELINHO",0,1,1,131,7,140,"2017"
"40642","260590 GAMELEIRA",1,1,5,349,1,357,"2017"
"40643","260600 GARANHUNS",8,7,17,2196,20,2248,"2017"
"40644","260610 GLORIA DO GOITA",1,2,6,432,3,444,"2017"
"40645","260620 GOIANA",2,3,15,1154,9,1183,"2017"
"40646","260630 GRANITO",0,1,3,90,1,95,"2017"
"40647","260640 GRAVATA",1,3,7,1008,27,1046,"2017"
"40648","260650 IATI",0,0,2,274,2,278,"2017"
"40649","260660 IBIMIRIM",1,0,6,472,5,484,"2017"
"40650","260670 IBIRAJUBA",0,0,1,90,5,96,"2017"
"40651","260680 IGARASSU",7,11,34,1478,14,1544,"2017"
"40652","260690 IGUARACY",0,0,2,147,1,150,"2017"
"40653","260700 INAJA",0,2,7,301,21,331,"2017"
"40654","260710 INGAZEIRA",0,0,1,53,0,54,"2017"
"40655","260720 IPOJUCA",7,11,38,1673,14,1743,"2017"
"40656","260730 IPUBI",2,2,12,465,9,490,"2017"
"40657","260740 ITACURUBA",0,0,2,74,1,77,"2017"
"40658","260750 ITAIBA",1,2,2,325,10,340,"2017"
"40659","260760 ILHA DE ITAMARACA",0,2,3,324,2,331,"2017"
"40660","260765 ITAMBE",0,1,7,400,1,409,"2017"
"40661","260770 ITAPETIM",0,1,0,166,0,167,"2017"
"40662","260775 ITAPISSUMA",0,4,6,311,3,324,"2017"
"40663","260780 ITAQUITINGA",0,1,1,237,3,242,"2017"
"40664","260790 JABOATAO DOS GUARARAPES",26,34,147,9325,59,9591,"2017"
"40665","260795 JAQUEIRA",2,0,3,180,8,193,"2017"
"40666","260800 JATAUBA",3,0,0,229,10,242,"2017"
"40667","260805 JATOBA",1,0,6,212,4,223,"2017"
"40668","260810 JOAO ALFREDO",5,3,3,339,3,353,"2017"
"40669","260820 JOAQUIM NABUCO",2,1,3,274,1,281,"2017"
"40670","260825 JUCATI",0,1,1,172,0,174,"2017"
"40671","260830 JUPI",0,1,5,271,2,279,"2017"
"40672","260840 JUREMA",1,3,3,200,10,217,"2017"
"40673","260845 LAGOA DO CARRO",0,2,1,229,1,233,"2017"
"40674","260850 LAGOA DE ITAENGA",0,0,5,337,5,347,"2017"
"40675","260860 LAGOA DO OURO",3,0,2,186,2,193,"2017"
"40676","260870 LAGOA DOS GATOS",0,0,1,186,4,191,"2017"
"40677","260875 LAGOA GRANDE",2,2,4,360,2,370,"2017"
"40678","260880 LAJEDO",4,3,12,600,19,638,"2017"
"40679","260890 LIMOEIRO",1,2,12,763,3,781,"2017"
"40680","260900 MACAPARANA",0,1,6,372,3,382,"2017"
"40681","260910 MACHADOS",1,0,2,209,0,212,"2017"
"40682","260915 MANARI",0,1,7,237,3,248,"2017"
"40683","260920 MARAIAL",3,0,1,235,1,240,"2017"
"40684","260930 MIRANDIBA",4,2,6,233,1,246,"2017"
"40685","260940 MORENO",3,4,10,736,5,758,"2017"
"40686","260950 NAZARE DA MATA",0,1,9,424,0,434,"2017"
"40687","260960 OLINDA",12,25,72,5511,51,5671,"2017"
"40688","260970 OROBO",0,1,3,256,3,263,"2017"
"40689","260980 OROCO",0,1,5,274,2,282,"2017"
"40690","260990 OURICURI",3,7,21,1049,6,1086,"2017"
"40691","261000 PALMARES",7,4,13,1104,2,1130,"2017"
"40692","261010 PALMEIRINA",0,0,5,113,1,119,"2017"
"40693","261020 PANELAS",0,2,7,332,19,360,"2017"
"40694","261030 PARANATAMA",1,0,3,211,0,215,"2017"
"40695","261040 PARNAMIRIM",0,4,3,259,0,266,"2017"
"40696","261050 PASSIRA",4,2,1,377,2,386,"2017"
"40697","261060 PAUDALHO",3,4,14,784,7,812,"2017"
"40698","261070 PAULISTA",13,19,74,3980,37,4123,"2017"
"40699","261080 PEDRA",1,0,2,342,5,350,"2017"
"40700","261090 PESQUEIRA",1,2,8,955,11,977,"2017"
"40701","261100 PETROLANDIA",1,4,6,623,8,642,"2017"
"40702","261110 PETROLINA",33,38,124,5937,78,6210,"2017"
"40703","261120 POCAO",0,0,2,131,4,137,"2017"
"40704","261130 POMBOS",1,1,4,384,2,392,"2017"
"40705","261140 PRIMAVERA",1,0,5,141,0,147,"2017"
"40706","261150 QUIPAPA",2,1,1,277,3,284,"2017"
"40707","261153 QUIXABA",1,0,0,86,0,87,"2017"
"40708","261160 RECIFE",67,86,305,22198,161,22817,"2017"
"40709","261170 RIACHO DAS ALMAS",0,1,4,293,16,314,"2017"
"40710","261180 RIBEIRAO",1,1,6,431,4,443,"2017"
"40711","261190 RIO FORMOSO",1,5,4,325,1,336,"2017"
"40712","261200 SAIRE",0,1,0,109,5,115,"2017"
"40713","261210 SALGADINHO",0,1,0,65,1,67,"2017"
"40714","261220 SALGUEIRO",2,4,25,954,2,987,"2017"
"40715","261230 SALOA",1,0,2,211,6,220,"2017"
"40716","261240 SANHARO",1,4,5,260,15,285,"2017"
"40717","261245 SANTA CRUZ",1,2,5,227,5,240,"2017"
"40718","261247 SANTA CRUZ DA BAIXA VERDE",0,0,29,144,16,189,"2017"
"40719","261250 SANTA CRUZ DO CAPIBARIBE",9,5,14,1273,63,1364,"2017"
"40720","261255 SANTA FILOMENA",0,1,5,161,0,167,"2017"
"40721","261260 SANTA MARIA DA BOA VISTA",7,4,13,657,4,685,"2017"
"40722","261270 SANTA MARIA DO CAMBUCA",1,0,1,193,9,204,"2017"
"40723","261280 SANTA TEREZINHA",1,0,0,162,1,164,"2017"
"40724","261290 SAO BENEDITO DO SUL",0,0,2,172,0,174,"2017"
"40725","261300 SAO BENTO DO UNA",1,0,6,678,25,710,"2017"
"40726","261310 SAO CAITANO",1,3,5,506,33,548,"2017"
"40727","261320 SAO JOAO",0,1,5,299,3,308,"2017"
"40728","261330 SAO JOAQUIM DO MONTE",1,0,5,281,20,307,"2017"
"40729","261340 SAO JOSE DA COROA GRANDE",1,1,4,325,5,336,"2017"
"40730","261350 SAO JOSE DO BELMONTE",1,2,15,417,8,443,"2017"
"40731","261360 SAO JOSE DO EGITO",1,5,2,450,1,459,"2017"
"40732","261370 SAO LOURENCO DA MATA",2,7,23,1550,18,1600,"2017"
"40733","261380 SAO VICENTE FERRER",1,1,5,258,1,266,"2017"
"40734","261390 SERRA TALHADA",4,5,133,1216,57,1415,"2017"
"40735","261400 SERRITA",1,0,15,263,0,279,"2017"
"40736","261410 SERTANIA",1,1,4,390,3,399,"2017"
"40737","261420 SIRINHAEM",1,2,10,559,1,573,"2017"
"40738","261430 MOREILANDIA",0,1,2,142,2,147,"2017"
"40739","261440 SOLIDAO",0,0,0,88,0,88,"2017"
"40740","261450 SURUBIM",2,2,6,824,10,844,"2017"
"40741","261460 TABIRA",0,2,3,392,1,398,"2017"
"40742","261470 TACAIMBO",2,0,5,133,9,149,"2017"
"40743","261480 TACARATU",2,2,6,294,8,312,"2017"
"40744","261485 TAMANDARE",3,2,4,389,1,399,"2017"
"40745","261500 TAQUARITINGA DO NORTE",1,2,5,343,14,365,"2017"
"40746","261510 TEREZINHA",0,1,1,101,0,103,"2017"
"40747","261520 TERRA NOVA",0,0,1,108,0,109,"2017"
"40748","261530 TIMBAUBA",2,3,10,745,0,760,"2017"
"40749","261540 TORITAMA",4,1,11,555,35,606,"2017"
"40750","261550 TRACUNHAEM",1,1,1,173,2,178,"2017"
"40751","261560 TRINDADE",1,6,4,581,0,592,"2017"
"40752","261570 TRIUNFO",0,3,16,175,9,203,"2017"
"40753","261580 TUPANATINGA",2,0,1,326,1,330,"2017"
"40754","261590 TUPARETAMA",1,0,1,117,0,119,"2017"
"40755","261600 VENTUROSA",1,1,4,220,3,229,"2017"
"40756","261610 VERDEJANTE",0,0,1,102,0,103,"2017"
"40757","261618 VERTENTE DO LERIO",0,1,1,103,4,109,"2017"
"40758","261620 VERTENTES",2,2,4,330,10,348,"2017"
"40759","261630 VICENCIA",2,1,5,371,4,383,"2017"
"40760","261640 VITORIA DE SANTO ANTAO",4,0,36,2026,9,2075,"2017"
"40761","261650 XEXEU",2,0,3,236,0,241,"2017"
"40762","270010 AGUA BRANCA",2,0,9,222,105,338,"2017"
"40763","270020 ANADIA",0,0,5,195,5,205,"2017"
"40764","270030 ARAPIRACA",6,18,35,3886,5,3950,"2017"
"40765","270040 ATALAIA",0,1,7,620,77,705,"2017"
"40766","270050 BARRA DE SANTO ANTONIO",0,0,2,300,7,309,"2017"
"40767","270060 BARRA DE SAO MIGUEL",0,0,2,138,1,141,"2017"
"40768","270070 BATALHA",0,2,0,279,1,282,"2017"
"40769","270080 BELEM",0,1,1,75,0,77,"2017"
"40770","270090 BELO MONTE",0,1,1,94,0,96,"2017"
"40771","270100 BOCA DA MATA",0,5,10,302,3,320,"2017"
"40772","270110 BRANQUINHA",0,0,0,183,2,185,"2017"
"40773","270120 CACIMBINHAS",1,0,5,164,1,171,"2017"
"40774","270130 CAJUEIRO",0,0,3,230,74,307,"2017"
"40775","270135 CAMPESTRE",0,0,2,91,1,94,"2017"
"40776","270140 CAMPO ALEGRE",2,2,11,504,7,526,"2017"
"40777","270150 CAMPO GRANDE",0,0,0,135,0,135,"2017"
"40778","270160 CANAPI",0,1,4,235,31,271,"2017"
"40779","270170 CAPELA",0,1,2,187,22,212,"2017"
"40780","270180 CARNEIROS",0,2,1,152,0,155,"2017"
"40781","270190 CHA PRETA",1,0,2,92,15,110,"2017"
"40782","270200 COITE DO NOIA",0,0,2,139,0,141,"2017"
"40783","270210 COLONIA LEOPOLDINA",1,1,5,234,2,243,"2017"
"40784","270220 COQUEIRO SECO",0,0,1,86,0,87,"2017"
"40785","270230 CORURIPE",1,4,13,833,5,856,"2017"
"40786","270235 CRAIBAS",1,2,9,360,5,377,"2017"
"40787","270240 DELMIRO GOUVEIA",0,1,11,385,425,822,"2017"
"40788","270250 DOIS RIACHOS",0,0,1,135,0,136,"2017"
"40789","270255 ESTRELA DE ALAGOAS",0,0,5,204,0,209,"2017"
"40790","270260 FEIRA GRANDE",0,1,5,324,1,331,"2017"
"40791","270270 FELIZ DESERTO",0,0,1,72,2,75,"2017"
"40792","270280 FLEXEIRAS",0,0,1,190,2,193,"2017"
"40793","270290 GIRAU DO PONCIANO",2,6,3,526,1,538,"2017"
"40794","270300 IBATEGUARA",0,1,3,243,2,249,"2017"
"40795","270310 IGACI",1,0,5,329,1,336,"2017"
"40796","270320 IGREJA NOVA",0,1,7,377,0,385,"2017"
"40797","270330 INHAPI",0,1,2,214,73,290,"2017"
"40798","270340 JACARE DOS HOMENS",0,0,3,102,0,105,"2017"
"40799","270350 JACUIPE",0,1,3,45,0,49,"2017"
"40800","270360 JAPARATINGA",0,0,4,140,3,147,"2017"
"40801","270370 JARAMATAIA",0,0,0,92,0,92,"2017"
"40802","270375 JEQUIA DA PRAIA",0,0,2,128,4,134,"2017"
"40803","270380 JOAQUIM GOMES",0,2,3,355,13,373,"2017"
"40804","270390 JUNDIA",0,0,1,47,2,50,"2017"
"40805","270400 JUNQUEIRO",2,1,5,312,1,321,"2017"
"40806","270410 LAGOA DA CANOA",3,1,3,291,0,298,"2017"
"40807","270420 LIMOEIRO DE ANADIA",0,1,6,348,1,356,"2017"
"40808","270430 MACEIO",30,39,145,14162,157,14533,"2017"
"40809","270440 MAJOR ISIDORO",1,0,4,242,13,260,"2017"
"40810","270450 MARAGOGI",2,1,8,538,7,556,"2017"
"40811","270460 MARAVILHA",0,0,1,161,2,164,"2017"
"40812","270470 MARECHAL DEODORO",2,2,5,890,7,906,"2017"
"40813","270480 MARIBONDO",0,0,2,182,0,184,"2017"
"40814","270490 MAR VERMELHO",0,0,0,35,1,36,"2017"
"40815","270500 MATA GRANDE",1,0,4,283,61,349,"2017"
"40816","270510 MATRIZ DE CAMARAGIBE",2,2,2,383,4,393,"2017"
"40817","270520 MESSIAS",2,0,5,265,8,280,"2017"
"40818","270530 MINADOR DO NEGRAO",0,0,1,71,0,72,"2017"
"40819","270540 MONTEIROPOLIS",2,0,1,108,1,112,"2017"
"40820","270550 MURICI",0,3,6,443,44,496,"2017"
"40821","270560 NOVO LINO",0,0,1,165,1,167,"2017"
"40822","270570 OLHO D'AGUA DAS FLORES",1,3,5,351,3,363,"2017"
"40823","270580 OLHO D'AGUA DO CASADO",0,0,1,107,29,137,"2017"
"40824","270590 OLHO D'AGUA GRANDE",0,0,0,74,0,74,"2017"
"40825","270600 OLIVENCA",0,0,0,179,1,180,"2017"
"40826","270610 OURO BRANCO",0,0,3,180,3,186,"2017"
"40827","270620 PALESTINA",0,0,0,83,0,83,"2017"
"40828","270630 PALMEIRA DOS INDIOS",3,5,21,1304,2,1335,"2017"
"40829","270640 PAO DE ACUCAR",2,0,1,373,7,383,"2017"
"40830","270642 PARICONHA",1,0,1,102,50,154,"2017"
"40831","270644 PARIPUEIRA",2,0,4,225,2,233,"2017"
"40832","270650 PASSO DE CAMARAGIBE",0,1,2,222,4,229,"2017"
"40833","270660 PAULO JACINTO",0,0,1,91,4,96,"2017"
"40834","270670 PENEDO",2,2,16,955,8,983,"2017"
"40835","270680 PIACABUCU",2,0,4,295,3,304,"2017"
"40836","270690 PILAR",0,1,2,541,19,563,"2017"
"40837","270700 PINDOBA",0,0,1,27,2,30,"2017"
"40838","270710 PIRANHAS",1,3,7,421,29,461,"2017"
"40839","270720 POCO DAS TRINCHEIRAS",0,1,3,200,3,207,"2017"
"40840","270730 PORTO CALVO",2,0,2,437,5,446,"2017"
"40841","270740 PORTO DE PEDRAS",0,0,1,126,0,127,"2017"
"40842","270750 PORTO REAL DO COLEGIO",0,0,4,255,7,266,"2017"
"40843","270760 QUEBRANGULO",0,1,2,182,1,186,"2017"
"40844","270770 RIO LARGO",3,5,23,1343,49,1423,"2017"
"40845","270780 ROTEIRO",0,1,0,131,3,135,"2017"
"40846","270790 SANTA LUZIA DO NORTE",1,1,1,118,0,121,"2017"
"40847","270800 SANTANA DO IPANEMA",1,3,3,782,7,796,"2017"
"40848","270810 SANTANA DO MUNDAU",0,1,1,177,1,180,"2017"
"40849","270820 SAO BRAS",0,0,2,100,2,104,"2017"
"40850","270830 SAO JOSE DA LAJE",0,2,4,384,6,396,"2017"
"40851","270840 SAO JOSE DA TAPERA",3,2,10,526,4,545,"2017"
"40852","270850 SAO LUIS DO QUITUNDE",1,1,5,573,5,585,"2017"
"40853","270860 SAO MIGUEL DOS CAMPOS",3,3,10,852,5,873,"2017"
"40854","270870 SAO MIGUEL DOS MILAGRES",1,0,2,125,4,132,"2017"
"40855","270880 SAO SEBASTIAO",0,2,6,465,1,474,"2017"
"40856","270890 SATUBA",0,1,1,310,7,319,"2017"
"40857","270895 SENADOR RUI PALMEIRA",1,0,5,191,3,200,"2017"
"40858","270900 TANQUE D'ARCA",0,0,2,74,1,77,"2017"
"40859","270910 TAQUARANA",1,0,4,280,2,287,"2017"
"40860","270915 TEOTONIO VILELA",0,5,8,597,0,610,"2017"
"40861","270920 TRAIPU",2,2,3,301,5,313,"2017"
"40862","270930 UNIAO DOS PALMARES",1,4,12,1037,10,1064,"2017"
"40863","270940 VICOSA",0,4,5,361,48,418,"2017"
"40864","280010 AMPARO DE SAO FRANCISCO",0,1,1,35,2,39,"2017"
"40865","280020 AQUIDABA",0,5,5,264,12,286,"2017"
"40866","280030 ARACAJU",36,32,172,8731,97,9068,"2017"
"40867","280040 ARAUA",0,0,4,148,2,154,"2017"
"40868","280050 AREIA BRANCA",0,2,2,262,2,268,"2017"
"40869","280060 BARRA DOS COQUEIROS",0,1,10,495,4,510,"2017"
"40870","280067 BOQUIM",0,0,4,292,4,300,"2017"
"40871","280070 BREJO GRANDE",0,1,0,120,11,132,"2017"
"40872","280100 CAMPO DO BRITO",0,0,3,247,3,253,"2017"
"40873","280110 CANHOBA",0,0,1,61,3,65,"2017"
"40874","280120 CANINDE DE SAO FRANCISCO",2,3,8,545,35,593,"2017"
"40875","280130 CAPELA",2,2,9,503,31,547,"2017"
"40876","280140 CARIRA",1,0,3,287,10,301,"2017"
"40877","280150 CARMOPOLIS",0,0,2,292,5,299,"2017"
"40878","280160 CEDRO DE SAO JOAO",0,0,1,74,3,78,"2017"
"40879","280170 CRISTINAPOLIS",0,1,6,287,9,303,"2017"
"40880","280190 CUMBE",0,0,0,55,2,57,"2017"
"40881","280200 DIVINA PASTORA",0,0,0,72,0,72,"2017"
"40882","280210 ESTANCIA",4,5,11,1071,14,1105,"2017"
"40883","280220 FEIRA NOVA",0,0,1,81,12,94,"2017"
"40884","280230 FREI PAULO",0,0,3,234,3,240,"2017"
"40885","280240 GARARU",0,0,5,122,25,152,"2017"
"40886","280250 GENERAL MAYNARD",0,0,2,47,1,50,"2017"
"40887","280260 GRACHO CARDOSO",0,0,0,67,13,80,"2017"
"40888","280270 ILHA DAS FLORES",0,1,3,127,9,140,"2017"
"40889","280280 INDIAROBA",2,3,6,264,7,282,"2017"
"40890","280290 ITABAIANA",4,4,16,1326,14,1364,"2017"
"40891","280300 ITABAIANINHA",2,4,12,584,10,612,"2017"
"40892","280310 ITABI",0,0,2,53,6,61,"2017"
"40893","280320 ITAPORANGA D'AJUDA",1,2,14,542,18,577,"2017"
"40894","280330 JAPARATUBA",0,1,5,243,9,258,"2017"
"40895","280340 JAPOATA",1,0,5,191,6,203,"2017"
"40896","280350 LAGARTO",6,2,24,1481,18,1531,"2017"
"40897","280360 LARANJEIRAS",1,3,10,429,10,453,"2017"
"40898","280370 MACAMBIRA",0,0,1,70,1,72,"2017"
"40899","280380 MALHADA DOS BOIS",0,1,3,52,1,57,"2017"
"40900","280390 MALHADOR",0,1,3,170,2,176,"2017"
"40901","280400 MARUIM",0,2,7,265,5,279,"2017"
"40902","280410 MOITA BONITA",0,0,1,103,1,105,"2017"
"40903","280420 MONTE ALEGRE DE SERGIPE",0,0,1,205,30,236,"2017"
"40904","280430 MURIBECA",0,0,0,102,3,105,"2017"
"40905","280440 NEOPOLIS",0,0,3,226,12,241,"2017"
"40906","280445 NOSSA SENHORA APARECIDA",0,0,2,100,2,104,"2017"
"40907","280450 NOSSA SENHORA DA GLORIA",1,3,6,526,61,597,"2017"
"40908","280460 NOSSA SENHORA DAS DORES",1,1,5,318,19,344,"2017"
"40909","280470 NOSSA SENHORA DE LOURDES",0,0,2,90,7,99,"2017"
"40910","280480 NOSSA SENHORA DO SOCORRO",15,16,66,3091,47,3235,"2017"
"40911","280490 PACATUBA",2,2,6,208,17,235,"2017"
"40912","280500 PEDRA MOLE",0,0,1,43,0,44,"2017"
"40913","280510 PEDRINHAS",1,0,2,118,3,124,"2017"
"40914","280520 PINHAO",1,0,0,74,1,76,"2017"
"40915","280530 PIRAMBU",1,0,0,154,11,166,"2017"
"40916","280540 POCO REDONDO",0,0,9,492,45,546,"2017"
"40917","280550 POCO VERDE",1,1,3,277,7,289,"2017"
"40918","280560 PORTO DA FOLHA",2,3,5,345,32,387,"2017"
"40919","280570 PROPRIA",0,1,12,474,17,504,"2017"
"40920","280580 RIACHAO DO DANTAS",1,1,3,236,7,248,"2017"
"40921","280590 RIACHUELO",0,0,2,159,4,165,"2017"
"40922","280600 RIBEIROPOLIS",0,1,0,188,2,191,"2017"
"40923","280610 ROSARIO DO CATETE",0,0,4,175,4,183,"2017"
"40924","280620 SALGADO",0,2,8,272,6,288,"2017"
"40925","280630 SANTA LUZIA DO ITANHY",0,1,5,227,2,235,"2017"
"40926","280640 SANTANA DO SAO FRANCISCO",0,0,1,119,1,121,"2017"
"40927","280650 SANTA ROSA DE LIMA",1,0,0,68,3,72,"2017"
"40928","280660 SANTO AMARO DAS BROTAS",1,1,3,157,6,168,"2017"
"40929","280670 SAO CRISTOVAO",5,10,19,1257,32,1323,"2017"
"40930","280680 SAO DOMINGOS",2,0,1,150,1,154,"2017"
"40931","280690 SAO FRANCISCO",1,0,0,54,1,56,"2017"
"40932","280700 SAO MIGUEL DO ALEIXO",0,1,1,48,1,51,"2017"
"40933","280710 SIMAO DIAS",0,1,3,590,2,596,"2017"
"40934","280720 SIRIRI",0,0,2,106,6,114,"2017"
"40935","280730 TELHA",0,0,2,47,5,54,"2017"
"40936","280740 TOBIAS BARRETO",2,3,12,670,11,698,"2017"
"40937","280750 TOMAR DO GERU",1,1,1,187,2,192,"2017"
"40938","280760 UMBAUBA",3,2,4,396,5,410,"2017"
"40939","MUNICIPIO IGNORADO - BA",0,0,0,10,0,10,"2017"
"40940","290010 ABAIRA",0,0,0,36,8,44,"2017"
"40941","290020 ABARE",0,2,5,254,3,264,"2017"
"40942","290030 ACAJUTIBA",1,2,6,178,1,188,"2017"
"40943","290035 ADUSTINA",0,1,0,153,21,175,"2017"
"40944","290040 AGUA FRIA",3,2,3,155,7,170,"2017"
"40945","290050 ERICO CARDOSO",1,0,0,107,0,108,"2017"
"40946","290060 AIQUARA",0,0,1,67,0,68,"2017"
"40947","290070 ALAGOINHAS",11,11,40,2273,56,2391,"2017"
"40948","290080 ALCOBACA",0,1,5,286,1,293,"2017"
"40949","290090 ALMADINA",1,0,4,68,3,76,"2017"
"40950","290100 AMARGOSA",1,2,11,440,8,462,"2017"
"40951","290110 AMELIA RODRIGUES",3,4,4,193,18,222,"2017"
"40952","290115 AMERICA DOURADA",2,1,5,224,1,233,"2017"
"40953","290120 ANAGE",0,2,5,200,6,213,"2017"
"40954","290130 ANDARAI",0,0,3,172,1,176,"2017"
"40955","290135 ANDORINHA",1,1,3,187,0,192,"2017"
"40956","290140 ANGICAL",2,3,3,163,1,172,"2017"
"40957","290150 ANGUERA",0,0,2,65,15,82,"2017"
"40958","290160 ANTAS",0,0,1,132,7,140,"2017"
"40959","290170 ANTONIO CARDOSO",1,0,2,106,28,137,"2017"
"40960","290180 ANTONIO GONCALVES",0,1,4,154,6,165,"2017"
"40961","290190 APORA",0,1,4,177,8,190,"2017"
"40962","290195 APUAREMA",0,1,0,81,2,84,"2017"
"40963","290200 ARACATU",0,1,3,157,1,162,"2017"
"40964","290205 ARACAS",0,2,5,141,4,152,"2017"
"40965","290210 ARACI",1,6,15,702,26,750,"2017"
"40966","290220 ARAMARI",1,1,1,111,5,119,"2017"
"40967","290225 ARATACA",1,1,2,113,1,118,"2017"
"40968","290230 ARATUIPE",0,1,2,131,1,135,"2017"
"40969","290240 AURELINO LEAL",1,1,6,145,54,207,"2017"
"40970","290250 BAIANOPOLIS",2,3,5,156,0,166,"2017"
"40971","290260 BAIXA GRANDE",0,1,4,215,3,223,"2017"
"40972","290265 BANZAE",0,0,0,71,126,197,"2017"
"40973","290270 BARRA",3,7,14,931,8,963,"2017"
"40974","290280 BARRA DA ESTIVA",1,3,4,406,0,414,"2017"
"40975","290290 BARRA DO CHOCA",0,0,16,513,12,541,"2017"
"40976","290300 BARRA DO MENDES",0,0,6,199,0,205,"2017"
"40977","290310 BARRA DO ROCHA",0,0,1,58,1,60,"2017"
"40978","290320 BARREIRAS",10,16,60,2715,3,2804,"2017"
"40979","290323 BARRO ALTO",1,3,2,169,0,175,"2017"
"40980","290327 BARROCAS",0,0,9,207,1,217,"2017"
"40981","290330 BARRO PRETO",1,1,4,95,0,101,"2017"
"40982","290340 BELMONTE",1,0,3,312,27,343,"2017"
"40983","290350 BELO CAMPO",0,5,4,217,1,227,"2017"
"40984","290360 BIRITINGA",3,0,6,169,7,185,"2017"
"40985","290370 BOA NOVA",2,0,1,185,5,193,"2017"
"40986","290380 BOA VISTA DO TUPIM",1,1,4,229,3,238,"2017"
"40987","290390 BOM JESUS DA LAPA",3,4,11,1129,10,1157,"2017"
"40988","290395 BOM JESUS DA SERRA",0,0,3,128,2,133,"2017"
"40989","290400 BONINAL",0,0,3,168,7,178,"2017"
"40990","290405 BONITO",0,2,9,250,1,262,"2017"
"40991","290410 BOQUIRA",0,2,3,244,5,254,"2017"
"40992","290420 BOTUPORA",0,0,1,120,1,122,"2017"
"40993","290430 BREJOES",0,0,1,169,1,171,"2017"
"40994","290440 BREJOLANDIA",0,0,2,78,4,84,"2017"
"40995","290450 BROTAS DE MACAUBAS",1,2,6,126,1,136,"2017"
"40996","290460 BRUMADO",1,6,9,852,0,868,"2017"
"40997","290470 BUERAREMA",0,0,5,222,2,229,"2017"
"40998","290475 BURITIRAMA",1,2,3,313,0,319,"2017"
"40999","290480 CAATIBA",0,0,2,58,12,72,"2017"
"41000","290485 CABACEIRAS DO PARAGUACU",0,2,8,189,51,250,"2017"
"41001","290490 CACHOEIRA",2,3,2,180,209,396,"2017"
"41002","290500 CACULE",0,1,3,262,2,268,"2017"
"41003","290510 CAEM",1,1,0,151,8,161,"2017"
"41004","290515 CAETANOS",0,2,1,106,4,113,"2017"
"41005","290520 CAETITE",1,5,7,670,9,692,"2017"
"41006","290530 CAFARNAUM",2,2,4,274,0,282,"2017"
"41007","290540 CAIRU",1,5,9,271,2,288,"2017"
"41008","290550 CALDEIRAO GRANDE",1,0,0,202,3,206,"2017"
"41009","290560 CAMACAN",3,6,7,355,1,372,"2017"
"41010","290570 CAMACARI",20,21,62,4223,53,4379,"2017"
"41011","290580 CAMAMU",3,5,23,656,19,706,"2017"
"41012","290590 CAMPO ALEGRE DE LOURDES",0,1,3,448,30,482,"2017"
"41013","290600 CAMPO FORMOSO",3,7,18,989,65,1082,"2017"
"41014","290610 CANAPOLIS",1,1,5,143,0,150,"2017"
"41015","290620 CANARANA",0,1,7,364,2,374,"2017"
"41016","290630 CANAVIEIRAS",1,5,13,429,35,483,"2017"
"41017","290640 CANDEAL",0,0,0,93,17,110,"2017"
"41018","290650 CANDEIAS",7,10,12,975,2,1006,"2017"
"41019","290660 CANDIBA",0,0,2,160,1,163,"2017"
"41020","290670 CANDIDO SALES",2,6,9,318,6,341,"2017"
"41021","290680 CANSANCAO",0,4,5,485,8,502,"2017"
"41022","290682 CANUDOS",0,4,3,222,3,232,"2017"
"41023","290685 CAPELA DO ALTO ALEGRE",0,0,0,105,2,107,"2017"
"41024","290687 CAPIM GROSSO",0,2,3,507,1,513,"2017"
"41025","290689 CARAIBAS",0,1,0,100,2,103,"2017"
"41026","290690 CARAVELAS",1,2,2,253,2,260,"2017"
"41027","290700 CARDEAL DA SILVA",1,0,1,120,7,129,"2017"
"41028","290710 CARINHANHA",5,3,3,404,7,422,"2017"
"41029","290720 CASA NOVA",9,8,18,1044,8,1087,"2017"
"41030","290730 CASTRO ALVES",0,3,5,343,3,354,"2017"
"41031","290740 CATOLANDIA",0,0,2,56,1,59,"2017"
"41032","290750 CATU",2,3,9,545,4,563,"2017"
"41033","290755 CATURAMA",0,1,0,78,0,79,"2017"
"41034","290760 CENTRAL",1,2,2,233,2,240,"2017"
"41035","290770 CHORROCHO",0,2,3,173,3,181,"2017"
"41036","290780 CICERO DANTAS",2,4,4,274,74,358,"2017"
"41037","290790 CIPO",1,2,5,172,117,297,"2017"
"41038","290800 COARACI",5,4,5,249,3,266,"2017"
"41039","290810 COCOS",1,1,0,272,0,274,"2017"
"41040","290820 CONCEICAO DA FEIRA",1,1,2,79,140,223,"2017"
"41041","290830 CONCEICAO DO ALMEIDA",0,0,3,146,4,153,"2017"
"41042","290840 CONCEICAO DO COITE",2,4,20,1043,5,1074,"2017"
"41043","290850 CONCEICAO DO JACUIPE",0,1,7,320,35,363,"2017"
"41044","290860 CONDE",1,4,3,347,7,362,"2017"
"41045","290870 CONDEUBA",0,1,8,167,3,179,"2017"
"41046","290880 CONTENDAS DO SINCORA",1,0,0,33,0,34,"2017"
"41047","290890 CORACAO DE MARIA",0,0,2,224,42,268,"2017"
"41048","290900 CORDEIROS",0,1,1,78,0,80,"2017"
"41049","290910 CORIBE",1,0,3,163,1,168,"2017"
"41050","290920 CORONEL JOAO SA",0,0,2,186,4,192,"2017"
"41051","290930 CORRENTINA",1,1,0,132,288,422,"2017"
"41052","290940 COTEGIPE",1,0,2,148,4,155,"2017"
"41053","290950 CRAVOLANDIA",1,0,0,74,1,76,"2017"
"41054","290960 CRISOPOLIS",2,0,5,255,3,265,"2017"
"41055","290970 CRISTOPOLIS",1,1,7,158,3,170,"2017"
"41056","290980 CRUZ DAS ALMAS",6,4,18,780,35,843,"2017"
"41057","290990 CURACA",2,4,11,547,3,567,"2017"
"41058","291000 DARIO MEIRA",2,0,3,158,6,169,"2017"
"41059","291005 DIAS D'AVILA",5,4,23,1140,7,1179,"2017"
"41060","291010 DOM BASILIO",0,0,2,163,1,166,"2017"
"41061","291020 DOM MACEDO COSTA",0,2,2,54,0,58,"2017"
"41062","291030 ELISIO MEDRADO",0,1,6,70,2,79,"2017"
"41063","291040 ENCRUZILHADA",0,3,4,238,7,252,"2017"
"41064","291050 ENTRE RIOS",2,3,14,522,9,550,"2017"
"41065","291060 ESPLANADA",1,3,7,468,1,480,"2017"
"41066","291070 EUCLIDES DA CUNHA",2,1,10,751,22,786,"2017"
"41067","291072 EUNAPOLIS",6,14,27,1759,13,1819,"2017"
"41068","291075 FATIMA",0,2,2,179,8,191,"2017"
"41069","291077 FEIRA DA MATA",0,0,0,33,3,36,"2017"
"41070","291080 FEIRA DE SANTANA",10,33,100,8180,1971,10294,"2017"
"41071","291085 FILADELFIA",1,6,7,241,2,257,"2017"
"41072","291090 FIRMINO ALVES",1,0,0,43,0,44,"2017"
"41073","291100 FLORESTA AZUL",0,0,1,106,1,108,"2017"
"41074","291110 FORMOSA DO RIO PRETO",0,3,3,381,8,395,"2017"
"41075","291120 GANDU",0,9,15,429,2,455,"2017"
"41076","291125 GAVIAO",0,0,0,50,0,50,"2017"
"41077","291130 GENTIO DO OURO",0,0,3,118,1,122,"2017"
"41078","291140 GLORIA",2,3,12,225,2,244,"2017"
"41079","291150 GONGOGI",0,2,1,97,2,102,"2017"
"41080","291160 GOVERNADOR MANGABEIRA",0,2,5,187,47,241,"2017"
"41081","291165 GUAJERU",0,0,1,84,0,85,"2017"
"41082","291170 GUANAMBI",4,2,14,1128,41,1189,"2017"
"41083","291180 GUARATINGA",1,3,7,249,8,268,"2017"
"41084","291185 HELIOPOLIS",1,1,2,118,14,136,"2017"
"41085","291190 IACU",1,3,9,403,1,417,"2017"
"41086","291200 IBIASSUCE",0,0,2,100,1,103,"2017"
"41087","291210 IBICARAI",0,5,5,268,5,283,"2017"
"41088","291220 IBICOARA",4,0,4,338,0,346,"2017"
"41089","291230 IBICUI",0,1,2,146,3,152,"2017"
"41090","291240 IBIPEBA",1,3,3,185,1,193,"2017"
"41091","291250 IBIPITANGA",0,1,2,143,1,147,"2017"
"41092","291260 IBIQUERA",1,0,0,43,1,45,"2017"
"41093","291270 IBIRAPITANGA",1,6,14,338,3,362,"2017"
"41094","291280 IBIRAPUA",0,1,1,120,1,123,"2017"
"41095","291290 IBIRATAIA",1,2,5,308,1,317,"2017"
"41096","291300 IBITIARA",1,0,3,163,0,167,"2017"
"41097","291310 IBITITA",3,1,1,205,1,211,"2017"
"41098","291320 IBOTIRAMA",3,3,9,390,4,409,"2017"
"41099","291330 ICHU",0,0,0,27,4,31,"2017"
"41100","291340 IGAPORA",0,0,3,165,3,171,"2017"
"41101","291345 IGRAPIUNA",0,1,9,174,0,184,"2017"
"41102","291350 IGUAI",3,3,2,364,0,372,"2017"
"41103","291360 ILHEUS",11,18,36,2035,460,2560,"2017"
"41104","291370 INHAMBUPE",2,4,14,419,8,447,"2017"
"41105","291380 IPECAETA",1,0,1,120,26,148,"2017"
"41106","291390 IPIAU",1,5,14,640,6,666,"2017"
"41107","291400 IPIRA",1,5,8,798,15,827,"2017"
"41108","291410 IPUPIARA",0,0,2,105,0,107,"2017"
"41109","291420 IRAJUBA",0,0,1,58,0,59,"2017"
"41110","291430 IRAMAIA",1,0,4,104,1,110,"2017"
"41111","291440 IRAQUARA",0,3,0,366,4,373,"2017"
"41112","291450 IRARA",1,2,5,299,24,331,"2017"
"41113","291460 IRECE",4,4,20,1285,0,1313,"2017"
"41114","291465 ITABELA",0,0,11,498,1,510,"2017"
"41115","291470 ITABERABA",1,1,8,857,4,871,"2017"
"41116","291480 ITABUNA",9,16,64,2838,13,2940,"2017"
"41117","291490 ITACARE",2,1,7,267,63,340,"2017"
"41118","291500 ITAETE",0,1,4,211,2,218,"2017"
"41119","291510 ITAGI",0,0,2,168,3,173,"2017"
"41120","291520 ITAGIBA",1,1,3,187,2,194,"2017"
"41121","291530 ITAGIMIRIM",0,0,4,61,2,67,"2017"
"41122","291535 ITAGUACU DA BAHIA",0,3,2,180,2,187,"2017"
"41123","291540 ITAJU DO COLONIA",0,5,2,84,8,99,"2017"
"41124","291550 ITAJUIPE",2,0,6,272,1,281,"2017"
"41125","291560 ITAMARAJU",1,6,22,965,20,1014,"2017"
"41126","291570 ITAMARI",3,1,1,105,0,110,"2017"
"41127","291580 ITAMBE",2,2,6,250,4,264,"2017"
"41128","291590 ITANAGRA",0,3,1,76,2,82,"2017"
"41129","291600 ITANHEM",1,0,6,176,0,183,"2017"
"41130","291610 ITAPARICA",2,0,3,209,19,233,"2017"
"41131","291620 ITAPE",0,3,3,114,3,123,"2017"
"41132","291630 ITAPEBI",0,1,1,131,3,136,"2017"
"41133","291640 ITAPETINGA",2,3,15,772,205,997,"2017"
"41134","291650 ITAPICURU",1,1,4,339,31,376,"2017"
"41135","291660 ITAPITANGA",1,0,2,89,0,92,"2017"
"41136","291670 ITAQUARA",0,2,1,90,7,100,"2017"
"41137","291680 ITARANTIM",1,0,3,185,25,214,"2017"
"41138","291685 ITATIM",0,0,4,152,21,177,"2017"
"41139","291690 ITIRUCU",0,3,4,113,0,120,"2017"
"41140","291700 ITIUBA",2,4,11,461,10,488,"2017"
"41141","291710 ITORORO",1,1,8,123,35,168,"2017"
"41142","291720 ITUACU",0,1,2,245,1,249,"2017"
"41143","291730 ITUBERA",3,3,13,329,6,354,"2017"
"41144","291733 IUIU",0,1,0,110,3,114,"2017"
"41145","291735 JABORANDI",0,0,1,132,0,133,"2017"
"41146","291740 JACARACI",0,1,2,152,0,155,"2017"
"41147","291750 JACOBINA",4,7,16,1266,9,1302,"2017"
"41148","291760 JAGUAQUARA",2,5,10,740,4,761,"2017"
"41149","291770 JAGUARARI",2,3,14,392,6,417,"2017"
"41150","291780 JAGUARIPE",0,1,5,203,4,213,"2017"
"41151","291790 JANDAIRA",0,0,3,140,2,145,"2017"
"41152","291800 JEQUIE",7,8,26,2381,21,2443,"2017"
"41153","291810 JEREMOABO",2,3,5,451,10,471,"2017"
"41154","291820 JIQUIRICA",1,0,2,146,3,152,"2017"
"41155","291830 JITAUNA",1,1,2,137,3,144,"2017"
"41156","291835 JOAO DOURADO",2,2,12,424,1,441,"2017"
"41157","291840 JUAZEIRO",14,29,101,4229,45,4418,"2017"
"41158","291845 JUCURUCU",1,0,2,80,4,87,"2017"
"41159","291850 JUSSARA",1,2,6,194,1,204,"2017"
"41160","291855 JUSSARI",0,0,2,95,1,98,"2017"
"41161","291860 JUSSIAPE",1,0,0,75,1,77,"2017"
"41162","291870 LAFAIETE COUTINHO",0,0,1,43,0,44,"2017"
"41163","291875 LAGOA REAL",0,0,1,164,0,165,"2017"
"41164","291880 LAJE",1,1,7,244,6,259,"2017"
"41165","291890 LAJEDAO",0,0,2,52,0,54,"2017"
"41166","291900 LAJEDINHO",1,2,0,39,0,42,"2017"
"41167","291905 LAJEDO DO TABOCAL",0,0,3,83,2,88,"2017"
"41168","291910 LAMARAO",1,1,5,62,2,71,"2017"
"41169","291915 LAPAO",0,4,15,418,0,437,"2017"
"41170","291920 LAURO DE FREITAS",16,18,39,2902,23,2998,"2017"
"41171","291930 LENCOIS",3,0,1,113,0,117,"2017"
"41172","291940 LICINIO DE ALMEIDA",1,2,2,131,2,138,"2017"
"41173","291950 LIVRAMENTO DE NOSSA SENHORA",0,1,6,576,2,585,"2017"
"41174","291955 LUIS EDUARDO MAGALHAES",8,5,40,1708,8,1769,"2017"
"41175","291960 MACAJUBA",0,0,3,145,0,148,"2017"
"41176","291970 MACARANI",3,1,5,185,27,221,"2017"
"41177","291980 MACAUBAS",1,1,6,543,1,552,"2017"
"41178","291990 MACURURE",0,1,2,86,1,90,"2017"
"41179","291992 MADRE DE DEUS",1,0,5,277,1,284,"2017"
"41180","291995 MAETINGA",0,2,2,65,0,69,"2017"
"41181","292000 MAIQUINIQUE",1,1,1,82,16,101,"2017"
"41182","292010 MAIRI",0,0,4,193,7,204,"2017"
"41183","292020 MALHADA",0,0,4,220,24,248,"2017"
"41184","292030 MALHADA DE PEDRAS",0,0,2,89,0,91,"2017"
"41185","292040 MANOEL VITORINO",0,1,3,186,4,194,"2017"
"41186","292045 MANSIDAO",1,0,7,94,0,102,"2017"
"41187","292050 MARACAS",0,1,4,360,4,369,"2017"
"41188","292060 MARAGOGIPE",1,2,4,204,238,449,"2017"
"41189","292070 MARAU",1,3,7,211,25,247,"2017"
"41190","292080 MARCIONILIO SOUZA",0,0,1,127,0,128,"2017"
"41191","292090 MASCOTE",0,0,2,171,1,174,"2017"
"41192","292100 MATA DE SAO JOAO",3,8,18,673,11,713,"2017"
"41193","292105 MATINA",0,0,3,124,1,128,"2017"
"41194","292110 MEDEIROS NETO",0,1,8,256,0,265,"2017"
"41195","292120 MIGUEL CALMON",3,1,8,363,1,376,"2017"
"41196","292130 MILAGRES",0,1,3,130,5,139,"2017"
"41197","292140 MIRANGABA",0,0,4,199,2,205,"2017"
"41198","292145 MIRANTE",0,0,4,88,0,92,"2017"
"41199","292150 MONTE SANTO",1,5,14,693,10,723,"2017"
"41200","292160 MORPARA",0,1,1,103,3,108,"2017"
"41201","292170 MORRO DO CHAPEU",1,4,4,529,1,539,"2017"
"41202","292180 MORTUGABA",0,0,3,120,1,124,"2017"
"41203","292190 MUCUGE",0,0,3,163,2,168,"2017"
"41204","292200 MUCURI",1,4,10,652,0,667,"2017"
"41205","292205 MULUNGU DO MORRO",1,1,10,189,0,201,"2017"
"41206","292210 MUNDO NOVO",1,1,1,236,1,240,"2017"
"41207","292220 MUNIZ FERREIRA",0,0,1,101,4,106,"2017"
"41208","292225 MUQUEM DE SAO FRANCISCO",1,0,6,152,4,163,"2017"
"41209","292230 MURITIBA",1,2,6,249,96,354,"2017"
"41210","292240 MUTUIPE",2,3,6,289,2,302,"2017"
"41211","292250 NAZARE",1,3,4,313,4,325,"2017"
"41212","292260 NILO PECANHA",0,1,13,176,0,190,"2017"
"41213","292265 NORDESTINA",1,1,3,183,3,191,"2017"
"41214","292270 NOVA CANAA",0,6,5,137,2,150,"2017"
"41215","292273 NOVA FATIMA",0,0,1,69,1,71,"2017"
"41216","292275 NOVA IBIA",0,2,2,68,2,74,"2017"
"41217","292280 NOVA ITARANA",1,2,1,106,2,112,"2017"
"41218","292285 NOVA REDENCAO",1,0,1,100,0,102,"2017"
"41219","292290 NOVA SOURE",1,2,6,240,86,335,"2017"
"41220","292300 NOVA VICOSA",2,3,14,570,2,591,"2017"
"41221","292303 NOVO HORIZONTE",1,0,1,115,0,117,"2017"
"41222","292305 NOVO TRIUNFO",0,0,2,80,1,83,"2017"
"41223","292310 OLINDINA",1,1,1,263,27,293,"2017"
"41224","292320 OLIVEIRA DOS BREJINHOS",2,0,4,270,13,289,"2017"
"41225","292330 OURICANGAS",0,0,2,73,4,79,"2017"
"41226","292335 OUROLANDIA",1,2,9,295,1,308,"2017"
"41227","292340 PALMAS DE MONTE ALTO",1,4,2,243,8,258,"2017"
"41228","292350 PALMEIRAS",0,0,1,148,18,167,"2017"
"41229","292360 PARAMIRIM",1,3,1,225,0,230,"2017"
"41230","292370 PARATINGA",1,3,15,395,5,419,"2017"
"41231","292380 PARIPIRANGA",1,0,2,261,2,266,"2017"
"41232","292390 PAU BRASIL",0,1,3,163,4,171,"2017"
"41233","292400 PAULO AFONSO",7,11,57,1649,6,1730,"2017"
"41234","292405 PE DE SERRA",0,3,4,151,7,165,"2017"
"41235","292410 PEDRAO",0,1,3,82,1,87,"2017"
"41236","292420 PEDRO ALEXANDRE",1,2,3,157,6,169,"2017"
"41237","292430 PIATA",1,1,5,239,1,247,"2017"
"41238","292440 PILAO ARCADO",2,2,12,587,6,609,"2017"
"41239","292450 PINDAI",0,0,3,170,2,175,"2017"
"41240","292460 PINDOBACU",2,4,7,254,1,268,"2017"
"41241","292465 PINTADAS",0,0,0,83,4,87,"2017"
"41242","292467 PIRAI DO NORTE",0,1,5,111,7,124,"2017"
"41243","292470 PIRIPA",0,0,5,94,1,100,"2017"
"41244","292480 PIRITIBA",0,2,2,243,2,249,"2017"
"41245","292490 PLANALTINO",1,0,0,71,1,73,"2017"
"41246","292500 PLANALTO",1,1,10,282,4,298,"2017"
"41247","292510 POCOES",0,0,15,621,4,640,"2017"
"41248","292520 POJUCA",2,5,9,434,5,455,"2017"
"41249","292525 PONTO NOVO",2,2,5,262,3,274,"2017"
"41250","292530 PORTO SEGURO",7,8,40,2655,55,2765,"2017"
"41251","292540 POTIRAGUA",0,1,1,103,7,112,"2017"
"41252","292550 PRADO",2,1,9,423,7,442,"2017"
"41253","292560 PRESIDENTE DUTRA",1,2,5,170,0,178,"2017"
"41254","292570 PRESIDENTE JANIO QUADROS",0,0,3,136,5,144,"2017"
"41255","292575 PRESIDENTE TANCREDO NEVES",2,2,7,265,114,390,"2017"
"41256","292580 QUEIMADAS",0,0,1,302,1,304,"2017"
"41257","292590 QUIJINGUE",1,4,5,340,13,363,"2017"
"41258","292593 QUIXABEIRA",0,0,2,94,0,96,"2017"
"41259","292595 RAFAEL JAMBEIRO",1,1,5,246,25,278,"2017"
"41260","292600 REMANSO",0,3,3,661,3,670,"2017"
"41261","292610 RETIROLANDIA",0,2,1,206,8,217,"2017"
"41262","292620 RIACHAO DAS NEVES",0,0,3,287,5,295,"2017"
"41263","292630 RIACHAO DO JACUIPE",1,2,6,407,3,419,"2017"
"41264","292640 RIACHO DE SANTANA",0,3,5,355,14,377,"2017"
"41265","292650 RIBEIRA DO AMPARO",0,1,2,99,90,192,"2017"
"41266","292660 RIBEIRA DO POMBAL",1,1,3,231,517,753,"2017"
"41267","292665 RIBEIRAO DO LARGO",1,0,2,76,5,84,"2017"
"41268","292670 RIO DE CONTAS",0,3,5,151,5,164,"2017"
"41269","292680 RIO DO ANTONIO",2,1,1,128,5,137,"2017"
"41270","292690 RIO DO PIRES",0,4,1,99,0,104,"2017"
"41271","292700 RIO REAL",1,6,10,465,9,491,"2017"
"41272","292710 RODELAS",1,2,3,185,2,193,"2017"
"41273","292720 RUY BARBOSA",4,4,18,433,2,461,"2017"
"41274","292730 SALINAS DA MARGARIDA",1,2,4,151,1,159,"2017"
"41275","292740 SALVADOR",187,204,697,34044,235,35367,"2017"
"41276","292750 SANTA BARBARA",0,2,5,176,34,217,"2017"
"41277","292760 SANTA BRIGIDA",1,1,8,172,3,185,"2017"
"41278","292770 SANTA CRUZ CABRALIA",1,1,10,429,4,445,"2017"
"41279","292780 SANTA CRUZ DA VITORIA",0,0,1,66,0,67,"2017"
"41280","292790 SANTA INES",2,0,1,118,0,121,"2017"
"41281","292800 SANTALUZ",1,3,16,469,2,491,"2017"
"41282","292805 SANTA LUZIA",1,3,4,154,7,169,"2017"
"41283","292810 SANTA MARIA DA VITORIA",1,5,11,453,11,481,"2017"
"41284","292820 SANTANA",0,3,7,308,2,320,"2017"
"41285","292830 SANTANOPOLIS",0,0,0,59,11,70,"2017"
"41286","292840 SANTA RITA DE CASSIA",1,6,11,372,8,398,"2017"
"41287","292850 SANTA TERESINHA",0,0,7,99,2,108,"2017"
"41288","292860 SANTO AMARO",4,5,16,630,17,672,"2017"
"41289","292870 SANTO ANTONIO DE JESUS",6,9,46,1321,31,1413,"2017"
"41290","292880 SANTO ESTEVAO",0,5,17,656,81,759,"2017"
"41291","292890 SAO DESIDERIO",1,3,11,484,10,509,"2017"
"41292","292895 SAO DOMINGOS",0,0,0,86,0,86,"2017"
"41293","292900 SAO FELIX",0,2,0,26,137,165,"2017"
"41294","292905 SAO FELIX DO CORIBE",1,1,8,225,2,237,"2017"
"41295","292910 SAO FELIPE",1,3,3,197,9,213,"2017"
"41296","292920 SAO FRANCISCO DO CONDE",3,1,13,615,1,633,"2017"
"41297","292925 SAO GABRIEL",3,1,6,240,3,253,"2017"
"41298","292930 SAO GONCALO DOS CAMPOS",2,2,4,281,56,345,"2017"
"41299","292935 SAO JOSE DA VITORIA",0,0,3,96,0,99,"2017"
"41300","292937 SAO JOSE DO JACUIPE",0,1,0,126,0,127,"2017"
"41301","292940 SAO MIGUEL DAS MATAS",0,1,1,101,3,106,"2017"
"41302","292950 SAO SEBASTIAO DO PASSE",2,5,4,552,4,567,"2017"
"41303","292960 SAPEACU",1,1,3,225,19,249,"2017"
"41304","292970 SATIRO DIAS",0,1,6,203,7,217,"2017"
"41305","292975 SAUBARA",0,1,1,105,0,107,"2017"
"41306","292980 SAUDE",2,0,0,127,1,130,"2017"
"41307","292990 SEABRA",1,5,4,568,14,592,"2017"
"41308","293000 SEBASTIAO LARANJEIRAS",0,0,0,80,3,83,"2017"
"41309","293010 SENHOR DO BONFIM",6,8,23,1109,14,1160,"2017"
"41310","293015 SERRA DO RAMALHO",1,5,4,480,20,510,"2017"
"41311","293020 SENTO SE",1,2,11,500,7,521,"2017"
"41312","293030 SERRA DOURADA",0,3,4,225,1,233,"2017"
"41313","293040 SERRA PRETA",1,1,2,99,21,124,"2017"
"41314","293050 SERRINHA",2,17,101,1086,10,1216,"2017"
"41315","293060 SERROLANDIA",1,0,8,176,2,187,"2017"
"41316","293070 SIMOES FILHO",11,7,30,1857,6,1911,"2017"
"41317","293075 SITIO DO MATO",1,1,7,222,3,234,"2017"
"41318","293076 SITIO DO QUINTO",0,1,0,140,6,147,"2017"
"41319","293077 SOBRADINHO",1,4,10,412,6,433,"2017"
"41320","293080 SOUTO SOARES",1,1,4,180,1,187,"2017"
"41321","293090 TABOCAS DO BREJO VELHO",1,1,2,147,1,152,"2017"
"41322","293100 TANHACU",0,3,5,222,1,231,"2017"
"41323","293105 TANQUE NOVO",1,1,7,213,2,224,"2017"
"41324","293110 TANQUINHO",0,1,0,52,11,64,"2017"
"41325","293120 TAPEROA",1,2,15,212,17,247,"2017"
"41326","293130 TAPIRAMUTA",0,1,3,189,2,195,"2017"
"41327","293135 TEIXEIRA DE FREITAS",2,15,31,2567,15,2630,"2017"
"41328","293140 TEODORO SAMPAIO",0,0,1,44,6,51,"2017"
"41329","293150 TEOFILANDIA",1,2,7,288,12,310,"2017"
"41330","293160 TEOLANDIA",0,0,4,150,11,165,"2017"
"41331","293170 TERRA NOVA",0,0,1,107,4,112,"2017"
"41332","293180 TREMEDAL",0,2,4,171,5,182,"2017"
"41333","293190 TUCANO",0,1,14,409,147,571,"2017"
"41334","293200 UAUA",0,0,10,312,3,325,"2017"
"41335","293210 UBAIRA",1,1,5,234,0,241,"2017"
"41336","293220 UBAITABA",0,6,3,275,23,307,"2017"
"41337","293230 UBATA",2,1,10,199,2,214,"2017"
"41338","293240 UIBAI",0,0,2,187,1,190,"2017"
"41339","293245 UMBURANAS",0,0,7,155,10,172,"2017"
"41340","293250 UNA",0,4,6,157,76,243,"2017"
"41341","293260 URANDI",0,1,3,201,2,207,"2017"
"41342","293270 URUCUCA",0,1,7,208,64,280,"2017"
"41343","293280 UTINGA",0,0,5,238,4,247,"2017"
"41344","293290 VALENCA",8,16,93,1420,6,1543,"2017"
"41345","293300 VALENTE",0,4,8,262,4,278,"2017"
"41346","293305 VARZEA DA ROCA",0,1,1,162,3,167,"2017"
"41347","293310 VARZEA DO POCO",0,0,1,97,0,98,"2017"
"41348","293315 VARZEA NOVA",0,0,5,206,4,215,"2017"
"41349","293317 VARZEDO",1,1,4,119,2,127,"2017"
"41350","293320 VERA CRUZ",1,0,10,437,39,487,"2017"
"41351","293325 VEREDA",1,0,1,67,0,69,"2017"
"41352","293330 VITORIA DA CONQUISTA",16,22,87,5704,50,5879,"2017"
"41353","293340 WAGNER",0,0,0,124,1,125,"2017"
"41354","293345 WANDERLEY",2,2,3,167,1,175,"2017"
"41355","293350 WENCESLAU GUIMARAES",2,4,15,350,15,386,"2017"
"41356","293360 XIQUE-XIQUE",0,8,17,737,28,790,"2017"
"41357","MUNICIPIO IGNORADO - MG",0,0,1,1,0,2,"2017"
"41358","310010 ABADIA DOS DOURADOS",0,0,0,52,0,52,"2017"
"41359","310020 ABAETE",0,0,1,242,1,244,"2017"
"41360","310030 ABRE CAMPO",0,0,0,101,34,135,"2017"
"41361","310040 ACAIACA",0,0,0,36,0,36,"2017"
"41362","310050 ACUCENA",0,1,0,112,0,113,"2017"
"41363","310060 AGUA BOA",0,1,3,182,4,190,"2017"
"41364","310070 AGUA COMPRIDA",0,0,1,19,0,20,"2017"
"41365","310080 AGUANIL",0,1,1,42,0,44,"2017"
"41366","310090 AGUAS FORMOSAS",1,0,1,252,0,254,"2017"
"41367","310100 AGUAS VERMELHAS",0,1,3,164,5,173,"2017"
"41368","310110 AIMORES",1,2,8,305,2,318,"2017"
"41369","310120 AIURUOCA",0,0,0,52,1,53,"2017"
"41370","310130 ALAGOA",0,0,0,20,0,20,"2017"
"41371","310140 ALBERTINA",0,0,0,23,0,23,"2017"
"41372","310150 ALEM PARAIBA",1,2,8,396,0,407,"2017"
"41373","310160 ALFENAS",1,4,15,978,0,998,"2017"
"41374","310163 ALFREDO VASCONCELOS",1,1,0,47,0,49,"2017"
"41375","310170 ALMENARA",4,5,7,555,1,572,"2017"
"41376","310180 ALPERCATA",1,0,1,82,8,92,"2017"
"41377","310190 ALPINOPOLIS",0,0,1,227,0,228,"2017"
"41378","310200 ALTEROSA",0,0,0,186,0,186,"2017"
"41379","310205 ALTO CAPARAO",0,0,0,45,32,77,"2017"
"41380","310210 ALTO RIO DOCE",0,1,2,104,4,111,"2017"
"41381","310220 ALVARENGA",0,0,0,47,4,51,"2017"
"41382","310230 ALVINOPOLIS",0,2,6,146,2,156,"2017"
"41383","310240 ALVORADA DE MINAS",0,0,0,59,0,59,"2017"
"41384","310250 AMPARO DO SERRA",0,0,0,65,0,65,"2017"
"41385","310260 ANDRADAS",1,1,5,500,0,507,"2017"
"41386","310270 CACHOEIRA DE PAJEU",0,0,3,74,1,78,"2017"
"41387","310280 ANDRELANDIA",0,1,0,109,1,111,"2017"
"41388","310285 ANGELANDIA",0,0,1,100,2,103,"2017"
"41389","310290 ANTONIO CARLOS",0,1,0,129,0,130,"2017"
"41390","310300 ANTONIO DIAS",0,1,1,91,2,95,"2017"
"41391","310310 ANTONIO PRADO DE MINAS",0,0,0,8,1,9,"2017"
"41392","310320 ARACAI",0,0,0,30,0,30,"2017"
"41393","310330 ARACITABA",0,0,0,18,0,18,"2017"
"41394","310340 ARACUAI",1,0,9,417,3,430,"2017"
"41395","310350 ARAGUARI",1,9,12,1386,13,1421,"2017"
"41396","310360 ARANTINA",0,0,1,36,1,38,"2017"
"41397","310370 ARAPONGA",0,0,5,75,4,84,"2017"
"41398","310375 ARAPORA",1,0,2,120,2,125,"2017"
"41399","310380 ARAPUA",0,0,0,17,0,17,"2017"
"41400","310390 ARAUJOS",0,0,0,94,0,94,"2017"
"41401","310400 ARAXA",2,4,8,1492,8,1514,"2017"
"41402","310410 ARCEBURGO",0,1,1,70,0,72,"2017"
"41403","310420 ARCOS",3,0,4,490,1,498,"2017"
"41404","310430 AREADO",0,0,2,153,0,155,"2017"
"41405","310440 ARGIRITA",0,0,0,24,0,24,"2017"
"41406","310445 ARICANDUVA",0,0,1,61,0,62,"2017"
"41407","310450 ARINOS",1,2,0,204,2,209,"2017"
"41408","310460 ASTOLFO DUTRA",1,0,2,124,0,127,"2017"
"41409","310470 ATALEIA",2,1,3,104,34,144,"2017"
"41410","310480 AUGUSTO DE LIMA",0,0,3,35,0,38,"2017"
"41411","310490 BAEPENDI",1,0,1,187,0,189,"2017"
"41412","310500 BALDIM",0,1,0,73,1,75,"2017"
"41413","310510 BAMBUI",0,0,4,230,0,234,"2017"
"41414","310520 BANDEIRA",1,0,0,36,0,37,"2017"
"41415","310530 BANDEIRA DO SUL",1,0,1,65,1,68,"2017"
"41416","310540 BARAO DE COCAIS",1,1,4,363,2,371,"2017"
"41417","310550 BARAO DE MONTE ALTO",1,0,2,35,1,39,"2017"
"41418","310560 BARBACENA",3,3,12,1346,6,1370,"2017"
"41419","310570 BARRA LONGA",1,3,0,48,0,52,"2017"
"41420","310590 BARROSO",0,2,1,235,0,238,"2017"
"41421","310600 BELA VISTA DE MINAS",0,0,2,117,0,119,"2017"
"41422","310610 BELMIRO BRAGA",0,0,0,30,0,30,"2017"
"41423","310620 BELO HORIZONTE",91,128,495,29335,95,30144,"2017"
"41424","310630 BELO ORIENTE",1,1,6,295,1,304,"2017"
"41425","310640 BELO VALE",1,0,0,108,0,109,"2017"
"41426","310650 BERILO",0,0,1,81,2,84,"2017"
"41427","310660 BERTOPOLIS",0,0,0,66,17,83,"2017"
"41428","310665 BERIZAL",0,0,0,52,4,56,"2017"
"41429","310670 BETIM",13,24,83,5780,17,5917,"2017"
"41430","310680 BIAS FORTES",0,0,0,25,1,26,"2017"
"41431","310690 BICAS",0,0,0,147,0,147,"2017"
"41432","310700 BIQUINHAS",0,0,0,17,1,18,"2017"
"41433","310710 BOA ESPERANCA",2,2,3,527,0,534,"2017"
"41434","310720 BOCAINA DE MINAS",0,0,0,39,0,39,"2017"
"41435","310730 BOCAIUVA",2,5,6,626,11,650,"2017"
"41436","310740 BOM DESPACHO",3,2,14,651,0,670,"2017"
"41437","310750 BOM JARDIM DE MINAS",1,0,0,68,0,69,"2017"
"41438","310760 BOM JESUS DA PENHA",0,0,1,36,0,37,"2017"
"41439","310770 BOM JESUS DO AMPARO",0,0,0,74,0,74,"2017"
"41440","310780 BOM JESUS DO GALHO",1,0,2,151,1,155,"2017"
"41441","310790 BOM REPOUSO",0,1,2,142,0,145,"2017"
"41442","310800 BOM SUCESSO",0,0,2,177,0,179,"2017"
"41443","310810 BONFIM",0,1,1,48,1,51,"2017"
"41444","310820 BONFINOPOLIS DE MINAS",1,0,0,58,3,62,"2017"
"41445","310825 BONITO DE MINAS",1,0,0,109,24,134,"2017"
"41446","310830 BORDA DA MATA",0,0,0,187,0,187,"2017"
"41447","310840 BOTELHOS",2,2,5,138,1,148,"2017"
"41448","310850 BOTUMIRIM",0,1,1,51,3,56,"2017"
"41449","310855 BRASILANDIA DE MINAS",0,0,4,208,7,219,"2017"
"41450","310860 BRASILIA DE MINAS",1,2,3,444,1,451,"2017"
"41451","310870 BRAS PIRES",0,0,1,33,0,34,"2017"
"41452","310880 BRAUNAS",0,1,0,36,0,37,"2017"
"41453","310890 BRAZOPOLIS",0,0,4,163,1,168,"2017"
"41454","310900 BRUMADINHO",0,0,3,431,4,438,"2017"
"41455","310910 BUENO BRANDAO",0,0,1,90,0,91,"2017"
"41456","310920 BUENOPOLIS",1,1,8,102,1,113,"2017"
"41457","310925 BUGRE",0,0,0,47,0,47,"2017"
"41458","310930 BURITIS",1,4,5,364,1,375,"2017"
"41459","310940 BURITIZEIRO",2,3,4,355,7,371,"2017"
"41460","310945 CABECEIRA GRANDE",0,0,0,74,0,74,"2017"
"41461","310950 CABO VERDE",0,1,1,162,0,164,"2017"
"41462","310960 CACHOEIRA DA PRATA",0,2,0,37,0,39,"2017"
"41463","310970 CACHOEIRA DE MINAS",0,0,3,111,0,114,"2017"
"41464","310980 CACHOEIRA DOURADA",1,0,0,23,0,24,"2017"
"41465","310990 CAETANOPOLIS",0,1,3,115,0,119,"2017"
"41466","311000 CAETE",1,0,4,482,10,497,"2017"
"41467","311010 CAIANA",0,0,0,63,0,63,"2017"
"41468","311020 CAJURI",0,0,0,35,0,35,"2017"
"41469","311030 CALDAS",0,0,7,105,0,112,"2017"
"41470","311040 CAMACHO",0,0,0,25,0,25,"2017"
"41471","311050 CAMANDUCAIA",1,0,1,275,3,280,"2017"
"41472","311060 CAMBUI",0,0,4,354,2,360,"2017"
"41473","311070 CAMBUQUIRA",0,1,0,134,0,135,"2017"
"41474","311080 CAMPANARIO",0,0,0,45,0,45,"2017"
"41475","311090 CAMPANHA",1,0,5,185,2,193,"2017"
"41476","311100 CAMPESTRE",1,1,1,176,0,179,"2017"
"41477","311110 CAMPINA VERDE",3,0,1,157,0,161,"2017"
"41478","311115 CAMPO AZUL",1,0,0,55,1,57,"2017"
"41479","311120 CAMPO BELO",2,1,11,595,0,609,"2017"
"41480","311130 CAMPO DO MEIO",1,0,0,144,0,145,"2017"
"41481","311140 CAMPO FLORIDO",0,1,4,87,1,93,"2017"
"41482","311150 CAMPOS ALTOS",1,0,1,183,0,185,"2017"
"41483","311160 CAMPOS GERAIS",0,2,4,281,2,289,"2017"
"41484","311170 CANAA",0,0,1,47,1,49,"2017"
"41485","311180 CANAPOLIS",0,1,3,124,7,135,"2017"
"41486","311190 CANA VERDE",0,0,1,59,0,60,"2017"
"41487","311200 CANDEIAS",0,0,0,117,0,117,"2017"
"41488","311205 CANTAGALO",1,0,0,59,0,60,"2017"
"41489","311210 CAPARAO",0,0,2,77,4,83,"2017"
"41490","311220 CAPELA NOVA",0,0,1,39,0,40,"2017"
"41491","311230 CAPELINHA",0,1,5,580,5,591,"2017"
"41492","311240 CAPETINGA",0,1,3,57,0,61,"2017"
"41493","311250 CAPIM BRANCO",2,0,0,119,2,123,"2017"
"41494","311260 CAPINOPOLIS",1,0,2,162,2,167,"2017"
"41495","311265 CAPITAO ANDRADE",0,0,1,62,5,68,"2017"
"41496","311270 CAPITAO ENEAS",0,2,4,177,3,186,"2017"
"41497","311280 CAPITOLIO",0,1,1,98,1,101,"2017"
"41498","311290 CAPUTIRA",0,0,0,17,108,125,"2017"
"41499","311300 CARAI",1,3,8,262,2,276,"2017"
"41500","311310 CARANAIBA",0,1,1,23,0,25,"2017"
"41501","311320 CARANDAI",1,1,3,293,2,300,"2017"
"41502","311330 CARANGOLA",0,2,6,407,0,415,"2017"
"41503","311340 CARATINGA",4,3,12,1085,37,1141,"2017"
"41504","311350 CARBONITA",0,1,1,87,1,90,"2017"
"41505","311360 CAREACU",0,0,2,65,1,68,"2017"
"41506","311370 CARLOS CHAGAS",0,2,2,207,2,213,"2017"
"41507","311380 CARMESIA",0,1,1,28,0,30,"2017"
"41508","311390 CARMO DA CACHOEIRA",0,0,1,133,0,134,"2017"
"41509","311400 CARMO DA MATA",0,0,2,92,0,94,"2017"
"41510","311410 CARMO DE MINAS",0,0,2,155,0,157,"2017"
"41511","311420 CARMO DO CAJURU",0,1,5,256,0,262,"2017"
"41512","311430 CARMO DO PARANAIBA",0,0,4,339,0,343,"2017"
"41513","311440 CARMO DO RIO CLARO",0,0,3,192,1,196,"2017"
"41514","311450 CARMOPOLIS DE MINAS",1,0,2,230,3,236,"2017"
"41515","311455 CARNEIRINHO",0,0,0,104,0,104,"2017"
"41516","311460 CARRANCAS",1,0,0,62,0,63,"2017"
"41517","311470 CARVALHOPOLIS",0,0,0,34,0,34,"2017"
"41518","311480 CARVALHOS",0,0,0,50,0,50,"2017"
"41519","311490 CASA GRANDE",0,0,0,20,0,20,"2017"
"41520","311500 CASCALHO RICO",0,0,0,32,0,32,"2017"
"41521","311510 CASSIA",0,0,3,209,0,212,"2017"
"41522","311520 CONCEICAO DA BARRA DE MINAS",0,0,0,29,0,29,"2017"
"41523","311530 CATAGUASES",8,4,26,788,0,826,"2017"
"41524","311535 CATAS ALTAS",0,0,2,58,2,62,"2017"
"41525","311540 CATAS ALTAS DA NORUEGA",0,0,0,27,0,27,"2017"
"41526","311545 CATUJI",0,1,3,133,2,139,"2017"
"41527","311547 CATUTI",1,0,1,34,32,68,"2017"
"41528","311550 CAXAMBU",2,1,2,182,43,230,"2017"
"41529","311560 CEDRO DO ABAETE",0,0,1,5,0,6,"2017"
"41530","311570 CENTRAL DE MINAS",0,0,0,77,2,79,"2017"
"41531","311580 CENTRALINA",0,0,2,91,9,102,"2017"
"41532","311590 CHACARA",0,0,0,39,0,39,"2017"
"41533","311600 CHALE",0,0,0,46,33,79,"2017"
"41534","311610 CHAPADA DO NORTE",0,0,1,104,2,107,"2017"
"41535","311615 CHAPADA GAUCHA",1,0,3,174,0,178,"2017"
"41536","311620 CHIADOR",0,0,0,24,0,24,"2017"
"41537","311630 CIPOTANEA",0,0,0,49,2,51,"2017"
"41538","311640 CLARAVAL",0,0,0,10,1,11,"2017"
"41539","311650 CLARO DOS POCOES",1,0,0,76,0,77,"2017"
"41540","311660 CLAUDIO",1,1,5,359,1,367,"2017"
"41541","311670 COIMBRA",0,0,1,74,0,75,"2017"
"41542","311680 COLUNA",0,0,2,106,2,110,"2017"
"41543","311690 COMENDADOR GOMES",0,0,0,27,0,27,"2017"
"41544","311700 COMERCINHO",0,1,0,58,1,60,"2017"
"41545","311710 CONCEICAO DA APARECIDA",0,0,2,110,2,114,"2017"
"41546","311720 CONCEICAO DAS PEDRAS",0,0,0,31,0,31,"2017"
"41547","311730 CONCEICAO DAS ALAGOAS",0,0,1,357,0,358,"2017"
"41548","311740 CONCEICAO DE IPANEMA",0,0,1,10,22,33,"2017"
"41549","311750 CONCEICAO DO MATO DENTRO",1,1,10,283,3,298,"2017"
"41550","311760 CONCEICAO DO PARA",0,0,1,50,4,55,"2017"
"41551","311770 CONCEICAO DO RIO VERDE",0,1,5,154,2,162,"2017"
"41552","311780 CONCEICAO DOS OUROS",0,2,2,119,0,123,"2017"
"41553","311783 CONEGO MARINHO",0,0,0,71,18,89,"2017"
"41554","311787 CONFINS",2,0,1,89,2,94,"2017"
"41555","311790 CONGONHAL",0,1,0,111,0,112,"2017"
"41556","311800 CONGONHAS",4,0,7,759,0,770,"2017"
"41557","311810 CONGONHAS DO NORTE",1,0,0,66,0,67,"2017"
"41558","311820 CONQUISTA",1,0,0,56,0,57,"2017"
"41559","311830 CONSELHEIRO LAFAIETE",5,3,14,1699,0,1721,"2017"
"41560","311840 CONSELHEIRO PENA",0,1,2,267,6,276,"2017"
"41561","311850 CONSOLACAO",0,0,1,26,0,27,"2017"
"41562","311860 CONTAGEM",20,37,153,8260,39,8509,"2017"
"41563","311870 COQUEIRAL",0,0,2,98,0,100,"2017"
"41564","311880 CORACAO DE JESUS",1,1,2,251,6,261,"2017"
"41565","311890 CORDISBURGO",0,0,1,50,0,51,"2017"
"41566","311900 CORDISLANDIA",0,0,1,38,0,39,"2017"
"41567","311910 CORINTO",3,2,8,291,1,305,"2017"
"41568","311920 COROACI",0,0,0,52,9,61,"2017"
"41569","311930 COROMANDEL",1,0,6,317,0,324,"2017"
"41570","311940 CORONEL FABRICIANO",5,3,10,1309,0,1327,"2017"
"41571","311950 CORONEL MURTA",0,1,2,97,3,103,"2017"
"41572","311960 CORONEL PACHECO",0,0,0,30,0,30,"2017"
"41573","311970 CORONEL XAVIER CHAVES",0,0,0,26,1,27,"2017"
"41574","311980 CORREGO DANTA",0,0,0,20,0,20,"2017"
"41575","311990 CORREGO DO BOM JESUS",0,0,0,37,0,37,"2017"
"41576","311995 CORREGO FUNDO",0,0,1,61,0,62,"2017"
"41577","312000 CORREGO NOVO",0,0,2,36,0,38,"2017"
"41578","312010 COUTO DE MAGALHAES DE MINAS",0,0,0,55,0,55,"2017"
"41579","312015 CRISOLITA",0,0,1,81,2,84,"2017"
"41580","312020 CRISTAIS",0,1,2,121,0,124,"2017"
"41581","312030 CRISTALIA",0,1,2,64,0,67,"2017"
"41582","312040 CRISTIANO OTONI",0,1,0,56,0,57,"2017"
"41583","312050 CRISTINA",0,0,0,99,0,99,"2017"
"41584","312060 CRUCILANDIA",0,0,0,44,0,44,"2017"
"41585","312070 CRUZEIRO DA FORTALEZA",0,0,1,56,0,57,"2017"
"41586","312080 CRUZILIA",0,0,0,228,2,230,"2017"
"41587","312083 CUPARAQUE",0,0,0,59,1,60,"2017"
"41588","312087 CURRAL DE DENTRO",0,0,2,67,13,82,"2017"
"41589","312090 CURVELO",11,0,32,906,3,952,"2017"
"41590","312100 DATAS",1,0,1,89,0,91,"2017"
"41591","312110 DELFIM MOREIRA",0,0,0,77,1,78,"2017"
"41592","312120 DELFINOPOLIS",0,0,1,67,0,68,"2017"
"41593","312125 DELTA",1,2,2,121,0,126,"2017"
"41594","312130 DESCOBERTO",0,0,1,50,0,51,"2017"
"41595","312140 DESTERRO DE ENTRE RIOS",0,1,3,58,0,62,"2017"
"41596","312150 DESTERRO DO MELO",0,0,0,31,0,31,"2017"
"41597","312160 DIAMANTINA",3,4,11,697,2,717,"2017"
"41598","312170 DIOGO DE VASCONCELOS",0,0,0,44,0,44,"2017"
"41599","312180 DIONISIO",1,0,2,57,0,60,"2017"
"41600","312190 DIVINESIA",0,0,0,33,0,33,"2017"
"41601","312200 DIVINO",0,0,3,275,1,279,"2017"
"41602","312210 DIVINO DAS LARANJEIRAS",0,0,0,51,1,52,"2017"
"41603","312220 DIVINOLANDIA DE MINAS",0,0,0,70,6,76,"2017"
"41604","312230 DIVINOPOLIS",5,10,39,2645,7,2706,"2017"
"41605","312235 DIVISA ALEGRE",0,0,4,86,1,91,"2017"
"41606","312240 DIVISA NOVA",0,1,0,78,0,79,"2017"
"41607","312245 DIVISOPOLIS",1,0,2,68,1,72,"2017"
"41608","312247 DOM BOSCO",1,0,0,33,0,34,"2017"
"41609","312250 DOM CAVATI",0,1,1,61,0,63,"2017"
"41610","312260 DOM JOAQUIM",2,0,1,57,0,60,"2017"
"41611","312270 DOM SILVERIO",0,0,1,40,0,41,"2017"
"41612","312280 DOM VICOSO",0,0,0,18,0,18,"2017"
"41613","312290 DONA EUSEBIA",0,0,2,77,0,79,"2017"
"41614","312300 DORES DE CAMPOS",0,1,0,96,0,97,"2017"
"41615","312310 DORES DE GUANHAES",0,0,0,49,0,49,"2017"
"41616","312320 DORES DO INDAIA",0,0,2,116,1,119,"2017"
"41617","312330 DORES DO TURVO",0,0,0,47,0,47,"2017"
"41618","312340 DORESOPOLIS",0,0,0,18,0,18,"2017"
"41619","312350 DOURADOQUARA",1,0,1,7,0,9,"2017"
"41620","312352 DURANDE",0,0,0,22,82,104,"2017"
"41621","312360 ELOI MENDES",3,2,4,330,2,341,"2017"
"41622","312370 ENGENHEIRO CALDAS",1,0,0,102,17,120,"2017"
"41623","312380 ENGENHEIRO NAVARRO",0,0,2,76,2,80,"2017"
"41624","312385 ENTRE FOLHAS",0,0,1,73,2,76,"2017"
"41625","312390 ENTRE RIOS DE MINAS",0,1,5,164,0,170,"2017"
"41626","312400 ERVALIA",0,1,2,215,4,222,"2017"
"41627","312410 ESMERALDAS",4,9,10,1177,12,1212,"2017"
"41628","312420 ESPERA FELIZ",0,0,2,316,2,320,"2017"
"41629","312430 ESPINOSA",1,0,7,352,12,372,"2017"
"41630","312440 ESPIRITO SANTO DO DOURADO",0,0,0,74,0,74,"2017"
"41631","312450 ESTIVA",0,0,3,100,0,103,"2017"
"41632","312460 ESTRELA DALVA",0,1,0,21,0,22,"2017"
"41633","312470 ESTRELA DO INDAIA",0,0,0,28,0,28,"2017"
"41634","312480 ESTRELA DO SUL",1,0,1,68,0,70,"2017"
"41635","312490 EUGENOPOLIS",0,1,1,104,2,108,"2017"
"41636","312500 EWBANK DA CAMARA",0,0,0,58,0,58,"2017"
"41637","312510 EXTREMA",1,0,0,678,0,679,"2017"
"41638","312520 FAMA",1,0,0,25,0,26,"2017"
"41639","312530 FARIA LEMOS",0,1,1,43,0,45,"2017"
"41640","312540 FELICIO DOS SANTOS",0,0,0,81,0,81,"2017"
"41641","312550 SAO GONCALO DO RIO PRETO",0,0,1,22,0,23,"2017"
"41642","312560 FELISBURGO",3,0,0,91,0,94,"2017"
"41643","312570 FELIXLANDIA",2,1,4,144,1,152,"2017"
"41644","312580 FERNANDES TOURINHO",0,1,0,30,1,32,"2017"
"41645","312590 FERROS",0,0,0,95,0,95,"2017"
"41646","312595 FERVEDOURO",1,0,0,131,1,133,"2017"
"41647","312600 FLORESTAL",0,0,0,67,3,70,"2017"
"41648","312610 FORMIGA",2,3,8,714,1,728,"2017"
"41649","312620 FORMOSO",0,0,1,85,2,88,"2017"
"41650","312630 FORTALEZA DE MINAS",0,0,1,36,1,38,"2017"
"41651","312640 FORTUNA DE MINAS",0,0,0,32,0,32,"2017"
"41652","312650 FRANCISCO BADARO",0,0,2,49,1,52,"2017"
"41653","312660 FRANCISCO DUMONT",0,1,1,51,2,55,"2017"
"41654","312670 FRANCISCO SA",3,2,9,221,2,237,"2017"
"41655","312675 FRANCISCOPOLIS",0,0,1,62,0,63,"2017"
"41656","312680 FREI GASPAR",0,0,0,69,0,69,"2017"
"41657","312690 FREI INOCENCIO",0,2,0,106,9,117,"2017"
"41658","312695 FREI LAGONEGRO",0,0,0,32,0,32,"2017"
"41659","312700 FRONTEIRA",0,0,1,148,0,149,"2017"
"41660","312705 FRONTEIRA DOS VALES",0,0,2,62,0,64,"2017"
"41661","312707 FRUTA DE LEITE",0,0,0,4,49,53,"2017"
"41662","312710 FRUTAL",1,1,7,708,3,720,"2017"
"41663","312720 FUNILANDIA",0,0,0,49,0,49,"2017"
"41664","312730 GALILEIA",0,0,1,77,5,83,"2017"
"41665","312733 GAMELEIRAS",0,0,0,10,49,59,"2017"
"41666","312735 GLAUCILANDIA",0,0,0,24,0,24,"2017"
"41667","312737 GOIABEIRA",0,0,0,50,1,51,"2017"
"41668","312738 GOIANA",0,0,1,31,1,33,"2017"
"41669","312740 GONCALVES",0,0,0,33,0,33,"2017"
"41670","312750 GONZAGA",1,2,0,64,8,75,"2017"
"41671","312760 GOUVEIA",1,2,4,140,1,148,"2017"
"41672","312770 GOVERNADOR VALADARES",13,5,24,3649,255,3946,"2017"
"41673","312780 GRAO MOGOL",0,0,1,129,21,151,"2017"
"41674","312790 GRUPIARA",0,0,0,5,0,5,"2017"
"41675","312800 GUANHAES",0,1,13,455,0,469,"2017"
"41676","312810 GUAPE",3,0,3,127,0,133,"2017"
"41677","312820 GUARACIABA",4,0,3,76,1,84,"2017"
"41678","312825 GUARACIAMA",1,1,0,48,0,50,"2017"
"41679","312830 GUARANESIA",2,0,2,214,11,229,"2017"
"41680","312840 GUARANI",0,0,1,87,1,89,"2017"
"41681","312850 GUARARA",0,0,0,36,0,36,"2017"
"41682","312860 GUARDA-MOR",0,1,3,93,2,99,"2017"
"41683","312870 GUAXUPE",5,11,17,643,0,676,"2017"
"41684","312880 GUIDOVAL",0,0,1,78,0,79,"2017"
"41685","312890 GUIMARANIA",0,0,1,100,0,101,"2017"
"41686","312900 GUIRICEMA",0,0,3,71,0,74,"2017"
"41687","312910 GURINHATA",0,0,1,30,0,31,"2017"
"41688","312920 HELIODORA",0,0,1,73,0,74,"2017"
"41689","312930 IAPU",0,1,3,118,0,122,"2017"
"41690","312940 IBERTIOGA",0,1,1,63,1,66,"2017"
"41691","312950 IBIA",3,0,6,279,0,288,"2017"
"41692","312960 IBIAI",0,0,1,101,3,105,"2017"
"41693","312965 IBIRACATU",0,0,0,82,1,83,"2017"
"41694","312970 IBIRACI",0,2,4,143,0,149,"2017"
"41695","312980 IBIRITE",5,7,38,2493,13,2556,"2017"
"41696","312990 IBITIURA DE MINAS",0,0,2,51,0,53,"2017"
"41697","313000 IBITURUNA",0,0,0,24,0,24,"2017"
"41698","313005 ICARAI DE MINAS",0,1,0,111,0,112,"2017"
"41699","313010 IGARAPE",1,2,11,548,4,566,"2017"
"41700","313020 IGARATINGA",0,0,3,130,2,135,"2017"
"41701","313030 IGUATAMA",0,0,0,72,1,73,"2017"
"41702","313040 IJACI",0,0,0,80,0,80,"2017"
"41703","313050 ILICINEA",0,1,1,143,3,148,"2017"
"41704","313055 IMBE DE MINAS",1,0,1,93,1,96,"2017"
"41705","313060 INCONFIDENTES",0,0,1,53,9,63,"2017"
"41706","313065 INDAIABIRA",0,0,2,68,3,73,"2017"
"41707","313070 INDIANOPOLIS",0,0,0,71,1,72,"2017"
"41708","313080 INGAI",0,0,0,30,0,30,"2017"
"41709","313090 INHAPIM",0,0,6,246,4,256,"2017"
"41710","313100 INHAUMA",0,0,1,77,0,78,"2017"
"41711","313110 INIMUTABA",1,1,2,62,0,66,"2017"
"41712","313115 IPABA",2,0,3,231,1,237,"2017"
"41713","313120 IPANEMA",0,0,0,209,43,252,"2017"
"41714","313130 IPATINGA",3,13,27,2987,6,3036,"2017"
"41715","313140 IPIACU",0,0,0,35,1,36,"2017"
"41716","313150 IPUIUNA",0,1,2,97,2,102,"2017"
"41717","313160 IRAI DE MINAS",1,0,0,83,1,85,"2017"
"41718","313170 ITABIRA",2,3,10,1422,10,1447,"2017"
"41719","313180 ITABIRINHA",0,0,0,149,1,150,"2017"
"41720","313190 ITABIRITO",1,2,12,728,0,743,"2017"
"41721","313200 ITACAMBIRA",0,0,1,37,0,38,"2017"
"41722","313210 ITACARAMBI",0,3,5,197,66,271,"2017"
"41723","313220 ITAGUARA",1,1,0,164,0,166,"2017"
"41724","313230 ITAIPE",1,1,1,178,1,182,"2017"
"41725","313240 ITAJUBA",3,2,15,1197,1,1218,"2017"
"41726","313250 ITAMARANDIBA",2,0,3,444,2,451,"2017"
"41727","313260 ITAMARATI DE MINAS",0,0,4,34,0,38,"2017"
"41728","313270 ITAMBACURI",1,1,7,329,3,341,"2017"
"41729","313280 ITAMBE DO MATO DENTRO",0,0,1,18,0,19,"2017"
"41730","313290 ITAMOGI",0,2,2,113,0,117,"2017"
"41731","313300 ITAMONTE",2,1,3,185,0,191,"2017"
"41732","313310 ITANHANDU",0,0,3,187,1,191,"2017"
"41733","313320 ITANHOMI",0,0,1,166,3,170,"2017"
"41734","313330 ITAOBIM",1,3,0,240,0,244,"2017"
"41735","313340 ITAPAGIPE",0,0,2,112,1,115,"2017"
"41736","313350 ITAPECERICA",0,0,4,201,0,205,"2017"
"41737","313360 ITAPEVA",0,0,0,139,0,139,"2017"
"41738","313370 ITATIAIUCU",2,0,0,124,0,126,"2017"
"41739","313375 ITAU DE MINAS",0,0,1,156,0,157,"2017"
"41740","313380 ITAUNA",1,1,8,1048,3,1061,"2017"
"41741","313390 ITAVERAVA",1,1,0,35,0,37,"2017"
"41742","313400 ITINGA",1,0,1,152,2,156,"2017"
"41743","313410 ITUETA",0,0,3,88,0,91,"2017"
"41744","313420 ITUIUTABA",3,4,3,1232,5,1247,"2017"
"41745","313430 ITUMIRIM",0,0,1,55,0,56,"2017"
"41746","313440 ITURAMA",0,1,2,497,0,500,"2017"
"41747","313450 ITUTINGA",0,0,1,35,0,36,"2017"
"41748","313460 JABOTICATUBAS",2,0,1,196,5,204,"2017"
"41749","313470 JACINTO",0,0,11,112,0,123,"2017"
"41750","313480 JACUI",0,0,0,91,0,91,"2017"
"41751","313490 JACUTINGA",0,0,1,276,1,278,"2017"
"41752","313500 JAGUARACU",0,0,0,29,0,29,"2017"
"41753","313505 JAIBA",2,3,18,517,61,601,"2017"
"41754","313507 JAMPRUCA",0,0,2,50,3,55,"2017"
"41755","313510 JANAUBA",1,4,15,990,8,1018,"2017"
"41756","313520 JANUARIA",0,3,12,903,117,1035,"2017"
"41757","313530 JAPARAIBA",0,1,0,66,0,67,"2017"
"41758","313535 JAPONVAR",0,0,0,107,0,107,"2017"
"41759","313540 JECEABA",0,0,0,67,0,67,"2017"
"41760","313545 JENIPAPO DE MINAS",0,0,1,88,0,89,"2017"
"41761","313550 JEQUERI",0,0,3,121,1,125,"2017"
"41762","313560 JEQUITAI",0,0,1,89,1,91,"2017"
"41763","313570 JEQUITIBA",0,0,2,45,0,47,"2017"
"41764","313580 JEQUITINHONHA",3,0,3,273,0,279,"2017"
"41765","313590 JESUANIA",0,0,0,63,0,63,"2017"
"41766","313600 JOAIMA",2,0,1,188,0,191,"2017"
"41767","313610 JOANESIA",0,1,0,33,0,34,"2017"
"41768","313620 JOAO MONLEVADE",3,2,10,860,1,876,"2017"
"41769","313630 JOAO PINHEIRO",0,1,6,618,20,645,"2017"
"41770","313640 JOAQUIM FELICIO",0,1,1,43,3,48,"2017"
"41771","313650 JORDANIA",0,0,1,109,2,112,"2017"
"41772","313652 JOSE GONCALVES DE MINAS",0,0,0,60,0,60,"2017"
"41773","313655 JOSE RAYDAN",0,0,1,44,0,45,"2017"
"41774","313657 JOSENOPOLIS",0,0,0,11,33,44,"2017"
"41775","313660 NOVA UNIAO",0,0,2,73,0,75,"2017"
"41776","313665 JUATUBA",0,3,4,384,1,392,"2017"
"41777","313670 JUIZ DE FORA",11,21,82,6422,50,6586,"2017"
"41778","313680 JURAMENTO",0,0,1,49,0,50,"2017"
"41779","313690 JURUAIA",0,1,1,149,2,153,"2017"
"41780","313695 JUVENILIA",0,0,1,15,47,63,"2017"
"41781","313700 LADAINHA",0,3,3,193,1,200,"2017"
"41782","313710 LAGAMAR",0,0,0,59,0,59,"2017"
"41783","313720 LAGOA DA PRATA",1,3,8,583,5,600,"2017"
"41784","313730 LAGOA DOS PATOS",0,0,0,38,0,38,"2017"
"41785","313740 LAGOA DOURADA",0,0,1,150,1,152,"2017"
"41786","313750 LAGOA FORMOSA",2,1,6,208,1,218,"2017"
"41787","313753 LAGOA GRANDE",0,1,1,122,0,124,"2017"
"41788","313760 LAGOA SANTA",0,2,13,786,6,807,"2017"
"41789","313770 LAJINHA",1,0,0,227,81,309,"2017"
"41790","313780 LAMBARI",0,1,1,232,0,234,"2017"
"41791","313790 LAMIM",0,0,0,33,0,33,"2017"
"41792","313800 LARANJAL",0,0,1,59,3,63,"2017"
"41793","313810 LASSANCE",0,1,0,71,2,74,"2017"
"41794","313820 LAVRAS",6,4,19,1405,3,1437,"2017"
"41795","313830 LEANDRO FERREIRA",1,1,0,28,1,31,"2017"
"41796","313835 LEME DO PRADO",0,0,1,50,0,51,"2017"
"41797","313840 LEOPOLDINA",0,3,8,637,3,651,"2017"
"41798","313850 LIBERDADE",0,1,0,41,0,42,"2017"
"41799","313860 LIMA DUARTE",0,0,1,166,1,168,"2017"
"41800","313862 LIMEIRA DO OESTE",0,0,3,114,0,117,"2017"
"41801","313865 LONTRA",0,0,0,132,0,132,"2017"
"41802","313867 LUISBURGO",0,0,0,5,106,111,"2017"
"41803","313868 LUISLANDIA",0,0,1,84,0,85,"2017"
"41804","313870 LUMINARIAS",0,0,1,41,0,42,"2017"
"41805","313880 LUZ",0,1,2,185,0,188,"2017"
"41806","313890 MACHACALIS",0,0,0,88,0,88,"2017"
"41807","313900 MACHADO",3,2,3,504,0,512,"2017"
"41808","313910 MADRE DE DEUS DE MINAS",0,0,0,60,0,60,"2017"
"41809","313920 MALACACHETA",1,0,1,207,2,211,"2017"
"41810","313925 MAMONAS",0,0,0,8,57,65,"2017"
"41811","313930 MANGA",0,1,5,67,238,311,"2017"
"41812","313940 MANHUACU",1,1,2,44,1276,1324,"2017"
"41813","313950 MANHUMIRIM",0,0,0,60,200,260,"2017"
"41814","313960 MANTENA",0,0,5,319,9,333,"2017"
"41815","313970 MARAVILHAS",1,0,0,65,1,67,"2017"
"41816","313980 MAR DE ESPANHA",0,4,4,161,0,169,"2017"
"41817","313990 MARIA DA FE",1,0,3,186,0,190,"2017"
"41818","314000 MARIANA",1,8,14,808,2,833,"2017"
"41819","314010 MARILAC",0,0,2,43,6,51,"2017"
"41820","314015 MARIO CAMPOS",0,1,2,204,1,208,"2017"
"41821","314020 MARIPA DE MINAS",0,0,0,30,2,32,"2017"
"41822","314030 MARLIERIA",0,0,0,45,0,45,"2017"
"41823","314040 MARMELOPOLIS",0,0,0,39,0,39,"2017"
"41824","314050 MARTINHO CAMPOS",1,1,1,148,4,155,"2017"
"41825","314053 MARTINS SOARES",0,0,0,26,84,110,"2017"
"41826","314055 MATA VERDE",1,1,3,83,0,88,"2017"
"41827","314060 MATERLANDIA",0,0,1,61,0,62,"2017"
"41828","314070 MATEUS LEME",1,3,6,440,4,454,"2017"
"41829","314080 MATIAS BARBOSA",1,0,1,127,0,129,"2017"
"41830","314085 MATIAS CARDOSO",0,0,3,85,13,101,"2017"
"41831","314090 MATIPO",0,2,4,153,142,301,"2017"
"41832","314100 MATO VERDE",1,0,1,100,39,141,"2017"
"41833","314110 MATOZINHOS",2,2,4,475,19,502,"2017"
"41834","314120 MATUTINA",0,0,1,47,0,48,"2017"
"41835","314130 MEDEIROS",0,0,0,42,0,42,"2017"
"41836","314140 MEDINA",1,1,9,239,0,250,"2017"
"41837","314150 MENDES PIMENTEL",0,0,0,71,3,74,"2017"
"41838","314160 MERCES",0,0,2,99,0,101,"2017"
"41839","314170 MESQUITA",0,0,1,56,0,57,"2017"
"41840","314180 MINAS NOVAS",1,1,5,291,19,317,"2017"
"41841","314190 MINDURI",0,0,0,46,0,46,"2017"
"41842","314200 MIRABELA",1,0,4,179,0,184,"2017"
"41843","314210 MIRADOURO",0,0,2,61,6,69,"2017"
"41844","314220 MIRAI",0,0,3,144,8,155,"2017"
"41845","314225 MIRAVANIA",0,0,0,18,33,51,"2017"
"41846","314230 MOEDA",0,0,0,41,0,41,"2017"
"41847","314240 MOEMA",0,0,0,65,0,65,"2017"
"41848","314250 MONJOLOS",0,0,0,27,1,28,"2017"
"41849","314260 MONSENHOR PAULO",0,0,1,83,0,84,"2017"
"41850","314270 MONTALVANIA",0,0,0,22,177,199,"2017"
"41851","314280 MONTE ALEGRE DE MINAS",0,0,3,206,70,279,"2017"
"41852","314290 MONTE AZUL",1,2,2,31,193,229,"2017"
"41853","314300 MONTE BELO",0,1,0,138,0,139,"2017"
"41854","314310 MONTE CARMELO",0,2,7,595,0,604,"2017"
"41855","314315 MONTE FORMOSO",0,0,0,60,0,60,"2017"
"41856","314320 MONTE SANTO DE MINAS",0,2,3,204,0,209,"2017"
"41857","314330 MONTES CLAROS",10,20,93,6119,33,6275,"2017"
"41858","314340 MONTE SIAO",1,4,1,194,23,223,"2017"
"41859","314345 MONTEZUMA",0,0,1,84,2,87,"2017"
"41860","314350 MORADA NOVA DE MINAS",1,0,2,82,0,85,"2017"
"41861","314360 MORRO DA GARCA",0,0,0,22,0,22,"2017"
"41862","314370 MORRO DO PILAR",0,0,1,39,1,41,"2017"
"41863","314380 MUNHOZ",0,0,2,50,2,54,"2017"
"41864","314390 MURIAE",0,10,11,1194,41,1256,"2017"
"41865","314400 MUTUM",0,0,0,324,44,368,"2017"
"41866","314410 MUZAMBINHO",1,0,9,253,0,263,"2017"
"41867","314420 NACIP RAYDAN",0,0,0,22,1,23,"2017"
"41868","314430 NANUQUE",1,3,7,445,2,458,"2017"
"41869","314435 NAQUE",0,0,2,82,0,84,"2017"
"41870","314437 NATALANDIA",0,0,0,48,0,48,"2017"
"41871","314440 NATERCIA",0,0,0,42,0,42,"2017"
"41872","314450 NAZARENO",0,0,0,81,3,84,"2017"
"41873","314460 NEPOMUCENO",3,0,4,283,0,290,"2017"
"41874","314465 NINHEIRA",0,0,0,48,46,94,"2017"
"41875","314467 NOVA BELEM",0,0,0,53,0,53,"2017"
"41876","314470 NOVA ERA",0,1,2,227,0,230,"2017"
"41877","314480 NOVA LIMA",3,6,21,1441,5,1476,"2017"
"41878","314490 NOVA MODICA",0,0,0,33,1,34,"2017"
"41879","314500 NOVA PONTE",3,1,1,171,0,176,"2017"
"41880","314505 NOVA PORTEIRINHA",2,1,1,95,2,101,"2017"
"41881","314510 NOVA RESENDE",0,4,12,226,2,244,"2017"
"41882","314520 NOVA SERRANA",3,10,20,1516,22,1571,"2017"
"41883","314530 NOVO CRUZEIRO",0,0,2,390,3,395,"2017"
"41884","314535 NOVO ORIENTE DE MINAS",1,1,2,108,3,115,"2017"
"41885","314537 NOVORIZONTE",0,0,1,20,49,70,"2017"
"41886","314540 OLARIA",0,0,0,11,0,11,"2017"
"41887","314545 OLHOS-D'AGUA",0,0,0,66,3,69,"2017"
"41888","314550 OLIMPIO NORONHA",0,0,0,31,0,31,"2017"
"41889","314560 OLIVEIRA",2,1,5,379,1,388,"2017"
"41890","314570 OLIVEIRA FORTES",0,0,0,12,0,12,"2017"
"41891","314580 ONCA DE PITANGUI",1,0,0,33,1,35,"2017"
"41892","314585 ORATORIOS",0,0,0,52,0,52,"2017"
"41893","314587 ORIZANIA",0,0,2,113,5,120,"2017"
"41894","314590 OURO BRANCO",4,2,3,519,0,528,"2017"
"41895","314600 OURO FINO",1,3,3,339,37,383,"2017"
"41896","314610 OURO PRETO",3,5,31,802,13,854,"2017"
"41897","314620 OURO VERDE DE MINAS",0,1,3,91,9,104,"2017"
"41898","314625 PADRE CARVALHO",0,0,1,22,57,80,"2017"
"41899","314630 PADRE PARAISO",1,1,4,242,2,250,"2017"
"41900","314640 PAINEIRAS",0,0,0,27,0,27,"2017"
"41901","314650 PAINS",1,0,1,85,0,87,"2017"
"41902","314655 PAI PEDRO",0,2,2,55,3,62,"2017"
"41903","314660 PAIVA",0,0,0,13,0,13,"2017"
"41904","314670 PALMA",0,0,0,63,2,65,"2017"
"41905","314675 PALMOPOLIS",0,0,2,80,0,82,"2017"
"41906","314690 PAPAGAIOS",1,0,3,171,2,177,"2017"
"41907","314700 PARACATU",2,3,17,1361,4,1387,"2017"
"41908","314710 PARA DE MINAS",4,2,20,1097,15,1138,"2017"
"41909","314720 PARAGUACU",1,0,3,265,1,270,"2017"
"41910","314730 PARAISOPOLIS",0,2,2,206,0,210,"2017"
"41911","314740 PARAOPEBA",0,1,4,300,0,305,"2017"
"41912","314750 PASSABEM",0,0,0,13,0,13,"2017"
"41913","314760 PASSA QUATRO",0,0,2,192,2,196,"2017"
"41914","314770 PASSA TEMPO",0,1,1,61,1,64,"2017"
"41915","314780 PASSA-VINTE",0,0,1,20,0,21,"2017"
"41916","314790 PASSOS",4,4,17,1459,3,1487,"2017"
"41917","314795 PATIS",0,0,0,50,0,50,"2017"
"41918","314800 PATOS DE MINAS",2,4,20,1865,6,1897,"2017"
"41919","314810 PATROCINIO",0,2,4,1276,4,1286,"2017"
"41920","314820 PATROCINIO DO MURIAE",0,0,0,42,0,42,"2017"
"41921","314830 PAULA CANDIDO",0,1,6,69,2,78,"2017"
"41922","314840 PAULISTAS",0,0,0,50,0,50,"2017"
"41923","314850 PAVAO",0,0,0,84,2,86,"2017"
"41924","314860 PECANHA",0,1,5,201,1,208,"2017"
"41925","314870 PEDRA AZUL",0,1,3,288,7,299,"2017"
"41926","314875 PEDRA BONITA",0,0,1,85,18,104,"2017"
"41927","314880 PEDRA DO ANTA",0,0,0,30,1,31,"2017"
"41928","314890 PEDRA DO INDAIA",0,0,1,36,0,37,"2017"
"41929","314900 PEDRA DOURADA",0,0,0,29,0,29,"2017"
"41930","314910 PEDRALVA",0,0,2,152,0,154,"2017"
"41931","314915 PEDRAS DE MARIA DA CRUZ",0,0,1,107,14,122,"2017"
"41932","314920 PEDRINOPOLIS",0,0,1,32,0,33,"2017"
"41933","314930 PEDRO LEOPOLDO",0,1,7,743,19,770,"2017"
"41934","314940 PEDRO TEIXEIRA",0,0,0,5,0,5,"2017"
"41935","314950 PEQUERI",0,1,0,26,0,27,"2017"
"41936","314960 PEQUI",0,0,0,42,0,42,"2017"
"41937","314970 PERDIGAO",0,0,2,136,1,139,"2017"
"41938","314980 PERDIZES",0,3,1,198,1,203,"2017"
"41939","314990 PERDOES",0,1,3,171,1,176,"2017"
"41940","314995 PERIQUITO",0,0,0,103,10,113,"2017"
"41941","315000 PESCADOR",1,1,1,49,2,54,"2017"
"41942","315010 PIAU",1,0,0,15,0,16,"2017"
"41943","315015 PIEDADE DE CARATINGA",0,1,0,125,1,127,"2017"
"41944","315020 PIEDADE DE PONTE NOVA",0,0,0,43,0,43,"2017"
"41945","315030 PIEDADE DO RIO GRANDE",0,1,1,47,0,49,"2017"
"41946","315040 PIEDADE DOS GERAIS",0,0,1,52,0,53,"2017"
"41947","315050 PIMENTA",0,0,0,67,0,67,"2017"
"41948","315053 PINGO-D'AGUA",0,1,0,65,0,66,"2017"
"41949","315057 PINTOPOLIS",0,0,1,107,4,112,"2017"
"41950","315060 PIRACEMA",0,0,2,52,0,54,"2017"
"41951","315070 PIRAJUBA",2,0,1,87,1,91,"2017"
"41952","315080 PIRANGA",0,0,1,149,1,151,"2017"
"41953","315090 PIRANGUCU",1,0,1,60,0,62,"2017"
"41954","315100 PIRANGUINHO",0,0,2,99,0,101,"2017"
"41955","315110 PIRAPETINGA",0,0,5,163,0,168,"2017"
"41956","315120 PIRAPORA",2,2,6,831,8,849,"2017"
"41957","315130 PIRAUBA",0,0,1,117,1,119,"2017"
"41958","315140 PITANGUI",1,1,3,296,47,348,"2017"
"41959","315150 PIUMHI",0,0,8,424,1,433,"2017"
"41960","315160 PLANURA",0,0,1,127,0,128,"2017"
"41961","315170 POCO FUNDO",1,0,1,161,0,163,"2017"
"41962","315180 POCOS DE CALDAS",3,11,73,1841,6,1934,"2017"
"41963","315190 POCRANE",0,0,1,57,13,71,"2017"
"41964","315200 POMPEU",0,5,2,403,0,410,"2017"
"41965","315210 PONTE NOVA",1,1,12,721,6,741,"2017"
"41966","315213 PONTO CHIQUE",0,1,1,53,3,58,"2017"
"41967","315217 PONTO DOS VOLANTES",0,0,3,144,0,147,"2017"
"41968","315220 PORTEIRINHA",0,0,12,413,7,432,"2017"
"41969","315230 PORTO FIRME",0,1,8,92,2,103,"2017"
"41970","315240 POTE",0,1,1,150,1,153,"2017"
"41971","315250 POUSO ALEGRE",3,5,8,1923,8,1947,"2017"
"41972","315260 POUSO ALTO",0,0,1,63,0,64,"2017"
"41973","315270 PRADOS",0,1,1,76,0,78,"2017"
"41974","315280 PRATA",2,1,5,354,2,364,"2017"
"41975","315290 PRATAPOLIS",0,0,2,78,0,80,"2017"
"41976","315300 PRATINHA",0,0,0,51,0,51,"2017"
"41977","315310 PRESIDENTE BERNARDES",0,0,2,45,1,48,"2017"
"41978","315320 PRESIDENTE JUSCELINO",3,1,0,36,0,40,"2017"
"41979","315330 PRESIDENTE KUBITSCHEK",0,0,2,43,0,45,"2017"
"41980","315340 PRESIDENTE OLEGARIO",1,2,4,191,0,198,"2017"
"41981","315350 ALTO JEQUITIBA",0,0,0,39,62,101,"2017"
"41982","315360 PRUDENTE DE MORAIS",0,0,1,125,0,126,"2017"
"41983","315370 QUARTEL GERAL",0,0,0,34,0,34,"2017"
"41984","315380 QUELUZITO",0,0,0,11,0,11,"2017"
"41985","315390 RAPOSOS",0,0,4,192,1,197,"2017"
"41986","315400 RAUL SOARES",2,1,0,267,0,270,"2017"
"41987","315410 RECREIO",0,0,1,96,1,98,"2017"
"41988","315415 REDUTO",0,0,0,3,101,104,"2017"
"41989","315420 RESENDE COSTA",0,0,2,112,0,114,"2017"
"41990","315430 RESPLENDOR",1,2,4,196,2,205,"2017"
"41991","315440 RESSAQUINHA",0,0,0,51,1,52,"2017"
"41992","315445 RIACHINHO",0,0,2,73,0,75,"2017"
"41993","315450 RIACHO DOS MACHADOS",0,1,3,99,1,104,"2017"
"41994","315460 RIBEIRAO DAS NEVES",17,29,90,4653,44,4833,"2017"
"41995","315470 RIBEIRAO VERMELHO",0,0,0,41,0,41,"2017"
"41996","315480 RIO ACIMA",1,0,4,142,1,148,"2017"
"41997","315490 RIO CASCA",0,0,1,139,3,143,"2017"
"41998","315500 RIO DOCE",0,0,0,14,0,14,"2017"
"41999","315510 RIO DO PRADO",0,0,1,65,0,66,"2017"
"42000","315520 RIO ESPERA",0,0,0,25,0,25,"2017"
"42001","315530 RIO MANSO",0,1,0,53,1,55,"2017"
"42002","315540 RIO NOVO",0,0,1,92,0,93,"2017"
"42003","315550 RIO PARANAIBA",0,0,5,139,0,144,"2017"
"42004","315560 RIO PARDO DE MINAS",0,1,5,365,1,372,"2017"
"42005","315570 RIO PIRACICABA",1,0,1,154,2,158,"2017"
"42006","315580 RIO POMBA",0,1,0,213,1,215,"2017"
"42007","315590 RIO PRETO",3,0,1,41,0,45,"2017"
"42008","315600 RIO VERMELHO",1,1,1,132,0,135,"2017"
"42009","315610 RITAPOLIS",0,0,0,45,0,45,"2017"
"42010","315620 ROCHEDO DE MINAS",0,0,0,28,0,28,"2017"
"42011","315630 RODEIRO",0,0,1,105,0,106,"2017"
"42012","315640 ROMARIA",0,0,0,33,0,33,"2017"
"42013","315645 ROSARIO DA LIMEIRA",0,1,1,48,0,50,"2017"
"42014","315650 RUBELITA",0,0,0,5,37,42,"2017"
"42015","315660 RUBIM",1,0,3,90,0,94,"2017"
"42016","315670 SABARA",8,6,25,1796,10,1845,"2017"
"42017","315680 SABINOPOLIS",0,2,3,158,1,164,"2017"
"42018","315690 SACRAMENTO",0,0,4,324,1,329,"2017"
"42019","315700 SALINAS",0,1,0,100,387,488,"2017"
"42020","315710 SALTO DA DIVISA",1,2,4,75,1,83,"2017"
"42021","315720 SANTA BARBARA",0,1,3,409,1,414,"2017"
"42022","315725 SANTA BARBARA DO LESTE",0,1,1,72,3,77,"2017"
"42023","315727 SANTA BARBARA DO MONTE VERDE",0,0,0,25,0,25,"2017"
"42024","315730 SANTA BARBARA DO TUGURIO",0,0,1,30,1,32,"2017"
"42025","315733 SANTA CRUZ DE MINAS",0,0,0,101,0,101,"2017"
"42026","315737 SANTA CRUZ DE SALINAS",0,0,0,13,15,28,"2017"
"42027","315740 SANTA CRUZ DO ESCALVADO",0,0,1,38,1,40,"2017"
"42028","315750 SANTA EFIGENIA DE MINAS",1,0,0,56,6,63,"2017"
"42029","315760 SANTA FE DE MINAS",0,1,1,48,1,51,"2017"
"42030","315765 SANTA HELENA DE MINAS",0,1,2,69,22,94,"2017"
"42031","315770 SANTA JULIANA",1,0,4,193,0,198,"2017"
"42032","315780 SANTA LUZIA",15,14,51,3035,16,3131,"2017"
"42033","315790 SANTA MARGARIDA",0,0,0,109,115,224,"2017"
"42034","315800 SANTA MARIA DE ITABIRA",1,1,1,131,2,136,"2017"
"42035","315810 SANTA MARIA DO SALTO",0,1,3,42,1,47,"2017"
"42036","315820 SANTA MARIA DO SUACUI",0,1,4,188,1,194,"2017"
"42037","315830 SANTANA DA VARGEM",0,2,2,71,1,76,"2017"
"42038","315840 SANTANA DE CATAGUASES",0,0,0,29,0,29,"2017"
"42039","315850 SANTANA DE PIRAPAMA",0,0,1,54,0,55,"2017"
"42040","315860 SANTANA DO DESERTO",0,0,0,36,0,36,"2017"
"42041","315870 SANTANA DO GARAMBEU",0,0,0,23,0,23,"2017"
"42042","315880 SANTANA DO JACARE",0,0,3,61,0,64,"2017"
"42043","315890 SANTANA DO MANHUACU",0,1,0,7,102,110,"2017"
"42044","315895 SANTANA DO PARAISO",1,0,2,668,2,673,"2017"
"42045","315900 SANTANA DO RIACHO",1,1,0,50,0,52,"2017"
"42046","315910 SANTANA DOS MONTES",1,0,0,31,0,32,"2017"
"42047","315920 SANTA RITA DE CALDAS",0,1,4,84,0,89,"2017"
"42048","315930 SANTA RITA DE JACUTINGA",0,0,0,44,0,44,"2017"
"42049","315935 SANTA RITA DE MINAS",0,1,3,86,0,90,"2017"
"42050","315940 SANTA RITA DE IBITIPOCA",0,0,0,28,2,30,"2017"
"42051","315950 SANTA RITA DO ITUETO",0,2,3,72,0,77,"2017"
"42052","315960 SANTA RITA DO SAPUCAI",1,1,4,523,0,529,"2017"
"42053","315970 SANTA ROSA DA SERRA",0,0,0,39,0,39,"2017"
"42054","315980 SANTA VITORIA",0,0,1,273,0,274,"2017"
"42055","315990 SANTO ANTONIO DO AMPARO",0,0,5,192,0,197,"2017"
"42056","316000 SANTO ANTONIO DO AVENTUREIRO",0,0,1,31,0,32,"2017"
"42057","316010 SANTO ANTONIO DO GRAMA",0,0,1,61,3,65,"2017"
"42058","316020 SANTO ANTONIO DO ITAMBE",0,0,0,52,1,53,"2017"
"42059","316030 SANTO ANTONIO DO JACINTO",1,0,9,112,1,123,"2017"
"42060","316040 SANTO ANTONIO DO MONTE",0,1,14,342,0,357,"2017"
"42061","316045 SANTO ANTONIO DO RETIRO",0,0,0,37,30,67,"2017"
"42062","316050 SANTO ANTONIO DO RIO ABAIXO",0,0,0,15,1,16,"2017"
"42063","316060 SANTO HIPOLITO",0,0,2,27,1,30,"2017"
"42064","316070 SANTOS DUMONT",0,0,2,472,8,482,"2017"
"42065","316080 SAO BENTO ABADE",0,0,1,65,0,66,"2017"
"42066","316090 SAO BRAS DO SUACUI",0,1,0,41,0,42,"2017"
"42067","316095 SAO DOMINGOS DAS DORES",0,0,0,96,0,96,"2017"
"42068","316100 SAO DOMINGOS DO PRATA",0,2,5,165,2,174,"2017"
"42069","316105 SAO FELIX DE MINAS",0,0,0,35,6,41,"2017"
"42070","316110 SAO FRANCISCO",3,6,4,818,6,837,"2017"
"42071","316120 SAO FRANCISCO DE PAULA",0,0,0,76,0,76,"2017"
"42072","316130 SAO FRANCISCO DE SALES",0,1,0,79,1,81,"2017"
"42073","316140 SAO FRANCISCO DO GLORIA",0,0,0,47,0,47,"2017"
"42074","316150 SAO GERALDO",1,1,0,90,1,93,"2017"
"42075","316160 SAO GERALDO DA PIEDADE",0,0,0,40,3,43,"2017"
"42076","316165 SAO GERALDO DO BAIXIO",0,0,1,34,4,39,"2017"
"42077","316170 SAO GONCALO DO ABAETE",0,0,0,58,1,59,"2017"
"42078","316180 SAO GONCALO DO PARA",0,0,1,118,2,121,"2017"
"42079","316190 SAO GONCALO DO RIO ABAIXO",0,0,0,147,0,147,"2017"
"42080","316200 SAO GONCALO DO SAPUCAI",0,0,12,278,0,290,"2017"
"42081","316210 SAO GOTARDO",1,2,6,679,1,689,"2017"
"42082","316220 SAO JOAO BATISTA DO GLORIA",0,0,1,88,0,89,"2017"
"42083","316225 SAO JOAO DA LAGOA",1,1,0,34,3,39,"2017"
"42084","316230 SAO JOAO DA MATA",0,0,1,37,0,38,"2017"
"42085","316240 SAO JOAO DA PONTE",1,0,2,291,4,298,"2017"
"42086","316245 SAO JOAO DAS MISSOES",0,0,0,114,150,264,"2017"
"42087","316250 SAO JOAO DEL REI",1,4,7,959,3,974,"2017"
"42088","316255 SAO JOAO DO MANHUACU",0,0,1,72,101,174,"2017"
"42089","316257 SAO JOAO DO MANTENINHA",0,0,2,77,1,80,"2017"
"42090","316260 SAO JOAO DO ORIENTE",0,1,3,115,0,119,"2017"
"42091","316265 SAO JOAO DO PACUI",0,0,1,39,0,40,"2017"
"42092","316270 SAO JOAO DO PARAISO",1,0,1,89,152,243,"2017"
"42093","316280 SAO JOAO EVANGELISTA",3,2,2,205,0,212,"2017"
"42094","316290 SAO JOAO NEPOMUCENO",0,0,3,286,2,291,"2017"
"42095","316292 SAO JOAQUIM DE BICAS",0,1,11,408,0,420,"2017"
"42096","316294 SAO JOSE DA BARRA",0,0,1,93,0,94,"2017"
"42097","316295 SAO JOSE DA LAPA",2,1,3,328,9,343,"2017"
"42098","316300 SAO JOSE DA SAFIRA",1,0,1,50,8,60,"2017"
"42099","316310 SAO JOSE DA VARGINHA",0,0,0,40,2,42,"2017"
"42100","316320 SAO JOSE DO ALEGRE",0,0,2,54,0,56,"2017"
"42101","316330 SAO JOSE DO DIVINO",0,0,3,46,0,49,"2017"
"42102","316340 SAO JOSE DO GOIABAL",0,0,1,46,2,49,"2017"
"42103","316350 SAO JOSE DO JACURI",0,0,1,73,0,74,"2017"
"42104","316360 SAO JOSE DO MANTIMENTO",0,0,0,10,28,38,"2017"
"42105","316370 SAO LOURENCO",1,2,8,527,1,539,"2017"
"42106","316380 SAO MIGUEL DO ANTA",0,0,1,58,0,59,"2017"
"42107","316390 SAO PEDRO DA UNIAO",0,0,0,61,0,61,"2017"
"42108","316400 SAO PEDRO DOS FERROS",0,0,1,76,0,77,"2017"
"42109","316410 SAO PEDRO DO SUACUI",0,1,0,64,1,66,"2017"
"42110","316420 SAO ROMAO",0,0,4,114,0,118,"2017"
"42111","316430 SAO ROQUE DE MINAS",0,0,0,63,0,63,"2017"
"42112","316440 SAO SEBASTIAO DA BELA VISTA",0,0,0,84,0,84,"2017"
"42113","316443 SAO SEBASTIAO DA VARGEM ALEGRE",0,0,0,21,0,21,"2017"
"42114","316447 SAO SEBASTIAO DO ANTA",1,0,0,78,0,79,"2017"
"42115","316450 SAO SEBASTIAO DO MARANHAO",1,0,0,91,0,92,"2017"
"42116","316460 SAO SEBASTIAO DO OESTE",0,0,3,113,0,116,"2017"
"42117","316470 SAO SEBASTIAO DO PARAISO",1,2,5,912,3,923,"2017"
"42118","316480 SAO SEBASTIAO DO RIO PRETO",0,0,0,15,0,15,"2017"
"42119","316490 SAO SEBASTIAO DO RIO VERDE",0,0,0,17,0,17,"2017"
"42120","316500 SAO TIAGO",0,0,1,128,0,129,"2017"
"42121","316510 SAO TOMAS DE AQUINO",0,0,0,65,1,66,"2017"
"42122","316520 SAO THOME DAS LETRAS",0,1,0,68,0,69,"2017"
"42123","316530 SAO VICENTE DE MINAS",0,0,1,77,0,78,"2017"
"42124","316540 SAPUCAI-MIRIM",1,0,2,72,1,76,"2017"
"42125","316550 SARDOA",1,0,0,73,4,78,"2017"
"42126","316553 SARZEDO",2,3,13,521,4,543,"2017"
"42127","316555 SETUBINHA",1,3,1,153,12,170,"2017"
"42128","316556 SEM-PEIXE",0,0,0,22,0,22,"2017"
"42129","316557 SENADOR AMARAL",0,0,0,101,0,101,"2017"
"42130","316560 SENADOR CORTES",0,0,3,23,0,26,"2017"
"42131","316570 SENADOR FIRMINO",0,0,0,87,4,91,"2017"
"42132","316580 SENADOR JOSE BENTO",0,0,0,11,0,11,"2017"
"42133","316590 SENADOR MODESTINO GONCALVES",0,0,0,39,0,39,"2017"
"42134","316600 SENHORA DE OLIVEIRA",0,0,0,43,0,43,"2017"
"42135","316610 SENHORA DO PORTO",0,0,0,32,0,32,"2017"
"42136","316620 SENHORA DOS REMEDIOS",1,0,1,104,0,106,"2017"
"42137","316630 SERICITA",0,0,1,83,3,87,"2017"
"42138","316640 SERITINGA",0,0,1,17,0,18,"2017"
"42139","316650 SERRA AZUL DE MINAS",0,0,1,42,1,44,"2017"
"42140","316660 SERRA DA SAUDADE",0,0,0,4,0,4,"2017"
"42141","316670 SERRA DOS AIMORES",1,0,2,72,0,75,"2017"
"42142","316680 SERRA DO SALITRE",0,1,3,172,1,177,"2017"
"42143","316690 SERRANIA",0,0,0,92,0,92,"2017"
"42144","316695 SERRANOPOLIS DE MINAS",0,0,1,41,1,43,"2017"
"42145","316700 SERRANOS",0,0,0,28,0,28,"2017"
"42146","316710 SERRO",2,0,4,257,1,264,"2017"
"42147","316720 SETE LAGOAS",6,6,35,2670,2,2719,"2017"
"42148","316730 SILVEIRANIA",0,0,0,27,1,28,"2017"
"42149","316740 SILVIANOPOLIS",0,0,1,51,0,52,"2017"
"42150","316750 SIMAO PEREIRA",0,0,1,29,3,33,"2017"
"42151","316760 SIMONESIA",0,0,0,44,264,308,"2017"
"42152","316770 SOBRALIA",0,0,1,49,9,59,"2017"
"42153","316780 SOLEDADE DE MINAS",0,0,1,60,1,62,"2017"
"42154","316790 TABULEIRO",0,0,0,35,0,35,"2017"
"42155","316800 TAIOBEIRAS",1,2,9,459,7,478,"2017"
"42156","316805 TAPARUBA",0,0,0,29,7,36,"2017"
"42157","316810 TAPIRA",0,0,0,46,0,46,"2017"
"42158","316820 TAPIRAI",0,0,1,12,0,13,"2017"
"42159","316830 TAQUARACU DE MINAS",1,1,0,36,0,38,"2017"
"42160","316840 TARUMIRIM",1,0,0,132,6,139,"2017"
"42161","316850 TEIXEIRAS",0,1,1,117,1,120,"2017"
"42162","316860 TEOFILO OTONI",7,6,35,1901,15,1964,"2017"
"42163","316870 TIMOTEO",2,3,6,969,0,980,"2017"
"42164","316880 TIRADENTES",0,0,0,82,0,82,"2017"
"42165","316890 TIROS",0,0,0,78,0,78,"2017"
"42166","316900 TOCANTINS",2,0,4,207,1,214,"2017"
"42167","316905 TOCOS DO MOJI",0,0,1,33,0,34,"2017"
"42168","316910 TOLEDO",0,0,0,64,0,64,"2017"
"42169","316920 TOMBOS",0,0,0,88,0,88,"2017"
"42170","316930 TRES CORACOES",3,3,16,1054,1,1077,"2017"
"42171","316935 TRES MARIAS",1,1,4,329,5,340,"2017"
"42172","316940 TRES PONTAS",2,6,9,681,11,709,"2017"
"42173","316950 TUMIRITINGA",0,0,0,74,7,81,"2017"
"42174","316960 TUPACIGUARA",2,2,3,266,3,276,"2017"
"42175","316970 TURMALINA",0,0,0,239,2,241,"2017"
"42176","316980 TURVOLANDIA",0,0,1,48,1,50,"2017"
"42177","316990 UBA",5,7,18,1224,8,1262,"2017"
"42178","317000 UBAI",0,0,0,132,0,132,"2017"
"42179","317005 UBAPORANGA",2,0,0,134,1,137,"2017"
"42180","317010 UBERABA",14,15,58,4138,30,4255,"2017"
"42181","317020 UBERLANDIA",21,16,92,9429,81,9639,"2017"
"42182","317030 UMBURATIBA",1,0,1,43,0,45,"2017"
"42183","317040 UNAI",5,5,10,1236,0,1256,"2017"
"42184","317043 UNIAO DE MINAS",0,0,2,44,0,46,"2017"
"42185","317047 URUANA DE MINAS",0,0,0,38,0,38,"2017"
"42186","317050 URUCANIA",0,1,2,126,3,132,"2017"
"42187","317052 URUCUIA",0,0,2,96,1,99,"2017"
"42188","317057 VARGEM ALEGRE",0,1,1,59,0,61,"2017"
"42189","317060 VARGEM BONITA",0,0,0,30,0,30,"2017"
"42190","317065 VARGEM GRANDE DO RIO PARDO",0,0,0,81,4,85,"2017"
"42191","317070 VARGINHA",6,3,19,1814,15,1857,"2017"
"42192","317075 VARJAO DE MINAS",0,0,0,83,1,84,"2017"
"42193","317080 VARZEA DA PALMA",1,0,3,357,4,365,"2017"
"42194","317090 VARZELANDIA",0,4,4,240,0,248,"2017"
"42195","317100 VAZANTE",1,0,2,277,2,282,"2017"
"42196","317103 VERDELANDIA",0,1,4,138,6,149,"2017"
"42197","317107 VEREDINHA",0,0,1,63,1,65,"2017"
"42198","317110 VERISSIMO",1,1,0,46,0,48,"2017"
"42199","317115 VERMELHO NOVO",0,0,0,44,0,44,"2017"
"42200","317120 VESPASIANO",8,11,39,1884,12,1954,"2017"
"42201","317130 VICOSA",0,7,24,938,19,988,"2017"
"42202","317140 VIEIRAS",0,0,0,30,2,32,"2017"
"42203","317150 MATHIAS LOBATO",1,0,0,32,1,34,"2017"
"42204","317160 VIRGEM DA LAPA",0,1,1,129,2,133,"2017"
"42205","317170 VIRGINIA",0,0,0,100,1,101,"2017"
"42206","317180 VIRGINOPOLIS",0,1,4,121,2,128,"2017"
"42207","317190 VIRGOLANDIA",0,0,0,36,4,40,"2017"
"42208","317200 VISCONDE DO RIO BRANCO",0,1,4,526,3,534,"2017"
"42209","317210 VOLTA GRANDE",0,0,2,60,1,63,"2017"
"42210","317220 WENCESLAU BRAZ",0,0,1,21,0,22,"2017"
"42211","320010 AFONSO CLAUDIO",0,5,5,350,4,364,"2017"
"42212","320013 AGUIA BRANCA",0,2,3,122,1,128,"2017"
"42213","320016 AGUA DOCE DO NORTE",0,1,2,157,1,161,"2017"
"42214","320020 ALEGRE",1,0,3,388,0,392,"2017"
"42215","320030 ALFREDO CHAVES",0,0,1,137,0,138,"2017"
"42216","320035 ALTO RIO NOVO",0,0,0,92,0,92,"2017"
"42217","320040 ANCHIETA",1,3,3,345,0,352,"2017"
"42218","320050 APIACA",0,0,1,92,0,93,"2017"
"42219","320060 ARACRUZ",2,2,19,1392,3,1418,"2017"
"42220","320070 ATILIO VIVACQUA",0,0,1,139,0,140,"2017"
"42221","320080 BAIXO GUANDU",1,1,9,411,1,423,"2017"
"42222","320090 BARRA DE SAO FRANCISCO",0,4,13,645,0,662,"2017"
"42223","320100 BOA ESPERANCA",0,2,4,182,3,191,"2017"
"42224","320110 BOM JESUS DO NORTE",0,1,1,92,0,94,"2017"
"42225","320115 BREJETUBA",0,0,6,188,1,195,"2017"
"42226","320120 CACHOEIRO DE ITAPEMIRIM",5,7,26,2700,4,2742,"2017"
"42227","320130 CARIACICA",14,17,75,5941,43,6090,"2017"
"42228","320140 CASTELO",1,2,6,430,3,442,"2017"
"42229","320150 COLATINA",2,9,24,1510,1,1546,"2017"
"42230","320160 CONCEICAO DA BARRA",1,1,5,421,2,430,"2017"
"42231","320170 CONCEICAO DO CASTELO",0,0,0,173,0,173,"2017"
"42232","320180 DIVINO DE SAO LOURENCO",0,0,0,61,0,61,"2017"
"42233","320190 DOMINGOS MARTINS",1,1,15,450,1,468,"2017"
"42234","320200 DORES DO RIO PRETO",0,0,1,71,1,73,"2017"
"42235","320210 ECOPORANGA",1,1,2,272,2,278,"2017"
"42236","320220 FUNDAO",4,1,5,251,7,268,"2017"
"42237","320225 GOVERNADOR LINDENBERG",0,0,4,114,0,118,"2017"
"42238","320230 GUACUI",1,1,8,418,0,428,"2017"
"42239","320240 GUARAPARI",4,4,36,1725,3,1772,"2017"
"42240","320245 IBATIBA",1,1,3,327,22,354,"2017"
"42241","320250 IBIRACU",0,1,2,156,0,159,"2017"
"42242","320255 IBITIRAMA",0,1,4,159,1,165,"2017"
"42243","320260 ICONHA",0,0,3,175,0,178,"2017"
"42244","320265 IRUPI",1,0,1,162,11,175,"2017"
"42245","320270 ITAGUACU",0,1,2,141,2,146,"2017"
"42246","320280 ITAPEMIRIM",1,4,12,595,0,612,"2017"
"42247","320290 ITARANA",0,0,1,102,0,103,"2017"
"42248","320300 IUNA",2,0,5,357,29,393,"2017"
"42249","320305 JAGUARE",3,1,3,462,0,469,"2017"
"42250","320310 JERONIMO MONTEIRO",0,0,0,139,1,140,"2017"
"42251","320313 JOAO NEIVA",1,1,3,189,0,194,"2017"
"42252","320316 LARANJA DA TERRA",0,1,1,86,0,88,"2017"
"42253","320320 LINHARES",3,8,21,2490,2,2524,"2017"
"42254","320330 MANTENOPOLIS",0,0,2,171,1,174,"2017"
"42255","320332 MARATAIZES",1,3,11,534,2,551,"2017"
"42256","320334 MARECHAL FLORIANO",1,1,4,241,1,248,"2017"
"42257","320335 MARILANDIA",1,1,2,126,0,130,"2017"
"42258","320340 MIMOSO DO SUL",1,1,7,286,2,297,"2017"
"42259","320350 MONTANHA",0,0,5,263,3,271,"2017"
"42260","320360 MUCURICI",0,0,2,90,0,92,"2017"
"42261","320370 MUNIZ FREIRE",0,0,5,255,0,260,"2017"
"42262","320380 MUQUI",0,1,0,160,0,161,"2017"
"42263","320390 NOVA VENECIA",3,1,5,687,0,696,"2017"
"42264","320400 PANCAS",0,1,3,218,0,222,"2017"
"42265","320405 PEDRO CANARIO",0,1,2,314,2,319,"2017"
"42266","320410 PINHEIROS",0,1,1,196,181,379,"2017"
"42267","320420 PIUMA",1,2,4,320,0,327,"2017"
"42268","320425 PONTO BELO",0,0,1,78,5,84,"2017"
"42269","320430 PRESIDENTE KENNEDY",0,0,0,197,1,198,"2017"
"42270","320435 RIO BANANAL",0,0,0,201,1,202,"2017"
"42271","320440 RIO NOVO DO SUL",0,0,4,151,0,155,"2017"
"42272","320450 SANTA LEOPOLDINA",0,1,1,146,0,148,"2017"
"42273","320455 SANTA MARIA DE JETIBA",2,1,8,593,1,605,"2017"
"42274","320460 SANTA TERESA",0,3,4,284,2,293,"2017"
"42275","320465 SAO DOMINGOS DO NORTE",0,0,2,97,0,99,"2017"
"42276","320470 SAO GABRIEL DA PALHA",1,4,4,401,0,410,"2017"
"42277","320480 SAO JOSE DO CALCADO",0,2,3,142,0,147,"2017"
"42278","320490 SAO MATEUS",3,11,20,1965,7,2006,"2017"
"42279","320495 SAO ROQUE DO CANAA",0,1,1,93,0,95,"2017"
"42280","320500 SERRA",45,31,104,7756,26,7962,"2017"
"42281","320501 SOORETAMA",0,1,3,468,2,474,"2017"
"42282","320503 VARGEM ALTA",0,2,3,258,3,266,"2017"
"42283","320506 VENDA NOVA DO IMIGRANTE",0,1,5,313,0,319,"2017"
"42284","320510 VIANA",1,2,17,1067,6,1093,"2017"
"42285","320515 VILA PAVAO",1,0,0,103,1,105,"2017"
"42286","320517 VILA VALERIO",0,0,6,191,0,197,"2017"
"42287","320520 VILA VELHA",15,18,71,6669,44,6817,"2017"
"42288","320530 VITORIA",11,13,58,4516,14,4612,"2017"
"42289","MUNICIPIO IGNORADO - RJ",0,0,2,5,1,8,"2017"
"42290","330010 ANGRA DOS REIS",4,1,78,2537,15,2635,"2017"
"42291","330015 APERIBE",1,0,2,143,0,146,"2017"
"42292","330020 ARARUAMA",9,8,48,1504,26,1595,"2017"
"42293","330022 AREAL",4,0,7,170,0,181,"2017"
"42294","330023 ARMACAO DOS BUZIOS",3,7,25,622,6,663,"2017"
"42295","330025 ARRAIAL DO CABO",6,2,8,376,70,462,"2017"
"42296","330030 BARRA DO PIRAI",2,5,19,1050,4,1080,"2017"
"42297","330040 BARRA MANSA",6,14,58,2031,7,2116,"2017"
"42298","330045 BELFORD ROXO",15,23,126,6843,93,7100,"2017"
"42299","330050 BOM JARDIM",0,2,6,187,2,197,"2017"
"42300","330060 BOM JESUS DO ITABAPOANA",0,3,2,462,0,467,"2017"
"42301","330070 CABO FRIO",3,12,52,2691,23,2781,"2017"
"42302","330080 CACHOEIRAS DE MACACU",3,4,14,776,11,808,"2017"
"42303","330090 CAMBUCI",0,0,2,148,1,151,"2017"
"42304","330093 CARAPEBUS",0,2,3,160,0,165,"2017"
"42305","330095 COMENDADOR LEVY GASPARIAN",0,0,2,112,2,116,"2017"
"42306","330100 CAMPOS DOS GOYTACAZES",24,34,118,7291,31,7498,"2017"
"42307","330110 CANTAGALO",0,2,5,197,1,205,"2017"
"42308","330115 CARDOSO MOREIRA",0,1,6,117,1,125,"2017"
"42309","330120 CARMO",1,0,3,214,3,221,"2017"
"42310","330130 CASIMIRO DE ABREU",0,3,11,663,2,679,"2017"
"42311","330140 CONCEICAO DE MACABU",0,0,5,263,4,272,"2017"
"42312","330150 CORDEIRO",2,4,3,268,0,277,"2017"
"42313","330160 DUAS BARRAS",0,1,3,124,0,128,"2017"
"42314","330170 DUQUE DE CAXIAS",27,81,320,13054,111,13593,"2017"
"42315","330180 ENGENHEIRO PAULO DE FRONTIN",0,0,2,119,0,121,"2017"
"42316","330185 GUAPIMIRIM",2,3,8,721,6,740,"2017"
"42317","330187 IGUABA GRANDE",2,1,9,339,10,361,"2017"
"42318","330190 ITABORAI",9,12,40,3057,21,3139,"2017"
"42319","330200 ITAGUAI",1,13,30,1830,18,1892,"2017"
"42320","330205 ITALVA",0,0,5,151,0,156,"2017"
"42321","330210 ITAOCARA",3,1,4,269,0,277,"2017"
"42322","330220 ITAPERUNA",1,9,24,1139,4,1177,"2017"
"42323","330225 ITATIAIA",1,1,8,422,1,433,"2017"
"42324","330227 JAPERI",5,4,16,1364,30,1419,"2017"
"42325","330230 LAJE DO MURIAE",0,0,0,60,0,60,"2017"
"42326","330240 MACAE",5,13,72,3816,22,3928,"2017"
"42327","330245 MACUCO",0,1,1,110,1,113,"2017"
"42328","330250 MAGE",7,21,65,3599,6,3698,"2017"
"42329","330260 MANGARATIBA",1,5,8,535,6,555,"2017"
"42330","330270 MARICA",3,2,29,1088,756,1878,"2017"
"42331","330280 MENDES",0,2,2,196,2,202,"2017"
"42332","330285 MESQUITA",6,9,35,2321,31,2402,"2017"
"42333","330290 MIGUEL PEREIRA",1,1,7,300,12,321,"2017"
"42334","330300 MIRACEMA",5,3,1,345,0,354,"2017"
"42335","330310 NATIVIDADE",0,3,10,165,1,179,"2017"
"42336","330320 NILOPOLIS",8,8,39,1759,20,1834,"2017"
"42337","330330 NITEROI",14,19,83,6195,25,6336,"2017"
"42338","330340 NOVA FRIBURGO",1,13,70,2026,14,2124,"2017"
"42339","330350 NOVA IGUACU",28,76,219,12018,157,12498,"2017"
"42340","330360 PARACAMBI",1,3,3,522,2,531,"2017"
"42341","330370 PARAIBA DO SUL",1,2,6,547,2,558,"2017"
"42342","330380 PARATY",0,0,11,608,5,624,"2017"
"42343","330385 PATY DO ALFERES",1,6,13,377,11,408,"2017"
"42344","330390 PETROPOLIS",14,12,61,3797,34,3918,"2017"
"42345","330395 PINHEIRAL",1,2,4,317,0,324,"2017"
"42346","330400 PIRAI",4,1,3,382,2,392,"2017"
"42347","330410 PORCIUNCULA",1,1,9,202,1,214,"2017"
"42348","330411 PORTO REAL",1,1,1,263,0,266,"2017"
"42349","330412 QUATIS",0,0,3,166,1,170,"2017"
"42350","330414 QUEIMADOS",4,15,44,2308,41,2412,"2017"
"42351","330415 QUISSAMA",2,2,5,309,0,318,"2017"
"42352","330420 RESENDE",5,2,36,1716,0,1759,"2017"
"42353","330430 RIO BONITO",2,1,10,703,3,719,"2017"
"42354","330440 RIO CLARO",1,0,1,186,0,188,"2017"
"42355","330450 RIO DAS FLORES",0,1,6,94,0,101,"2017"
"42356","330452 RIO DAS OSTRAS",4,10,36,1985,9,2044,"2017"
"42357","330455 RIO DE JANEIRO",174,421,1487,81633,806,84521,"2017"
"42358","330460 SANTA MARIA MADALENA",0,1,0,98,0,99,"2017"
"42359","330470 SANTO ANTONIO DE PADUA",1,2,9,493,3,508,"2017"
"42360","330475 SAO FRANCISCO DE ITABAPOANA",1,0,7,621,5,634,"2017"
"42361","330480 SAO FIDELIS",1,8,23,347,10,389,"2017"
"42362","330490 SAO GONCALO",27,43,167,10997,56,11290,"2017"
"42363","330500 SAO JOAO DA BARRA",1,2,9,500,2,514,"2017"
"42364","330510 SAO JOAO DE MERITI",14,46,126,6310,49,6545,"2017"
"42365","330513 SAO JOSE DE UBA",0,1,0,105,0,106,"2017"
"42366","330515 SAO JOSE DO VALE DO RIO PRETO",0,1,3,270,0,274,"2017"
"42367","330520 SAO PEDRO DA ALDEIA",2,13,52,1562,21,1650,"2017"
"42368","330530 SAO SEBASTIAO DO ALTO",0,0,0,95,0,95,"2017"
"42369","330540 SAPUCAIA",0,2,1,186,3,192,"2017"
"42370","330550 SAQUAREMA",4,4,25,1164,10,1207,"2017"
"42371","330555 SEROPEDICA",0,5,18,1029,14,1066,"2017"
"42372","330560 SILVA JARDIM",0,1,4,280,1,286,"2017"
"42373","330570 SUMIDOURO",0,0,2,226,0,228,"2017"
"42374","330575 TANGUA",1,2,1,456,1,461,"2017"
"42375","330580 TERESOPOLIS",1,17,55,2221,6,2300,"2017"
"42376","330590 TRAJANO DE MORAES",0,1,1,110,2,114,"2017"
"42377","330600 TRES RIOS",0,4,13,1168,9,1194,"2017"
"42378","330610 VALENCA",2,6,18,795,1,822,"2017"
"42379","330615 VARRE-SAI",0,2,6,147,1,156,"2017"
"42380","330620 VASSOURAS",4,1,8,475,1,489,"2017"
"42381","330630 VOLTA REDONDA",8,11,44,3197,12,3272,"2017"
"42382","MUNICIPIO IGNORADO - SP",0,0,0,1,4,5,"2017"
"42383","350010 ADAMANTINA",1,0,0,343,0,344,"2017"
"42384","350020 ADOLFO",0,0,0,38,0,38,"2017"
"42385","350030 AGUAI",3,1,4,424,4,436,"2017"
"42386","350040 AGUAS DA PRATA",0,1,1,76,1,79,"2017"
"42387","350050 AGUAS DE LINDOIA",1,1,3,234,0,239,"2017"
"42388","350055 AGUAS DE SANTA BARBARA",1,0,1,69,0,71,"2017"
"42389","350060 AGUAS DE SAO PEDRO",0,0,1,36,0,37,"2017"
"42390","350070 AGUDOS",1,1,2,573,0,577,"2017"
"42391","350075 ALAMBARI",0,0,3,67,0,70,"2017"
"42392","350080 ALFREDO MARCONDES",0,1,0,47,0,48,"2017"
"42393","350090 ALTAIR",0,1,3,45,0,49,"2017"
"42394","350100 ALTINOPOLIS",1,2,1,177,2,183,"2017"
"42395","350110 ALTO ALEGRE",0,0,0,49,0,49,"2017"
"42396","350115 ALUMINIO",0,2,7,236,1,246,"2017"
"42397","350120 ALVARES FLORENCE",0,0,1,29,0,30,"2017"
"42398","350130 ALVARES MACHADO",4,0,5,322,0,331,"2017"
"42399","350140 ALVARO DE CARVALHO",0,0,3,37,0,40,"2017"
"42400","350150 ALVINLANDIA",0,1,5,36,0,42,"2017"
"42401","350160 AMERICANA",7,8,31,2627,5,2678,"2017"
"42402","350170 AMERICO BRASILIENSE",3,5,3,487,2,500,"2017"
"42403","350180 AMERICO DE CAMPOS",0,0,0,47,0,47,"2017"
"42404","350190 AMPARO",3,1,8,872,1,885,"2017"
"42405","350200 ANALANDIA",0,0,0,47,0,47,"2017"
"42406","350210 ANDRADINA",1,0,6,666,1,674,"2017"
"42407","350220 ANGATUBA",0,1,2,314,0,317,"2017"
"42408","350230 ANHEMBI",1,0,2,68,5,76,"2017"
"42409","350240 ANHUMAS",0,1,1,55,0,57,"2017"
"42410","350250 APARECIDA",0,2,4,461,13,480,"2017"
"42411","350260 APARECIDA D'OESTE",0,0,0,43,0,43,"2017"
"42412","350270 APIAI",1,2,8,348,1,360,"2017"
"42413","350275 ARACARIGUAMA",2,1,9,319,2,333,"2017"
"42414","350280 ARACATUBA",3,9,46,2392,1,2451,"2017"
"42415","350290 ARACOIABA DA SERRA",2,1,8,402,2,415,"2017"
"42416","350300 ARAMINA",1,1,3,77,1,83,"2017"
"42417","350310 ARANDU",0,0,1,95,1,97,"2017"
"42418","350315 ARAPEI",0,0,0,14,0,14,"2017"
"42419","350320 ARARAQUARA",4,10,32,2724,3,2773,"2017"
"42420","350330 ARARAS",4,7,24,1450,1,1486,"2017"
"42421","350335 ARCO-IRIS",0,1,0,15,0,16,"2017"
"42422","350340 AREALVA",0,0,0,67,0,67,"2017"
"42423","350350 AREIAS",1,0,0,44,2,47,"2017"
"42424","350360 AREIOPOLIS",1,2,2,126,0,131,"2017"
"42425","350370 ARIRANHA",0,0,1,69,0,70,"2017"
"42426","350380 ARTUR NOGUEIRA",0,1,5,666,7,679,"2017"
"42427","350390 ARUJA",7,5,10,1386,1,1409,"2017"
"42428","350395 ASPASIA",0,0,0,21,0,21,"2017"
"42429","350400 ASSIS",4,4,12,1280,1,1301,"2017"
"42430","350410 ATIBAIA",3,2,28,2043,2,2078,"2017"
"42431","350420 AURIFLAMA",0,1,2,168,0,171,"2017"
"42432","350430 AVAI",0,0,1,59,0,60,"2017"
"42433","350440 AVANHANDAVA",0,0,0,157,0,157,"2017"
"42434","350450 AVARE",0,5,9,1287,5,1306,"2017"
"42435","350460 BADY BASSITT",1,0,0,237,0,238,"2017"
"42436","350470 BALBINOS",0,0,0,15,0,15,"2017"
"42437","350480 BALSAMO",0,0,1,84,0,85,"2017"
"42438","350490 BANANAL",1,1,2,88,2,94,"2017"
"42439","350500 BARAO DE ANTONINA",0,1,0,56,0,57,"2017"
"42440","350510 BARBOSA",0,0,1,92,0,93,"2017"
"42441","350520 BARIRI",0,1,5,393,2,401,"2017"
"42442","350530 BARRA BONITA",3,0,5,289,1,298,"2017"
"42443","350535 BARRA DO CHAPEU",0,0,0,88,0,88,"2017"
"42444","350540 BARRA DO TURVO",1,0,1,74,0,76,"2017"
"42445","350550 BARRETOS",19,8,32,1519,1,1579,"2017"
"42446","350560 BARRINHA",1,1,4,463,1,470,"2017"
"42447","350570 BARUERI",22,14,41,5581,8,5666,"2017"
"42448","350580 BASTOS",0,2,2,286,0,290,"2017"
"42449","350590 BATATAIS",2,3,3,732,6,746,"2017"
"42450","350600 BAURU",21,13,62,4585,18,4699,"2017"
"42451","350610 BEBEDOURO",3,0,9,997,3,1012,"2017"
"42452","350620 BENTO DE ABREU",0,0,1,25,0,26,"2017"
"42453","350630 BERNARDINO DE CAMPOS",2,1,1,143,1,148,"2017"
"42454","350635 BERTIOGA",2,2,15,1026,0,1045,"2017"
"42455","350640 BILAC",2,0,0,73,0,75,"2017"
"42456","350650 BIRIGUI",1,8,13,1478,0,1500,"2017"
"42457","350660 BIRITIBA-MIRIM",0,2,5,383,4,394,"2017"
"42458","350670 BOA ESPERANCA DO SUL",0,0,3,165,2,170,"2017"
"42459","350680 BOCAINA",0,0,2,123,0,125,"2017"
"42460","350690 BOFETE",0,0,2,126,2,130,"2017"
"42461","350700 BOITUVA",2,2,14,793,0,811,"2017"
"42462","350710 BOM JESUS DOS PERDOES",1,1,4,323,0,329,"2017"
"42463","350715 BOM SUCESSO DE ITARARE",0,1,2,63,0,66,"2017"
"42464","350720 BORA",0,0,0,12,0,12,"2017"
"42465","350730 BORACEIA",0,0,0,65,0,65,"2017"
"42466","350740 BORBOREMA",0,0,1,162,0,163,"2017"
"42467","350745 BOREBI",0,0,0,43,0,43,"2017"
"42468","350750 BOTUCATU",10,13,47,1639,6,1715,"2017"
"42469","350760 BRAGANCA PAULISTA",6,4,22,2188,4,2224,"2017"
"42470","350770 BRAUNA",0,0,1,74,0,75,"2017"
"42471","350775 BREJO ALEGRE",0,0,0,35,0,35,"2017"
"42472","350780 BRODOWSKI",0,1,4,322,3,330,"2017"
"42473","350790 BROTAS",2,1,3,267,0,273,"2017"
"42474","350800 BURI",2,3,16,282,1,304,"2017"
"42475","350810 BURITAMA",0,1,7,171,0,179,"2017"
"42476","350820 BURITIZAL",0,0,0,41,0,41,"2017"
"42477","350830 CABRALIA PAULISTA",0,0,0,59,0,59,"2017"
"42478","350840 CABREUVA",2,4,9,767,0,782,"2017"
"42479","350850 CACAPAVA",2,2,19,1238,2,1263,"2017"
"42480","350860 CACHOEIRA PAULISTA",1,1,3,376,23,404,"2017"
"42481","350870 CACONDE",1,0,1,209,1,212,"2017"
"42482","350880 CAFELANDIA",0,1,2,224,2,229,"2017"
"42483","350890 CAIABU",0,0,0,41,0,41,"2017"
"42484","350900 CAIEIRAS",1,5,12,1439,1,1458,"2017"
"42485","350910 CAIUA",0,0,1,44,2,47,"2017"
"42486","350920 CAJAMAR",3,5,11,1306,6,1331,"2017"
"42487","350925 CAJATI",2,1,8,486,0,497,"2017"
"42488","350930 CAJOBI",0,0,1,95,0,96,"2017"
"42489","350940 CAJURU",3,1,4,332,1,341,"2017"
"42490","350945 CAMPINA DO MONTE ALEGRE",0,0,1,74,0,75,"2017"
"42491","350950 CAMPINAS",35,64,141,15117,76,15433,"2017"
"42492","350960 CAMPO LIMPO PAULISTA",3,3,15,1035,1,1057,"2017"
"42493","350970 CAMPOS DO JORDAO",0,2,9,756,0,767,"2017"
"42494","350980 CAMPOS NOVOS PAULISTA",1,0,2,74,0,77,"2017"
"42495","350990 CANANEIA",0,2,2,186,0,190,"2017"
"42496","350995 CANAS",0,0,0,80,5,85,"2017"
"42497","351000 CANDIDO MOTA",1,1,2,332,1,337,"2017"
"42498","351010 CANDIDO RODRIGUES",0,0,0,15,0,15,"2017"
"42499","351015 CANITAR",1,1,1,67,0,70,"2017"
"42500","351020 CAPAO BONITO",0,0,6,662,1,669,"2017"
"42501","351030 CAPELA DO ALTO",0,1,5,278,1,285,"2017"
"42502","351040 CAPIVARI",4,1,7,670,0,682,"2017"
"42503","351050 CARAGUATATUBA",3,5,24,1718,7,1757,"2017"
"42504","351060 CARAPICUIBA",11,14,67,6850,24,6966,"2017"
"42505","351070 CARDOSO",0,0,0,118,0,118,"2017"
"42506","351080 CASA BRANCA",2,1,3,310,0,316,"2017"
"42507","351090 CASSIA DOS COQUEIROS",0,0,0,29,0,29,"2017"
"42508","351100 CASTILHO",0,1,9,235,1,246,"2017"
"42509","351110 CATANDUVA",2,7,17,1323,3,1352,"2017"
"42510","351120 CATIGUA",0,0,1,91,1,93,"2017"
"42511","351130 CEDRAL",0,1,1,100,0,102,"2017"
"42512","351140 CERQUEIRA CESAR",0,1,5,238,0,244,"2017"
"42513","351150 CERQUILHO",0,0,5,496,2,503,"2017"
"42514","351160 CESARIO LANGE",0,4,6,272,0,282,"2017"
"42515","351170 CHARQUEADA",0,0,3,201,2,206,"2017"
"42516","351190 CLEMENTINA",0,0,1,106,0,107,"2017"
"42517","351200 COLINA",2,0,6,239,0,247,"2017"
"42518","351210 COLOMBIA",0,1,2,82,0,85,"2017"
"42519","351220 CONCHAL",1,0,9,400,0,410,"2017"
"42520","351230 CONCHAS",0,2,6,199,1,208,"2017"
"42521","351240 CORDEIROPOLIS",1,0,1,279,1,282,"2017"
"42522","351250 COROADOS",0,0,0,72,0,72,"2017"
"42523","351260 CORONEL MACEDO",0,0,1,50,0,51,"2017"
"42524","351270 CORUMBATAI",0,0,1,53,0,54,"2017"
"42525","351280 COSMOPOLIS",2,0,7,723,7,739,"2017"
"42526","351290 COSMORAMA",0,0,1,67,0,68,"2017"
"42527","351300 COTIA",3,12,49,4244,3,4311,"2017"
"42528","351310 CRAVINHOS",1,4,6,391,0,402,"2017"
"42529","351320 CRISTAIS PAULISTA",0,1,2,118,0,121,"2017"
"42530","351330 CRUZALIA",0,0,0,28,0,28,"2017"
"42531","351340 CRUZEIRO",2,2,19,891,11,925,"2017"
"42532","351350 CUBATAO",3,10,39,1562,6,1620,"2017"
"42533","351360 CUNHA",0,0,4,234,3,241,"2017"
"42534","351370 DESCALVADO",0,1,2,356,0,359,"2017"
"42535","351380 DIADEMA",10,23,81,5747,19,5880,"2017"
"42536","351385 DIRCE REIS",0,0,0,13,0,13,"2017"
"42537","351390 DIVINOLANDIA",0,1,0,115,0,116,"2017"
"42538","351400 DOBRADA",1,0,0,119,0,120,"2017"
"42539","351410 DOIS CORREGOS",0,2,1,331,0,334,"2017"
"42540","351420 DOLCINOPOLIS",0,0,1,24,0,25,"2017"
"42541","351430 DOURADO",0,1,1,94,0,96,"2017"
"42542","351440 DRACENA",1,0,5,482,3,491,"2017"
"42543","351450 DUARTINA",1,0,0,146,0,147,"2017"
"42544","351460 DUMONT",0,0,4,95,0,99,"2017"
"42545","351470 ECHAPORA",1,0,2,77,1,81,"2017"
"42546","351480 ELDORADO",1,1,1,203,0,206,"2017"
"42547","351490 ELIAS FAUSTO",1,0,3,204,0,208,"2017"
"42548","351492 ELISIARIO",0,0,0,28,0,28,"2017"
"42549","351495 EMBAUBA",0,0,0,18,0,18,"2017"
"42550","351500 EMBU DAS ARTES",6,12,58,4207,12,4295,"2017"
"42551","351510 EMBU-GUACU",0,2,23,978,5,1008,"2017"
"42552","351512 EMILIANOPOLIS",0,0,0,32,0,32,"2017"
"42553","351515 ENGENHEIRO COELHO",1,1,2,268,0,272,"2017"
"42554","351518 ESPIRITO SANTO DO PINHAL",1,2,9,466,0,478,"2017"
"42555","351519 ESPIRITO SANTO DO TURVO",0,0,1,54,0,55,"2017"
"42556","351520 ESTRELA D'OESTE",1,0,0,108,0,109,"2017"
"42557","351530 ESTRELA DO NORTE",0,0,0,39,0,39,"2017"
"42558","351535 EUCLIDES DA CUNHA PAULISTA",2,0,2,106,0,110,"2017"
"42559","351540 FARTURA",1,0,0,177,0,178,"2017"
"42560","351550 FERNANDOPOLIS",0,4,16,773,0,793,"2017"
"42561","351560 FERNANDO PRESTES",0,0,0,66,1,67,"2017"
"42562","351565 FERNAO",0,0,1,17,0,18,"2017"
"42563","351570 FERRAZ DE VASCONCELOS",6,11,35,2836,12,2900,"2017"
"42564","351580 FLORA RICA",0,0,0,21,0,21,"2017"
"42565","351590 FLOREAL",0,0,0,26,0,26,"2017"
"42566","351600 FLORIDA PAULISTA",1,1,1,127,0,130,"2017"
"42567","351610 FLORINIA",0,0,0,33,0,33,"2017"
"42568","351620 FRANCA",11,16,79,4891,5,5002,"2017"
"42569","351630 FRANCISCO MORATO",21,10,38,2846,13,2928,"2017"
"42570","351640 FRANCO DA ROCHA",11,10,26,2255,16,2318,"2017"
"42571","351650 GABRIEL MONTEIRO",0,1,1,23,0,25,"2017"
"42572","351660 GALIA",0,2,1,74,1,78,"2017"
"42573","351670 GARCA",4,4,17,505,0,530,"2017"
"42574","351680 GASTAO VIDIGAL",0,0,2,47,0,49,"2017"
"42575","351685 GAVIAO PEIXOTO",0,1,0,68,0,69,"2017"
"42576","351690 GENERAL SALGADO",0,1,0,119,2,122,"2017"
"42577","351700 GETULINA",1,0,0,99,0,100,"2017"
"42578","351710 GLICERIO",0,0,0,58,0,58,"2017"
"42579","351720 GUAICARA",0,0,3,149,0,152,"2017"
"42580","351730 GUAIMBE",0,0,1,88,0,89,"2017"
"42581","351740 GUAIRA",1,1,14,463,0,479,"2017"
"42582","351750 GUAPIACU",0,2,1,237,0,240,"2017"
"42583","351760 GUAPIARA",2,4,8,258,0,272,"2017"
"42584","351770 GUARA",0,1,2,237,0,240,"2017"
"42585","351780 GUARACAI",2,0,2,67,0,71,"2017"
"42586","351790 GUARACI",0,0,2,121,0,123,"2017"
"42587","351800 GUARANI D'OESTE",0,0,0,11,0,11,"2017"
"42588","351810 GUARANTA",0,0,2,84,0,86,"2017"
"42589","351820 GUARARAPES",0,1,5,364,0,370,"2017"
"42590","351830 GUARAREMA",0,1,8,397,0,406,"2017"
"42591","351840 GUARATINGUETA",4,4,19,1487,9,1523,"2017"
"42592","351850 GUAREI",0,0,5,144,3,152,"2017"
"42593","351860 GUARIBA",0,0,12,484,6,502,"2017"
"42594","351870 GUARUJA",5,18,69,4318,19,4429,"2017"
"42595","351880 GUARULHOS",34,84,254,20767,80,21219,"2017"
"42596","351885 GUATAPARA",0,0,0,110,0,110,"2017"
"42597","351890 GUZOLANDIA",0,1,0,52,0,53,"2017"
"42598","351900 HERCULANDIA",0,0,1,103,0,104,"2017"
"42599","351905 HOLAMBRA",0,0,1,220,1,222,"2017"
"42600","351907 HORTOLANDIA",10,10,33,3037,4,3094,"2017"
"42601","351910 IACANGA",1,0,0,128,2,131,"2017"
"42602","351920 IACRI",0,1,1,54,0,56,"2017"
"42603","351925 IARAS",0,0,0,70,0,70,"2017"
"42604","351930 IBATE",1,0,5,493,3,502,"2017"
"42605","351940 IBIRA",0,0,1,145,0,146,"2017"
"42606","351950 IBIRAREMA",0,0,0,67,0,67,"2017"
"42607","351960 IBITINGA",3,0,12,725,2,742,"2017"
"42608","351970 IBIUNA",3,1,14,1154,5,1177,"2017"
"42609","351980 ICEM",0,0,1,109,0,110,"2017"
"42610","351990 IEPE",1,1,0,100,1,103,"2017"
"42611","352000 IGARACU DO TIETE",0,3,5,281,0,289,"2017"
"42612","352010 IGARAPAVA",0,1,3,341,1,346,"2017"
"42613","352020 IGARATA",0,0,4,114,0,118,"2017"
"42614","352030 IGUAPE",4,4,6,352,0,366,"2017"
"42615","352040 ILHABELA",0,2,11,517,0,530,"2017"
"42616","352042 ILHA COMPRIDA",1,0,2,156,0,159,"2017"
"42617","352044 ILHA SOLTEIRA",0,0,3,286,0,289,"2017"
"42618","352050 INDAIATUBA",6,11,49,3125,4,3195,"2017"
"42619","352060 INDIANA",0,0,0,55,0,55,"2017"
"42620","352070 INDIAPORA",0,1,0,36,0,37,"2017"
"42621","352080 INUBIA PAULISTA",0,0,1,33,0,34,"2017"
"42622","352090 IPAUSSU",3,0,5,182,1,191,"2017"
"42623","352100 IPERO",1,1,8,338,0,348,"2017"
"42624","352110 IPEUNA",0,0,0,104,0,104,"2017"
"42625","352115 IPIGUA",0,0,0,59,0,59,"2017"
"42626","352120 IPORANGA",0,1,2,63,1,67,"2017"
"42627","352130 IPUA",2,2,4,182,0,190,"2017"
"42628","352140 IRACEMAPOLIS",0,0,3,229,0,232,"2017"
"42629","352150 IRAPUA",0,0,1,79,0,80,"2017"
"42630","352160 IRAPURU",0,0,1,79,0,80,"2017"
"42631","352170 ITABERA",1,4,18,192,2,217,"2017"
"42632","352180 ITAI",0,0,6,324,0,330,"2017"
"42633","352190 ITAJOBI",1,0,1,172,0,174,"2017"
"42634","352200 ITAJU",0,0,0,33,0,33,"2017"
"42635","352210 ITANHAEM",1,5,20,1498,3,1527,"2017"
"42636","352215 ITAOCA",0,0,1,41,0,42,"2017"
"42637","352220 ITAPECERICA DA SERRA",5,12,33,2732,8,2790,"2017"
"42638","352230 ITAPETININGA",6,9,35,2129,1,2180,"2017"
"42639","352240 ITAPEVA",1,13,54,1304,1,1373,"2017"
"42640","352250 ITAPEVI",14,9,60,4262,19,4364,"2017"
"42641","352260 ITAPIRA",2,2,12,784,3,803,"2017"
"42642","352265 ITAPIRAPUA PAULISTA",1,0,2,67,1,71,"2017"
"42643","352270 ITAPOLIS",1,3,8,443,0,455,"2017"
"42644","352280 ITAPORANGA",2,0,2,194,0,198,"2017"
"42645","352290 ITAPUI",0,0,1,152,1,154,"2017"
"42646","352300 ITAPURA",0,0,3,76,1,80,"2017"
"42647","352310 ITAQUAQUECETUBA",15,15,61,5831,38,5960,"2017"
"42648","352320 ITARARE",0,2,11,630,0,643,"2017"
"42649","352330 ITARIRI",0,2,0,153,1,156,"2017"
"42650","352340 ITATIBA",2,1,12,1388,2,1405,"2017"
"42651","352350 ITATINGA",1,2,6,265,1,275,"2017"
"42652","352360 ITIRAPINA",1,2,2,166,0,171,"2017"
"42653","352370 ITIRAPUA",2,0,2,65,0,69,"2017"
"42654","352380 ITOBI",0,0,1,100,0,101,"2017"
"42655","352390 ITU",3,8,20,2282,7,2320,"2017"
"42656","352400 ITUPEVA",1,2,10,834,0,847,"2017"
"42657","352410 ITUVERAVA",2,1,4,473,1,481,"2017"
"42658","352420 JABORANDI",0,0,2,60,0,62,"2017"
"42659","352430 JABOTICABAL",3,2,13,750,0,768,"2017"
"42660","352440 JACAREI",6,15,55,2985,15,3076,"2017"
"42661","352450 JACI",0,0,0,95,0,95,"2017"
"42662","352460 JACUPIRANGA",1,1,5,254,1,262,"2017"
"42663","352470 JAGUARIUNA",4,4,5,785,2,800,"2017"
"42664","352480 JALES",0,0,2,514,0,516,"2017"
"42665","352490 JAMBEIRO",0,3,1,63,0,67,"2017"
"42666","352500 JANDIRA",4,10,18,1757,11,1800,"2017"
"42667","352510 JARDINOPOLIS",3,3,11,600,3,620,"2017"
"42668","352520 JARINU",2,1,5,466,0,474,"2017"
"42669","352530 JAU",3,2,9,1608,8,1630,"2017"
"42670","352540 JERIQUARA",0,0,0,36,0,36,"2017"
"42671","352550 JOANOPOLIS",0,0,2,136,0,138,"2017"
"42672","352560 JOAO RAMALHO",0,0,0,62,0,62,"2017"
"42673","352570 JOSE BONIFACIO",0,0,5,464,0,469,"2017"
"42674","352580 JULIO MESQUITA",0,1,2,55,0,58,"2017"
"42675","352585 JUMIRIM",0,0,2,33,0,35,"2017"
"42676","352590 JUNDIAI",9,22,70,5959,6,6066,"2017"
"42677","352600 JUNQUEIROPOLIS",0,0,1,226,0,227,"2017"
"42678","352610 JUQUIA",1,0,0,277,0,278,"2017"
"42679","352620 JUQUITIBA",1,2,8,436,5,452,"2017"
"42680","352630 LAGOINHA",0,0,0,40,0,40,"2017"
"42681","352640 LARANJAL PAULISTA",1,1,4,326,0,332,"2017"
"42682","352650 LAVINIA",0,1,2,66,0,69,"2017"
"42683","352660 LAVRINHAS",0,1,0,99,1,101,"2017"
"42684","352670 LEME",2,4,10,1197,0,1213,"2017"
"42685","352680 LENCOIS PAULISTA",1,2,43,810,4,860,"2017"
"42686","352690 LIMEIRA",7,7,32,3562,12,3620,"2017"
"42687","352700 LINDOIA",0,0,1,69,0,70,"2017"
"42688","352710 LINS",4,2,7,924,1,938,"2017"
"42689","352720 LORENA",2,5,10,1172,74,1263,"2017"
"42690","352725 LOURDES",0,0,0,21,0,21,"2017"
"42691","352730 LOUVEIRA",4,1,9,784,0,798,"2017"
"42692","352740 LUCELIA",0,1,3,167,0,171,"2017"
"42693","352750 LUCIANOPOLIS",0,0,0,24,0,24,"2017"
"42694","352760 LUIS ANTONIO",0,1,7,180,0,188,"2017"
"42695","352770 LUIZIANIA",0,0,1,65,0,66,"2017"
"42696","352780 LUPERCIO",0,1,1,64,0,66,"2017"
"42697","352790 LUTECIA",0,0,1,29,0,30,"2017"
"42698","352800 MACATUBA",0,1,4,187,0,192,"2017"
"42699","352810 MACAUBAL",0,0,0,72,0,72,"2017"
"42700","352820 MACEDONIA",0,0,1,23,0,24,"2017"
"42701","352830 MAGDA",0,0,1,28,0,29,"2017"
"42702","352840 MAIRINQUE",5,2,17,648,0,672,"2017"
"42703","352850 MAIRIPORA",5,2,20,999,0,1026,"2017"
"42704","352860 MANDURI",1,1,0,107,0,109,"2017"
"42705","352870 MARABA PAULISTA",0,0,0,38,0,38,"2017"
"42706","352880 MARACAI",0,1,3,155,0,159,"2017"
"42707","352885 MARAPOAMA",0,0,0,27,0,27,"2017"
"42708","352890 MARIAPOLIS",0,1,1,33,0,35,"2017"
"42709","352900 MARILIA",3,12,54,3071,3,3143,"2017"
"42710","352910 MARINOPOLIS",0,0,0,13,0,13,"2017"
"42711","352920 MARTINOPOLIS",0,0,2,272,0,274,"2017"
"42712","352930 MATAO",4,8,6,994,1,1013,"2017"
"42713","352940 MAUA",18,18,60,5615,18,5729,"2017"
"42714","352950 MENDONCA",0,0,1,76,0,77,"2017"
"42715","352960 MERIDIANO",0,0,0,49,1,50,"2017"
"42716","352965 MESOPOLIS",0,0,0,27,0,27,"2017"
"42717","352970 MIGUELOPOLIS",0,0,2,267,0,269,"2017"
"42718","352980 MINEIROS DO TIETE",1,2,1,129,1,134,"2017"
"42719","352990 MIRACATU",2,3,4,290,0,299,"2017"
"42720","353000 MIRA ESTRELA",0,0,0,30,0,30,"2017"
"42721","353010 MIRANDOPOLIS",0,1,5,263,0,269,"2017"
"42722","353020 MIRANTE DO PARANAPANEMA",0,2,3,174,1,180,"2017"
"42723","353030 MIRASSOL",0,3,6,713,0,722,"2017"
"42724","353040 MIRASSOLANDIA",0,0,0,57,0,57,"2017"
"42725","353050 MOCOCA",0,1,7,795,2,805,"2017"
"42726","353060 MOGI DAS CRUZES",19,19,49,6235,23,6345,"2017"
"42727","353070 MOGI GUACU",2,5,39,1914,9,1969,"2017"
"42728","353080 MOGI MIRIM",5,2,8,1033,3,1051,"2017"
"42729","353090 MOMBUCA",0,0,0,49,0,49,"2017"
"42730","353100 MONCOES",0,0,0,29,0,29,"2017"
"42731","353110 MONGAGUA",2,4,20,684,1,711,"2017"
"42732","353120 MONTE ALEGRE DO SUL",0,1,1,78,1,81,"2017"
"42733","353130 MONTE ALTO",0,0,7,479,3,489,"2017"
"42734","353140 MONTE APRAZIVEL",0,2,0,226,0,228,"2017"
"42735","353150 MONTE AZUL PAULISTA",1,1,2,226,0,230,"2017"
"42736","353160 MONTE CASTELO",0,0,2,37,0,39,"2017"
"42737","353170 MONTEIRO LOBATO",0,0,2,33,0,35,"2017"
"42738","353180 MONTE MOR",7,2,3,910,4,926,"2017"
"42739","353190 MORRO AGUDO",0,1,9,364,0,374,"2017"
"42740","353200 MORUNGABA",0,0,1,150,1,152,"2017"
"42741","353205 MOTUCA",0,0,0,49,0,49,"2017"
"42742","353210 MURUTINGA DO SUL",0,0,0,44,0,44,"2017"
"42743","353215 NANTES",0,0,1,48,0,49,"2017"
"42744","353220 NARANDIBA",0,0,1,53,0,54,"2017"
"42745","353230 NATIVIDADE DA SERRA",0,0,3,79,0,82,"2017"
"42746","353240 NAZARE PAULISTA",1,2,3,209,0,215,"2017"
"42747","353250 NEVES PAULISTA",1,0,1,90,0,92,"2017"
"42748","353260 NHANDEARA",1,0,1,101,0,103,"2017"
"42749","353270 NIPOA",0,0,0,82,0,82,"2017"
"42750","353280 NOVA ALIANCA",0,0,1,88,0,89,"2017"
"42751","353282 NOVA CAMPINA",1,2,5,131,0,139,"2017"
"42752","353284 NOVA CANAA PAULISTA",0,0,0,11,0,11,"2017"
"42753","353286 NOVA CASTILHO",0,0,0,13,0,13,"2017"
"42754","353290 NOVA EUROPA",0,1,0,119,0,120,"2017"
"42755","353300 NOVA GRANADA",0,0,1,253,0,254,"2017"
"42756","353310 NOVA GUATAPORANGA",0,0,0,24,0,24,"2017"
"42757","353320 NOVA INDEPENDENCIA",0,0,0,64,0,64,"2017"
"42758","353325 NOVAIS",0,1,1,70,0,72,"2017"
"42759","353330 NOVA LUZITANIA",0,0,0,28,0,28,"2017"
"42760","353340 NOVA ODESSA",3,6,10,718,0,737,"2017"
"42761","353350 NOVO HORIZONTE",0,0,3,505,0,508,"2017"
"42762","353360 NUPORANGA",1,0,3,78,0,82,"2017"
"42763","353370 OCAUCU",0,0,1,69,1,71,"2017"
"42764","353380 OLEO",0,0,1,26,0,27,"2017"
"42765","353390 OLIMPIA",1,0,12,656,0,669,"2017"
"42766","353400 ONDA VERDE",0,0,0,64,0,64,"2017"
"42767","353410 ORIENTE",1,0,1,73,0,75,"2017"
"42768","353420 ORINDIUVA",1,1,0,79,0,81,"2017"
"42769","353430 ORLANDIA",0,1,5,463,0,469,"2017"
"42770","353440 OSASCO",15,31,138,9947,48,10179,"2017"
"42771","353450 OSCAR BRESSANE",0,0,0,27,0,27,"2017"
"42772","353460 OSVALDO CRUZ",2,1,0,324,1,328,"2017"
"42773","353470 OURINHOS",6,2,10,1331,5,1354,"2017"
"42774","353475 OUROESTE",0,0,0,127,0,127,"2017"
"42775","353480 OURO VERDE",0,0,0,97,1,98,"2017"
"42776","353490 PACAEMBU",0,1,1,105,1,108,"2017"
"42777","353500 PALESTINA",0,0,0,139,1,140,"2017"
"42778","353510 PALMARES PAULISTA",0,2,4,133,1,140,"2017"
"42779","353520 PALMEIRA D'OESTE",0,0,1,86,0,87,"2017"
"42780","353530 PALMITAL",1,2,2,256,0,261,"2017"
"42781","353540 PANORAMA",0,2,2,218,2,224,"2017"
"42782","353550 PARAGUACU PAULISTA",2,3,9,579,0,593,"2017"
"42783","353560 PARAIBUNA",1,0,0,209,2,212,"2017"
"42784","353570 PARAISO",0,0,0,77,1,78,"2017"
"42785","353580 PARANAPANEMA",0,1,3,306,0,310,"2017"
"42786","353590 PARANAPUA",0,0,0,67,0,67,"2017"
"42787","353600 PARAPUA",0,0,0,93,0,93,"2017"
"42788","353610 PARDINHO",0,1,4,86,1,92,"2017"
"42789","353620 PARIQUERA-ACU",0,0,0,308,1,309,"2017"
"42790","353625 PARISI",0,2,0,36,1,39,"2017"
"42791","353630 PATROCINIO PAULISTA",0,2,7,195,1,205,"2017"
"42792","353640 PAULICEIA",0,0,1,112,1,114,"2017"
"42793","353650 PAULINIA",2,7,10,1445,6,1470,"2017"
"42794","353657 PAULISTANIA",0,0,0,28,0,28,"2017"
"42795","353660 PAULO DE FARIA",0,0,1,80,0,81,"2017"
"42796","353670 PEDERNEIRAS",2,0,4,521,4,531,"2017"
"42797","353680 PEDRA BELA",0,0,0,68,0,68,"2017"
"42798","353690 PEDRANOPOLIS",0,0,0,14,0,14,"2017"
"42799","353700 PEDREGULHO",1,0,5,210,0,216,"2017"
"42800","353710 PEDREIRA",1,0,3,477,0,481,"2017"
"42801","353715 PEDRINHAS PAULISTA",0,0,0,34,0,34,"2017"
"42802","353720 PEDRO DE TOLEDO",0,1,3,114,0,118,"2017"
"42803","353730 PENAPOLIS",0,1,9,824,1,835,"2017"
"42804","353740 PEREIRA BARRETO",0,0,4,256,1,261,"2017"
"42805","353750 PEREIRAS",0,2,0,103,0,105,"2017"
"42806","353760 PERUIBE",1,6,9,908,3,927,"2017"
"42807","353770 PIACATU",0,0,0,63,0,63,"2017"
"42808","353780 PIEDADE",1,2,14,711,3,731,"2017"
"42809","353790 PILAR DO SUL",0,0,4,384,0,388,"2017"
"42810","353800 PINDAMONHANGABA",6,14,27,2185,8,2240,"2017"
"42811","353810 PINDORAMA",0,3,4,152,0,159,"2017"
"42812","353820 PINHALZINHO",1,0,1,147,1,150,"2017"
"42813","353830 PIQUEROBI",0,0,0,25,1,26,"2017"
"42814","353850 PIQUETE",0,0,2,136,16,154,"2017"
"42815","353860 PIRACAIA",0,0,2,361,2,365,"2017"
"42816","353870 PIRACICABA",12,22,46,5143,11,5234,"2017"
"42817","353880 PIRAJU",0,1,0,383,0,384,"2017"
"42818","353890 PIRAJUI",0,0,8,265,0,273,"2017"
"42819","353900 PIRANGI",0,0,1,127,1,129,"2017"
"42820","353910 PIRAPORA DO BOM JESUS",0,0,0,265,0,265,"2017"
"42821","353920 PIRAPOZINHO",0,0,4,330,2,336,"2017"
"42822","353930 PIRASSUNUNGA",3,4,9,858,3,877,"2017"
"42823","353940 PIRATININGA",0,1,0,190,2,193,"2017"
"42824","353950 PITANGUEIRAS",0,1,0,474,0,475,"2017"
"42825","353960 PLANALTO",0,0,0,89,0,89,"2017"
"42826","353970 PLATINA",0,0,0,46,0,46,"2017"
"42827","353980 POA",1,10,28,1545,10,1594,"2017"
"42828","353990 POLONI",0,1,0,62,0,63,"2017"
"42829","354000 POMPEIA",1,0,1,258,0,260,"2017"
"42830","354010 PONGAI",0,0,1,30,0,31,"2017"
"42831","354020 PONTAL",1,0,5,554,0,560,"2017"
"42832","354025 PONTALINDA",0,0,1,55,0,56,"2017"
"42833","354030 PONTES GESTAL",0,0,2,28,0,30,"2017"
"42834","354040 POPULINA",0,0,1,42,0,43,"2017"
"42835","354050 PORANGABA",0,0,1,82,1,84,"2017"
"42836","354060 PORTO FELIZ",2,1,6,730,0,739,"2017"
"42837","354070 PORTO FERREIRA",1,0,1,558,0,560,"2017"
"42838","354075 POTIM",1,1,2,236,12,252,"2017"
"42839","354080 POTIRENDABA",0,0,0,217,0,217,"2017"
"42840","354085 PRACINHA",0,0,0,15,0,15,"2017"
"42841","354090 PRADOPOLIS",1,0,7,218,1,227,"2017"
"42842","354100 PRAIA GRANDE",5,32,74,4422,21,4554,"2017"
"42843","354105 PRATANIA",0,1,3,77,0,81,"2017"
"42844","354110 PRESIDENTE ALVES",0,0,0,45,0,45,"2017"
"42845","354120 PRESIDENTE BERNARDES",1,1,0,130,0,132,"2017"
"42846","354130 PRESIDENTE EPITACIO",1,0,1,533,0,535,"2017"
"42847","354140 PRESIDENTE PRUDENTE",11,7,36,2981,3,3038,"2017"
"42848","354150 PRESIDENTE VENCESLAU",0,0,0,419,5,424,"2017"
"42849","354160 PROMISSAO",1,2,4,415,1,423,"2017"
"42850","354165 QUADRA",0,0,0,52,0,52,"2017"
"42851","354170 QUATA",0,0,1,148,0,149,"2017"
"42852","354180 QUEIROZ",0,0,0,56,0,56,"2017"
"42853","354190 QUELUZ",1,0,1,108,1,111,"2017"
"42854","354200 QUINTANA",0,0,3,82,0,85,"2017"
"42855","354210 RAFARD",1,0,0,107,0,108,"2017"
"42856","354220 RANCHARIA",0,1,4,387,0,392,"2017"
"42857","354230 REDENCAO DA SERRA",0,0,2,48,0,50,"2017"
"42858","354240 REGENTE FEIJO",1,0,2,245,0,248,"2017"
"42859","354250 REGINOPOLIS",0,0,0,66,0,66,"2017"
"42860","354260 REGISTRO",1,2,5,785,0,793,"2017"
"42861","354270 RESTINGA",0,0,3,111,0,114,"2017"
"42862","354280 RIBEIRA",0,0,1,42,0,43,"2017"
"42863","354290 RIBEIRAO BONITO",0,0,1,140,0,141,"2017"
"42864","354300 RIBEIRAO BRANCO",2,8,16,241,0,267,"2017"
"42865","354310 RIBEIRAO CORRENTE",0,0,0,47,2,49,"2017"
"42866","354320 RIBEIRAO DO SUL",0,0,0,45,0,45,"2017"
"42867","354323 RIBEIRAO DOS INDIOS",0,0,1,21,0,22,"2017"
"42868","354325 RIBEIRAO GRANDE",0,0,0,87,0,87,"2017"
"42869","354330 RIBEIRAO PIRES",2,5,12,1288,4,1311,"2017"
"42870","354340 RIBEIRAO PRETO",19,33,127,8165,34,8378,"2017"
"42871","354350 RIVERSUL",0,0,2,61,0,63,"2017"
"42872","354360 RIFAINA",0,0,0,46,0,46,"2017"
"42873","354370 RINCAO",0,0,3,125,1,129,"2017"
"42874","354380 RINOPOLIS",0,0,4,101,0,105,"2017"
"42875","354390 RIO CLARO",3,11,32,2318,7,2371,"2017"
"42876","354400 RIO DAS PEDRAS",1,0,2,385,0,388,"2017"
"42877","354410 RIO GRANDE DA SERRA",3,1,10,609,2,625,"2017"
"42878","354420 RIOLANDIA",0,0,0,110,0,110,"2017"
"42879","354425 ROSANA",1,1,3,225,0,230,"2017"
"42880","354430 ROSEIRA",0,0,2,129,2,133,"2017"
"42881","354440 RUBIACEA",0,0,0,35,0,35,"2017"
"42882","354450 RUBINEIA",0,0,0,25,0,25,"2017"
"42883","354460 SABINO",0,1,0,55,0,56,"2017"
"42884","354470 SAGRES",0,0,0,25,1,26,"2017"
"42885","354480 SALES",0,0,0,60,0,60,"2017"
"42886","354490 SALES OLIVEIRA",1,0,3,129,0,133,"2017"
"42887","354500 SALESOPOLIS",0,1,1,182,4,188,"2017"
"42888","354510 SALMOURAO",0,1,1,71,1,74,"2017"
"42889","354515 SALTINHO",0,0,0,93,0,93,"2017"
"42890","354520 SALTO",2,2,21,1653,3,1681,"2017"
"42891","354530 SALTO DE PIRAPORA",1,0,13,526,1,541,"2017"
"42892","354540 SALTO GRANDE",0,0,1,108,0,109,"2017"
"42893","354550 SANDOVALINA",0,0,0,53,0,53,"2017"
"42894","354560 SANTA ADELIA",0,0,2,181,0,183,"2017"
"42895","354570 SANTA ALBERTINA",0,1,1,63,0,65,"2017"
"42896","354580 SANTA BARBARA D'OESTE",7,7,38,2353,7,2412,"2017"
"42897","354600 SANTA BRANCA",1,4,3,156,0,164,"2017"
"42898","354610 SANTA CLARA D'OESTE",0,1,0,20,0,21,"2017"
"42899","354620 SANTA CRUZ DA CONCEICAO",0,0,0,27,0,27,"2017"
"42900","354625 SANTA CRUZ DA ESPERANCA",0,0,0,23,0,23,"2017"
"42901","354630 SANTA CRUZ DAS PALMEIRAS",1,3,5,385,0,394,"2017"
"42902","354640 SANTA CRUZ DO RIO PARDO",0,1,4,657,2,664,"2017"
"42903","354650 SANTA ERNESTINA",0,0,0,49,0,49,"2017"
"42904","354660 SANTA FE DO SUL",3,1,2,429,0,435,"2017"
"42905","354670 SANTA GERTRUDES",2,0,3,310,1,316,"2017"
"42906","354680 SANTA ISABEL",3,4,17,694,0,718,"2017"
"42907","354690 SANTA LUCIA",0,3,3,93,0,99,"2017"
"42908","354700 SANTA MARIA DA SERRA",0,0,1,69,0,70,"2017"
"42909","354710 SANTA MERCEDES",0,0,1,44,0,45,"2017"
"42910","354720 SANTANA DA PONTE PENSA",0,0,0,20,0,20,"2017"
"42911","354730 SANTANA DE PARNAIBA",7,7,32,2118,0,2164,"2017"
"42912","354740 SANTA RITA D'OESTE",0,0,0,27,0,27,"2017"
"42913","354750 SANTA RITA DO PASSA QUATRO",1,1,1,245,0,248,"2017"
"42914","354760 SANTA ROSA DE VITERBO",0,0,1,246,2,249,"2017"
"42915","354765 SANTA SALETE",0,0,0,13,0,13,"2017"
"42916","354770 SANTO ANASTACIO",2,2,5,209,1,219,"2017"
"42917","354780 SANTO ANDRE",22,35,120,8902,16,9095,"2017"
"42918","354790 SANTO ANTONIO DA ALEGRIA",0,1,0,77,0,78,"2017"
"42919","354800 SANTO ANTONIO DE POSSE",0,3,4,251,4,262,"2017"
"42920","354805 SANTO ANTONIO DO ARACANGUA",0,0,2,101,0,103,"2017"
"42921","354810 SANTO ANTONIO DO JARDIM",0,0,2,62,0,64,"2017"
"42922","354820 SANTO ANTONIO DO PINHAL",0,3,2,88,0,93,"2017"
"42923","354830 SANTO EXPEDITO",0,0,0,33,0,33,"2017"
"42924","354840 SANTOPOLIS DO AGUAPEI",0,1,1,57,0,59,"2017"
"42925","354850 SANTOS",4,14,85,4654,11,4768,"2017"
"42926","354860 SAO BENTO DO SAPUCAI",1,0,5,116,0,122,"2017"
"42927","354870 SAO BERNARDO DO CAMPO",16,37,164,10728,29,10974,"2017"
"42928","354880 SAO CAETANO DO SUL",3,3,15,1813,2,1836,"2017"
"42929","354890 SAO CARLOS",3,15,36,3173,4,3231,"2017"
"42930","354900 SAO FRANCISCO",1,0,0,26,0,27,"2017"
"42931","354910 SAO JOAO DA BOA VISTA",3,7,12,1102,3,1127,"2017"
"42932","354920 SAO JOAO DAS DUAS PONTES",0,0,0,26,0,26,"2017"
"42933","354925 SAO JOAO DE IRACEMA",0,1,1,18,0,20,"2017"
"42934","354930 SAO JOAO DO PAU D'ALHO",0,1,0,22,0,23,"2017"
"42935","354940 SAO JOAQUIM DA BARRA",1,2,13,570,0,586,"2017"
"42936","354950 SAO JOSE DA BELA VISTA",0,0,2,91,1,94,"2017"
"42937","354960 SAO JOSE DO BARREIRO",1,0,0,45,1,47,"2017"
"42938","354970 SAO JOSE DO RIO PARDO",1,1,4,698,1,705,"2017"
"42939","354980 SAO JOSE DO RIO PRETO",8,13,34,5401,5,5461,"2017"
"42940","354990 SAO JOSE DOS CAMPOS",19,26,89,9578,31,9743,"2017"
"42941","354995 SAO LOURENCO DA SERRA",0,1,2,199,0,202,"2017"
"42942","355000 SAO LUIS DO PARAITINGA",0,1,2,118,0,121,"2017"
"42943","355010 SAO MANUEL",1,4,8,510,1,524,"2017"
"42944","355020 SAO MIGUEL ARCANJO",0,4,5,412,1,422,"2017"
"42945","355030 SAO PAULO",398,604,2310,165425,562,169299,"2017"
"42946","355040 SAO PEDRO",0,2,5,420,0,427,"2017"
"42947","355050 SAO PEDRO DO TURVO",0,1,1,84,0,86,"2017"
"42948","355060 SAO ROQUE",3,7,20,1064,5,1099,"2017"
"42949","355070 SAO SEBASTIAO",1,5,12,1271,2,1291,"2017"
"42950","355080 SAO SEBASTIAO DA GRAMA",0,2,1,86,0,89,"2017"
"42951","355090 SAO SIMAO",0,1,3,129,0,133,"2017"
"42952","355100 SAO VICENTE",7,40,138,4434,38,4657,"2017"
"42953","355110 SARAPUI",0,0,2,110,0,112,"2017"
"42954","355120 SARUTAIA",1,0,0,57,0,58,"2017"
"42955","355130 SEBASTIANOPOLIS DO SUL",0,0,1,33,0,34,"2017"
"42956","355140 SERRA AZUL",0,3,4,128,0,135,"2017"
"42957","355150 SERRANA",0,5,5,627,0,637,"2017"
"42958","355160 SERRA NEGRA",0,0,1,303,1,305,"2017"
"42959","355170 SERTAOZINHO",5,5,17,1551,2,1580,"2017"
"42960","355180 SETE BARRAS",0,1,2,197,2,202,"2017"
"42961","355190 SEVERINIA",1,1,2,181,0,185,"2017"
"42962","355200 SILVEIRAS",0,0,1,65,4,70,"2017"
"42963","355210 SOCORRO",1,0,2,411,0,414,"2017"
"42964","355220 SOROCABA",20,32,175,9018,22,9267,"2017"
"42965","355230 SUD MENNUCCI",0,0,1,105,0,106,"2017"
"42966","355240 SUMARE",7,14,59,3965,11,4056,"2017"
"42967","355250 SUZANO",12,23,74,4428,22,4559,"2017"
"42968","355255 SUZANAPOLIS",0,0,0,42,0,42,"2017"
"42969","355260 TABAPUA",0,0,2,115,0,117,"2017"
"42970","355270 TABATINGA",0,1,1,210,0,212,"2017"
"42971","355280 TABOAO DA SERRA",18,17,44,4568,14,4661,"2017"
"42972","355290 TACIBA",0,0,0,74,0,74,"2017"
"42973","355300 TAGUAI",2,0,0,183,0,185,"2017"
"42974","355310 TAIACU",0,0,0,63,0,63,"2017"
"42975","355320 TAIUVA",0,0,1,57,0,58,"2017"
"42976","355330 TAMBAU",1,2,3,297,0,303,"2017"
"42977","355340 TANABI",0,0,1,248,0,249,"2017"
"42978","355350 TAPIRAI",0,0,0,97,0,97,"2017"
"42979","355360 TAPIRATIBA",0,0,2,139,1,142,"2017"
"42980","355365 TAQUARAL",0,0,0,19,0,19,"2017"
"42981","355370 TAQUARITINGA",1,1,6,628,0,636,"2017"
"42982","355380 TAQUARITUBA",3,1,4,280,0,288,"2017"
"42983","355385 TAQUARIVAI",0,3,8,84,0,95,"2017"
"42984","355390 TARABAI",0,0,0,84,0,84,"2017"
"42985","355395 TARUMA",0,0,0,209,0,209,"2017"
"42986","355400 TATUI",6,6,12,1670,0,1694,"2017"
"42987","355410 TAUBATE",6,19,75,3883,8,3991,"2017"
"42988","355420 TEJUPA",0,0,0,80,0,80,"2017"
"42989","355430 TEODORO SAMPAIO",0,0,1,354,0,355,"2017"
"42990","355440 TERRA ROXA",0,1,2,53,41,97,"2017"
"42991","355450 TIETE",1,2,12,515,1,531,"2017"
"42992","355460 TIMBURI",1,0,0,20,0,21,"2017"
"42993","355465 TORRE DE PEDRA",0,0,1,19,0,20,"2017"
"42994","355470 TORRINHA",0,2,0,101,0,103,"2017"
"42995","355475 TRABIJU",0,0,0,20,0,20,"2017"
"42996","355480 TREMEMBE",0,2,10,573,1,586,"2017"
"42997","355490 TRES FRONTEIRAS",0,0,0,63,1,64,"2017"
"42998","355495 TUIUTI",0,0,0,53,0,53,"2017"
"42999","355500 TUPA",3,2,9,717,1,732,"2017"
"43000","355510 TUPI PAULISTA",0,0,0,141,0,141,"2017"
"43001","355520 TURIUBA",0,0,0,13,0,13,"2017"
"43002","355530 TURMALINA",0,0,0,18,0,18,"2017"
"43003","355535 UBARANA",0,0,1,91,0,92,"2017"
"43004","355540 UBATUBA",2,9,19,1237,5,1272,"2017"
"43005","355550 UBIRAJARA",1,0,3,77,5,86,"2017"
"43006","355560 UCHOA",0,0,0,94,0,94,"2017"
"43007","355570 UNIAO PAULISTA",0,0,0,13,0,13,"2017"
"43008","355580 URANIA",0,0,0,99,0,99,"2017"
"43009","355590 URU",0,0,0,9,1,10,"2017"
"43010","355600 URUPES",0,1,2,142,0,145,"2017"
"43011","355610 VALENTIM GENTIL",1,0,3,179,0,183,"2017"
"43012","355620 VALINHOS",3,3,10,1375,1,1392,"2017"
"43013","355630 VALPARAISO",0,2,5,315,0,322,"2017"
"43014","355635 VARGEM",0,0,1,113,0,114,"2017"
"43015","355640 VARGEM GRANDE DO SUL",1,0,3,549,3,556,"2017"
"43016","355645 VARGEM GRANDE PAULISTA",2,1,9,726,2,740,"2017"
"43017","355650 VARZEA PAULISTA",2,6,18,1423,1,1450,"2017"
"43018","355660 VERA CRUZ",0,0,1,110,0,111,"2017"
"43019","355670 VINHEDO",2,1,4,938,2,947,"2017"
"43020","355680 VIRADOURO",2,1,2,218,0,223,"2017"
"43021","355690 VISTA ALEGRE DO ALTO",0,0,1,106,0,107,"2017"
"43022","355695 VITORIA BRASIL",0,0,0,15,0,15,"2017"
"43023","355700 VOTORANTIM",5,6,28,1717,3,1759,"2017"
"43024","355710 VOTUPORANGA",2,0,8,1034,1,1045,"2017"
"43025","355715 ZACARIAS",0,0,1,23,0,24,"2017"
"43026","355720 CHAVANTES",0,0,2,187,0,189,"2017"
"43027","355730 ESTIVA GERBI",0,0,6,120,1,127,"2017"
"43028","MUNICIPIO IGNORADO - PR",0,0,0,2,6,8,"2017"
"43029","410010 ABATIA",0,0,2,114,0,116,"2017"
"43030","410020 ADRIANOPOLIS",0,0,2,94,2,98,"2017"
"43031","410030 AGUDOS DO SUL",1,2,2,107,1,113,"2017"
"43032","410040 ALMIRANTE TAMANDARE",6,1,18,1752,9,1786,"2017"
"43033","410045 ALTAMIRA DO PARANA",0,1,1,69,0,71,"2017"
"43034","410050 ALTONIA",0,0,3,242,0,245,"2017"
"43035","410060 ALTO PARANA",0,1,1,175,1,178,"2017"
"43036","410070 ALTO PIQUIRI",1,0,2,130,0,133,"2017"
"43037","410080 ALVORADA DO SUL",0,1,1,109,0,111,"2017"
"43038","410090 AMAPORA",0,1,0,81,0,82,"2017"
"43039","410100 AMPERE",0,1,7,258,0,266,"2017"
"43040","410105 ANAHY",0,0,2,27,0,29,"2017"
"43041","410110 ANDIRA",1,3,3,238,1,246,"2017"
"43042","410115 ANGULO",0,0,1,40,0,41,"2017"
"43043","410120 ANTONINA",0,1,2,276,0,279,"2017"
"43044","410130 ANTONIO OLINTO",0,0,1,74,0,75,"2017"
"43045","410140 APUCARANA",5,8,23,1746,4,1786,"2017"
"43046","410150 ARAPONGAS",3,4,15,1567,0,1589,"2017"
"43047","410160 ARAPOTI",1,3,9,382,1,396,"2017"
"43048","410165 ARAPUA",0,0,0,51,0,51,"2017"
"43049","410170 ARARUNA",0,1,0,189,0,190,"2017"
"43050","410180 ARAUCARIA",4,9,29,2307,9,2358,"2017"
"43051","410185 ARIRANHA DO IVAI",0,0,2,42,0,44,"2017"
"43052","410190 ASSAI",0,0,1,190,1,192,"2017"
"43053","410200 ASSIS CHATEAUBRIAND",0,1,2,467,0,470,"2017"
"43054","410210 ASTORGA",0,2,1,312,0,315,"2017"
"43055","410220 ATALAIA",0,0,1,50,0,51,"2017"
"43056","410230 BALSA NOVA",0,1,7,229,0,237,"2017"
"43057","410240 BANDEIRANTES",0,4,8,432,2,446,"2017"
"43058","410250 BARBOSA FERRAZ",1,0,0,117,1,119,"2017"
"43059","410260 BARRACAO",0,0,2,147,0,149,"2017"
"43060","410270 BARRA DO JACARE",1,0,0,24,0,25,"2017"
"43061","410275 BELA VISTA DA CAROBA",0,0,0,48,0,48,"2017"
"43062","410280 BELA VISTA DO PARAISO",0,2,2,212,1,217,"2017"
"43063","410290 BITURUNA",0,0,1,269,0,270,"2017"
"43064","410300 BOA ESPERANCA",0,1,0,63,0,64,"2017"
"43065","410302 BOA ESPERANCA DO IGUACU",0,0,0,30,0,30,"2017"
"43066","410304 BOA VENTURA DE SAO ROQUE",0,1,2,79,0,82,"2017"
"43067","410305 BOA VISTA DA APARECIDA",0,0,1,122,0,123,"2017"
"43068","410310 BOCAIUVA DO SUL",1,2,0,196,1,200,"2017"
"43069","410315 BOM JESUS DO SUL",0,0,1,61,0,62,"2017"
"43070","410320 BOM SUCESSO",0,0,6,80,0,86,"2017"
"43071","410322 BOM SUCESSO DO SUL",0,0,1,35,0,36,"2017"
"43072","410330 BORRAZOPOLIS",0,0,1,88,0,89,"2017"
"43073","410335 BRAGANEY",0,0,2,62,0,64,"2017"
"43074","410337 BRASILANDIA DO SUL",1,0,0,53,0,54,"2017"
"43075","410340 CAFEARA",0,0,1,14,0,15,"2017"
"43076","410345 CAFELANDIA",2,1,5,292,0,300,"2017"
"43077","410347 CAFEZAL DO SUL",0,0,2,49,0,51,"2017"
"43078","410350 CALIFORNIA",0,2,3,108,0,113,"2017"
"43079","410360 CAMBARA",1,0,2,279,1,283,"2017"
"43080","410370 CAMBE",6,6,14,1327,2,1355,"2017"
"43081","410380 CAMBIRA",1,1,1,95,0,98,"2017"
"43082","410390 CAMPINA DA LAGOA",0,1,2,217,1,221,"2017"
"43083","410395 CAMPINA DO SIMAO",0,0,1,69,0,70,"2017"
"43084","410400 CAMPINA GRANDE DO SUL",2,1,7,829,3,842,"2017"
"43085","410405 CAMPO BONITO",0,0,2,61,0,63,"2017"
"43086","410410 CAMPO DO TENENTE",0,1,1,133,0,135,"2017"
"43087","410420 CAMPO LARGO",3,9,42,1677,4,1735,"2017"
"43088","410425 CAMPO MAGRO",2,1,6,379,2,390,"2017"
"43089","410430 CAMPO MOURAO",1,5,12,1365,2,1385,"2017"
"43090","410440 CANDIDO DE ABREU",0,0,2,183,1,186,"2017"
"43091","410442 CANDOI",0,1,3,275,0,279,"2017"
"43092","410445 CANTAGALO",0,0,7,178,0,185,"2017"
"43093","410450 CAPANEMA",1,0,2,246,1,250,"2017"
"43094","410460 CAPITAO LEONIDAS MARQUES",0,1,3,240,0,244,"2017"
"43095","410465 CARAMBEI",0,1,4,359,1,365,"2017"
"43096","410470 CARLOPOLIS",2,0,0,199,1,202,"2017"
"43097","410480 CASCAVEL",4,14,110,4750,1,4879,"2017"
"43098","410490 CASTRO",2,4,23,1175,5,1209,"2017"
"43099","410500 CATANDUVAS",0,2,4,109,0,115,"2017"
"43100","410510 CENTENARIO DO SUL",0,0,1,172,0,173,"2017"
"43101","410520 CERRO AZUL",0,3,2,213,3,221,"2017"
"43102","410530 CEU AZUL",1,0,4,125,0,130,"2017"
"43103","410540 CHOPINZINHO",0,2,8,277,1,288,"2017"
"43104","410550 CIANORTE",0,4,6,1114,0,1124,"2017"
"43105","410560 CIDADE GAUCHA",0,0,0,148,0,148,"2017"
"43106","410570 CLEVELANDIA",0,4,0,226,0,230,"2017"
"43107","410580 COLOMBO",12,7,37,3624,16,3696,"2017"
"43108","410590 COLORADO",2,2,5,277,0,286,"2017"
"43109","410600 CONGONHINHAS",2,1,1,133,0,137,"2017"
"43110","410610 CONSELHEIRO MAIRINCK",0,0,0,56,0,56,"2017"
"43111","410620 CONTENDA",0,2,5,233,1,241,"2017"
"43112","410630 CORBELIA",0,0,3,254,0,257,"2017"
"43113","410640 CORNELIO PROCOPIO",0,1,2,513,0,516,"2017"
"43114","410645 CORONEL DOMINGOS SOARES",0,0,0,106,0,106,"2017"
"43115","410650 CORONEL VIVIDA",0,1,4,328,0,333,"2017"
"43116","410655 CORUMBATAI DO SUL",0,0,0,40,0,40,"2017"
"43117","410657 CRUZEIRO DO IGUACU",0,0,0,63,0,63,"2017"
"43118","410660 CRUZEIRO DO OESTE",1,1,3,287,0,292,"2017"
"43119","410670 CRUZEIRO DO SUL",1,0,1,74,1,77,"2017"
"43120","410680 CRUZ MACHADO",0,1,4,205,0,210,"2017"
"43121","410685 CRUZMALTINA",0,0,1,41,0,42,"2017"
"43122","410690 CURITIBA",39,89,395,22168,54,22745,"2017"
"43123","410700 CURIUVA",0,0,1,188,0,189,"2017"
"43124","410710 DIAMANTE DO NORTE",0,0,0,46,0,46,"2017"
"43125","410712 DIAMANTE DO SUL",0,0,3,50,0,53,"2017"
"43126","410715 DIAMANTE D'OESTE",0,0,0,75,1,76,"2017"
"43127","410720 DOIS VIZINHOS",1,3,14,606,0,624,"2017"
"43128","410725 DOURADINA",0,1,3,123,0,127,"2017"
"43129","410730 DOUTOR CAMARGO",0,0,0,61,0,61,"2017"
"43130","410740 ENEAS MARQUES",0,1,0,64,0,65,"2017"
"43131","410750 ENGENHEIRO BELTRAO",0,0,4,161,0,165,"2017"
"43132","410752 ESPERANCA NOVA",0,0,0,22,0,22,"2017"
"43133","410753 ENTRE RIOS DO OESTE",1,0,2,52,0,55,"2017"
"43134","410754 ESPIGAO ALTO DO IGUACU",0,0,2,61,0,63,"2017"
"43135","410755 FAROL",0,0,2,46,0,48,"2017"
"43136","410760 FAXINAL",0,0,2,267,1,270,"2017"
"43137","410765 FAZENDA RIO GRANDE",8,5,45,1894,0,1952,"2017"
"43138","410770 FENIX",0,0,1,58,0,59,"2017"
"43139","410773 FERNANDES PINHEIRO",0,0,0,102,0,102,"2017"
"43140","410775 FIGUEIRA",0,0,1,96,0,97,"2017"
"43141","410780 FLORAI",0,0,1,54,0,55,"2017"
"43142","410785 FLOR DA SERRA DO SUL",0,0,0,74,0,74,"2017"
"43143","410790 FLORESTA",0,0,1,115,0,116,"2017"
"43144","410800 FLORESTOPOLIS",0,1,3,146,0,150,"2017"
"43145","410810 FLORIDA",0,0,0,27,0,27,"2017"
"43146","410820 FORMOSA DO OESTE",0,0,2,107,0,109,"2017"
"43147","410830 FOZ DO IGUACU",9,17,57,4306,12,4401,"2017"
"43148","410832 FRANCISCO ALVES",0,0,2,92,0,94,"2017"
"43149","410840 FRANCISCO BELTRAO",1,4,21,1283,4,1313,"2017"
"43150","410845 FOZ DO JORDAO",1,0,1,74,0,76,"2017"
"43151","410850 GENERAL CARNEIRO",0,1,5,193,0,199,"2017"
"43152","410855 GODOY MOREIRA",0,0,2,36,0,38,"2017"
"43153","410860 GOIOERE",2,1,1,378,1,383,"2017"
"43154","410865 GOIOXIM",0,0,0,108,0,108,"2017"
"43155","410870 GRANDES RIOS",0,0,0,88,0,88,"2017"
"43156","410880 GUAIRA",0,0,10,485,1,496,"2017"
"43157","410890 GUAIRACA",0,0,0,77,0,77,"2017"
"43158","410895 GUAMIRANGA",0,1,4,109,0,114,"2017"
"43159","410900 GUAPIRAMA",0,1,2,52,0,55,"2017"
"43160","410910 GUAPOREMA",0,0,0,21,0,21,"2017"
"43161","410920 GUARACI",2,0,1,64,0,67,"2017"
"43162","410930 GUARANIACU",1,0,8,201,0,210,"2017"
"43163","410940 GUARAPUAVA",4,6,28,2944,2,2984,"2017"
"43164","410950 GUARAQUECABA",0,0,0,97,2,99,"2017"
"43165","410960 GUARATUBA",2,1,9,498,2,512,"2017"
"43166","410965 HONORIO SERPA",0,1,1,53,0,55,"2017"
"43167","410970 IBAITI",1,3,4,338,0,346,"2017"
"43168","410975 IBEMA",0,0,1,93,0,94,"2017"
"43169","410980 IBIPORA",1,2,8,690,0,701,"2017"
"43170","410990 ICARAIMA",0,0,2,112,0,114,"2017"
"43171","411000 IGUARACU",0,0,0,54,0,54,"2017"
"43172","411005 IGUATU",0,0,0,26,0,26,"2017"
"43173","411007 IMBAU",0,1,2,172,3,178,"2017"
"43174","411010 IMBITUVA",2,3,6,460,0,471,"2017"
"43175","411020 INACIO MARTINS",0,1,0,171,0,172,"2017"
"43176","411030 INAJA",0,0,0,32,0,32,"2017"
"43177","411040 INDIANOPOLIS",0,0,0,51,0,51,"2017"
"43178","411050 IPIRANGA",1,0,4,187,0,192,"2017"
"43179","411060 IPORA",0,1,2,190,0,193,"2017"
"43180","411065 IRACEMA DO OESTE",0,0,0,20,0,20,"2017"
"43181","411070 IRATI",1,4,6,839,0,850,"2017"
"43182","411080 IRETAMA",0,3,1,141,0,145,"2017"
"43183","411090 ITAGUAJE",0,1,0,65,0,66,"2017"
"43184","411095 ITAIPULANDIA",0,1,4,189,0,194,"2017"
"43185","411100 ITAMBARACA",0,0,2,64,0,66,"2017"
"43186","411110 ITAMBE",1,1,0,71,0,73,"2017"
"43187","411120 ITAPEJARA D'OESTE",0,0,2,187,0,189,"2017"
"43188","411125 ITAPERUCU",0,3,7,516,1,527,"2017"
"43189","411130 ITAUNA DO SUL",0,0,0,37,1,38,"2017"
"43190","411140 IVAI",0,0,1,194,1,196,"2017"
"43191","411150 IVAIPORA",0,0,5,384,0,389,"2017"
"43192","411155 IVATE",0,0,0,91,0,91,"2017"
"43193","411160 IVATUBA",0,0,1,37,0,38,"2017"
"43194","411170 JABOTI",2,1,0,75,1,79,"2017"
"43195","411180 JACAREZINHO",2,3,4,533,1,543,"2017"
"43196","411190 JAGUAPITA",0,1,2,174,0,177,"2017"
"43197","411200 JAGUARIAIVA",3,0,11,538,0,552,"2017"
"43198","411210 JANDAIA DO SUL",0,1,1,271,0,273,"2017"
"43199","411220 JANIOPOLIS",1,0,2,69,0,72,"2017"
"43200","411230 JAPIRA",0,0,4,70,0,74,"2017"
"43201","411240 JAPURA",1,0,1,107,0,109,"2017"
"43202","411250 JARDIM ALEGRE",0,0,4,127,0,131,"2017"
"43203","411260 JARDIM OLINDA",0,0,0,14,0,14,"2017"
"43204","411270 JATAIZINHO",4,0,2,191,0,197,"2017"
"43205","411275 JESUITAS",0,0,3,98,0,101,"2017"
"43206","411280 JOAQUIM TAVORA",0,1,4,157,1,163,"2017"
"43207","411290 JUNDIAI DO SUL",0,0,2,29,0,31,"2017"
"43208","411295 JURANDA",0,0,2,94,0,96,"2017"
"43209","411300 JUSSARA",0,0,0,90,0,90,"2017"
"43210","411310 KALORE",0,0,2,47,0,49,"2017"
"43211","411320 LAPA",1,2,14,548,0,565,"2017"
"43212","411325 LARANJAL",0,0,1,94,0,95,"2017"
"43213","411330 LARANJEIRAS DO SUL",2,5,11,462,0,480,"2017"
"43214","411340 LEOPOLIS",2,0,1,45,0,48,"2017"
"43215","411342 LIDIANOPOLIS",0,0,3,49,0,52,"2017"
"43216","411345 LINDOESTE",0,0,0,71,0,71,"2017"
"43217","411350 LOANDA",2,0,1,322,0,325,"2017"
"43218","411360 LOBATO",0,0,1,58,0,59,"2017"
"43219","411370 LONDRINA",18,30,92,6962,14,7116,"2017"
"43220","411373 LUIZIANA",0,1,0,83,0,84,"2017"
"43221","411375 LUNARDELLI",0,0,1,55,0,56,"2017"
"43222","411380 LUPIONOPOLIS",1,1,0,39,0,41,"2017"
"43223","411390 MALLET",0,0,6,163,0,169,"2017"
"43224","411400 MAMBORE",0,0,1,201,0,202,"2017"
"43225","411410 MANDAGUACU",1,1,5,346,1,354,"2017"
"43226","411420 MANDAGUARI",1,0,15,490,2,508,"2017"
"43227","411430 MANDIRITUBA",4,4,7,383,3,401,"2017"
"43228","411435 MANFRINOPOLIS",0,0,0,36,0,36,"2017"
"43229","411440 MANGUEIRINHA",0,0,4,244,0,248,"2017"
"43230","411450 MANOEL RIBAS",0,0,3,190,1,194,"2017"
"43231","411460 MARECHAL CANDIDO RONDON",2,3,6,746,1,758,"2017"
"43232","411470 MARIA HELENA",0,0,1,75,0,76,"2017"
"43233","411480 MARIALVA",1,2,16,473,1,493,"2017"
"43234","411490 MARILANDIA DO SUL",0,2,1,112,0,115,"2017"
"43235","411500 MARILENA",0,0,1,84,0,85,"2017"
"43236","411510 MARILUZ",0,1,3,143,0,147,"2017"
"43237","411520 MARINGA",13,15,95,5030,4,5157,"2017"
"43238","411530 MARIOPOLIS",0,0,2,87,0,89,"2017"
"43239","411535 MARIPA",0,0,2,80,0,82,"2017"
"43240","411540 MARMELEIRO",2,1,2,204,2,211,"2017"
"43241","411545 MARQUINHO",0,1,1,70,0,72,"2017"
"43242","411550 MARUMBI",2,1,1,54,1,59,"2017"
"43243","411560 MATELANDIA",2,0,1,277,0,280,"2017"
"43244","411570 MATINHOS",1,2,6,468,6,483,"2017"
"43245","411573 MATO RICO",0,0,1,36,0,37,"2017"
"43246","411575 MAUA DA SERRA",0,0,2,151,2,155,"2017"
"43247","411580 MEDIANEIRA",3,1,18,746,0,768,"2017"
"43248","411585 MERCEDES",1,0,1,75,0,77,"2017"
"43249","411590 MIRADOR",0,0,0,40,0,40,"2017"
"43250","411600 MIRASELVA",0,0,0,16,0,16,"2017"
"43251","411605 MISSAL",0,0,1,134,0,135,"2017"
"43252","411610 MOREIRA SALES",0,0,1,157,0,158,"2017"
"43253","411620 MORRETES",2,1,1,226,1,231,"2017"
"43254","411630 MUNHOZ DE MELO",1,0,1,50,0,52,"2017"
"43255","411640 NOSSA SENHORA DAS GRACAS",1,0,0,52,0,53,"2017"
"43256","411650 NOVA ALIANCA DO IVAI",0,0,0,21,0,21,"2017"
"43257","411660 NOVA AMERICA DA COLINA",0,0,0,40,0,40,"2017"
"43258","411670 NOVA AURORA",0,0,2,140,0,142,"2017"
"43259","411680 NOVA CANTU",1,0,3,95,0,99,"2017"
"43260","411690 NOVA ESPERANCA",1,0,6,323,0,330,"2017"
"43261","411695 NOVA ESPERANCA DO SUDOESTE",0,0,0,66,1,67,"2017"
"43262","411700 NOVA FATIMA",1,0,1,90,0,92,"2017"
"43263","411705 NOVA LARANJEIRAS",0,0,2,143,0,145,"2017"
"43264","411710 NOVA LONDRINA",1,2,2,160,0,165,"2017"
"43265","411720 NOVA OLIMPIA",0,0,0,74,0,74,"2017"
"43266","411721 NOVA SANTA BARBARA",0,0,0,52,0,52,"2017"
"43267","411722 NOVA SANTA ROSA",0,1,2,125,0,128,"2017"
"43268","411725 NOVA PRATA DO IGUACU",0,0,1,116,0,117,"2017"
"43269","411727 NOVA TEBAS",0,0,1,99,1,101,"2017"
"43270","411729 NOVO ITACOLOMI",1,0,3,40,0,44,"2017"
"43271","411730 ORTIGUEIRA",1,4,4,304,2,315,"2017"
"43272","411740 OURIZONA",0,0,1,39,0,40,"2017"
"43273","411745 OURO VERDE DO OESTE",0,1,1,86,0,88,"2017"
"43274","411750 PAICANDU",4,1,8,632,1,646,"2017"
"43275","411760 PALMAS",1,2,8,829,0,840,"2017"
"43276","411770 PALMEIRA",4,5,12,468,0,489,"2017"
"43277","411780 PALMITAL",0,1,4,212,0,217,"2017"
"43278","411790 PALOTINA",0,1,9,495,0,505,"2017"
"43279","411800 PARAISO DO NORTE",0,1,0,184,0,185,"2017"
"43280","411810 PARANACITY",0,1,6,140,0,147,"2017"
"43281","411820 PARANAGUA",6,6,36,2299,13,2360,"2017"
"43282","411830 PARANAPOEMA",0,0,1,39,0,40,"2017"
"43283","411840 PARANAVAI",0,0,7,1280,0,1287,"2017"
"43284","411845 PATO BRAGADO",0,1,0,68,3,72,"2017"
"43285","411850 PATO BRANCO",2,3,10,1199,0,1214,"2017"
"43286","411860 PAULA FREITAS",0,0,1,68,1,70,"2017"
"43287","411870 PAULO FRONTIN",1,0,0,79,0,80,"2017"
"43288","411880 PEABIRU",0,0,3,165,0,168,"2017"
"43289","411885 PEROBAL",0,0,0,113,0,113,"2017"
"43290","411890 PEROLA",1,0,1,152,0,154,"2017"
"43291","411900 PEROLA D'OESTE",0,0,1,70,0,71,"2017"
"43292","411910 PIEN",1,1,2,156,1,161,"2017"
"43293","411915 PINHAIS",7,13,34,1832,5,1891,"2017"
"43294","411920 PINHALAO",0,0,0,85,0,85,"2017"
"43295","411925 PINHAL DE SAO BENTO",0,1,0,33,0,34,"2017"
"43296","411930 PINHAO",3,2,4,537,4,550,"2017"
"43297","411940 PIRAI DO SUL",1,2,10,354,1,368,"2017"
"43298","411950 PIRAQUARA",8,4,22,1529,4,1567,"2017"
"43299","411960 PITANGA",1,1,12,425,0,439,"2017"
"43300","411965 PITANGUEIRAS",0,0,1,23,0,24,"2017"
"43301","411970 PLANALTINA DO PARANA",0,0,0,65,0,65,"2017"
"43302","411980 PLANALTO",0,2,6,131,1,140,"2017"
"43303","411990 PONTA GROSSA",24,30,158,5067,13,5292,"2017"
"43304","411995 PONTAL DO PARANA",1,2,2,410,3,418,"2017"
"43305","412000 PORECATU",0,1,4,160,0,165,"2017"
"43306","412010 PORTO AMAZONAS",0,0,1,43,0,44,"2017"
"43307","412015 PORTO BARREIRO",0,0,0,41,0,41,"2017"
"43308","412020 PORTO RICO",0,0,0,35,0,35,"2017"
"43309","412030 PORTO VITORIA",0,0,0,54,0,54,"2017"
"43310","412033 PRADO FERREIRA",0,1,2,47,0,50,"2017"
"43311","412035 PRANCHITA",0,0,1,95,0,96,"2017"
"43312","412040 PRESIDENTE CASTELO BRANCO",1,0,1,67,0,69,"2017"
"43313","412050 PRIMEIRO DE MAIO",0,0,1,95,0,96,"2017"
"43314","412060 PRUDENTOPOLIS",1,0,3,661,0,665,"2017"
"43315","412065 QUARTO CENTENARIO",0,0,1,54,0,55,"2017"
"43316","412070 QUATIGUA",0,0,0,99,0,99,"2017"
"43317","412080 QUATRO BARRAS",2,3,2,324,3,334,"2017"
"43318","412085 QUATRO PONTES",0,0,1,39,0,40,"2017"
"43319","412090 QUEDAS DO IGUACU",3,1,5,497,0,506,"2017"
"43320","412100 QUERENCIA DO NORTE",0,0,1,170,0,171,"2017"
"43321","412110 QUINTA DO SOL",0,2,1,70,0,73,"2017"
"43322","412120 QUITANDINHA",1,0,4,234,2,241,"2017"
"43323","412125 RAMILANDIA",0,0,2,64,0,66,"2017"
"43324","412130 RANCHO ALEGRE",0,0,0,27,0,27,"2017"
"43325","412135 RANCHO ALEGRE D'OESTE",0,0,1,41,0,42,"2017"
"43326","412140 REALEZA",1,0,4,205,0,210,"2017"
"43327","412150 REBOUCAS",0,2,1,231,0,234,"2017"
"43328","412160 RENASCENCA",0,0,0,86,1,87,"2017"
"43329","412170 RESERVA",1,2,5,387,1,396,"2017"
"43330","412175 RESERVA DO IGUACU",0,1,2,106,0,109,"2017"
"43331","412180 RIBEIRAO CLARO",1,2,1,172,2,178,"2017"
"43332","412190 RIBEIRAO DO PINHAL",0,1,3,171,0,175,"2017"
"43333","412200 RIO AZUL",0,0,0,207,0,207,"2017"
"43334","412210 RIO BOM",0,0,0,42,0,42,"2017"
"43335","412215 RIO BONITO DO IGUACU",1,1,5,238,0,245,"2017"
"43336","412217 RIO BRANCO DO IVAI",0,0,0,73,0,73,"2017"
"43337","412220 RIO BRANCO DO SUL",2,3,10,541,6,562,"2017"
"43338","412230 RIO NEGRO",1,3,4,396,2,406,"2017"
"43339","412240 ROLANDIA",3,5,12,946,1,967,"2017"
"43340","412250 RONCADOR",2,2,0,159,1,164,"2017"
"43341","412260 RONDON",0,1,0,134,0,135,"2017"
"43342","412265 ROSARIO DO IVAI",0,0,0,81,1,82,"2017"
"43343","412270 SABAUDIA",0,0,2,95,0,97,"2017"
"43344","412280 SALGADO FILHO",0,0,0,65,0,65,"2017"
"43345","412290 SALTO DO ITARARE",0,0,0,34,0,34,"2017"
"43346","412300 SALTO DO LONTRA",0,0,2,208,1,211,"2017"
"43347","412310 SANTA AMELIA",0,0,0,46,0,46,"2017"
"43348","412320 SANTA CECILIA DO PAVAO",0,0,0,63,0,63,"2017"
"43349","412330 SANTA CRUZ DE MONTE CASTELO",1,0,2,138,0,141,"2017"
"43350","412340 SANTA FE",0,1,1,114,0,116,"2017"
"43351","412350 SANTA HELENA",1,2,7,363,3,376,"2017"
"43352","412360 SANTA INES",0,0,0,20,0,20,"2017"
"43353","412370 SANTA ISABEL DO IVAI",1,0,1,96,0,98,"2017"
"43354","412380 SANTA IZABEL DO OESTE",1,0,0,158,1,160,"2017"
"43355","412382 SANTA LUCIA",0,0,0,45,0,45,"2017"
"43356","412385 SANTA MARIA DO OESTE",1,0,1,143,0,145,"2017"
"43357","412390 SANTA MARIANA",0,0,0,136,0,136,"2017"
"43358","412395 SANTA MONICA",0,1,2,53,0,56,"2017"
"43359","412400 SANTANA DO ITARARE",0,1,1,57,3,62,"2017"
"43360","412402 SANTA TEREZA DO OESTE",0,0,3,197,0,200,"2017"
"43361","412405 SANTA TEREZINHA DE ITAIPU",0,0,5,366,11,382,"2017"
"43362","412410 SANTO ANTONIO DA PLATINA",1,7,6,661,3,678,"2017"
"43363","412420 SANTO ANTONIO DO CAIUA",0,0,0,20,0,20,"2017"
"43364","412430 SANTO ANTONIO DO PARAISO",0,0,0,22,0,22,"2017"
"43365","412440 SANTO ANTONIO DO SUDOESTE",0,0,1,305,0,306,"2017"
"43366","412450 SANTO INACIO",1,0,3,103,1,108,"2017"
"43367","412460 SAO CARLOS DO IVAI",0,1,0,83,0,84,"2017"
"43368","412470 SAO JERONIMO DA SERRA",0,1,1,127,0,129,"2017"
"43369","412480 SAO JOAO",1,1,4,140,0,146,"2017"
"43370","412490 SAO JOAO DO CAIUA",0,2,0,81,0,83,"2017"
"43371","412500 SAO JOAO DO IVAI",3,0,6,136,0,145,"2017"
"43372","412510 SAO JOAO DO TRIUNFO",0,1,5,156,1,163,"2017"
"43373","412520 SAO JORGE D'OESTE",0,1,2,109,0,112,"2017"
"43374","412530 SAO JORGE DO IVAI",0,1,4,44,0,49,"2017"
"43375","412535 SAO JORGE DO PATROCINIO",0,0,0,88,0,88,"2017"
"43376","412540 SAO JOSE DA BOA VISTA",0,1,1,72,1,75,"2017"
"43377","412545 SAO JOSE DAS PALMEIRAS",0,1,1,72,0,74,"2017"
"43378","412550 SAO JOSE DOS PINHAIS",5,22,57,4569,16,4669,"2017"
"43379","412555 SAO MANOEL DO PARANA",0,0,0,24,0,24,"2017"
"43380","412560 SAO MATEUS DO SUL",1,2,7,635,3,648,"2017"
"43381","412570 SAO MIGUEL DO IGUACU",0,1,4,407,0,412,"2017"
"43382","412575 SAO PEDRO DO IGUACU",0,0,2,74,0,76,"2017"
"43383","412580 SAO PEDRO DO IVAI",1,0,2,97,0,100,"2017"
"43384","412590 SAO PEDRO DO PARANA",0,0,1,39,0,40,"2017"
"43385","412600 SAO SEBASTIAO DA AMOREIRA",0,0,3,110,0,113,"2017"
"43386","412610 SAO TOME",0,0,2,75,0,77,"2017"
"43387","412620 SAPOPEMA",0,0,0,97,0,97,"2017"
"43388","412625 SARANDI",4,7,18,1600,1,1630,"2017"
"43389","412627 SAUDADE DO IGUACU",1,0,4,95,0,100,"2017"
"43390","412630 SENGES",0,0,4,221,0,225,"2017"
"43391","412635 SERRANOPOLIS DO IGUACU",0,1,2,43,0,46,"2017"
"43392","412640 SERTANEJA",0,2,0,56,0,58,"2017"
"43393","412650 SERTANOPOLIS",0,0,0,185,0,185,"2017"
"43394","412660 SIQUEIRA CAMPOS",1,0,6,254,7,268,"2017"
"43395","412665 SULINA",0,0,0,38,0,38,"2017"
"43396","412667 TAMARANA",0,3,3,194,1,201,"2017"
"43397","412670 TAMBOARA",0,0,0,70,0,70,"2017"
"43398","412680 TAPEJARA",0,0,2,204,0,206,"2017"
"43399","412690 TAPIRA",1,1,1,57,0,60,"2017"
"43400","412700 TEIXEIRA SOARES",0,0,0,125,0,125,"2017"
"43401","412710 TELEMACO BORBA",2,3,13,1133,1,1152,"2017"
"43402","412720 TERRA BOA",0,0,2,229,0,231,"2017"
"43403","412730 TERRA RICA",1,1,5,191,1,199,"2017"
"43404","412740 TERRA ROXA",1,0,4,247,0,252,"2017"
"43405","412750 TIBAGI",0,1,5,296,1,303,"2017"
"43406","412760 TIJUCAS DO SUL",0,2,8,233,2,245,"2017"
"43407","412770 TOLEDO",3,11,39,2109,0,2162,"2017"
"43408","412780 TOMAZINA",0,0,2,84,0,86,"2017"
"43409","412785 TRES BARRAS DO PARANA",0,0,4,160,0,164,"2017"
"43410","412788 TUNAS DO PARANA",1,1,5,122,1,130,"2017"
"43411","412790 TUNEIRAS DO OESTE",0,0,1,115,0,116,"2017"
"43412","412795 TUPASSI",0,1,1,89,0,91,"2017"
"43413","412796 TURVO",1,2,4,219,0,226,"2017"
"43414","412800 UBIRATA",0,1,2,312,0,315,"2017"
"43415","412810 UMUARAMA",2,7,26,1532,0,1567,"2017"
"43416","412820 UNIAO DA VITORIA",0,2,2,838,0,842,"2017"
"43417","412830 UNIFLOR",0,0,1,26,0,27,"2017"
"43418","412840 URAI",0,2,0,96,0,98,"2017"
"43419","412850 WENCESLAU BRAZ",0,4,4,248,2,258,"2017"
"43420","412853 VENTANIA",0,0,5,153,0,158,"2017"
"43421","412855 VERA CRUZ DO OESTE",0,0,1,107,0,108,"2017"
"43422","412860 VERE",1,0,0,113,0,114,"2017"
"43423","412862 ALTO PARAISO",0,0,0,45,0,45,"2017"
"43424","412863 DOUTOR ULYSSES",0,1,1,68,0,70,"2017"
"43425","412865 VIRMOND",0,0,1,55,0,56,"2017"
"43426","412870 VITORINO",1,1,0,128,1,131,"2017"
"43427","412880 XAMBRE",1,0,1,71,0,73,"2017"
"43428","MUNICIPIO IGNORADO - SC",0,0,0,1,0,1,"2017"
"43429","420005 ABDON BATISTA",0,0,0,41,0,41,"2017"
"43430","420010 ABELARDO LUZ",0,2,4,271,0,277,"2017"
"43431","420020 AGROLANDIA",0,0,4,152,3,159,"2017"
"43432","420030 AGRONOMICA",0,0,1,67,0,68,"2017"
"43433","420040 AGUA DOCE",0,0,0,106,0,106,"2017"
"43434","420050 AGUAS DE CHAPECO",0,0,0,54,0,54,"2017"
"43435","420055 AGUAS FRIAS",0,0,0,28,0,28,"2017"
"43436","420060 AGUAS MORNAS",1,0,2,73,2,78,"2017"
"43437","420070 ALFREDO WAGNER",1,1,6,125,1,134,"2017"
"43438","420075 ALTO BELA VISTA",0,0,0,6,0,6,"2017"
"43439","420080 ANCHIETA",0,0,2,64,0,66,"2017"
"43440","420090 ANGELINA",0,0,2,52,0,54,"2017"
"43441","420100 ANITA GARIBALDI",1,0,2,80,0,83,"2017"
"43442","420110 ANITAPOLIS",0,0,1,31,0,32,"2017"
"43443","420120 ANTONIO CARLOS",0,1,2,122,0,125,"2017"
"43444","420125 APIUNA",0,0,1,142,2,145,"2017"
"43445","420127 ARABUTA",0,0,1,54,0,55,"2017"
"43446","420130 ARAQUARI",1,2,11,545,1,560,"2017"
"43447","420140 ARARANGUA",3,1,10,903,0,917,"2017"
"43448","420150 ARMAZEM",0,1,0,131,0,132,"2017"
"43449","420160 ARROIO TRINTA",0,0,0,43,0,43,"2017"
"43450","420165 ARVOREDO",0,0,0,32,0,32,"2017"
"43451","420170 ASCURRA",0,0,0,84,0,84,"2017"
"43452","420180 ATALANTA",1,0,1,49,0,51,"2017"
"43453","420190 AURORA",0,0,1,79,0,80,"2017"
"43454","420195 BALNEARIO ARROIO DO SILVA",0,0,1,161,0,162,"2017"
"43455","420200 BALNEARIO CAMBORIU",3,4,27,1656,5,1695,"2017"
"43456","420205 BALNEARIO BARRA DO SUL",0,2,2,141,1,146,"2017"
"43457","420207 BALNEARIO GAIVOTA",1,0,0,144,0,145,"2017"
"43458","420208 BANDEIRANTE",0,0,1,33,0,34,"2017"
"43459","420209 BARRA BONITA",0,0,0,24,0,24,"2017"
"43460","420210 BARRA VELHA",3,3,5,501,3,515,"2017"
"43461","420213 BELA VISTA DO TOLDO",0,0,1,68,0,69,"2017"
"43462","420215 BELMONTE",3,0,1,37,0,41,"2017"
"43463","420220 BENEDITO NOVO",0,0,1,101,0,102,"2017"
"43464","420230 BIGUACU",1,4,22,960,7,994,"2017"
"43465","420240 BLUMENAU",7,12,52,4439,0,4510,"2017"
"43466","420243 BOCAINA DO SUL",0,1,3,46,0,50,"2017"
"43467","420245 BOMBINHAS",0,0,6,286,0,292,"2017"
"43468","420250 BOM JARDIM DA SERRA",0,0,1,49,1,51,"2017"
"43469","420253 BOM JESUS",0,0,0,30,0,30,"2017"
"43470","420257 BOM JESUS DO OESTE",0,0,1,28,0,29,"2017"
"43471","420260 BOM RETIRO",0,3,9,141,3,156,"2017"
"43472","420270 BOTUVERA",0,0,1,53,0,54,"2017"
"43473","420280 BRACO DO NORTE",2,0,6,490,0,498,"2017"
"43474","420285 BRACO DO TROMBUDO",1,1,1,41,0,44,"2017"
"43475","420287 BRUNOPOLIS",0,0,1,27,0,28,"2017"
"43476","420290 BRUSQUE",5,4,23,1806,3,1841,"2017"
"43477","420300 CACADOR",3,5,17,1124,1,1150,"2017"
"43478","420310 CAIBI",0,0,3,66,0,69,"2017"
"43479","420315 CALMON",0,1,1,66,0,68,"2017"
"43480","420320 CAMBORIU",5,2,19,1385,7,1418,"2017"
"43481","420325 CAPAO ALTO",0,0,2,23,0,25,"2017"
"43482","420330 CAMPO ALEGRE",2,1,0,143,0,146,"2017"
"43483","420340 CAMPO BELO DO SUL",0,3,7,105,0,115,"2017"
"43484","420350 CAMPO ERE",3,0,3,134,0,140,"2017"
"43485","420360 CAMPOS NOVOS",1,1,4,502,2,510,"2017"
"43486","420370 CANELINHA",0,0,4,114,0,118,"2017"
"43487","420380 CANOINHAS",2,5,17,769,0,793,"2017"
"43488","420390 CAPINZAL",2,4,2,316,1,325,"2017"
"43489","420395 CAPIVARI DE BAIXO",1,1,2,323,0,327,"2017"
"43490","420400 CATANDUVAS",1,0,1,185,0,187,"2017"
"43491","420410 CAXAMBU DO SUL",0,1,0,56,0,57,"2017"
"43492","420415 CELSO RAMOS",0,0,0,31,0,31,"2017"
"43493","420417 CERRO NEGRO",0,0,0,36,0,36,"2017"
"43494","420419 CHAPADAO DO LAGEADO",0,0,2,41,0,43,"2017"
"43495","420420 CHAPECO",15,9,60,3428,4,3516,"2017"
"43496","420425 COCAL DO SUL",1,1,0,200,0,202,"2017"
"43497","420430 CONCORDIA",2,3,25,1099,1,1130,"2017"
"43498","420435 CORDILHEIRA ALTA",0,0,0,67,0,67,"2017"
"43499","420440 CORONEL FREITAS",0,0,3,106,0,109,"2017"
"43500","420445 CORONEL MARTINS",0,0,1,33,0,34,"2017"
"43501","420450 CORUPA",0,0,4,178,0,182,"2017"
"43502","420455 CORREIA PINTO",0,2,8,206,1,217,"2017"
"43503","420460 CRICIUMA",10,2,14,2841,4,2871,"2017"
"43504","420470 CUNHA PORA",0,3,0,128,0,131,"2017"
"43505","420475 CUNHATAI",0,0,0,17,0,17,"2017"
"43506","420480 CURITIBANOS",0,2,14,602,0,618,"2017"
"43507","420490 DESCANSO",2,1,1,97,0,101,"2017"
"43508","420500 DIONISIO CERQUEIRA",0,1,1,209,0,211,"2017"
"43509","420510 DONA EMMA",1,1,1,52,0,55,"2017"
"43510","420515 DOUTOR PEDRINHO",0,0,0,31,0,31,"2017"
"43511","420517 ENTRE RIOS",0,0,0,61,0,61,"2017"
"43512","420519 ERMO",0,0,0,41,0,41,"2017"
"43513","420520 ERVAL VELHO",0,0,0,68,0,68,"2017"
"43514","420530 FAXINAL DOS GUEDES",1,0,1,162,0,164,"2017"
"43515","420535 FLOR DO SERTAO",0,0,0,15,0,15,"2017"
"43516","420540 FLORIANOPOLIS",16,14,89,6216,20,6355,"2017"
"43517","420543 FORMOSA DO SUL",0,0,1,38,0,39,"2017"
"43518","420545 FORQUILHINHA",0,1,5,426,3,435,"2017"
"43519","420550 FRAIBURGO",0,2,6,508,0,516,"2017"
"43520","420555 FREI ROGERIO",0,0,0,23,0,23,"2017"
"43521","420560 GALVAO",0,1,0,50,0,51,"2017"
"43522","420570 GAROPABA",0,1,6,309,1,317,"2017"
"43523","420580 GARUVA",1,2,4,285,1,293,"2017"
"43524","420590 GASPAR",2,9,10,885,0,906,"2017"
"43525","420600 GOVERNADOR CELSO RAMOS",0,1,2,172,1,176,"2017"
"43526","420610 GRAO PARA",0,0,0,70,0,70,"2017"
"43527","420620 GRAVATAL",0,0,1,127,0,128,"2017"
"43528","420630 GUABIRUBA",0,0,4,298,0,302,"2017"
"43529","420640 GUARACIABA",0,0,0,123,0,123,"2017"
"43530","420650 GUARAMIRIM",3,1,9,633,0,646,"2017"
"43531","420660 GUARUJA DO SUL",0,0,1,56,0,57,"2017"
"43532","420665 GUATAMBU",0,0,1,117,0,118,"2017"
"43533","420670 HERVAL D'OESTE",0,1,1,318,0,320,"2017"
"43534","420675 IBIAM",0,0,1,23,0,24,"2017"
"43535","420680 IBICARE",0,0,0,28,0,28,"2017"
"43536","420690 IBIRAMA",0,1,5,237,0,243,"2017"
"43537","420700 ICARA",4,0,4,737,2,747,"2017"
"43538","420710 ILHOTA",0,1,1,166,0,168,"2017"
"43539","420720 IMARUI",0,0,3,108,0,111,"2017"
"43540","420730 IMBITUBA",1,1,12,640,3,657,"2017"
"43541","420740 IMBUIA",0,0,7,74,0,81,"2017"
"43542","420750 INDAIAL",1,2,14,948,2,967,"2017"
"43543","420757 IOMERE",0,0,0,47,0,47,"2017"
"43544","420760 IPIRA",0,0,1,47,1,49,"2017"
"43545","420765 IPORA DO OESTE",0,0,0,108,0,108,"2017"
"43546","420768 IPUACU",0,0,4,174,1,179,"2017"
"43547","420770 IPUMIRIM",1,1,0,110,0,112,"2017"
"43548","420775 IRACEMINHA",0,0,0,49,0,49,"2017"
"43549","420780 IRANI",0,0,1,116,0,117,"2017"
"43550","420785 IRATI",0,0,1,27,0,28,"2017"
"43551","420790 IRINEOPOLIS",0,0,1,144,0,145,"2017"
"43552","420800 ITA",0,0,3,48,0,51,"2017"
"43553","420810 ITAIOPOLIS",1,0,4,288,0,293,"2017"
"43554","420820 ITAJAI",12,13,69,3499,6,3599,"2017"
"43555","420830 ITAPEMA",2,1,20,849,0,872,"2017"
"43556","420840 ITAPIRANGA",0,0,5,205,0,210,"2017"
"43557","420845 ITAPOA",1,1,7,254,1,264,"2017"
"43558","420850 ITUPORANGA",1,0,8,370,0,379,"2017"
"43559","420860 JABORA",0,0,1,65,0,66,"2017"
"43560","420870 JACINTO MACHADO",0,1,1,125,0,127,"2017"
"43561","420880 JAGUARUNA",0,1,2,249,1,253,"2017"
"43562","420890 JARAGUA DO SUL",1,5,41,2372,2,2421,"2017"
"43563","420895 JARDINOPOLIS",0,0,0,26,0,26,"2017"
"43564","420900 JOACABA",1,1,1,339,0,342,"2017"
"43565","420910 JOINVILLE",19,37,140,7876,11,8083,"2017"
"43566","420915 JOSE BOITEUX",0,0,2,99,1,102,"2017"
"43567","420917 JUPIA",0,0,1,28,0,29,"2017"
"43568","420920 LACERDOPOLIS",0,0,0,25,0,25,"2017"
"43569","420930 LAGES",2,29,112,2340,8,2491,"2017"
"43570","420940 LAGUNA",1,0,4,468,0,473,"2017"
"43571","420945 LAJEADO GRANDE",0,0,1,25,0,26,"2017"
"43572","420950 LAURENTINO",0,0,2,99,0,101,"2017"
"43573","420960 LAURO MULLER",0,0,5,161,0,166,"2017"
"43574","420970 LEBON REGIS",0,0,2,143,1,146,"2017"
"43575","420980 LEOBERTO LEAL",0,0,3,36,0,39,"2017"
"43576","420985 LINDOIA DO SUL",0,0,3,55,0,58,"2017"
"43577","420990 LONTRAS",0,1,2,162,1,166,"2017"
"43578","421000 LUIZ ALVES",1,1,2,173,1,178,"2017"
"43579","421003 LUZERNA",0,0,0,61,0,61,"2017"
"43580","421005 MACIEIRA",0,0,0,21,0,21,"2017"
"43581","421010 MAFRA",2,3,7,830,1,843,"2017"
"43582","421020 MAJOR GERCINO",1,0,0,37,0,38,"2017"
"43583","421030 MAJOR VIEIRA",1,1,0,80,0,82,"2017"
"43584","421040 MARACAJA",0,1,0,89,0,90,"2017"
"43585","421050 MARAVILHA",0,0,5,355,0,360,"2017"
"43586","421055 MAREMA",0,0,0,17,0,17,"2017"
"43587","421060 MASSARANDUBA",0,1,2,207,0,210,"2017"
"43588","421070 MATOS COSTA",1,0,1,29,0,31,"2017"
"43589","421080 MELEIRO",0,0,1,81,0,82,"2017"
"43590","421085 MIRIM DOCE",0,0,0,22,0,22,"2017"
"43591","421090 MODELO",0,0,0,44,0,44,"2017"
"43592","421100 MONDAI",0,0,2,119,0,121,"2017"
"43593","421105 MONTE CARLO",0,1,1,148,0,150,"2017"
"43594","421110 MONTE CASTELO",2,1,1,128,0,132,"2017"
"43595","421120 MORRO DA FUMACA",0,0,2,265,1,268,"2017"
"43596","421125 MORRO GRANDE",0,2,1,46,0,49,"2017"
"43597","421130 NAVEGANTES",6,4,23,1334,3,1370,"2017"
"43598","421140 NOVA ERECHIM",0,0,1,58,0,59,"2017"
"43599","421145 NOVA ITABERABA",0,0,2,36,1,39,"2017"
"43600","421150 NOVA TRENTO",0,2,2,143,0,147,"2017"
"43601","421160 NOVA VENEZA",0,0,1,159,0,160,"2017"
"43602","421165 NOVO HORIZONTE",1,0,0,28,0,29,"2017"
"43603","421170 ORLEANS",0,1,12,297,0,310,"2017"
"43604","421175 OTACILIO COSTA",0,2,16,237,1,256,"2017"
"43605","421180 OURO",0,0,1,89,0,90,"2017"
"43606","421185 OURO VERDE",0,0,0,26,0,26,"2017"
"43607","421187 PAIAL",0,0,0,24,0,24,"2017"
"43608","421189 PAINEL",0,1,2,16,0,19,"2017"
"43609","421190 PALHOCA",3,7,50,2733,21,2814,"2017"
"43610","421200 PALMA SOLA",0,0,1,95,1,97,"2017"
"43611","421205 PALMEIRA",0,0,2,18,0,20,"2017"
"43612","421210 PALMITOS",0,0,0,189,0,189,"2017"
"43613","421220 PAPANDUVA",1,0,1,250,0,252,"2017"
"43614","421223 PARAISO",0,1,1,52,0,54,"2017"
"43615","421225 PASSO DE TORRES",0,1,1,102,1,105,"2017"
"43616","421227 PASSOS MAIA",0,0,1,75,0,76,"2017"
"43617","421230 PAULO LOPES",0,1,1,103,1,106,"2017"
"43618","421240 PEDRAS GRANDES",0,0,0,37,0,37,"2017"
"43619","421250 PENHA",1,4,8,413,1,427,"2017"
"43620","421260 PERITIBA",0,0,0,37,0,37,"2017"
"43621","421265 PESCARIA BRAVA",0,0,0,90,0,90,"2017"
"43622","421270 PETROLANDIA",0,0,2,81,0,83,"2017"
"43623","421280 BALNEARIO PICARRAS",2,4,3,370,1,380,"2017"
"43624","421290 PINHALZINHO",0,2,3,305,0,310,"2017"
"43625","421300 PINHEIRO PRETO",0,0,0,37,0,37,"2017"
"43626","421310 PIRATUBA",0,0,1,78,0,79,"2017"
"43627","421315 PLANALTO ALEGRE",0,0,0,30,0,30,"2017"
"43628","421320 POMERODE",0,3,5,401,0,409,"2017"
"43629","421330 PONTE ALTA",1,2,1,53,0,57,"2017"
"43630","421335 PONTE ALTA DO NORTE",0,0,2,60,0,62,"2017"
"43631","421340 PONTE SERRADA",0,0,4,168,0,172,"2017"
"43632","421350 PORTO BELO",0,1,3,261,4,269,"2017"
"43633","421360 PORTO UNIAO",0,0,4,385,0,389,"2017"
"43634","421370 POUSO REDONDO",0,0,6,226,1,233,"2017"
"43635","421380 PRAIA GRANDE",1,0,0,96,1,98,"2017"
"43636","421390 PRESIDENTE CASTELLO BRANCO",0,0,0,18,0,18,"2017"
"43637","421400 PRESIDENTE GETULIO",0,2,1,213,0,216,"2017"
"43638","421410 PRESIDENTE NEREU",1,0,1,21,0,23,"2017"
"43639","421415 PRINCESA",0,0,0,35,0,35,"2017"
"43640","421420 QUILOMBO",0,0,0,143,0,143,"2017"
"43641","421430 RANCHO QUEIMADO",0,0,1,31,1,33,"2017"
"43642","421440 RIO DAS ANTAS",1,0,1,72,1,75,"2017"
"43643","421450 RIO DO CAMPO",0,0,2,92,0,94,"2017"
"43644","421460 RIO DO OESTE",0,1,1,110,0,112,"2017"
"43645","421470 RIO DOS CEDROS",0,0,0,99,0,99,"2017"
"43646","421480 RIO DO SUL",3,3,16,883,0,905,"2017"
"43647","421490 RIO FORTUNA",0,0,0,77,0,77,"2017"
"43648","421500 RIO NEGRINHO",0,4,4,587,0,595,"2017"
"43649","421505 RIO RUFINO",0,1,2,25,1,29,"2017"
"43650","421507 RIQUEZA",0,0,1,55,0,56,"2017"
"43651","421510 RODEIO",1,0,1,131,0,133,"2017"
"43652","421520 ROMELANDIA",0,0,1,46,0,47,"2017"
"43653","421530 SALETE",1,1,1,80,0,83,"2017"
"43654","421535 SALTINHO",0,0,1,45,0,46,"2017"
"43655","421540 SALTO VELOSO",0,0,0,43,0,43,"2017"
"43656","421545 SANGAO",0,1,0,208,2,211,"2017"
"43657","421550 SANTA CECILIA",1,0,3,299,0,303,"2017"
"43658","421555 SANTA HELENA",0,0,0,27,1,28,"2017"
"43659","421560 SANTA ROSA DE LIMA",0,0,2,25,0,27,"2017"
"43660","421565 SANTA ROSA DO SUL",0,0,0,111,0,111,"2017"
"43661","421567 SANTA TEREZINHA",1,0,0,85,0,86,"2017"
"43662","421568 SANTA TEREZINHA DO PROGRESSO",0,0,0,41,0,41,"2017"
"43663","421569 SANTIAGO DO SUL",0,0,0,13,0,13,"2017"
"43664","421570 SANTO AMARO DA IMPERATRIZ",1,1,5,322,3,332,"2017"
"43665","421575 SAO BERNARDINO",0,0,1,25,0,26,"2017"
"43666","421580 SAO BENTO DO SUL",3,1,8,1074,1,1087,"2017"
"43667","421590 SAO BONIFACIO",0,0,0,26,0,26,"2017"
"43668","421600 SAO CARLOS",0,1,1,144,0,146,"2017"
"43669","421605 SAO CRISTOVAO DO SUL",0,0,1,75,0,76,"2017"
"43670","421610 SAO DOMINGOS",0,1,3,112,0,116,"2017"
"43671","421620 SAO FRANCISCO DO SUL",5,8,12,670,6,701,"2017"
"43672","421625 SAO JOAO DO OESTE",0,0,1,63,0,64,"2017"
"43673","421630 SAO JOAO BATISTA",0,2,8,453,0,463,"2017"
"43674","421635 SAO JOAO DO ITAPERIU",0,0,1,45,0,46,"2017"
"43675","421640 SAO JOAO DO SUL",0,0,0,105,0,105,"2017"
"43676","421650 SAO JOAQUIM",0,4,14,342,1,361,"2017"
"43677","421660 SAO JOSE",9,9,54,3285,10,3367,"2017"
"43678","421670 SAO JOSE DO CEDRO",0,0,1,172,0,173,"2017"
"43679","421680 SAO JOSE DO CERRITO",1,0,5,76,2,84,"2017"
"43680","421690 SAO LOURENCO DO OESTE",1,2,7,300,0,310,"2017"
"43681","421700 SAO LUDGERO",0,1,2,195,1,199,"2017"
"43682","421710 SAO MARTINHO",0,0,1,45,0,46,"2017"
"43683","421715 SAO MIGUEL DA BOA VISTA",0,0,2,22,0,24,"2017"
"43684","421720 SAO MIGUEL DO OESTE",2,2,1,568,0,573,"2017"
"43685","421725 SAO PEDRO DE ALCANTARA",0,0,0,38,0,38,"2017"
"43686","421730 SAUDADES",0,0,2,134,0,136,"2017"
"43687","421740 SCHROEDER",0,0,7,249,0,256,"2017"
"43688","421750 SEARA",0,0,1,246,1,248,"2017"
"43689","421755 SERRA ALTA",0,0,0,38,0,38,"2017"
"43690","421760 SIDEROPOLIS",1,0,4,132,0,137,"2017"
"43691","421770 SOMBRIO",1,1,7,409,3,421,"2017"
"43692","421775 SUL BRASIL",0,0,0,30,0,30,"2017"
"43693","421780 TAIO",3,2,6,234,0,245,"2017"
"43694","421790 TANGARA",0,0,3,81,0,84,"2017"
"43695","421795 TIGRINHOS",0,0,0,29,0,29,"2017"
"43696","421800 TIJUCAS",2,5,10,649,3,669,"2017"
"43697","421810 TIMBE DO SUL",0,0,1,69,0,70,"2017"
"43698","421820 TIMBO",1,1,2,501,0,505,"2017"
"43699","421825 TIMBO GRANDE",0,1,1,109,0,111,"2017"
"43700","421830 TRES BARRAS",0,0,3,282,0,285,"2017"
"43701","421835 TREVISO",0,0,0,36,0,36,"2017"
"43702","421840 TREZE DE MAIO",0,1,0,100,0,101,"2017"
"43703","421850 TREZE TILIAS",1,0,0,123,0,124,"2017"
"43704","421860 TROMBUDO CENTRAL",0,0,1,105,0,106,"2017"
"43705","421870 TUBARAO",1,2,13,1394,1,1411,"2017"
"43706","421875 TUNAPOLIS",0,0,0,50,0,50,"2017"
"43707","421880 TURVO",0,0,0,173,2,175,"2017"
"43708","421885 UNIAO DO OESTE",0,0,1,36,0,37,"2017"
"43709","421890 URUBICI",0,2,4,132,3,141,"2017"
"43710","421895 URUPEMA",0,1,0,28,2,31,"2017"
"43711","421900 URUSSANGA",1,1,2,201,1,206,"2017"
"43712","421910 VARGEAO",0,0,0,46,0,46,"2017"
"43713","421915 VARGEM",0,0,0,45,0,45,"2017"
"43714","421917 VARGEM BONITA",0,0,0,57,0,57,"2017"
"43715","421920 VIDAL RAMOS",0,0,1,84,0,85,"2017"
"43716","421930 VIDEIRA",1,4,8,731,1,745,"2017"
"43717","421935 VITOR MEIRELES",0,2,1,63,1,67,"2017"
"43718","421940 WITMARSUM",0,0,0,52,0,52,"2017"
"43719","421950 XANXERE",1,2,8,694,0,705,"2017"
"43720","421960 XAVANTINA",0,0,2,34,0,36,"2017"
"43721","421970 XAXIM",0,0,2,426,1,429,"2017"
"43722","421985 ZORTEA",0,0,0,43,0,43,"2017"
"43723","422000 BALNEARIO RINCAO",0,1,1,193,0,195,"2017"
"43724","430003 ACEGUA",0,0,1,51,0,52,"2017"
"43725","430005 AGUA SANTA",0,0,0,45,0,45,"2017"
"43726","430010 AGUDO",0,0,3,147,0,150,"2017"
"43727","430020 AJURICABA",0,0,0,60,0,60,"2017"
"43728","430030 ALECRIM",0,0,0,59,0,59,"2017"
"43729","430040 ALEGRETE",2,6,16,864,0,888,"2017"
"43730","430045 ALEGRIA",0,0,0,38,0,38,"2017"
"43731","430047 ALMIRANTE TAMANDARE DO SUL",0,0,0,25,0,25,"2017"
"43732","430050 ALPESTRE",2,0,0,68,0,70,"2017"
"43733","430055 ALTO ALEGRE",0,0,0,13,0,13,"2017"
"43734","430057 ALTO FELIZ",0,0,1,25,0,26,"2017"
"43735","430060 ALVORADA",6,15,78,3158,6,3263,"2017"
"43736","430063 AMARAL FERRADOR",0,0,1,47,0,48,"2017"
"43737","430064 AMETISTA DO SUL",0,0,4,73,0,77,"2017"
"43738","430066 ANDRE DA ROCHA",0,0,0,6,0,6,"2017"
"43739","430070 ANTA GORDA",0,0,2,54,0,56,"2017"
"43740","430080 ANTONIO PRADO",0,2,0,123,0,125,"2017"
"43741","430085 ARAMBARE",0,0,0,41,0,41,"2017"
"43742","430087 ARARICA",1,1,2,84,0,88,"2017"
"43743","430090 ARATIBA",0,0,0,51,0,51,"2017"
"43744","430100 ARROIO DO MEIO",0,1,5,228,0,234,"2017"
"43745","430105 ARROIO DO SAL",0,1,4,113,0,118,"2017"
"43746","430107 ARROIO DO PADRE",0,0,1,20,0,21,"2017"
"43747","430110 ARROIO DOS RATOS",0,1,2,166,0,169,"2017"
"43748","430120 ARROIO DO TIGRE",0,0,3,159,0,162,"2017"
"43749","430130 ARROIO GRANDE",0,1,11,208,0,220,"2017"
"43750","430140 ARVOREZINHA",0,0,3,111,0,114,"2017"
"43751","430150 AUGUSTO PESTANA",0,0,0,76,0,76,"2017"
"43752","430155 AUREA",0,0,0,23,0,23,"2017"
"43753","430160 BAGE",6,10,20,1591,17,1644,"2017"
"43754","430163 BALNEARIO PINHAL",1,2,3,146,1,153,"2017"
"43755","430165 BARAO",0,0,4,47,0,51,"2017"
"43756","430170 BARAO DE COTEGIPE",0,0,0,62,0,62,"2017"
"43757","430175 BARAO DO TRIUNFO",0,0,2,69,2,73,"2017"
"43758","430180 BARRACAO",0,0,0,46,0,46,"2017"
"43759","430185 BARRA DO GUARITA",0,0,0,52,0,52,"2017"
"43760","430187 BARRA DO QUARAI",0,0,0,9,44,53,"2017"
"43761","430190 BARRA DO RIBEIRO",0,0,4,148,11,163,"2017"
"43762","430192 BARRA DO RIO AZUL",0,0,0,13,0,13,"2017"
"43763","430195 BARRA FUNDA",0,0,1,35,0,36,"2017"
"43764","430200 BARROS CASSAL",0,0,2,102,0,104,"2017"
"43765","430205 BENJAMIN CONSTANT DO SUL",0,0,0,40,0,40,"2017"
"43766","430210 BENTO GONCALVES",1,10,32,1492,6,1541,"2017"
"43767","430215 BOA VISTA DAS MISSOES",0,0,0,20,0,20,"2017"
"43768","430220 BOA VISTA DO BURICA",0,0,2,85,0,87,"2017"
"43769","430222 BOA VISTA DO CADEADO",0,0,0,24,0,24,"2017"
"43770","430223 BOA VISTA DO INCRA",0,1,0,44,1,46,"2017"
"43771","430225 BOA VISTA DO SUL",0,0,0,14,0,14,"2017"
"43772","430230 BOM JESUS",0,0,2,158,5,165,"2017"
"43773","430235 BOM PRINCIPIO",0,2,5,162,0,169,"2017"
"43774","430237 BOM PROGRESSO",0,0,0,39,0,39,"2017"
"43775","430240 BOM RETIRO DO SUL",0,2,1,146,0,149,"2017"
"43776","430245 BOQUEIRAO DO LEAO",0,1,2,61,0,64,"2017"
"43777","430250 BOSSOROCA",0,0,1,53,0,54,"2017"
"43778","430258 BOZANO",0,1,1,20,0,22,"2017"
"43779","430260 BRAGA",0,0,1,45,0,46,"2017"
"43780","430265 BROCHIER",1,0,0,48,1,50,"2017"
"43781","430270 BUTIA",0,1,2,235,5,243,"2017"
"43782","430280 CACAPAVA DO SUL",2,0,5,355,4,366,"2017"
"43783","430290 CACEQUI",2,2,0,94,0,98,"2017"
"43784","430300 CACHOEIRA DO SUL",2,2,16,975,2,997,"2017"
"43785","430310 CACHOEIRINHA",0,10,31,1851,2,1894,"2017"
"43786","430320 CACIQUE DOBLE",0,0,0,47,0,47,"2017"
"43787","430330 CAIBATE",0,0,0,67,0,67,"2017"
"43788","430340 CAICARA",0,0,2,52,0,54,"2017"
"43789","430350 CAMAQUA",3,4,17,754,8,786,"2017"
"43790","430355 CAMARGO",0,0,0,35,0,35,"2017"
"43791","430360 CAMBARA DO SUL",0,0,2,43,0,45,"2017"
"43792","430367 CAMPESTRE DA SERRA",0,0,1,24,0,25,"2017"
"43793","430370 CAMPINA DAS MISSOES",0,0,3,46,0,49,"2017"
"43794","430380 CAMPINAS DO SUL",0,0,0,53,0,53,"2017"
"43795","430390 CAMPO BOM",2,2,12,886,2,904,"2017"
"43796","430400 CAMPO NOVO",0,0,1,84,0,85,"2017"
"43797","430410 CAMPOS BORGES",0,0,0,57,0,57,"2017"
"43798","430420 CANDELARIA",1,1,15,305,0,322,"2017"
"43799","430430 CANDIDO GODOI",0,0,3,59,0,62,"2017"
"43800","430435 CANDIOTA",0,0,1,134,2,137,"2017"
"43801","430440 CANELA",0,2,16,627,3,648,"2017"
"43802","430450 CANGUCU",2,5,10,568,0,585,"2017"
"43803","430460 CANOAS",6,14,67,4891,13,4991,"2017"
"43804","430461 CANUDOS DO VALE",0,0,0,11,0,11,"2017"
"43805","430462 CAPAO BONITO DO SUL",0,0,0,18,0,18,"2017"
"43806","430463 CAPAO DA CANOA",1,5,12,877,0,895,"2017"
"43807","430465 CAPAO DO CIPO",0,0,0,28,0,28,"2017"
"43808","430466 CAPAO DO LEAO",3,2,13,361,1,380,"2017"
"43809","430467 CAPIVARI DO SUL",0,0,0,52,0,52,"2017"
"43810","430468 CAPELA DE SANTANA",1,0,1,125,0,127,"2017"
"43811","430469 CAPITAO",0,0,1,27,0,28,"2017"
"43812","430470 CARAZINHO",3,4,9,788,3,807,"2017"
"43813","430471 CARAA",0,0,0,53,1,54,"2017"
"43814","430480 CARLOS BARBOSA",0,3,5,293,0,301,"2017"
"43815","430485 CARLOS GOMES",0,0,0,14,0,14,"2017"
"43816","430490 CASCA",1,0,1,115,0,117,"2017"
"43817","430495 CASEIROS",0,0,0,37,0,37,"2017"
"43818","430500 CATUIPE",0,0,2,82,0,84,"2017"
"43819","430510 CAXIAS DO SUL",7,20,110,5687,15,5839,"2017"
"43820","430511 CENTENARIO",0,0,0,24,0,24,"2017"
"43821","430512 CERRITO",0,0,1,49,0,50,"2017"
"43822","430513 CERRO BRANCO",0,0,0,42,1,43,"2017"
"43823","430515 CERRO GRANDE",0,0,0,33,0,33,"2017"
"43824","430517 CERRO GRANDE DO SUL",0,0,1,126,0,127,"2017"
"43825","430520 CERRO LARGO",1,0,2,147,0,150,"2017"
"43826","430530 CHAPADA",0,0,1,67,0,68,"2017"
"43827","430535 CHARQUEADAS",0,1,2,363,1,367,"2017"
"43828","430537 CHARRUA",0,0,0,29,0,29,"2017"
"43829","430540 CHIAPETTA",0,0,0,59,0,59,"2017"
"43830","430543 CHUI",0,0,1,41,0,42,"2017"
"43831","430544 CHUVISCA",0,1,0,48,0,49,"2017"
"43832","430545 CIDREIRA",0,1,8,192,0,201,"2017"
"43833","430550 CIRIACO",0,1,0,44,0,45,"2017"
"43834","430558 COLINAS",0,0,0,30,0,30,"2017"
"43835","430560 COLORADO",0,0,0,31,0,31,"2017"
"43836","430570 CONDOR",0,2,0,79,1,82,"2017"
"43837","430580 CONSTANTINA",0,2,2,121,0,125,"2017"
"43838","430583 COQUEIRO BAIXO",0,1,0,6,0,7,"2017"
"43839","430585 COQUEIROS DO SUL",0,0,0,27,0,27,"2017"
"43840","430587 CORONEL BARROS",0,0,1,36,0,37,"2017"
"43841","430590 CORONEL BICACO",0,0,0,88,2,90,"2017"
"43842","430593 CORONEL PILAR",0,0,0,12,0,12,"2017"
"43843","430595 COTIPORA",0,0,1,27,0,28,"2017"
"43844","430597 COXILHA",0,0,2,42,1,45,"2017"
"43845","430600 CRISSIUMAL",0,0,2,130,1,133,"2017"
"43846","430605 CRISTAL",0,0,0,82,0,82,"2017"
"43847","430607 CRISTAL DO SUL",0,0,1,29,0,30,"2017"
"43848","430610 CRUZ ALTA",2,2,14,844,0,862,"2017"
"43849","430613 CRUZALTENSE",0,0,0,11,0,11,"2017"
"43850","430620 CRUZEIRO DO SUL",1,0,2,103,0,106,"2017"
"43851","430630 DAVID CANABARRO",0,0,0,37,0,37,"2017"
"43852","430632 DERRUBADAS",0,0,0,37,0,37,"2017"
"43853","430635 DEZESSEIS DE NOVEMBRO",0,0,2,25,0,27,"2017"
"43854","430637 DILERMANDO DE AGUIAR",0,0,1,23,0,24,"2017"
"43855","430640 DOIS IRMAOS",1,3,7,385,0,396,"2017"
"43856","430642 DOIS IRMAOS DAS MISSOES",0,0,0,34,0,34,"2017"
"43857","430645 DOIS LAJEADOS",0,0,0,23,0,23,"2017"
"43858","430650 DOM FELICIANO",0,0,3,147,0,150,"2017"
"43859","430655 DOM PEDRO DE ALCANTARA",0,0,0,21,0,21,"2017"
"43860","430660 DOM PEDRITO",0,0,0,413,2,415,"2017"
"43861","430670 DONA FRANCISCA",0,0,0,25,0,25,"2017"
"43862","430673 DOUTOR MAURICIO CARDOSO",0,0,0,49,0,49,"2017"
"43863","430675 DOUTOR RICARDO",0,0,0,20,0,20,"2017"
"43864","430676 ELDORADO DO SUL",2,2,8,555,4,571,"2017"
"43865","430680 ENCANTADO",0,2,2,288,0,292,"2017"
"43866","430690 ENCRUZILHADA DO SUL",0,3,1,278,0,282,"2017"
"43867","430692 ENGENHO VELHO",0,0,0,22,0,22,"2017"
"43868","430693 ENTRE-IJUIS",0,0,1,96,0,97,"2017"
"43869","430695 ENTRE RIOS DO SUL",0,0,1,32,0,33,"2017"
"43870","430697 EREBANGO",1,0,0,45,0,46,"2017"
"43871","430700 ERECHIM",2,4,14,1317,3,1340,"2017"
"43872","430705 ERNESTINA",0,0,0,33,0,33,"2017"
"43873","430710 HERVAL",0,0,0,70,0,70,"2017"
"43874","430720 ERVAL GRANDE",0,0,2,60,0,62,"2017"
"43875","430730 ERVAL SECO",0,0,1,80,0,81,"2017"
"43876","430740 ESMERALDA",0,0,0,31,0,31,"2017"
"43877","430745 ESPERANCA DO SUL",0,0,1,35,0,36,"2017"
"43878","430750 ESPUMOSO",0,1,1,195,0,197,"2017"
"43879","430755 ESTACAO",0,2,1,69,0,72,"2017"
"43880","430760 ESTANCIA VELHA",3,1,12,639,0,655,"2017"
"43881","430770 ESTEIO",3,3,15,1085,0,1106,"2017"
"43882","430780 ESTRELA",0,2,9,439,0,450,"2017"
"43883","430781 ESTRELA VELHA",0,0,0,36,0,36,"2017"
"43884","430783 EUGENIO DE CASTRO",0,0,0,28,0,28,"2017"
"43885","430786 FAGUNDES VARELA",0,0,0,29,0,29,"2017"
"43886","430790 FARROUPILHA",0,2,16,855,1,874,"2017"
"43887","430800 FAXINAL DO SOTURNO",0,1,1,54,0,56,"2017"
"43888","430805 FAXINALZINHO",1,0,1,24,0,26,"2017"
"43889","430807 FAZENDA VILANOVA",0,0,0,53,0,53,"2017"
"43890","430810 FELIZ",0,1,3,146,0,150,"2017"
"43891","430820 FLORES DA CUNHA",0,2,5,371,1,379,"2017"
"43892","430825 FLORIANO PEIXOTO",0,0,0,17,0,17,"2017"
"43893","430830 FONTOURA XAVIER",0,0,2,86,1,89,"2017"
"43894","430840 FORMIGUEIRO",0,0,1,68,0,69,"2017"
"43895","430843 FORQUETINHA",0,0,0,18,0,18,"2017"
"43896","430845 FORTALEZA DOS VALOS",0,0,0,47,0,47,"2017"
"43897","430850 FREDERICO WESTPHALEN",0,1,8,389,0,398,"2017"
"43898","430860 GARIBALDI",0,2,7,391,0,400,"2017"
"43899","430865 GARRUCHOS",0,0,0,24,0,24,"2017"
"43900","430870 GAURAMA",0,0,1,49,0,50,"2017"
"43901","430880 GENERAL CAMARA",0,0,0,90,0,90,"2017"
"43902","430885 GENTIL",0,0,0,26,0,26,"2017"
"43903","430890 GETULIO VARGAS",2,0,4,188,0,194,"2017"
"43904","430900 GIRUA",0,1,7,179,3,190,"2017"
"43905","430905 GLORINHA",0,1,0,101,1,103,"2017"
"43906","430910 GRAMADO",3,3,13,589,0,608,"2017"
"43907","430912 GRAMADO DOS LOUREIROS",0,0,0,22,0,22,"2017"
"43908","430915 GRAMADO XAVIER",1,0,2,38,0,41,"2017"
"43909","430920 GRAVATAI",6,16,66,3493,1,3582,"2017"
"43910","430925 GUABIJU",0,0,0,17,0,17,"2017"
"43911","430930 GUAIBA",2,4,26,1287,13,1332,"2017"
"43912","430940 GUAPORE",0,1,6,312,1,320,"2017"
"43913","430950 GUARANI DAS MISSOES",0,0,0,78,0,78,"2017"
"43914","430955 HARMONIA",0,0,1,44,0,45,"2017"
"43915","430957 HERVEIRAS",0,1,0,29,0,30,"2017"
"43916","430960 HORIZONTINA",2,0,1,264,0,267,"2017"
"43917","430965 HULHA NEGRA",0,3,1,88,0,92,"2017"
"43918","430970 HUMAITA",0,0,0,51,0,51,"2017"
"43919","430975 IBARAMA",0,1,0,35,0,36,"2017"
"43920","430980 IBIACA",0,0,0,34,0,34,"2017"
"43921","430990 IBIRAIARAS",0,0,0,76,0,76,"2017"
"43922","430995 IBIRAPUITA",0,0,2,35,1,38,"2017"
"43923","431000 IBIRUBA",0,0,0,277,0,277,"2017"
"43924","431010 IGREJINHA",2,6,9,500,1,518,"2017"
"43925","431020 IJUI",0,9,14,1137,0,1160,"2017"
"43926","431030 ILOPOLIS",0,0,0,54,0,54,"2017"
"43927","431033 IMBE",1,1,4,287,3,296,"2017"
"43928","431036 IMIGRANTE",0,0,1,21,0,22,"2017"
"43929","431040 INDEPENDENCIA",0,0,1,78,0,79,"2017"
"43930","431041 INHACORA",0,0,0,22,0,22,"2017"
"43931","431043 IPE",0,0,1,51,0,52,"2017"
"43932","431046 IPIRANGA DO SUL",0,1,1,10,0,12,"2017"
"43933","431050 IRAI",0,0,2,90,0,92,"2017"
"43934","431053 ITAARA",0,0,1,56,0,57,"2017"
"43935","431055 ITACURUBI",0,0,0,24,0,24,"2017"
"43936","431057 ITAPUCA",0,0,1,20,0,21,"2017"
"43937","431060 ITAQUI",0,1,10,538,2,551,"2017"
"43938","431065 ITATI",0,0,0,23,0,23,"2017"
"43939","431070 ITATIBA DO SUL",0,0,1,26,0,27,"2017"
"43940","431075 IVORA",0,0,0,12,0,12,"2017"
"43941","431080 IVOTI",0,1,7,263,0,271,"2017"
"43942","431085 JABOTICABA",0,0,0,33,0,33,"2017"
"43943","431087 JACUIZINHO",0,0,0,18,0,18,"2017"
"43944","431090 JACUTINGA",0,0,1,28,0,29,"2017"
"43945","431100 JAGUARAO",2,1,5,315,2,325,"2017"
"43946","431110 JAGUARI",1,0,0,84,0,85,"2017"
"43947","431112 JAQUIRANA",0,0,2,39,1,42,"2017"
"43948","431113 JARI",0,1,0,34,0,35,"2017"
"43949","431115 JOIA",0,0,2,70,0,72,"2017"
"43950","431120 JULIO DE CASTILHOS",0,1,5,234,1,241,"2017"
"43951","431123 LAGOA BONITA DO SUL",0,0,0,27,0,27,"2017"
"43952","431125 LAGOAO",0,1,2,63,0,66,"2017"
"43953","431127 LAGOA DOS TRES CANTOS",0,0,0,12,0,12,"2017"
"43954","431130 LAGOA VERMELHA",0,0,2,392,0,394,"2017"
"43955","431140 LAJEADO",0,4,15,1227,0,1246,"2017"
"43956","431142 LAJEADO DO BUGRE",1,0,1,26,0,28,"2017"
"43957","431150 LAVRAS DO SUL",0,0,1,71,0,72,"2017"
"43958","431160 LIBERATO SALZANO",3,0,0,72,0,75,"2017"
"43959","431162 LINDOLFO COLLOR",0,0,1,74,0,75,"2017"
"43960","431164 LINHA NOVA",0,0,0,7,0,7,"2017"
"43961","431170 MACHADINHO",0,1,0,77,0,78,"2017"
"43962","431171 MACAMBARA",0,0,0,47,0,47,"2017"
"43963","431173 MAMPITUBA",0,0,0,33,0,33,"2017"
"43964","431175 MANOEL VIANA",0,1,1,70,0,72,"2017"
"43965","431177 MAQUINE",0,1,1,68,4,74,"2017"
"43966","431179 MARATA",0,0,0,20,0,20,"2017"
"43967","431180 MARAU",0,1,1,530,0,532,"2017"
"43968","431190 MARCELINO RAMOS",0,1,1,39,0,41,"2017"
"43969","431198 MARIANA PIMENTEL",0,0,2,29,3,34,"2017"
"43970","431200 MARIANO MORO",0,0,1,7,0,8,"2017"
"43971","431205 MARQUES DE SOUZA",0,0,0,28,0,28,"2017"
"43972","431210 MATA",0,0,1,43,0,44,"2017"
"43973","431213 MATO CASTELHANO",0,0,0,25,0,25,"2017"
"43974","431215 MATO LEITAO",0,0,2,47,0,49,"2017"
"43975","431217 MATO QUEIMADO",0,0,1,14,0,15,"2017"
"43976","431220 MAXIMILIANO DE ALMEIDA",0,1,1,46,0,48,"2017"
"43977","431225 MINAS DO LEAO",0,0,0,93,2,95,"2017"
"43978","431230 MIRAGUAI",0,0,0,57,1,58,"2017"
"43979","431235 MONTAURI",0,0,2,15,0,17,"2017"
"43980","431237 MONTE ALEGRE DOS CAMPOS",0,0,0,38,1,39,"2017"
"43981","431238 MONTE BELO DO SUL",0,0,0,13,0,13,"2017"
"43982","431240 MONTENEGRO",1,3,7,961,3,975,"2017"
"43983","431242 MORMACO",0,1,1,31,1,34,"2017"
"43984","431244 MORRINHOS DO SUL",0,0,0,33,0,33,"2017"
"43985","431245 MORRO REDONDO",0,0,0,58,0,58,"2017"
"43986","431247 MORRO REUTER",0,0,0,59,0,59,"2017"
"43987","431250 MOSTARDAS",0,1,2,136,0,139,"2017"
"43988","431260 MUCUM",0,0,1,56,0,57,"2017"
"43989","431261 MUITOS CAPOES",0,0,0,42,0,42,"2017"
"43990","431262 MULITERNO",0,0,1,31,0,32,"2017"
"43991","431265 NAO-ME-TOQUE",0,2,2,246,0,250,"2017"
"43992","431267 NICOLAU VERGUEIRO",0,0,0,19,0,19,"2017"
"43993","431270 NONOAI",0,1,4,185,0,190,"2017"
"43994","431275 NOVA ALVORADA",0,1,0,31,0,32,"2017"
"43995","431280 NOVA ARACA",0,0,1,61,0,62,"2017"
"43996","431290 NOVA BASSANO",1,1,0,86,0,88,"2017"
"43997","431295 NOVA BOA VISTA",0,0,2,18,0,20,"2017"
"43998","431300 NOVA BRESCIA",0,0,0,29,0,29,"2017"
"43999","431301 NOVA CANDELARIA",0,0,0,33,0,33,"2017"
"44000","431303 NOVA ESPERANCA DO SUL",0,0,0,52,0,52,"2017"
"44001","431306 NOVA HARTZ",0,1,0,256,0,257,"2017"
"44002","431308 NOVA PADUA",0,0,0,17,0,17,"2017"
"44003","431310 NOVA PALMA",0,1,1,65,0,67,"2017"
"44004","431320 NOVA PETROPOLIS",0,1,7,259,0,267,"2017"
"44005","431330 NOVA PRATA",1,1,2,310,0,314,"2017"
"44006","431333 NOVA RAMADA",0,0,0,27,0,27,"2017"
"44007","431335 NOVA ROMA DO SUL",0,0,1,26,0,27,"2017"
"44008","431337 NOVA SANTA RITA",2,2,5,378,0,387,"2017"
"44009","431339 NOVO CABRAIS",0,0,0,38,0,38,"2017"
"44010","431340 NOVO HAMBURGO",8,15,58,3128,4,3213,"2017"
"44011","431342 NOVO MACHADO",0,0,0,26,0,26,"2017"
"44012","431344 NOVO TIRADENTES",0,0,1,24,1,26,"2017"
"44013","431346 NOVO XINGU",0,0,0,17,0,17,"2017"
"44014","431349 NOVO BARREIRO",0,1,0,51,0,52,"2017"
"44015","431350 OSORIO",2,0,9,606,1,618,"2017"
"44016","431360 PAIM FILHO",0,0,0,29,0,29,"2017"
"44017","431365 PALMARES DO SUL",0,0,1,145,1,147,"2017"
"44018","431370 PALMEIRA DAS MISSOES",8,1,5,512,0,526,"2017"
"44019","431380 PALMITINHO",0,2,4,87,0,93,"2017"
"44020","431390 PANAMBI",0,2,7,635,5,649,"2017"
"44021","431395 PANTANO GRANDE",0,1,1,124,0,126,"2017"
"44022","431400 PARAI",0,0,0,77,0,77,"2017"
"44023","431402 PARAISO DO SUL",0,0,0,57,1,58,"2017"
"44024","431403 PARECI NOVO",0,0,0,46,0,46,"2017"
"44025","431405 PAROBE",3,5,15,716,1,740,"2017"
"44026","431406 PASSA SETE",0,0,0,45,0,45,"2017"
"44027","431407 PASSO DO SOBRADO",0,0,0,51,0,51,"2017"
"44028","431410 PASSO FUNDO",4,14,50,2806,9,2883,"2017"
"44029","431413 PAULO BENTO",2,0,1,19,0,22,"2017"
"44030","431415 PAVERAMA",0,0,0,65,0,65,"2017"
"44031","431417 PEDRAS ALTAS",0,0,0,19,0,19,"2017"
"44032","431420 PEDRO OSORIO",0,1,1,86,1,89,"2017"
"44033","431430 PEJUCARA",0,0,0,34,0,34,"2017"
"44034","431440 PELOTAS",10,28,102,4152,16,4308,"2017"
"44035","431442 PICADA CAFE",0,0,2,52,0,54,"2017"
"44036","431445 PINHAL",0,1,0,38,0,39,"2017"
"44037","431446 PINHAL DA SERRA",0,0,0,17,0,17,"2017"
"44038","431447 PINHAL GRANDE",0,0,1,46,0,47,"2017"
"44039","431449 PINHEIRINHO DO VALE",0,1,1,50,0,52,"2017"
"44040","431450 PINHEIRO MACHADO",0,2,3,118,0,123,"2017"
"44041","431454 PINTO BANDEIRA",0,0,1,28,0,29,"2017"
"44042","431455 PIRAPO",0,0,0,16,0,16,"2017"
"44043","431460 PIRATINI",1,0,4,196,1,202,"2017"
"44044","431470 PLANALTO",0,0,0,147,1,148,"2017"
"44045","431475 POCO DAS ANTAS",0,0,0,14,0,14,"2017"
"44046","431477 PONTAO",0,1,1,38,0,40,"2017"
"44047","431478 PONTE PRETA",0,0,0,21,0,21,"2017"
"44048","431480 PORTAO",0,2,9,381,1,393,"2017"
"44049","431490 PORTO ALEGRE",30,81,361,17953,65,18490,"2017"
"44050","431500 PORTO LUCENA",0,0,1,36,0,37,"2017"
"44051","431505 PORTO MAUA",0,0,1,8,0,9,"2017"
"44052","431507 PORTO VERA CRUZ",0,0,2,11,0,13,"2017"
"44053","431510 PORTO XAVIER",0,0,2,112,0,114,"2017"
"44054","431513 POUSO NOVO",0,1,0,19,1,21,"2017"
"44055","431514 PRESIDENTE LUCENA",0,0,0,38,0,38,"2017"
"44056","431515 PROGRESSO",0,1,1,46,0,48,"2017"
"44057","431517 PROTASIO ALVES",0,0,0,24,0,24,"2017"
"44058","431520 PUTINGA",0,0,0,37,0,37,"2017"
"44059","431530 QUARAI",3,1,4,314,2,324,"2017"
"44060","431531 QUATRO IRMAOS",0,0,1,15,0,16,"2017"
"44061","431532 QUEVEDOS",0,0,1,21,0,22,"2017"
"44062","431535 QUINZE DE NOVEMBRO",0,0,5,36,0,41,"2017"
"44063","431540 REDENTORA",0,1,2,177,4,184,"2017"
"44064","431545 RELVADO",0,0,0,13,0,13,"2017"
"44065","431550 RESTINGA SECA",0,2,5,151,1,159,"2017"
"44066","431555 RIO DOS INDIOS",0,0,0,31,0,31,"2017"
"44067","431560 RIO GRANDE",5,24,56,2672,11,2768,"2017"
"44068","431570 RIO PARDO",0,4,5,392,1,402,"2017"
"44069","431575 RIOZINHO",0,0,0,45,0,45,"2017"
"44070","431580 ROCA SALES",1,0,2,95,0,98,"2017"
"44071","431590 RODEIO BONITO",0,0,1,97,0,98,"2017"
"44072","431595 ROLADOR",0,0,0,15,0,15,"2017"
"44073","431600 ROLANTE",2,1,4,247,2,256,"2017"
"44074","431610 RONDA ALTA",2,0,1,108,0,111,"2017"
"44075","431620 RONDINHA",0,0,0,40,0,40,"2017"
"44076","431630 ROQUE GONZALES",0,0,1,78,0,79,"2017"
"44077","431640 ROSARIO DO SUL",1,2,5,451,3,462,"2017"
"44078","431642 SAGRADA FAMILIA",0,0,0,24,0,24,"2017"
"44079","431643 SALDANHA MARINHO",0,0,0,24,0,24,"2017"
"44080","431645 SALTO DO JACUI",0,0,2,102,0,104,"2017"
"44081","431647 SALVADOR DAS MISSOES",0,0,0,28,0,28,"2017"
"44082","431650 SALVADOR DO SUL",0,1,1,83,0,85,"2017"
"44083","431660 SANANDUVA",0,4,6,197,0,207,"2017"
"44084","431670 SANTA BARBARA DO SUL",0,0,1,94,0,95,"2017"
"44085","431673 SANTA CECILIA DO SUL",0,0,0,28,0,28,"2017"
"44086","431675 SANTA CLARA DO SUL",0,0,0,77,0,77,"2017"
"44087","431680 SANTA CRUZ DO SUL",2,11,24,1583,0,1620,"2017"
"44088","431690 SANTA MARIA",10,13,58,3421,7,3509,"2017"
"44089","431695 SANTA MARIA DO HERVAL",1,1,0,56,0,58,"2017"
"44090","431697 SANTA MARGARIDA DO SUL",0,0,0,17,0,17,"2017"
"44091","431700 SANTANA DA BOA VISTA",0,1,3,58,2,64,"2017"
"44092","431710 SANT'ANA DO LIVRAMENTO",1,2,7,1087,2,1099,"2017"
"44093","431720 SANTA ROSA",3,3,34,988,0,1028,"2017"
"44094","431725 SANTA TEREZA",0,0,1,9,0,10,"2017"
"44095","431730 SANTA VITORIA DO PALMAR",0,4,8,389,0,401,"2017"
"44096","431740 SANTIAGO",2,2,4,563,1,572,"2017"
"44097","431750 SANTO ANGELO",1,3,9,1047,2,1062,"2017"
"44098","431755 SANTO ANTONIO DO PALMA",0,0,0,21,0,21,"2017"
"44099","431760 SANTO ANTONIO DA PATRULHA",1,5,12,431,1,450,"2017"
"44100","431770 SANTO ANTONIO DAS MISSOES",0,0,1,108,0,109,"2017"
"44101","431775 SANTO ANTONIO DO PLANALTO",0,0,0,17,0,17,"2017"
"44102","431780 SANTO AUGUSTO",0,0,0,182,1,183,"2017"
"44103","431790 SANTO CRISTO",0,0,6,144,1,151,"2017"
"44104","431795 SANTO EXPEDITO DO SUL",0,0,0,29,0,29,"2017"
"44105","431800 SAO BORJA",2,4,4,813,0,823,"2017"
"44106","431805 SAO DOMINGOS DO SUL",0,1,2,25,0,28,"2017"
"44107","431810 SAO FRANCISCO DE ASSIS",0,1,3,173,1,178,"2017"
"44108","431820 SAO FRANCISCO DE PAULA",1,1,3,268,2,275,"2017"
"44109","431830 SAO GABRIEL",2,6,8,783,3,802,"2017"
"44110","431840 SAO JERONIMO",1,1,2,286,0,290,"2017"
"44111","431842 SAO JOAO DA URTIGA",0,0,2,35,0,37,"2017"
"44112","431843 SAO JOAO DO POLESINE",0,0,1,28,0,29,"2017"
"44113","431844 SAO JORGE",0,1,0,21,0,22,"2017"
"44114","431845 SAO JOSE DAS MISSOES",0,0,0,26,0,26,"2017"
"44115","431846 SAO JOSE DO HERVAL",0,0,1,20,0,21,"2017"
"44116","431848 SAO JOSE DO HORTENCIO",0,0,0,42,0,42,"2017"
"44117","431849 SAO JOSE DO INHACORA",1,0,1,31,0,33,"2017"
"44118","431850 SAO JOSE DO NORTE",0,0,18,273,2,293,"2017"
"44119","431860 SAO JOSE DO OURO",0,0,0,83,0,83,"2017"
"44120","431861 SAO JOSE DO SUL",0,0,0,22,0,22,"2017"
"44121","431862 SAO JOSE DOS AUSENTES",0,0,0,52,2,54,"2017"
"44122","431870 SAO LEOPOLDO",12,12,44,2899,14,2981,"2017"
"44123","431880 SAO LOURENCO DO SUL",0,5,8,425,0,438,"2017"
"44124","431890 SAO LUIZ GONZAGA",0,1,2,432,1,436,"2017"
"44125","431900 SAO MARCOS",0,0,3,212,0,215,"2017"
"44126","431910 SAO MARTINHO",0,0,0,54,0,54,"2017"
"44127","431912 SAO MARTINHO DA SERRA",0,1,1,30,0,32,"2017"
"44128","431915 SAO MIGUEL DAS MISSOES",0,0,0,90,0,90,"2017"
"44129","431920 SAO NICOLAU",0,0,0,59,0,59,"2017"
"44130","431930 SAO PAULO DAS MISSOES",0,0,3,42,0,45,"2017"
"44131","431935 SAO PEDRO DA SERRA",0,0,1,41,0,42,"2017"
"44132","431936 SAO PEDRO DAS MISSOES",0,0,0,25,0,25,"2017"
"44133","431937 SAO PEDRO DO BUTIA",0,0,0,31,0,31,"2017"
"44134","431940 SAO PEDRO DO SUL",1,0,5,147,0,153,"2017"
"44135","431950 SAO SEBASTIAO DO CAI",1,2,3,296,1,303,"2017"
"44136","431960 SAO SEPE",0,1,9,248,1,259,"2017"
"44137","431970 SAO VALENTIM",0,0,1,30,0,31,"2017"
"44138","431971 SAO VALENTIM DO SUL",0,0,0,9,0,9,"2017"
"44139","431973 SAO VALERIO DO SUL",0,0,0,37,0,37,"2017"
"44140","431975 SAO VENDELINO",0,0,1,20,0,21,"2017"
"44141","431980 SAO VICENTE DO SUL",0,0,1,91,0,92,"2017"
"44142","431990 SAPIRANGA",1,3,17,1171,6,1198,"2017"
"44143","432000 SAPUCAIA DO SUL",6,13,50,1782,4,1855,"2017"
"44144","432010 SARANDI",2,1,1,316,0,320,"2017"
"44145","432020 SEBERI",0,0,1,172,1,174,"2017"
"44146","432023 SEDE NOVA",0,0,0,32,0,32,"2017"
"44147","432026 SEGREDO",0,0,0,64,0,64,"2017"
"44148","432030 SELBACH",0,1,0,50,0,51,"2017"
"44149","432032 SENADOR SALGADO FILHO",0,1,1,31,0,33,"2017"
"44150","432035 SENTINELA DO SUL",0,0,2,49,1,52,"2017"
"44151","432040 SERAFINA CORREA",0,0,5,197,0,202,"2017"
"44152","432045 SERIO",0,0,1,23,0,24,"2017"
"44153","432050 SERTAO",0,0,2,58,0,60,"2017"
"44154","432055 SERTAO SANTANA",0,0,0,75,1,76,"2017"
"44155","432057 SETE DE SETEMBRO",0,0,0,17,0,17,"2017"
"44156","432060 SEVERIANO DE ALMEIDA",0,0,0,26,0,26,"2017"
"44157","432065 SILVEIRA MARTINS",0,0,0,22,0,22,"2017"
"44158","432067 SINIMBU",0,0,1,69,2,72,"2017"
"44159","432070 SOBRADINHO",1,1,1,185,1,189,"2017"
"44160","432080 SOLEDADE",1,0,1,373,0,375,"2017"
"44161","432085 TABAI",1,0,0,76,0,77,"2017"
"44162","432090 TAPEJARA",0,8,4,307,1,320,"2017"
"44163","432100 TAPERA",0,0,1,129,0,130,"2017"
"44164","432110 TAPES",0,0,2,197,2,201,"2017"
"44165","432120 TAQUARA",2,4,12,648,0,666,"2017"
"44166","432130 TAQUARI",0,0,7,270,0,277,"2017"
"44167","432132 TAQUARUCU DO SUL",0,0,0,38,0,38,"2017"
"44168","432135 TAVARES",1,1,0,46,1,49,"2017"
"44169","432140 TENENTE PORTELA",1,1,3,210,0,215,"2017"
"44170","432143 TERRA DE AREIA",0,0,2,118,0,120,"2017"
"44171","432145 TEUTONIA",0,0,3,390,0,393,"2017"
"44172","432146 TIO HUGO",0,0,1,30,0,31,"2017"
"44173","432147 TIRADENTES DO SUL",0,0,0,34,0,34,"2017"
"44174","432149 TOROPI",0,0,2,25,0,27,"2017"
"44175","432150 TORRES",0,2,7,547,1,557,"2017"
"44176","432160 TRAMANDAI",2,4,20,826,4,856,"2017"
"44177","432162 TRAVESSEIRO",0,0,1,16,0,17,"2017"
"44178","432163 TRES ARROIOS",0,0,1,9,0,10,"2017"
"44179","432166 TRES CACHOEIRAS",0,0,2,127,1,130,"2017"
"44180","432170 TRES COROAS",0,1,3,286,2,292,"2017"
"44181","432180 TRES DE MAIO",1,1,2,315,0,319,"2017"
"44182","432183 TRES FORQUILHAS",0,0,1,25,0,26,"2017"
"44183","432185 TRES PALMEIRAS",1,0,0,70,0,71,"2017"
"44184","432190 TRES PASSOS",0,0,3,303,0,306,"2017"
"44185","432195 TRINDADE DO SUL",1,0,3,80,0,84,"2017"
"44186","432200 TRIUNFO",2,1,6,330,1,340,"2017"
"44187","432210 TUCUNDUVA",0,0,1,52,0,53,"2017"
"44188","432215 TUNAS",0,0,0,51,0,51,"2017"
"44189","432218 TUPANCI DO SUL",0,0,0,15,0,15,"2017"
"44190","432220 TUPANCIRETA",0,2,4,237,0,243,"2017"
"44191","432225 TUPANDI",0,0,0,56,0,56,"2017"
"44192","432230 TUPARENDI",0,1,1,72,0,74,"2017"
"44193","432232 TURUCU",0,0,3,35,0,38,"2017"
"44194","432234 UBIRETAMA",0,0,0,13,0,13,"2017"
"44195","432235 UNIAO DA SERRA",0,0,0,4,0,4,"2017"
"44196","432237 UNISTALDA",0,0,1,28,0,29,"2017"
"44197","432240 URUGUAIANA",1,11,11,535,1236,1794,"2017"
"44198","432250 VACARIA",0,4,12,964,10,990,"2017"
"44199","432252 VALE VERDE",0,0,1,36,0,37,"2017"
"44200","432253 VALE DO SOL",1,1,1,74,0,77,"2017"
"44201","432254 VALE REAL",0,0,0,57,0,57,"2017"
"44202","432255 VANINI",0,0,0,20,0,20,"2017"
"44203","432260 VENANCIO AIRES",0,0,5,766,1,772,"2017"
"44204","432270 VERA CRUZ",0,0,1,262,0,263,"2017"
"44205","432280 VERANOPOLIS",0,1,4,239,1,245,"2017"
"44206","432285 VESPASIANO CORREA",0,0,0,23,0,23,"2017"
"44207","432290 VIADUTOS",0,0,1,41,0,42,"2017"
"44208","432300 VIAMAO",6,17,53,3045,16,3137,"2017"
"44209","432310 VICENTE DUTRA",0,0,0,65,0,65,"2017"
"44210","432320 VICTOR GRAEFF",0,0,0,25,0,25,"2017"
"44211","432330 VILA FLORES",0,1,0,47,0,48,"2017"
"44212","432335 VILA LANGARO",0,0,0,18,0,18,"2017"
"44213","432340 VILA MARIA",0,0,0,38,0,38,"2017"
"44214","432345 VILA NOVA DO SUL",0,0,0,28,0,28,"2017"
"44215","432350 VISTA ALEGRE",1,1,1,25,0,28,"2017"
"44216","432360 VISTA ALEGRE DO PRATA",0,0,0,5,0,5,"2017"
"44217","432370 VISTA GAUCHA",0,1,2,25,0,28,"2017"
"44218","432375 VITORIA DAS MISSOES",0,0,0,34,0,34,"2017"
"44219","432377 WESTFALIA",0,0,0,30,0,30,"2017"
"44220","432380 XANGRI-LA",0,1,4,282,0,287,"2017"
"44221","500020 AGUA CLARA",0,1,1,314,0,316,"2017"
"44222","500025 ALCINOPOLIS",0,0,0,49,1,50,"2017"
"44223","500060 AMAMBAI",0,2,14,630,0,646,"2017"
"44224","500070 ANASTACIO",1,2,3,350,10,366,"2017"
"44225","500080 ANAURILANDIA",0,0,2,80,0,82,"2017"
"44226","500085 ANGELICA",0,0,1,170,1,172,"2017"
"44227","500090 ANTONIO JOAO",0,1,1,127,3,132,"2017"
"44228","500100 APARECIDA DO TABOADO",0,2,5,372,0,379,"2017"
"44229","500110 AQUIDAUANA",0,1,3,836,28,868,"2017"
"44230","500124 ARAL MOREIRA",0,36,7,119,4,166,"2017"
"44231","500150 BANDEIRANTES",0,0,1,89,0,90,"2017"
"44232","500190 BATAGUASSU",0,1,3,368,0,372,"2017"
"44233","500200 BATAYPORA",0,0,0,177,0,177,"2017"
"44234","500210 BELA VISTA",0,1,2,435,0,438,"2017"
"44235","500215 BODOQUENA",0,2,2,131,1,136,"2017"
"44236","500220 BONITO",1,1,2,378,0,382,"2017"
"44237","500230 BRASILANDIA",0,0,0,138,0,138,"2017"
"44238","500240 CAARAPO",1,0,6,536,0,543,"2017"
"44239","500260 CAMAPUA",1,0,0,182,0,183,"2017"
"44240","500270 CAMPO GRANDE",36,33,104,14060,31,14264,"2017"
"44241","500280 CARACOL",0,0,0,68,1,69,"2017"
"44242","500290 CASSILANDIA",1,2,0,246,1,250,"2017"
"44243","500295 CHAPADAO DO SUL",2,0,4,432,0,438,"2017"
"44244","500310 CORGUINHO",2,0,0,41,0,43,"2017"
"44245","500315 CORONEL SAPUCAIA",3,3,5,309,8,328,"2017"
"44246","500320 CORUMBA",4,8,16,1855,5,1888,"2017"
"44247","500325 COSTA RICA",1,2,2,455,0,460,"2017"
"44248","500330 COXIM",0,2,4,561,2,569,"2017"
"44249","500345 DEODAPOLIS",1,0,3,184,2,190,"2017"
"44250","500348 DOIS IRMAOS DO BURITI",0,1,1,161,1,164,"2017"
"44251","500350 DOURADINA",0,1,1,54,1,57,"2017"
"44252","500370 DOURADOS",3,16,59,4067,34,4179,"2017"
"44253","500375 ELDORADO",0,1,18,148,0,167,"2017"
"44254","500380 FATIMA DO SUL",0,1,6,294,0,301,"2017"
"44255","500390 FIGUEIRAO",0,1,0,33,0,34,"2017"
"44256","500400 GLORIA DE DOURADOS",0,2,0,127,0,129,"2017"
"44257","500410 GUIA LOPES DA LAGUNA",1,0,1,123,2,127,"2017"
"44258","500430 IGUATEMI",0,0,2,237,2,241,"2017"
"44259","500440 INOCENCIA",1,0,0,109,0,110,"2017"
"44260","500450 ITAPORA",1,1,2,235,0,239,"2017"
"44261","500460 ITAQUIRAI",0,0,2,273,0,275,"2017"
"44262","500470 IVINHEMA",0,2,2,390,0,394,"2017"
"44263","500480 JAPORA",0,3,6,172,1,182,"2017"
"44264","500490 JARAGUARI",0,0,0,48,0,48,"2017"
"44265","500500 JARDIM",0,1,2,421,1,425,"2017"
"44266","500510 JATEI",0,0,0,36,0,36,"2017"
"44267","500515 JUTI",0,2,0,106,0,108,"2017"
"44268","500520 LADARIO",0,2,0,398,0,400,"2017"
"44269","500525 LAGUNA CARAPA",1,1,1,126,0,129,"2017"
"44270","500540 MARACAJU",2,3,10,775,1,791,"2017"
"44271","500560 MIRANDA",1,1,8,531,2,543,"2017"
"44272","500568 MUNDO NOVO",2,3,46,243,1,295,"2017"
"44273","500570 NAVIRAI",2,1,11,931,0,945,"2017"
"44274","500580 NIOAQUE",0,0,0,174,3,177,"2017"
"44275","500600 NOVA ALVORADA DO SUL",1,4,1,315,1,322,"2017"
"44276","500620 NOVA ANDRADINA",0,2,8,780,0,790,"2017"
"44277","500625 NOVO HORIZONTE DO SUL",0,0,1,77,0,78,"2017"
"44278","500627 PARAISO DAS AGUAS",0,1,0,57,0,58,"2017"
"44279","500630 PARANAIBA",0,1,2,553,0,556,"2017"
"44280","500635 PARANHOS",0,0,4,242,37,283,"2017"
"44281","500640 PEDRO GOMES",1,0,3,86,1,91,"2017"
"44282","500660 PONTA PORA",9,5,16,1658,18,1706,"2017"
"44283","500690 PORTO MURTINHO",0,1,3,250,1,255,"2017"
"44284","500710 RIBAS DO RIO PARDO",1,0,2,358,1,362,"2017"
"44285","500720 RIO BRILHANTE",1,1,6,691,1,700,"2017"
"44286","500730 RIO NEGRO",0,0,1,57,0,58,"2017"
"44287","500740 RIO VERDE DE MATO GROSSO",0,2,5,274,0,281,"2017"
"44288","500750 ROCHEDO",0,0,0,72,0,72,"2017"
"44289","500755 SANTA RITA DO PARDO",0,1,1,82,0,84,"2017"
"44290","500769 SAO GABRIEL DO OESTE",0,3,8,582,2,595,"2017"
"44291","500770 SETE QUEDAS",0,0,2,158,1,161,"2017"
"44292","500780 SELVIRIA",0,0,1,75,0,76,"2017"
"44293","500790 SIDROLANDIA",2,2,3,724,2,733,"2017"
"44294","500793 SONORA",0,1,1,236,0,238,"2017"
"44295","500795 TACURU",2,0,2,190,2,196,"2017"
"44296","500797 TAQUARUSSU",0,1,3,40,0,44,"2017"
"44297","500800 TERENOS",0,0,2,170,0,172,"2017"
"44298","500830 TRES LAGOAS",3,6,23,2097,0,2129,"2017"
"44299","500840 VICENTINA",0,0,0,76,0,76,"2017"
"44300","MUNICIPIO IGNORADO - MT",0,0,0,3,0,3,"2017"
"44301","510010 ACORIZAL",1,0,0,76,0,77,"2017"
"44302","510020 AGUA BOA",0,1,7,373,10,391,"2017"
"44303","510025 ALTA FLORESTA",0,3,6,877,0,886,"2017"
"44304","510030 ALTO ARAGUAIA",0,1,1,218,0,220,"2017"
"44305","510035 ALTO BOA VISTA",0,0,0,55,17,72,"2017"
"44306","510040 ALTO GARCAS",0,1,1,122,0,124,"2017"
"44307","510050 ALTO PARAGUAI",0,1,2,91,0,94,"2017"
"44308","510060 ALTO TAQUARI",0,0,1,162,0,163,"2017"
"44309","510080 APIACAS",0,0,2,126,0,128,"2017"
"44310","510100 ARAGUAIANA",0,0,0,38,0,38,"2017"
"44311","510120 ARAGUAINHA",0,0,0,6,0,6,"2017"
"44312","510125 ARAPUTANGA",0,2,2,263,0,267,"2017"
"44313","510130 ARENAPOLIS",0,0,5,146,0,151,"2017"
"44314","510140 ARIPUANA",0,1,4,356,1,362,"2017"
"44315","510160 BARAO DE MELGACO",0,0,0,75,1,76,"2017"
"44316","510170 BARRA DO BUGRES",1,4,14,507,1,527,"2017"
"44317","510180 BARRA DO GARCAS",1,3,9,1056,4,1073,"2017"
"44318","510185 BOM JESUS DO ARAGUAIA",0,0,0,98,21,119,"2017"
"44319","510190 BRASNORTE",2,1,6,304,7,320,"2017"
"44320","510250 CACERES",4,7,18,1532,6,1567,"2017"
"44321","510260 CAMPINAPOLIS",0,2,9,233,199,443,"2017"
"44322","510263 CAMPO NOVO DO PARECIS",0,2,15,717,2,736,"2017"
"44323","510267 CAMPO VERDE",3,7,6,768,1,785,"2017"
"44324","510268 CAMPOS DE JULIO",1,0,0,134,0,135,"2017"
"44325","510269 CANABRAVA DO NORTE",0,0,1,54,1,56,"2017"
"44326","510270 CANARANA",0,1,3,408,31,443,"2017"
"44327","510279 CARLINDA",0,0,1,144,0,145,"2017"
"44328","510285 CASTANHEIRA",0,0,0,115,0,115,"2017"
"44329","510300 CHAPADA DOS GUIMARAES",0,2,3,271,0,276,"2017"
"44330","510305 CLAUDIA",0,0,1,134,0,135,"2017"
"44331","510310 COCALINHO",0,0,1,57,2,60,"2017"
"44332","510320 COLIDER",0,1,8,475,1,485,"2017"
"44333","510325 COLNIZA",0,1,4,428,0,433,"2017"
"44334","510330 COMODORO",0,1,1,346,40,388,"2017"
"44335","510335 CONFRESA",1,0,7,497,17,522,"2017"
"44336","510336 CONQUISTA D'OESTE",0,0,0,58,0,58,"2017"
"44337","510337 COTRIGUACU",0,0,0,164,0,164,"2017"
"44338","510340 CUIABA",20,24,113,10243,13,10413,"2017"
"44339","510343 CURVELANDIA",0,0,0,65,0,65,"2017"
"44340","510345 DENISE",0,0,2,98,0,100,"2017"
"44341","510350 DIAMANTINO",0,1,2,405,0,408,"2017"
"44342","510360 DOM AQUINO",0,1,3,81,0,85,"2017"
"44343","510370 FELIZ NATAL",0,1,2,184,4,191,"2017"
"44344","510380 FIGUEIROPOLIS D'OESTE",0,0,0,46,0,46,"2017"
"44345","510385 GAUCHA DO NORTE",3,0,2,139,14,158,"2017"
"44346","510390 GENERAL CARNEIRO",1,1,2,93,7,104,"2017"
"44347","510395 GLORIA D'OESTE",0,0,1,40,0,41,"2017"
"44348","510410 GUARANTA DO NORTE",1,1,9,553,2,566,"2017"
"44349","510420 GUIRATINGA",0,0,0,114,0,114,"2017"
"44350","510450 INDIAVAI",0,0,1,36,0,37,"2017"
"44351","510452 IPIRANGA DO NORTE",0,0,0,110,0,110,"2017"
"44352","510454 ITANHANGA",1,1,0,79,0,81,"2017"
"44353","510455 ITAUBA",0,0,1,67,0,68,"2017"
"44354","510460 ITIQUIRA",2,0,0,172,0,174,"2017"
"44355","510480 JACIARA",1,1,4,476,0,482,"2017"
"44356","510490 JANGADA",0,0,0,115,0,115,"2017"
"44357","510500 JAURU",0,0,1,128,0,129,"2017"
"44358","510510 JUARA",5,2,3,569,6,585,"2017"
"44359","510515 JUINA",5,4,12,717,2,740,"2017"
"44360","510517 JURUENA",0,0,0,129,0,129,"2017"
"44361","510520 JUSCIMEIRA",0,1,1,128,0,130,"2017"
"44362","510523 LAMBARI D'OESTE",1,0,1,73,0,75,"2017"
"44363","510525 LUCAS DO RIO VERDE",4,4,17,1389,1,1415,"2017"
"44364","510530 LUCIARA",0,0,0,30,0,30,"2017"
"44365","510550 VILA BELA DA SANTISSIMA TRINDADE",0,1,6,266,10,283,"2017"
"44366","510558 MARCELANDIA",1,1,20,169,7,198,"2017"
"44367","510560 MATUPA",1,2,6,306,0,315,"2017"
"44368","510562 MIRASSOL D'OESTE",0,1,4,402,1,408,"2017"
"44369","510590 NOBRES",0,3,7,256,1,267,"2017"
"44370","510600 NORTELANDIA",0,1,4,94,0,99,"2017"
"44371","510610 NOSSA SENHORA DO LIVRAMENTO",0,0,1,137,0,138,"2017"
"44372","510615 NOVA BANDEIRANTES",1,0,2,155,0,158,"2017"
"44373","510617 NOVA NAZARE",0,0,0,59,42,101,"2017"
"44374","510618 NOVA LACERDA",0,0,1,92,1,94,"2017"
"44375","510619 NOVA SANTA HELENA",1,0,2,47,0,50,"2017"
"44376","510620 NOVA BRASILANDIA",1,1,1,39,0,42,"2017"
"44377","510621 NOVA CANAA DO NORTE",0,2,1,149,0,152,"2017"
"44378","510622 NOVA MUTUM",2,1,8,929,0,940,"2017"
"44379","510623 NOVA OLIMPIA",0,0,5,278,0,283,"2017"
"44380","510624 NOVA UBIRATA",0,0,0,189,0,189,"2017"
"44381","510625 NOVA XAVANTINA",2,0,3,266,0,271,"2017"
"44382","510626 NOVO MUNDO",0,0,3,104,0,107,"2017"
"44383","510627 NOVO HORIZONTE DO NORTE",1,0,1,57,0,59,"2017"
"44384","510628 NOVO SAO JOAQUIM",0,1,2,82,1,86,"2017"
"44385","510629 PARANAITA",0,1,3,190,0,194,"2017"
"44386","510630 PARANATINGA",2,5,7,351,12,377,"2017"
"44387","510631 NOVO SANTO ANTONIO",0,0,0,26,0,26,"2017"
"44388","510637 PEDRA PRETA",2,3,1,258,0,264,"2017"
"44389","510642 PEIXOTO DE AZEVEDO",1,1,11,612,2,627,"2017"
"44390","510645 PLANALTO DA SERRA",0,2,0,39,0,41,"2017"
"44391","510650 POCONE",1,0,6,454,1,462,"2017"
"44392","510665 PONTAL DO ARAGUAIA",0,1,0,82,1,84,"2017"
"44393","510670 PONTE BRANCA",0,0,1,17,0,18,"2017"
"44394","510675 PONTES E LACERDA",2,2,3,836,2,845,"2017"
"44395","510677 PORTO ALEGRE DO NORTE",0,0,1,112,3,116,"2017"
"44396","510680 PORTO DOS GAUCHOS",2,0,2,68,3,75,"2017"
"44397","510682 PORTO ESPERIDIAO",1,1,4,191,3,200,"2017"
"44398","510685 PORTO ESTRELA",0,0,0,33,1,34,"2017"
"44399","510700 POXOREO",0,1,4,235,5,245,"2017"
"44400","510704 PRIMAVERA DO LESTE",3,2,9,1287,1,1302,"2017"
"44401","510706 QUERENCIA",0,1,0,352,10,363,"2017"
"44402","510710 SAO JOSE DOS QUATRO MARCOS",1,0,2,261,1,265,"2017"
"44403","510715 RESERVA DO CABACAL",0,0,0,31,0,31,"2017"
"44404","510718 RIBEIRAO CASCALHEIRA",0,2,1,140,34,177,"2017"
"44405","510719 RIBEIRAOZINHO",0,0,0,35,0,35,"2017"
"44406","510720 RIO BRANCO",0,1,1,80,1,83,"2017"
"44407","510724 SANTA CARMEM",1,0,0,80,1,82,"2017"
"44408","510726 SANTO AFONSO",0,0,0,27,1,28,"2017"
"44409","510729 SAO JOSE DO POVO",0,0,0,20,0,20,"2017"
"44410","510730 SAO JOSE DO RIO CLARO",0,0,1,272,0,273,"2017"
"44411","510735 SAO JOSE DO XINGU",0,0,1,76,0,77,"2017"
"44412","510740 SAO PEDRO DA CIPA",0,1,0,72,0,73,"2017"
"44413","510757 RONDOLANDIA",0,0,0,33,0,33,"2017"
"44414","510760 RONDONOPOLIS",19,19,36,3887,3,3964,"2017"
"44415","510770 ROSARIO OESTE",0,0,0,184,0,184,"2017"
"44416","510774 SANTA CRUZ DO XINGU",0,0,0,21,1,22,"2017"
"44417","510775 SALTO DO CEU",0,0,0,42,0,42,"2017"
"44418","510776 SANTA RITA DO TRIVELATO",0,0,0,52,0,52,"2017"
"44419","510777 SANTA TEREZINHA",0,1,0,103,0,104,"2017"
"44420","510779 SANTO ANTONIO DO LESTE",0,1,0,50,5,56,"2017"
"44421","510780 SANTO ANTONIO DO LEVERGER",0,1,1,244,0,246,"2017"
"44422","510785 SAO FELIX DO ARAGUAIA",1,0,1,127,1,130,"2017"
"44423","510787 SAPEZAL",0,4,7,520,1,532,"2017"
"44424","510788 SERRA NOVA DOURADA",0,0,0,26,0,26,"2017"
"44425","510790 SINOP",4,8,25,2917,5,2959,"2017"
"44426","510792 SORRISO",2,2,21,1697,3,1725,"2017"
"44427","510794 TABAPORA",0,0,2,136,0,138,"2017"
"44428","510795 TANGARA DA SERRA",3,5,40,1528,6,1582,"2017"
"44429","510800 TAPURAH",1,0,1,215,0,217,"2017"
"44430","510805 TERRA NOVA DO NORTE",0,0,3,148,1,152,"2017"
"44431","510810 TESOURO",0,1,0,46,1,48,"2017"
"44432","510820 TORIXOREU",0,0,1,39,0,40,"2017"
"44433","510830 UNIAO DO SUL",0,0,0,45,0,45,"2017"
"44434","510835 VALE DE SAO DOMINGOS",0,0,1,33,0,34,"2017"
"44435","510840 VARZEA GRANDE",12,21,48,4796,14,4891,"2017"
"44436","510850 VERA",0,0,4,147,0,151,"2017"
"44437","510860 VILA RICA",0,0,0,287,0,287,"2017"
"44438","510880 NOVA GUARITA",1,0,0,64,0,65,"2017"
"44439","510885 NOVA MARILANDIA",0,0,2,48,0,50,"2017"
"44440","510890 NOVA MARINGA",0,0,1,82,0,83,"2017"
"44441","510895 NOVA MONTE VERDE",1,1,0,120,0,122,"2017"
"44442","MUNICIPIO IGNORADO - GO",0,0,0,4,1,5,"2017"
"44443","520005 ABADIA DE GOIAS",1,1,1,193,0,196,"2017"
"44444","520010 ABADIANIA",1,1,5,197,0,204,"2017"
"44445","520013 ACREUNA",0,0,79,191,1,271,"2017"
"44446","520015 ADELANDIA",0,0,0,22,0,22,"2017"
"44447","520017 AGUA FRIA DE GOIAS",0,0,0,44,0,44,"2017"
"44448","520020 AGUA LIMPA",0,0,1,21,0,22,"2017"
"44449","520025 AGUAS LINDAS DE GOIAS",4,10,50,2301,204,2569,"2017"
"44450","520030 ALEXANIA",1,1,6,429,0,437,"2017"
"44451","520050 ALOANDIA",0,0,0,15,0,15,"2017"
"44452","520055 ALTO HORIZONTE",0,0,4,119,0,123,"2017"
"44453","520060 ALTO PARAISO DE GOIAS",0,1,3,134,7,145,"2017"
"44454","520080 ALVORADA DO NORTE",1,0,10,125,0,136,"2017"
"44455","520082 AMARALINA",0,0,0,26,0,26,"2017"
"44456","520085 AMERICANO DO BRASIL",1,0,2,80,1,84,"2017"
"44457","520090 AMORINOPOLIS",0,0,0,38,0,38,"2017"
"44458","520110 ANAPOLIS",11,30,106,6036,18,6201,"2017"
"44459","520120 ANHANGUERA",0,0,0,7,0,7,"2017"
"44460","520130 ANICUNS",1,0,2,193,0,196,"2017"
"44461","520140 APARECIDA DE GOIANIA",22,18,112,7681,65,7898,"2017"
"44462","520145 APARECIDA DO RIO DOCE",0,0,0,24,0,24,"2017"
"44463","520150 APORE",1,2,2,60,0,65,"2017"
"44464","520160 ARACU",0,1,0,55,1,57,"2017"
"44465","520170 ARAGARCAS",1,0,6,236,0,243,"2017"
"44466","520180 ARAGOIANIA",0,1,2,122,2,127,"2017"
"44467","520215 ARAGUAPAZ",1,0,1,90,0,92,"2017"
"44468","520235 ARENOPOLIS",0,0,1,38,0,39,"2017"
"44469","520250 ARUANA",0,0,3,116,1,120,"2017"
"44470","520260 AURILANDIA",0,0,0,28,0,28,"2017"
"44471","520280 AVELINOPOLIS",0,1,1,16,0,18,"2017"
"44472","520310 BALIZA",0,0,1,30,0,31,"2017"
"44473","520320 BARRO ALTO",0,0,3,138,0,141,"2017"
"44474","520330 BELA VISTA DE GOIAS",2,3,4,451,1,461,"2017"
"44475","520340 BOM JARDIM DE GOIAS",1,0,2,96,0,99,"2017"
"44476","520350 BOM JESUS DE GOIAS",3,5,8,334,3,353,"2017"
"44477","520355 BONFINOPOLIS",0,0,1,111,1,113,"2017"
"44478","520357 BONOPOLIS",0,0,1,35,0,36,"2017"
"44479","520360 BRAZABRANTES",0,0,2,45,3,50,"2017"
"44480","520380 BRITANIA",0,0,1,85,1,87,"2017"
"44481","520390 BURITI ALEGRE",0,0,3,143,0,146,"2017"
"44482","520393 BURITI DE GOIAS",0,0,0,33,0,33,"2017"
"44483","520396 BURITINOPOLIS",1,1,6,32,0,40,"2017"
"44484","520400 CABECEIRAS",0,0,2,98,0,100,"2017"
"44485","520410 CACHOEIRA ALTA",0,0,0,133,0,133,"2017"
"44486","520420 CACHOEIRA DE GOIAS",0,1,0,9,0,10,"2017"
"44487","520425 CACHOEIRA DOURADA",0,0,0,95,0,95,"2017"
"44488","520430 CACU",0,1,1,167,0,169,"2017"
"44489","520440 CAIAPONIA",1,1,4,207,0,213,"2017"
"44490","520450 CALDAS NOVAS",3,9,23,1249,2,1286,"2017"
"44491","520455 CALDAZINHA",0,0,0,48,0,48,"2017"
"44492","520460 CAMPESTRE DE GOIAS",0,0,0,33,1,34,"2017"
"44493","520465 CAMPINACU",0,0,0,37,1,38,"2017"
"44494","520470 CAMPINORTE",1,0,2,145,0,148,"2017"
"44495","520480 CAMPO ALEGRE DE GOIAS",1,0,1,69,0,71,"2017"
"44496","520485 CAMPO LIMPO DE GOIAS",0,1,2,141,0,144,"2017"
"44497","520490 CAMPOS BELOS",1,0,5,323,2,331,"2017"
"44498","520495 CAMPOS VERDES",1,1,2,56,0,60,"2017"
"44499","520500 CARMO DO RIO VERDE",0,0,1,119,0,120,"2017"
"44500","520505 CASTELANDIA",0,0,1,33,0,34,"2017"
"44501","520510 CATALAO",1,1,9,1466,2,1479,"2017"
"44502","520520 CATURAI",0,0,0,61,0,61,"2017"
"44503","520530 CAVALCANTE",1,0,2,134,3,140,"2017"
"44504","520540 CERES",0,0,1,294,0,295,"2017"
"44505","520545 CEZARINA",1,1,1,104,0,107,"2017"
"44506","520547 CHAPADAO DO CEU",0,0,2,189,0,191,"2017"
"44507","520549 CIDADE OCIDENTAL",6,0,12,1056,24,1098,"2017"
"44508","520551 COCALZINHO DE GOIAS",0,3,3,185,23,214,"2017"
"44509","520552 COLINAS DO SUL",0,0,0,48,1,49,"2017"
"44510","520570 CORREGO DO OURO",2,1,0,36,1,40,"2017"
"44511","520580 CORUMBA DE GOIAS",0,0,1,99,0,100,"2017"
"44512","520590 CORUMBAIBA",0,1,0,97,0,98,"2017"
"44513","520620 CRISTALINA",0,1,7,894,7,909,"2017"
"44514","520630 CRISTIANOPOLIS",0,0,0,36,0,36,"2017"
"44515","520640 CRIXAS",0,0,3,238,2,243,"2017"
"44516","520650 CROMINIA",0,0,1,30,0,31,"2017"
"44517","520660 CUMARI",0,1,0,30,0,31,"2017"
"44518","520670 DAMIANOPOLIS",0,0,0,46,0,46,"2017"
"44519","520680 DAMOLANDIA",0,0,0,31,0,31,"2017"
"44520","520690 DAVINOPOLIS",1,0,0,15,0,16,"2017"
"44521","520710 DIORAMA",0,1,0,20,0,21,"2017"
"44522","520725 DOVERLANDIA",0,0,4,62,0,66,"2017"
"44523","520735 EDEALINA",0,0,0,51,0,51,"2017"
"44524","520740 EDEIA",0,0,1,147,1,149,"2017"
"44525","520750 ESTRELA DO NORTE",0,0,1,54,0,55,"2017"
"44526","520753 FAINA",0,1,2,76,0,79,"2017"
"44527","520760 FAZENDA NOVA",0,0,0,48,0,48,"2017"
"44528","520780 FIRMINOPOLIS",0,0,1,97,1,99,"2017"
"44529","520790 FLORES DE GOIAS",1,0,2,111,1,115,"2017"
"44530","520800 FORMOSA",1,4,22,1805,2,1834,"2017"
"44531","520810 FORMOSO",0,0,1,57,0,58,"2017"
"44532","520815 GAMELEIRA DE GOIAS",0,0,1,41,0,42,"2017"
"44533","520830 DIVINOPOLIS DE GOIAS",0,0,1,62,1,64,"2017"
"44534","520840 GOIANAPOLIS",1,1,5,200,0,207,"2017"
"44535","520850 GOIANDIRA",0,0,1,42,0,43,"2017"
"44536","520860 GOIANESIA",1,2,23,914,1,941,"2017"
"44537","520870 GOIANIA",59,77,279,20900,103,21418,"2017"
"44538","520880 GOIANIRA",2,3,10,892,3,910,"2017"
"44539","520890 GOIAS",1,0,3,272,4,280,"2017"
"44540","520910 GOIATUBA",1,1,5,424,0,431,"2017"
"44541","520915 GOUVELANDIA",1,0,0,47,0,48,"2017"
"44542","520920 GUAPO",1,1,1,206,1,210,"2017"
"44543","520929 GUARAITA",0,0,1,22,0,23,"2017"
"44544","520940 GUARANI DE GOIAS",0,0,3,26,1,30,"2017"
"44545","520945 GUARINOS",0,0,0,18,0,18,"2017"
"44546","520960 HEITORAI",0,0,0,23,1,24,"2017"
"44547","520970 HIDROLANDIA",1,0,4,294,1,300,"2017"
"44548","520980 HIDROLINA",0,0,0,52,0,52,"2017"
"44549","520990 IACIARA",0,1,1,157,0,159,"2017"
"44550","520993 INACIOLANDIA",0,1,0,57,0,58,"2017"
"44551","520995 INDIARA",0,0,0,207,1,208,"2017"
"44552","521000 INHUMAS",2,1,15,660,1,679,"2017"
"44553","521010 IPAMERI",2,0,2,345,0,349,"2017"
"44554","521015 IPIRANGA DE GOIAS",0,0,0,23,0,23,"2017"
"44555","521020 IPORA",1,0,1,442,0,444,"2017"
"44556","521030 ISRAELANDIA",1,0,1,24,0,26,"2017"
"44557","521040 ITABERAI",2,2,3,577,4,588,"2017"
"44558","521056 ITAGUARI",0,1,0,73,0,74,"2017"
"44559","521060 ITAGUARU",0,2,0,43,0,45,"2017"
"44560","521080 ITAJA",0,0,1,38,0,39,"2017"
"44561","521090 ITAPACI",0,0,3,313,0,316,"2017"
"44562","521100 ITAPIRAPUA",0,0,3,116,0,119,"2017"
"44563","521120 ITAPURANGA",0,0,3,333,2,338,"2017"
"44564","521130 ITARUMA",0,0,1,54,1,56,"2017"
"44565","521140 ITAUCU",0,0,2,74,0,76,"2017"
"44566","521150 ITUMBIARA",2,4,20,1423,3,1452,"2017"
"44567","521160 IVOLANDIA",1,0,0,14,0,15,"2017"
"44568","521170 JANDAIA",0,0,1,73,0,74,"2017"
"44569","521180 JARAGUA",1,6,10,560,4,581,"2017"
"44570","521190 JATAI",3,11,29,1457,0,1500,"2017"
"44571","521200 JAUPACI",0,0,0,34,0,34,"2017"
"44572","521205 JESUPOLIS",0,0,1,21,0,22,"2017"
"44573","521210 JOVIANIA",0,0,0,102,0,102,"2017"
"44574","521220 JUSSARA",0,0,4,271,0,275,"2017"
"44575","521225 LAGOA SANTA",0,0,0,15,0,15,"2017"
"44576","521230 LEOPOLDO DE BULHOES",0,0,2,93,0,95,"2017"
"44577","521250 LUZIANIA",9,8,38,2865,90,3010,"2017"
"44578","521260 MAIRIPOTABA",0,0,0,30,0,30,"2017"
"44579","521270 MAMBAI",0,0,2,121,0,123,"2017"
"44580","521280 MARA ROSA",0,0,2,123,0,125,"2017"
"44581","521290 MARZAGAO",0,0,1,37,0,38,"2017"
"44582","521295 MATRINCHA",1,0,0,44,0,45,"2017"
"44583","521300 MAURILANDIA",0,0,2,146,1,149,"2017"
"44584","521305 MIMOSO DE GOIAS",0,0,0,6,11,17,"2017"
"44585","521308 MINACU",0,2,5,423,1,431,"2017"
"44586","521310 MINEIROS",3,3,8,1197,0,1211,"2017"
"44587","521340 MOIPORA",0,0,0,5,0,5,"2017"
"44588","521350 MONTE ALEGRE DE GOIAS",0,0,1,86,4,91,"2017"
"44589","521370 MONTES CLAROS DE GOIAS",0,0,3,111,1,115,"2017"
"44590","521375 MONTIVIDIU",0,2,2,163,0,167,"2017"
"44591","521377 MONTIVIDIU DO NORTE",0,0,2,35,0,37,"2017"
"44592","521380 MORRINHOS",1,3,5,624,0,633,"2017"
"44593","521385 MORRO AGUDO DE GOIAS",0,0,0,21,0,21,"2017"
"44594","521390 MOSSAMEDES",1,0,1,44,0,46,"2017"
"44595","521400 MOZARLANDIA",1,1,5,211,1,219,"2017"
"44596","521405 MUNDO NOVO",0,0,1,75,0,76,"2017"
"44597","521410 MUTUNOPOLIS",0,1,2,43,0,46,"2017"
"44598","521440 NAZARIO",0,0,1,96,0,97,"2017"
"44599","521450 NEROPOLIS",2,6,6,491,2,507,"2017"
"44600","521460 NIQUELANDIA",1,3,6,448,3,461,"2017"
"44601","521470 NOVA AMERICA",0,0,0,27,0,27,"2017"
"44602","521480 NOVA AURORA",0,1,1,23,0,25,"2017"
"44603","521483 NOVA CRIXAS",0,0,1,163,0,164,"2017"
"44604","521486 NOVA GLORIA",0,0,1,89,0,90,"2017"
"44605","521487 NOVA IGUACU DE GOIAS",0,0,0,26,0,26,"2017"
"44606","521490 NOVA ROMA",0,1,0,36,0,37,"2017"
"44607","521500 NOVA VENEZA",0,0,1,110,1,112,"2017"
"44608","521520 NOVO BRASIL",0,0,1,29,0,30,"2017"
"44609","521523 NOVO GAMA",4,4,31,1396,37,1472,"2017"
"44610","521525 NOVO PLANALTO",0,0,0,61,0,61,"2017"
"44611","521530 ORIZONA",0,0,2,202,0,204,"2017"
"44612","521540 OURO VERDE DE GOIAS",0,0,0,49,2,51,"2017"
"44613","521550 OUVIDOR",0,0,1,74,0,75,"2017"
"44614","521560 PADRE BERNARDO",2,0,5,109,348,464,"2017"
"44615","521565 PALESTINA DE GOIAS",0,0,0,53,0,53,"2017"
"44616","521570 PALMEIRAS DE GOIAS",0,1,5,395,3,404,"2017"
"44617","521580 PALMELO",0,0,0,20,0,20,"2017"
"44618","521590 PALMINOPOLIS",0,0,0,43,0,43,"2017"
"44619","521600 PANAMA",1,0,0,25,0,26,"2017"
"44620","521630 PARANAIGUARA",0,0,0,104,0,104,"2017"
"44621","521640 PARAUNA",1,0,3,161,0,165,"2017"
"44622","521645 PEROLANDIA",0,0,0,47,1,48,"2017"
"44623","521680 PETROLINA DE GOIAS",0,1,0,77,0,78,"2017"
"44624","521690 PILAR DE GOIAS",0,0,0,38,0,38,"2017"
"44625","521710 PIRACANJUBA",0,2,6,236,1,245,"2017"
"44626","521720 PIRANHAS",1,0,0,124,0,125,"2017"
"44627","521730 PIRENOPOLIS",2,1,3,274,1,281,"2017"
"44628","521740 PIRES DO RIO",1,5,6,314,1,327,"2017"
"44629","521760 PLANALTINA",4,2,15,1591,4,1616,"2017"
"44630","521770 PONTALINA",0,0,0,207,0,207,"2017"
"44631","521800 PORANGATU",1,2,21,542,0,566,"2017"
"44632","521805 PORTEIRAO",1,0,0,51,1,53,"2017"
"44633","521810 PORTELANDIA",0,0,0,37,0,37,"2017"
"44634","521830 POSSE",0,3,17,519,0,539,"2017"
"44635","521839 PROFESSOR JAMIL",0,0,0,42,1,43,"2017"
"44636","521850 QUIRINOPOLIS",1,0,3,641,0,645,"2017"
"44637","521860 RIALMA",0,0,0,158,0,158,"2017"
"44638","521870 RIANAPOLIS",0,0,0,56,0,56,"2017"
"44639","521878 RIO QUENTE",0,0,0,58,0,58,"2017"
"44640","521880 RIO VERDE",5,8,22,3332,4,3371,"2017"
"44641","521890 RUBIATABA",0,0,2,232,0,234,"2017"
"44642","521900 SANCLERLANDIA",0,1,5,89,1,96,"2017"
"44643","521910 SANTA BARBARA DE GOIAS",0,0,0,92,1,93,"2017"
"44644","521920 SANTA CRUZ DE GOIAS",0,0,0,35,0,35,"2017"
"44645","521925 SANTA FE DE GOIAS",0,1,1,79,1,82,"2017"
"44646","521930 SANTA HELENA DE GOIAS",0,1,13,538,1,553,"2017"
"44647","521935 SANTA ISABEL",0,0,1,34,0,35,"2017"
"44648","521940 SANTA RITA DO ARAGUAIA",0,0,0,105,0,105,"2017"
"44649","521945 SANTA RITA DO NOVO DESTINO",0,0,0,30,0,30,"2017"
"44650","521950 SANTA ROSA DE GOIAS",0,0,0,39,0,39,"2017"
"44651","521960 SANTA TEREZA DE GOIAS",0,1,2,30,0,33,"2017"
"44652","521970 SANTA TEREZINHA DE GOIAS",0,0,3,131,0,134,"2017"
"44653","521971 SANTO ANTONIO DA BARRA",0,0,0,46,0,46,"2017"
"44654","521973 SANTO ANTONIO DE GOIAS",0,0,0,97,1,98,"2017"
"44655","521975 SANTO ANTONIO DO DESCOBERTO",6,0,12,969,7,994,"2017"
"44656","521980 SAO DOMINGOS",0,1,2,122,1,126,"2017"
"44657","521990 SAO FRANCISCO DE GOIAS",1,0,0,76,0,77,"2017"
"44658","522000 SAO JOAO D'ALIANCA",1,1,2,138,2,144,"2017"
"44659","522005 SAO JOAO DA PARAUNA",0,0,0,18,0,18,"2017"
"44660","522010 SAO LUIS DE MONTES BELOS",0,1,2,443,0,446,"2017"
"44661","522015 SAO LUIZ DO NORTE",0,0,0,60,0,60,"2017"
"44662","522020 SAO MIGUEL DO ARAGUAIA",0,1,4,309,0,314,"2017"
"44663","522026 SAO MIGUEL DO PASSA QUATRO",0,0,0,28,0,28,"2017"
"44664","522028 SAO PATRICIO",0,0,2,22,0,24,"2017"
"44665","522040 SAO SIMAO",1,2,0,279,0,282,"2017"
"44666","522045 SENADOR CANEDO",0,6,29,2231,6,2272,"2017"
"44667","522050 SERRANOPOLIS",0,0,3,78,0,81,"2017"
"44668","522060 SILVANIA",0,1,2,233,0,236,"2017"
"44669","522068 SIMOLANDIA",0,1,4,65,2,72,"2017"
"44670","522070 SITIO D'ABADIA",0,0,1,17,1,19,"2017"
"44671","522100 TAQUARAL DE GOIAS",0,0,0,36,0,36,"2017"
"44672","522108 TERESINA DE GOIAS",0,0,0,46,2,48,"2017"
"44673","522119 TEREZOPOLIS DE GOIAS",2,0,3,124,2,131,"2017"
"44674","522130 TRES RANCHOS",0,0,0,28,0,28,"2017"
"44675","522140 TRINDADE",3,5,16,1933,8,1965,"2017"
"44676","522145 TROMBAS",0,0,2,32,0,34,"2017"
"44677","522150 TURVANIA",1,0,1,53,0,55,"2017"
"44678","522155 TURVELANDIA",0,0,0,76,0,76,"2017"
"44679","522157 UIRAPURU",0,0,0,22,0,22,"2017"
"44680","522160 URUACU",0,3,30,553,2,588,"2017"
"44681","522170 URUANA",1,1,0,151,0,153,"2017"
"44682","522180 URUTAI",0,0,1,21,0,22,"2017"
"44683","522185 VALPARAISO DE GOIAS",7,6,34,2445,77,2569,"2017"
"44684","522190 VARJAO",0,0,0,41,0,41,"2017"
"44685","522200 VIANOPOLIS",1,0,1,194,0,196,"2017"
"44686","522205 VICENTINOPOLIS",0,1,0,109,0,110,"2017"
"44687","522220 VILA BOA",0,0,1,58,2,61,"2017"
"44688","522230 VILA PROPICIO",0,0,4,62,0,66,"2017"
"44689","530010 BRASILIA",156,153,715,42286,1258,44568,"2017"
"44690","TOTAL",7493,11512,42254,2827196,56477,2944932,"2018"
"44691","MUNICIPIO IGNORADO - RO",0,0,0,2,0,2,"2018"
"44692","110001 ALTA FLORESTA D'OESTE",1,1,1,404,1,408,"2018"
"44693","110002 ARIQUEMES",2,6,25,1646,3,1682,"2018"
"44694","110003 CABIXI",1,0,1,78,2,82,"2018"
"44695","110004 CACOAL",2,3,14,1423,4,1446,"2018"
"44696","110005 CEREJEIRAS",0,1,3,259,1,264,"2018"
"44697","110006 COLORADO DO OESTE",1,1,1,231,1,235,"2018"
"44698","110007 CORUMBIARA",0,0,0,128,1,129,"2018"
"44699","110008 COSTA MARQUES",0,2,8,233,3,246,"2018"
"44700","110009 ESPIGAO D'OESTE",1,1,4,470,0,476,"2018"
"44701","110010 GUAJARA-MIRIM",0,2,11,887,26,926,"2018"
"44702","110011 JARU",1,2,4,904,0,911,"2018"
"44703","110012 JI-PARANA",11,10,31,2222,4,2278,"2018"
"44704","110013 MACHADINHO D'OESTE",1,4,8,499,5,517,"2018"
"44705","110014 NOVA BRASILANDIA D'OESTE",2,0,4,284,0,290,"2018"
"44706","110015 OURO PRETO DO OESTE",0,4,7,602,1,614,"2018"
"44707","110018 PIMENTA BUENO",0,1,12,638,0,651,"2018"
"44708","110020 PORTO VELHO",10,19,71,8570,82,8752,"2018"
"44709","110025 PRESIDENTE MEDICI",2,1,2,289,0,294,"2018"
"44710","110026 RIO CRESPO",0,0,0,46,0,46,"2018"
"44711","110028 ROLIM DE MOURA",2,1,12,885,0,900,"2018"
"44712","110029 SANTA LUZIA D'OESTE",1,0,1,101,0,103,"2018"
"44713","110030 VILHENA",2,6,21,1527,1,1557,"2018"
"44714","110032 SAO MIGUEL DO GUAPORE",0,3,5,381,2,391,"2018"
"44715","110033 NOVA MAMORE",0,1,6,465,10,482,"2018"
"44716","110034 ALVORADA D'OESTE",0,0,2,160,0,162,"2018"
"44717","110037 ALTO ALEGRE DOS PARECIS",0,0,2,157,1,160,"2018"
"44718","110040 ALTO PARAISO",2,3,0,213,1,219,"2018"
"44719","110045 BURITIS",2,2,7,605,1,617,"2018"
"44720","110050 NOVO HORIZONTE DO OESTE",0,1,0,110,0,111,"2018"
"44721","110060 CACAULANDIA",0,0,2,78,0,80,"2018"
"44722","110070 CAMPO NOVO DE RONDONIA",0,0,1,192,2,195,"2018"
"44723","110080 CANDEIAS DO JAMARI",0,1,8,407,5,421,"2018"
"44724","110090 CASTANHEIRAS",0,0,2,54,0,56,"2018"
"44725","110092 CHUPINGUAIA",0,0,2,177,2,181,"2018"
"44726","110094 CUJUBIM",0,1,4,219,5,229,"2018"
"44727","110100 GOVERNADOR JORGE TEIXEIRA",0,1,2,130,0,133,"2018"
"44728","110110 ITAPUA DO OESTE",0,0,0,92,0,92,"2018"
"44729","110120 MINISTRO ANDREAZZA",1,0,2,89,0,92,"2018"
"44730","110130 MIRANTE DA SERRA",1,0,1,158,0,160,"2018"
"44731","110140 MONTE NEGRO",1,2,2,215,0,220,"2018"
"44732","110143 NOVA UNIAO",0,0,3,84,0,87,"2018"
"44733","110145 PARECIS",0,0,1,52,0,53,"2018"
"44734","110146 PIMENTEIRAS DO OESTE",0,1,2,49,0,52,"2018"
"44735","110147 PRIMAVERA DE RONDONIA",0,0,0,38,0,38,"2018"
"44736","110148 SAO FELIPE D'OESTE",0,0,0,54,0,54,"2018"
"44737","110149 SAO FRANCISCO DO GUAPORE",4,4,25,294,0,327,"2018"
"44738","110150 SERINGUEIRAS",0,0,8,146,0,154,"2018"
"44739","110155 TEIXEIROPOLIS",0,0,1,59,0,60,"2018"
"44740","110160 THEOBROMA",2,0,0,129,0,131,"2018"
"44741","110170 URUPA",0,0,1,138,0,139,"2018"
"44742","110175 VALE DO ANARI",0,0,0,91,0,91,"2018"
"44743","110180 VALE DO PARAISO",0,1,0,94,0,95,"2018"
"44744","120001 ACRELANDIA",1,0,2,213,0,216,"2018"
"44745","120005 ASSIS BRASIL",0,1,7,227,29,264,"2018"
"44746","120010 BRASILEIA",4,3,10,512,11,540,"2018"
"44747","120013 BUJARI",0,1,3,297,5,306,"2018"
"44748","120017 CAPIXABA",0,2,3,210,7,222,"2018"
"44749","120020 CRUZEIRO DO SUL",0,10,17,1703,26,1756,"2018"
"44750","120025 EPITACIOLANDIA",1,3,3,262,4,273,"2018"
"44751","120030 FEIJO",3,4,11,686,129,833,"2018"
"44752","120032 JORDAO",0,2,3,147,122,274,"2018"
"44753","120033 MANCIO LIMA",1,0,6,357,3,367,"2018"
"44754","120034 MANOEL URBANO",0,1,1,227,23,252,"2018"
"44755","120035 MARECHAL THAUMATURGO",0,0,3,170,234,407,"2018"
"44756","120038 PLACIDO DE CASTRO",2,1,3,294,9,309,"2018"
"44757","120039 PORTO WALTER",0,0,4,245,5,254,"2018"
"44758","120040 RIO BRANCO",9,31,78,6280,97,6495,"2018"
"44759","120042 RODRIGUES ALVES",1,3,6,363,21,394,"2018"
"44760","120043 SANTA ROSA DO PURUS",0,1,2,99,105,207,"2018"
"44761","120045 SENADOR GUIOMARD",0,2,11,452,11,476,"2018"
"44762","120050 SENA MADUREIRA",1,5,11,750,21,788,"2018"
"44763","120060 TARAUACA",5,6,15,1063,104,1193,"2018"
"44764","120070 XAPURI",0,0,8,313,4,325,"2018"
"44765","120080 PORTO ACRE",0,4,4,374,10,392,"2018"
"44766","MUNICIPIO IGNORADO - AM",0,0,1,22,2,25,"2018"
"44767","130002 ALVARAES",0,3,6,336,1,346,"2018"
"44768","130006 AMATURA",0,0,4,150,93,247,"2018"
"44769","130008 ANAMA",1,0,3,200,10,214,"2018"
"44770","130010 ANORI",1,0,5,225,16,247,"2018"
"44771","130014 APUI",1,1,8,232,0,242,"2018"
"44772","130020 ATALAIA DO NORTE",1,1,1,210,144,357,"2018"
"44773","130030 AUTAZES",3,5,7,844,89,948,"2018"
"44774","130040 BARCELOS",1,1,1,302,265,570,"2018"
"44775","130050 BARREIRINHA",2,3,10,688,148,851,"2018"
"44776","130060 BENJAMIN CONSTANT",1,5,7,967,5,985,"2018"
"44777","130063 BERURI",1,0,6,400,94,501,"2018"
"44778","130068 BOA VISTA DO RAMOS",0,1,8,307,2,318,"2018"
"44779","130070 BOCA DO ACRE",2,2,9,723,3,739,"2018"
"44780","130080 BORBA",1,3,10,722,53,789,"2018"
"44781","130083 CAAPIRANGA",1,0,0,173,14,188,"2018"
"44782","130090 CANUTAMA",0,1,3,218,0,222,"2018"
"44783","130100 CARAUARI",1,3,22,301,309,636,"2018"
"44784","130110 CAREIRO",0,1,4,516,29,550,"2018"
"44785","130115 CAREIRO DA VARZEA",2,0,1,248,24,275,"2018"
"44786","130120 COARI",4,7,14,1722,0,1747,"2018"
"44787","130130 CODAJAS",0,2,6,418,3,429,"2018"
"44788","130140 EIRUNEPE",2,10,16,683,119,830,"2018"
"44789","130150 ENVIRA",4,3,2,329,31,369,"2018"
"44790","130160 FONTE BOA",1,1,3,616,0,621,"2018"
"44791","130165 GUAJARA",0,0,4,269,20,293,"2018"
"44792","130170 HUMAITA",1,5,13,986,1,1006,"2018"
"44793","130180 IPIXUNA",0,0,0,354,59,413,"2018"
"44794","130185 IRANDUBA",1,1,5,931,7,945,"2018"
"44795","130190 ITACOATIARA",3,8,15,1988,54,2068,"2018"
"44796","130195 ITAMARATI",0,0,2,233,68,303,"2018"
"44797","130200 ITAPIRANGA",1,0,3,167,0,171,"2018"
"44798","130210 JAPURA",0,1,1,144,5,151,"2018"
"44799","130220 JURUA",0,2,2,227,20,251,"2018"
"44800","130230 JUTAI",2,0,4,538,104,648,"2018"
"44801","130240 LABREA",0,3,39,712,25,779,"2018"
"44802","130250 MANACAPURU",5,7,10,2029,5,2056,"2018"
"44803","130255 MANAQUIRI",0,0,2,298,3,303,"2018"
"44804","130260 MANAUS",64,93,327,37946,158,38588,"2018"
"44805","130270 MANICORE",0,0,22,850,141,1013,"2018"
"44806","130280 MARAA",2,0,1,378,24,405,"2018"
"44807","130290 MAUES",4,6,17,1220,334,1581,"2018"
"44808","130300 NHAMUNDA",2,1,11,262,38,314,"2018"
"44809","130310 NOVA OLINDA DO NORTE",0,1,9,534,68,612,"2018"
"44810","130320 NOVO AIRAO",1,2,1,312,11,327,"2018"
"44811","130330 NOVO ARIPUANA",2,5,10,337,25,379,"2018"
"44812","130340 PARINTINS",8,8,26,1939,86,2067,"2018"
"44813","130350 PAUINI",1,3,0,339,19,362,"2018"
"44814","130353 PRESIDENTE FIGUEIREDO",1,1,12,540,4,558,"2018"
"44815","130356 RIO PRETO DA EVA",2,0,5,422,2,431,"2018"
"44816","130360 SANTA ISABEL DO RIO NEGRO",0,2,22,180,168,372,"2018"
"44817","130370 SANTO ANTONIO DO ICA",0,1,5,523,175,704,"2018"
"44818","130380 SAO GABRIEL DA CACHOEIRA",0,1,6,373,847,1227,"2018"
"44819","130390 SAO PAULO DE OLIVENCA",0,2,12,458,463,935,"2018"
"44820","130395 SAO SEBASTIAO DO UATUMA",1,1,3,176,5,186,"2018"
"44821","130400 SILVES",0,3,0,190,4,197,"2018"
"44822","130406 TABATINGA",1,2,9,1216,457,1685,"2018"
"44823","130410 TAPAUA",0,0,3,345,46,394,"2018"
"44824","130420 TEFE",11,6,12,1745,48,1822,"2018"
"44825","130423 TONANTINS",0,1,2,417,15,435,"2018"
"44826","130426 UARINI",0,1,20,256,9,286,"2018"
"44827","130430 URUCARA",3,1,3,250,4,261,"2018"
"44828","130440 URUCURITUBA",2,2,1,282,26,313,"2018"
"44829","MUNICIPIO IGNORADO - RR",0,0,0,1,0,1,"2018"
"44830","140002 AMAJARI",12,0,2,212,207,433,"2018"
"44831","140005 ALTO ALEGRE",6,0,3,207,521,737,"2018"
"44832","140010 BOA VISTA",86,15,68,7970,24,8163,"2018"
"44833","140015 BONFIM",16,0,3,295,77,391,"2018"
"44834","140017 CANTA",16,1,4,302,14,337,"2018"
"44835","140020 CARACARAI",3,1,4,327,71,406,"2018"
"44836","140023 CAROEBE",0,1,3,175,2,181,"2018"
"44837","140028 IRACEMA",3,1,0,97,37,138,"2018"
"44838","140030 MUCAJAI",1,1,5,282,36,325,"2018"
"44839","140040 NORMANDIA",10,1,6,350,96,463,"2018"
"44840","140045 PACARAIMA",9,3,3,369,39,423,"2018"
"44841","140047 RORAINOPOLIS",5,1,4,611,7,628,"2018"
"44842","140050 SAO JOAO DA BALIZA",0,0,1,114,4,119,"2018"
"44843","140060 SAO LUIZ",1,0,0,85,0,86,"2018"
"44844","140070 UIRAMUTA",16,1,2,327,167,513,"2018"
"44845","MUNICIPIO IGNORADO - PA",0,0,0,1,0,1,"2018"
"44846","150010 ABAETETUBA",7,17,43,2579,25,2671,"2018"
"44847","150013 ABEL FIGUEIREDO",0,0,1,129,0,130,"2018"
"44848","150020 ACARA",2,2,14,969,26,1013,"2018"
"44849","150030 AFUA",2,9,8,979,24,1022,"2018"
"44850","150034 AGUA AZUL DO NORTE",0,3,1,219,0,223,"2018"
"44851","150040 ALENQUER",11,4,8,1127,40,1190,"2018"
"44852","150050 ALMEIRIM",4,1,14,747,14,780,"2018"
"44853","150060 ALTAMIRA",26,7,22,2476,37,2568,"2018"
"44854","150070 ANAJAS",4,8,38,645,176,871,"2018"
"44855","150080 ANANINDEUA",23,24,60,7642,23,7772,"2018"
"44856","150085 ANAPU",3,4,9,637,3,656,"2018"
"44857","150090 AUGUSTO CORREA",2,4,13,795,87,901,"2018"
"44858","150095 AURORA DO PARA",3,1,34,330,0,368,"2018"
"44859","150100 AVEIRO",0,1,2,161,18,182,"2018"
"44860","150110 BAGRE",0,8,13,374,187,582,"2018"
"44861","150120 BAIAO",1,2,12,507,58,580,"2018"
"44862","150125 BANNACH",0,0,0,49,0,49,"2018"
"44863","150130 BARCARENA",4,7,18,2236,9,2274,"2018"
"44864","150140 BELEM",54,73,176,18929,116,19348,"2018"
"44865","150145 BELTERRA",0,1,13,276,6,296,"2018"
"44866","150150 BENEVIDES",5,3,8,1012,9,1037,"2018"
"44867","150157 BOM JESUS DO TOCANTINS",0,2,1,272,2,277,"2018"
"44868","150160 BONITO",0,0,1,187,0,188,"2018"
"44869","150170 BRAGANCA",5,6,22,2113,57,2203,"2018"
"44870","150172 BRASIL NOVO",0,1,9,340,1,351,"2018"
"44871","150175 BREJO GRANDE DO ARAGUAIA",0,0,1,87,4,92,"2018"
"44872","150178 BREU BRANCO",0,0,10,720,60,790,"2018"
"44873","150180 BREVES",9,27,88,2717,8,2849,"2018"
"44874","150190 BUJARU",1,3,11,440,19,474,"2018"
"44875","150195 CACHOEIRA DO PIRIA",0,2,2,277,25,306,"2018"
"44876","150200 CACHOEIRA DO ARARI",0,2,4,341,3,350,"2018"
"44877","150210 CAMETA",12,39,95,2431,101,2678,"2018"
"44878","150215 CANAA DOS CARAJAS",7,3,18,1203,1,1232,"2018"
"44879","150220 CAPANEMA",2,1,8,1028,7,1046,"2018"
"44880","150230 CAPITAO POCO",2,1,7,917,14,941,"2018"
"44881","150240 CASTANHAL",4,17,29,3245,10,3305,"2018"
"44882","150250 CHAVES",1,0,6,386,26,419,"2018"
"44883","150260 COLARES",1,0,3,171,9,184,"2018"
"44884","150270 CONCEICAO DO ARAGUAIA",0,3,8,779,1,791,"2018"
"44885","150275 CONCORDIA DO PARA",1,1,7,547,6,562,"2018"
"44886","150276 CUMARU DO NORTE",0,1,6,172,1,180,"2018"
"44887","150277 CURIONOPOLIS",1,0,1,306,0,308,"2018"
"44888","150280 CURRALINHO",1,9,8,618,112,748,"2018"
"44889","150285 CURUA",1,2,1,185,49,238,"2018"
"44890","150290 CURUCA",2,4,8,535,6,555,"2018"
"44891","150293 DOM ELISEU",2,2,16,622,5,647,"2018"
"44892","150295 ELDORADO DOS CARAJAS",2,0,10,516,2,530,"2018"
"44893","150300 FARO",0,0,5,134,3,142,"2018"
"44894","150304 FLORESTA DO ARAGUAIA",0,2,2,372,0,376,"2018"
"44895","150307 GARRAFAO DO NORTE",1,1,1,392,28,423,"2018"
"44896","150309 GOIANESIA DO PARA",0,0,4,549,22,575,"2018"
"44897","150310 GURUPA",1,1,6,707,49,764,"2018"
"44898","150320 IGARAPE-ACU",1,2,6,567,2,578,"2018"
"44899","150330 IGARAPE-MIRI",2,11,32,982,52,1079,"2018"
"44900","150340 INHANGAPI",0,2,4,179,0,185,"2018"
"44901","150345 IPIXUNA DO PARA",1,1,11,597,16,626,"2018"
"44902","150350 IRITUIA",1,4,8,399,22,434,"2018"
"44903","150360 ITAITUBA",9,14,90,2170,8,2291,"2018"
"44904","150370 ITUPIRANGA",1,1,12,824,6,844,"2018"
"44905","150375 JACAREACANGA",0,0,3,367,232,602,"2018"
"44906","150380 JACUNDA",0,2,9,726,14,751,"2018"
"44907","150390 JURUTI",2,3,25,980,81,1091,"2018"
"44908","150400 LIMOEIRO DO AJURU",3,2,15,390,33,443,"2018"
"44909","150405 MAE DO RIO",1,5,10,621,11,648,"2018"
"44910","150410 MAGALHAES BARATA",1,0,1,91,0,93,"2018"
"44911","150420 MARABA",4,17,44,4846,32,4943,"2018"
"44912","150430 MARACANA",2,2,8,366,6,384,"2018"
"44913","150440 MARAPANIM",1,1,2,280,8,292,"2018"
"44914","150442 MARITUBA",9,6,13,1681,5,1714,"2018"
"44915","150445 MEDICILANDIA",0,2,4,415,1,422,"2018"
"44916","150450 MELGACO",1,6,21,425,178,631,"2018"
"44917","150460 MOCAJUBA",4,3,6,443,8,464,"2018"
"44918","150470 MOJU",9,8,16,1241,38,1312,"2018"
"44919","150475 MOJUI DOS CAMPOS",1,2,9,272,5,289,"2018"
"44920","150480 MONTE ALEGRE",2,4,29,996,1,1032,"2018"
"44921","150490 MUANA",4,8,14,545,7,578,"2018"
"44922","150495 NOVA ESPERANCA DO PIRIA",1,3,4,398,0,406,"2018"
"44923","150497 NOVA IPIXUNA",1,2,6,213,1,223,"2018"
"44924","150500 NOVA TIMBOTEUA",0,0,1,131,2,134,"2018"
"44925","150503 NOVO PROGRESSO",1,7,9,613,1,631,"2018"
"44926","150506 NOVO REPARTIMENTO",4,2,10,1203,21,1240,"2018"
"44927","150510 OBIDOS",3,1,5,922,88,1019,"2018"
"44928","150520 OEIRAS DO PARA",1,5,27,652,41,726,"2018"
"44929","150530 ORIXIMINA",18,3,31,1457,38,1547,"2018"
"44930","150540 OUREM",1,1,5,315,0,322,"2018"
"44931","150543 OURILANDIA DO NORTE",1,2,12,710,0,725,"2018"
"44932","150548 PACAJA",2,2,4,724,12,744,"2018"
"44933","150549 PALESTINA DO PARA",0,0,2,106,2,110,"2018"
"44934","150550 PARAGOMINAS",7,7,29,2098,7,2148,"2018"
"44935","150553 PARAUAPEBAS",18,17,57,4711,7,4810,"2018"
"44936","150555 PAU D'ARCO",0,2,4,121,0,127,"2018"
"44937","150560 PEIXE-BOI",0,0,1,101,1,103,"2018"
"44938","150563 PICARRA",0,2,2,170,2,176,"2018"
"44939","150565 PLACAS",3,2,5,310,1,321,"2018"
"44940","150570 PONTA DE PEDRAS",1,0,4,335,11,351,"2018"
"44941","150580 PORTEL",1,3,13,1380,281,1678,"2018"
"44942","150590 PORTO DE MOZ",1,2,9,737,6,755,"2018"
"44943","150600 PRAINHA",0,6,25,551,121,703,"2018"
"44944","150610 PRIMAVERA",0,2,3,195,0,200,"2018"
"44945","150611 QUATIPURU",0,1,2,157,0,160,"2018"
"44946","150613 REDENCAO",3,6,24,1721,2,1756,"2018"
"44947","150616 RIO MARIA",1,0,9,297,1,308,"2018"
"44948","150618 RONDON DO PARA",1,2,18,587,2,610,"2018"
"44949","150619 RUROPOLIS",0,1,11,400,1,413,"2018"
"44950","150620 SALINOPOLIS",1,1,1,670,3,676,"2018"
"44951","150630 SALVATERRA",0,0,2,359,1,362,"2018"
"44952","150635 SANTA BARBARA DO PARA",1,2,5,316,2,326,"2018"
"44953","150640 SANTA CRUZ DO ARARI",2,0,1,62,16,81,"2018"
"44954","150650 SANTA IZABEL DO PARA",1,6,16,993,3,1019,"2018"
"44955","150655 SANTA LUZIA DO PARA",0,0,1,293,11,305,"2018"
"44956","150658 SANTA MARIA DAS BARREIRAS",0,3,2,176,0,181,"2018"
"44957","150660 SANTA MARIA DO PARA",0,3,5,390,1,399,"2018"
"44958","150670 SANTANA DO ARAGUAIA",0,1,10,594,0,605,"2018"
"44959","150680 SANTAREM",31,60,142,6016,454,6703,"2018"
"44960","150690 SANTAREM NOVO",1,0,0,86,0,87,"2018"
"44961","150700 SANTO ANTONIO DO TAUA",1,1,7,480,12,501,"2018"
"44962","150710 SAO CAETANO DE ODIVELAS",2,2,1,221,1,227,"2018"
"44963","150715 SAO DOMINGOS DO ARAGUAIA",0,1,4,416,1,422,"2018"
"44964","150720 SAO DOMINGOS DO CAPIM",0,1,11,448,10,470,"2018"
"44965","150730 SAO FELIX DO XINGU",5,8,33,1108,5,1159,"2018"
"44966","150740 SAO FRANCISCO DO PARA",0,2,5,234,1,242,"2018"
"44967","150745 SAO GERALDO DO ARAGUAIA",1,3,2,529,1,536,"2018"
"44968","150746 SAO JOAO DA PONTA",0,0,1,90,6,97,"2018"
"44969","150747 SAO JOAO DE PIRABAS",0,1,3,294,8,306,"2018"
"44970","150750 SAO JOAO DO ARAGUAIA",0,0,1,238,1,240,"2018"
"44971","150760 SAO MIGUEL DO GUAMA",7,5,7,920,3,942,"2018"
"44972","150770 SAO SEBASTIAO DA BOA VISTA",2,5,19,488,3,517,"2018"
"44973","150775 SAPUCAIA",2,0,1,116,0,119,"2018"
"44974","150780 SENADOR JOSE PORFIRIO",0,2,2,289,0,293,"2018"
"44975","150790 SOURE",1,0,1,393,0,395,"2018"
"44976","150795 TAILANDIA",3,3,12,1441,3,1462,"2018"
"44977","150796 TERRA ALTA",3,2,1,167,2,175,"2018"
"44978","150797 TERRA SANTA",0,3,16,327,0,346,"2018"
"44979","150800 TOME-ACU",0,8,21,1452,7,1488,"2018"
"44980","150803 TRACUATEUA",1,2,7,490,3,503,"2018"
"44981","150805 TRAIRAO",1,1,2,257,1,262,"2018"
"44982","150808 TUCUMA",0,1,12,749,0,762,"2018"
"44983","150810 TUCURUI",10,9,28,1634,219,1900,"2018"
"44984","150812 ULIANOPOLIS",0,2,13,460,0,475,"2018"
"44985","150815 URUARA",2,5,5,779,2,793,"2018"
"44986","150820 VIGIA",2,2,6,737,1,748,"2018"
"44987","150830 VISEU",2,2,12,902,229,1147,"2018"
"44988","150835 VITORIA DO XINGU",3,4,3,378,0,388,"2018"
"44989","150840 XINGUARA",2,5,17,925,1,950,"2018"
"44990","160005 SERRA DO NAVIO",0,0,0,76,0,76,"2018"
"44991","160010 AMAPA",0,1,0,180,7,188,"2018"
"44992","160015 PEDRA BRANCA DO AMAPARI",0,4,3,273,23,303,"2018"
"44993","160020 CALCOENE",0,1,2,219,1,223,"2018"
"44994","160021 CUTIAS",0,0,1,102,15,118,"2018"
"44995","160023 FERREIRA GOMES",0,0,3,160,5,168,"2018"
"44996","160025 ITAUBAL",0,1,1,141,14,157,"2018"
"44997","160027 LARANJAL DO JARI",0,3,5,820,2,830,"2018"
"44998","160030 MACAPA",49,22,97,8981,144,9293,"2018"
"44999","160040 MAZAGAO",1,3,10,463,39,516,"2018"
"45000","160050 OIAPOQUE",0,8,15,478,76,577,"2018"
"45001","160053 PORTO GRANDE",4,1,4,427,4,440,"2018"
"45002","160055 PRACUUBA",0,0,0,59,18,77,"2018"
"45003","160060 SANTANA",3,5,33,2216,22,2279,"2018"
"45004","160070 TARTARUGALZINHO",1,1,2,237,78,319,"2018"
"45005","160080 VITORIA DO JARI",0,1,8,288,3,300,"2018"
"45006","170025 ABREULANDIA",0,0,0,43,1,44,"2018"
"45007","170030 AGUIARNOPOLIS",0,0,0,74,3,77,"2018"
"45008","170035 ALIANCA DO TOCANTINS",0,0,0,71,1,72,"2018"
"45009","170040 ALMAS",0,0,1,106,1,108,"2018"
"45010","170070 ALVORADA",0,0,0,131,1,132,"2018"
"45011","170100 ANANAS",0,0,6,161,0,167,"2018"
"45012","170105 ANGICO",0,0,0,38,1,39,"2018"
"45013","170110 APARECIDA DO RIO NEGRO",1,1,0,83,0,85,"2018"
"45014","170130 ARAGOMINAS",0,0,3,72,0,75,"2018"
"45015","170190 ARAGUACEMA",0,0,1,98,1,100,"2018"
"45016","170200 ARAGUACU",0,0,1,85,0,86,"2018"
"45017","170210 ARAGUAINA",7,7,65,3260,18,3357,"2018"
"45018","170215 ARAGUANA",0,0,4,86,0,90,"2018"
"45019","170220 ARAGUATINS",1,3,8,440,50,502,"2018"
"45020","170230 ARAPOEMA",0,0,1,100,0,101,"2018"
"45021","170240 ARRAIAS",0,1,2,140,2,145,"2018"
"45022","170255 AUGUSTINOPOLIS",0,0,8,327,39,374,"2018"
"45023","170270 AURORA DO TOCANTINS",0,0,1,28,1,30,"2018"
"45024","170290 AXIXA DO TOCANTINS",0,2,3,183,15,203,"2018"
"45025","170300 BABACULANDIA",0,0,1,102,0,103,"2018"
"45026","170305 BANDEIRANTES DO TOCANTINS",0,0,1,50,0,51,"2018"
"45027","170307 BARRA DO OURO",0,2,1,76,4,83,"2018"
"45028","170310 BARROLANDIA",0,0,0,66,0,66,"2018"
"45029","170320 BERNARDO SAYAO",0,0,1,49,0,50,"2018"
"45030","170330 BOM JESUS DO TOCANTINS",0,0,0,79,1,80,"2018"
"45031","170360 BRASILANDIA DO TOCANTINS",0,0,2,24,0,26,"2018"
"45032","170370 BREJINHO DE NAZARE",0,2,0,62,1,65,"2018"
"45033","170380 BURITI DO TOCANTINS",0,0,3,119,13,135,"2018"
"45034","170382 CACHOEIRINHA",0,0,0,34,6,40,"2018"
"45035","170384 CAMPOS LINDOS",0,2,4,171,12,189,"2018"
"45036","170386 CARIRI DO TOCANTINS",0,0,0,64,1,65,"2018"
"45037","170388 CARMOLANDIA",0,0,0,37,0,37,"2018"
"45038","170389 CARRASCO BONITO",0,0,2,61,7,70,"2018"
"45039","170390 CASEARA",0,1,0,89,1,91,"2018"
"45040","170410 CENTENARIO",0,0,1,23,1,25,"2018"
"45041","170460 CHAPADA DE AREIA",0,0,0,19,0,19,"2018"
"45042","170510 CHAPADA DA NATIVIDADE",0,0,1,35,0,36,"2018"
"45043","170550 COLINAS DO TOCANTINS",0,2,8,555,7,572,"2018"
"45044","170555 COMBINADO",2,0,0,54,0,56,"2018"
"45045","170560 CONCEICAO DO TOCANTINS",1,0,2,61,1,65,"2018"
"45046","170600 COUTO MAGALHAES",0,0,1,83,0,84,"2018"
"45047","170610 CRISTALANDIA",0,0,0,82,3,85,"2018"
"45048","170625 CRIXAS DO TOCANTINS",0,0,0,20,0,20,"2018"
"45049","170650 DARCINOPOLIS",0,1,1,81,8,91,"2018"
"45050","170700 DIANOPOLIS",2,2,4,353,3,364,"2018"
"45051","170710 DIVINOPOLIS DO TOCANTINS",0,0,0,107,2,109,"2018"
"45052","170720 DOIS IRMAOS DO TOCANTINS",0,0,0,67,2,69,"2018"
"45053","170730 DUERE",0,0,1,53,0,54,"2018"
"45054","170740 ESPERANTINA",0,0,8,133,9,150,"2018"
"45055","170755 FATIMA",0,0,0,43,0,43,"2018"
"45056","170765 FIGUEIROPOLIS",0,0,0,71,0,71,"2018"
"45057","170770 FILADELFIA",1,0,1,107,3,112,"2018"
"45058","170820 FORMOSO DO ARAGUAIA",0,1,0,279,0,280,"2018"
"45059","170825 FORTALEZA DO TABOCAO",0,0,1,55,0,56,"2018"
"45060","170830 GOIANORTE",0,0,0,61,0,61,"2018"
"45061","170900 GOIATINS",0,2,4,215,25,246,"2018"
"45062","170930 GUARAI",1,2,6,356,0,365,"2018"
"45063","170950 GURUPI",6,4,7,1350,2,1369,"2018"
"45064","170980 IPUEIRAS",0,0,0,26,0,26,"2018"
"45065","171050 ITACAJA",0,1,3,143,2,149,"2018"
"45066","171070 ITAGUATINS",0,0,2,48,5,55,"2018"
"45067","171090 ITAPIRATINS",0,0,1,60,1,62,"2018"
"45068","171110 ITAPORA DO TOCANTINS",0,0,1,33,0,34,"2018"
"45069","171150 JAU DO TOCANTINS",0,0,0,37,1,38,"2018"
"45070","171180 JUARINA",0,0,1,35,0,36,"2018"
"45071","171190 LAGOA DA CONFUSAO",0,0,2,268,1,271,"2018"
"45072","171195 LAGOA DO TOCANTINS",1,1,1,61,3,67,"2018"
"45073","171200 LAJEADO",0,1,0,49,0,50,"2018"
"45074","171215 LAVANDEIRA",0,0,0,13,0,13,"2018"
"45075","171240 LIZARDA",0,0,0,45,3,48,"2018"
"45076","171245 LUZINOPOLIS",0,0,0,48,1,49,"2018"
"45077","171250 MARIANOPOLIS DO TOCANTINS",0,0,0,71,0,71,"2018"
"45078","171270 MATEIROS",0,0,0,42,1,43,"2018"
"45079","171280 MAURILANDIA DO TOCANTINS",0,0,0,28,3,31,"2018"
"45080","171320 MIRACEMA DO TOCANTINS",0,1,3,317,2,323,"2018"
"45081","171330 MIRANORTE",0,0,2,182,0,184,"2018"
"45082","171360 MONTE DO CARMO",0,0,0,98,2,100,"2018"
"45083","171370 MONTE SANTO DO TOCANTINS",0,0,2,35,0,37,"2018"
"45084","171380 PALMEIRAS DO TOCANTINS",0,0,2,82,0,84,"2018"
"45085","171395 MURICILANDIA",0,0,1,62,2,65,"2018"
"45086","171420 NATIVIDADE",0,1,2,138,0,141,"2018"
"45087","171430 NAZARE",0,0,1,71,1,73,"2018"
"45088","171488 NOVA OLINDA",1,1,5,169,3,179,"2018"
"45089","171500 NOVA ROSALANDIA",0,0,0,43,0,43,"2018"
"45090","171510 NOVO ACORDO",0,1,0,69,3,73,"2018"
"45091","171515 NOVO ALEGRE",0,0,0,17,1,18,"2018"
"45092","171525 NOVO JARDIM",0,0,1,25,1,27,"2018"
"45093","171550 OLIVEIRA DE FATIMA",0,0,0,21,0,21,"2018"
"45094","171570 PALMEIRANTE",0,0,1,58,0,59,"2018"
"45095","171575 PALMEIROPOLIS",0,0,0,99,0,99,"2018"
"45096","171610 PARAISO DO TOCANTINS",1,0,3,861,7,872,"2018"
"45097","171620 PARANA",0,2,1,173,2,178,"2018"
"45098","171630 PAU D'ARCO",0,0,2,70,0,72,"2018"
"45099","171650 PEDRO AFONSO",0,0,3,235,2,240,"2018"
"45100","171660 PEIXE",0,0,0,143,1,144,"2018"
"45101","171665 PEQUIZEIRO",0,0,0,64,1,65,"2018"
"45102","171670 COLMEIA",0,0,1,119,1,121,"2018"
"45103","171700 PINDORAMA DO TOCANTINS",1,0,0,71,2,74,"2018"
"45104","171720 PIRAQUE",0,0,4,26,0,30,"2018"
"45105","171750 PIUM",1,0,2,84,1,88,"2018"
"45106","171780 PONTE ALTA DO BOM JESUS",0,1,1,52,2,56,"2018"
"45107","171790 PONTE ALTA DO TOCANTINS",0,0,1,102,1,104,"2018"
"45108","171800 PORTO ALEGRE DO TOCANTINS",0,0,3,47,1,51,"2018"
"45109","171820 PORTO NACIONAL",3,9,14,1165,1,1192,"2018"
"45110","171830 PRAIA NORTE",0,0,3,89,11,103,"2018"
"45111","171840 PRESIDENTE KENNEDY",0,0,1,45,1,47,"2018"
"45112","171845 PUGMIL",0,0,0,28,0,28,"2018"
"45113","171850 RECURSOLANDIA",0,0,0,45,0,45,"2018"
"45114","171855 RIACHINHO",0,0,0,55,2,57,"2018"
"45115","171865 RIO DA CONCEICAO",0,0,3,38,0,41,"2018"
"45116","171870 RIO DOS BOIS",0,0,2,35,0,37,"2018"
"45117","171875 RIO SONO",0,0,2,60,1,63,"2018"
"45118","171880 SAMPAIO",4,1,3,85,8,101,"2018"
"45119","171884 SANDOLANDIA",0,0,1,44,0,45,"2018"
"45120","171886 SANTA FE DO ARAGUAIA",0,1,1,129,1,132,"2018"
"45121","171888 SANTA MARIA DO TOCANTINS",1,0,0,43,0,44,"2018"
"45122","171889 SANTA RITA DO TOCANTINS",0,1,0,23,0,24,"2018"
"45123","171890 SANTA ROSA DO TOCANTINS",1,1,1,79,0,82,"2018"
"45124","171900 SANTA TEREZA DO TOCANTINS",0,0,0,44,0,44,"2018"
"45125","172000 SANTA TEREZINHA DO TOCANTINS",0,1,1,22,1,25,"2018"
"45126","172010 SAO BENTO DO TOCANTINS",0,1,0,79,9,89,"2018"
"45127","172015 SAO FELIX DO TOCANTINS",0,0,1,29,1,31,"2018"
"45128","172020 SAO MIGUEL DO TOCANTINS",0,1,6,149,6,162,"2018"
"45129","172025 SAO SALVADOR DO TOCANTINS",0,1,0,28,0,29,"2018"
"45130","172030 SAO SEBASTIAO DO TOCANTINS",0,1,0,60,11,72,"2018"
"45131","172049 SAO VALERIO",0,1,0,59,1,61,"2018"
"45132","172065 SILVANOPOLIS",1,0,3,75,0,79,"2018"
"45133","172080 SITIO NOVO DO TOCANTINS",0,0,2,158,2,162,"2018"
"45134","172085 SUCUPIRA",0,0,0,23,0,23,"2018"
"45135","172090 TAGUATINGA",0,0,2,170,1,173,"2018"
"45136","172093 TAIPAS DO TOCANTINS",0,0,2,22,1,25,"2018"
"45137","172097 TALISMA",0,0,0,30,0,30,"2018"
"45138","172100 PALMAS",6,7,44,5284,12,5353,"2018"
"45139","172110 TOCANTINIA",1,0,2,227,1,231,"2018"
"45140","172120 TOCANTINOPOLIS",1,1,5,411,5,423,"2018"
"45141","172125 TUPIRAMA",0,0,0,22,0,22,"2018"
"45142","172130 TUPIRATINS",0,0,0,16,0,16,"2018"
"45143","172208 WANDERLANDIA",0,1,2,142,2,147,"2018"
"45144","172210 XAMBIOA",0,1,7,229,1,238,"2018"
"45145","MUNICIPIO IGNORADO - MA",0,0,2,5,0,7,"2018"
"45146","210005 ACAILANDIA",4,8,51,1881,5,1949,"2018"
"45147","210010 AFONSO CUNHA",0,1,10,132,0,143,"2018"
"45148","210015 AGUA DOCE DO MARANHAO",0,1,1,158,5,165,"2018"
"45149","210020 ALCANTARA",1,0,4,176,51,232,"2018"
"45150","210030 ALDEIAS ALTAS",1,0,14,430,2,447,"2018"
"45151","210040 ALTAMIRA DO MARANHAO",0,0,0,98,2,100,"2018"
"45152","210043 ALTO ALEGRE DO MARANHAO",0,0,3,454,0,457,"2018"
"45153","210047 ALTO ALEGRE DO PINDARE",2,2,8,480,5,497,"2018"
"45154","210050 ALTO PARNAIBA",0,2,3,154,3,162,"2018"
"45155","210055 AMAPA DO MARANHAO",0,0,4,112,2,118,"2018"
"45156","210060 AMARANTE DO MARANHAO",2,4,12,788,56,862,"2018"
"45157","210070 ANAJATUBA",3,3,9,344,2,361,"2018"
"45158","210080 ANAPURUS",0,1,2,320,0,323,"2018"
"45159","210083 APICUM-ACU",1,0,0,61,205,267,"2018"
"45160","210087 ARAGUANA",0,1,1,117,0,119,"2018"
"45161","210090 ARAIOSES",2,12,27,526,44,611,"2018"
"45162","210095 ARAME",0,2,21,513,4,540,"2018"
"45163","210100 ARARI",0,0,18,488,7,513,"2018"
"45164","210110 AXIXA",0,1,2,165,6,174,"2018"
"45165","210120 BACABAL",5,11,42,1621,8,1687,"2018"
"45166","210125 BACABEIRA",0,2,10,278,3,293,"2018"
"45167","210130 BACURI",0,1,1,114,152,268,"2018"
"45168","210135 BACURITUBA",0,0,0,65,0,65,"2018"
"45169","210140 BALSAS",6,9,21,2024,17,2077,"2018"
"45170","210150 BARAO DE GRAJAU",0,2,4,312,0,318,"2018"
"45171","210160 BARRA DO CORDA",3,4,13,1589,32,1641,"2018"
"45172","210170 BARREIRINHAS",2,2,6,1247,23,1280,"2018"
"45173","210173 BELAGUA",2,0,0,81,129,212,"2018"
"45174","210177 BELA VISTA DO MARANHAO",0,2,3,215,1,221,"2018"
"45175","210180 BENEDITO LEITE",1,0,0,54,9,64,"2018"
"45176","210190 BEQUIMAO",0,1,4,94,189,288,"2018"
"45177","210193 BERNARDO DO MEARIM",0,1,0,80,1,82,"2018"
"45178","210197 BOA VISTA DO GURUPI",0,0,1,130,2,133,"2018"
"45179","210200 BOM JARDIM",3,2,7,567,22,601,"2018"
"45180","210203 BOM JESUS DAS SELVAS",1,8,8,553,1,571,"2018"
"45181","210207 BOM LUGAR",0,1,5,162,0,168,"2018"
"45182","210210 BREJO",0,0,3,561,1,565,"2018"
"45183","210215 BREJO DE AREIA",1,0,1,137,3,142,"2018"
"45184","210220 BURITI",1,7,20,543,9,580,"2018"
"45185","210230 BURITI BRAVO",16,2,5,400,5,428,"2018"
"45186","210232 BURITICUPU",0,7,14,1384,9,1414,"2018"
"45187","210235 BURITIRANA",0,0,6,202,5,213,"2018"
"45188","210237 CACHOEIRA GRANDE",0,1,2,156,4,163,"2018"
"45189","210240 CAJAPIO",0,0,1,45,100,146,"2018"
"45190","210250 CAJARI",1,0,2,129,109,241,"2018"
"45191","210255 CAMPESTRE DO MARANHAO",1,3,9,219,4,236,"2018"
"45192","210260 CANDIDO MENDES",1,1,4,288,42,336,"2018"
"45193","210270 CANTANHEDE",0,1,1,261,1,264,"2018"
"45194","210275 CAPINZAL DO NORTE",0,0,2,163,4,169,"2018"
"45195","210280 CAROLINA",2,2,13,366,4,387,"2018"
"45196","210290 CARUTAPERA",1,0,5,426,7,439,"2018"
"45197","210300 CAXIAS",1,3,77,2610,15,2706,"2018"
"45198","210310 CEDRAL",0,0,1,80,30,111,"2018"
"45199","210312 CENTRAL DO MARANHAO",3,0,2,117,33,155,"2018"
"45200","210315 CENTRO DO GUILHERME",0,7,3,210,7,227,"2018"
"45201","210317 CENTRO NOVO DO MARANHAO",1,2,3,334,17,357,"2018"
"45202","210320 CHAPADINHA",7,10,29,1498,6,1550,"2018"
"45203","210325 CIDELANDIA",2,1,4,186,8,201,"2018"
"45204","210330 CODO",3,13,59,1837,33,1945,"2018"
"45205","210340 COELHO NETO",0,3,29,738,2,772,"2018"
"45206","210350 COLINAS",2,3,8,707,0,720,"2018"
"45207","210355 CONCEICAO DO LAGO-ACU",0,0,3,235,13,251,"2018"
"45208","210360 COROATA",1,5,15,1089,7,1117,"2018"
"45209","210370 CURURUPU",4,5,0,322,248,579,"2018"
"45210","210375 DAVINOPOLIS",1,0,13,234,0,248,"2018"
"45211","210380 DOM PEDRO",1,1,0,376,6,384,"2018"
"45212","210390 DUQUE BACELAR",2,0,5,194,1,202,"2018"
"45213","210400 ESPERANTINOPOLIS",0,1,3,365,2,371,"2018"
"45214","210405 ESTREITO",2,0,8,407,191,608,"2018"
"45215","210407 FEIRA NOVA DO MARANHAO",0,0,0,81,5,86,"2018"
"45216","210408 FERNANDO FALCAO",1,1,1,180,67,250,"2018"
"45217","210409 FORMOSA DA SERRA NEGRA",0,1,1,98,120,220,"2018"
"45218","210410 FORTALEZA DOS NOGUEIRAS",1,1,3,201,22,228,"2018"
"45219","210420 FORTUNA",0,1,8,320,3,332,"2018"
"45220","210430 GODOFREDO VIANA",0,0,3,151,13,167,"2018"
"45221","210440 GONCALVES DIAS",0,2,2,97,114,215,"2018"
"45222","210450 GOVERNADOR ARCHER",0,0,1,149,0,150,"2018"
"45223","210455 GOVERNADOR EDISON LOBAO",1,1,11,310,2,325,"2018"
"45224","210460 GOVERNADOR EUGENIO BARROS",1,1,10,237,0,249,"2018"
"45225","210462 GOVERNADOR LUIZ ROCHA",0,1,2,125,1,129,"2018"
"45226","210465 GOVERNADOR NEWTON BELLO",0,1,8,133,4,146,"2018"
"45227","210467 GOVERNADOR NUNES FREIRE",1,1,8,477,5,492,"2018"
"45228","210470 GRACA ARANHA",1,0,0,82,1,84,"2018"
"45229","210480 GRAJAU",1,1,36,1522,17,1577,"2018"
"45230","210490 GUIMARAES",1,2,0,147,27,177,"2018"
"45231","210500 HUMBERTO DE CAMPOS",1,2,5,520,49,577,"2018"
"45232","210510 ICATU",0,3,6,351,11,371,"2018"
"45233","210515 IGARAPE DO MEIO",0,1,3,248,6,258,"2018"
"45234","210520 IGARAPE GRANDE",0,0,2,144,3,149,"2018"
"45235","210530 IMPERATRIZ",18,26,114,5096,20,5274,"2018"
"45236","210535 ITAIPAVA DO GRAJAU",0,0,6,304,0,310,"2018"
"45237","210540 ITAPECURU MIRIM",2,4,9,1272,19,1306,"2018"
"45238","210542 ITINGA DO MARANHAO",1,2,6,368,1,378,"2018"
"45239","210545 JATOBA",0,1,0,132,0,133,"2018"
"45240","210547 JENIPAPO DOS VIEIRAS",0,0,4,342,57,403,"2018"
"45241","210550 JOAO LISBOA",2,0,19,456,1,478,"2018"
"45242","210560 JOSELANDIA",1,0,0,267,3,271,"2018"
"45243","210565 JUNCO DO MARANHAO",1,1,2,126,5,135,"2018"
"45244","210570 LAGO DA PEDRA",6,1,20,841,0,868,"2018"
"45245","210580 LAGO DO JUNCO",0,2,0,183,0,185,"2018"
"45246","210590 LAGO VERDE",0,1,5,274,4,284,"2018"
"45247","210592 LAGOA DO MATO",0,1,3,118,2,124,"2018"
"45248","210594 LAGO DOS RODRIGUES",0,0,1,146,0,147,"2018"
"45249","210596 LAGOA GRANDE DO MARANHAO",0,1,3,232,0,236,"2018"
"45250","210598 LAJEADO NOVO",0,1,3,90,0,94,"2018"
"45251","210600 LIMA CAMPOS",1,3,2,193,2,201,"2018"
"45252","210610 LORETO",1,0,2,53,109,165,"2018"
"45253","210620 LUIS DOMINGUES",0,1,4,95,46,146,"2018"
"45254","210630 MAGALHAES DE ALMEIDA",0,2,10,187,3,202,"2018"
"45255","210632 MARACACUME",0,3,3,353,3,362,"2018"
"45256","210635 MARAJA DO SENA",1,0,0,84,4,89,"2018"
"45257","210637 MARANHAOZINHO",1,4,4,179,5,193,"2018"
"45258","210640 MATA ROMA",2,4,1,327,9,343,"2018"
"45259","210650 MATINHA",2,1,2,47,391,443,"2018"
"45260","210660 MATOES",0,2,8,532,2,544,"2018"
"45261","210663 MATOES DO NORTE",0,0,1,120,0,121,"2018"
"45262","210667 MILAGRES DO MARANHAO",0,1,6,63,1,71,"2018"
"45263","210670 MIRADOR",2,2,3,381,1,389,"2018"
"45264","210675 MIRANDA DO NORTE",2,2,3,328,3,338,"2018"
"45265","210680 MIRINZAL",3,2,1,52,219,277,"2018"
"45266","210690 MONCAO",2,1,2,592,14,611,"2018"
"45267","210700 MONTES ALTOS",0,0,6,155,3,164,"2018"
"45268","210710 MORROS",1,2,3,417,31,454,"2018"
"45269","210720 NINA RODRIGUES",2,2,15,204,5,228,"2018"
"45270","210725 NOVA COLINAS",1,0,0,99,0,100,"2018"
"45271","210730 NOVA IORQUE",0,0,0,43,9,52,"2018"
"45272","210735 NOVA OLINDA DO MARANHAO",0,2,10,305,14,331,"2018"
"45273","210740 OLHO D'AGUA DAS CUNHAS",1,1,1,270,0,273,"2018"
"45274","210745 OLINDA NOVA DO MARANHAO",1,3,1,30,220,255,"2018"
"45275","210750 PACO DO LUMIAR",9,8,30,1694,34,1775,"2018"
"45276","210760 PALMEIRANDIA",1,2,6,267,30,306,"2018"
"45277","210770 PARAIBANO",0,4,8,320,1,333,"2018"
"45278","210780 PARNARAMA",1,4,8,434,34,481,"2018"
"45279","210790 PASSAGEM FRANCA",0,3,4,374,0,381,"2018"
"45280","210800 PASTOS BONS",0,0,2,57,294,353,"2018"
"45281","210805 PAULINO NEVES",1,1,1,335,17,355,"2018"
"45282","210810 PAULO RAMOS",1,1,4,378,0,384,"2018"
"45283","210820 PEDREIRAS",3,1,7,562,0,573,"2018"
"45284","210825 PEDRO DO ROSARIO",0,0,13,322,48,383,"2018"
"45285","210830 PENALVA",0,3,4,615,47,669,"2018"
"45286","210840 PERI MIRIM",0,0,4,91,3,98,"2018"
"45287","210845 PERITORO",0,2,4,371,2,379,"2018"
"45288","210850 PINDARE-MIRIM",0,0,8,479,3,490,"2018"
"45289","210860 PINHEIRO",4,6,59,1524,44,1637,"2018"
"45290","210870 PIO XII",0,2,2,414,1,419,"2018"
"45291","210880 PIRAPEMAS",0,2,5,281,2,290,"2018"
"45292","210890 POCAO DE PEDRAS",0,0,0,210,0,210,"2018"
"45293","210900 PORTO FRANCO",1,0,8,464,2,475,"2018"
"45294","210905 PORTO RICO DO MARANHAO",2,1,0,62,11,76,"2018"
"45295","210910 PRESIDENTE DUTRA",1,2,8,823,0,834,"2018"
"45296","210920 PRESIDENTE JUSCELINO",1,0,4,231,20,256,"2018"
"45297","210923 PRESIDENTE MEDICI",0,2,2,93,1,98,"2018"
"45298","210927 PRESIDENTE SARNEY",1,1,7,329,45,383,"2018"
"45299","210930 PRESIDENTE VARGAS",1,3,9,187,11,211,"2018"
"45300","210940 PRIMEIRA CRUZ",0,0,3,191,19,213,"2018"
"45301","210945 RAPOSA",0,1,11,472,8,492,"2018"
"45302","210950 RIACHAO",0,0,3,379,0,382,"2018"
"45303","210955 RIBAMAR FIQUENE",2,0,6,113,2,123,"2018"
"45304","210960 ROSARIO",6,3,18,587,17,631,"2018"
"45305","210970 SAMBAIBA",0,0,3,78,0,81,"2018"
"45306","210975 SANTA FILOMENA DO MARANHAO",1,0,0,89,0,90,"2018"
"45307","210980 SANTA HELENA",0,0,13,498,72,583,"2018"
"45308","210990 SANTA INES",0,3,25,1656,6,1690,"2018"
"45309","211000 SANTA LUZIA",0,4,13,1098,41,1156,"2018"
"45310","211003 SANTA LUZIA DO PARUA",1,0,7,341,2,351,"2018"
"45311","211010 SANTA QUITERIA DO MARANHAO",2,2,55,462,8,529,"2018"
"45312","211020 SANTA RITA",6,3,32,570,2,613,"2018"
"45313","211023 SANTANA DO MARANHAO",0,0,2,125,3,130,"2018"
"45314","211027 SANTO AMARO DO MARANHAO",0,0,3,142,70,215,"2018"
"45315","211030 SANTO ANTONIO DOS LOPES",0,0,2,261,0,263,"2018"
"45316","211040 SAO BENEDITO DO RIO PRETO",0,0,3,324,34,361,"2018"
"45317","211050 SAO BENTO",1,3,7,538,11,560,"2018"
"45318","211060 SAO BERNARDO",4,1,8,421,3,437,"2018"
"45319","211065 SAO DOMINGOS DO AZEITAO",2,0,0,54,57,113,"2018"
"45320","211070 SAO DOMINGOS DO MARANHAO",0,0,5,562,3,570,"2018"
"45321","211080 SAO FELIX DE BALSAS",0,0,1,22,46,69,"2018"
"45322","211085 SAO FRANCISCO DO BREJAO",2,3,0,109,0,114,"2018"
"45323","211090 SAO FRANCISCO DO MARANHAO",0,0,1,132,17,150,"2018"
"45324","211100 SAO JOAO BATISTA",1,3,15,202,50,271,"2018"
"45325","211102 SAO JOAO DO CARU",0,0,16,246,1,263,"2018"
"45326","211105 SAO JOAO DO PARAISO",0,1,8,130,6,145,"2018"
"45327","211107 SAO JOAO DO SOTER",0,0,7,292,9,308,"2018"
"45328","211110 SAO JOAO DOS PATOS",2,1,3,390,0,396,"2018"
"45329","211120 SAO JOSE DE RIBAMAR",13,14,61,3631,72,3791,"2018"
"45330","211125 SAO JOSE DOS BASILIOS",2,0,0,96,0,98,"2018"
"45331","211130 SAO LUIS",69,61,245,15386,198,15959,"2018"
"45332","211140 SAO LUIS GONZAGA DO MARANHAO",2,0,6,294,3,305,"2018"
"45333","211150 SAO MATEUS DO MARANHAO",1,2,6,683,0,692,"2018"
"45334","211153 SAO PEDRO DA AGUA BRANCA",1,1,5,181,1,189,"2018"
"45335","211157 SAO PEDRO DOS CRENTES",0,0,0,90,3,93,"2018"
"45336","211160 SAO RAIMUNDO DAS MANGABEIRAS",0,0,2,274,44,320,"2018"
"45337","211163 SAO RAIMUNDO DO DOCA BEZERRA",0,1,2,92,1,96,"2018"
"45338","211167 SAO ROBERTO",0,0,1,74,0,75,"2018"
"45339","211170 SAO VICENTE FERRER",0,0,1,43,255,299,"2018"
"45340","211172 SATUBINHA",1,0,1,94,0,96,"2018"
"45341","211174 SENADOR ALEXANDRE COSTA",1,4,4,169,1,179,"2018"
"45342","211176 SENADOR LA ROCQUE",0,0,13,265,2,280,"2018"
"45343","211178 SERRANO DO MARANHAO",5,1,1,77,77,161,"2018"
"45344","211180 SITIO NOVO",1,1,4,280,10,296,"2018"
"45345","211190 SUCUPIRA DO NORTE",0,0,3,170,2,175,"2018"
"45346","211195 SUCUPIRA DO RIACHAO",1,0,2,71,0,74,"2018"
"45347","211200 TASSO FRAGOSO",0,0,2,137,11,150,"2018"
"45348","211210 TIMBIRAS",0,2,8,525,2,537,"2018"
"45349","211220 TIMON",7,10,32,3031,6,3086,"2018"
"45350","211223 TRIZIDELA DO VALE",1,0,3,355,2,361,"2018"
"45351","211227 TUFILANDIA",0,0,2,78,2,82,"2018"
"45352","211230 TUNTUM",1,3,11,526,1,542,"2018"
"45353","211240 TURIACU",0,3,2,43,646,694,"2018"
"45354","211245 TURILANDIA",2,1,7,296,74,380,"2018"
"45355","211250 TUTOIA",1,4,15,956,32,1008,"2018"
"45356","211260 URBANO SANTOS",0,0,2,233,394,629,"2018"
"45357","211270 VARGEM GRANDE",1,4,24,872,32,933,"2018"
"45358","211280 VIANA",5,2,14,927,98,1046,"2018"
"45359","211285 VILA NOVA DOS MARTIRIOS",0,1,4,175,3,183,"2018"
"45360","211290 VITORIA DO MEARIM",0,2,7,484,9,502,"2018"
"45361","211300 VITORINO FREIRE",0,1,2,487,0,490,"2018"
"45362","211400 ZE DOCA",2,8,30,762,2,804,"2018"
"45363","MUNICIPIO IGNORADO - PI",0,0,0,1,0,1,"2018"
"45364","220005 ACAUA",0,0,0,70,25,95,"2018"
"45365","220010 AGRICOLANDIA",1,0,2,72,1,76,"2018"
"45366","220020 AGUA BRANCA",0,2,7,287,2,298,"2018"
"45367","220025 ALAGOINHA DO PIAUI",1,0,1,83,0,85,"2018"
"45368","220027 ALEGRETE DO PIAUI",1,0,1,52,0,54,"2018"
"45369","220030 ALTO LONGA",0,0,1,154,4,159,"2018"
"45370","220040 ALTOS",2,3,8,644,22,679,"2018"
"45371","220045 ALVORADA DO GURGUEIA",0,0,1,63,15,79,"2018"
"45372","220050 AMARANTE",2,3,8,281,5,299,"2018"
"45373","220060 ANGICAL DO PIAUI",0,0,2,81,4,87,"2018"
"45374","220070 ANISIO DE ABREU",0,0,2,107,14,123,"2018"
"45375","220080 ANTONIO ALMEIDA",0,0,0,40,0,40,"2018"
"45376","220090 AROAZES",0,0,2,67,1,70,"2018"
"45377","220095 AROEIRAS DO ITAIM",0,0,1,32,0,33,"2018"
"45378","220100 ARRAIAL",0,0,1,67,1,69,"2018"
"45379","220105 ASSUNCAO DO PIAUI",0,1,1,91,31,124,"2018"
"45380","220110 AVELINO LOPES",0,0,0,117,59,176,"2018"
"45381","220115 BAIXA GRANDE DO RIBEIRO",0,2,0,169,94,265,"2018"
"45382","220117 BARRA D'ALCANTARA",0,0,0,51,1,52,"2018"
"45383","220120 BARRAS",1,8,17,737,34,797,"2018"
"45384","220130 BARREIRAS DO PIAUI",0,0,0,18,33,51,"2018"
"45385","220140 BARRO DURO",0,0,4,86,7,97,"2018"
"45386","220150 BATALHA",1,3,6,370,3,383,"2018"
"45387","220155 BELA VISTA DO PIAUI",0,1,3,47,0,51,"2018"
"45388","220157 BELEM DO PIAUI",0,0,0,23,0,23,"2018"
"45389","220160 BENEDITINOS",1,0,1,104,18,124,"2018"
"45390","220170 BERTOLINIA",0,1,6,79,2,88,"2018"
"45391","220173 BETANIA DO PIAUI",0,0,3,83,30,116,"2018"
"45392","220177 BOA HORA",1,0,0,88,10,99,"2018"
"45393","220180 BOCAINA",1,0,0,47,0,48,"2018"
"45394","220190 BOM JESUS",0,1,8,368,140,517,"2018"
"45395","220191 BOM PRINCIPIO DO PIAUI",0,0,1,84,0,85,"2018"
"45396","220192 BONFIM DO PIAUI",0,0,0,65,10,75,"2018"
"45397","220194 BOQUEIRAO DO PIAUI",0,0,0,22,55,77,"2018"
"45398","220196 BRASILEIRA",1,1,0,90,0,92,"2018"
"45399","220198 BREJO DO PIAUI",0,0,0,41,5,46,"2018"
"45400","220200 BURITI DOS LOPES",0,0,1,347,0,348,"2018"
"45401","220202 BURITI DOS MONTES",1,0,0,44,20,65,"2018"
"45402","220205 CABECEIRAS DO PIAUI",0,0,0,54,57,111,"2018"
"45403","220207 CAJAZEIRAS DO PIAUI",0,1,1,34,0,36,"2018"
"45404","220208 CAJUEIRO DA PRAIA",0,1,1,99,1,102,"2018"
"45405","220209 CALDEIRAO GRANDE DO PIAUI",0,0,1,75,0,76,"2018"
"45406","220210 CAMPINAS DO PIAUI",0,0,0,54,0,54,"2018"
"45407","220211 CAMPO ALEGRE DO FIDALGO",0,0,0,68,1,69,"2018"
"45408","220213 CAMPO GRANDE DO PIAUI",0,1,3,88,1,93,"2018"
"45409","220217 CAMPO LARGO DO PIAUI",0,0,4,85,1,90,"2018"
"45410","220220 CAMPO MAIOR",2,3,3,185,396,589,"2018"
"45411","220225 CANAVIEIRA",0,0,4,44,3,51,"2018"
"45412","220230 CANTO DO BURITI",0,1,5,230,18,254,"2018"
"45413","220240 CAPITAO DE CAMPOS",1,3,1,114,54,173,"2018"
"45414","220245 CAPITAO GERVASIO OLIVEIRA",0,0,0,51,1,52,"2018"
"45415","220250 CARACOL",1,0,5,95,73,174,"2018"
"45416","220253 CARAUBAS DO PIAUI",0,2,2,70,0,74,"2018"
"45417","220255 CARIDADE DO PIAUI",0,0,1,58,0,59,"2018"
"45418","220260 CASTELO DO PIAUI",0,0,3,115,172,290,"2018"
"45419","220265 CAXINGO",0,0,5,84,0,89,"2018"
"45420","220270 COCAL",0,5,6,406,5,422,"2018"
"45421","220271 COCAL DE TELHA",0,1,0,44,10,55,"2018"
"45422","220272 COCAL DOS ALVES",0,0,0,79,0,79,"2018"
"45423","220273 COIVARAS",1,0,1,41,12,55,"2018"
"45424","220275 COLONIA DO GURGUEIA",0,2,2,81,7,92,"2018"
"45425","220277 COLONIA DO PIAUI",0,0,0,81,0,81,"2018"
"45426","220280 CONCEICAO DO CANINDE",1,1,4,62,1,69,"2018"
"45427","220285 CORONEL JOSE DIAS",0,0,1,45,4,50,"2018"
"45428","220290 CORRENTE",3,0,0,56,458,517,"2018"
"45429","220300 CRISTALANDIA DO PIAUI",0,0,0,9,86,95,"2018"
"45430","220310 CRISTINO CASTRO",1,1,0,107,43,152,"2018"
"45431","220320 CURIMATA",1,0,6,110,93,210,"2018"
"45432","220323 CURRAIS",0,0,0,57,22,79,"2018"
"45433","220325 CURRALINHOS",0,1,2,62,1,66,"2018"
"45434","220327 CURRAL NOVO DO PIAUI",0,0,1,64,15,80,"2018"
"45435","220330 DEMERVAL LOBAO",1,0,4,253,2,260,"2018"
"45436","220335 DIRCEU ARCOVERDE",1,0,3,63,33,100,"2018"
"45437","220340 DOM EXPEDITO LOPES",0,0,3,76,0,79,"2018"
"45438","220342 DOMINGOS MOURAO",0,1,3,61,1,66,"2018"
"45439","220345 DOM INOCENCIO",0,0,3,55,25,83,"2018"
"45440","220350 ELESBAO VELOSO",1,0,2,163,1,167,"2018"
"45441","220360 ELISEU MARTINS",0,0,0,46,1,47,"2018"
"45442","220370 ESPERANTINA",2,3,11,648,3,667,"2018"
"45443","220375 FARTURA DO PIAUI",0,0,0,64,25,89,"2018"
"45444","220380 FLORES DO PIAUI",0,1,0,54,0,55,"2018"
"45445","220385 FLORESTA DO PIAUI",1,0,1,21,0,23,"2018"
"45446","220390 FLORIANO",2,6,18,941,1,968,"2018"
"45447","220400 FRANCINOPOLIS",0,0,3,64,2,69,"2018"
"45448","220410 FRANCISCO AYRES",0,0,2,69,0,71,"2018"
"45449","220415 FRANCISCO MACEDO",0,0,2,34,0,36,"2018"
"45450","220420 FRANCISCO SANTOS",0,0,0,93,1,94,"2018"
"45451","220430 FRONTEIRAS",0,1,3,137,0,141,"2018"
"45452","220435 GEMINIANO",0,0,1,82,0,83,"2018"
"45453","220440 GILBUES",0,0,4,63,110,177,"2018"
"45454","220450 GUADALUPE",1,1,2,156,1,161,"2018"
"45455","220455 GUARIBAS",0,1,3,50,15,69,"2018"
"45456","220460 HUGO NAPOLEAO",0,0,2,39,1,42,"2018"
"45457","220465 ILHA GRANDE",0,0,1,160,1,162,"2018"
"45458","220470 INHUMA",0,0,0,155,3,158,"2018"
"45459","220480 IPIRANGA DO PIAUI",2,0,1,116,3,122,"2018"
"45460","220490 ISAIAS COELHO",0,0,2,115,1,118,"2018"
"45461","220500 ITAINOPOLIS",0,1,1,126,0,128,"2018"
"45462","220510 ITAUEIRA",0,0,2,125,0,127,"2018"
"45463","220515 JACOBINA DO PIAUI",0,0,2,55,7,64,"2018"
"45464","220520 JAICOS",1,1,9,287,1,299,"2018"
"45465","220525 JARDIM DO MULATO",0,0,2,43,1,46,"2018"
"45466","220527 JATOBA DO PIAUI",0,0,0,16,43,59,"2018"
"45467","220530 JERUMENHA",0,0,1,63,0,64,"2018"
"45468","220535 JOAO COSTA",0,1,2,39,2,44,"2018"
"45469","220540 JOAQUIM PIRES",0,1,7,216,3,227,"2018"
"45470","220545 JOCA MARQUES",0,1,0,77,4,82,"2018"
"45471","220550 JOSE DE FREITAS",1,4,15,603,13,636,"2018"
"45472","220551 JUAZEIRO DO PIAUI",0,0,1,16,39,56,"2018"
"45473","220552 JULIO BORGES",0,0,1,43,47,91,"2018"
"45474","220553 JUREMA",0,1,1,63,12,77,"2018"
"45475","220554 LAGOINHA DO PIAUI",0,0,1,39,0,40,"2018"
"45476","220555 LAGOA ALEGRE",0,1,1,102,16,120,"2018"
"45477","220556 LAGOA DO BARRO DO PIAUI",0,0,3,56,24,83,"2018"
"45478","220557 LAGOA DE SAO FRANCISCO",0,0,3,75,0,78,"2018"
"45479","220558 LAGOA DO PIAUI",0,0,0,64,0,64,"2018"
"45480","220559 LAGOA DO SITIO",0,0,0,50,0,50,"2018"
"45481","220560 LANDRI SALES",0,0,1,56,1,58,"2018"
"45482","220570 LUIS CORREIA",0,3,9,453,2,467,"2018"
"45483","220580 LUZILANDIA",0,2,3,347,13,365,"2018"
"45484","220585 MADEIRO",1,0,4,124,1,130,"2018"
"45485","220590 MANOEL EMIDIO",1,0,0,69,0,70,"2018"
"45486","220595 MARCOLANDIA",2,0,5,128,0,135,"2018"
"45487","220600 MARCOS PARENTE",0,1,1,61,0,63,"2018"
"45488","220605 MASSAPE DO PIAUI",0,0,2,52,1,55,"2018"
"45489","220610 MATIAS OLIMPIO",0,0,3,188,1,192,"2018"
"45490","220620 MIGUEL ALVES",2,2,8,509,21,542,"2018"
"45491","220630 MIGUEL LEAO",0,0,1,19,0,20,"2018"
"45492","220635 MILTON BRANDAO",0,1,3,85,2,91,"2018"
"45493","220640 MONSENHOR GIL",1,0,0,122,5,128,"2018"
"45494","220650 MONSENHOR HIPOLITO",0,0,2,101,0,103,"2018"
"45495","220660 MONTE ALEGRE DO PIAUI",1,1,0,123,63,188,"2018"
"45496","220665 MORRO CABECA NO TEMPO",0,0,2,30,32,64,"2018"
"45497","220667 MORRO DO CHAPEU DO PIAUI",0,0,3,100,0,103,"2018"
"45498","220669 MURICI DOS PORTELAS",0,1,2,107,0,110,"2018"
"45499","220670 NAZARE DO PIAUI",2,0,5,100,0,107,"2018"
"45500","220672 NAZARIA",0,1,5,143,7,156,"2018"
"45501","220675 NOSSA SENHORA DE NAZARE",0,0,1,11,51,63,"2018"
"45502","220680 NOSSA SENHORA DOS REMEDIOS",1,1,3,134,5,144,"2018"
"45503","220690 NOVO ORIENTE DO PIAUI",0,0,0,74,1,75,"2018"
"45504","220695 NOVO SANTO ANTONIO",0,1,0,31,5,37,"2018"
"45505","220700 OEIRAS",2,1,6,481,5,495,"2018"
"45506","220710 OLHO D'AGUA DO PIAUI",0,0,1,35,2,38,"2018"
"45507","220720 PADRE MARCOS",0,1,3,98,1,103,"2018"
"45508","220730 PAES LANDIM",0,0,0,59,0,59,"2018"
"45509","220735 PAJEU DO PIAUI",0,1,1,29,0,31,"2018"
"45510","220740 PALMEIRA DO PIAUI",0,1,1,48,27,77,"2018"
"45511","220750 PALMEIRAIS",1,0,1,151,50,203,"2018"
"45512","220755 PAQUETA",0,0,0,54,1,55,"2018"
"45513","220760 PARNAGUA",0,0,0,49,126,175,"2018"
"45514","220770 PARNAIBA",2,5,38,2480,6,2531,"2018"
"45515","220775 PASSAGEM FRANCA DO PIAUI",0,1,2,56,2,61,"2018"
"45516","220777 PATOS DO PIAUI",1,1,0,52,3,57,"2018"
"45517","220779 PAU D'ARCO DO PIAUI",0,0,0,40,1,41,"2018"
"45518","220780 PAULISTANA",0,3,7,295,72,377,"2018"
"45519","220785 PAVUSSU",0,0,1,46,3,50,"2018"
"45520","220790 PEDRO II",2,6,15,527,15,565,"2018"
"45521","220793 PEDRO LAURENTINO",0,0,1,26,0,27,"2018"
"45522","220795 NOVA SANTA RITA",0,0,0,45,1,46,"2018"
"45523","220800 PICOS",4,3,19,1115,2,1143,"2018"
"45524","220810 PIMENTEIRAS",1,0,2,133,1,137,"2018"
"45525","220820 PIO IX",0,3,6,225,2,236,"2018"
"45526","220830 PIRACURUCA",0,3,4,435,1,443,"2018"
"45527","220840 PIRIPIRI",6,7,18,893,7,931,"2018"
"45528","220850 PORTO",0,2,5,226,5,238,"2018"
"45529","220855 PORTO ALEGRE DO PIAUI",0,0,1,35,1,37,"2018"
"45530","220860 PRATA DO PIAUI",0,0,2,38,1,41,"2018"
"45531","220865 QUEIMADA NOVA",0,1,3,63,20,87,"2018"
"45532","220870 REDENCAO DO GURGUEIA",1,0,1,130,53,185,"2018"
"45533","220880 REGENERACAO",0,0,1,293,0,294,"2018"
"45534","220885 RIACHO FRIO",0,0,0,2,49,51,"2018"
"45535","220887 RIBEIRA DO PIAUI",1,1,2,42,0,46,"2018"
"45536","220890 RIBEIRO GONCALVES",0,0,0,23,91,114,"2018"
"45537","220900 RIO GRANDE DO PIAUI",0,3,2,61,8,74,"2018"
"45538","220910 SANTA CRUZ DO PIAUI",0,0,1,73,1,75,"2018"
"45539","220915 SANTA CRUZ DOS MILAGRES",0,0,0,36,0,36,"2018"
"45540","220920 SANTA FILOMENA",0,0,2,88,4,94,"2018"
"45541","220930 SANTA LUZ",1,0,2,65,29,97,"2018"
"45542","220935 SANTANA DO PIAUI",0,0,0,47,0,47,"2018"
"45543","220937 SANTA ROSA DO PIAUI",0,0,0,60,0,60,"2018"
"45544","220940 SANTO ANTONIO DE LISBOA",0,2,1,74,0,77,"2018"
"45545","220945 SANTO ANTONIO DOS MILAGRES",0,0,0,26,2,28,"2018"
"45546","220950 SANTO INACIO DO PIAUI",0,1,2,36,0,39,"2018"
"45547","220955 SAO BRAZ DO PIAUI",0,0,0,51,8,59,"2018"
"45548","220960 SAO FELIX DO PIAUI",0,0,0,27,0,27,"2018"
"45549","220965 SAO FRANCISCO DE ASSIS DO PIAUI",0,0,2,65,5,72,"2018"
"45550","220970 SAO FRANCISCO DO PIAUI",0,1,3,76,2,82,"2018"
"45551","220975 SAO GONCALO DO GURGUEIA",0,0,0,6,30,36,"2018"
"45552","220980 SAO GONCALO DO PIAUI",0,0,1,73,3,77,"2018"
"45553","220985 SAO JOAO DA CANABRAVA",0,0,3,50,0,53,"2018"
"45554","220987 SAO JOAO DA FRONTEIRA",0,0,0,83,0,83,"2018"
"45555","220990 SAO JOAO DA SERRA",0,0,2,34,26,62,"2018"
"45556","220995 SAO JOAO DA VARJOTA",0,0,1,59,0,60,"2018"
"45557","220997 SAO JOAO DO ARRAIAL",2,4,7,144,1,158,"2018"
"45558","221000 SAO JOAO DO PIAUI",2,4,10,358,1,375,"2018"
"45559","221005 SAO JOSE DO DIVINO",0,0,2,61,0,63,"2018"
"45560","221010 SAO JOSE DO PEIXE",0,0,1,28,0,29,"2018"
"45561","221020 SAO JOSE DO PIAUI",0,0,1,80,1,82,"2018"
"45562","221030 SAO JULIAO",0,0,1,73,0,74,"2018"
"45563","221035 SAO LOURENCO DO PIAUI",1,0,1,32,4,38,"2018"
"45564","221037 SAO LUIS DO PIAUI",0,0,1,26,0,27,"2018"
"45565","221038 SAO MIGUEL DA BAIXA GRANDE",0,0,1,20,0,21,"2018"
"45566","221039 SAO MIGUEL DO FIDALGO",0,1,1,51,0,53,"2018"
"45567","221040 SAO MIGUEL DO TAPUIO",1,3,2,158,61,225,"2018"
"45568","221050 SAO PEDRO DO PIAUI",0,1,4,206,5,216,"2018"
"45569","221060 SAO RAIMUNDO NONATO",2,3,7,559,98,669,"2018"
"45570","221062 SEBASTIAO BARROS",0,1,0,8,50,59,"2018"
"45571","221063 SEBASTIAO LEAL",0,0,2,35,3,40,"2018"
"45572","221065 SIGEFREDO PACHECO",0,0,0,39,65,104,"2018"
"45573","221070 SIMOES",0,0,3,217,1,221,"2018"
"45574","221080 SIMPLICIO MENDES",3,1,3,162,2,171,"2018"
"45575","221090 SOCORRO DO PIAUI",1,0,1,44,0,46,"2018"
"45576","221093 SUSSUAPARA",0,0,5,80,0,85,"2018"
"45577","221095 TAMBORIL DO PIAUI",0,0,0,41,7,48,"2018"
"45578","221097 TANQUE DO PIAUI",1,0,1,30,0,32,"2018"
"45579","221100 TERESINA",59,42,168,13717,89,14075,"2018"
"45580","221110 UNIAO",4,0,6,538,221,769,"2018"
"45581","221120 URUCUI",1,5,4,395,26,431,"2018"
"45582","221130 VALENCA DO PIAUI",0,1,3,298,2,304,"2018"
"45583","221135 VARZEA BRANCA",0,0,1,70,13,84,"2018"
"45584","221140 VARZEA GRANDE",0,1,0,60,1,62,"2018"
"45585","221150 VERA MENDES",0,0,3,44,0,47,"2018"
"45586","221160 VILA NOVA DO PIAUI",0,0,0,40,0,40,"2018"
"45587","221170 WALL FERRAZ",0,0,0,38,0,38,"2018"
"45588","230010 ABAIARA",0,0,2,152,0,154,"2018"
"45589","230015 ACARAPE",1,0,4,194,0,199,"2018"
"45590","230020 ACARAU",6,4,12,1025,7,1054,"2018"
"45591","230030 ACOPIARA",2,2,18,566,1,589,"2018"
"45592","230040 AIUABA",0,1,6,185,1,193,"2018"
"45593","230050 ALCANTARAS",1,1,1,138,0,141,"2018"
"45594","230060 ALTANEIRA",0,0,3,102,2,107,"2018"
"45595","230070 ALTO SANTO",0,0,1,192,1,194,"2018"
"45596","230075 AMONTADA",0,2,5,86,666,759,"2018"
"45597","230080 ANTONINA DO NORTE",1,1,0,106,1,109,"2018"
"45598","230090 APUIARES",0,0,3,127,1,131,"2018"
"45599","230100 AQUIRAZ",1,4,16,1180,5,1206,"2018"
"45600","230110 ARACATI",0,6,13,957,3,979,"2018"
"45601","230120 ARACOIABA",1,3,10,403,1,418,"2018"
"45602","230125 ARARENDA",1,1,2,150,1,155,"2018"
"45603","230130 ARARIPE",0,4,13,344,2,363,"2018"
"45604","230140 ARATUBA",2,0,3,167,0,172,"2018"
"45605","230150 ARNEIROZ",1,1,3,82,2,89,"2018"
"45606","230160 ASSARE",2,3,6,277,3,291,"2018"
"45607","230170 AURORA",0,1,5,303,1,310,"2018"
"45608","230180 BAIXIO",0,0,1,77,0,78,"2018"
"45609","230185 BANABUIU",0,0,9,284,1,294,"2018"
"45610","230190 BARBALHA",3,4,35,1100,61,1203,"2018"
"45611","230195 BARREIRA",1,1,6,332,1,341,"2018"
"45612","230200 BARRO",0,0,4,236,1,241,"2018"
"45613","230205 BARROQUINHA",0,2,7,220,1,230,"2018"
"45614","230210 BATURITE",2,4,6,533,2,547,"2018"
"45615","230220 BEBERIBE",2,0,12,643,0,657,"2018"
"45616","230230 BELA CRUZ",4,2,10,383,0,399,"2018"
"45617","230240 BOA VIAGEM",3,2,5,712,1,723,"2018"
"45618","230250 BREJO SANTO",2,2,16,830,2,852,"2018"
"45619","230260 CAMOCIM",3,11,41,947,1,1003,"2018"
"45620","230270 CAMPOS SALES",2,4,7,351,4,368,"2018"
"45621","230280 CANINDE",5,3,25,1134,7,1174,"2018"
"45622","230290 CAPISTRANO",0,1,8,269,2,280,"2018"
"45623","230300 CARIDADE",0,0,6,236,1,243,"2018"
"45624","230310 CARIRE",3,1,4,227,2,237,"2018"
"45625","230320 CARIRIACU",0,1,21,394,3,419,"2018"
"45626","230330 CARIUS",0,2,3,201,0,206,"2018"
"45627","230340 CARNAUBAL",1,2,5,229,0,237,"2018"
"45628","230350 CASCAVEL",3,8,9,999,4,1023,"2018"
"45629","230360 CATARINA",1,1,4,140,2,148,"2018"
"45630","230365 CATUNDA",1,0,2,90,1,94,"2018"
"45631","230370 CAUCAIA",13,18,75,5351,18,5475,"2018"
"45632","230380 CEDRO",3,0,15,305,2,325,"2018"
"45633","230390 CHAVAL",2,4,9,185,0,200,"2018"
"45634","230393 CHORO",2,1,3,228,1,235,"2018"
"45635","230395 CHOROZINHO",2,3,4,301,3,313,"2018"
"45636","230400 COREAU",1,2,5,323,0,331,"2018"
"45637","230410 CRATEUS",2,7,25,1032,5,1071,"2018"
"45638","230420 CRATO",12,10,55,2184,5,2266,"2018"
"45639","230423 CROATA",1,1,1,222,0,225,"2018"
"45640","230425 CRUZ",0,1,7,471,2,481,"2018"
"45641","230426 DEPUTADO IRAPUAN PINHEIRO",0,1,2,93,0,96,"2018"
"45642","230427 ERERE",0,0,0,22,0,22,"2018"
"45643","230428 EUSEBIO",3,2,9,1211,3,1228,"2018"
"45644","230430 FARIAS BRITO",2,1,5,264,0,272,"2018"
"45645","230435 FORQUILHA",1,3,8,326,2,340,"2018"
"45646","230440 FORTALEZA",108,134,489,34899,203,35833,"2018"
"45647","230445 FORTIM",2,1,5,181,0,189,"2018"
"45648","230450 FRECHEIRINHA",0,0,6,266,0,272,"2018"
"45649","230460 GENERAL SAMPAIO",0,3,3,114,0,120,"2018"
"45650","230465 GRACA",0,1,2,156,2,161,"2018"
"45651","230470 GRANJA",4,4,22,845,2,877,"2018"
"45652","230480 GRANJEIRO",0,0,2,75,0,77,"2018"
"45653","230490 GROAIRAS",1,0,5,121,0,127,"2018"
"45654","230495 GUAIUBA",2,4,7,340,0,353,"2018"
"45655","230500 GUARACIABA DO NORTE",1,4,11,674,0,690,"2018"
"45656","230510 GUARAMIRANGA",0,0,1,87,0,88,"2018"
"45657","230520 HIDROLANDIA",0,1,2,270,0,273,"2018"
"45658","230523 HORIZONTE",2,3,25,1246,7,1283,"2018"
"45659","230526 IBARETAMA",0,0,2,199,3,204,"2018"
"45660","230530 IBIAPINA",0,2,7,373,3,385,"2018"
"45661","230533 IBICUITINGA",0,1,1,146,1,149,"2018"
"45662","230535 ICAPUI",0,0,3,224,1,228,"2018"
"45663","230540 ICO",0,2,12,882,1,897,"2018"
"45664","230550 IGUATU",4,10,46,1342,7,1409,"2018"
"45665","230560 INDEPENDENCIA",3,3,10,306,1,323,"2018"
"45666","230565 IPAPORANGA",0,1,4,147,0,152,"2018"
"45667","230570 IPAUMIRIM",0,0,6,126,0,132,"2018"
"45668","230580 IPU",2,1,7,656,4,670,"2018"
"45669","230590 IPUEIRAS",0,1,4,518,4,527,"2018"
"45670","230600 IRACEMA",0,0,1,149,0,150,"2018"
"45671","230610 IRAUCUBA",3,0,5,348,1,357,"2018"
"45672","230620 ITAICABA",1,0,1,88,1,91,"2018"
"45673","230625 ITAITINGA",2,2,13,676,3,696,"2018"
"45674","230630 ITAPAGE",0,5,10,697,5,717,"2018"
"45675","230640 ITAPIPOCA",4,2,6,246,1987,2245,"2018"
"45676","230650 ITAPIUNA",2,0,3,217,0,222,"2018"
"45677","230655 ITAREMA",2,3,10,703,2,720,"2018"
"45678","230660 ITATIRA",1,0,6,313,4,324,"2018"
"45679","230670 JAGUARETAMA",1,1,2,230,2,236,"2018"
"45680","230680 JAGUARIBARA",0,0,3,158,1,162,"2018"
"45681","230690 JAGUARIBE",1,1,5,472,2,481,"2018"
"45682","230700 JAGUARUANA",0,6,7,400,1,414,"2018"
"45683","230710 JARDIM",1,1,17,375,14,408,"2018"
"45684","230720 JATI",0,0,0,122,1,123,"2018"
"45685","230725 JIJOCA DE JERICOACOARA",3,0,7,420,2,432,"2018"
"45686","230730 JUAZEIRO DO NORTE",6,18,184,4066,18,4292,"2018"
"45687","230740 JUCAS",1,0,15,347,1,364,"2018"
"45688","230750 LAVRAS DA MANGABEIRA",0,0,7,332,2,341,"2018"
"45689","230760 LIMOEIRO DO NORTE",3,4,12,765,0,784,"2018"
"45690","230763 MADALENA",1,1,4,223,2,231,"2018"
"45691","230765 MARACANAU",10,14,44,4346,18,4432,"2018"
"45692","230770 MARANGUAPE",4,3,22,1500,6,1535,"2018"
"45693","230780 MARCO",2,2,5,572,1,582,"2018"
"45694","230790 MARTINOPOLE",0,1,3,176,0,180,"2018"
"45695","230800 MASSAPE",0,3,11,627,2,643,"2018"
"45696","230810 MAURITI",2,5,17,690,3,717,"2018"
"45697","230820 MERUOCA",0,0,3,205,0,208,"2018"
"45698","230830 MILAGRES",0,0,4,339,5,348,"2018"
"45699","230835 MILHA",0,1,2,153,1,157,"2018"
"45700","230837 MIRAIMA",0,1,0,22,159,182,"2018"
"45701","230840 MISSAO VELHA",3,5,23,571,26,628,"2018"
"45702","230850 MOMBACA",1,3,13,512,2,531,"2018"
"45703","230860 MONSENHOR TABOSA",0,0,2,254,2,258,"2018"
"45704","230870 MORADA NOVA",2,6,13,674,3,698,"2018"
"45705","230880 MORAUJO",0,0,2,120,1,123,"2018"
"45706","230890 MORRINHOS",4,1,4,368,1,378,"2018"
"45707","230900 MUCAMBO",0,2,5,180,0,187,"2018"
"45708","230910 MULUNGU",0,0,3,118,4,125,"2018"
"45709","230920 NOVA OLINDA",1,1,10,260,1,273,"2018"
"45710","230930 NOVA RUSSAS",2,2,12,413,1,430,"2018"
"45711","230940 NOVO ORIENTE",1,4,7,317,1,330,"2018"
"45712","230945 OCARA",2,0,5,294,2,303,"2018"
"45713","230950 OROS",0,1,6,254,1,262,"2018"
"45714","230960 PACAJUS",4,3,16,892,3,918,"2018"
"45715","230970 PACATUBA",2,6,19,938,5,970,"2018"
"45716","230980 PACOTI",0,0,2,154,1,157,"2018"
"45717","230990 PACUJA",0,0,0,80,0,80,"2018"
"45718","231000 PALHANO",0,0,5,105,1,111,"2018"
"45719","231010 PALMACIA",0,0,0,99,2,101,"2018"
"45720","231020 PARACURU",0,4,8,577,2,591,"2018"
"45721","231025 PARAIPABA",1,2,9,454,7,473,"2018"
"45722","231030 PARAMBU",2,4,5,420,1,432,"2018"
"45723","231040 PARAMOTI",1,0,2,141,0,144,"2018"
"45724","231050 PEDRA BRANCA",2,3,22,479,1,507,"2018"
"45725","231060 PENAFORTE",0,0,3,189,2,194,"2018"
"45726","231070 PENTECOSTE",0,5,12,554,4,575,"2018"
"45727","231080 PEREIRO",1,0,12,213,1,227,"2018"
"45728","231085 PINDORETAMA",1,1,4,320,1,327,"2018"
"45729","231090 PIQUET CARNEIRO",2,1,3,152,0,158,"2018"
"45730","231095 PIRES FERREIRA",0,0,1,114,2,117,"2018"
"45731","231100 PORANGA",0,1,3,202,1,207,"2018"
"45732","231110 PORTEIRAS",0,2,7,254,1,264,"2018"
"45733","231120 POTENGI",0,1,2,119,1,123,"2018"
"45734","231123 POTIRETAMA",0,0,1,71,0,72,"2018"
"45735","231126 QUITERIANOPOLIS",0,2,5,251,2,260,"2018"
"45736","231130 QUIXADA",0,6,19,1406,7,1438,"2018"
"45737","231135 QUIXELO",1,2,8,212,0,223,"2018"
"45738","231140 QUIXERAMOBIM",3,5,50,1143,10,1211,"2018"
"45739","231150 QUIXERE",0,1,2,234,1,238,"2018"
"45740","231160 REDENCAO",0,2,13,354,1,370,"2018"
"45741","231170 RERIUTABA",0,0,9,239,2,250,"2018"
"45742","231180 RUSSAS",3,3,27,964,4,1001,"2018"
"45743","231190 SABOEIRO",1,1,2,188,2,194,"2018"
"45744","231195 SALITRE",2,1,11,286,0,300,"2018"
"45745","231200 SANTANA DO ACARAU",2,3,10,405,0,420,"2018"
"45746","231210 SANTANA DO CARIRI",2,3,5,247,1,258,"2018"
"45747","231220 SANTA QUITERIA",4,3,3,528,0,538,"2018"
"45748","231230 SAO BENEDITO",1,6,14,723,3,747,"2018"
"45749","231240 SAO GONCALO DO AMARANTE",3,3,17,903,4,930,"2018"
"45750","231250 SAO JOAO DO JAGUARIBE",0,0,1,73,1,75,"2018"
"45751","231260 SAO LUIS DO CURU",0,1,3,151,2,157,"2018"
"45752","231270 SENADOR POMPEU",1,3,6,289,0,299,"2018"
"45753","231280 SENADOR SA",1,0,6,105,0,112,"2018"
"45754","231290 SOBRAL",6,10,59,3303,14,3392,"2018"
"45755","231300 SOLONOPOLE",0,2,2,188,0,192,"2018"
"45756","231310 TABULEIRO DO NORTE",1,3,5,368,0,377,"2018"
"45757","231320 TAMBORIL",1,2,8,319,1,331,"2018"
"45758","231325 TARRAFAS",1,0,1,100,0,102,"2018"
"45759","231330 TAUA",0,6,29,744,2,781,"2018"
"45760","231335 TEJUCUOCA",0,3,5,253,4,265,"2018"
"45761","231340 TIANGUA",3,6,22,1449,6,1486,"2018"
"45762","231350 TRAIRI",2,1,6,382,506,897,"2018"
"45763","231355 TURURU",0,1,2,17,242,262,"2018"
"45764","231360 UBAJARA",3,2,9,527,2,543,"2018"
"45765","231370 UMARI",0,0,0,91,2,93,"2018"
"45766","231375 UMIRIM",0,1,0,41,259,301,"2018"
"45767","231380 URUBURETAMA",0,1,0,56,342,399,"2018"
"45768","231390 URUOCA",1,1,5,181,0,188,"2018"
"45769","231395 VARJOTA",1,0,2,322,3,328,"2018"
"45770","231400 VARZEA ALEGRE",2,2,11,516,1,532,"2018"
"45771","231410 VICOSA DO CEARA",3,2,21,1015,3,1044,"2018"
"45772","240010 ACARI",0,0,3,107,0,110,"2018"
"45773","240020 ACU",1,3,14,774,0,792,"2018"
"45774","240030 AFONSO BEZERRA",1,1,0,130,0,132,"2018"
"45775","240040 AGUA NOVA",0,0,0,54,0,54,"2018"
"45776","240050 ALEXANDRIA",0,1,0,181,0,182,"2018"
"45777","240060 ALMINO AFONSO",0,0,0,52,0,52,"2018"
"45778","240070 ALTO DO RODRIGUES",0,0,2,187,2,191,"2018"
"45779","240080 ANGICOS",1,0,1,134,0,136,"2018"
"45780","240090 ANTONIO MARTINS",0,0,1,65,0,66,"2018"
"45781","240100 APODI",1,3,2,405,2,413,"2018"
"45782","240110 AREIA BRANCA",0,2,1,333,0,336,"2018"
"45783","240120 ARES",1,2,3,192,1,199,"2018"
"45784","240130 AUGUSTO SEVERO",0,0,1,102,1,104,"2018"
"45785","240140 BAIA FORMOSA",2,0,2,108,2,114,"2018"
"45786","240145 BARAUNA",1,2,5,357,2,367,"2018"
"45787","240150 BARCELONA",1,0,0,37,1,39,"2018"
"45788","240160 BENTO FERNANDES",0,0,0,72,0,72,"2018"
"45789","240165 BODO",0,0,4,44,2,50,"2018"
"45790","240170 BOM JESUS",0,0,9,139,1,149,"2018"
"45791","240180 BREJINHO",1,1,3,161,3,169,"2018"
"45792","240185 CAICARA DO NORTE",0,0,0,73,0,73,"2018"
"45793","240190 CAICARA DO RIO DO VENTO",0,0,0,57,1,58,"2018"
"45794","240200 CAICO",3,4,27,653,1,688,"2018"
"45795","240210 CAMPO REDONDO",1,0,5,112,2,120,"2018"
"45796","240220 CANGUARETAMA",4,2,13,505,3,527,"2018"
"45797","240230 CARAUBAS",1,1,6,252,2,262,"2018"
"45798","240240 CARNAUBA DOS DANTAS",1,0,3,84,0,88,"2018"
"45799","240250 CARNAUBAIS",1,0,0,121,0,122,"2018"
"45800","240260 CEARA-MIRIM",2,4,13,1135,4,1158,"2018"
"45801","240270 CERRO CORA",0,0,4,146,1,151,"2018"
"45802","240280 CORONEL EZEQUIEL",0,0,2,81,0,83,"2018"
"45803","240290 CORONEL JOAO PESSOA",0,0,0,68,0,68,"2018"
"45804","240300 CRUZETA",0,1,7,78,0,86,"2018"
"45805","240310 CURRAIS NOVOS",0,3,30,484,0,517,"2018"
"45806","240320 DOUTOR SEVERIANO",0,0,0,92,0,92,"2018"
"45807","240325 PARNAMIRIM",7,18,47,3856,8,3936,"2018"
"45808","240330 ENCANTO",0,0,1,81,0,82,"2018"
"45809","240340 EQUADOR",0,1,2,66,0,69,"2018"
"45810","240350 ESPIRITO SANTO",0,2,2,92,1,97,"2018"
"45811","240360 EXTREMOZ",1,3,5,638,3,650,"2018"
"45812","240370 FELIPE GUERRA",1,0,0,54,0,55,"2018"
"45813","240375 FERNANDO PEDROZA",0,0,1,44,0,45,"2018"
"45814","240380 FLORANIA",0,1,4,117,0,122,"2018"
"45815","240390 FRANCISCO DANTAS",0,0,0,40,0,40,"2018"
"45816","240400 FRUTUOSO GOMES",0,0,0,61,0,61,"2018"
"45817","240410 GALINHOS",1,1,0,35,0,37,"2018"
"45818","240420 GOIANINHA",1,2,6,495,4,508,"2018"
"45819","240430 GOVERNADOR DIX-SEPT ROSADO",0,0,1,166,1,168,"2018"
"45820","240440 GROSSOS",0,0,1,106,1,108,"2018"
"45821","240450 GUAMARE",1,0,6,303,0,310,"2018"
"45822","240460 IELMO MARINHO",1,1,0,139,0,141,"2018"
"45823","240470 IPANGUACU",1,0,3,243,2,249,"2018"
"45824","240480 IPUEIRA",0,0,0,19,0,19,"2018"
"45825","240485 ITAJA",0,0,1,133,0,134,"2018"
"45826","240490 ITAU",0,0,0,64,0,64,"2018"
"45827","240500 JACANA",0,0,2,106,2,110,"2018"
"45828","240510 JANDAIRA",0,0,2,78,1,81,"2018"
"45829","240520 JANDUIS",0,0,1,66,1,68,"2018"
"45830","240530 JANUARIO CICCO",0,1,3,144,2,150,"2018"
"45831","240540 JAPI",0,0,2,105,0,107,"2018"
"45832","240550 JARDIM DE ANGICOS",0,1,2,34,0,37,"2018"
"45833","240560 JARDIM DE PIRANHAS",0,1,4,189,2,196,"2018"
"45834","240570 JARDIM DO SERIDO",0,2,6,108,1,117,"2018"
"45835","240580 JOAO CAMARA",4,2,3,503,2,514,"2018"
"45836","240590 JOAO DIAS",0,0,0,40,0,40,"2018"
"45837","240600 JOSE DA PENHA",3,0,0,78,0,81,"2018"
"45838","240610 JUCURUTU",0,1,1,200,1,203,"2018"
"45839","240615 JUNDIA",0,0,0,18,0,18,"2018"
"45840","240620 LAGOA D'ANTA",0,1,1,83,1,86,"2018"
"45841","240630 LAGOA DE PEDRAS",0,1,2,107,2,112,"2018"
"45842","240640 LAGOA DE VELHOS",0,0,0,53,2,55,"2018"
"45843","240650 LAGOA NOVA",1,3,12,201,1,218,"2018"
"45844","240660 LAGOA SALGADA",1,1,4,147,0,153,"2018"
"45845","240670 LAJES",0,0,3,103,0,106,"2018"
"45846","240680 LAJES PINTADAS",0,1,1,82,0,84,"2018"
"45847","240690 LUCRECIA",0,0,0,41,0,41,"2018"
"45848","240700 LUIS GOMES",1,1,0,132,0,134,"2018"
"45849","240710 MACAIBA",2,4,14,1067,4,1091,"2018"
"45850","240720 MACAU",1,1,2,313,0,317,"2018"
"45851","240725 MAJOR SALES",0,1,2,50,0,53,"2018"
"45852","240730 MARCELINO VIEIRA",0,3,0,106,0,109,"2018"
"45853","240740 MARTINS",0,0,2,97,0,99,"2018"
"45854","240750 MAXARANGUAPE",1,0,1,132,2,136,"2018"
"45855","240760 MESSIAS TARGINO",1,1,0,52,0,54,"2018"
"45856","240770 MONTANHAS",2,2,3,171,1,179,"2018"
"45857","240780 MONTE ALEGRE",2,1,6,278,0,287,"2018"
"45858","240790 MONTE DAS GAMELEIRAS",0,1,1,44,1,47,"2018"
"45859","240800 MOSSORO",4,15,24,3838,12,3893,"2018"
"45860","240810 NATAL",34,68,182,11994,40,12318,"2018"
"45861","240820 NISIA FLORESTA",2,2,4,372,4,384,"2018"
"45862","240830 NOVA CRUZ",1,4,15,476,4,500,"2018"
"45863","240840 OLHO-D'AGUA DO BORGES",0,0,1,37,0,38,"2018"
"45864","240850 OURO BRANCO",0,0,1,48,0,49,"2018"
"45865","240860 PARANA",0,0,0,48,0,48,"2018"
"45866","240870 PARAU",0,0,0,49,0,49,"2018"
"45867","240880 PARAZINHO",1,0,0,105,1,107,"2018"
"45868","240890 PARELHAS",0,0,2,272,0,274,"2018"
"45869","240895 RIO DO FOGO",0,0,2,182,1,185,"2018"
"45870","240910 PASSA E FICA",0,2,6,143,5,156,"2018"
"45871","240920 PASSAGEM",0,0,0,32,1,33,"2018"
"45872","240930 PATU",0,0,1,128,0,129,"2018"
"45873","240933 SANTA MARIA",0,0,1,63,0,64,"2018"
"45874","240940 PAU DOS FERROS",2,2,1,554,1,560,"2018"
"45875","240950 PEDRA GRANDE",0,0,0,51,3,54,"2018"
"45876","240960 PEDRA PRETA",0,0,1,44,0,45,"2018"
"45877","240970 PEDRO AVELINO",0,0,0,76,1,77,"2018"
"45878","240980 PEDRO VELHO",0,0,4,235,1,240,"2018"
"45879","240990 PENDENCIAS",0,3,0,164,0,167,"2018"
"45880","241000 PILOES",0,0,0,42,0,42,"2018"
"45881","241010 POCO BRANCO",0,1,2,163,2,168,"2018"
"45882","241020 PORTALEGRE",0,1,1,98,0,100,"2018"
"45883","241025 PORTO DO MANGUE",0,0,0,92,0,92,"2018"
"45884","241030 SERRA CAIADA",0,0,3,129,0,132,"2018"
"45885","241040 PUREZA",0,1,0,127,0,128,"2018"
"45886","241050 RAFAEL FERNANDES",1,0,0,67,0,68,"2018"
"45887","241060 RAFAEL GODEIRO",0,0,0,27,0,27,"2018"
"45888","241070 RIACHO DA CRUZ",0,0,0,46,0,46,"2018"
"45889","241080 RIACHO DE SANTANA",0,0,0,37,0,37,"2018"
"45890","241090 RIACHUELO",2,1,0,95,5,103,"2018"
"45891","241100 RODOLFO FERNANDES",0,0,2,63,0,65,"2018"
"45892","241105 TIBAU",0,0,2,91,1,94,"2018"
"45893","241110 RUY BARBOSA",1,0,1,35,0,37,"2018"
"45894","241120 SANTA CRUZ",0,3,8,570,3,584,"2018"
"45895","241140 SANTANA DO MATOS",0,1,5,157,0,163,"2018"
"45896","241142 SANTANA DO SERIDO",0,0,0,45,0,45,"2018"
"45897","241150 SANTO ANTONIO",0,1,5,334,0,340,"2018"
"45898","241160 SAO BENTO DO NORTE",1,1,0,50,2,54,"2018"
"45899","241170 SAO BENTO DO TRAIRI",1,0,2,57,0,60,"2018"
"45900","241180 SAO FERNANDO",0,0,3,36,0,39,"2018"
"45901","241190 SAO FRANCISCO DO OESTE",1,1,0,58,0,60,"2018"
"45902","241200 SAO GONCALO DO AMARANTE",0,3,20,1494,5,1522,"2018"
"45903","241210 SAO JOAO DO SABUGI",0,0,4,55,0,59,"2018"
"45904","241220 SAO JOSE DE MIPIBU",5,3,13,742,1,764,"2018"
"45905","241230 SAO JOSE DO CAMPESTRE",2,1,5,135,2,145,"2018"
"45906","241240 SAO JOSE DO SERIDO",1,0,0,58,0,59,"2018"
"45907","241250 SAO MIGUEL",0,1,4,393,3,401,"2018"
"45908","241255 SAO MIGUEL DO GOSTOSO",0,1,0,57,1,59,"2018"
"45909","241260 SAO PAULO DO POTENGI",0,2,6,196,4,208,"2018"
"45910","241270 SAO PEDRO",0,2,0,67,1,70,"2018"
"45911","241280 SAO RAFAEL",0,0,1,81,1,83,"2018"
"45912","241290 SAO TOME",0,1,4,97,1,103,"2018"
"45913","241300 SAO VICENTE",0,1,4,68,0,73,"2018"
"45914","241310 SENADOR ELOI DE SOUZA",1,1,4,79,0,85,"2018"
"45915","241320 SENADOR GEORGINO AVELINO",0,1,2,65,0,68,"2018"
"45916","241330 SERRA DE SAO BENTO",1,1,0,76,0,78,"2018"
"45917","241335 SERRA DO MEL",1,0,2,198,0,201,"2018"
"45918","241340 SERRA NEGRA DO NORTE",0,0,1,58,1,60,"2018"
"45919","241350 SERRINHA",0,2,4,87,1,94,"2018"
"45920","241355 SERRINHA DOS PINTOS",0,0,0,43,0,43,"2018"
"45921","241360 SEVERIANO MELO",0,1,2,76,0,79,"2018"
"45922","241370 SITIO NOVO",1,0,2,63,1,67,"2018"
"45923","241380 TABOLEIRO GRANDE",1,0,0,35,0,36,"2018"
"45924","241390 TAIPU",1,0,0,151,1,153,"2018"
"45925","241400 TANGARA",0,3,3,211,1,218,"2018"
"45926","241410 TENENTE ANANIAS",0,0,0,129,0,129,"2018"
"45927","241415 TENENTE LAURENTINO CRUZ",0,2,4,86,0,92,"2018"
"45928","241420 TIBAU DO SUL",3,1,6,263,3,276,"2018"
"45929","241430 TIMBAUBA DOS BATISTAS",0,0,0,20,0,20,"2018"
"45930","241440 TOUROS",2,9,4,480,4,499,"2018"
"45931","241445 TRIUNFO POTIGUAR",0,0,1,59,0,60,"2018"
"45932","241450 UMARIZAL",1,0,1,111,1,114,"2018"
"45933","241460 UPANEMA",0,0,2,158,0,160,"2018"
"45934","241470 VARZEA",0,0,1,77,0,78,"2018"
"45935","241475 VENHA-VER",0,0,0,66,0,66,"2018"
"45936","241480 VERA CRUZ",0,3,4,162,1,170,"2018"
"45937","241490 VICOSA",1,0,2,15,0,18,"2018"
"45938","241500 VILA FLOR",0,0,0,44,1,45,"2018"
"45939","MUNICIPIO IGNORADO - PB",0,0,0,1,1,2,"2018"
"45940","250010 AGUA BRANCA",0,1,3,131,1,136,"2018"
"45941","250020 AGUIAR",0,0,2,52,0,54,"2018"
"45942","250030 ALAGOA GRANDE",1,3,12,414,7,437,"2018"
"45943","250040 ALAGOA NOVA",0,3,8,307,3,321,"2018"
"45944","250050 ALAGOINHA",1,3,1,213,1,219,"2018"
"45945","250053 ALCANTIL",0,1,2,101,1,105,"2018"
"45946","250057 ALGODAO DE JANDAIRA",0,0,1,45,1,47,"2018"
"45947","250060 ALHANDRA",1,5,5,399,5,415,"2018"
"45948","250070 SAO JOAO DO RIO DO PEIXE",0,1,3,220,1,225,"2018"
"45949","250073 AMPARO",0,0,0,36,0,36,"2018"
"45950","250077 APARECIDA",0,0,2,106,0,108,"2018"
"45951","250080 ARACAGI",1,1,2,226,1,231,"2018"
"45952","250090 ARARA",0,1,1,124,0,126,"2018"
"45953","250100 ARARUNA",0,1,3,266,1,271,"2018"
"45954","250110 AREIA",0,4,3,328,4,339,"2018"
"45955","250115 AREIA DE BARAUNAS",0,0,0,36,1,37,"2018"
"45956","250120 AREIAL",0,1,2,93,0,96,"2018"
"45957","250130 AROEIRAS",1,0,2,315,3,321,"2018"
"45958","250135 ASSUNCAO",0,1,1,85,0,87,"2018"
"45959","250140 BAIA DA TRAICAO",1,1,2,159,0,163,"2018"
"45960","250150 BANANEIRAS",1,3,4,310,1,319,"2018"
"45961","250153 BARAUNA",0,0,0,60,1,61,"2018"
"45962","250157 BARRA DE SANTANA",1,0,5,114,1,121,"2018"
"45963","250160 BARRA DE SANTA ROSA",0,0,4,132,0,136,"2018"
"45964","250170 BARRA DE SAO MIGUEL",0,0,0,96,1,97,"2018"
"45965","250180 BAYEUX",2,6,22,1449,2,1481,"2018"
"45966","250190 BELEM",1,2,3,217,0,223,"2018"
"45967","250200 BELEM DO BREJO DO CRUZ",0,0,0,70,0,70,"2018"
"45968","250205 BERNARDINO BATISTA",0,1,1,54,0,56,"2018"
"45969","250210 BOA VENTURA",0,0,0,95,1,96,"2018"
"45970","250215 BOA VISTA",0,0,1,111,0,112,"2018"
"45971","250220 BOM JESUS",0,1,2,32,0,35,"2018"
"45972","250230 BOM SUCESSO",0,0,0,51,0,51,"2018"
"45973","250240 BONITO DE SANTA FE",0,2,3,127,0,132,"2018"
"45974","250250 BOQUEIRAO",0,1,1,255,0,257,"2018"
"45975","250260 IGARACY",0,0,1,70,3,74,"2018"
"45976","250270 BORBOREMA",0,1,0,76,0,77,"2018"
"45977","250280 BREJO DO CRUZ",0,2,2,157,2,163,"2018"
"45978","250290 BREJO DOS SANTOS",0,0,0,79,0,79,"2018"
"45979","250300 CAAPORA",0,2,7,350,3,362,"2018"
"45980","250310 CABACEIRAS",1,1,0,65,1,68,"2018"
"45981","250320 CABEDELO",2,6,13,912,3,936,"2018"
"45982","250330 CACHOEIRA DOS INDIOS",0,0,3,132,1,136,"2018"
"45983","250340 CACIMBA DE AREIA",0,0,1,66,2,69,"2018"
"45984","250350 CACIMBA DE DENTRO",0,1,6,213,1,221,"2018"
"45985","250355 CACIMBAS",0,1,2,144,15,162,"2018"
"45986","250360 CAICARA",1,0,2,93,0,96,"2018"
"45987","250370 CAJAZEIRAS",3,7,14,906,4,934,"2018"
"45988","250375 CAJAZEIRINHAS",0,1,0,33,0,34,"2018"
"45989","250380 CALDAS BRANDAO",0,1,2,103,0,106,"2018"
"45990","250390 CAMALAU",0,0,1,102,0,103,"2018"
"45991","250400 CAMPINA GRANDE",4,22,81,6444,36,6587,"2018"
"45992","250403 CAPIM",1,0,4,129,0,134,"2018"
"45993","250407 CARAUBAS",1,0,0,60,0,61,"2018"
"45994","250410 CARRAPATEIRA",0,0,0,37,0,37,"2018"
"45995","250415 CASSERENGUE",0,0,2,94,0,96,"2018"
"45996","250420 CATINGUEIRA",0,0,4,66,1,71,"2018"
"45997","250430 CATOLE DO ROCHA",4,4,3,408,2,421,"2018"
"45998","250435 CATURITE",0,1,0,82,0,83,"2018"
"45999","250440 CONCEICAO",1,1,6,252,3,263,"2018"
"46000","250450 CONDADO",0,0,3,89,2,94,"2018"
"46001","250460 CONDE",1,5,5,495,4,510,"2018"
"46002","250470 CONGO",1,1,1,84,1,88,"2018"
"46003","250480 COREMAS",0,1,9,205,2,217,"2018"
"46004","250485 COXIXOLA",1,0,1,18,0,20,"2018"
"46005","250490 CRUZ DO ESPIRITO SANTO",2,4,5,339,0,350,"2018"
"46006","250500 CUBATI",1,0,3,119,0,123,"2018"
"46007","250510 CUITE",0,2,0,249,3,254,"2018"
"46008","250520 CUITEGI",0,0,4,115,0,119,"2018"
"46009","250523 CUITE DE MAMANGUAPE",0,0,2,98,0,100,"2018"
"46010","250527 CURRAL DE CIMA",0,0,1,80,0,81,"2018"
"46011","250530 CURRAL VELHO",0,0,0,23,0,23,"2018"
"46012","250535 DAMIAO",0,0,2,53,0,55,"2018"
"46013","250540 DESTERRO",0,0,1,114,8,123,"2018"
"46014","250550 VISTA SERRANA",0,0,0,48,0,48,"2018"
"46015","250560 DIAMANTE",0,0,1,93,0,94,"2018"
"46016","250570 DONA INES",0,1,1,145,2,149,"2018"
"46017","250580 DUAS ESTRADAS",1,0,0,41,0,42,"2018"
"46018","250590 EMAS",0,0,2,50,0,52,"2018"
"46019","250600 ESPERANCA",0,0,5,473,0,478,"2018"
"46020","250610 FAGUNDES",0,0,2,188,4,194,"2018"
"46021","250620 FREI MARTINHO",0,0,1,21,0,22,"2018"
"46022","250625 GADO BRAVO",0,2,2,117,2,123,"2018"
"46023","250630 GUARABIRA",3,4,3,902,4,916,"2018"
"46024","250640 GURINHEM",0,0,4,189,0,193,"2018"
"46025","250650 GURJAO",0,0,1,50,0,51,"2018"
"46026","250660 IBIARA",0,1,0,74,0,75,"2018"
"46027","250670 IMACULADA",1,3,1,162,1,168,"2018"
"46028","250680 INGA",0,0,4,258,3,265,"2018"
"46029","250690 ITABAIANA",0,2,3,350,0,355,"2018"
"46030","250700 ITAPORANGA",2,0,6,341,5,354,"2018"
"46031","250710 ITAPOROROCA",0,0,6,280,0,286,"2018"
"46032","250720 ITATUBA",0,1,5,140,4,150,"2018"
"46033","250730 JACARAU",1,2,4,197,1,205,"2018"
"46034","250740 JERICO",0,1,0,100,2,103,"2018"
"46035","250750 JOAO PESSOA",26,42,160,12131,45,12404,"2018"
"46036","250760 JUAREZ TAVORA",0,0,3,112,2,117,"2018"
"46037","250770 JUAZEIRINHO",0,2,2,324,0,328,"2018"
"46038","250780 JUNCO DO SERIDO",0,0,0,97,1,98,"2018"
"46039","250790 JURIPIRANGA",0,2,4,185,0,191,"2018"
"46040","250800 JURU",0,1,2,108,2,113,"2018"
"46041","250810 LAGOA",0,2,1,64,0,67,"2018"
"46042","250820 LAGOA DE DENTRO",0,0,0,144,1,145,"2018"
"46043","250830 LAGOA SECA",1,1,7,393,3,405,"2018"
"46044","250840 LASTRO",0,0,1,45,1,47,"2018"
"46045","250850 LIVRAMENTO",0,1,3,95,2,101,"2018"
"46046","250855 LOGRADOURO",0,0,1,45,0,46,"2018"
"46047","250860 LUCENA",1,0,5,226,0,232,"2018"
"46048","250870 MAE D'AGUA",0,1,1,42,0,44,"2018"
"46049","250880 MALTA",0,0,2,100,3,105,"2018"
"46050","250890 MAMANGUAPE",1,4,15,827,3,850,"2018"
"46051","250900 MANAIRA",0,3,2,116,6,127,"2018"
"46052","250905 MARCACAO",1,1,4,192,2,200,"2018"
"46053","250910 MARI",0,0,2,292,1,295,"2018"
"46054","250915 MARIZOPOLIS",0,0,1,57,0,58,"2018"
"46055","250920 MASSARANDUBA",0,0,2,200,2,204,"2018"
"46056","250930 MATARACA",1,1,5,158,0,165,"2018"
"46057","250933 MATINHAS",0,0,0,75,0,75,"2018"
"46058","250937 MATO GROSSO",0,0,1,24,0,25,"2018"
"46059","250939 MATUREIA",1,1,2,109,2,115,"2018"
"46060","250940 MOGEIRO",0,1,2,205,1,209,"2018"
"46061","250950 MONTADAS",0,0,2,81,0,83,"2018"
"46062","250960 MONTE HOREBE",0,0,1,65,1,67,"2018"
"46063","250970 MONTEIRO",4,2,3,517,2,528,"2018"
"46064","250980 MULUNGU",0,1,1,140,2,144,"2018"
"46065","250990 NATUBA",1,1,2,97,1,102,"2018"
"46066","251000 NAZAREZINHO",0,0,0,107,0,107,"2018"
"46067","251010 NOVA FLORESTA",0,0,1,116,2,119,"2018"
"46068","251020 NOVA OLINDA",0,0,2,68,2,72,"2018"
"46069","251030 NOVA PALMEIRA",0,1,0,37,0,38,"2018"
"46070","251040 OLHO D'AGUA",0,2,2,89,1,94,"2018"
"46071","251050 OLIVEDOS",0,0,1,46,1,48,"2018"
"46072","251060 OURO VELHO",0,0,1,47,0,48,"2018"
"46073","251065 PARARI",0,0,0,20,0,20,"2018"
"46074","251070 PASSAGEM",0,0,0,53,1,54,"2018"
"46075","251080 PATOS",2,5,43,1571,14,1635,"2018"
"46076","251090 PAULISTA",0,0,1,136,1,138,"2018"
"46077","251100 PEDRA BRANCA",0,0,0,52,0,52,"2018"
"46078","251110 PEDRA LAVRADA",1,1,0,74,0,76,"2018"
"46079","251120 PEDRAS DE FOGO",0,0,13,576,2,591,"2018"
"46080","251130 PIANCO",1,2,1,192,2,198,"2018"
"46081","251140 PICUI",3,3,2,259,0,267,"2018"
"46082","251150 PILAR",0,0,4,181,0,185,"2018"
"46083","251160 PILOES",1,0,3,143,2,149,"2018"
"46084","251170 PILOEZINHOS",0,0,2,108,1,111,"2018"
"46085","251180 PIRPIRITUBA",0,1,4,151,1,157,"2018"
"46086","251190 PITIMBU",0,3,1,264,10,278,"2018"
"46087","251200 POCINHOS",0,0,1,270,2,273,"2018"
"46088","251203 POCO DANTAS",0,0,1,55,0,56,"2018"
"46089","251207 POCO DE JOSE DE MOURA",0,0,1,41,1,43,"2018"
"46090","251210 POMBAL",0,2,6,466,1,475,"2018"
"46091","251220 PRATA",0,0,0,44,0,44,"2018"
"46092","251230 PRINCESA ISABEL",1,2,8,284,2,297,"2018"
"46093","251240 PUXINANA",0,1,6,187,1,195,"2018"
"46094","251250 QUEIMADAS",0,2,10,704,3,719,"2018"
"46095","251260 QUIXABA",0,0,0,24,0,24,"2018"
"46096","251270 REMIGIO",2,1,4,273,2,282,"2018"
"46097","251272 PEDRO REGIS",0,2,0,66,0,68,"2018"
"46098","251274 RIACHAO",1,0,0,46,1,48,"2018"
"46099","251275 RIACHAO DO BACAMARTE",0,0,2,62,0,64,"2018"
"46100","251276 RIACHAO DO POCO",0,0,4,76,0,80,"2018"
"46101","251278 RIACHO DE SANTO ANTONIO",0,1,1,32,0,34,"2018"
"46102","251280 RIACHO DOS CAVALOS",0,0,3,129,0,132,"2018"
"46103","251290 RIO TINTO",0,0,5,368,1,374,"2018"
"46104","251300 SALGADINHO",0,1,1,49,0,51,"2018"
"46105","251310 SALGADO DE SAO FELIX",0,1,0,147,1,149,"2018"
"46106","251315 SANTA CECILIA",0,1,1,97,1,100,"2018"
"46107","251320 SANTA CRUZ",2,0,1,79,0,82,"2018"
"46108","251330 SANTA HELENA",0,1,0,65,1,67,"2018"
"46109","251335 SANTA INES",0,0,0,48,1,49,"2018"
"46110","251340 SANTA LUZIA",0,0,3,195,1,199,"2018"
"46111","251350 SANTANA DE MANGUEIRA",0,0,1,58,1,60,"2018"
"46112","251360 SANTANA DOS GARROTES",0,0,0,98,1,99,"2018"
"46113","251365 JOCA CLAUDINO",0,0,1,31,0,32,"2018"
"46114","251370 SANTA RITA",6,10,44,2442,0,2502,"2018"
"46115","251380 SANTA TERESINHA",1,0,2,71,0,74,"2018"
"46116","251385 SANTO ANDRE",0,0,0,28,0,28,"2018"
"46117","251390 SAO BENTO",4,3,6,409,0,422,"2018"
"46118","251392 SAO BENTINHO",0,1,0,60,0,61,"2018"
"46119","251394 SAO DOMINGOS DO CARIRI",0,0,0,33,0,33,"2018"
"46120","251396 SAO DOMINGOS",0,0,0,42,0,42,"2018"
"46121","251398 SAO FRANCISCO",0,1,0,25,0,26,"2018"
"46122","251400 SAO JOAO DO CARIRI",2,1,0,65,0,68,"2018"
"46123","251410 SAO JOAO DO TIGRE",0,0,0,60,0,60,"2018"
"46124","251420 SAO JOSE DA LAGOA TAPADA",0,0,0,100,0,100,"2018"
"46125","251430 SAO JOSE DE CAIANA",0,0,1,58,0,59,"2018"
"46126","251440 SAO JOSE DE ESPINHARAS",0,0,3,46,0,49,"2018"
"46127","251445 SAO JOSE DOS RAMOS",0,1,1,83,0,85,"2018"
"46128","251450 SAO JOSE DE PIRANHAS",1,0,6,273,0,280,"2018"
"46129","251455 SAO JOSE DE PRINCESA",0,1,1,24,2,28,"2018"
"46130","251460 SAO JOSE DO BONFIM",0,1,0,50,2,53,"2018"
"46131","251465 SAO JOSE DO BREJO DO CRUZ",1,0,0,17,0,18,"2018"
"46132","251470 SAO JOSE DO SABUGI",0,1,0,44,0,45,"2018"
"46133","251480 SAO JOSE DOS CORDEIROS",0,0,0,35,0,35,"2018"
"46134","251490 SAO MAMEDE",0,3,3,91,2,99,"2018"
"46135","251500 SAO MIGUEL DE TAIPU",0,0,0,94,0,94,"2018"
"46136","251510 SAO SEBASTIAO DE LAGOA DE ROCA",1,0,2,163,2,168,"2018"
"46137","251520 SAO SEBASTIAO DO UMBUZEIRO",0,0,0,54,0,54,"2018"
"46138","251530 SAPE",1,3,6,575,2,587,"2018"
"46139","251540 SAO VICENTE DO SERIDO",0,0,1,190,2,193,"2018"
"46140","251550 SERRA BRANCA",0,0,2,164,0,166,"2018"
"46141","251560 SERRA DA RAIZ",0,0,0,37,1,38,"2018"
"46142","251570 SERRA GRANDE",0,0,1,42,0,43,"2018"
"46143","251580 SERRA REDONDA",0,0,0,94,3,97,"2018"
"46144","251590 SERRARIA",0,0,0,68,1,69,"2018"
"46145","251593 SERTAOZINHO",0,0,0,72,0,72,"2018"
"46146","251597 SOBRADO",1,1,2,113,1,118,"2018"
"46147","251600 SOLANEA",1,1,7,420,1,430,"2018"
"46148","251610 SOLEDADE",0,1,2,189,4,196,"2018"
"46149","251615 SOSSEGO",0,0,2,56,0,58,"2018"
"46150","251620 SOUSA",3,3,13,987,4,1010,"2018"
"46151","251630 SUME",0,3,0,238,0,241,"2018"
"46152","251640 TACIMA",0,0,0,82,0,82,"2018"
"46153","251650 TAPEROA",0,2,4,214,4,224,"2018"
"46154","251660 TAVARES",0,1,4,198,2,205,"2018"
"46155","251670 TEIXEIRA",3,3,2,215,6,229,"2018"
"46156","251675 TENORIO",0,0,0,37,2,39,"2018"
"46157","251680 TRIUNFO",0,0,1,85,2,88,"2018"
"46158","251690 UIRAUNA",0,2,1,183,1,187,"2018"
"46159","251700 UMBUZEIRO",0,0,2,132,4,138,"2018"
"46160","251710 VARZEA",0,0,4,33,0,37,"2018"
"46161","251720 VIEIROPOLIS",0,0,0,42,0,42,"2018"
"46162","251740 ZABELE",2,0,0,32,0,34,"2018"
"46163","MUNICIPIO IGNORADO - PE",0,0,0,31,1,32,"2018"
"46164","260005 ABREU E LIMA",10,1,24,1452,3,1490,"2018"
"46165","260010 AFOGADOS DA INGAZEIRA",4,3,5,610,1,623,"2018"
"46166","260020 AFRANIO",0,0,5,251,12,268,"2018"
"46167","260030 AGRESTINA",1,1,5,334,10,351,"2018"
"46168","260040 AGUA PRETA",2,1,5,438,5,451,"2018"
"46169","260050 AGUAS BELAS",2,1,14,757,6,780,"2018"
"46170","260060 ALAGOINHA",1,0,3,190,5,199,"2018"
"46171","260070 ALIANCA",2,1,7,517,5,532,"2018"
"46172","260080 ALTINHO",1,1,3,236,4,245,"2018"
"46173","260090 AMARAJI",0,0,7,286,1,294,"2018"
"46174","260100 ANGELIM",1,0,2,146,1,150,"2018"
"46175","260105 ARACOIABA",1,0,1,293,4,299,"2018"
"46176","260110 ARARIPINA",6,6,21,1602,4,1639,"2018"
"46177","260120 ARCOVERDE",2,3,11,1138,7,1161,"2018"
"46178","260130 BARRA DE GUABIRABA",0,0,5,173,4,182,"2018"
"46179","260140 BARREIROS",2,7,7,688,6,710,"2018"
"46180","260150 BELEM DE MARIA",2,2,1,152,1,158,"2018"
"46181","260160 BELEM DE SAO FRANCISCO",1,1,6,299,9,316,"2018"
"46182","260170 BELO JARDIM",4,0,9,1202,39,1254,"2018"
"46183","260180 BETANIA",1,1,2,178,14,196,"2018"
"46184","260190 BEZERROS",2,1,12,757,11,783,"2018"
"46185","260200 BODOCO",2,3,12,559,2,578,"2018"
"46186","260210 BOM CONSELHO",5,3,4,486,7,505,"2018"
"46187","260220 BOM JARDIM",1,1,7,441,2,452,"2018"
"46188","260230 BONITO",1,1,6,606,4,618,"2018"
"46189","260240 BREJAO",2,3,0,152,3,160,"2018"
"46190","260250 BREJINHO",0,1,1,109,1,112,"2018"
"46191","260260 BREJO DA MADRE DE DEUS",4,3,5,719,4,735,"2018"
"46192","260270 BUENOS AIRES",0,0,0,198,0,198,"2018"
"46193","260280 BUIQUE",4,6,6,870,4,890,"2018"
"46194","260290 CABO DE SANTO AGOSTINHO",10,12,42,3031,33,3128,"2018"
"46195","260300 CABROBO",2,4,4,533,3,546,"2018"
"46196","260310 CACHOEIRINHA",1,0,6,286,1,294,"2018"
"46197","260320 CAETES",2,1,6,402,3,414,"2018"
"46198","260330 CALCADO",1,0,2,127,0,130,"2018"
"46199","260340 CALUMBI",0,0,1,44,26,71,"2018"
"46200","260345 CAMARAGIBE",2,3,25,2153,8,2191,"2018"
"46201","260350 CAMOCIM DE SAO FELIX",0,1,1,180,7,189,"2018"
"46202","260360 CAMUTANGA",0,0,1,132,0,133,"2018"
"46203","260370 CANHOTINHO",0,4,4,341,2,351,"2018"
"46204","260380 CAPOEIRAS",1,1,1,239,2,244,"2018"
"46205","260390 CARNAIBA",0,1,2,257,0,260,"2018"
"46206","260392 CARNAUBEIRA DA PENHA",0,2,11,259,6,278,"2018"
"46207","260400 CARPINA",3,4,10,988,2,1007,"2018"
"46208","260410 CARUARU",11,10,68,5849,24,5962,"2018"
"46209","260415 CASINHAS",0,0,0,213,0,213,"2018"
"46210","260420 CATENDE",5,0,5,514,2,526,"2018"
"46211","260430 CEDRO",0,0,4,164,1,169,"2018"
"46212","260440 CHA DE ALEGRIA",0,0,2,192,2,196,"2018"
"46213","260450 CHA GRANDE",0,0,4,336,1,341,"2018"
"46214","260460 CONDADO",2,2,0,367,2,373,"2018"
"46215","260470 CORRENTES",0,3,5,230,2,240,"2018"
"46216","260480 CORTES",1,0,2,193,0,196,"2018"
"46217","260490 CUMARU",2,0,3,159,3,167,"2018"
"46218","260500 CUPIRA",0,3,8,322,6,339,"2018"
"46219","260510 CUSTODIA",2,4,4,517,2,529,"2018"
"46220","260515 DORMENTES",1,3,6,225,17,252,"2018"
"46221","260520 ESCADA",3,2,10,885,10,910,"2018"
"46222","260530 EXU",5,5,10,510,2,532,"2018"
"46223","260540 FEIRA NOVA",1,2,2,310,4,319,"2018"
"46224","260545 FERNANDO DE NORONHA",0,0,0,23,1,24,"2018"
"46225","260550 FERREIROS",1,0,2,119,2,124,"2018"
"46226","260560 FLORES",1,0,5,209,19,234,"2018"
"46227","260570 FLORESTA",3,0,6,495,11,515,"2018"
"46228","260580 FREI MIGUELINHO",0,1,2,162,1,166,"2018"
"46229","260590 GAMELEIRA",4,2,1,304,1,312,"2018"
"46230","260600 GARANHUNS",22,4,17,2262,8,2313,"2018"
"46231","260610 GLORIA DO GOITA",1,1,4,405,4,415,"2018"
"46232","260620 GOIANA",1,4,14,1191,6,1216,"2018"
"46233","260630 GRANITO",0,0,3,121,2,126,"2018"
"46234","260640 GRAVATA",1,3,9,1115,12,1140,"2018"
"46235","260650 IATI",1,3,4,314,2,324,"2018"
"46236","260660 IBIMIRIM",2,2,4,432,16,456,"2018"
"46237","260670 IBIRAJUBA",1,0,0,96,2,99,"2018"
"46238","260680 IGARASSU",3,7,19,1589,13,1631,"2018"
"46239","260690 IGUARACY",0,1,0,129,0,130,"2018"
"46240","260700 INAJA",2,0,7,348,23,380,"2018"
"46241","260710 INGAZEIRA",0,0,0,65,0,65,"2018"
"46242","260720 IPOJUCA",4,9,31,1749,7,1800,"2018"
"46243","260730 IPUBI",2,5,3,492,1,503,"2018"
"46244","260740 ITACURUBA",0,1,1,68,2,72,"2018"
"46245","260750 ITAIBA",1,2,5,386,7,401,"2018"
"46246","260760 ILHA DE ITAMARACA",1,2,5,316,4,328,"2018"
"46247","260765 ITAMBE",0,2,8,425,2,437,"2018"
"46248","260770 ITAPETIM",1,0,0,200,1,202,"2018"
"46249","260775 ITAPISSUMA",1,1,5,366,2,375,"2018"
"46250","260780 ITAQUITINGA",2,2,1,236,1,242,"2018"
"46251","260790 JABOATAO DOS GUARARAPES",36,43,140,9414,55,9688,"2018"
"46252","260795 JAQUEIRA",0,0,5,174,1,180,"2018"
"46253","260800 JATAUBA",2,0,4,227,2,235,"2018"
"46254","260805 JATOBA",0,2,6,189,1,198,"2018"
"46255","260810 JOAO ALFREDO",1,3,6,360,3,373,"2018"
"46256","260820 JOAQUIM NABUCO",0,0,3,205,0,208,"2018"
"46257","260825 JUCATI",0,1,0,174,0,175,"2018"
"46258","260830 JUPI",1,3,2,293,3,302,"2018"
"46259","260840 JUREMA",0,1,2,237,3,243,"2018"
"46260","260845 LAGOA DO CARRO",1,3,1,245,1,251,"2018"
"46261","260850 LAGOA DE ITAENGA",2,1,2,310,1,316,"2018"
"46262","260860 LAGOA DO OURO",1,1,1,183,0,186,"2018"
"46263","260870 LAGOA DOS GATOS",1,0,3,208,4,216,"2018"
"46264","260875 LAGOA GRANDE",1,1,4,391,0,397,"2018"
"46265","260880 LAJEDO",3,2,15,657,8,685,"2018"
"46266","260890 LIMOEIRO",4,2,8,754,1,769,"2018"
"46267","260900 MACAPARANA",0,2,6,384,1,393,"2018"
"46268","260910 MACHADOS",2,2,3,188,1,196,"2018"
"46269","260915 MANARI",2,3,4,267,8,284,"2018"
"46270","260920 MARAIAL",1,1,2,239,4,247,"2018"
"46271","260930 MIRANDIBA",0,1,8,244,3,256,"2018"
"46272","260940 MORENO",3,0,8,768,9,788,"2018"
"46273","260950 NAZARE DA MATA",2,1,2,419,1,425,"2018"
"46274","260960 OLINDA",12,16,69,5366,30,5493,"2018"
"46275","260970 OROBO",3,0,2,286,2,293,"2018"
"46276","260980 OROCO",1,0,6,230,3,240,"2018"
"46277","260990 OURICURI",1,6,26,1085,5,1123,"2018"
"46278","261000 PALMARES",1,3,7,1019,3,1033,"2018"
"46279","261010 PALMEIRINA",2,0,0,101,1,104,"2018"
"46280","261020 PANELAS",0,1,6,351,11,369,"2018"
"46281","261030 PARANATAMA",2,0,0,237,1,240,"2018"
"46282","261040 PARNAMIRIM",1,3,7,295,2,308,"2018"
"46283","261050 PASSIRA",0,0,4,387,3,394,"2018"
"46284","261060 PAUDALHO",2,1,8,843,8,862,"2018"
"46285","261070 PAULISTA",16,11,47,4046,19,4139,"2018"
"46286","261080 PEDRA",1,1,3,296,3,304,"2018"
"46287","261090 PESQUEIRA",1,2,16,915,5,939,"2018"
"46288","261100 PETROLANDIA",1,2,8,698,5,714,"2018"
"46289","261110 PETROLINA",34,27,129,6308,80,6578,"2018"
"46290","261120 POCAO",0,1,0,155,2,158,"2018"
"46291","261130 POMBOS",2,0,6,391,2,401,"2018"
"46292","261140 PRIMAVERA",2,0,3,145,0,150,"2018"
"46293","261150 QUIPAPA",3,0,1,288,2,294,"2018"
"46294","261153 QUIXABA",0,1,1,104,0,106,"2018"
"46295","261160 RECIFE",58,79,250,21697,128,22212,"2018"
"46296","261170 RIACHO DAS ALMAS",1,0,2,358,13,374,"2018"
"46297","261180 RIBEIRAO",2,2,6,459,2,471,"2018"
"46298","261190 RIO FORMOSO",0,2,5,366,0,373,"2018"
"46299","261200 SAIRE",1,3,2,102,2,110,"2018"
"46300","261210 SALGADINHO",1,0,1,62,0,64,"2018"
"46301","261220 SALGUEIRO",4,8,15,975,7,1009,"2018"
"46302","261230 SALOA",1,0,2,225,3,231,"2018"
"46303","261240 SANHARO",0,5,4,250,10,269,"2018"
"46304","261245 SANTA CRUZ",0,3,4,221,0,228,"2018"
"46305","261247 SANTA CRUZ DA BAIXA VERDE",0,2,1,141,42,186,"2018"
"46306","261250 SANTA CRUZ DO CAPIBARIBE",3,5,9,1476,19,1512,"2018"
"46307","261255 SANTA FILOMENA",0,1,6,194,2,203,"2018"
"46308","261260 SANTA MARIA DA BOA VISTA",3,10,15,686,9,723,"2018"
"46309","261270 SANTA MARIA DO CAMBUCA",2,0,3,198,1,204,"2018"
"46310","261280 SANTA TEREZINHA",0,0,1,153,0,154,"2018"
"46311","261290 SAO BENEDITO DO SUL",0,1,2,133,2,138,"2018"
"46312","261300 SAO BENTO DO UNA",2,5,9,731,13,760,"2018"
"46313","261310 SAO CAITANO",3,6,9,498,11,527,"2018"
"46314","261320 SAO JOAO",0,3,2,350,3,358,"2018"
"46315","261330 SAO JOAQUIM DO MONTE",2,0,4,336,8,350,"2018"
"46316","261340 SAO JOSE DA COROA GRANDE",1,3,3,318,5,330,"2018"
"46317","261350 SAO JOSE DO BELMONTE",1,1,9,532,11,554,"2018"
"46318","261360 SAO JOSE DO EGITO",2,2,4,446,0,454,"2018"
"46319","261370 SAO LOURENCO DA MATA",3,7,23,1522,8,1563,"2018"
"46320","261380 SAO VICENTE FERRER",0,0,2,299,2,303,"2018"
"46321","261390 SERRA TALHADA",8,4,22,1309,269,1612,"2018"
"46322","261400 SERRITA",0,0,5,289,1,295,"2018"
"46323","261410 SERTANIA",0,1,3,422,1,427,"2018"
"46324","261420 SIRINHAEM",2,0,8,573,4,587,"2018"
"46325","261430 MOREILANDIA",0,0,5,137,1,143,"2018"
"46326","261440 SOLIDAO",0,0,0,82,0,82,"2018"
"46327","261450 SURUBIM",0,2,8,910,5,925,"2018"
"46328","261460 TABIRA",1,2,2,463,0,468,"2018"
"46329","261470 TACAIMBO",1,0,1,160,6,168,"2018"
"46330","261480 TACARATU",0,2,3,361,2,368,"2018"
"46331","261485 TAMANDARE",1,3,5,356,3,368,"2018"
"46332","261500 TAQUARITINGA DO NORTE",2,2,3,408,5,420,"2018"
"46333","261510 TEREZINHA",0,1,1,99,0,101,"2018"
"46334","261520 TERRA NOVA",0,0,2,133,0,135,"2018"
"46335","261530 TIMBAUBA",0,3,8,682,5,698,"2018"
"46336","261540 TORITAMA",2,0,8,653,11,674,"2018"
"46337","261550 TRACUNHAEM",0,1,2,189,1,193,"2018"
"46338","261560 TRINDADE",5,4,3,549,1,562,"2018"
"46339","261570 TRIUNFO",0,1,3,143,32,179,"2018"
"46340","261580 TUPANATINGA",0,1,5,365,6,377,"2018"
"46341","261590 TUPARETAMA",0,1,5,96,0,102,"2018"
"46342","261600 VENTUROSA",3,0,2,278,2,285,"2018"
"46343","261610 VERDEJANTE",0,0,2,140,1,143,"2018"
"46344","261618 VERTENTE DO LERIO",1,0,2,108,1,112,"2018"
"46345","261620 VERTENTES",0,1,4,354,2,361,"2018"
"46346","261630 VICENCIA",2,0,3,432,0,437,"2018"
"46347","261640 VITORIA DE SANTO ANTAO",5,3,17,2023,11,2059,"2018"
"46348","261650 XEXEU",0,0,3,227,2,232,"2018"
"46349","270010 AGUA BRANCA",0,2,4,293,31,330,"2018"
"46350","270020 ANADIA",2,1,3,243,5,254,"2018"
"46351","270030 ARAPIRACA",7,15,36,4092,6,4156,"2018"
"46352","270040 ATALAIA",1,6,9,634,38,688,"2018"
"46353","270050 BARRA DE SANTO ANTONIO",0,1,7,325,4,337,"2018"
"46354","270060 BARRA DE SAO MIGUEL",0,0,4,152,2,158,"2018"
"46355","270070 BATALHA",0,0,2,306,0,308,"2018"
"46356","270080 BELEM",0,0,2,80,0,82,"2018"
"46357","270090 BELO MONTE",0,0,0,99,2,101,"2018"
"46358","270100 BOCA DA MATA",1,0,9,330,0,340,"2018"
"46359","270110 BRANQUINHA",0,0,1,182,0,183,"2018"
"46360","270120 CACIMBINHAS",0,0,4,156,0,160,"2018"
"46361","270130 CAJUEIRO",1,4,4,287,16,312,"2018"
"46362","270135 CAMPESTRE",1,0,4,90,1,96,"2018"
"46363","270140 CAMPO ALEGRE",1,1,12,521,1,536,"2018"
"46364","270150 CAMPO GRANDE",0,0,2,133,1,136,"2018"
"46365","270160 CANAPI",0,2,3,290,23,318,"2018"
"46366","270170 CAPELA",1,1,5,171,21,199,"2018"
"46367","270180 CARNEIROS",0,0,2,165,0,167,"2018"
"46368","270190 CHA PRETA",0,0,1,79,15,95,"2018"
"46369","270200 COITE DO NOIA",1,0,1,160,0,162,"2018"
"46370","270210 COLONIA LEOPOLDINA",0,0,10,263,1,274,"2018"
"46371","270220 COQUEIRO SECO",0,0,1,77,0,78,"2018"
"46372","270230 CORURIPE",0,1,10,884,14,909,"2018"
"46373","270235 CRAIBAS",2,1,4,424,7,438,"2018"
"46374","270240 DELMIRO GOUVEIA",3,5,18,748,44,818,"2018"
"46375","270250 DOIS RIACHOS",2,1,1,157,1,162,"2018"
"46376","270255 ESTRELA DE ALAGOAS",0,2,2,240,0,244,"2018"
"46377","270260 FEIRA GRANDE",1,0,2,360,1,364,"2018"
"46378","270270 FELIZ DESERTO",0,0,2,76,1,79,"2018"
"46379","270280 FLEXEIRAS",0,0,1,202,9,212,"2018"
"46380","270290 GIRAU DO PONCIANO",0,0,4,587,2,593,"2018"
"46381","270300 IBATEGUARA",1,1,6,263,2,273,"2018"
"46382","270310 IGACI",1,1,11,403,2,418,"2018"
"46383","270320 IGREJA NOVA",0,1,4,345,0,350,"2018"
"46384","270330 INHAPI",0,0,2,247,43,292,"2018"
"46385","270340 JACARE DOS HOMENS",1,0,2,103,0,106,"2018"
"46386","270350 JACUIPE",0,0,0,69,0,69,"2018"
"46387","270360 JAPARATINGA",0,0,2,157,2,161,"2018"
"46388","270370 JARAMATAIA",0,0,0,95,0,95,"2018"
"46389","270375 JEQUIA DA PRAIA",0,0,1,150,0,151,"2018"
"46390","270380 JOAQUIM GOMES",0,1,1,314,7,323,"2018"
"46391","270390 JUNDIA",0,1,0,71,1,73,"2018"
"46392","270400 JUNQUEIRO",3,2,2,326,0,333,"2018"
"46393","270410 LAGOA DA CANOA",0,1,5,332,1,339,"2018"
"46394","270420 LIMOEIRO DE ANADIA",0,2,5,388,0,395,"2018"
"46395","270430 MACEIO",26,53,195,14436,319,15029,"2018"
"46396","270440 MAJOR ISIDORO",0,0,4,244,5,253,"2018"
"46397","270450 MARAGOGI",1,1,6,595,7,610,"2018"
"46398","270460 MARAVILHA",0,0,2,154,0,156,"2018"
"46399","270470 MARECHAL DEODORO",1,4,15,897,5,922,"2018"
"46400","270480 MARIBONDO",1,1,2,180,0,184,"2018"
"46401","270490 MAR VERMELHO",0,0,1,27,3,31,"2018"
"46402","270500 MATA GRANDE",1,1,6,307,35,350,"2018"
"46403","270510 MATRIZ DE CAMARAGIBE",2,1,5,434,2,444,"2018"
"46404","270520 MESSIAS",0,2,3,289,4,298,"2018"
"46405","270530 MINADOR DO NEGRAO",0,0,4,84,1,89,"2018"
"46406","270540 MONTEIROPOLIS",0,0,1,122,0,123,"2018"
"46407","270550 MURICI",0,1,8,531,5,545,"2018"
"46408","270560 NOVO LINO",0,1,5,136,2,144,"2018"
"46409","270570 OLHO D'AGUA DAS FLORES",0,2,4,341,1,348,"2018"
"46410","270580 OLHO D'AGUA DO CASADO",0,2,0,159,4,165,"2018"
"46411","270590 OLHO D'AGUA GRANDE",1,1,1,106,0,109,"2018"
"46412","270600 OLIVENCA",2,0,1,211,0,214,"2018"
"46413","270610 OURO BRANCO",0,0,0,201,1,202,"2018"
"46414","270620 PALESTINA",0,2,2,93,0,97,"2018"
"46415","270630 PALMEIRA DOS INDIOS",2,5,13,1332,2,1354,"2018"
"46416","270640 PAO DE ACUCAR",0,2,2,388,4,396,"2018"
"46417","270642 PARICONHA",1,1,5,174,8,189,"2018"
"46418","270644 PARIPUEIRA",0,1,2,228,3,234,"2018"
"46419","270650 PASSO DE CAMARAGIBE",0,0,6,230,1,237,"2018"
"46420","270660 PAULO JACINTO",0,0,1,86,3,90,"2018"
"46421","270670 PENEDO",2,2,24,943,2,973,"2018"
"46422","270680 PIACABUCU",0,1,7,320,1,329,"2018"
"46423","270690 PILAR",1,1,8,634,14,658,"2018"
"46424","270700 PINDOBA",0,0,0,31,2,33,"2018"
"46425","270710 PIRANHAS",0,0,6,440,7,453,"2018"
"46426","270720 POCO DAS TRINCHEIRAS",0,1,1,200,1,203,"2018"
"46427","270730 PORTO CALVO",0,0,7,401,3,411,"2018"
"46428","270740 PORTO DE PEDRAS",0,0,1,158,0,159,"2018"
"46429","270750 PORTO REAL DO COLEGIO",1,1,3,289,1,295,"2018"
"46430","270760 QUEBRANGULO",0,1,5,172,0,178,"2018"
"46431","270770 RIO LARGO",3,2,21,1282,40,1348,"2018"
"46432","270780 ROTEIRO",2,1,2,146,1,152,"2018"
"46433","270790 SANTA LUZIA DO NORTE",0,0,1,107,6,114,"2018"
"46434","270800 SANTANA DO IPANEMA",2,0,6,856,0,864,"2018"
"46435","270810 SANTANA DO MUNDAU",0,0,4,179,2,185,"2018"
"46436","270820 SAO BRAS",0,0,0,82,1,83,"2018"
"46437","270830 SAO JOSE DA LAJE",2,2,7,404,3,418,"2018"
"46438","270840 SAO JOSE DA TAPERA",3,0,2,569,1,575,"2018"
"46439","270850 SAO LUIS DO QUITUNDE",2,1,7,525,3,538,"2018"
"46440","270860 SAO MIGUEL DOS CAMPOS",4,6,16,901,6,933,"2018"
"46441","270870 SAO MIGUEL DOS MILAGRES",1,0,0,124,0,125,"2018"
"46442","270880 SAO SEBASTIAO",2,6,8,557,1,574,"2018"
"46443","270890 SATUBA",0,0,5,308,6,319,"2018"
"46444","270895 SENADOR RUI PALMEIRA",0,0,4,197,2,203,"2018"
"46445","270900 TANQUE D'ARCA",0,0,1,76,0,77,"2018"
"46446","270910 TAQUARANA",1,1,1,273,2,278,"2018"
"46447","270915 TEOTONIO VILELA",7,1,8,641,1,658,"2018"
"46448","270920 TRAIPU",0,1,3,329,10,343,"2018"
"46449","270930 UNIAO DOS PALMARES",1,4,11,1113,7,1136,"2018"
"46450","270940 VICOSA",0,3,5,351,42,401,"2018"
"46451","280010 AMPARO DE SAO FRANCISCO",0,0,0,28,1,29,"2018"
"46452","280020 AQUIDABA",1,1,4,251,6,263,"2018"
"46453","280030 ARACAJU",32,43,129,9087,67,9358,"2018"
"46454","280040 ARAUA",0,0,1,135,2,138,"2018"
"46455","280050 AREIA BRANCA",3,1,2,265,6,277,"2018"
"46456","280060 BARRA DOS COQUEIROS",2,3,8,523,2,538,"2018"
"46457","280067 BOQUIM",0,1,4,325,3,333,"2018"
"46458","280070 BREJO GRANDE",0,0,0,122,4,126,"2018"
"46459","280100 CAMPO DO BRITO",2,1,8,251,4,266,"2018"
"46460","280110 CANHOBA",0,2,2,71,2,77,"2018"
"46461","280120 CANINDE DE SAO FRANCISCO",1,4,8,539,20,572,"2018"
"46462","280130 CAPELA",1,3,6,496,27,533,"2018"
"46463","280140 CARIRA",2,0,2,295,8,307,"2018"
"46464","280150 CARMOPOLIS",2,1,5,234,5,247,"2018"
"46465","280160 CEDRO DE SAO JOAO",0,0,0,68,0,68,"2018"
"46466","280170 CRISTINAPOLIS",2,1,5,279,11,298,"2018"
"46467","280190 CUMBE",0,0,0,40,1,41,"2018"
"46468","280200 DIVINA PASTORA",0,1,2,63,0,66,"2018"
"46469","280210 ESTANCIA",1,5,16,1110,11,1143,"2018"
"46470","280220 FEIRA NOVA",1,0,1,97,4,103,"2018"
"46471","280230 FREI PAULO",0,0,3,213,4,220,"2018"
"46472","280240 GARARU",1,2,3,147,9,162,"2018"
"46473","280250 GENERAL MAYNARD",0,0,0,38,2,40,"2018"
"46474","280260 GRACHO CARDOSO",0,0,1,65,4,70,"2018"
"46475","280270 ILHA DAS FLORES",0,0,2,140,5,147,"2018"
"46476","280280 INDIAROBA",0,2,3,282,5,292,"2018"
"46477","280290 ITABAIANA",6,6,17,1450,15,1494,"2018"
"46478","280300 ITABAIANINHA",0,3,8,606,6,623,"2018"
"46479","280310 ITABI",0,1,1,54,1,57,"2018"
"46480","280320 ITAPORANGA D'AJUDA",2,0,10,588,14,614,"2018"
"46481","280330 JAPARATUBA",1,1,6,210,8,226,"2018"
"46482","280340 JAPOATA",0,0,3,182,5,190,"2018"
"46483","280350 LAGARTO",3,3,14,1506,7,1533,"2018"
"46484","280360 LARANJEIRAS",1,2,5,400,10,418,"2018"
"46485","280370 MACAMBIRA",1,0,1,102,0,104,"2018"
"46486","280380 MALHADA DOS BOIS",1,1,0,56,4,62,"2018"
"46487","280390 MALHADOR",0,0,2,181,5,188,"2018"
"46488","280400 MARUIM",0,0,5,262,6,273,"2018"
"46489","280410 MOITA BONITA",0,0,2,118,1,121,"2018"
"46490","280420 MONTE ALEGRE DE SERGIPE",0,1,3,248,16,268,"2018"
"46491","280430 MURIBECA",0,0,1,112,3,116,"2018"
"46492","280440 NEOPOLIS",1,1,3,256,8,269,"2018"
"46493","280445 NOSSA SENHORA APARECIDA",1,0,0,100,4,105,"2018"
"46494","280450 NOSSA SENHORA DA GLORIA",0,2,6,545,30,583,"2018"
"46495","280460 NOSSA SENHORA DAS DORES",0,2,5,351,9,367,"2018"
"46496","280470 NOSSA SENHORA DE LOURDES",0,0,1,69,2,72,"2018"
"46497","280480 NOSSA SENHORA DO SOCORRO",11,11,58,3150,27,3257,"2018"
"46498","280490 PACATUBA",0,1,6,216,12,235,"2018"
"46499","280500 PEDRA MOLE",0,1,1,41,0,43,"2018"
"46500","280510 PEDRINHAS",0,0,2,98,0,100,"2018"
"46501","280520 PINHAO",0,1,1,82,1,85,"2018"
"46502","280530 PIRAMBU",0,0,2,150,0,152,"2018"
"46503","280540 POCO REDONDO",0,1,9,532,30,572,"2018"
"46504","280550 POCO VERDE",0,1,6,279,5,291,"2018"
"46505","280560 PORTO DA FOLHA",0,0,11,367,16,394,"2018"
"46506","280570 PROPRIA",1,6,10,454,10,481,"2018"
"46507","280580 RIACHAO DO DANTAS",0,0,6,231,4,241,"2018"
"46508","280590 RIACHUELO",0,0,1,135,5,141,"2018"
"46509","280600 RIBEIROPOLIS",0,0,4,188,0,192,"2018"
"46510","280610 ROSARIO DO CATETE",1,1,1,146,4,153,"2018"
"46511","280620 SALGADO",3,1,3,266,5,278,"2018"
"46512","280630 SANTA LUZIA DO ITANHY",0,0,3,218,5,226,"2018"
"46513","280640 SANTANA DO SAO FRANCISCO",0,1,3,103,3,110,"2018"
"46514","280650 SANTA ROSA DE LIMA",0,0,0,51,3,54,"2018"
"46515","280660 SANTO AMARO DAS BROTAS",0,0,3,161,1,165,"2018"
"46516","280670 SAO CRISTOVAO",6,9,18,1317,30,1380,"2018"
"46517","280680 SAO DOMINGOS",0,2,3,143,6,154,"2018"
"46518","280690 SAO FRANCISCO",0,0,0,31,0,31,"2018"
"46519","280700 SAO MIGUEL DO ALEIXO",1,0,0,47,1,49,"2018"
"46520","280710 SIMAO DIAS",0,3,11,632,6,652,"2018"
"46521","280720 SIRIRI",3,3,0,93,0,99,"2018"
"46522","280730 TELHA",0,1,2,53,0,56,"2018"
"46523","280740 TOBIAS BARRETO",4,4,12,652,5,677,"2018"
"46524","280750 TOMAR DO GERU",0,0,5,170,2,177,"2018"
"46525","280760 UMBAUBA",0,4,3,401,6,414,"2018"
"46526","MUNICIPIO IGNORADO - BA",0,0,0,2,1,3,"2018"
"46527","290010 ABAIRA",0,0,1,45,4,50,"2018"
"46528","290020 ABARE",0,3,11,279,3,296,"2018"
"46529","290030 ACAJUTIBA",1,0,3,179,3,186,"2018"
"46530","290035 ADUSTINA",1,0,0,144,18,163,"2018"
"46531","290040 AGUA FRIA",0,1,3,150,1,155,"2018"
"46532","290050 ERICO CARDOSO",0,0,1,109,3,113,"2018"
"46533","290060 AIQUARA",0,0,1,46,1,48,"2018"
"46534","290070 ALAGOINHAS",9,11,33,2275,41,2369,"2018"
"46535","290080 ALCOBACA",0,1,4,310,3,318,"2018"
"46536","290090 ALMADINA",0,1,1,49,0,51,"2018"
"46537","290100 AMARGOSA",5,3,24,443,2,477,"2018"
"46538","290110 AMELIA RODRIGUES",2,1,3,177,3,186,"2018"
"46539","290115 AMERICA DOURADA",1,2,9,206,1,219,"2018"
"46540","290120 ANAGE",1,1,1,210,1,214,"2018"
"46541","290130 ANDARAI",0,1,2,189,1,193,"2018"
"46542","290135 ANDORINHA",3,2,3,220,0,228,"2018"
"46543","290140 ANGICAL",1,1,5,177,0,184,"2018"
"46544","290150 ANGUERA",0,1,2,73,3,79,"2018"
"46545","290160 ANTAS",1,0,3,133,9,146,"2018"
"46546","290170 ANTONIO CARDOSO",0,1,3,114,4,122,"2018"
"46547","290180 ANTONIO GONCALVES",0,0,0,165,1,166,"2018"
"46548","290190 APORA",1,1,6,149,6,163,"2018"
"46549","290195 APUAREMA",0,0,2,89,2,93,"2018"
"46550","290200 ARACATU",1,0,2,169,0,172,"2018"
"46551","290205 ARACAS",0,1,3,146,4,154,"2018"
"46552","290210 ARACI",3,4,18,689,18,732,"2018"
"46553","290220 ARAMARI",0,2,1,110,1,114,"2018"
"46554","290225 ARATACA",0,2,3,113,0,118,"2018"
"46555","290230 ARATUIPE",0,1,3,129,2,135,"2018"
"46556","290240 AURELINO LEAL",0,1,6,128,47,182,"2018"
"46557","290250 BAIANOPOLIS",0,0,2,132,0,134,"2018"
"46558","290260 BAIXA GRANDE",1,0,3,218,1,223,"2018"
"46559","290265 BANZAE",0,0,0,16,163,179,"2018"
"46560","290270 BARRA",2,8,11,897,25,943,"2018"
"46561","290280 BARRA DA ESTIVA",0,4,6,410,0,420,"2018"
"46562","290290 BARRA DO CHOCA",2,3,11,468,6,490,"2018"
"46563","290300 BARRA DO MENDES",0,1,4,158,1,164,"2018"
"46564","290310 BARRA DO ROCHA",0,0,2,61,0,63,"2018"
"46565","290320 BARREIRAS",7,11,42,2652,4,2716,"2018"
"46566","290323 BARRO ALTO",2,4,5,181,1,193,"2018"
"46567","290327 BARROCAS",2,4,13,186,0,205,"2018"
"46568","290330 BARRO PRETO",2,1,2,89,3,97,"2018"
"46569","290340 BELMONTE",0,1,4,306,9,320,"2018"
"46570","290350 BELO CAMPO",1,1,1,236,4,243,"2018"
"46571","290360 BIRITINGA",1,1,5,204,1,212,"2018"
"46572","290370 BOA NOVA",1,0,1,218,5,225,"2018"
"46573","290380 BOA VISTA DO TUPIM",0,0,3,219,4,226,"2018"
"46574","290390 BOM JESUS DA LAPA",0,9,7,1172,9,1197,"2018"
"46575","290395 BOM JESUS DA SERRA",2,0,4,111,3,120,"2018"
"46576","290400 BONINAL",0,0,2,186,8,196,"2018"
"46577","290405 BONITO",1,2,4,255,2,264,"2018"
"46578","290410 BOQUIRA",1,2,3,272,4,282,"2018"
"46579","290420 BOTUPORA",0,1,1,138,0,140,"2018"
"46580","290430 BREJOES",0,0,3,165,1,169,"2018"
"46581","290440 BREJOLANDIA",0,1,3,94,1,99,"2018"
"46582","290450 BROTAS DE MACAUBAS",0,0,3,129,4,136,"2018"
"46583","290460 BRUMADO",6,8,21,881,4,920,"2018"
"46584","290470 BUERAREMA",1,3,9,223,3,239,"2018"
"46585","290475 BURITIRAMA",2,2,5,313,3,325,"2018"
"46586","290480 CAATIBA",0,0,3,64,3,70,"2018"
"46587","290485 CABACEIRAS DO PARAGUACU",1,0,3,168,49,221,"2018"
"46588","290490 CACHOEIRA",0,1,3,99,301,404,"2018"
"46589","290500 CACULE",3,2,3,286,1,295,"2018"
"46590","290510 CAEM",0,0,2,136,2,140,"2018"
"46591","290515 CAETANOS",0,0,1,114,2,117,"2018"
"46592","290520 CAETITE",0,0,8,706,10,724,"2018"
"46593","290530 CAFARNAUM",0,3,12,318,1,334,"2018"
"46594","290540 CAIRU",2,2,9,320,3,336,"2018"
"46595","290550 CALDEIRAO GRANDE",0,0,0,219,1,220,"2018"
"46596","290560 CAMACAN",2,5,6,383,4,400,"2018"
"46597","290570 CAMACARI",12,13,53,4217,88,4383,"2018"
"46598","290580 CAMAMU",2,4,24,526,9,565,"2018"
"46599","290590 CAMPO ALEGRE DE LOURDES",6,1,8,517,16,548,"2018"
"46600","290600 CAMPO FORMOSO",0,12,16,1181,29,1238,"2018"
"46601","290610 CANAPOLIS",0,1,4,106,7,118,"2018"
"46602","290620 CANARANA",2,2,19,324,2,349,"2018"
"46603","290630 CANAVIEIRAS",3,2,15,455,29,504,"2018"
"46604","290640 CANDEAL",1,1,0,77,8,87,"2018"
"46605","290650 CANDEIAS",6,6,18,1071,5,1106,"2018"
"46606","290660 CANDIBA",2,1,1,151,1,156,"2018"
"46607","290670 CANDIDO SALES",1,0,6,309,2,318,"2018"
"46608","290680 CANSANCAO",1,3,10,450,3,467,"2018"
"46609","290682 CANUDOS",0,0,3,213,4,220,"2018"
"46610","290685 CAPELA DO ALTO ALEGRE",0,1,0,111,0,112,"2018"
"46611","290687 CAPIM GROSSO",0,1,5,516,2,524,"2018"
"46612","290689 CARAIBAS",0,0,2,98,3,103,"2018"
"46613","290690 CARAVELAS",2,1,8,270,2,283,"2018"
"46614","290700 CARDEAL DA SILVA",1,0,1,116,3,121,"2018"
"46615","290710 CARINHANHA",3,0,2,467,4,476,"2018"
"46616","290720 CASA NOVA",5,9,19,1010,7,1050,"2018"
"46617","290730 CASTRO ALVES",0,1,6,304,0,311,"2018"
"46618","290740 CATOLANDIA",0,0,1,37,0,38,"2018"
"46619","290750 CATU",5,2,17,514,2,540,"2018"
"46620","290755 CATURAMA",0,0,0,106,2,108,"2018"
"46621","290760 CENTRAL",0,1,3,232,1,237,"2018"
"46622","290770 CHORROCHO",0,0,7,172,2,181,"2018"
"46623","290780 CICERO DANTAS",0,1,3,235,87,326,"2018"
"46624","290790 CIPO",1,4,3,146,132,286,"2018"
"46625","290800 COARACI",1,1,12,239,2,255,"2018"
"46626","290810 COCOS",0,0,2,268,4,274,"2018"
"46627","290820 CONCEICAO DA FEIRA",0,0,5,83,201,289,"2018"
"46628","290830 CONCEICAO DO ALMEIDA",0,1,7,162,2,172,"2018"
"46629","290840 CONCEICAO DO COITE",1,3,17,1031,7,1059,"2018"
"46630","290850 CONCEICAO DO JACUIPE",0,2,4,343,10,359,"2018"
"46631","290860 CONDE",0,2,12,327,10,351,"2018"
"46632","290870 CONDEUBA",0,1,4,182,1,188,"2018"
"46633","290880 CONTENDAS DO SINCORA",0,0,0,40,1,41,"2018"
"46634","290890 CORACAO DE MARIA",0,1,5,244,13,263,"2018"
"46635","290900 CORDEIROS",0,0,1,83,0,84,"2018"
"46636","290910 CORIBE",2,0,4,202,1,209,"2018"
"46637","290920 CORONEL JOAO SA",1,1,3,197,7,209,"2018"
"46638","290930 CORRENTINA",0,2,2,114,321,439,"2018"
"46639","290940 COTEGIPE",1,1,1,169,5,177,"2018"
"46640","290950 CRAVOLANDIA",0,0,2,56,0,58,"2018"
"46641","290960 CRISOPOLIS",0,0,6,249,7,262,"2018"
"46642","290970 CRISTOPOLIS",0,0,2,171,1,174,"2018"
"46643","290980 CRUZ DAS ALMAS",2,2,13,783,9,809,"2018"
"46644","290990 CURACA",5,4,12,531,9,561,"2018"
"46645","291000 DARIO MEIRA",1,0,4,141,1,147,"2018"
"46646","291005 DIAS D'AVILA",5,10,19,1101,8,1143,"2018"
"46647","291010 DOM BASILIO",1,0,1,140,0,142,"2018"
"46648","291020 DOM MACEDO COSTA",0,0,0,51,0,51,"2018"
"46649","291030 ELISIO MEDRADO",0,1,2,77,0,80,"2018"
"46650","291040 ENCRUZILHADA",1,1,8,262,3,275,"2018"
"46651","291050 ENTRE RIOS",2,0,10,520,7,539,"2018"
"46652","291060 ESPLANADA",2,3,11,535,2,553,"2018"
"46653","291070 EUCLIDES DA CUNHA",1,5,13,852,9,880,"2018"
"46654","291072 EUNAPOLIS",6,10,26,1941,6,1989,"2018"
"46655","291075 FATIMA",0,3,4,179,32,218,"2018"
"46656","291077 FEIRA DA MATA",0,0,0,27,5,32,"2018"
"46657","291080 FEIRA DE SANTANA",16,26,136,9833,304,10315,"2018"
"46658","291085 FILADELFIA",1,5,15,250,4,275,"2018"
"46659","291090 FIRMINO ALVES",1,1,1,47,0,50,"2018"
"46660","291100 FLORESTA AZUL",1,0,2,70,1,74,"2018"
"46661","291110 FORMOSA DO RIO PRETO",3,1,9,425,10,448,"2018"
"46662","291120 GANDU",3,1,6,459,2,471,"2018"
"46663","291125 GAVIAO",0,0,1,42,0,43,"2018"
"46664","291130 GENTIO DO OURO",0,1,4,115,0,120,"2018"
"46665","291140 GLORIA",0,1,10,257,3,271,"2018"
"46666","291150 GONGOGI",0,0,0,60,0,60,"2018"
"46667","291160 GOVERNADOR MANGABEIRA",1,1,3,160,106,271,"2018"
"46668","291165 GUAJERU",2,0,0,97,0,99,"2018"
"46669","291170 GUANAMBI",5,2,12,1264,39,1322,"2018"
"46670","291180 GUARATINGA",0,1,5,251,5,262,"2018"
"46671","291185 HELIOPOLIS",0,0,1,90,33,124,"2018"
"46672","291190 IACU",1,3,7,422,2,435,"2018"
"46673","291200 IBIASSUCE",0,0,0,107,0,107,"2018"
"46674","291210 IBICARAI",0,0,4,255,0,259,"2018"
"46675","291220 IBICOARA",1,5,4,341,1,352,"2018"
"46676","291230 IBICUI",0,2,5,119,3,129,"2018"
"46677","291240 IBIPEBA",0,2,3,177,2,184,"2018"
"46678","291250 IBIPITANGA",0,0,3,140,2,145,"2018"
"46679","291260 IBIQUERA",0,0,0,52,0,52,"2018"
"46680","291270 IBIRAPITANGA",1,4,7,286,5,303,"2018"
"46681","291280 IBIRAPUA",0,1,1,119,0,121,"2018"
"46682","291290 IBIRATAIA",0,2,1,299,1,303,"2018"
"46683","291300 IBITIARA",0,2,1,148,0,151,"2018"
"46684","291310 IBITITA",1,1,5,216,0,223,"2018"
"46685","291320 IBOTIRAMA",0,0,12,385,9,406,"2018"
"46686","291330 ICHU",1,0,1,46,0,48,"2018"
"46687","291340 IGAPORA",1,0,4,153,5,163,"2018"
"46688","291345 IGRAPIUNA",1,3,5,193,4,206,"2018"
"46689","291350 IGUAI",1,4,4,365,0,374,"2018"
"46690","291360 ILHEUS",5,20,43,2154,250,2472,"2018"
"46691","291370 INHAMBUPE",0,5,7,407,10,429,"2018"
"46692","291380 IPECAETA",0,0,4,123,9,136,"2018"
"46693","291390 IPIAU",1,1,13,657,1,673,"2018"
"46694","291400 IPIRA",4,3,11,787,3,808,"2018"
"46695","291410 IPUPIARA",0,1,2,111,1,115,"2018"
"46696","291420 IRAJUBA",2,0,0,84,0,86,"2018"
"46697","291430 IRAMAIA",0,0,6,98,1,105,"2018"
"46698","291440 IRAQUARA",1,1,6,378,2,388,"2018"
"46699","291450 IRARA",2,0,5,314,9,330,"2018"
"46700","291460 IRECE",5,12,27,1316,1,1361,"2018"
"46701","291465 ITABELA",1,4,9,479,1,494,"2018"
"46702","291470 ITABERABA",1,2,7,949,1,960,"2018"
"46703","291480 ITABUNA",11,13,56,2811,13,2904,"2018"
"46704","291490 ITACARE",0,3,6,320,29,358,"2018"
"46705","291500 ITAETE",1,0,1,204,2,208,"2018"
"46706","291510 ITAGI",1,1,4,194,2,202,"2018"
"46707","291520 ITAGIBA",2,1,3,155,2,163,"2018"
"46708","291530 ITAGIMIRIM",0,1,1,64,4,70,"2018"
"46709","291535 ITAGUACU DA BAHIA",3,2,4,189,0,198,"2018"
"46710","291540 ITAJU DO COLONIA",1,1,3,85,4,94,"2018"
"46711","291550 ITAJUIPE",1,1,9,302,3,316,"2018"
"46712","291560 ITAMARAJU",3,4,20,1032,16,1075,"2018"
"46713","291570 ITAMARI",1,0,1,102,2,106,"2018"
"46714","291580 ITAMBE",0,4,6,266,5,281,"2018"
"46715","291590 ITANAGRA",0,1,1,89,2,93,"2018"
"46716","291600 ITANHEM",1,0,3,162,2,168,"2018"
"46717","291610 ITAPARICA",0,2,1,209,41,253,"2018"
"46718","291620 ITAPE",1,0,2,126,4,133,"2018"
"46719","291630 ITAPEBI",0,0,2,114,0,116,"2018"
"46720","291640 ITAPETINGA",4,13,17,913,66,1013,"2018"
"46721","291650 ITAPICURU",0,5,5,382,13,405,"2018"
"46722","291660 ITAPITANGA",1,0,2,87,1,91,"2018"
"46723","291670 ITAQUARA",0,0,4,71,2,77,"2018"
"46724","291680 ITARANTIM",1,2,10,209,10,232,"2018"
"46725","291685 ITATIM",0,0,0,170,3,173,"2018"
"46726","291690 ITIRUCU",0,0,2,129,0,131,"2018"
"46727","291700 ITIUBA",1,5,7,502,5,520,"2018"
"46728","291710 ITORORO",0,1,5,204,13,223,"2018"
"46729","291720 ITUACU",0,0,6,227,0,233,"2018"
"46730","291730 ITUBERA",1,0,6,341,1,349,"2018"
"46731","291733 IUIU",0,0,4,114,0,118,"2018"
"46732","291735 JABORANDI",0,0,4,152,3,159,"2018"
"46733","291740 JACARACI",0,1,1,127,2,131,"2018"
"46734","291750 JACOBINA",3,9,15,1295,9,1331,"2018"
"46735","291760 JAGUAQUARA",1,3,8,758,2,772,"2018"
"46736","291770 JAGUARARI",3,3,12,376,5,399,"2018"
"46737","291780 JAGUARIPE",0,1,3,186,2,192,"2018"
"46738","291790 JANDAIRA",1,1,1,156,1,160,"2018"
"46739","291800 JEQUIE",2,5,34,2461,22,2524,"2018"
"46740","291810 JEREMOABO",2,7,8,481,13,511,"2018"
"46741","291820 JIQUIRICA",1,0,3,155,0,159,"2018"
"46742","291830 JITAUNA",1,1,4,160,1,167,"2018"
"46743","291835 JOAO DOURADO",1,4,16,420,1,442,"2018"
"46744","291840 JUAZEIRO",21,23,86,4401,42,4573,"2018"
"46745","291845 JUCURUCU",0,6,4,100,1,111,"2018"
"46746","291850 JUSSARA",1,2,6,197,1,207,"2018"
"46747","291855 JUSSARI",0,1,1,78,1,81,"2018"
"46748","291860 JUSSIAPE",0,0,0,72,0,72,"2018"
"46749","291870 LAFAIETE COUTINHO",0,0,1,51,2,54,"2018"
"46750","291875 LAGOA REAL",0,0,0,132,0,132,"2018"
"46751","291880 LAJE",3,2,9,269,5,288,"2018"
"46752","291890 LAJEDAO",0,0,2,44,0,46,"2018"
"46753","291900 LAJEDINHO",0,0,1,40,1,42,"2018"
"46754","291905 LAJEDO DO TABOCAL",0,0,1,73,1,75,"2018"
"46755","291910 LAMARAO",0,0,4,81,1,86,"2018"
"46756","291915 LAPAO",4,3,9,396,1,413,"2018"
"46757","291920 LAURO DE FREITAS",10,13,51,3032,23,3129,"2018"
"46758","291930 LENCOIS",0,1,0,138,5,144,"2018"
"46759","291940 LICINIO DE ALMEIDA",0,0,2,113,0,115,"2018"
"46760","291950 LIVRAMENTO DE NOSSA SENHORA",1,5,9,590,1,606,"2018"
"46761","291955 LUIS EDUARDO MAGALHAES",11,10,37,1885,12,1955,"2018"
"46762","291960 MACAJUBA",1,1,2,130,2,136,"2018"
"46763","291970 MACARANI",2,2,2,179,11,196,"2018"
"46764","291980 MACAUBAS",3,2,3,528,0,536,"2018"
"46765","291990 MACURURE",0,1,4,102,3,110,"2018"
"46766","291992 MADRE DE DEUS",0,2,6,271,1,280,"2018"
"46767","291995 MAETINGA",1,0,3,62,2,68,"2018"
"46768","292000 MAIQUINIQUE",0,1,2,95,2,100,"2018"
"46769","292010 MAIRI",0,5,3,182,0,190,"2018"
"46770","292020 MALHADA",0,1,2,232,13,248,"2018"
"46771","292030 MALHADA DE PEDRAS",0,0,2,110,0,112,"2018"
"46772","292040 MANOEL VITORINO",1,1,2,207,1,212,"2018"
"46773","292045 MANSIDAO",2,2,1,94,3,102,"2018"
"46774","292050 MARACAS",3,2,9,346,5,365,"2018"
"46775","292060 MARAGOGIPE",0,2,2,209,280,493,"2018"
"46776","292070 MARAU",1,4,5,241,15,266,"2018"
"46777","292080 MARCIONILIO SOUZA",1,0,3,126,0,130,"2018"
"46778","292090 MASCOTE",2,1,0,155,1,159,"2018"
"46779","292100 MATA DE SAO JOAO",4,2,17,699,7,729,"2018"
"46780","292105 MATINA",0,1,0,118,2,121,"2018"
"46781","292110 MEDEIROS NETO",0,3,4,307,0,314,"2018"
"46782","292120 MIGUEL CALMON",1,1,8,394,1,405,"2018"
"46783","292130 MILAGRES",0,1,1,150,0,152,"2018"
"46784","292140 MIRANGABA",1,1,1,172,2,177,"2018"
"46785","292145 MIRANTE",0,1,3,100,1,105,"2018"
"46786","292150 MONTE SANTO",2,0,24,663,6,695,"2018"
"46787","292160 MORPARA",1,0,4,103,0,108,"2018"
"46788","292170 MORRO DO CHAPEU",1,3,4,504,4,516,"2018"
"46789","292180 MORTUGABA",0,1,5,106,0,112,"2018"
"46790","292190 MUCUGE",0,0,2,142,2,146,"2018"
"46791","292200 MUCURI",0,2,25,659,1,687,"2018"
"46792","292205 MULUNGU DO MORRO",0,1,6,215,0,222,"2018"
"46793","292210 MUNDO NOVO",0,2,6,205,5,218,"2018"
"46794","292220 MUNIZ FERREIRA",1,0,3,89,1,94,"2018"
"46795","292225 MUQUEM DE SAO FRANCISCO",0,0,7,182,4,193,"2018"
"46796","292230 MURITIBA",0,1,10,211,104,326,"2018"
"46797","292240 MUTUIPE",0,8,2,265,1,276,"2018"
"46798","292250 NAZARE",2,4,2,327,1,336,"2018"
"46799","292260 NILO PECANHA",0,1,6,186,0,193,"2018"
"46800","292265 NORDESTINA",2,0,3,142,0,147,"2018"
"46801","292270 NOVA CANAA",0,1,2,129,1,133,"2018"
"46802","292273 NOVA FATIMA",0,0,0,69,0,69,"2018"
"46803","292275 NOVA IBIA",0,0,2,56,1,59,"2018"
"46804","292280 NOVA ITARANA",0,1,0,121,3,125,"2018"
"46805","292285 NOVA REDENCAO",1,0,2,79,13,95,"2018"
"46806","292290 NOVA SOURE",1,2,3,173,141,320,"2018"
"46807","292300 NOVA VICOSA",0,3,10,540,1,554,"2018"
"46808","292303 NOVO HORIZONTE",0,0,4,124,0,128,"2018"
"46809","292305 NOVO TRIUNFO",0,0,2,113,11,126,"2018"
"46810","292310 OLINDINA",2,1,3,226,86,318,"2018"
"46811","292320 OLIVEIRA DOS BREJINHOS",0,1,5,273,4,283,"2018"
"46812","292330 OURICANGAS",1,0,2,76,5,84,"2018"
"46813","292335 OUROLANDIA",1,2,3,278,3,287,"2018"
"46814","292340 PALMAS DE MONTE ALTO",0,2,6,257,9,274,"2018"
"46815","292350 PALMEIRAS",0,0,2,137,13,152,"2018"
"46816","292360 PARAMIRIM",0,0,0,201,0,201,"2018"
"46817","292370 PARATINGA",0,3,3,470,2,478,"2018"
"46818","292380 PARIPIRANGA",1,1,8,272,5,287,"2018"
"46819","292390 PAU BRASIL",0,2,7,151,2,162,"2018"
"46820","292400 PAULO AFONSO",4,11,58,1726,10,1809,"2018"
"46821","292405 PE DE SERRA",0,0,2,132,1,135,"2018"
"46822","292410 PEDRAO",1,0,1,70,1,73,"2018"
"46823","292420 PEDRO ALEXANDRE",0,1,5,213,3,222,"2018"
"46824","292430 PIATA",3,1,4,224,0,232,"2018"
"46825","292440 PILAO ARCADO",2,1,3,579,9,594,"2018"
"46826","292450 PINDAI",0,0,0,140,1,141,"2018"
"46827","292460 PINDOBACU",0,0,2,292,0,294,"2018"
"46828","292465 PINTADAS",0,0,3,90,0,93,"2018"
"46829","292467 PIRAI DO NORTE",0,1,2,86,0,89,"2018"
"46830","292470 PIRIPA",0,0,1,114,2,117,"2018"
"46831","292480 PIRITIBA",0,0,7,222,0,229,"2018"
"46832","292490 PLANALTINO",0,1,0,78,1,80,"2018"
"46833","292500 PLANALTO",0,1,7,302,4,314,"2018"
"46834","292510 POCOES",2,1,7,643,4,657,"2018"
"46835","292520 POJUCA",2,2,7,435,0,446,"2018"
"46836","292525 PONTO NOVO",1,4,5,235,1,246,"2018"
"46837","292530 PORTO SEGURO",3,14,40,2751,59,2867,"2018"
"46838","292540 POTIRAGUA",0,0,4,99,14,117,"2018"
"46839","292550 PRADO",2,2,6,469,8,487,"2018"
"46840","292560 PRESIDENTE DUTRA",1,1,1,148,0,151,"2018"
"46841","292570 PRESIDENTE JANIO QUADROS",0,0,2,120,1,123,"2018"
"46842","292575 PRESIDENTE TANCREDO NEVES",3,2,6,313,73,397,"2018"
"46843","292580 QUEIMADAS",0,1,2,300,2,305,"2018"
"46844","292590 QUIJINGUE",0,3,5,276,9,293,"2018"
"46845","292593 QUIXABEIRA",0,0,1,121,1,123,"2018"
"46846","292595 RAFAEL JAMBEIRO",0,0,9,306,4,319,"2018"
"46847","292600 REMANSO",2,1,5,675,2,685,"2018"
"46848","292610 RETIROLANDIA",0,1,3,183,3,190,"2018"
"46849","292620 RIACHAO DAS NEVES",0,2,3,284,11,300,"2018"
"46850","292630 RIACHAO DO JACUIPE",0,3,4,395,1,403,"2018"
"46851","292640 RIACHO DE SANTANA",0,2,2,333,9,346,"2018"
"46852","292650 RIBEIRA DO AMPARO",1,1,1,45,151,199,"2018"
"46853","292660 RIBEIRA DO POMBAL",3,2,3,75,757,840,"2018"
"46854","292665 RIBEIRAO DO LARGO",1,0,3,94,6,104,"2018"
"46855","292670 RIO DE CONTAS",2,0,1,130,1,134,"2018"
"46856","292680 RIO DO ANTONIO",0,1,1,109,3,114,"2018"
"46857","292690 RIO DO PIRES",0,0,0,82,0,82,"2018"
"46858","292700 RIO REAL",0,1,9,483,2,495,"2018"
"46859","292710 RODELAS",1,0,4,179,1,185,"2018"
"46860","292720 RUY BARBOSA",2,4,11,413,1,431,"2018"
"46861","292730 SALINAS DA MARGARIDA",0,3,4,139,3,149,"2018"
"46862","292740 SALVADOR",195,196,602,33563,252,34808,"2018"
"46863","292750 SANTA BARBARA",1,1,6,207,9,224,"2018"
"46864","292760 SANTA BRIGIDA",1,3,6,204,3,217,"2018"
"46865","292770 SANTA CRUZ CABRALIA",1,0,11,447,4,463,"2018"
"46866","292780 SANTA CRUZ DA VITORIA",0,0,1,60,1,62,"2018"
"46867","292790 SANTA INES",0,3,0,104,0,107,"2018"
"46868","292800 SANTALUZ",0,2,15,506,0,523,"2018"
"46869","292805 SANTA LUZIA",2,0,3,198,1,204,"2018"
"46870","292810 SANTA MARIA DA VITORIA",0,2,5,448,6,461,"2018"
"46871","292820 SANTANA",1,1,6,289,3,300,"2018"
"46872","292830 SANTANOPOLIS",1,0,5,43,3,52,"2018"
"46873","292840 SANTA RITA DE CASSIA",3,0,10,320,9,342,"2018"
"46874","292850 SANTA TERESINHA",0,1,3,135,3,142,"2018"
"46875","292860 SANTO AMARO",3,5,8,582,11,609,"2018"
"46876","292870 SANTO ANTONIO DE JESUS",5,12,26,1337,15,1395,"2018"
"46877","292880 SANTO ESTEVAO",0,2,9,682,42,735,"2018"
"46878","292890 SAO DESIDERIO",0,2,7,561,6,576,"2018"
"46879","292895 SAO DOMINGOS",0,0,2,73,1,76,"2018"
"46880","292900 SAO FELIX",0,0,1,34,150,185,"2018"
"46881","292905 SAO FELIX DO CORIBE",0,2,4,253,4,263,"2018"
"46882","292910 SAO FELIPE",0,1,7,215,1,224,"2018"
"46883","292920 SAO FRANCISCO DO CONDE",2,2,5,629,0,638,"2018"
"46884","292925 SAO GABRIEL",2,1,3,270,0,276,"2018"
"46885","292930 SAO GONCALO DOS CAMPOS",0,2,4,339,17,362,"2018"
"46886","292935 SAO JOSE DA VITORIA",0,2,2,88,0,92,"2018"
"46887","292937 SAO JOSE DO JACUIPE",2,1,5,132,0,140,"2018"
"46888","292940 SAO MIGUEL DAS MATAS",0,0,1,111,2,114,"2018"
"46889","292950 SAO SEBASTIAO DO PASSE",5,3,13,514,11,546,"2018"
"46890","292960 SAPEACU",0,1,5,228,0,234,"2018"
"46891","292970 SATIRO DIAS",1,2,5,207,4,219,"2018"
"46892","292975 SAUBARA",0,0,2,105,0,107,"2018"
"46893","292980 SAUDE",1,3,4,128,1,137,"2018"
"46894","292990 SEABRA",1,2,5,526,9,543,"2018"
"46895","293000 SEBASTIAO LARANJEIRAS",2,1,2,90,2,97,"2018"
"46896","293010 SENHOR DO BONFIM",9,6,19,1082,4,1120,"2018"
"46897","293015 SERRA DO RAMALHO",0,2,6,522,8,538,"2018"
"46898","293020 SENTO SE",1,4,11,535,1,552,"2018"
"46899","293030 SERRA DOURADA",0,0,1,259,2,262,"2018"
"46900","293040 SERRA PRETA",3,1,2,90,2,98,"2018"
"46901","293050 SERRINHA",4,6,77,1207,4,1298,"2018"
"46902","293060 SERROLANDIA",0,2,3,174,0,179,"2018"
"46903","293070 SIMOES FILHO",6,5,34,1853,6,1904,"2018"
"46904","293075 SITIO DO MATO",1,0,5,206,5,217,"2018"
"46905","293076 SITIO DO QUINTO",2,0,1,121,24,148,"2018"
"46906","293077 SOBRADINHO",3,0,8,369,6,386,"2018"
"46907","293080 SOUTO SOARES",0,4,6,238,3,251,"2018"
"46908","293090 TABOCAS DO BREJO VELHO",0,3,4,137,1,145,"2018"
"46909","293100 TANHACU",0,3,5,226,2,236,"2018"
"46910","293105 TANQUE NOVO",0,2,2,229,1,234,"2018"
"46911","293110 TANQUINHO",0,0,1,82,2,85,"2018"
"46912","293120 TAPEROA",0,1,8,194,33,236,"2018"
"46913","293130 TAPIRAMUTA",2,3,8,214,0,227,"2018"
"46914","293135 TEIXEIRA DE FREITAS",3,8,39,2595,24,2669,"2018"
"46915","293140 TEODORO SAMPAIO",0,0,0,32,0,32,"2018"
"46916","293150 TEOFILANDIA",1,3,18,249,9,280,"2018"
"46917","293160 TEOLANDIA",0,0,1,154,9,164,"2018"
"46918","293170 TERRA NOVA",0,2,2,102,4,110,"2018"
"46919","293180 TREMEDAL",1,0,2,159,3,165,"2018"
"46920","293190 TUCANO",3,4,11,587,37,642,"2018"
"46921","293200 UAUA",3,1,6,293,2,305,"2018"
"46922","293210 UBAIRA",0,0,17,237,1,255,"2018"
"46923","293220 UBAITABA",1,3,4,282,10,300,"2018"
"46924","293230 UBATA",0,0,4,197,0,201,"2018"
"46925","293240 UIBAI",1,2,3,161,0,167,"2018"
"46926","293245 UMBURANAS",2,1,8,186,2,199,"2018"
"46927","293250 UNA",0,3,7,165,58,233,"2018"
"46928","293260 URANDI",0,0,1,179,2,182,"2018"
"46929","293270 URUCUCA",2,2,7,284,28,323,"2018"
"46930","293280 UTINGA",0,1,5,234,15,255,"2018"
"46931","293290 VALENCA",8,19,76,1527,3,1633,"2018"
"46932","293300 VALENTE",0,1,9,284,0,294,"2018"
"46933","293305 VARZEA DA ROCA",0,2,3,124,0,129,"2018"
"46934","293310 VARZEA DO POCO",0,2,1,84,1,88,"2018"
"46935","293315 VARZEA NOVA",0,2,6,175,5,188,"2018"
"46936","293317 VARZEDO",0,0,2,138,1,141,"2018"
"46937","293320 VERA CRUZ",3,2,14,428,57,504,"2018"
"46938","293325 VEREDA",1,1,4,78,0,84,"2018"
"46939","293330 VITORIA DA CONQUISTA",19,15,79,5539,49,5701,"2018"
"46940","293340 WAGNER",0,0,1,91,25,117,"2018"
"46941","293345 WANDERLEY",1,0,2,163,0,166,"2018"
"46942","293350 WENCESLAU GUIMARAES",1,1,5,372,8,387,"2018"
"46943","293360 XIQUE-XIQUE",4,4,27,882,23,940,"2018"
"46944","MUNICIPIO IGNORADO - MG",0,0,0,3,0,3,"2018"
"46945","310010 ABADIA DOS DOURADOS",0,0,0,64,0,64,"2018"
"46946","310020 ABAETE",0,0,2,250,0,252,"2018"
"46947","310030 ABRE CAMPO",0,1,1,138,38,178,"2018"
"46948","310040 ACAIACA",0,0,3,40,0,43,"2018"
"46949","310050 ACUCENA",0,0,1,107,1,109,"2018"
"46950","310060 AGUA BOA",1,0,2,181,3,187,"2018"
"46951","310070 AGUA COMPRIDA",0,0,1,28,0,29,"2018"
"46952","310080 AGUANIL",0,0,2,53,0,55,"2018"
"46953","310090 AGUAS FORMOSAS",2,0,3,288,1,294,"2018"
"46954","310100 AGUAS VERMELHAS",0,0,0,163,2,165,"2018"
"46955","310110 AIMORES",0,2,7,292,2,303,"2018"
"46956","310120 AIURUOCA",0,0,2,43,0,45,"2018"
"46957","310130 ALAGOA",0,0,0,31,0,31,"2018"
"46958","310140 ALBERTINA",0,0,1,26,0,27,"2018"
"46959","310150 ALEM PARAIBA",2,5,3,434,0,444,"2018"
"46960","310160 ALFENAS",0,2,12,982,3,999,"2018"
"46961","310163 ALFREDO VASCONCELOS",0,3,1,74,0,78,"2018"
"46962","310170 ALMENARA",1,6,15,551,0,573,"2018"
"46963","310180 ALPERCATA",0,0,1,72,12,85,"2018"
"46964","310190 ALPINOPOLIS",0,2,1,213,1,217,"2018"
"46965","310200 ALTEROSA",0,1,1,176,0,178,"2018"
"46966","310205 ALTO CAPARAO",0,0,0,73,16,89,"2018"
"46967","310210 ALTO RIO DOCE",0,0,2,105,2,109,"2018"
"46968","310220 ALVARENGA",0,0,0,52,5,57,"2018"
"46969","310230 ALVINOPOLIS",0,0,2,147,0,149,"2018"
"46970","310240 ALVORADA DE MINAS",0,0,2,54,0,56,"2018"
"46971","310250 AMPARO DO SERRA",0,0,2,58,0,60,"2018"
"46972","310260 ANDRADAS",0,1,7,465,2,475,"2018"
"46973","310270 CACHOEIRA DE PAJEU",0,1,2,82,4,89,"2018"
"46974","310280 ANDRELANDIA",0,0,0,142,0,142,"2018"
"46975","310285 ANGELANDIA",0,0,4,81,2,87,"2018"
"46976","310290 ANTONIO CARLOS",0,0,0,108,1,109,"2018"
"46977","310300 ANTONIO DIAS",1,0,0,107,0,108,"2018"
"46978","310310 ANTONIO PRADO DE MINAS",0,0,0,6,0,6,"2018"
"46979","310320 ARACAI",1,0,0,22,1,24,"2018"
"46980","310330 ARACITABA",0,0,1,24,0,25,"2018"
"46981","310340 ARACUAI",1,1,7,413,5,427,"2018"
"46982","310350 ARAGUARI",4,4,13,1401,4,1426,"2018"
"46983","310360 ARANTINA",0,0,0,39,0,39,"2018"
"46984","310370 ARAPONGA",1,0,3,98,0,102,"2018"
"46985","310375 ARAPORA",0,0,1,122,3,126,"2018"
"46986","310380 ARAPUA",0,0,0,17,0,17,"2018"
"46987","310390 ARAUJOS",0,0,2,106,0,108,"2018"
"46988","310400 ARAXA",1,9,14,1492,6,1522,"2018"
"46989","310410 ARCEBURGO",0,0,0,72,0,72,"2018"
"46990","310420 ARCOS",5,0,4,471,0,480,"2018"
"46991","310430 AREADO",1,0,4,169,0,174,"2018"
"46992","310440 ARGIRITA",1,0,0,27,0,28,"2018"
"46993","310445 ARICANDUVA",0,0,2,53,0,55,"2018"
"46994","310450 ARINOS",0,0,3,205,2,210,"2018"
"46995","310460 ASTOLFO DUTRA",1,1,3,125,1,131,"2018"
"46996","310470 ATALEIA",0,0,2,118,12,132,"2018"
"46997","310480 AUGUSTO DE LIMA",0,0,2,50,1,53,"2018"
"46998","310490 BAEPENDI",0,1,1,200,1,203,"2018"
"46999","310500 BALDIM",1,0,0,71,0,72,"2018"
"47000","310510 BAMBUI",2,0,3,214,1,220,"2018"
"47001","310520 BANDEIRA",0,0,0,39,0,39,"2018"
"47002","310530 BANDEIRA DO SUL",1,1,0,77,0,79,"2018"
"47003","310540 BARAO DE COCAIS",0,1,3,347,3,354,"2018"
"47004","310550 BARAO DE MONTE ALTO",0,0,1,48,0,49,"2018"
"47005","310560 BARBACENA",1,3,6,1474,2,1486,"2018"
"47006","310570 BARRA LONGA",0,0,0,38,1,39,"2018"
"47007","310590 BARROSO",1,1,1,235,0,238,"2018"
"47008","310600 BELA VISTA DE MINAS",1,1,0,137,0,139,"2018"
"47009","310610 BELMIRO BRAGA",0,0,0,34,0,34,"2018"
"47010","310620 BELO HORIZONTE",88,131,492,29002,100,29813,"2018"
"47011","310630 BELO ORIENTE",1,2,5,323,0,331,"2018"
"47012","310640 BELO VALE",1,0,1,88,0,90,"2018"
"47013","310650 BERILO",0,1,1,82,4,88,"2018"
"47014","310660 BERTOPOLIS",0,0,1,72,20,93,"2018"
"47015","310665 BERIZAL",1,0,0,51,2,54,"2018"
"47016","310670 BETIM",16,32,89,5930,22,6089,"2018"
"47017","310680 BIAS FORTES",0,0,0,23,0,23,"2018"
"47018","310690 BICAS",1,1,0,151,0,153,"2018"
"47019","310700 BIQUINHAS",0,0,0,16,0,16,"2018"
"47020","310710 BOA ESPERANCA",1,2,3,556,1,563,"2018"
"47021","310720 BOCAINA DE MINAS",0,0,0,43,0,43,"2018"
"47022","310730 BOCAIUVA",1,3,9,626,14,653,"2018"
"47023","310740 BOM DESPACHO",2,1,12,727,3,745,"2018"
"47024","310750 BOM JARDIM DE MINAS",0,1,0,60,0,61,"2018"
"47025","310760 BOM JESUS DA PENHA",0,1,2,50,0,53,"2018"
"47026","310770 BOM JESUS DO AMPARO",1,0,0,84,0,85,"2018"
"47027","310780 BOM JESUS DO GALHO",1,0,2,160,8,171,"2018"
"47028","310790 BOM REPOUSO",0,0,2,155,2,159,"2018"
"47029","310800 BOM SUCESSO",0,1,4,174,3,182,"2018"
"47030","310810 BONFIM",1,0,1,53,1,56,"2018"
"47031","310820 BONFINOPOLIS DE MINAS",0,0,0,61,3,64,"2018"
"47032","310825 BONITO DE MINAS",0,0,0,69,53,122,"2018"
"47033","310830 BORDA DA MATA",0,0,0,164,1,165,"2018"
"47034","310840 BOTELHOS",0,0,2,127,2,131,"2018"
"47035","310850 BOTUMIRIM",0,0,1,75,0,76,"2018"
"47036","310855 BRASILANDIA DE MINAS",1,0,0,234,2,237,"2018"
"47037","310860 BRASILIA DE MINAS",0,2,4,501,1,508,"2018"
"47038","310870 BRAS PIRES",0,0,0,44,1,45,"2018"
"47039","310880 BRAUNAS",0,0,1,53,3,57,"2018"
"47040","310890 BRAZOPOLIS",0,1,0,149,0,150,"2018"
"47041","310900 BRUMADINHO",5,0,4,392,1,402,"2018"
"47042","310910 BUENO BRANDAO",0,0,1,90,2,93,"2018"
"47043","310920 BUENOPOLIS",2,1,3,92,0,98,"2018"
"47044","310925 BUGRE",0,0,1,59,0,60,"2018"
"47045","310930 BURITIS",0,1,7,359,1,368,"2018"
"47046","310940 BURITIZEIRO",0,3,3,287,55,348,"2018"
"47047","310945 CABECEIRA GRANDE",2,0,0,78,0,80,"2018"
"47048","310950 CABO VERDE",0,1,1,141,0,143,"2018"
"47049","310960 CACHOEIRA DA PRATA",0,0,0,44,0,44,"2018"
"47050","310970 CACHOEIRA DE MINAS",0,0,1,120,0,121,"2018"
"47051","310980 CACHOEIRA DOURADA",0,0,0,25,0,25,"2018"
"47052","310990 CAETANOPOLIS",0,1,1,132,1,135,"2018"
"47053","311000 CAETE",2,0,5,448,11,466,"2018"
"47054","311010 CAIANA",0,0,0,67,1,68,"2018"
"47055","311020 CAJURI",0,0,1,38,0,39,"2018"
"47056","311030 CALDAS",0,0,1,116,2,119,"2018"
"47057","311040 CAMACHO",0,0,3,23,0,26,"2018"
"47058","311050 CAMANDUCAIA",2,1,2,296,1,302,"2018"
"47059","311060 CAMBUI",1,2,5,337,0,345,"2018"
"47060","311070 CAMBUQUIRA",0,0,2,139,1,142,"2018"
"47061","311080 CAMPANARIO",0,0,0,41,0,41,"2018"
"47062","311090 CAMPANHA",0,1,2,174,0,177,"2018"
"47063","311100 CAMPESTRE",0,3,3,194,0,200,"2018"
"47064","311110 CAMPINA VERDE",0,1,1,174,2,178,"2018"
"47065","311115 CAMPO AZUL",0,0,0,40,0,40,"2018"
"47066","311120 CAMPO BELO",1,1,6,599,0,607,"2018"
"47067","311130 CAMPO DO MEIO",0,0,2,157,2,161,"2018"
"47068","311140 CAMPO FLORIDO",3,0,1,121,1,126,"2018"
"47069","311150 CAMPOS ALTOS",4,4,6,191,1,206,"2018"
"47070","311160 CAMPOS GERAIS",1,0,0,300,1,302,"2018"
"47071","311170 CANAA",0,1,2,64,3,70,"2018"
"47072","311180 CANAPOLIS",1,1,2,105,4,113,"2018"
"47073","311190 CANA VERDE",0,0,0,49,0,49,"2018"
"47074","311200 CANDEIAS",0,0,1,134,0,135,"2018"
"47075","311205 CANTAGALO",0,1,0,44,0,45,"2018"
"47076","311210 CAPARAO",0,1,0,90,4,95,"2018"
"47077","311220 CAPELA NOVA",0,0,1,42,0,43,"2018"
"47078","311230 CAPELINHA",1,2,6,622,6,637,"2018"
"47079","311240 CAPETINGA",0,0,0,75,0,75,"2018"
"47080","311250 CAPIM BRANCO",1,0,2,129,2,134,"2018"
"47081","311260 CAPINOPOLIS",0,0,0,175,1,176,"2018"
"47082","311265 CAPITAO ANDRADE",0,0,0,55,2,57,"2018"
"47083","311270 CAPITAO ENEAS",1,1,3,224,2,231,"2018"
"47084","311280 CAPITOLIO",0,1,0,85,1,87,"2018"
"47085","311290 CAPUTIRA",0,0,0,8,108,116,"2018"
"47086","311300 CARAI",1,1,5,257,4,268,"2018"
"47087","311310 CARANAIBA",0,0,0,28,0,28,"2018"
"47088","311320 CARANDAI",0,3,2,266,2,273,"2018"
"47089","311330 CARANGOLA",0,0,4,445,2,451,"2018"
"47090","311340 CARATINGA",3,1,6,1129,71,1210,"2018"
"47091","311350 CARBONITA",0,1,3,76,1,81,"2018"
"47092","311360 CAREACU",0,0,0,81,1,82,"2018"
"47093","311370 CARLOS CHAGAS",1,0,3,237,3,244,"2018"
"47094","311380 CARMESIA",0,1,2,33,0,36,"2018"
"47095","311390 CARMO DA CACHOEIRA",1,1,0,125,0,127,"2018"
"47096","311400 CARMO DA MATA",0,0,0,99,0,99,"2018"
"47097","311410 CARMO DE MINAS",0,0,3,159,1,163,"2018"
"47098","311420 CARMO DO CAJURU",0,0,6,286,4,296,"2018"
"47099","311430 CARMO DO PARANAIBA",0,1,0,344,0,345,"2018"
"47100","311440 CARMO DO RIO CLARO",0,3,6,209,0,218,"2018"
"47101","311450 CARMOPOLIS DE MINAS",0,0,1,194,1,196,"2018"
"47102","311455 CARNEIRINHO",0,0,2,116,0,118,"2018"
"47103","311460 CARRANCAS",0,0,0,39,0,39,"2018"
"47104","311470 CARVALHOPOLIS",0,0,0,45,0,45,"2018"
"47105","311480 CARVALHOS",0,0,2,30,1,33,"2018"
"47106","311490 CASA GRANDE",0,0,0,24,0,24,"2018"
"47107","311500 CASCALHO RICO",0,0,0,36,0,36,"2018"
"47108","311510 CASSIA",2,1,2,213,0,218,"2018"
"47109","311520 CONCEICAO DA BARRA DE MINAS",0,0,0,28,0,28,"2018"
"47110","311530 CATAGUASES",4,8,26,767,1,806,"2018"
"47111","311535 CATAS ALTAS",0,0,0,76,0,76,"2018"
"47112","311540 CATAS ALTAS DA NORUEGA",0,0,1,36,0,37,"2018"
"47113","311545 CATUJI",1,0,1,135,1,138,"2018"
"47114","311547 CATUTI",0,0,1,11,34,46,"2018"
"47115","311550 CAXAMBU",0,0,3,231,2,236,"2018"
"47116","311560 CEDRO DO ABAETE",0,0,0,7,0,7,"2018"
"47117","311570 CENTRAL DE MINAS",0,0,1,108,1,110,"2018"
"47118","311580 CENTRALINA",0,0,2,111,6,119,"2018"
"47119","311590 CHACARA",0,0,1,37,0,38,"2018"
"47120","311600 CHALE",1,0,0,32,57,90,"2018"
"47121","311610 CHAPADA DO NORTE",1,0,1,84,9,95,"2018"
"47122","311615 CHAPADA GAUCHA",1,1,0,187,0,189,"2018"
"47123","311620 CHIADOR",0,0,1,28,0,29,"2018"
"47124","311630 CIPOTANEA",0,0,0,48,0,48,"2018"
"47125","311640 CLARAVAL",0,0,0,20,0,20,"2018"
"47126","311650 CLARO DOS POCOES",0,1,2,70,4,77,"2018"
"47127","311660 CLAUDIO",0,2,10,366,1,379,"2018"
"47128","311670 COIMBRA",0,0,0,68,0,68,"2018"
"47129","311680 COLUNA",0,0,0,110,0,110,"2018"
"47130","311690 COMENDADOR GOMES",0,0,1,21,0,22,"2018"
"47131","311700 COMERCINHO",0,0,3,56,3,62,"2018"
"47132","311710 CONCEICAO DA APARECIDA",0,0,1,118,0,119,"2018"
"47133","311720 CONCEICAO DAS PEDRAS",0,0,1,20,0,21,"2018"
"47134","311730 CONCEICAO DAS ALAGOAS",0,1,3,361,1,366,"2018"
"47135","311740 CONCEICAO DE IPANEMA",0,0,0,34,19,53,"2018"
"47136","311750 CONCEICAO DO MATO DENTRO",1,6,3,236,0,246,"2018"
"47137","311760 CONCEICAO DO PARA",0,0,1,51,5,57,"2018"
"47138","311770 CONCEICAO DO RIO VERDE",1,0,2,162,0,165,"2018"
"47139","311780 CONCEICAO DOS OUROS",0,0,2,134,1,137,"2018"
"47140","311783 CONEGO MARINHO",0,0,0,49,42,91,"2018"
"47141","311787 CONFINS",0,1,0,101,5,107,"2018"
"47142","311790 CONGONHAL",0,0,3,116,0,119,"2018"
"47143","311800 CONGONHAS",2,4,6,721,0,733,"2018"
"47144","311810 CONGONHAS DO NORTE",0,0,1,42,1,44,"2018"
"47145","311820 CONQUISTA",0,0,0,61,0,61,"2018"
"47146","311830 CONSELHEIRO LAFAIETE",5,9,8,1750,3,1775,"2018"
"47147","311840 CONSELHEIRO PENA",0,1,2,261,5,269,"2018"
"47148","311850 CONSOLACAO",0,0,1,28,0,29,"2018"
"47149","311860 CONTAGEM",26,61,137,8277,43,8544,"2018"
"47150","311870 COQUEIRAL",0,0,1,83,1,85,"2018"
"47151","311880 CORACAO DE JESUS",0,0,6,247,4,257,"2018"
"47152","311890 CORDISBURGO",2,0,0,58,0,60,"2018"
"47153","311900 CORDISLANDIA",0,0,0,43,0,43,"2018"
"47154","311910 CORINTO",3,4,11,277,3,298,"2018"
"47155","311920 COROACI",0,1,0,72,6,79,"2018"
"47156","311930 COROMANDEL",0,0,4,337,1,342,"2018"
"47157","311940 CORONEL FABRICIANO",4,5,10,1207,4,1230,"2018"
"47158","311950 CORONEL MURTA",0,0,1,88,13,102,"2018"
"47159","311960 CORONEL PACHECO",0,0,1,28,1,30,"2018"
"47160","311970 CORONEL XAVIER CHAVES",0,0,0,18,0,18,"2018"
"47161","311980 CORREGO DANTA",0,0,0,28,0,28,"2018"
"47162","311990 CORREGO DO BOM JESUS",0,0,1,31,0,32,"2018"
"47163","311995 CORREGO FUNDO",0,1,1,47,0,49,"2018"
"47164","312000 CORREGO NOVO",0,0,0,39,0,39,"2018"
"47165","312010 COUTO DE MAGALHAES DE MINAS",0,1,1,44,0,46,"2018"
"47166","312015 CRISOLITA",0,0,0,95,1,96,"2018"
"47167","312020 CRISTAIS",1,0,5,149,1,156,"2018"
"47168","312030 CRISTALIA",0,0,0,60,2,62,"2018"
"47169","312040 CRISTIANO OTONI",0,0,1,66,0,67,"2018"
"47170","312050 CRISTINA",0,0,1,90,0,91,"2018"
"47171","312060 CRUCILANDIA",0,0,0,44,0,44,"2018"
"47172","312070 CRUZEIRO DA FORTALEZA",0,2,0,52,1,55,"2018"
"47173","312080 CRUZILIA",1,1,0,219,0,221,"2018"
"47174","312083 CUPARAQUE",0,0,1,65,5,71,"2018"
"47175","312087 CURRAL DE DENTRO",0,0,1,85,37,123,"2018"
"47176","312090 CURVELO",5,0,30,982,4,1021,"2018"
"47177","312100 DATAS",0,0,1,92,1,94,"2018"
"47178","312110 DELFIM MOREIRA",0,0,1,79,0,80,"2018"
"47179","312120 DELFINOPOLIS",1,0,0,71,0,72,"2018"
"47180","312125 DELTA",1,0,2,134,0,137,"2018"
"47181","312130 DESCOBERTO",0,0,0,65,1,66,"2018"
"47182","312140 DESTERRO DE ENTRE RIOS",0,0,1,40,0,41,"2018"
"47183","312150 DESTERRO DO MELO",0,0,1,39,0,40,"2018"
"47184","312160 DIAMANTINA",3,4,20,631,4,662,"2018"
"47185","312170 DIOGO DE VASCONCELOS",0,2,0,33,0,35,"2018"
"47186","312180 DIONISIO",0,0,0,59,0,59,"2018"
"47187","312190 DIVINESIA",0,1,1,44,3,49,"2018"
"47188","312200 DIVINO",0,1,0,307,6,314,"2018"
"47189","312210 DIVINO DAS LARANJEIRAS",0,0,0,55,5,60,"2018"
"47190","312220 DIVINOLANDIA DE MINAS",2,1,0,90,2,95,"2018"
"47191","312230 DIVINOPOLIS",2,15,45,2642,5,2709,"2018"
"47192","312235 DIVISA ALEGRE",0,1,0,89,1,91,"2018"
"47193","312240 DIVISA NOVA",0,0,1,82,2,85,"2018"
"47194","312245 DIVISOPOLIS",0,0,4,82,1,87,"2018"
"47195","312247 DOM BOSCO",0,0,0,31,0,31,"2018"
"47196","312250 DOM CAVATI",0,0,0,50,1,51,"2018"
"47197","312260 DOM JOAQUIM",0,1,3,52,0,56,"2018"
"47198","312270 DOM SILVERIO",0,0,1,37,0,38,"2018"
"47199","312280 DOM VICOSO",0,0,1,29,0,30,"2018"
"47200","312290 DONA EUSEBIA",0,1,1,52,0,54,"2018"
"47201","312300 DORES DE CAMPOS",0,0,0,83,0,83,"2018"
"47202","312310 DORES DE GUANHAES",0,1,1,47,0,49,"2018"
"47203","312320 DORES DO INDAIA",0,1,2,108,0,111,"2018"
"47204","312330 DORES DO TURVO",0,0,1,44,1,46,"2018"
"47205","312340 DORESOPOLIS",0,0,0,14,0,14,"2018"
"47206","312350 DOURADOQUARA",0,0,0,21,0,21,"2018"
"47207","312352 DURANDE",0,0,0,34,102,136,"2018"
"47208","312360 ELOI MENDES",2,0,1,325,1,329,"2018"
"47209","312370 ENGENHEIRO CALDAS",0,0,3,96,9,108,"2018"
"47210","312380 ENGENHEIRO NAVARRO",0,0,2,75,1,78,"2018"
"47211","312385 ENTRE FOLHAS",0,0,0,74,8,82,"2018"
"47212","312390 ENTRE RIOS DE MINAS",0,2,1,155,0,158,"2018"
"47213","312400 ERVALIA",1,0,2,220,5,228,"2018"
"47214","312410 ESMERALDAS",7,8,15,1150,8,1188,"2018"
"47215","312420 ESPERA FELIZ",0,0,3,336,8,347,"2018"
"47216","312430 ESPINOSA",1,1,6,436,31,475,"2018"
"47217","312440 ESPIRITO SANTO DO DOURADO",0,0,0,81,1,82,"2018"
"47218","312450 ESTIVA",0,0,3,106,0,109,"2018"
"47219","312460 ESTRELA DALVA",0,0,0,24,1,25,"2018"
"47220","312470 ESTRELA DO INDAIA",0,0,0,24,0,24,"2018"
"47221","312480 ESTRELA DO SUL",2,0,3,86,0,91,"2018"
"47222","312490 EUGENOPOLIS",0,0,3,102,3,108,"2018"
"47223","312500 EWBANK DA CAMARA",0,0,0,58,0,58,"2018"
"47224","312510 EXTREMA",1,3,4,714,0,722,"2018"
"47225","312520 FAMA",0,0,0,25,0,25,"2018"
"47226","312530 FARIA LEMOS",0,0,0,45,1,46,"2018"
"47227","312540 FELICIO DOS SANTOS",1,0,3,37,3,44,"2018"
"47228","312550 SAO GONCALO DO RIO PRETO",0,0,1,22,0,23,"2018"
"47229","312560 FELISBURGO",1,0,4,98,0,103,"2018"
"47230","312570 FELIXLANDIA",1,0,2,122,2,127,"2018"
"47231","312580 FERNANDES TOURINHO",0,0,0,34,3,37,"2018"
"47232","312590 FERROS",0,0,2,90,0,92,"2018"
"47233","312595 FERVEDOURO",0,0,1,146,3,150,"2018"
"47234","312600 FLORESTAL",1,0,1,88,1,91,"2018"
"47235","312610 FORMIGA",0,1,8,676,2,687,"2018"
"47236","312620 FORMOSO",0,1,2,58,1,62,"2018"
"47237","312630 FORTALEZA DE MINAS",0,0,1,48,0,49,"2018"
"47238","312640 FORTUNA DE MINAS",0,0,0,39,1,40,"2018"
"47239","312650 FRANCISCO BADARO",0,1,1,66,4,72,"2018"
"47240","312660 FRANCISCO DUMONT",0,0,1,57,0,58,"2018"
"47241","312670 FRANCISCO SA",4,1,2,265,5,277,"2018"
"47242","312675 FRANCISCOPOLIS",0,0,1,61,0,62,"2018"
"47243","312680 FREI GASPAR",0,0,1,62,1,64,"2018"
"47244","312690 FREI INOCENCIO",0,0,1,79,8,88,"2018"
"47245","312695 FREI LAGONEGRO",0,0,0,38,0,38,"2018"
"47246","312700 FRONTEIRA",0,1,1,148,0,150,"2018"
"47247","312705 FRONTEIRA DOS VALES",0,0,1,49,0,50,"2018"
"47248","312707 FRUTA DE LEITE",0,0,0,9,41,50,"2018"
"47249","312710 FRUTAL",2,1,8,754,4,769,"2018"
"47250","312720 FUNILANDIA",0,0,0,64,0,64,"2018"
"47251","312730 GALILEIA",0,0,0,84,10,94,"2018"
"47252","312733 GAMELEIRAS",0,1,0,8,54,63,"2018"
"47253","312735 GLAUCILANDIA",0,0,0,34,0,34,"2018"
"47254","312737 GOIABEIRA",0,0,1,43,2,46,"2018"
"47255","312738 GOIANA",0,0,0,27,2,29,"2018"
"47256","312740 GONCALVES",0,0,0,35,0,35,"2018"
"47257","312750 GONZAGA",1,0,1,58,5,65,"2018"
"47258","312760 GOUVEIA",0,0,3,116,0,119,"2018"
"47259","312770 GOVERNADOR VALADARES",4,10,32,3830,179,4055,"2018"
"47260","312780 GRAO MOGOL",0,0,3,123,17,143,"2018"
"47261","312790 GRUPIARA",0,0,0,11,0,11,"2018"
"47262","312800 GUANHAES",0,3,11,427,1,442,"2018"
"47263","312810 GUAPE",0,1,1,142,0,144,"2018"
"47264","312820 GUARACIABA",3,3,1,80,0,87,"2018"
"47265","312825 GUARACIAMA",0,0,4,49,1,54,"2018"
"47266","312830 GUARANESIA",0,0,3,228,7,238,"2018"
"47267","312840 GUARANI",0,1,0,95,2,98,"2018"
"47268","312850 GUARARA",0,1,1,33,0,35,"2018"
"47269","312860 GUARDA-MOR",0,0,1,78,1,80,"2018"
"47270","312870 GUAXUPE",1,2,20,558,1,582,"2018"
"47271","312880 GUIDOVAL",0,1,2,65,1,69,"2018"
"47272","312890 GUIMARANIA",1,0,0,108,0,109,"2018"
"47273","312900 GUIRICEMA",0,0,0,67,0,67,"2018"
"47274","312910 GURINHATA",0,0,0,30,0,30,"2018"
"47275","312920 HELIODORA",1,0,0,53,1,55,"2018"
"47276","312930 IAPU",0,2,1,136,1,140,"2018"
"47277","312940 IBERTIOGA",0,0,1,65,0,66,"2018"
"47278","312950 IBIA",1,4,4,292,0,301,"2018"
"47279","312960 IBIAI",0,0,3,94,20,117,"2018"
"47280","312965 IBIRACATU",0,2,1,61,0,64,"2018"
"47281","312970 IBIRACI",0,1,4,137,0,142,"2018"
"47282","312980 IBIRITE",7,9,43,2525,13,2597,"2018"
"47283","312990 IBITIURA DE MINAS",0,0,0,33,0,33,"2018"
"47284","313000 IBITURUNA",0,0,0,28,0,28,"2018"
"47285","313005 ICARAI DE MINAS",0,1,2,126,0,129,"2018"
"47286","313010 IGARAPE",1,2,6,604,6,619,"2018"
"47287","313020 IGARATINGA",0,1,2,119,1,123,"2018"
"47288","313030 IGUATAMA",1,0,2,83,0,86,"2018"
"47289","313040 IJACI",0,0,2,86,0,88,"2018"
"47290","313050 ILICINEA",0,1,2,171,2,176,"2018"
"47291","313055 IMBE DE MINAS",0,0,0,92,2,94,"2018"
"47292","313060 INCONFIDENTES",0,0,0,62,2,64,"2018"
"47293","313065 INDAIABIRA",0,0,1,85,0,86,"2018"
"47294","313070 INDIANOPOLIS",1,0,2,67,1,71,"2018"
"47295","313080 INGAI",0,0,0,27,0,27,"2018"
"47296","313090 INHAPIM",0,0,1,268,5,274,"2018"
"47297","313100 INHAUMA",1,1,0,53,1,56,"2018"
"47298","313110 INIMUTABA",0,0,1,70,0,71,"2018"
"47299","313115 IPABA",1,0,1,249,1,252,"2018"
"47300","313120 IPANEMA",0,1,0,238,29,268,"2018"
"47301","313130 IPATINGA",9,7,31,2982,13,3042,"2018"
"47302","313140 IPIACU",0,0,0,36,0,36,"2018"
"47303","313150 IPUIUNA",0,0,0,108,1,109,"2018"
"47304","313160 IRAI DE MINAS",0,1,0,100,0,101,"2018"
"47305","313170 ITABIRA",6,3,9,1436,3,1457,"2018"
"47306","313180 ITABIRINHA",0,0,1,115,1,117,"2018"
"47307","313190 ITABIRITO",1,3,18,717,1,740,"2018"
"47308","313200 ITACAMBIRA",0,0,0,35,0,35,"2018"
"47309","313210 ITACARAMBI",1,3,2,224,50,280,"2018"
"47310","313220 ITAGUARA",0,1,4,145,0,150,"2018"
"47311","313230 ITAIPE",0,1,1,204,0,206,"2018"
"47312","313240 ITAJUBA",3,2,7,1188,4,1204,"2018"
"47313","313250 ITAMARANDIBA",0,0,7,426,1,434,"2018"
"47314","313260 ITAMARATI DE MINAS",0,1,1,48,1,51,"2018"
"47315","313270 ITAMBACURI",0,3,5,322,4,334,"2018"
"47316","313280 ITAMBE DO MATO DENTRO",0,0,0,15,0,15,"2018"
"47317","313290 ITAMOGI",0,0,5,139,1,145,"2018"
"47318","313300 ITAMONTE",0,0,2,209,0,211,"2018"
"47319","313310 ITANHANDU",0,0,1,163,1,165,"2018"
"47320","313320 ITANHOMI",0,0,0,146,5,151,"2018"
"47321","313330 ITAOBIM",0,0,2,219,0,221,"2018"
"47322","313340 ITAPAGIPE",0,0,2,114,0,116,"2018"
"47323","313350 ITAPECERICA",0,2,5,181,0,188,"2018"
"47324","313360 ITAPEVA",0,0,1,135,0,136,"2018"
"47325","313370 ITATIAIUCU",0,1,0,151,1,153,"2018"
"47326","313375 ITAU DE MINAS",0,0,1,153,1,155,"2018"
"47327","313380 ITAUNA",3,2,13,1029,1,1048,"2018"
"47328","313390 ITAVERAVA",0,3,0,51,0,54,"2018"
"47329","313400 ITINGA",0,0,3,134,2,139,"2018"
"47330","313410 ITUETA",0,1,4,67,0,72,"2018"
"47331","313420 ITUIUTABA",8,4,5,1179,11,1207,"2018"
"47332","313430 ITUMIRIM",0,1,0,62,0,63,"2018"
"47333","313440 ITURAMA",0,4,2,507,1,514,"2018"
"47334","313450 ITUTINGA",1,0,1,37,0,39,"2018"
"47335","313460 JABOTICATUBAS",0,1,3,203,3,210,"2018"
"47336","313470 JACINTO",0,0,28,113,0,141,"2018"
"47337","313480 JACUI",0,1,1,92,0,94,"2018"
"47338","313490 JACUTINGA",0,1,1,331,1,334,"2018"
"47339","313500 JAGUARACU",0,0,0,39,0,39,"2018"
"47340","313505 JAIBA",2,3,17,561,50,633,"2018"
"47341","313507 JAMPRUCA",0,0,0,48,7,55,"2018"
"47342","313510 JANAUBA",3,7,18,968,8,1004,"2018"
"47343","313520 JANUARIA",2,1,9,622,419,1053,"2018"
"47344","313530 JAPARAIBA",0,0,1,61,1,63,"2018"
"47345","313535 JAPONVAR",0,1,2,106,0,109,"2018"
"47346","313540 JECEABA",0,0,0,56,0,56,"2018"
"47347","313545 JENIPAPO DE MINAS",0,0,1,81,3,85,"2018"
"47348","313550 JEQUERI",1,0,0,148,0,149,"2018"
"47349","313560 JEQUITAI",1,1,2,57,17,78,"2018"
"47350","313570 JEQUITIBA",0,0,1,56,0,57,"2018"
"47351","313580 JEQUITINHONHA",1,2,3,259,1,266,"2018"
"47352","313590 JESUANIA",0,1,0,54,0,55,"2018"
"47353","313600 JOAIMA",2,3,3,210,4,222,"2018"
"47354","313610 JOANESIA",1,0,1,43,0,45,"2018"
"47355","313620 JOAO MONLEVADE",6,5,16,876,3,906,"2018"
"47356","313630 JOAO PINHEIRO",1,2,4,645,5,657,"2018"
"47357","313640 JOAQUIM FELICIO",0,0,1,35,0,36,"2018"
"47358","313650 JORDANIA",0,2,1,114,1,118,"2018"
"47359","313652 JOSE GONCALVES DE MINAS",0,0,0,39,1,40,"2018"
"47360","313655 JOSE RAYDAN",0,0,3,47,0,50,"2018"
"47361","313657 JOSENOPOLIS",0,0,0,11,20,31,"2018"
"47362","313660 NOVA UNIAO",0,0,0,67,0,67,"2018"
"47363","313665 JUATUBA",3,5,8,369,2,387,"2018"
"47364","313670 JUIZ DE FORA",14,14,78,6370,40,6516,"2018"
"47365","313680 JURAMENTO",0,1,1,48,0,50,"2018"
"47366","313690 JURUAIA",1,1,0,121,0,123,"2018"
"47367","313695 JUVENILIA",0,0,0,16,57,73,"2018"
"47368","313700 LADAINHA",0,2,5,185,6,198,"2018"
"47369","313710 LAGAMAR",0,0,1,63,0,64,"2018"
"47370","313720 LAGOA DA PRATA",1,0,11,582,0,594,"2018"
"47371","313730 LAGOA DOS PATOS",1,0,0,42,4,47,"2018"
"47372","313740 LAGOA DOURADA",0,0,0,140,2,142,"2018"
"47373","313750 LAGOA FORMOSA",1,0,0,196,0,197,"2018"
"47374","313753 LAGOA GRANDE",0,1,2,101,0,104,"2018"
"47375","313760 LAGOA SANTA",1,8,9,794,15,827,"2018"
"47376","313770 LAJINHA",1,1,1,230,85,318,"2018"
"47377","313780 LAMBARI",1,0,3,217,0,221,"2018"
"47378","313790 LAMIM",0,0,0,27,0,27,"2018"
"47379","313800 LARANJAL",0,0,3,43,2,48,"2018"
"47380","313810 LASSANCE",1,1,0,77,10,89,"2018"
"47381","313820 LAVRAS",2,2,18,1415,4,1441,"2018"
"47382","313830 LEANDRO FERREIRA",0,0,0,29,0,29,"2018"
"47383","313835 LEME DO PRADO",0,0,0,44,1,45,"2018"
"47384","313840 LEOPOLDINA",2,1,6,618,2,629,"2018"
"47385","313850 LIBERDADE",0,0,1,41,1,43,"2018"
"47386","313860 LIMA DUARTE",0,1,6,171,0,178,"2018"
"47387","313862 LIMEIRA DO OESTE",0,0,1,100,0,101,"2018"
"47388","313865 LONTRA",1,3,2,108,0,114,"2018"
"47389","313867 LUISBURGO",0,1,1,10,82,94,"2018"
"47390","313868 LUISLANDIA",0,0,0,104,0,104,"2018"
"47391","313870 LUMINARIAS",0,0,0,57,0,57,"2018"
"47392","313880 LUZ",0,0,1,179,1,181,"2018"
"47393","313890 MACHACALIS",0,1,1,91,0,93,"2018"
"47394","313900 MACHADO",0,1,8,442,1,452,"2018"
"47395","313910 MADRE DE DEUS DE MINAS",0,0,0,58,1,59,"2018"
"47396","313920 MALACACHETA",3,3,3,221,1,231,"2018"
"47397","313925 MAMONAS",0,0,0,9,56,65,"2018"
"47398","313930 MANGA",0,0,2,61,217,280,"2018"
"47399","313940 MANHUACU",0,0,4,58,1365,1427,"2018"
"47400","313950 MANHUMIRIM",0,0,0,53,274,327,"2018"
"47401","313960 MANTENA",6,0,4,350,2,362,"2018"
"47402","313970 MARAVILHAS",1,0,1,85,0,87,"2018"
"47403","313980 MAR DE ESPANHA",3,2,3,157,1,166,"2018"
"47404","313990 MARIA DA FE",1,1,2,187,0,191,"2018"
"47405","314000 MARIANA",0,5,11,826,9,851,"2018"
"47406","314010 MARILAC",0,0,0,56,7,63,"2018"
"47407","314015 MARIO CAMPOS",0,0,4,233,1,238,"2018"
"47408","314020 MARIPA DE MINAS",0,0,0,23,0,23,"2018"
"47409","314030 MARLIERIA",0,0,3,53,1,57,"2018"
"47410","314040 MARMELOPOLIS",0,0,0,42,0,42,"2018"
"47411","314050 MARTINHO CAMPOS",4,1,1,133,1,140,"2018"
"47412","314053 MARTINS SOARES",0,0,1,31,106,138,"2018"
"47413","314055 MATA VERDE",0,1,2,80,0,83,"2018"
"47414","314060 MATERLANDIA",0,1,0,36,2,39,"2018"
"47415","314070 MATEUS LEME",0,1,4,475,4,484,"2018"
"47416","314080 MATIAS BARBOSA",0,2,1,145,1,149,"2018"
"47417","314085 MATIAS CARDOSO",0,1,2,94,26,123,"2018"
"47418","314090 MATIPO",0,0,2,178,130,310,"2018"
"47419","314100 MATO VERDE",0,0,2,66,85,153,"2018"
"47420","314110 MATOZINHOS",2,1,3,475,17,498,"2018"
"47421","314120 MATUTINA",0,0,0,35,0,35,"2018"
"47422","314130 MEDEIROS",0,0,0,44,0,44,"2018"
"47423","314140 MEDINA",2,2,6,239,2,251,"2018"
"47424","314150 MENDES PIMENTEL",2,0,0,62,1,65,"2018"
"47425","314160 MERCES",0,1,2,98,7,108,"2018"
"47426","314170 MESQUITA",1,4,0,62,0,67,"2018"
"47427","314180 MINAS NOVAS",2,0,3,267,39,311,"2018"
"47428","314190 MINDURI",0,0,0,44,0,44,"2018"
"47429","314200 MIRABELA",0,0,0,164,0,164,"2018"
"47430","314210 MIRADOURO",0,0,1,62,2,65,"2018"
"47431","314220 MIRAI",0,0,1,155,1,157,"2018"
"47432","314225 MIRAVANIA",1,0,0,12,31,44,"2018"
"47433","314230 MOEDA",0,0,0,61,0,61,"2018"
"47434","314240 MOEMA",1,0,3,68,0,72,"2018"
"47435","314250 MONJOLOS",1,0,0,21,0,22,"2018"
"47436","314260 MONSENHOR PAULO",0,0,0,99,0,99,"2018"
"47437","314270 MONTALVANIA",0,0,0,24,188,212,"2018"
"47438","314280 MONTE ALEGRE DE MINAS",0,0,0,222,33,255,"2018"
"47439","314290 MONTE AZUL",0,0,2,41,259,302,"2018"
"47440","314300 MONTE BELO",0,0,2,158,0,160,"2018"
"47441","314310 MONTE CARMELO",1,3,6,566,1,577,"2018"
"47442","314315 MONTE FORMOSO",0,0,0,53,1,54,"2018"
"47443","314320 MONTE SANTO DE MINAS",0,0,5,230,2,237,"2018"
"47444","314330 MONTES CLAROS",15,18,104,6548,35,6720,"2018"
"47445","314340 MONTE SIAO",0,2,1,211,12,226,"2018"
"47446","314345 MONTEZUMA",0,0,1,80,0,81,"2018"
"47447","314350 MORADA NOVA DE MINAS",0,1,0,78,0,79,"2018"
"47448","314360 MORRO DA GARCA",0,0,1,38,0,39,"2018"
"47449","314370 MORRO DO PILAR",0,0,0,31,0,31,"2018"
"47450","314380 MUNHOZ",0,0,1,53,4,58,"2018"
"47451","314390 MURIAE",5,5,16,1291,22,1339,"2018"
"47452","314400 MUTUM",0,2,0,292,65,359,"2018"
"47453","314410 MUZAMBINHO",1,1,4,260,0,266,"2018"
"47454","314420 NACIP RAYDAN",0,0,0,23,1,24,"2018"
"47455","314430 NANUQUE",1,6,11,474,1,493,"2018"
"47456","314435 NAQUE",0,0,1,95,1,97,"2018"
"47457","314437 NATALANDIA",0,0,0,41,0,41,"2018"
"47458","314440 NATERCIA",0,0,2,41,0,43,"2018"
"47459","314450 NAZARENO",0,0,0,70,0,70,"2018"
"47460","314460 NEPOMUCENO",0,0,3,257,0,260,"2018"
"47461","314465 NINHEIRA",1,0,0,75,23,99,"2018"
"47462","314467 NOVA BELEM",0,0,0,47,0,47,"2018"
"47463","314470 NOVA ERA",0,1,8,205,1,215,"2018"
"47464","314480 NOVA LIMA",5,2,27,1435,11,1480,"2018"
"47465","314490 NOVA MODICA",0,0,0,38,0,38,"2018"
"47466","314500 NOVA PONTE",0,0,4,189,0,193,"2018"
"47467","314505 NOVA PORTEIRINHA",0,0,3,86,0,89,"2018"
"47468","314510 NOVA RESENDE",1,0,2,215,0,218,"2018"
"47469","314520 NOVA SERRANA",3,5,28,1743,11,1790,"2018"
"47470","314530 NOVO CRUZEIRO",1,2,4,405,8,420,"2018"
"47471","314535 NOVO ORIENTE DE MINAS",1,2,2,138,5,148,"2018"
"47472","314537 NOVORIZONTE",1,0,0,16,38,55,"2018"
"47473","314540 OLARIA",0,0,0,15,0,15,"2018"
"47474","314545 OLHOS-D'AGUA",0,0,0,70,2,72,"2018"
"47475","314550 OLIMPIO NORONHA",0,0,0,27,0,27,"2018"
"47476","314560 OLIVEIRA",0,2,5,429,1,437,"2018"
"47477","314570 OLIVEIRA FORTES",0,0,0,22,0,22,"2018"
"47478","314580 ONCA DE PITANGUI",1,0,0,33,0,34,"2018"
"47479","314585 ORATORIOS",0,0,0,67,0,67,"2018"
"47480","314587 ORIZANIA",0,0,0,104,5,109,"2018"
"47481","314590 OURO BRANCO",1,1,3,480,1,486,"2018"
"47482","314600 OURO FINO",0,2,4,270,28,304,"2018"
"47483","314610 OURO PRETO",2,13,52,793,11,871,"2018"
"47484","314620 OURO VERDE DE MINAS",0,0,1,83,2,86,"2018"
"47485","314625 PADRE CARVALHO",0,0,0,16,51,67,"2018"
"47486","314630 PADRE PARAISO",1,3,2,268,0,274,"2018"
"47487","314640 PAINEIRAS",0,0,0,38,0,38,"2018"
"47488","314650 PAINS",1,0,1,78,0,80,"2018"
"47489","314655 PAI PEDRO",0,0,3,55,2,60,"2018"
"47490","314660 PAIVA",0,0,0,13,0,13,"2018"
"47491","314670 PALMA",0,0,1,36,0,37,"2018"
"47492","314675 PALMOPOLIS",0,1,1,81,0,83,"2018"
"47493","314690 PAPAGAIOS",0,1,0,180,4,185,"2018"
"47494","314700 PARACATU",1,5,11,1420,2,1439,"2018"
"47495","314710 PARA DE MINAS",3,3,10,1137,8,1161,"2018"
"47496","314720 PARAGUACU",2,1,3,275,3,284,"2018"
"47497","314730 PARAISOPOLIS",0,0,2,208,4,214,"2018"
"47498","314740 PARAOPEBA",0,0,0,283,2,285,"2018"
"47499","314750 PASSABEM",0,0,0,17,0,17,"2018"
"47500","314760 PASSA QUATRO",0,1,8,198,0,207,"2018"
"47501","314770 PASSA TEMPO",0,1,1,65,0,67,"2018"
"47502","314780 PASSA-VINTE",0,0,0,21,0,21,"2018"
"47503","314790 PASSOS",3,3,19,1452,3,1480,"2018"
"47504","314795 PATIS",0,0,0,49,0,49,"2018"
"47505","314800 PATOS DE MINAS",5,3,25,1933,1,1967,"2018"
"47506","314810 PATROCINIO",4,4,14,1272,2,1296,"2018"
"47507","314820 PATROCINIO DO MURIAE",0,0,0,33,0,33,"2018"
"47508","314830 PAULA CANDIDO",0,2,0,102,2,106,"2018"
"47509","314840 PAULISTAS",1,0,0,63,0,64,"2018"
"47510","314850 PAVAO",0,0,2,80,0,82,"2018"
"47511","314860 PECANHA",1,0,2,219,0,222,"2018"
"47512","314870 PEDRA AZUL",0,4,11,298,5,318,"2018"
"47513","314875 PEDRA BONITA",0,0,0,94,14,108,"2018"
"47514","314880 PEDRA DO ANTA",0,0,1,28,1,30,"2018"
"47515","314890 PEDRA DO INDAIA",0,0,0,36,1,37,"2018"
"47516","314900 PEDRA DOURADA",0,0,0,29,0,29,"2018"
"47517","314910 PEDRALVA",0,0,4,119,1,124,"2018"
"47518","314915 PEDRAS DE MARIA DA CRUZ",0,0,1,73,36,110,"2018"
"47519","314920 PEDRINOPOLIS",0,0,0,30,0,30,"2018"
"47520","314930 PEDRO LEOPOLDO",1,2,9,794,22,828,"2018"
"47521","314940 PEDRO TEIXEIRA",0,0,0,19,0,19,"2018"
"47522","314950 PEQUERI",0,1,0,35,0,36,"2018"
"47523","314960 PEQUI",0,0,0,43,1,44,"2018"
"47524","314970 PERDIGAO",0,2,1,183,2,188,"2018"
"47525","314980 PERDIZES",0,0,2,230,1,233,"2018"
"47526","314990 PERDOES",0,0,5,187,1,193,"2018"
"47527","314995 PERIQUITO",0,1,0,98,12,111,"2018"
"47528","315000 PESCADOR",0,0,0,41,1,42,"2018"
"47529","315010 PIAU",0,1,1,20,0,22,"2018"
"47530","315015 PIEDADE DE CARATINGA",1,2,0,103,5,111,"2018"
"47531","315020 PIEDADE DE PONTE NOVA",0,1,0,62,1,64,"2018"
"47532","315030 PIEDADE DO RIO GRANDE",0,0,0,50,1,51,"2018"
"47533","315040 PIEDADE DOS GERAIS",0,0,0,49,1,50,"2018"
"47534","315050 PIMENTA",0,0,0,56,0,56,"2018"
"47535","315053 PINGO-D'AGUA",0,0,0,53,0,53,"2018"
"47536","315057 PINTOPOLIS",0,0,0,91,0,91,"2018"
"47537","315060 PIRACEMA",0,0,0,59,0,59,"2018"
"47538","315070 PIRAJUBA",0,0,1,98,1,100,"2018"
"47539","315080 PIRANGA",0,1,3,152,2,158,"2018"
"47540","315090 PIRANGUCU",1,0,0,59,0,60,"2018"
"47541","315100 PIRANGUINHO",0,0,0,103,1,104,"2018"
"47542","315110 PIRAPETINGA",1,0,3,162,0,166,"2018"
"47543","315120 PIRAPORA",1,4,6,733,108,852,"2018"
"47544","315130 PIRAUBA",0,0,0,120,3,123,"2018"
"47545","315140 PITANGUI",1,0,7,296,39,343,"2018"
"47546","315150 PIUMHI",2,0,3,399,1,405,"2018"
"47547","315160 PLANURA",0,0,2,134,0,136,"2018"
"47548","315170 POCO FUNDO",0,0,0,159,1,160,"2018"
"47549","315180 POCOS DE CALDAS",6,11,30,1844,8,1899,"2018"
"47550","315190 POCRANE",0,0,1,96,15,112,"2018"
"47551","315200 POMPEU",2,1,3,434,0,440,"2018"
"47552","315210 PONTE NOVA",1,0,2,653,6,662,"2018"
"47553","315213 PONTO CHIQUE",1,0,0,38,8,47,"2018"
"47554","315217 PONTO DOS VOLANTES",0,1,2,145,0,148,"2018"
"47555","315220 PORTEIRINHA",2,2,7,489,1,501,"2018"
"47556","315230 PORTO FIRME",0,0,2,95,2,99,"2018"
"47557","315240 POTE",0,0,3,166,0,169,"2018"
"47558","315250 POUSO ALEGRE",0,4,10,1900,3,1917,"2018"
"47559","315260 POUSO ALTO",0,0,2,75,0,77,"2018"
"47560","315270 PRADOS",0,0,0,83,1,84,"2018"
"47561","315280 PRATA",0,0,3,359,2,364,"2018"
"47562","315290 PRATAPOLIS",0,1,0,64,0,65,"2018"
"47563","315300 PRATINHA",0,0,0,42,0,42,"2018"
"47564","315310 PRESIDENTE BERNARDES",0,0,0,50,0,50,"2018"
"47565","315320 PRESIDENTE JUSCELINO",0,0,1,33,2,36,"2018"
"47566","315330 PRESIDENTE KUBITSCHEK",0,2,1,31,1,35,"2018"
"47567","315340 PRESIDENTE OLEGARIO",3,2,1,189,0,195,"2018"
"47568","315350 ALTO JEQUITIBA",0,0,0,36,58,94,"2018"
"47569","315360 PRUDENTE DE MORAIS",0,0,2,154,2,158,"2018"
"47570","315370 QUARTEL GERAL",0,0,0,32,0,32,"2018"
"47571","315380 QUELUZITO",0,0,1,13,0,14,"2018"
"47572","315390 RAPOSOS",0,0,2,176,1,179,"2018"
"47573","315400 RAUL SOARES",0,0,0,255,3,258,"2018"
"47574","315410 RECREIO",1,1,1,83,0,86,"2018"
"47575","315415 REDUTO",0,0,0,4,100,104,"2018"
"47576","315420 RESENDE COSTA",1,0,0,98,0,99,"2018"
"47577","315430 RESPLENDOR",0,0,2,217,6,225,"2018"
"47578","315440 RESSAQUINHA",0,0,0,42,0,42,"2018"
"47579","315445 RIACHINHO",0,0,0,67,0,67,"2018"
"47580","315450 RIACHO DOS MACHADOS",0,0,2,109,0,111,"2018"
"47581","315460 RIBEIRAO DAS NEVES",14,19,79,4470,34,4616,"2018"
"47582","315470 RIBEIRAO VERMELHO",0,0,0,40,1,41,"2018"
"47583","315480 RIO ACIMA",0,1,1,124,0,126,"2018"
"47584","315490 RIO CASCA",0,0,1,140,1,142,"2018"
"47585","315500 RIO DOCE",0,0,0,21,0,21,"2018"
"47586","315510 RIO DO PRADO",0,1,2,58,0,61,"2018"
"47587","315520 RIO ESPERA",0,0,0,39,0,39,"2018"
"47588","315530 RIO MANSO",0,0,1,37,0,38,"2018"
"47589","315540 RIO NOVO",0,1,3,73,1,78,"2018"
"47590","315550 RIO PARANAIBA",0,0,0,135,0,135,"2018"
"47591","315560 RIO PARDO DE MINAS",0,1,6,392,3,402,"2018"
"47592","315570 RIO PIRACICABA",0,1,2,150,1,154,"2018"
"47593","315580 RIO POMBA",0,1,4,186,13,204,"2018"
"47594","315590 RIO PRETO",0,0,0,39,0,39,"2018"
"47595","315600 RIO VERMELHO",0,0,5,115,2,122,"2018"
"47596","315610 RITAPOLIS",0,0,0,56,0,56,"2018"
"47597","315620 ROCHEDO DE MINAS",0,0,0,25,0,25,"2018"
"47598","315630 RODEIRO",0,1,1,122,1,125,"2018"
"47599","315640 ROMARIA",0,0,0,43,0,43,"2018"
"47600","315645 ROSARIO DA LIMEIRA",0,0,0,61,1,62,"2018"
"47601","315650 RUBELITA",0,1,0,10,62,73,"2018"
"47602","315660 RUBIM",0,0,2,84,1,87,"2018"
"47603","315670 SABARA",5,5,37,1742,18,1807,"2018"
"47604","315680 SABINOPOLIS",0,0,1,142,6,149,"2018"
"47605","315690 SACRAMENTO",0,0,4,321,0,325,"2018"
"47606","315700 SALINAS",0,1,2,99,451,553,"2018"
"47607","315710 SALTO DA DIVISA",0,0,4,45,2,51,"2018"
"47608","315720 SANTA BARBARA",1,1,4,381,0,387,"2018"
"47609","315725 SANTA BARBARA DO LESTE",0,0,0,117,10,127,"2018"
"47610","315727 SANTA BARBARA DO MONTE VERDE",0,0,0,24,1,25,"2018"
"47611","315730 SANTA BARBARA DO TUGURIO",0,0,1,39,0,40,"2018"
"47612","315733 SANTA CRUZ DE MINAS",0,0,2,74,0,76,"2018"
"47613","315737 SANTA CRUZ DE SALINAS",0,0,1,7,26,34,"2018"
"47614","315740 SANTA CRUZ DO ESCALVADO",0,1,0,41,0,42,"2018"
"47615","315750 SANTA EFIGENIA DE MINAS",0,0,1,48,4,53,"2018"
"47616","315760 SANTA FE DE MINAS",0,0,0,35,7,42,"2018"
"47617","315765 SANTA HELENA DE MINAS",0,1,3,80,9,93,"2018"
"47618","315770 SANTA JULIANA",0,1,3,187,1,192,"2018"
"47619","315780 SANTA LUZIA",7,11,57,3038,14,3127,"2018"
"47620","315790 SANTA MARGARIDA",0,0,0,99,155,254,"2018"
"47621","315800 SANTA MARIA DE ITABIRA",1,0,1,127,4,133,"2018"
"47622","315810 SANTA MARIA DO SALTO",0,0,2,52,0,54,"2018"
"47623","315820 SANTA MARIA DO SUACUI",0,1,0,179,1,181,"2018"
"47624","315830 SANTANA DA VARGEM",1,0,1,77,1,80,"2018"
"47625","315840 SANTANA DE CATAGUASES",0,1,1,24,0,26,"2018"
"47626","315850 SANTANA DE PIRAPAMA",0,1,0,52,0,53,"2018"
"47627","315860 SANTANA DO DESERTO",0,0,0,30,1,31,"2018"
"47628","315870 SANTANA DO GARAMBEU",0,0,1,23,0,24,"2018"
"47629","315880 SANTANA DO JACARE",0,1,1,49,0,51,"2018"
"47630","315890 SANTANA DO MANHUACU",0,0,0,2,152,154,"2018"
"47631","315895 SANTANA DO PARAISO",2,5,10,699,2,718,"2018"
"47632","315900 SANTANA DO RIACHO",0,0,1,61,0,62,"2018"
"47633","315910 SANTANA DOS MONTES",0,0,0,32,0,32,"2018"
"47634","315920 SANTA RITA DE CALDAS",0,2,1,75,0,78,"2018"
"47635","315930 SANTA RITA DE JACUTINGA",0,0,0,32,1,33,"2018"
"47636","315935 SANTA RITA DE MINAS",1,0,0,82,8,91,"2018"
"47637","315940 SANTA RITA DE IBITIPOCA",0,0,0,27,0,27,"2018"
"47638","315950 SANTA RITA DO ITUETO",0,0,2,87,3,92,"2018"
"47639","315960 SANTA RITA DO SAPUCAI",2,1,3,521,6,533,"2018"
"47640","315970 SANTA ROSA DA SERRA",0,0,0,38,0,38,"2018"
"47641","315980 SANTA VITORIA",1,0,0,285,1,287,"2018"
"47642","315990 SANTO ANTONIO DO AMPARO",0,1,3,183,0,187,"2018"
"47643","316000 SANTO ANTONIO DO AVENTUREIRO",0,0,1,35,0,36,"2018"
"47644","316010 SANTO ANTONIO DO GRAMA",0,0,0,52,0,52,"2018"
"47645","316020 SANTO ANTONIO DO ITAMBE",0,0,2,29,1,32,"2018"
"47646","316030 SANTO ANTONIO DO JACINTO",0,0,11,125,1,137,"2018"
"47647","316040 SANTO ANTONIO DO MONTE",0,2,14,342,0,358,"2018"
"47648","316045 SANTO ANTONIO DO RETIRO",0,0,0,42,51,93,"2018"
"47649","316050 SANTO ANTONIO DO RIO ABAIXO",0,0,0,20,0,20,"2018"
"47650","316060 SANTO HIPOLITO",0,0,1,28,0,29,"2018"
"47651","316070 SANTOS DUMONT",1,0,5,493,1,500,"2018"
"47652","316080 SAO BENTO ABADE",0,0,0,75,0,75,"2018"
"47653","316090 SAO BRAS DO SUACUI",0,0,0,30,0,30,"2018"
"47654","316095 SAO DOMINGOS DAS DORES",1,0,1,73,3,78,"2018"
"47655","316100 SAO DOMINGOS DO PRATA",0,1,1,164,0,166,"2018"
"47656","316105 SAO FELIX DE MINAS",0,0,1,45,2,48,"2018"
"47657","316110 SAO FRANCISCO",0,2,16,821,7,846,"2018"
"47658","316120 SAO FRANCISCO DE PAULA",0,0,1,74,0,75,"2018"
"47659","316130 SAO FRANCISCO DE SALES",0,0,1,67,0,68,"2018"
"47660","316140 SAO FRANCISCO DO GLORIA",0,0,2,44,0,46,"2018"
"47661","316150 SAO GERALDO",0,0,2,94,0,96,"2018"
"47662","316160 SAO GERALDO DA PIEDADE",0,0,0,46,1,47,"2018"
"47663","316165 SAO GERALDO DO BAIXIO",0,0,0,34,4,38,"2018"
"47664","316170 SAO GONCALO DO ABAETE",0,0,2,72,0,74,"2018"
"47665","316180 SAO GONCALO DO PARA",0,2,6,135,2,145,"2018"
"47666","316190 SAO GONCALO DO RIO ABAIXO",0,0,0,138,0,138,"2018"
"47667","316200 SAO GONCALO DO SAPUCAI",0,0,6,323,0,329,"2018"
"47668","316210 SAO GOTARDO",4,1,2,787,0,794,"2018"
"47669","316220 SAO JOAO BATISTA DO GLORIA",0,0,1,88,0,89,"2018"
"47670","316225 SAO JOAO DA LAGOA",1,0,0,67,2,70,"2018"
"47671","316230 SAO JOAO DA MATA",0,0,1,35,0,36,"2018"
"47672","316240 SAO JOAO DA PONTE",2,0,4,236,3,245,"2018"
"47673","316245 SAO JOAO DAS MISSOES",1,0,0,136,163,300,"2018"
"47674","316250 SAO JOAO DEL REI",1,2,10,993,2,1008,"2018"
"47675","316255 SAO JOAO DO MANHUACU",0,1,0,95,127,223,"2018"
"47676","316257 SAO JOAO DO MANTENINHA",0,0,2,80,1,83,"2018"
"47677","316260 SAO JOAO DO ORIENTE",0,1,1,122,0,124,"2018"
"47678","316265 SAO JOAO DO PACUI",0,0,2,36,3,41,"2018"
"47679","316270 SAO JOAO DO PARAISO",0,2,3,165,100,270,"2018"
"47680","316280 SAO JOAO EVANGELISTA",1,0,4,191,0,196,"2018"
"47681","316290 SAO JOAO NEPOMUCENO",3,1,6,286,0,296,"2018"
"47682","316292 SAO JOAQUIM DE BICAS",0,2,5,363,1,371,"2018"
"47683","316294 SAO JOSE DA BARRA",0,0,2,107,0,109,"2018"
"47684","316295 SAO JOSE DA LAPA",1,1,5,353,7,367,"2018"
"47685","316300 SAO JOSE DA SAFIRA",1,0,0,58,6,65,"2018"
"47686","316310 SAO JOSE DA VARGINHA",0,0,0,32,0,32,"2018"
"47687","316320 SAO JOSE DO ALEGRE",0,0,1,49,0,50,"2018"
"47688","316330 SAO JOSE DO DIVINO",0,0,0,46,1,47,"2018"
"47689","316340 SAO JOSE DO GOIABAL",0,0,0,43,0,43,"2018"
"47690","316350 SAO JOSE DO JACURI",0,0,1,83,0,84,"2018"
"47691","316360 SAO JOSE DO MANTIMENTO",0,0,0,13,23,36,"2018"
"47692","316370 SAO LOURENCO",1,0,8,534,0,543,"2018"
"47693","316380 SAO MIGUEL DO ANTA",0,0,2,56,0,58,"2018"
"47694","316390 SAO PEDRO DA UNIAO",0,0,1,38,0,39,"2018"
"47695","316400 SAO PEDRO DOS FERROS",0,1,0,79,0,80,"2018"
"47696","316410 SAO PEDRO DO SUACUI",0,0,1,63,0,64,"2018"
"47697","316420 SAO ROMAO",0,1,2,107,4,114,"2018"
"47698","316430 SAO ROQUE DE MINAS",0,0,2,83,1,86,"2018"
"47699","316440 SAO SEBASTIAO DA BELA VISTA",0,0,0,69,1,70,"2018"
"47700","316443 SAO SEBASTIAO DA VARGEM ALEGRE",0,0,0,21,0,21,"2018"
"47701","316447 SAO SEBASTIAO DO ANTA",0,1,0,100,3,104,"2018"
"47702","316450 SAO SEBASTIAO DO MARANHAO",1,0,1,100,0,102,"2018"
"47703","316460 SAO SEBASTIAO DO OESTE",1,1,2,135,0,139,"2018"
"47704","316470 SAO SEBASTIAO DO PARAISO",2,2,6,926,3,939,"2018"
"47705","316480 SAO SEBASTIAO DO RIO PRETO",0,0,0,5,0,5,"2018"
"47706","316490 SAO SEBASTIAO DO RIO VERDE",0,0,0,24,0,24,"2018"
"47707","316500 SAO TIAGO",0,0,1,111,0,112,"2018"
"47708","316510 SAO TOMAS DE AQUINO",0,0,1,82,0,83,"2018"
"47709","316520 SAO THOME DAS LETRAS",0,0,2,68,0,70,"2018"
"47710","316530 SAO VICENTE DE MINAS",0,0,1,76,3,80,"2018"
"47711","316540 SAPUCAI-MIRIM",1,0,1,71,0,73,"2018"
"47712","316550 SARDOA",0,1,0,51,4,56,"2018"
"47713","316553 SARZEDO",0,1,12,530,2,545,"2018"
"47714","316555 SETUBINHA",0,0,2,134,5,141,"2018"
"47715","316556 SEM-PEIXE",0,0,0,10,0,10,"2018"
"47716","316557 SENADOR AMARAL",0,0,2,99,0,101,"2018"
"47717","316560 SENADOR CORTES",0,0,0,20,0,20,"2018"
"47718","316570 SENADOR FIRMINO",2,1,1,84,1,89,"2018"
"47719","316580 SENADOR JOSE BENTO",0,0,1,9,0,10,"2018"
"47720","316590 SENADOR MODESTINO GONCALVES",0,1,2,34,0,37,"2018"
"47721","316600 SENHORA DE OLIVEIRA",0,0,0,55,0,55,"2018"
"47722","316610 SENHORA DO PORTO",0,0,4,36,0,40,"2018"
"47723","316620 SENHORA DOS REMEDIOS",0,1,0,77,0,78,"2018"
"47724","316630 SERICITA",0,0,2,98,3,103,"2018"
"47725","316640 SERITINGA",0,0,0,23,0,23,"2018"
"47726","316650 SERRA AZUL DE MINAS",1,2,2,53,0,58,"2018"
"47727","316660 SERRA DA SAUDADE",0,0,0,7,0,7,"2018"
"47728","316670 SERRA DOS AIMORES",1,0,0,79,0,80,"2018"
"47729","316680 SERRA DO SALITRE",2,1,1,169,1,174,"2018"
"47730","316690 SERRANIA",0,0,3,101,0,104,"2018"
"47731","316695 SERRANOPOLIS DE MINAS",0,0,1,38,1,40,"2018"
"47732","316700 SERRANOS",0,0,0,17,0,17,"2018"
"47733","316710 SERRO",2,1,2,260,1,266,"2018"
"47734","316720 SETE LAGOAS",10,5,31,2769,6,2821,"2018"
"47735","316730 SILVEIRANIA",0,0,0,19,1,20,"2018"
"47736","316740 SILVIANOPOLIS",0,1,2,67,0,70,"2018"
"47737","316750 SIMAO PEREIRA",0,0,1,20,0,21,"2018"
"47738","316760 SIMONESIA",1,0,1,33,301,336,"2018"
"47739","316770 SOBRALIA",0,0,2,45,9,56,"2018"
"47740","316780 SOLEDADE DE MINAS",0,0,2,56,0,58,"2018"
"47741","316790 TABULEIRO",0,0,0,49,2,51,"2018"
"47742","316800 TAIOBEIRAS",0,0,4,425,3,432,"2018"
"47743","316805 TAPARUBA",0,0,1,36,3,40,"2018"
"47744","316810 TAPIRA",0,0,0,62,0,62,"2018"
"47745","316820 TAPIRAI",0,0,0,10,0,10,"2018"
"47746","316830 TAQUARACU DE MINAS",0,0,0,38,0,38,"2018"
"47747","316840 TARUMIRIM",0,0,0,137,11,148,"2018"
"47748","316850 TEIXEIRAS",0,0,6,107,0,113,"2018"
"47749","316860 TEOFILO OTONI",11,4,21,1954,17,2007,"2018"
"47750","316870 TIMOTEO",2,6,8,1013,2,1031,"2018"
"47751","316880 TIRADENTES",1,1,0,71,1,74,"2018"
"47752","316890 TIROS",0,0,0,77,0,77,"2018"
"47753","316900 TOCANTINS",0,2,3,179,5,189,"2018"
"47754","316905 TOCOS DO MOJI",0,0,0,42,0,42,"2018"
"47755","316910 TOLEDO",0,1,0,54,0,55,"2018"
"47756","316920 TOMBOS",0,0,0,99,0,99,"2018"
"47757","316930 TRES CORACOES",1,2,6,1075,1,1085,"2018"
"47758","316935 TRES MARIAS",1,1,5,372,0,379,"2018"
"47759","316940 TRES PONTAS",2,6,10,707,8,733,"2018"
"47760","316950 TUMIRITINGA",1,0,0,64,7,72,"2018"
"47761","316960 TUPACIGUARA",0,1,4,205,6,216,"2018"
"47762","316970 TURMALINA",0,0,3,173,2,178,"2018"
"47763","316980 TURVOLANDIA",1,0,1,73,0,75,"2018"
"47764","316990 UBA",0,4,9,1248,14,1275,"2018"
"47765","317000 UBAI",0,0,0,145,0,145,"2018"
"47766","317005 UBAPORANGA",0,1,0,141,14,156,"2018"
"47767","317010 UBERABA",28,11,61,4067,21,4188,"2018"
"47768","317020 UBERLANDIA",32,29,56,9486,82,9685,"2018"
"47769","317030 UMBURATIBA",0,0,1,35,0,36,"2018"
"47770","317040 UNAI",4,4,10,1190,4,1212,"2018"
"47771","317043 UNIAO DE MINAS",0,0,0,40,0,40,"2018"
"47772","317047 URUANA DE MINAS",0,0,0,34,1,35,"2018"
"47773","317050 URUCANIA",0,0,3,135,2,140,"2018"
"47774","317052 URUCUIA",1,0,0,121,0,122,"2018"
"47775","317057 VARGEM ALEGRE",0,0,0,76,3,79,"2018"
"47776","317060 VARGEM BONITA",0,0,0,22,0,22,"2018"
"47777","317065 VARGEM GRANDE DO RIO PARDO",0,0,0,67,3,70,"2018"
"47778","317070 VARGINHA",4,6,22,1810,3,1845,"2018"
"47779","317075 VARJAO DE MINAS",0,0,1,106,0,107,"2018"
"47780","317080 VARZEA DA PALMA",1,2,10,346,56,415,"2018"
"47781","317090 VARZELANDIA",2,1,5,278,0,286,"2018"
"47782","317100 VAZANTE",0,1,1,230,1,233,"2018"
"47783","317103 VERDELANDIA",1,0,4,128,2,135,"2018"
"47784","317107 VEREDINHA",0,0,0,52,0,52,"2018"
"47785","317110 VERISSIMO",0,0,0,41,0,41,"2018"
"47786","317115 VERMELHO NOVO",0,0,1,62,5,68,"2018"
"47787","317120 VESPASIANO",8,13,33,1795,10,1859,"2018"
"47788","317130 VICOSA",2,4,18,993,6,1023,"2018"
"47789","317140 VIEIRAS",0,0,0,31,0,31,"2018"
"47790","317150 MATHIAS LOBATO",0,0,0,32,3,35,"2018"
"47791","317160 VIRGEM DA LAPA",0,0,0,120,4,124,"2018"
"47792","317170 VIRGINIA",0,1,1,95,0,97,"2018"
"47793","317180 VIRGINOPOLIS",0,1,0,129,0,130,"2018"
"47794","317190 VIRGOLANDIA",0,0,4,52,4,60,"2018"
"47795","317200 VISCONDE DO RIO BRANCO",0,1,2,516,3,522,"2018"
"47796","317210 VOLTA GRANDE",0,0,0,52,1,53,"2018"
"47797","317220 WENCESLAU BRAZ",0,0,1,29,0,30,"2018"
"47798","MUNICIPIO IGNORADO - ES",0,0,0,1,0,1,"2018"
"47799","320010 AFONSO CLAUDIO",2,3,6,454,0,465,"2018"
"47800","320013 AGUIA BRANCA",0,1,0,114,1,116,"2018"
"47801","320016 AGUA DOCE DO NORTE",1,0,5,147,0,153,"2018"
"47802","320020 ALEGRE",0,0,4,429,0,433,"2018"
"47803","320030 ALFREDO CHAVES",0,0,5,141,0,146,"2018"
"47804","320035 ALTO RIO NOVO",1,0,0,101,1,103,"2018"
"47805","320040 ANCHIETA",0,1,8,382,0,391,"2018"
"47806","320050 APIACA",0,1,1,76,0,78,"2018"
"47807","320060 ARACRUZ",1,4,17,1434,1,1457,"2018"
"47808","320070 ATILIO VIVACQUA",1,0,2,129,2,134,"2018"
"47809","320080 BAIXO GUANDU",0,1,6,393,0,400,"2018"
"47810","320090 BARRA DE SAO FRANCISCO",2,1,6,682,0,691,"2018"
"47811","320100 BOA ESPERANCA",0,0,0,210,1,211,"2018"
"47812","320110 BOM JESUS DO NORTE",2,1,1,101,0,105,"2018"
"47813","320115 BREJETUBA",1,0,8,196,0,205,"2018"
"47814","320120 CACHOEIRO DE ITAPEMIRIM",5,12,35,2672,8,2732,"2018"
"47815","320130 CARIACICA",5,14,64,5767,28,5878,"2018"
"47816","320140 CASTELO",1,1,9,461,2,474,"2018"
"47817","320150 COLATINA",5,13,25,1709,2,1754,"2018"
"47818","320160 CONCEICAO DA BARRA",2,0,3,411,1,417,"2018"
"47819","320170 CONCEICAO DO CASTELO",0,0,4,156,2,162,"2018"
"47820","320180 DIVINO DE SAO LOURENCO",0,1,0,59,3,63,"2018"
"47821","320190 DOMINGOS MARTINS",0,2,12,492,2,508,"2018"
"47822","320200 DORES DO RIO PRETO",0,1,3,97,0,101,"2018"
"47823","320210 ECOPORANGA",1,4,2,289,0,296,"2018"
"47824","320220 FUNDAO",1,2,4,255,2,264,"2018"
"47825","320225 GOVERNADOR LINDENBERG",0,1,2,131,1,135,"2018"
"47826","320230 GUACUI",0,2,6,413,0,421,"2018"
"47827","320240 GUARAPARI",3,7,31,1747,10,1798,"2018"
"47828","320245 IBATIBA",0,2,5,337,24,368,"2018"
"47829","320250 IBIRACU",0,2,2,168,0,172,"2018"
"47830","320255 IBITIRAMA",0,1,4,170,1,176,"2018"
"47831","320260 ICONHA",1,0,0,140,0,141,"2018"
"47832","320265 IRUPI",0,0,5,130,32,167,"2018"
"47833","320270 ITAGUACU",0,1,2,138,0,141,"2018"
"47834","320280 ITAPEMIRIM",3,2,8,589,0,602,"2018"
"47835","320290 ITARANA",0,0,1,121,0,122,"2018"
"47836","320300 IUNA",0,3,8,359,33,403,"2018"
"47837","320305 JAGUARE",0,2,9,518,2,531,"2018"
"47838","320310 JERONIMO MONTEIRO",0,1,2,166,1,170,"2018"
"47839","320313 JOAO NEIVA",0,0,2,206,1,209,"2018"
"47840","320316 LARANJA DA TERRA",0,0,3,110,0,113,"2018"
"47841","320320 LINHARES",6,17,28,2555,21,2627,"2018"
"47842","320330 MANTENOPOLIS",1,1,4,158,0,164,"2018"
"47843","320332 MARATAIZES",0,2,12,562,1,577,"2018"
"47844","320334 MARECHAL FLORIANO",0,2,3,220,0,225,"2018"
"47845","320335 MARILANDIA",0,0,5,150,0,155,"2018"
"47846","320340 MIMOSO DO SUL",1,0,3,229,4,237,"2018"
"47847","320350 MONTANHA",1,2,7,250,3,263,"2018"
"47848","320360 MUCURICI",0,0,0,77,2,79,"2018"
"47849","320370 MUNIZ FREIRE",0,1,4,250,3,258,"2018"
"47850","320380 MUQUI",0,0,5,179,1,185,"2018"
"47851","320390 NOVA VENECIA",0,3,8,729,0,740,"2018"
"47852","320400 PANCAS",1,1,4,222,1,229,"2018"
"47853","320405 PEDRO CANARIO",0,3,4,346,2,355,"2018"
"47854","320410 PINHEIROS",0,1,4,351,38,394,"2018"
"47855","320420 PIUMA",0,2,0,341,0,343,"2018"
"47856","320425 PONTO BELO",0,2,2,84,0,88,"2018"
"47857","320430 PRESIDENTE KENNEDY",0,1,3,213,0,217,"2018"
"47858","320435 RIO BANANAL",3,0,0,287,3,293,"2018"
"47859","320440 RIO NOVO DO SUL",0,1,3,130,0,134,"2018"
"47860","320450 SANTA LEOPOLDINA",1,0,1,117,0,119,"2018"
"47861","320455 SANTA MARIA DE JETIBA",1,2,6,722,5,736,"2018"
"47862","320460 SANTA TERESA",0,0,6,338,1,345,"2018"
"47863","320465 SAO DOMINGOS DO NORTE",0,1,2,113,0,116,"2018"
"47864","320470 SAO GABRIEL DA PALHA",1,1,6,424,0,432,"2018"
"47865","320480 SAO JOSE DO CALCADO",0,2,2,139,0,143,"2018"
"47866","320490 SAO MATEUS",4,10,24,1837,7,1882,"2018"
"47867","320495 SAO ROQUE DO CANAA",0,2,2,100,1,105,"2018"
"47868","320500 SERRA",33,24,96,7855,27,8035,"2018"
"47869","320501 SOORETAMA",1,2,10,424,4,441,"2018"
"47870","320503 VARGEM ALTA",1,1,5,264,1,272,"2018"
"47871","320506 VENDA NOVA DO IMIGRANTE",0,1,6,316,0,323,"2018"
"47872","320510 VIANA",4,3,14,1180,11,1212,"2018"
"47873","320515 VILA PAVAO",0,0,2,100,0,102,"2018"
"47874","320517 VILA VALERIO",0,2,2,166,2,172,"2018"
"47875","320520 VILA VELHA",13,16,71,6535,37,6672,"2018"
"47876","320530 VITORIA",12,9,34,4574,15,4644,"2018"
"47877","MUNICIPIO IGNORADO - RJ",0,0,0,13,5,18,"2018"
"47878","330010 ANGRA DOS REIS",9,3,77,2507,16,2612,"2018"
"47879","330015 APERIBE",0,2,3,136,0,141,"2018"
"47880","330020 ARARUAMA",3,9,35,1652,24,1723,"2018"
"47881","330022 AREAL",0,2,2,174,2,180,"2018"
"47882","330023 ARMACAO DOS BUZIOS",3,6,14,594,10,627,"2018"
"47883","330025 ARRAIAL DO CABO",1,2,11,352,36,402,"2018"
"47884","330030 BARRA DO PIRAI",2,6,24,1037,3,1072,"2018"
"47885","330040 BARRA MANSA",3,14,54,2126,5,2202,"2018"
"47886","330045 BELFORD ROXO",18,38,119,6705,63,6943,"2018"
"47887","330050 BOM JARDIM",1,0,5,359,2,367,"2018"
"47888","330060 BOM JESUS DO ITABAPOANA",2,2,3,519,0,526,"2018"
"47889","330070 CABO FRIO",11,9,50,2858,26,2954,"2018"
"47890","330080 CACHOEIRAS DE MACACU",1,6,22,742,9,780,"2018"
"47891","330090 CAMBUCI",1,0,4,145,0,150,"2018"
"47892","330093 CARAPEBUS",2,2,4,158,0,166,"2018"
"47893","330095 COMENDADOR LEVY GASPARIAN",2,1,1,129,2,135,"2018"
"47894","330100 CAMPOS DOS GOYTACAZES",25,26,127,7247,24,7449,"2018"
"47895","330110 CANTAGALO",0,3,5,208,2,218,"2018"
"47896","330115 CARDOSO MOREIRA",0,0,0,129,0,129,"2018"
"47897","330120 CARMO",2,1,2,209,1,215,"2018"
"47898","330130 CASIMIRO DE ABREU",1,3,6,592,2,604,"2018"
"47899","330140 CONCEICAO DE MACABU",0,1,6,276,2,285,"2018"
"47900","330150 CORDEIRO",2,1,5,242,1,251,"2018"
"47901","330160 DUAS BARRAS",0,2,5,136,1,144,"2018"
"47902","330170 DUQUE DE CAXIAS",29,56,273,12650,107,13115,"2018"
"47903","330180 ENGENHEIRO PAULO DE FRONTIN",0,0,2,158,0,160,"2018"
"47904","330185 GUAPIMIRIM",2,5,22,714,2,745,"2018"
"47905","330187 IGUABA GRANDE",1,6,7,375,4,393,"2018"
"47906","330190 ITABORAI",9,16,32,2957,28,3042,"2018"
"47907","330200 ITAGUAI",2,10,26,1711,13,1762,"2018"
"47908","330205 ITALVA",0,0,1,166,0,167,"2018"
"47909","330210 ITAOCARA",1,2,8,288,0,299,"2018"
"47910","330220 ITAPERUNA",0,7,16,1197,0,1220,"2018"
"47911","330225 ITATIAIA",1,1,13,391,3,409,"2018"
"47912","330227 JAPERI",3,8,22,1271,23,1327,"2018"
"47913","330230 LAJE DO MURIAE",0,0,3,92,1,96,"2018"
"47914","330240 MACAE",9,13,41,3817,22,3902,"2018"
"47915","330245 MACUCO",0,2,1,98,0,101,"2018"
"47916","330250 MAGE",7,18,71,3628,3,3727,"2018"
"47917","330260 MANGARATIBA",0,0,3,465,2,470,"2018"
"47918","330270 MARICA",1,5,15,1065,885,1971,"2018"
"47919","330280 MENDES",1,0,1,223,1,226,"2018"
"47920","330285 MESQUITA",5,12,49,2244,14,2324,"2018"
"47921","330290 MIGUEL PEREIRA",2,1,12,351,10,376,"2018"
"47922","330300 MIRACEMA",4,2,1,371,1,379,"2018"
"47923","330310 NATIVIDADE",2,4,8,152,0,166,"2018"
"47924","330320 NILOPOLIS",1,8,44,1743,10,1806,"2018"
"47925","330330 NITEROI",19,23,98,5967,32,6139,"2018"
"47926","330340 NOVA FRIBURGO",7,10,57,2237,17,2328,"2018"
"47927","330350 NOVA IGUACU",21,64,214,11745,139,12183,"2018"
"47928","330360 PARACAMBI",1,3,7,444,7,462,"2018"
"47929","330370 PARAIBA DO SUL",1,4,6,512,1,524,"2018"
"47930","330380 PARATY",5,3,7,666,2,683,"2018"
"47931","330385 PATY DO ALFERES",5,1,11,377,8,402,"2018"
"47932","330390 PETROPOLIS",10,9,71,3838,48,3976,"2018"
"47933","330395 PINHEIRAL",1,0,2,310,0,313,"2018"
"47934","330400 PIRAI",1,1,4,360,0,366,"2018"
"47935","330410 PORCIUNCULA",1,0,5,185,0,191,"2018"
"47936","330411 PORTO REAL",0,1,7,291,1,300,"2018"
"47937","330412 QUATIS",1,0,4,168,0,173,"2018"
"47938","330414 QUEIMADOS",5,12,34,2190,31,2272,"2018"
"47939","330415 QUISSAMA",0,3,11,287,1,302,"2018"
"47940","330420 RESENDE",13,1,29,1700,2,1745,"2018"
"47941","330430 RIO BONITO",0,4,14,739,2,759,"2018"
"47942","330440 RIO CLARO",0,1,2,205,0,208,"2018"
"47943","330450 RIO DAS FLORES",0,1,7,104,0,112,"2018"
"47944","330452 RIO DAS OSTRAS",3,13,51,2056,17,2140,"2018"
"47945","330455 RIO DE JANEIRO",171,377,1357,79872,777,82554,"2018"
"47946","330460 SANTA MARIA MADALENA",0,2,2,90,0,94,"2018"
"47947","330470 SANTO ANTONIO DE PADUA",4,1,6,534,0,545,"2018"
"47948","330475 SAO FRANCISCO DE ITABAPOANA",3,2,11,560,3,579,"2018"
"47949","330480 SAO FIDELIS",2,5,23,378,24,432,"2018"
"47950","330490 SAO GONCALO",20,35,159,10722,33,10969,"2018"
"47951","330500 SAO JOAO DA BARRA",1,2,13,604,4,624,"2018"
"47952","330510 SAO JOAO DE MERITI",17,25,101,6064,46,6253,"2018"
"47953","330513 SAO JOSE DE UBA",0,1,2,136,0,139,"2018"
"47954","330515 SAO JOSE DO VALE DO RIO PRETO",0,0,6,245,1,252,"2018"
"47955","330520 SAO PEDRO DA ALDEIA",6,7,37,1575,49,1674,"2018"
"47956","330530 SAO SEBASTIAO DO ALTO",0,0,0,106,0,106,"2018"
"47957","330540 SAPUCAIA",1,0,6,201,5,213,"2018"
"47958","330550 SAQUAREMA",2,7,35,1202,13,1259,"2018"
"47959","330555 SEROPEDICA",4,6,21,1144,4,1179,"2018"
"47960","330560 SILVA JARDIM",0,3,2,300,2,307,"2018"
"47961","330570 SUMIDOURO",3,3,0,219,1,226,"2018"
"47962","330575 TANGUA",0,5,4,468,1,478,"2018"
"47963","330580 TERESOPOLIS",3,11,55,2202,10,2281,"2018"
"47964","330590 TRAJANO DE MORAES",0,1,1,118,0,120,"2018"
"47965","330600 TRES RIOS",2,6,20,1151,9,1188,"2018"
"47966","330610 VALENCA",2,9,24,859,2,896,"2018"
"47967","330615 VARRE-SAI",1,0,5,161,0,167,"2018"
"47968","330620 VASSOURAS",1,1,6,524,2,534,"2018"
"47969","330630 VOLTA REDONDA",13,16,36,3307,4,3376,"2018"
"47970","MUNICIPIO IGNORADO - SP",0,0,0,3,1,4,"2018"
"47971","350010 ADAMANTINA",0,2,7,357,0,366,"2018"
"47972","350020 ADOLFO",0,0,0,46,0,46,"2018"
"47973","350030 AGUAI",0,0,1,448,2,451,"2018"
"47974","350040 AGUAS DA PRATA",1,1,1,82,0,85,"2018"
"47975","350050 AGUAS DE LINDOIA",0,1,1,195,1,198,"2018"
"47976","350055 AGUAS DE SANTA BARBARA",1,0,1,63,0,65,"2018"
"47977","350060 AGUAS DE SAO PEDRO",1,0,0,25,0,26,"2018"
"47978","350070 AGUDOS",3,0,4,536,0,543,"2018"
"47979","350075 ALAMBARI",0,0,2,66,1,69,"2018"
"47980","350080 ALFREDO MARCONDES",0,1,0,59,0,60,"2018"
"47981","350090 ALTAIR",0,0,0,39,1,40,"2018"
"47982","350100 ALTINOPOLIS",0,1,2,182,2,187,"2018"
"47983","350110 ALTO ALEGRE",0,0,1,32,0,33,"2018"
"47984","350115 ALUMINIO",0,1,8,201,1,211,"2018"
"47985","350120 ALVARES FLORENCE",0,0,2,26,0,28,"2018"
"47986","350130 ALVARES MACHADO",1,0,2,331,0,334,"2018"
"47987","350140 ALVARO DE CARVALHO",0,0,1,41,0,42,"2018"
"47988","350150 ALVINLANDIA",1,1,1,50,0,53,"2018"
"47989","350160 AMERICANA",12,5,36,2618,9,2680,"2018"
"47990","350170 AMERICO BRASILIENSE",5,1,2,436,3,447,"2018"
"47991","350180 AMERICO DE CAMPOS",0,0,0,62,0,62,"2018"
"47992","350190 AMPARO",2,3,8,840,1,854,"2018"
"47993","350200 ANALANDIA",0,0,0,47,0,47,"2018"
"47994","350210 ANDRADINA",0,1,3,734,1,739,"2018"
"47995","350220 ANGATUBA",0,1,7,329,0,337,"2018"
"47996","350230 ANHEMBI",0,1,3,87,1,92,"2018"
"47997","350240 ANHUMAS",1,0,0,54,0,55,"2018"
"47998","350250 APARECIDA",0,1,9,399,9,418,"2018"
"47999","350260 APARECIDA D'OESTE",0,0,0,48,0,48,"2018"
"48000","350270 APIAI",1,1,7,334,2,345,"2018"
"48001","350275 ARACARIGUAMA",1,0,7,361,3,372,"2018"
"48002","350280 ARACATUBA",7,9,20,2390,0,2426,"2018"
"48003","350290 ARACOIABA DA SERRA",2,2,3,353,0,360,"2018"
"48004","350300 ARAMINA",0,0,0,72,0,72,"2018"
"48005","350310 ARANDU",0,0,0,84,0,84,"2018"
"48006","350315 ARAPEI",0,0,0,16,0,16,"2018"
"48007","350320 ARARAQUARA",6,15,22,2759,1,2803,"2018"
"48008","350330 ARARAS",6,8,19,1543,3,1579,"2018"
"48009","350335 ARCO-IRIS",0,0,0,19,0,19,"2018"
"48010","350340 AREALVA",0,0,1,63,0,64,"2018"
"48011","350350 AREIAS",0,0,0,46,0,46,"2018"
"48012","350360 AREIOPOLIS",1,4,2,137,0,144,"2018"
"48013","350370 ARIRANHA",0,0,3,85,0,88,"2018"
"48014","350380 ARTUR NOGUEIRA",1,0,6,652,4,663,"2018"
"48015","350390 ARUJA",4,7,21,1370,3,1405,"2018"
"48016","350395 ASPASIA",0,0,0,20,0,20,"2018"
"48017","350400 ASSIS",6,3,9,1211,1,1230,"2018"
"48018","350410 ATIBAIA",4,6,21,2089,6,2126,"2018"
"48019","350420 AURIFLAMA",0,0,1,139,0,140,"2018"
"48020","350430 AVAI",0,0,1,57,0,58,"2018"
"48021","350440 AVANHANDAVA",0,1,2,144,0,147,"2018"
"48022","350450 AVARE",3,6,10,1352,0,1371,"2018"
"48023","350460 BADY BASSITT",0,0,0,277,0,277,"2018"
"48024","350470 BALBINOS",0,0,0,15,0,15,"2018"
"48025","350480 BALSAMO",0,1,1,80,0,82,"2018"
"48026","350490 BANANAL",0,0,2,80,0,82,"2018"
"48027","350500 BARAO DE ANTONINA",0,0,0,43,0,43,"2018"
"48028","350510 BARBOSA",0,0,2,95,0,97,"2018"
"48029","350520 BARIRI",1,1,3,403,4,412,"2018"
"48030","350530 BARRA BONITA",1,0,1,347,1,350,"2018"
"48031","350535 BARRA DO CHAPEU",1,0,2,81,0,84,"2018"
"48032","350540 BARRA DO TURVO",1,0,1,80,1,83,"2018"
"48033","350550 BARRETOS",7,5,22,1486,6,1526,"2018"
"48034","350560 BARRINHA",1,4,2,481,3,491,"2018"
"48035","350570 BARUERI",12,13,52,5686,16,5779,"2018"
"48036","350580 BASTOS",1,0,7,286,0,294,"2018"
"48037","350590 BATATAIS",2,0,5,720,15,742,"2018"
"48038","350600 BAURU",17,10,60,4530,17,4634,"2018"
"48039","350610 BEBEDOURO",4,3,7,916,0,930,"2018"
"48040","350620 BENTO DE ABREU",0,0,1,25,0,26,"2018"
"48041","350630 BERNARDINO DE CAMPOS",0,0,1,133,0,134,"2018"
"48042","350635 BERTIOGA",1,5,15,1020,4,1045,"2018"
"48043","350640 BILAC",0,0,1,68,0,69,"2018"
"48044","350650 BIRIGUI",2,7,11,1491,1,1512,"2018"
"48045","350660 BIRITIBA-MIRIM",0,0,5,364,3,372,"2018"
"48046","350670 BOA ESPERANCA DO SUL",1,0,2,165,1,169,"2018"
"48047","350680 BOCAINA",0,0,0,151,2,153,"2018"
"48048","350690 BOFETE",0,1,3,140,3,147,"2018"
"48049","350700 BOITUVA",0,4,17,835,1,857,"2018"
"48050","350710 BOM JESUS DOS PERDOES",0,1,2,315,1,319,"2018"
"48051","350715 BOM SUCESSO DE ITARARE",0,1,7,49,0,57,"2018"
"48052","350720 BORA",0,0,0,16,0,16,"2018"
"48053","350730 BORACEIA",2,0,2,52,0,56,"2018"
"48054","350740 BORBOREMA",1,0,1,139,0,141,"2018"
"48055","350745 BOREBI",0,0,0,28,0,28,"2018"
"48056","350750 BOTUCATU",5,15,55,1738,5,1818,"2018"
"48057","350760 BRAGANCA PAULISTA",2,4,20,2241,4,2271,"2018"
"48058","350770 BRAUNA",0,0,0,77,0,77,"2018"
"48059","350775 BREJO ALEGRE",0,0,1,22,0,23,"2018"
"48060","350780 BRODOWSKI",1,0,6,325,3,335,"2018"
"48061","350790 BROTAS",0,0,9,323,2,334,"2018"
"48062","350800 BURI",0,6,7,323,4,340,"2018"
"48063","350810 BURITAMA",0,0,6,200,0,206,"2018"
"48064","350820 BURITIZAL",0,0,1,43,0,44,"2018"
"48065","350830 CABRALIA PAULISTA",0,0,2,58,0,60,"2018"
"48066","350840 CABREUVA",0,2,18,744,0,764,"2018"
"48067","350850 CACAPAVA",3,4,13,1282,4,1306,"2018"
"48068","350860 CACHOEIRA PAULISTA",0,1,0,396,27,424,"2018"
"48069","350870 CACONDE",0,1,1,216,1,219,"2018"
"48070","350880 CAFELANDIA",2,0,2,229,0,233,"2018"
"48071","350890 CAIABU",0,1,0,41,0,42,"2018"
"48072","350900 CAIEIRAS",0,6,19,1396,3,1424,"2018"
"48073","350910 CAIUA",0,0,1,47,0,48,"2018"
"48074","350920 CAJAMAR",5,2,11,1228,0,1246,"2018"
"48075","350925 CAJATI",0,1,0,465,0,466,"2018"
"48076","350930 CAJOBI",0,0,0,92,0,92,"2018"
"48077","350940 CAJURU",0,1,3,353,0,357,"2018"
"48078","350945 CAMPINA DO MONTE ALEGRE",0,0,3,91,1,95,"2018"
"48079","350950 CAMPINAS",40,61,145,14751,63,15060,"2018"
"48080","350960 CAMPO LIMPO PAULISTA",1,3,14,1000,0,1018,"2018"
"48081","350970 CAMPOS DO JORDAO",0,2,9,750,1,762,"2018"
"48082","350980 CAMPOS NOVOS PAULISTA",0,0,2,56,1,59,"2018"
"48083","350990 CANANEIA",1,0,2,179,0,182,"2018"
"48084","350995 CANAS",0,0,0,76,7,83,"2018"
"48085","351000 CANDIDO MOTA",0,3,2,317,0,322,"2018"
"48086","351010 CANDIDO RODRIGUES",0,0,1,28,0,29,"2018"
"48087","351015 CANITAR",0,1,1,65,0,67,"2018"
"48088","351020 CAPAO BONITO",0,4,2,653,0,659,"2018"
"48089","351030 CAPELA DO ALTO",2,1,9,295,1,308,"2018"
"48090","351040 CAPIVARI",0,2,5,581,95,683,"2018"
"48091","351050 CARAGUATATUBA",3,4,18,1813,2,1840,"2018"
"48092","351060 CARAPICUIBA",12,16,72,6863,35,6998,"2018"
"48093","351070 CARDOSO",1,0,2,110,0,113,"2018"
"48094","351080 CASA BRANCA",2,0,5,305,0,312,"2018"
"48095","351090 CASSIA DOS COQUEIROS",0,0,0,24,0,24,"2018"
"48096","351100 CASTILHO",0,0,8,214,1,223,"2018"
"48097","351110 CATANDUVA",1,3,27,1312,4,1347,"2018"
"48098","351120 CATIGUA",0,0,2,73,0,75,"2018"
"48099","351130 CEDRAL",0,0,0,115,0,115,"2018"
"48100","351140 CERQUEIRA CESAR",1,1,3,257,1,263,"2018"
"48101","351150 CERQUILHO",0,3,13,487,3,506,"2018"
"48102","351160 CESARIO LANGE",1,1,7,238,0,247,"2018"
"48103","351170 CHARQUEADA",1,0,0,224,0,225,"2018"
"48104","351190 CLEMENTINA",0,0,2,114,0,116,"2018"
"48105","351200 COLINA",0,0,1,228,0,229,"2018"
"48106","351210 COLOMBIA",0,0,2,99,1,102,"2018"
"48107","351220 CONCHAL",0,3,6,477,0,486,"2018"
"48108","351230 CONCHAS",0,2,2,212,0,216,"2018"
"48109","351240 CORDEIROPOLIS",0,2,4,282,0,288,"2018"
"48110","351250 COROADOS",0,0,0,58,0,58,"2018"
"48111","351260 CORONEL MACEDO",0,0,4,36,1,41,"2018"
"48112","351270 CORUMBATAI",1,0,0,44,0,45,"2018"
"48113","351280 COSMOPOLIS",2,3,9,740,2,756,"2018"
"48114","351290 COSMORAMA",1,0,0,91,0,92,"2018"
"48115","351300 COTIA",10,11,47,4130,16,4214,"2018"
"48116","351310 CRAVINHOS",2,2,8,400,2,414,"2018"
"48117","351320 CRISTAIS PAULISTA",0,0,1,102,1,104,"2018"
"48118","351330 CRUZALIA",0,0,0,26,0,26,"2018"
"48119","351340 CRUZEIRO",8,2,10,900,4,924,"2018"
"48120","351350 CUBATAO",4,9,33,1577,1,1624,"2018"
"48121","351360 CUNHA",0,0,7,242,0,249,"2018"
"48122","351370 DESCALVADO",0,2,4,359,1,366,"2018"
"48123","351380 DIADEMA",9,25,63,5476,11,5584,"2018"
"48124","351385 DIRCE REIS",0,0,0,13,0,13,"2018"
"48125","351390 DIVINOLANDIA",0,0,1,127,1,129,"2018"
"48126","351400 DOBRADA",0,0,5,94,0,99,"2018"
"48127","351410 DOIS CORREGOS",1,1,4,324,1,331,"2018"
"48128","351420 DOLCINOPOLIS",0,0,0,19,0,19,"2018"
"48129","351430 DOURADO",0,2,1,82,0,85,"2018"
"48130","351440 DRACENA",3,2,6,484,2,497,"2018"
"48131","351450 DUARTINA",0,2,2,131,0,135,"2018"
"48132","351460 DUMONT",0,0,3,124,1,128,"2018"
"48133","351470 ECHAPORA",0,0,1,88,0,89,"2018"
"48134","351480 ELDORADO",1,0,2,235,0,238,"2018"
"48135","351490 ELIAS FAUSTO",1,1,2,182,28,214,"2018"
"48136","351492 ELISIARIO",0,0,0,34,0,34,"2018"
"48137","351495 EMBAUBA",0,0,0,24,0,24,"2018"
"48138","351500 EMBU DAS ARTES",8,10,39,4161,5,4223,"2018"
"48139","351510 EMBU-GUACU",0,4,15,933,6,958,"2018"
"48140","351512 EMILIANOPOLIS",0,0,1,34,0,35,"2018"
"48141","351515 ENGENHEIRO COELHO",1,2,4,283,1,291,"2018"
"48142","351518 ESPIRITO SANTO DO PINHAL",2,2,6,466,0,476,"2018"
"48143","351519 ESPIRITO SANTO DO TURVO",0,0,1,58,0,59,"2018"
"48144","351520 ESTRELA D'OESTE",1,1,0,81,0,83,"2018"
"48145","351530 ESTRELA DO NORTE",0,0,0,32,0,32,"2018"
"48146","351535 EUCLIDES DA CUNHA PAULISTA",0,1,1,108,1,111,"2018"
"48147","351540 FARTURA",0,1,4,205,0,210,"2018"
"48148","351550 FERNANDOPOLIS",0,2,9,789,0,800,"2018"
"48149","351560 FERNANDO PRESTES",0,1,1,53,1,56,"2018"
"48150","351565 FERNAO",1,0,1,20,1,23,"2018"
"48151","351570 FERRAZ DE VASCONCELOS",3,15,30,2788,10,2846,"2018"
"48152","351580 FLORA RICA",0,0,0,12,0,12,"2018"
"48153","351590 FLOREAL",0,0,0,27,0,27,"2018"
"48154","351600 FLORIDA PAULISTA",2,0,0,93,0,95,"2018"
"48155","351610 FLORINIA",0,0,0,21,0,21,"2018"
"48156","351620 FRANCA",5,16,60,4886,9,4976,"2018"
"48157","351630 FRANCISCO MORATO",6,14,36,2809,15,2880,"2018"
"48158","351640 FRANCO DA ROCHA",5,10,27,2146,16,2204,"2018"
"48159","351650 GABRIEL MONTEIRO",0,0,0,38,0,38,"2018"
"48160","351660 GALIA",0,1,2,76,0,79,"2018"
"48161","351670 GARCA",1,3,22,501,1,528,"2018"
"48162","351680 GASTAO VIDIGAL",1,0,0,34,0,35,"2018"
"48163","351685 GAVIAO PEIXOTO",0,0,0,61,0,61,"2018"
"48164","351690 GENERAL SALGADO",0,0,0,120,1,121,"2018"
"48165","351700 GETULINA",0,0,1,91,0,92,"2018"
"48166","351710 GLICERIO",0,0,1,52,0,53,"2018"
"48167","351720 GUAICARA",0,1,2,137,0,140,"2018"
"48168","351730 GUAIMBE",0,0,2,48,0,50,"2018"
"48169","351740 GUAIRA",0,4,4,448,1,457,"2018"
"48170","351750 GUAPIACU",0,0,1,253,0,254,"2018"
"48171","351760 GUAPIARA",2,1,5,250,1,259,"2018"
"48172","351770 GUARA",0,1,4,230,0,235,"2018"
"48173","351780 GUARACAI",0,0,0,77,0,77,"2018"
"48174","351790 GUARACI",1,0,3,107,0,111,"2018"
"48175","351800 GUARANI D'OESTE",0,0,0,25,0,25,"2018"
"48176","351810 GUARANTA",0,0,1,78,1,80,"2018"
"48177","351820 GUARARAPES",1,0,5,333,0,339,"2018"
"48178","351830 GUARAREMA",0,1,5,413,0,419,"2018"
"48179","351840 GUARATINGUETA",4,11,16,1449,1,1481,"2018"
"48180","351850 GUAREI",1,0,6,170,2,179,"2018"
"48181","351860 GUARIBA",3,0,9,509,7,528,"2018"
"48182","351870 GUARUJA",7,16,72,4379,23,4497,"2018"
"48183","351880 GUARULHOS",33,71,249,20679,80,21112,"2018"
"48184","351885 GUATAPARA",0,0,2,85,1,88,"2018"
"48185","351890 GUZOLANDIA",0,0,2,48,1,51,"2018"
"48186","351900 HERCULANDIA",0,2,1,87,0,90,"2018"
"48187","351905 HOLAMBRA",1,1,2,199,3,206,"2018"
"48188","351907 HORTOLANDIA",4,9,29,3005,7,3054,"2018"
"48189","351910 IACANGA",0,0,1,137,0,138,"2018"
"48190","351920 IACRI",0,1,0,67,0,68,"2018"
"48191","351925 IARAS",0,0,1,67,0,68,"2018"
"48192","351930 IBATE",0,1,7,516,0,524,"2018"
"48193","351940 IBIRA",0,0,0,128,0,128,"2018"
"48194","351950 IBIRAREMA",0,0,2,74,0,76,"2018"
"48195","351960 IBITINGA",2,3,4,766,9,784,"2018"
"48196","351970 IBIUNA",0,6,10,1026,3,1045,"2018"
"48197","351980 ICEM",1,0,1,97,1,100,"2018"
"48198","351990 IEPE",0,1,1,107,0,109,"2018"
"48199","352000 IGARACU DO TIETE",0,1,3,292,1,297,"2018"
"48200","352010 IGARAPAVA",0,0,4,312,0,316,"2018"
"48201","352020 IGARATA",0,1,4,139,2,146,"2018"
"48202","352030 IGUAPE",0,2,1,369,1,373,"2018"
"48203","352040 ILHABELA",0,1,9,497,1,508,"2018"
"48204","352042 ILHA COMPRIDA",0,0,1,173,0,174,"2018"
"48205","352044 ILHA SOLTEIRA",1,0,5,255,0,261,"2018"
"48206","352050 INDAIATUBA",9,8,44,3296,0,3357,"2018"
"48207","352060 INDIANA",0,0,0,70,0,70,"2018"
"48208","352070 INDIAPORA",0,0,1,40,0,41,"2018"
"48209","352080 INUBIA PAULISTA",0,0,0,43,0,43,"2018"
"48210","352090 IPAUSSU",0,0,1,188,1,190,"2018"
"48211","352100 IPERO",0,1,10,310,1,322,"2018"
"48212","352110 IPEUNA",2,0,0,86,0,88,"2018"
"48213","352115 IPIGUA",0,0,1,86,0,87,"2018"
"48214","352120 IPORANGA",1,0,2,46,0,49,"2018"
"48215","352130 IPUA",0,0,3,172,1,176,"2018"
"48216","352140 IRACEMAPOLIS",0,0,3,288,1,292,"2018"
"48217","352150 IRAPUA",0,0,2,84,0,86,"2018"
"48218","352160 IRAPURU",0,0,0,66,0,66,"2018"
"48219","352170 ITABERA",2,1,9,200,2,214,"2018"
"48220","352180 ITAI",1,1,4,329,0,335,"2018"
"48221","352190 ITAJOBI",0,0,1,166,0,167,"2018"
"48222","352200 ITAJU",0,0,0,40,0,40,"2018"
"48223","352210 ITANHAEM",2,14,32,1409,6,1463,"2018"
"48224","352215 ITAOCA",0,0,2,43,1,46,"2018"
"48225","352220 ITAPECERICA DA SERRA",0,14,44,2614,4,2676,"2018"
"48226","352230 ITAPETININGA",8,13,36,2141,5,2203,"2018"
"48227","352240 ITAPEVA",4,19,37,1364,0,1424,"2018"
"48228","352250 ITAPEVI",14,15,61,4024,18,4132,"2018"
"48229","352260 ITAPIRA",1,2,8,840,0,851,"2018"
"48230","352265 ITAPIRAPUA PAULISTA",0,0,0,59,0,59,"2018"
"48231","352270 ITAPOLIS",0,1,5,475,2,483,"2018"
"48232","352280 ITAPORANGA",1,1,2,163,0,167,"2018"
"48233","352290 ITAPUI",0,1,1,152,0,154,"2018"
"48234","352300 ITAPURA",0,0,1,56,0,57,"2018"
"48235","352310 ITAQUAQUECETUBA",17,21,62,5943,51,6094,"2018"
"48236","352320 ITARARE",1,4,9,653,1,668,"2018"
"48237","352330 ITARIRI",0,7,4,198,2,211,"2018"
"48238","352340 ITATIBA",1,3,14,1432,2,1452,"2018"
"48239","352350 ITATINGA",1,4,6,232,2,245,"2018"
"48240","352360 ITIRAPINA",0,0,2,175,1,178,"2018"
"48241","352370 ITIRAPUA",0,0,0,67,0,67,"2018"
"48242","352380 ITOBI",0,0,0,85,0,85,"2018"
"48243","352390 ITU",3,2,15,2196,11,2227,"2018"
"48244","352400 ITUPEVA",0,1,9,853,1,864,"2018"
"48245","352410 ITUVERAVA",1,2,4,446,0,453,"2018"
"48246","352420 JABORANDI",0,0,0,67,1,68,"2018"
"48247","352430 JABOTICABAL",1,2,11,771,0,785,"2018"
"48248","352440 JACAREI",5,12,52,2927,4,3000,"2018"
"48249","352450 JACI",0,0,0,95,0,95,"2018"
"48250","352460 JACUPIRANGA",1,1,3,238,1,244,"2018"
"48251","352470 JAGUARIUNA",1,1,7,816,3,828,"2018"
"48252","352480 JALES",5,4,3,489,1,502,"2018"
"48253","352490 JAMBEIRO",0,0,1,73,1,75,"2018"
"48254","352500 JANDIRA",6,5,23,1637,5,1676,"2018"
"48255","352510 JARDINOPOLIS",0,2,15,566,3,586,"2018"
"48256","352520 JARINU",1,1,3,479,0,484,"2018"
"48257","352530 JAU",8,3,10,1650,6,1677,"2018"
"48258","352540 JERIQUARA",0,0,0,47,0,47,"2018"
"48259","352550 JOANOPOLIS",1,0,1,155,0,157,"2018"
"48260","352560 JOAO RAMALHO",0,0,0,52,0,52,"2018"
"48261","352570 JOSE BONIFACIO",0,2,2,431,2,437,"2018"
"48262","352580 JULIO MESQUITA",1,0,1,55,1,58,"2018"
"48263","352585 JUMIRIM",0,0,0,39,0,39,"2018"
"48264","352590 JUNDIAI",10,14,56,6277,9,6366,"2018"
"48265","352600 JUNQUEIROPOLIS",1,1,2,236,0,240,"2018"
"48266","352610 JUQUIA",2,0,1,281,2,286,"2018"
"48267","352620 JUQUITIBA",1,1,6,465,4,477,"2018"
"48268","352630 LAGOINHA",0,0,1,36,0,37,"2018"
"48269","352640 LARANJAL PAULISTA",3,3,8,403,0,417,"2018"
"48270","352650 LAVINIA",0,0,0,43,0,43,"2018"
"48271","352660 LAVRINHAS",0,0,0,98,1,99,"2018"
"48272","352670 LEME",1,3,8,1183,2,1197,"2018"
"48273","352680 LENCOIS PAULISTA",3,7,28,797,1,836,"2018"
"48274","352690 LIMEIRA",11,15,40,3830,9,3905,"2018"
"48275","352700 LINDOIA",0,0,0,75,0,75,"2018"
"48276","352710 LINS",1,2,5,1008,0,1016,"2018"
"48277","352720 LORENA",0,4,16,1197,25,1242,"2018"
"48278","352725 LOURDES",0,0,1,19,0,20,"2018"
"48279","352730 LOUVEIRA",3,3,17,768,1,792,"2018"
"48280","352740 LUCELIA",0,0,2,190,0,192,"2018"
"48281","352750 LUCIANOPOLIS",0,0,0,26,0,26,"2018"
"48282","352760 LUIS ANTONIO",0,0,2,162,2,166,"2018"
"48283","352770 LUIZIANIA",0,1,0,66,0,67,"2018"
"48284","352780 LUPERCIO",0,0,1,52,1,54,"2018"
"48285","352790 LUTECIA",0,0,0,35,0,35,"2018"
"48286","352800 MACATUBA",0,0,2,188,0,190,"2018"
"48287","352810 MACAUBAL",0,0,0,81,0,81,"2018"
"48288","352820 MACEDONIA",0,0,0,38,0,38,"2018"
"48289","352830 MAGDA",0,0,1,28,0,29,"2018"
"48290","352840 MAIRINQUE",4,1,12,633,1,651,"2018"
"48291","352850 MAIRIPORA",5,5,9,1104,1,1124,"2018"
"48292","352860 MANDURI",0,1,1,93,0,95,"2018"
"48293","352870 MARABA PAULISTA",0,0,0,34,0,34,"2018"
"48294","352880 MARACAI",1,0,1,169,0,171,"2018"
"48295","352885 MARAPOAMA",0,0,0,42,0,42,"2018"
"48296","352890 MARIAPOLIS",0,0,1,35,0,36,"2018"
"48297","352900 MARILIA",8,11,53,3030,12,3114,"2018"
"48298","352910 MARINOPOLIS",0,0,0,15,0,15,"2018"
"48299","352920 MARTINOPOLIS",0,1,3,301,0,305,"2018"
"48300","352930 MATAO",0,3,9,945,2,959,"2018"
"48301","352940 MAUA",10,16,65,5384,26,5501,"2018"
"48302","352950 MENDONCA",0,0,2,69,0,71,"2018"
"48303","352960 MERIDIANO",0,0,0,30,0,30,"2018"
"48304","352965 MESOPOLIS",0,0,0,25,0,25,"2018"
"48305","352970 MIGUELOPOLIS",2,1,1,265,0,269,"2018"
"48306","352980 MINEIROS DO TIETE",0,0,1,156,1,158,"2018"
"48307","352990 MIRACATU",0,1,2,292,1,296,"2018"
"48308","353000 MIRA ESTRELA",0,0,0,38,0,38,"2018"
"48309","353010 MIRANDOPOLIS",0,1,4,274,0,279,"2018"
"48310","353020 MIRANTE DO PARANAPANEMA",0,0,3,179,1,183,"2018"
"48311","353030 MIRASSOL",0,0,3,772,1,776,"2018"
"48312","353040 MIRASSOLANDIA",0,0,2,59,0,61,"2018"
"48313","353050 MOCOCA",1,2,12,784,0,799,"2018"
"48314","353060 MOGI DAS CRUZES",8,15,66,6404,31,6524,"2018"
"48315","353070 MOGI GUACU",3,11,34,1924,7,1979,"2018"
"48316","353080 MOGI MIRIM",0,3,4,1034,5,1046,"2018"
"48317","353090 MOMBUCA",0,0,0,46,13,59,"2018"
"48318","353100 MONCOES",0,0,0,32,0,32,"2018"
"48319","353110 MONGAGUA",3,6,17,754,3,783,"2018"
"48320","353120 MONTE ALEGRE DO SUL",0,0,0,59,0,59,"2018"
"48321","353130 MONTE ALTO",2,2,0,519,0,523,"2018"
"48322","353140 MONTE APRAZIVEL",1,0,2,251,0,254,"2018"
"48323","353150 MONTE AZUL PAULISTA",1,1,0,216,0,218,"2018"
"48324","353160 MONTE CASTELO",0,1,0,47,0,48,"2018"
"48325","353170 MONTEIRO LOBATO",0,0,0,32,2,34,"2018"
"48326","353180 MONTE MOR",2,0,9,848,1,860,"2018"
"48327","353190 MORRO AGUDO",4,2,2,385,1,394,"2018"
"48328","353200 MORUNGABA",1,0,1,181,0,183,"2018"
"48329","353205 MOTUCA",0,0,0,53,0,53,"2018"
"48330","353210 MURUTINGA DO SUL",0,0,0,33,0,33,"2018"
"48331","353215 NANTES",0,0,0,36,0,36,"2018"
"48332","353220 NARANDIBA",1,0,0,65,0,66,"2018"
"48333","353230 NATIVIDADE DA SERRA",0,0,2,63,0,65,"2018"
"48334","353240 NAZARE PAULISTA",1,0,5,233,0,239,"2018"
"48335","353250 NEVES PAULISTA",0,1,0,108,0,109,"2018"
"48336","353260 NHANDEARA",1,1,1,105,0,108,"2018"
"48337","353270 NIPOA",0,0,1,81,0,82,"2018"
"48338","353280 NOVA ALIANCA",0,0,0,88,0,88,"2018"
"48339","353282 NOVA CAMPINA",0,1,2,115,0,118,"2018"
"48340","353284 NOVA CANAA PAULISTA",0,0,0,17,0,17,"2018"
"48341","353286 NOVA CASTILHO",0,0,0,17,0,17,"2018"
"48342","353290 NOVA EUROPA",0,1,4,138,0,143,"2018"
"48343","353300 NOVA GRANADA",2,0,3,260,0,265,"2018"
"48344","353310 NOVA GUATAPORANGA",0,0,2,31,0,33,"2018"
"48345","353320 NOVA INDEPENDENCIA",0,0,0,59,0,59,"2018"
"48346","353325 NOVAIS",0,0,0,49,0,49,"2018"
"48347","353330 NOVA LUZITANIA",0,0,0,35,0,35,"2018"
"48348","353340 NOVA ODESSA",2,3,10,683,4,702,"2018"
"48349","353350 NOVO HORIZONTE",1,1,2,482,0,486,"2018"
"48350","353360 NUPORANGA",0,0,0,82,0,82,"2018"
"48351","353370 OCAUCU",0,0,0,63,0,63,"2018"
"48352","353380 OLEO",0,2,0,28,0,30,"2018"
"48353","353390 OLIMPIA",2,1,13,681,1,698,"2018"
"48354","353400 ONDA VERDE",0,0,0,68,0,68,"2018"
"48355","353410 ORIENTE",0,0,2,70,0,72,"2018"
"48356","353420 ORINDIUVA",0,0,1,80,0,81,"2018"
"48357","353430 ORLANDIA",1,1,2,454,0,458,"2018"
"48358","353440 OSASCO",21,34,125,9756,39,9975,"2018"
"48359","353450 OSCAR BRESSANE",0,0,0,34,0,34,"2018"
"48360","353460 OSVALDO CRUZ",1,0,3,320,0,324,"2018"
"48361","353470 OURINHOS",3,6,16,1264,9,1298,"2018"
"48362","353475 OUROESTE",1,0,1,129,0,131,"2018"
"48363","353480 OURO VERDE",1,1,0,98,0,100,"2018"
"48364","353490 PACAEMBU",1,0,0,102,0,103,"2018"
"48365","353500 PALESTINA",0,0,0,127,0,127,"2018"
"48366","353510 PALMARES PAULISTA",0,0,1,139,0,140,"2018"
"48367","353520 PALMEIRA D'OESTE",0,0,1,93,0,94,"2018"
"48368","353530 PALMITAL",1,0,0,263,0,264,"2018"
"48369","353540 PANORAMA",1,1,2,197,0,201,"2018"
"48370","353550 PARAGUACU PAULISTA",2,0,7,603,0,612,"2018"
"48371","353560 PARAIBUNA",1,0,2,211,2,216,"2018"
"48372","353570 PARAISO",0,0,0,63,0,63,"2018"
"48373","353580 PARANAPANEMA",0,1,2,241,0,244,"2018"
"48374","353590 PARANAPUA",0,0,2,42,0,44,"2018"
"48375","353600 PARAPUA",0,0,0,101,0,101,"2018"
"48376","353610 PARDINHO",0,0,1,78,1,80,"2018"
"48377","353620 PARIQUERA-ACU",1,2,2,290,0,295,"2018"
"48378","353625 PARISI",0,0,0,36,0,36,"2018"
"48379","353630 PATROCINIO PAULISTA",0,0,5,200,0,205,"2018"
"48380","353640 PAULICEIA",0,1,3,94,0,98,"2018"
"48381","353650 PAULINIA",4,3,15,1515,6,1543,"2018"
"48382","353657 PAULISTANIA",0,0,0,27,0,27,"2018"
"48383","353660 PAULO DE FARIA",0,0,0,88,0,88,"2018"
"48384","353670 PEDERNEIRAS",0,3,3,569,4,579,"2018"
"48385","353680 PEDRA BELA",0,0,0,78,0,78,"2018"
"48386","353690 PEDRANOPOLIS",0,0,1,30,0,31,"2018"
"48387","353700 PEDREGULHO",0,1,4,185,1,191,"2018"
"48388","353710 PEDREIRA",2,1,6,464,4,477,"2018"
"48389","353715 PEDRINHAS PAULISTA",0,0,1,32,0,33,"2018"
"48390","353720 PEDRO DE TOLEDO",2,0,4,131,0,137,"2018"
"48391","353730 PENAPOLIS",2,3,9,744,0,758,"2018"
"48392","353740 PEREIRA BARRETO",1,2,8,285,1,297,"2018"
"48393","353750 PEREIRAS",1,1,3,108,0,113,"2018"
"48394","353760 PERUIBE",4,11,21,906,4,946,"2018"
"48395","353770 PIACATU",1,0,0,65,0,66,"2018"
"48396","353780 PIEDADE",2,2,9,689,2,704,"2018"
"48397","353790 PILAR DO SUL",1,5,7,372,0,385,"2018"
"48398","353800 PINDAMONHANGABA",5,11,35,2282,3,2336,"2018"
"48399","353810 PINDORAMA",1,0,3,133,0,137,"2018"
"48400","353820 PINHALZINHO",0,3,2,149,0,154,"2018"
"48401","353830 PIQUEROBI",0,0,0,29,1,30,"2018"
"48402","353850 PIQUETE",0,0,3,131,5,139,"2018"
"48403","353860 PIRACAIA",0,0,4,343,2,349,"2018"
"48404","353870 PIRACICABA",13,17,57,4965,15,5067,"2018"
"48405","353880 PIRAJU",0,1,2,343,0,346,"2018"
"48406","353890 PIRAJUI",1,1,5,203,0,210,"2018"
"48407","353900 PIRANGI",0,0,1,127,0,128,"2018"
"48408","353910 PIRAPORA DO BOM JESUS",0,0,6,265,2,273,"2018"
"48409","353920 PIRAPOZINHO",1,0,3,306,0,310,"2018"
"48410","353930 PIRASSUNUNGA",2,4,5,877,0,888,"2018"
"48411","353940 PIRATININGA",1,0,0,171,1,173,"2018"
"48412","353950 PITANGUEIRAS",0,1,5,498,0,504,"2018"
"48413","353960 PLANALTO",0,1,0,75,0,76,"2018"
"48414","353970 PLATINA",0,0,0,46,0,46,"2018"
"48415","353980 POA",1,2,23,1557,5,1588,"2018"
"48416","353990 POLONI",0,1,0,73,1,75,"2018"
"48417","354000 POMPEIA",0,0,1,231,1,233,"2018"
"48418","354010 PONGAI",0,0,0,37,0,37,"2018"
"48419","354020 PONTAL",3,0,1,571,0,575,"2018"
"48420","354025 PONTALINDA",0,0,2,57,0,59,"2018"
"48421","354030 PONTES GESTAL",0,0,1,24,0,25,"2018"
"48422","354040 POPULINA",0,0,0,48,0,48,"2018"
"48423","354050 PORANGABA",0,0,6,85,1,92,"2018"
"48424","354060 PORTO FELIZ",0,2,7,689,0,698,"2018"
"48425","354070 PORTO FERREIRA",1,0,3,602,0,606,"2018"
"48426","354075 POTIM",0,1,4,228,12,245,"2018"
"48427","354080 POTIRENDABA",0,0,1,193,0,194,"2018"
"48428","354085 PRACINHA",0,0,0,10,0,10,"2018"
"48429","354090 PRADOPOLIS",0,0,4,210,0,214,"2018"
"48430","354100 PRAIA GRANDE",4,22,76,4399,10,4511,"2018"
"48431","354105 PRATANIA",0,0,2,68,0,70,"2018"
"48432","354110 PRESIDENTE ALVES",0,0,1,48,1,50,"2018"
"48433","354120 PRESIDENTE BERNARDES",2,0,2,132,0,136,"2018"
"48434","354130 PRESIDENTE EPITACIO",2,3,4,495,0,504,"2018"
"48435","354140 PRESIDENTE PRUDENTE",8,7,28,2941,4,2988,"2018"
"48436","354150 PRESIDENTE VENCESLAU",0,1,2,401,0,404,"2018"
"48437","354160 PROMISSAO",0,0,0,435,0,435,"2018"
"48438","354165 QUADRA",0,0,1,42,0,43,"2018"
"48439","354170 QUATA",1,0,0,159,0,160,"2018"
"48440","354180 QUEIROZ",0,0,0,58,0,58,"2018"
"48441","354190 QUELUZ",1,0,0,124,0,125,"2018"
"48442","354200 QUINTANA",0,1,1,92,1,95,"2018"
"48443","354210 RAFARD",0,0,0,97,13,110,"2018"
"48444","354220 RANCHARIA",0,0,6,395,1,402,"2018"
"48445","354230 REDENCAO DA SERRA",0,0,3,42,2,47,"2018"
"48446","354240 REGENTE FEIJO",0,2,3,225,0,230,"2018"
"48447","354250 REGINOPOLIS",0,0,0,43,0,43,"2018"
"48448","354260 REGISTRO",7,2,3,844,1,857,"2018"
"48449","354270 RESTINGA",0,0,3,102,0,105,"2018"
"48450","354280 RIBEIRA",0,0,1,32,0,33,"2018"
"48451","354290 RIBEIRAO BONITO",1,1,3,153,1,159,"2018"
"48452","354300 RIBEIRAO BRANCO",2,5,11,300,2,320,"2018"
"48453","354310 RIBEIRAO CORRENTE",0,0,2,60,0,62,"2018"
"48454","354320 RIBEIRAO DO SUL",0,0,1,41,0,42,"2018"
"48455","354323 RIBEIRAO DOS INDIOS",0,0,0,21,0,21,"2018"
"48456","354325 RIBEIRAO GRANDE",0,0,2,88,0,90,"2018"
"48457","354330 RIBEIRAO PIRES",1,2,23,1344,4,1374,"2018"
"48458","354340 RIBEIRAO PRETO",23,36,138,8160,47,8404,"2018"
"48459","354350 RIVERSUL",0,1,1,62,0,64,"2018"
"48460","354360 RIFAINA",1,0,1,36,1,39,"2018"
"48461","354370 RINCAO",1,0,1,119,0,121,"2018"
"48462","354380 RINOPOLIS",0,0,2,97,1,100,"2018"
"48463","354390 RIO CLARO",7,5,26,2448,6,2492,"2018"
"48464","354400 RIO DAS PEDRAS",0,2,7,430,0,439,"2018"
"48465","354410 RIO GRANDE DA SERRA",3,1,5,531,7,547,"2018"
"48466","354420 RIOLANDIA",0,0,1,122,0,123,"2018"
"48467","354425 ROSANA",1,1,9,207,0,218,"2018"
"48468","354430 ROSEIRA",0,0,1,134,0,135,"2018"
"48469","354440 RUBIACEA",0,0,0,42,0,42,"2018"
"48470","354450 RUBINEIA",0,0,0,53,0,53,"2018"
"48471","354460 SABINO",0,0,0,64,0,64,"2018"
"48472","354470 SAGRES",0,0,0,33,0,33,"2018"
"48473","354480 SALES",0,0,1,62,2,65,"2018"
"48474","354490 SALES OLIVEIRA",0,1,2,127,1,131,"2018"
"48475","354500 SALESOPOLIS",0,2,0,209,7,218,"2018"
"48476","354510 SALMOURAO",0,0,1,68,0,69,"2018"
"48477","354515 SALTINHO",0,0,0,91,0,91,"2018"
"48478","354520 SALTO",2,5,21,1677,7,1712,"2018"
"48479","354530 SALTO DE PIRAPORA",3,5,12,519,1,540,"2018"
"48480","354540 SALTO GRANDE",0,1,0,115,0,116,"2018"
"48481","354550 SANDOVALINA",0,1,0,43,0,44,"2018"
"48482","354560 SANTA ADELIA",0,0,1,145,0,146,"2018"
"48483","354570 SANTA ALBERTINA",0,0,2,61,0,63,"2018"
"48484","354580 SANTA BARBARA D'OESTE",8,13,28,2344,4,2397,"2018"
"48485","354600 SANTA BRANCA",1,0,3,152,0,156,"2018"
"48486","354610 SANTA CLARA D'OESTE",0,1,1,32,0,34,"2018"
"48487","354620 SANTA CRUZ DA CONCEICAO",0,0,1,36,0,37,"2018"
"48488","354625 SANTA CRUZ DA ESPERANCA",0,0,0,32,0,32,"2018"
"48489","354630 SANTA CRUZ DAS PALMEIRAS",0,1,3,377,1,382,"2018"
"48490","354640 SANTA CRUZ DO RIO PARDO",1,4,8,583,1,597,"2018"
"48491","354650 SANTA ERNESTINA",0,0,0,77,0,77,"2018"
"48492","354660 SANTA FE DO SUL",1,3,2,396,0,402,"2018"
"48493","354670 SANTA GERTRUDES",0,3,2,321,0,326,"2018"
"48494","354680 SANTA ISABEL",0,3,11,681,0,695,"2018"
"48495","354690 SANTA LUCIA",0,0,3,95,2,100,"2018"
"48496","354700 SANTA MARIA DA SERRA",1,0,0,86,1,88,"2018"
"48497","354710 SANTA MERCEDES",0,0,1,23,0,24,"2018"
"48498","354720 SANTANA DA PONTE PENSA",0,0,1,11,0,12,"2018"
"48499","354730 SANTANA DE PARNAIBA",5,3,25,2276,4,2313,"2018"
"48500","354740 SANTA RITA D'OESTE",0,0,0,29,0,29,"2018"
"48501","354750 SANTA RITA DO PASSA QUATRO",1,0,3,245,0,249,"2018"
"48502","354760 SANTA ROSA DE VITERBO",0,2,2,280,0,284,"2018"
"48503","354765 SANTA SALETE",0,0,0,16,0,16,"2018"
"48504","354770 SANTO ANASTACIO",0,0,2,206,0,208,"2018"
"48505","354780 SANTO ANDRE",30,38,119,8781,27,8995,"2018"
"48506","354790 SANTO ANTONIO DA ALEGRIA",0,0,0,75,0,75,"2018"
"48507","354800 SANTO ANTONIO DE POSSE",0,0,3,281,0,284,"2018"
"48508","354805 SANTO ANTONIO DO ARACANGUA",0,0,0,101,0,101,"2018"
"48509","354810 SANTO ANTONIO DO JARDIM",0,1,1,67,0,69,"2018"
"48510","354820 SANTO ANTONIO DO PINHAL",0,1,1,87,0,89,"2018"
"48511","354830 SANTO EXPEDITO",0,0,0,35,0,35,"2018"
"48512","354840 SANTOPOLIS DO AGUAPEI",0,0,2,54,0,56,"2018"
"48513","354850 SANTOS",5,23,79,4451,11,4569,"2018"
"48514","354860 SAO BENTO DO SAPUCAI",0,3,3,121,1,128,"2018"
"48515","354870 SAO BERNARDO DO CAMPO",21,38,126,10512,26,10723,"2018"
"48516","354880 SAO CAETANO DO SUL",1,4,13,1700,5,1723,"2018"
"48517","354890 SAO CARLOS",6,10,41,3181,9,3247,"2018"
"48518","354900 SAO FRANCISCO",0,0,0,25,1,26,"2018"
"48519","354910 SAO JOAO DA BOA VISTA",0,3,7,1085,1,1096,"2018"
"48520","354920 SAO JOAO DAS DUAS PONTES",0,0,0,28,0,28,"2018"
"48521","354925 SAO JOAO DE IRACEMA",0,0,0,25,0,25,"2018"
"48522","354930 SAO JOAO DO PAU D'ALHO",0,0,0,17,0,17,"2018"
"48523","354940 SAO JOAQUIM DA BARRA",3,2,17,556,0,578,"2018"
"48524","354950 SAO JOSE DA BELA VISTA",1,1,1,91,0,94,"2018"
"48525","354960 SAO JOSE DO BARREIRO",0,0,1,41,0,42,"2018"
"48526","354970 SAO JOSE DO RIO PARDO",2,2,6,662,2,674,"2018"
"48527","354980 SAO JOSE DO RIO PRETO",2,12,41,5566,6,5627,"2018"
"48528","354990 SAO JOSE DOS CAMPOS",16,22,86,9532,30,9686,"2018"
"48529","354995 SAO LOURENCO DA SERRA",0,1,6,187,1,195,"2018"
"48530","355000 SAO LUIS DO PARAITINGA",0,2,5,99,2,108,"2018"
"48531","355010 SAO MANUEL",2,1,9,454,2,468,"2018"
"48532","355020 SAO MIGUEL ARCANJO",3,0,6,398,0,407,"2018"
"48533","355030 SAO PAULO",394,618,2209,161548,586,165355,"2018"
"48534","355040 SAO PEDRO",2,0,4,412,0,418,"2018"
"48535","355050 SAO PEDRO DO TURVO",0,1,1,109,1,112,"2018"
"48536","355060 SAO ROQUE",3,10,15,1045,7,1080,"2018"
"48537","355070 SAO SEBASTIAO",3,2,26,1262,2,1295,"2018"
"48538","355080 SAO SEBASTIAO DA GRAMA",0,0,1,106,2,109,"2018"
"48539","355090 SAO SIMAO",0,1,0,142,0,143,"2018"
"48540","355100 SAO VICENTE",10,31,136,4366,26,4569,"2018"
"48541","355110 SARAPUI",0,1,2,99,0,102,"2018"
"48542","355120 SARUTAIA",0,0,1,38,0,39,"2018"
"48543","355130 SEBASTIANOPOLIS DO SUL",0,0,0,46,0,46,"2018"
"48544","355140 SERRA AZUL",0,0,5,106,2,113,"2018"
"48545","355150 SERRANA",1,3,8,605,2,619,"2018"
"48546","355160 SERRA NEGRA",1,3,2,338,0,344,"2018"
"48547","355170 SERTAOZINHO",3,4,11,1559,3,1580,"2018"
"48548","355180 SETE BARRAS",0,3,6,209,1,219,"2018"
"48549","355190 SEVERINIA",2,0,3,199,0,204,"2018"
"48550","355200 SILVEIRAS",0,0,1,71,0,72,"2018"
"48551","355210 SOCORRO",2,1,3,383,0,389,"2018"
"48552","355220 SOROCABA",19,33,188,9159,19,9418,"2018"
"48553","355230 SUD MENNUCCI",0,0,3,115,0,118,"2018"
"48554","355240 SUMARE",7,20,51,3783,19,3880,"2018"
"48555","355250 SUZANO",9,25,82,4350,23,4489,"2018"
"48556","355255 SUZANAPOLIS",0,1,1,40,0,42,"2018"
"48557","355260 TABAPUA",0,2,0,106,0,108,"2018"
"48558","355270 TABATINGA",1,0,1,194,0,196,"2018"
"48559","355280 TABOAO DA SERRA",6,15,44,4256,9,4330,"2018"
"48560","355290 TACIBA",0,0,1,78,0,79,"2018"
"48561","355300 TAGUAI",0,1,8,182,0,191,"2018"
"48562","355310 TAIACU",0,0,1,66,0,67,"2018"
"48563","355320 TAIUVA",0,1,0,67,0,68,"2018"
"48564","355330 TAMBAU",1,1,1,269,0,272,"2018"
"48565","355340 TANABI",0,0,1,250,0,251,"2018"
"48566","355350 TAPIRAI",1,0,2,114,2,119,"2018"
"48567","355360 TAPIRATIBA",1,0,2,124,0,127,"2018"
"48568","355365 TAQUARAL",0,0,0,29,0,29,"2018"
"48569","355370 TAQUARITINGA",2,1,6,603,2,614,"2018"
"48570","355380 TAQUARITUBA",1,3,6,320,0,330,"2018"
"48571","355385 TAQUARIVAI",0,5,5,112,0,122,"2018"
"48572","355390 TARABAI",0,2,0,93,0,95,"2018"
"48573","355395 TARUMA",1,0,1,208,1,211,"2018"
"48574","355400 TATUI",4,3,19,1713,2,1741,"2018"
"48575","355410 TAUBATE",8,16,72,3797,16,3909,"2018"
"48576","355420 TEJUPA",0,1,1,66,0,68,"2018"
"48577","355430 TEODORO SAMPAIO",0,1,3,328,1,333,"2018"
"48578","355440 TERRA ROXA",0,0,1,48,50,99,"2018"
"48579","355450 TIETE",0,1,6,503,2,512,"2018"
"48580","355460 TIMBURI",0,1,0,20,0,21,"2018"
"48581","355465 TORRE DE PEDRA",0,0,1,26,0,27,"2018"
"48582","355470 TORRINHA",0,0,1,114,0,115,"2018"
"48583","355475 TRABIJU",0,0,0,14,0,14,"2018"
"48584","355480 TREMEMBE",0,0,12,502,3,517,"2018"
"48585","355490 TRES FRONTEIRAS",1,0,1,65,0,67,"2018"
"48586","355495 TUIUTI",0,0,0,66,0,66,"2018"
"48587","355500 TUPA",0,3,10,765,2,780,"2018"
"48588","355510 TUPI PAULISTA",0,1,1,116,0,118,"2018"
"48589","355520 TURIUBA",0,0,0,12,0,12,"2018"
"48590","355530 TURMALINA",0,0,0,14,0,14,"2018"
"48591","355535 UBARANA",0,0,0,77,0,77,"2018"
"48592","355540 UBATUBA",6,4,31,1349,2,1392,"2018"
"48593","355550 UBIRAJARA",0,1,2,89,2,94,"2018"
"48594","355560 UCHOA",0,0,0,95,0,95,"2018"
"48595","355570 UNIAO PAULISTA",0,0,0,34,0,34,"2018"
"48596","355580 URANIA",0,0,0,89,0,89,"2018"
"48597","355590 URU",0,0,0,21,0,21,"2018"
"48598","355600 URUPES",0,1,1,134,0,136,"2018"
"48599","355610 VALENTIM GENTIL",2,0,0,175,0,177,"2018"
"48600","355620 VALINHOS",2,7,15,1407,1,1432,"2018"
"48601","355630 VALPARAISO",1,2,2,312,2,319,"2018"
"48602","355635 VARGEM",0,0,0,120,0,120,"2018"
"48603","355640 VARGEM GRANDE DO SUL",0,1,4,561,0,566,"2018"
"48604","355645 VARGEM GRANDE PAULISTA",1,3,5,749,2,760,"2018"
"48605","355650 VARZEA PAULISTA",2,5,22,1397,1,1427,"2018"
"48606","355660 VERA CRUZ",0,0,2,124,0,126,"2018"
"48607","355670 VINHEDO",2,1,9,915,1,928,"2018"
"48608","355680 VIRADOURO",0,2,2,230,0,234,"2018"
"48609","355690 VISTA ALEGRE DO ALTO",0,0,0,95,0,95,"2018"
"48610","355695 VITORIA BRASIL",0,0,1,14,0,15,"2018"
"48611","355700 VOTORANTIM",5,6,23,1645,4,1683,"2018"
"48612","355710 VOTUPORANGA",2,4,14,1109,1,1130,"2018"
"48613","355715 ZACARIAS",0,0,0,25,0,25,"2018"
"48614","355720 CHAVANTES",0,1,0,181,0,182,"2018"
"48615","355730 ESTIVA GERBI",1,0,1,133,2,137,"2018"
"48616","410010 ABATIA",2,0,2,94,0,98,"2018"
"48617","410020 ADRIANOPOLIS",0,0,0,70,1,71,"2018"
"48618","410030 AGUDOS DO SUL",1,2,3,141,4,151,"2018"
"48619","410040 ALMIRANTE TAMANDARE",5,5,29,1676,9,1724,"2018"
"48620","410045 ALTAMIRA DO PARANA",0,0,0,42,0,42,"2018"
"48621","410050 ALTONIA",0,1,3,280,1,285,"2018"
"48622","410060 ALTO PARANA",2,2,1,209,0,214,"2018"
"48623","410070 ALTO PIQUIRI",1,4,3,137,0,145,"2018"
"48624","410080 ALVORADA DO SUL",0,1,2,107,0,110,"2018"
"48625","410090 AMAPORA",0,0,0,60,0,60,"2018"
"48626","410100 AMPERE",0,0,4,286,0,290,"2018"
"48627","410105 ANAHY",0,1,1,31,0,33,"2018"
"48628","410110 ANDIRA",0,2,2,231,0,235,"2018"
"48629","410115 ANGULO",0,0,0,39,0,39,"2018"
"48630","410120 ANTONINA",1,3,2,239,0,245,"2018"
"48631","410130 ANTONIO OLINTO",0,0,0,62,0,62,"2018"
"48632","410140 APUCARANA",2,6,39,1659,4,1710,"2018"
"48633","410150 ARAPONGAS",6,4,24,1559,0,1593,"2018"
"48634","410160 ARAPOTI",0,5,5,370,2,382,"2018"
"48635","410165 ARAPUA",0,0,0,43,0,43,"2018"
"48636","410170 ARARUNA",0,1,2,185,0,188,"2018"
"48637","410180 ARAUCARIA",4,12,34,2152,5,2207,"2018"
"48638","410185 ARIRANHA DO IVAI",0,0,0,33,0,33,"2018"
"48639","410190 ASSAI",0,0,4,193,0,197,"2018"
"48640","410200 ASSIS CHATEAUBRIAND",0,2,3,457,0,462,"2018"
"48641","410210 ASTORGA",0,2,3,349,0,354,"2018"
"48642","410220 ATALAIA",1,0,0,46,0,47,"2018"
"48643","410230 BALSA NOVA",1,1,6,195,3,206,"2018"
"48644","410240 BANDEIRANTES",1,1,4,444,0,450,"2018"
"48645","410250 BARBOSA FERRAZ",0,0,2,111,1,114,"2018"
"48646","410260 BARRACAO",2,0,1,162,0,165,"2018"
"48647","410270 BARRA DO JACARE",0,0,0,30,0,30,"2018"
"48648","410275 BELA VISTA DA CAROBA",1,1,1,31,0,34,"2018"
"48649","410280 BELA VISTA DO PARAISO",0,1,4,226,0,231,"2018"
"48650","410290 BITURUNA",1,0,3,284,0,288,"2018"
"48651","410300 BOA ESPERANCA",0,0,1,53,0,54,"2018"
"48652","410302 BOA ESPERANCA DO IGUACU",0,0,2,34,0,36,"2018"
"48653","410304 BOA VENTURA DE SAO ROQUE",0,0,1,87,0,88,"2018"
"48654","410305 BOA VISTA DA APARECIDA",0,0,3,105,0,108,"2018"
"48655","410310 BOCAIUVA DO SUL",0,2,5,186,2,195,"2018"
"48656","410315 BOM JESUS DO SUL",0,0,0,51,0,51,"2018"
"48657","410320 BOM SUCESSO",0,0,3,99,0,102,"2018"
"48658","410322 BOM SUCESSO DO SUL",0,0,0,38,1,39,"2018"
"48659","410330 BORRAZOPOLIS",0,0,0,76,0,76,"2018"
"48660","410335 BRAGANEY",0,0,2,60,0,62,"2018"
"48661","410337 BRASILANDIA DO SUL",0,0,0,52,0,52,"2018"
"48662","410340 CAFEARA",0,0,0,31,0,31,"2018"
"48663","410345 CAFELANDIA",0,0,7,276,0,283,"2018"
"48664","410347 CAFEZAL DO SUL",0,0,0,57,0,57,"2018"
"48665","410350 CALIFORNIA",0,2,0,118,0,120,"2018"
"48666","410360 CAMBARA",0,0,2,299,0,301,"2018"
"48667","410370 CAMBE",5,5,20,1268,0,1298,"2018"
"48668","410380 CAMBIRA",0,1,1,109,0,111,"2018"
"48669","410390 CAMPINA DA LAGOA",1,0,2,226,1,230,"2018"
"48670","410395 CAMPINA DO SIMAO",0,0,0,60,0,60,"2018"
"48671","410400 CAMPINA GRANDE DO SUL",1,3,18,745,1,768,"2018"
"48672","410405 CAMPO BONITO",0,0,0,47,0,47,"2018"
"48673","410410 CAMPO DO TENENTE",0,1,2,116,1,120,"2018"
"48674","410420 CAMPO LARGO",7,13,41,1647,7,1715,"2018"
"48675","410425 CAMPO MAGRO",1,1,3,385,3,393,"2018"
"48676","410430 CAMPO MOURAO",6,3,23,1395,2,1429,"2018"
"48677","410440 CANDIDO DE ABREU",1,2,5,194,0,202,"2018"
"48678","410442 CANDOI",0,0,3,245,0,248,"2018"
"48679","410445 CANTAGALO",0,1,5,192,0,198,"2018"
"48680","410450 CAPANEMA",0,0,1,276,0,277,"2018"
"48681","410460 CAPITAO LEONIDAS MARQUES",0,0,7,217,1,225,"2018"
"48682","410465 CARAMBEI",0,0,5,359,2,366,"2018"
"48683","410470 CARLOPOLIS",0,3,2,212,0,217,"2018"
"48684","410480 CASCAVEL",3,17,107,4803,4,4934,"2018"
"48685","410490 CASTRO",4,2,26,1177,6,1215,"2018"
"48686","410500 CATANDUVAS",0,0,1,127,0,128,"2018"
"48687","410510 CENTENARIO DO SUL",0,1,5,129,0,135,"2018"
"48688","410520 CERRO AZUL",0,1,6,233,5,245,"2018"
"48689","410530 CEU AZUL",0,0,4,134,0,138,"2018"
"48690","410540 CHOPINZINHO",0,1,9,260,1,271,"2018"
"48691","410550 CIANORTE",3,4,6,1079,1,1093,"2018"
"48692","410560 CIDADE GAUCHA",1,1,2,159,0,163,"2018"
"48693","410570 CLEVELANDIA",0,0,3,260,0,263,"2018"
"48694","410580 COLOMBO",9,17,32,3503,6,3567,"2018"
"48695","410590 COLORADO",0,1,6,277,1,285,"2018"
"48696","410600 CONGONHINHAS",0,0,1,128,0,129,"2018"
"48697","410610 CONSELHEIRO MAIRINCK",0,0,0,54,0,54,"2018"
"48698","410620 CONTENDA",0,3,4,243,1,251,"2018"
"48699","410630 CORBELIA",0,1,4,207,0,212,"2018"
"48700","410640 CORNELIO PROCOPIO",1,0,6,492,2,501,"2018"
"48701","410645 CORONEL DOMINGOS SOARES",0,0,2,110,0,112,"2018"
"48702","410650 CORONEL VIVIDA",2,0,2,304,0,308,"2018"
"48703","410655 CORUMBATAI DO SUL",0,1,0,61,1,63,"2018"
"48704","410657 CRUZEIRO DO IGUACU",0,0,0,46,0,46,"2018"
"48705","410660 CRUZEIRO DO OESTE",0,1,5,272,0,278,"2018"
"48706","410670 CRUZEIRO DO SUL",0,0,0,70,0,70,"2018"
"48707","410680 CRUZ MACHADO",0,1,2,216,0,219,"2018"
"48708","410685 CRUZMALTINA",0,0,0,51,0,51,"2018"
"48709","410690 CURITIBA",51,97,309,21577,78,22112,"2018"
"48710","410700 CURIUVA",1,0,4,160,0,165,"2018"
"48711","410710 DIAMANTE DO NORTE",0,1,0,50,0,51,"2018"
"48712","410712 DIAMANTE DO SUL",0,0,1,59,0,60,"2018"
"48713","410715 DIAMANTE D'OESTE",0,1,2,60,1,64,"2018"
"48714","410720 DOIS VIZINHOS",2,4,4,606,0,616,"2018"
"48715","410725 DOURADINA",0,1,0,134,2,137,"2018"
"48716","410730 DOUTOR CAMARGO",0,0,1,69,0,70,"2018"
"48717","410740 ENEAS MARQUES",0,0,0,74,0,74,"2018"
"48718","410750 ENGENHEIRO BELTRAO",0,0,1,141,0,142,"2018"
"48719","410752 ESPERANCA NOVA",0,0,0,23,0,23,"2018"
"48720","410753 ENTRE RIOS DO OESTE",0,1,1,67,1,70,"2018"
"48721","410754 ESPIGAO ALTO DO IGUACU",0,0,2,66,1,69,"2018"
"48722","410755 FAROL",0,0,0,28,0,28,"2018"
"48723","410760 FAXINAL",1,1,7,243,2,254,"2018"
"48724","410765 FAZENDA RIO GRANDE",6,14,49,1896,15,1980,"2018"
"48725","410770 FENIX",0,0,1,61,0,62,"2018"
"48726","410773 FERNANDES PINHEIRO",0,0,2,88,0,90,"2018"
"48727","410775 FIGUEIRA",0,0,0,114,0,114,"2018"
"48728","410780 FLORAI",0,0,2,49,0,51,"2018"
"48729","410785 FLOR DA SERRA DO SUL",0,2,1,76,0,79,"2018"
"48730","410790 FLORESTA",0,2,1,105,0,108,"2018"
"48731","410800 FLORESTOPOLIS",2,1,3,155,0,161,"2018"
"48732","410810 FLORIDA",0,0,0,38,0,38,"2018"
"48733","410820 FORMOSA DO OESTE",0,1,4,79,0,84,"2018"
"48734","410830 FOZ DO IGUACU",9,9,62,4318,24,4422,"2018"
"48735","410832 FRANCISCO ALVES",0,0,0,98,0,98,"2018"
"48736","410840 FRANCISCO BELTRAO",4,9,19,1292,1,1325,"2018"
"48737","410845 FOZ DO JORDAO",0,0,1,55,0,56,"2018"
"48738","410850 GENERAL CARNEIRO",0,0,1,204,0,205,"2018"
"48739","410855 GODOY MOREIRA",0,0,1,46,1,48,"2018"
"48740","410860 GOIOERE",0,2,0,369,2,373,"2018"
"48741","410865 GOIOXIM",0,2,2,113,0,117,"2018"
"48742","410870 GRANDES RIOS",0,0,1,95,0,96,"2018"
"48743","410880 GUAIRA",2,1,13,532,7,555,"2018"
"48744","410890 GUAIRACA",0,0,1,101,0,102,"2018"
"48745","410895 GUAMIRANGA",2,1,0,146,0,149,"2018"
"48746","410900 GUAPIRAMA",0,0,1,63,0,64,"2018"
"48747","410910 GUAPOREMA",0,0,0,20,0,20,"2018"
"48748","410920 GUARACI",0,0,0,48,0,48,"2018"
"48749","410930 GUARANIACU",0,0,1,202,0,203,"2018"
"48750","410940 GUARAPUAVA",8,9,28,3017,0,3062,"2018"
"48751","410950 GUARAQUECABA",1,1,1,95,1,99,"2018"
"48752","410960 GUARATUBA",2,2,9,515,3,531,"2018"
"48753","410965 HONORIO SERPA",1,0,1,62,0,64,"2018"
"48754","410970 IBAITI",4,3,1,399,0,407,"2018"
"48755","410975 IBEMA",1,1,5,125,0,132,"2018"
"48756","410980 IBIPORA",2,2,5,691,2,702,"2018"
"48757","410990 ICARAIMA",0,0,2,124,0,126,"2018"
"48758","411000 IGUARACU",0,0,0,63,0,63,"2018"
"48759","411005 IGUATU",0,0,1,17,0,18,"2018"
"48760","411007 IMBAU",0,0,2,168,0,170,"2018"
"48761","411010 IMBITUVA",2,4,4,460,0,470,"2018"
"48762","411020 INACIO MARTINS",0,2,1,125,0,128,"2018"
"48763","411030 INAJA",0,0,0,22,0,22,"2018"
"48764","411040 INDIANOPOLIS",0,0,0,53,0,53,"2018"
"48765","411050 IPIRANGA",0,1,3,187,4,195,"2018"
"48766","411060 IPORA",0,1,1,232,0,234,"2018"
"48767","411065 IRACEMA DO OESTE",0,0,0,30,0,30,"2018"
"48768","411070 IRATI",1,2,9,811,1,824,"2018"
"48769","411080 IRETAMA",1,2,2,154,1,160,"2018"
"48770","411090 ITAGUAJE",0,0,1,57,0,58,"2018"
"48771","411095 ITAIPULANDIA",2,0,1,154,0,157,"2018"
"48772","411100 ITAMBARACA",0,0,0,65,0,65,"2018"
"48773","411110 ITAMBE",0,0,0,84,0,84,"2018"
"48774","411120 ITAPEJARA D'OESTE",1,1,5,162,0,169,"2018"
"48775","411125 ITAPERUCU",1,3,9,510,4,527,"2018"
"48776","411130 ITAUNA DO SUL",0,0,0,55,0,55,"2018"
"48777","411140 IVAI",0,0,2,203,1,206,"2018"
"48778","411150 IVAIPORA",1,1,2,397,0,401,"2018"
"48779","411155 IVATE",0,0,0,90,0,90,"2018"
"48780","411160 IVATUBA",0,0,0,32,0,32,"2018"
"48781","411170 JABOTI",0,1,0,66,0,67,"2018"
"48782","411180 JACAREZINHO",0,0,4,597,0,601,"2018"
"48783","411190 JAGUAPITA",0,1,5,157,0,163,"2018"
"48784","411200 JAGUARIAIVA",0,4,12,537,0,553,"2018"
"48785","411210 JANDAIA DO SUL",1,0,2,257,0,260,"2018"
"48786","411220 JANIOPOLIS",0,1,2,69,0,72,"2018"
"48787","411230 JAPIRA",0,0,0,77,0,77,"2018"
"48788","411240 JAPURA",0,0,0,96,0,96,"2018"
"48789","411250 JARDIM ALEGRE",0,1,1,151,0,153,"2018"
"48790","411260 JARDIM OLINDA",0,0,0,31,0,31,"2018"
"48791","411270 JATAIZINHO",0,2,0,171,0,173,"2018"
"48792","411275 JESUITAS",0,0,3,94,0,97,"2018"
"48793","411280 JOAQUIM TAVORA",0,0,1,146,0,147,"2018"
"48794","411290 JUNDIAI DO SUL",0,0,1,50,0,51,"2018"
"48795","411295 JURANDA",0,0,3,99,1,103,"2018"
"48796","411300 JUSSARA",0,0,1,87,0,88,"2018"
"48797","411310 KALORE",0,0,0,51,0,51,"2018"
"48798","411320 LAPA",0,2,9,592,1,604,"2018"
"48799","411325 LARANJAL",0,0,1,70,0,71,"2018"
"48800","411330 LARANJEIRAS DO SUL",1,4,12,517,1,535,"2018"
"48801","411340 LEOPOLIS",0,0,0,34,0,34,"2018"
"48802","411342 LIDIANOPOLIS",0,0,1,51,1,53,"2018"
"48803","411345 LINDOESTE",0,0,3,72,0,75,"2018"
"48804","411350 LOANDA",2,0,1,350,2,355,"2018"
"48805","411360 LOBATO",0,0,0,55,0,55,"2018"
"48806","411370 LONDRINA",13,40,92,6841,16,7002,"2018"
"48807","411373 LUIZIANA",0,1,0,94,0,95,"2018"
"48808","411375 LUNARDELLI",0,0,1,65,1,67,"2018"
"48809","411380 LUPIONOPOLIS",0,0,0,48,0,48,"2018"
"48810","411390 MALLET",0,0,2,175,0,177,"2018"
"48811","411400 MAMBORE",0,1,4,163,1,169,"2018"
"48812","411410 MANDAGUACU",1,0,7,365,0,373,"2018"
"48813","411420 MANDAGUARI",2,1,6,487,0,496,"2018"
"48814","411430 MANDIRITUBA",1,4,2,335,1,343,"2018"
"48815","411435 MANFRINOPOLIS",0,0,1,19,0,20,"2018"
"48816","411440 MANGUEIRINHA",2,2,4,243,1,252,"2018"
"48817","411450 MANOEL RIBAS",0,0,1,176,0,177,"2018"
"48818","411460 MARECHAL CANDIDO RONDON",1,2,20,738,0,761,"2018"
"48819","411470 MARIA HELENA",1,0,0,69,0,70,"2018"
"48820","411480 MARIALVA",3,2,2,480,0,487,"2018"
"48821","411490 MARILANDIA DO SUL",0,0,3,115,1,119,"2018"
"48822","411500 MARILENA",0,0,0,85,0,85,"2018"
"48823","411510 MARILUZ",0,1,0,148,0,149,"2018"
"48824","411520 MARINGA",7,26,71,4879,2,4985,"2018"
"48825","411530 MARIOPOLIS",0,0,1,88,0,89,"2018"
"48826","411535 MARIPA",1,0,0,82,0,83,"2018"
"48827","411540 MARMELEIRO",0,0,4,190,0,194,"2018"
"48828","411545 MARQUINHO",0,0,2,63,0,65,"2018"
"48829","411550 MARUMBI",0,0,1,50,0,51,"2018"
"48830","411560 MATELANDIA",2,1,4,247,0,254,"2018"
"48831","411570 MATINHOS",1,2,3,517,1,524,"2018"
"48832","411573 MATO RICO",0,0,0,53,0,53,"2018"
"48833","411575 MAUA DA SERRA",0,0,4,161,0,165,"2018"
"48834","411580 MEDIANEIRA",1,3,19,718,0,741,"2018"
"48835","411585 MERCEDES",0,0,0,63,0,63,"2018"
"48836","411590 MIRADOR",0,0,0,30,0,30,"2018"
"48837","411600 MIRASELVA",0,0,0,24,0,24,"2018"
"48838","411605 MISSAL",0,1,2,129,0,132,"2018"
"48839","411610 MOREIRA SALES",0,0,2,145,0,147,"2018"
"48840","411620 MORRETES",0,1,4,230,0,235,"2018"
"48841","411630 MUNHOZ DE MELO",0,0,0,61,0,61,"2018"
"48842","411640 NOSSA SENHORA DAS GRACAS",0,1,0,49,0,50,"2018"
"48843","411650 NOVA ALIANCA DO IVAI",0,0,0,18,0,18,"2018"
"48844","411660 NOVA AMERICA DA COLINA",0,0,1,30,0,31,"2018"
"48845","411670 NOVA AURORA",0,0,3,161,0,164,"2018"
"48846","411680 NOVA CANTU",1,2,0,80,0,83,"2018"
"48847","411690 NOVA ESPERANCA",1,1,6,316,0,324,"2018"
"48848","411695 NOVA ESPERANCA DO SUDOESTE",0,0,1,71,1,73,"2018"
"48849","411700 NOVA FATIMA",0,2,0,80,0,82,"2018"
"48850","411705 NOVA LARANJEIRAS",0,1,6,170,0,177,"2018"
"48851","411710 NOVA LONDRINA",1,2,0,145,2,150,"2018"
"48852","411720 NOVA OLIMPIA",0,0,1,73,0,74,"2018"
"48853","411721 NOVA SANTA BARBARA",0,0,0,62,0,62,"2018"
"48854","411722 NOVA SANTA ROSA",0,0,3,117,0,120,"2018"
"48855","411725 NOVA PRATA DO IGUACU",0,0,6,141,0,147,"2018"
"48856","411727 NOVA TEBAS",0,0,0,85,0,85,"2018"
"48857","411729 NOVO ITACOLOMI",0,0,0,31,0,31,"2018"
"48858","411730 ORTIGUEIRA",0,2,8,325,2,337,"2018"
"48859","411740 OURIZONA",0,0,1,37,0,38,"2018"
"48860","411745 OURO VERDE DO OESTE",0,0,0,82,0,82,"2018"
"48861","411750 PAICANDU",5,4,6,583,0,598,"2018"
"48862","411760 PALMAS",1,2,17,854,0,874,"2018"
"48863","411770 PALMEIRA",1,3,7,459,2,472,"2018"
"48864","411780 PALMITAL",0,0,3,228,0,231,"2018"
"48865","411790 PALOTINA",0,0,6,524,0,530,"2018"
"48866","411800 PARAISO DO NORTE",0,0,0,176,0,176,"2018"
"48867","411810 PARANACITY",0,0,3,146,0,149,"2018"
"48868","411820 PARANAGUA",4,9,28,2271,15,2327,"2018"
"48869","411830 PARANAPOEMA",0,0,0,26,0,26,"2018"
"48870","411840 PARANAVAI",0,2,6,1265,0,1273,"2018"
"48871","411845 PATO BRAGADO",0,0,1,80,0,81,"2018"
"48872","411850 PATO BRANCO",2,3,16,1272,0,1293,"2018"
"48873","411860 PAULA FREITAS",0,0,1,70,0,71,"2018"
"48874","411870 PAULO FRONTIN",0,0,0,77,0,77,"2018"
"48875","411880 PEABIRU",0,0,1,151,0,152,"2018"
"48876","411885 PEROBAL",0,1,2,108,0,111,"2018"
"48877","411890 PEROLA",1,1,4,166,1,173,"2018"
"48878","411900 PEROLA D'OESTE",0,0,2,79,0,81,"2018"
"48879","411910 PIEN",0,2,5,179,1,187,"2018"
"48880","411915 PINHAIS",7,12,49,1798,6,1872,"2018"
"48881","411920 PINHALAO",1,3,0,93,0,97,"2018"
"48882","411925 PINHAL DE SAO BENTO",0,0,0,30,0,30,"2018"
"48883","411930 PINHAO",1,1,8,521,2,533,"2018"
"48884","411940 PIRAI DO SUL",3,0,9,311,2,325,"2018"
"48885","411950 PIRAQUARA",6,13,23,1517,4,1563,"2018"
"48886","411960 PITANGA",0,2,11,476,0,489,"2018"
"48887","411965 PITANGUEIRAS",0,2,1,29,0,32,"2018"
"48888","411970 PLANALTINA DO PARANA",1,0,0,60,0,61,"2018"
"48889","411980 PLANALTO",0,0,4,152,0,156,"2018"
"48890","411990 PONTA GROSSA",11,34,115,5234,21,5415,"2018"
"48891","411995 PONTAL DO PARANA",1,1,6,426,2,436,"2018"
"48892","412000 PORECATU",0,1,2,134,0,137,"2018"
"48893","412010 PORTO AMAZONAS",0,0,3,57,0,60,"2018"
"48894","412015 PORTO BARREIRO",0,0,1,32,0,33,"2018"
"48895","412020 PORTO RICO",0,0,0,30,0,30,"2018"
"48896","412030 PORTO VITORIA",0,0,0,56,0,56,"2018"
"48897","412033 PRADO FERREIRA",0,1,0,43,0,44,"2018"
"48898","412035 PRANCHITA",0,0,1,79,0,80,"2018"
"48899","412040 PRESIDENTE CASTELO BRANCO",0,1,3,77,0,81,"2018"
"48900","412050 PRIMEIRO DE MAIO",0,0,1,89,0,90,"2018"
"48901","412060 PRUDENTOPOLIS",3,4,10,582,0,599,"2018"
"48902","412065 QUARTO CENTENARIO",0,1,0,53,0,54,"2018"
"48903","412070 QUATIGUA",0,0,3,89,0,92,"2018"
"48904","412080 QUATRO BARRAS",0,0,6,297,0,303,"2018"
"48905","412085 QUATRO PONTES",0,1,3,60,0,64,"2018"
"48906","412090 QUEDAS DO IGUACU",1,1,14,477,0,493,"2018"
"48907","412100 QUERENCIA DO NORTE",0,0,1,174,0,175,"2018"
"48908","412110 QUINTA DO SOL",0,0,2,61,0,63,"2018"
"48909","412120 QUITANDINHA",0,1,3,234,1,239,"2018"
"48910","412125 RAMILANDIA",0,0,2,62,0,64,"2018"
"48911","412130 RANCHO ALEGRE",0,0,0,36,0,36,"2018"
"48912","412135 RANCHO ALEGRE D'OESTE",0,0,0,31,0,31,"2018"
"48913","412140 REALEZA",0,0,5,214,0,219,"2018"
"48914","412150 REBOUCAS",0,1,1,196,0,198,"2018"
"48915","412160 RENASCENCA",1,0,2,93,1,97,"2018"
"48916","412170 RESERVA",3,1,4,373,0,381,"2018"
"48917","412175 RESERVA DO IGUACU",0,0,0,109,0,109,"2018"
"48918","412180 RIBEIRAO CLARO",0,0,0,139,0,139,"2018"
"48919","412190 RIBEIRAO DO PINHAL",0,0,2,197,0,199,"2018"
"48920","412200 RIO AZUL",1,1,2,198,0,202,"2018"
"48921","412210 RIO BOM",0,1,2,42,0,45,"2018"
"48922","412215 RIO BONITO DO IGUACU",2,2,7,215,1,227,"2018"
"48923","412217 RIO BRANCO DO IVAI",0,0,0,69,0,69,"2018"
"48924","412220 RIO BRANCO DO SUL",2,1,11,564,6,584,"2018"
"48925","412230 RIO NEGRO",2,2,8,363,1,376,"2018"
"48926","412240 ROLANDIA",1,11,31,1028,1,1072,"2018"
"48927","412250 RONCADOR",0,0,4,136,0,140,"2018"
"48928","412260 RONDON",0,0,1,110,0,111,"2018"
"48929","412265 ROSARIO DO IVAI",0,1,1,78,0,80,"2018"
"48930","412270 SABAUDIA",0,2,1,106,0,109,"2018"
"48931","412280 SALGADO FILHO",0,1,1,49,0,51,"2018"
"48932","412290 SALTO DO ITARARE",0,1,1,64,0,66,"2018"
"48933","412300 SALTO DO LONTRA",0,0,4,184,0,188,"2018"
"48934","412310 SANTA AMELIA",2,0,1,58,0,61,"2018"
"48935","412320 SANTA CECILIA DO PAVAO",0,0,0,49,0,49,"2018"
"48936","412330 SANTA CRUZ DE MONTE CASTELO",0,0,0,120,0,120,"2018"
"48937","412340 SANTA FE",0,0,2,130,0,132,"2018"
"48938","412350 SANTA HELENA",0,3,4,379,2,388,"2018"
"48939","412360 SANTA INES",0,0,0,19,0,19,"2018"
"48940","412370 SANTA ISABEL DO IVAI",0,0,1,105,0,106,"2018"
"48941","412380 SANTA IZABEL DO OESTE",0,0,2,138,0,140,"2018"
"48942","412382 SANTA LUCIA",0,0,3,38,0,41,"2018"
"48943","412385 SANTA MARIA DO OESTE",0,2,2,134,0,138,"2018"
"48944","412390 SANTA MARIANA",0,1,2,140,0,143,"2018"
"48945","412395 SANTA MONICA",0,0,0,57,0,57,"2018"
"48946","412400 SANTANA DO ITARARE",0,0,0,59,0,59,"2018"
"48947","412402 SANTA TEREZA DO OESTE",0,0,10,193,0,203,"2018"
"48948","412405 SANTA TEREZINHA DE ITAIPU",0,1,4,289,4,298,"2018"
"48949","412410 SANTO ANTONIO DA PLATINA",2,1,6,614,0,623,"2018"
"48950","412420 SANTO ANTONIO DO CAIUA",0,0,1,32,0,33,"2018"
"48951","412430 SANTO ANTONIO DO PARAISO",0,0,0,25,0,25,"2018"
"48952","412440 SANTO ANTONIO DO SUDOESTE",0,0,2,262,1,265,"2018"
"48953","412450 SANTO INACIO",0,0,1,77,0,78,"2018"
"48954","412460 SAO CARLOS DO IVAI",0,0,0,79,0,79,"2018"
"48955","412470 SAO JERONIMO DA SERRA",1,0,0,148,0,149,"2018"
"48956","412480 SAO JOAO",0,1,2,130,0,133,"2018"
"48957","412490 SAO JOAO DO CAIUA",0,2,1,84,0,87,"2018"
"48958","412500 SAO JOAO DO IVAI",0,0,2,132,0,134,"2018"
"48959","412510 SAO JOAO DO TRIUNFO",0,1,3,170,0,174,"2018"
"48960","412520 SAO JORGE D'OESTE",0,0,0,121,1,122,"2018"
"48961","412530 SAO JORGE DO IVAI",0,0,1,61,0,62,"2018"
"48962","412535 SAO JORGE DO PATROCINIO",0,0,0,76,1,77,"2018"
"48963","412540 SAO JOSE DA BOA VISTA",0,1,1,73,0,75,"2018"
"48964","412545 SAO JOSE DAS PALMEIRAS",0,0,0,40,1,41,"2018"
"48965","412550 SAO JOSE DOS PINHAIS",11,25,77,4491,12,4616,"2018"
"48966","412555 SAO MANOEL DO PARANA",0,0,0,26,0,26,"2018"
"48967","412560 SAO MATEUS DO SUL",1,1,4,559,4,569,"2018"
"48968","412570 SAO MIGUEL DO IGUACU",3,2,8,415,3,431,"2018"
"48969","412575 SAO PEDRO DO IGUACU",0,0,0,89,0,89,"2018"
"48970","412580 SAO PEDRO DO IVAI",1,0,0,109,0,110,"2018"
"48971","412590 SAO PEDRO DO PARANA",0,0,0,30,0,30,"2018"
"48972","412600 SAO SEBASTIAO DA AMOREIRA",1,0,2,120,1,124,"2018"
"48973","412610 SAO TOME",0,0,0,68,0,68,"2018"
"48974","412620 SAPOPEMA",0,0,0,80,0,80,"2018"
"48975","412625 SARANDI",6,3,27,1590,4,1630,"2018"
"48976","412627 SAUDADE DO IGUACU",0,0,5,92,0,97,"2018"
"48977","412630 SENGES",0,0,5,208,1,214,"2018"
"48978","412635 SERRANOPOLIS DO IGUACU",0,0,1,55,0,56,"2018"
"48979","412640 SERTANEJA",0,1,1,53,0,55,"2018"
"48980","412650 SERTANOPOLIS",0,1,0,200,3,204,"2018"
"48981","412660 SIQUEIRA CAMPOS",0,0,1,292,1,294,"2018"
"48982","412665 SULINA",0,0,0,29,0,29,"2018"
"48983","412667 TAMARANA",2,2,3,180,0,187,"2018"
"48984","412670 TAMBOARA",0,0,0,59,0,59,"2018"
"48985","412680 TAPEJARA",1,0,2,207,0,210,"2018"
"48986","412690 TAPIRA",0,2,0,71,0,73,"2018"
"48987","412700 TEIXEIRA SOARES",0,0,1,171,0,172,"2018"
"48988","412710 TELEMACO BORBA",2,10,18,1123,0,1153,"2018"
"48989","412720 TERRA BOA",1,1,4,211,1,218,"2018"
"48990","412730 TERRA RICA",2,0,1,207,0,210,"2018"
"48991","412740 TERRA ROXA",0,1,7,253,2,263,"2018"
"48992","412750 TIBAGI",0,2,5,302,1,310,"2018"
"48993","412760 TIJUCAS DO SUL",0,1,5,257,0,263,"2018"
"48994","412770 TOLEDO",5,4,31,1992,2,2034,"2018"
"48995","412780 TOMAZINA",0,0,0,83,0,83,"2018"
"48996","412785 TRES BARRAS DO PARANA",0,0,1,177,2,180,"2018"
"48997","412788 TUNAS DO PARANA",0,1,1,119,5,126,"2018"
"48998","412790 TUNEIRAS DO OESTE",0,2,1,113,0,116,"2018"
"48999","412795 TUPASSI",1,1,0,89,0,91,"2018"
"49000","412796 TURVO",0,3,5,208,1,217,"2018"
"49001","412800 UBIRATA",1,0,5,289,0,295,"2018"
"49002","412810 UMUARAMA",1,10,14,1527,3,1555,"2018"
"49003","412820 UNIAO DA VITORIA",0,1,7,808,0,816,"2018"
"49004","412830 UNIFLOR",0,0,0,21,0,21,"2018"
"49005","412840 URAI",1,0,0,111,1,113,"2018"
"49006","412850 WENCESLAU BRAZ",0,3,1,269,2,275,"2018"
"49007","412853 VENTANIA",0,1,2,132,0,135,"2018"
"49008","412855 VERA CRUZ DO OESTE",1,0,3,95,0,99,"2018"
"49009","412860 VERE",1,0,1,103,0,105,"2018"
"49010","412862 ALTO PARAISO",1,0,1,50,0,52,"2018"
"49011","412863 DOUTOR ULYSSES",0,0,3,77,0,80,"2018"
"49012","412865 VIRMOND",0,0,2,57,0,59,"2018"
"49013","412870 VITORINO",0,1,0,117,1,119,"2018"
"49014","412880 XAMBRE",0,0,0,78,0,78,"2018"
"49015","420005 ABDON BATISTA",0,0,1,33,1,35,"2018"
"49016","420010 ABELARDO LUZ",2,0,6,291,0,299,"2018"
"49017","420020 AGROLANDIA",0,0,1,139,0,140,"2018"
"49018","420030 AGRONOMICA",0,0,4,72,0,76,"2018"
"49019","420040 AGUA DOCE",0,0,2,95,1,98,"2018"
"49020","420050 AGUAS DE CHAPECO",0,0,0,76,0,76,"2018"
"49021","420055 AGUAS FRIAS",1,0,0,39,0,40,"2018"
"49022","420060 AGUAS MORNAS",0,0,2,76,0,78,"2018"
"49023","420070 ALFREDO WAGNER",0,1,3,113,1,118,"2018"
"49024","420075 ALTO BELA VISTA",0,0,0,18,0,18,"2018"
"49025","420080 ANCHIETA",1,0,1,62,0,64,"2018"
"49026","420090 ANGELINA",0,0,1,58,0,59,"2018"
"49027","420100 ANITA GARIBALDI",0,0,4,113,0,117,"2018"
"49028","420110 ANITAPOLIS",0,0,1,37,0,38,"2018"
"49029","420120 ANTONIO CARLOS",1,0,0,127,1,129,"2018"
"49030","420125 APIUNA",0,0,6,132,1,139,"2018"
"49031","420127 ARABUTA",0,0,0,44,0,44,"2018"
"49032","420130 ARAQUARI",2,3,13,563,7,588,"2018"
"49033","420140 ARARANGUA",3,6,14,887,0,910,"2018"
"49034","420150 ARMAZEM",0,0,0,113,0,113,"2018"
"49035","420160 ARROIO TRINTA",0,1,0,30,0,31,"2018"
"49036","420165 ARVOREDO",0,0,0,15,0,15,"2018"
"49037","420170 ASCURRA",0,0,2,124,0,126,"2018"
"49038","420180 ATALANTA",0,0,2,30,0,32,"2018"
"49039","420190 AURORA",0,0,3,85,1,89,"2018"
"49040","420195 BALNEARIO ARROIO DO SILVA",1,0,2,152,0,155,"2018"
"49041","420200 BALNEARIO CAMBORIU",1,7,23,1600,4,1635,"2018"
"49042","420205 BALNEARIO BARRA DO SUL",0,0,3,146,0,149,"2018"
"49043","420207 BALNEARIO GAIVOTA",0,0,3,158,0,161,"2018"
"49044","420208 BANDEIRANTE",0,0,0,41,0,41,"2018"
"49045","420209 BARRA BONITA",0,0,0,10,0,10,"2018"
"49046","420210 BARRA VELHA",3,5,12,498,6,524,"2018"
"49047","420213 BELA VISTA DO TOLDO",0,0,0,87,0,87,"2018"
"49048","420215 BELMONTE",0,0,0,28,0,28,"2018"
"49049","420220 BENEDITO NOVO",0,1,0,124,0,125,"2018"
"49050","420230 BIGUACU",3,3,17,930,5,958,"2018"
"49051","420240 BLUMENAU",6,14,54,4458,0,4532,"2018"
"49052","420243 BOCAINA DO SUL",0,0,0,34,1,35,"2018"
"49053","420245 BOMBINHAS",1,2,1,293,2,299,"2018"
"49054","420250 BOM JARDIM DA SERRA",0,0,2,51,0,53,"2018"
"49055","420253 BOM JESUS",1,0,0,31,0,32,"2018"
"49056","420257 BOM JESUS DO OESTE",0,0,0,21,0,21,"2018"
"49057","420260 BOM RETIRO",0,3,8,108,1,120,"2018"
"49058","420270 BOTUVERA",0,1,2,57,0,60,"2018"
"49059","420280 BRACO DO NORTE",1,1,4,508,2,516,"2018"
"49060","420285 BRACO DO TROMBUDO",1,1,1,39,0,42,"2018"
"49061","420287 BRUNOPOLIS",0,0,0,37,0,37,"2018"
"49062","420290 BRUSQUE",7,4,22,1885,5,1923,"2018"
"49063","420300 CACADOR",6,4,4,1215,1,1230,"2018"
"49064","420310 CAIBI",0,0,1,66,1,68,"2018"
"49065","420315 CALMON",1,0,0,63,0,64,"2018"
"49066","420320 CAMBORIU",3,6,14,1410,5,1438,"2018"
"49067","420325 CAPAO ALTO",1,1,1,27,0,30,"2018"
"49068","420330 CAMPO ALEGRE",1,2,3,148,0,154,"2018"
"49069","420340 CAMPO BELO DO SUL",0,3,3,89,0,95,"2018"
"49070","420350 CAMPO ERE",0,1,1,150,0,152,"2018"
"49071","420360 CAMPOS NOVOS",0,0,3,572,3,578,"2018"
"49072","420370 CANELINHA",0,0,0,148,1,149,"2018"
"49073","420380 CANOINHAS",2,6,21,812,1,842,"2018"
"49074","420390 CAPINZAL",0,1,5,323,4,333,"2018"
"49075","420395 CAPIVARI DE BAIXO",1,3,1,305,0,310,"2018"
"49076","420400 CATANDUVAS",0,0,1,160,0,161,"2018"
"49077","420410 CAXAMBU DO SUL",0,2,1,44,0,47,"2018"
"49078","420415 CELSO RAMOS",0,0,0,29,0,29,"2018"
"49079","420417 CERRO NEGRO",0,0,3,32,0,35,"2018"
"49080","420419 CHAPADAO DO LAGEADO",0,0,2,33,0,35,"2018"
"49081","420420 CHAPECO",6,15,77,3524,4,3626,"2018"
"49082","420425 COCAL DO SUL",1,0,1,210,0,212,"2018"
"49083","420430 CONCORDIA",0,4,20,1038,1,1063,"2018"
"49084","420435 CORDILHEIRA ALTA",0,0,1,67,0,68,"2018"
"49085","420440 CORONEL FREITAS",0,0,0,119,0,119,"2018"
"49086","420445 CORONEL MARTINS",0,0,0,20,0,20,"2018"
"49087","420450 CORUPA",0,1,2,189,0,192,"2018"
"49088","420455 CORREIA PINTO",1,5,16,206,1,229,"2018"
"49089","420460 CRICIUMA",7,12,27,2787,6,2839,"2018"
"49090","420470 CUNHA PORA",0,0,0,123,0,123,"2018"
"49091","420475 CUNHATAI",0,0,0,24,0,24,"2018"
"49092","420480 CURITIBANOS",0,2,10,674,1,687,"2018"
"49093","420490 DESCANSO",0,0,1,110,0,111,"2018"
"49094","420500 DIONISIO CERQUEIRA",1,0,2,247,0,250,"2018"
"49095","420510 DONA EMMA",0,0,3,58,0,61,"2018"
"49096","420515 DOUTOR PEDRINHO",0,1,0,41,0,42,"2018"
"49097","420517 ENTRE RIOS",0,0,0,54,1,55,"2018"
"49098","420519 ERMO",0,0,0,32,0,32,"2018"
"49099","420520 ERVAL VELHO",0,0,2,54,0,56,"2018"
"49100","420530 FAXINAL DOS GUEDES",0,0,1,164,0,165,"2018"
"49101","420535 FLOR DO SERTAO",0,0,1,25,0,26,"2018"
"49102","420540 FLORIANOPOLIS",18,12,80,6217,41,6368,"2018"
"49103","420543 FORMOSA DO SUL",0,0,0,40,0,40,"2018"
"49104","420545 FORQUILHINHA",1,0,6,447,0,454,"2018"
"49105","420550 FRAIBURGO",2,0,4,532,0,538,"2018"
"49106","420555 FREI ROGERIO",0,0,0,25,0,25,"2018"
"49107","420560 GALVAO",1,0,0,47,0,48,"2018"
"49108","420570 GAROPABA",0,0,4,302,2,308,"2018"
"49109","420580 GARUVA",2,1,8,292,2,305,"2018"
"49110","420590 GASPAR",3,8,19,903,2,935,"2018"
"49111","420600 GOVERNADOR CELSO RAMOS",0,1,2,203,3,209,"2018"
"49112","420610 GRAO PARA",0,1,1,83,0,85,"2018"
"49113","420620 GRAVATAL",0,0,1,140,0,141,"2018"
"49114","420630 GUABIRUBA",1,1,3,317,0,322,"2018"
"49115","420640 GUARACIABA",0,0,0,116,0,116,"2018"
"49116","420650 GUARAMIRIM",1,3,10,583,1,598,"2018"
"49117","420660 GUARUJA DO SUL",0,0,0,59,0,59,"2018"
"49118","420665 GUATAMBU",1,1,1,104,1,108,"2018"
"49119","420670 HERVAL D'OESTE",0,0,6,329,0,335,"2018"
"49120","420675 IBIAM",0,0,0,16,0,16,"2018"
"49121","420680 IBICARE",0,1,0,50,0,51,"2018"
"49122","420690 IBIRAMA",0,0,11,279,0,290,"2018"
"49123","420700 ICARA",4,1,6,823,2,836,"2018"
"49124","420710 ILHOTA",0,0,2,181,0,183,"2018"
"49125","420720 IMARUI",0,0,4,101,0,105,"2018"
"49126","420730 IMBITUBA",1,3,12,649,0,665,"2018"
"49127","420740 IMBUIA",0,0,1,68,0,69,"2018"
"49128","420750 INDAIAL",3,0,4,893,1,901,"2018"
"49129","420757 IOMERE",0,0,0,19,0,19,"2018"
"49130","420760 IPIRA",0,0,2,58,0,60,"2018"
"49131","420765 IPORA DO OESTE",0,1,2,102,1,106,"2018"
"49132","420768 IPUACU",3,0,1,149,0,153,"2018"
"49133","420770 IPUMIRIM",0,0,0,86,0,86,"2018"
"49134","420775 IRACEMINHA",0,0,1,46,0,47,"2018"
"49135","420780 IRANI",0,0,2,131,0,133,"2018"
"49136","420785 IRATI",1,0,1,19,0,21,"2018"
"49137","420790 IRINEOPOLIS",0,2,0,135,1,138,"2018"
"49138","420800 ITA",0,0,2,53,0,55,"2018"
"49139","420810 ITAIOPOLIS",0,0,1,278,1,280,"2018"
"49140","420820 ITAJAI",15,20,66,3700,7,3808,"2018"
"49141","420830 ITAPEMA",0,4,5,878,3,890,"2018"
"49142","420840 ITAPIRANGA",0,0,5,211,2,218,"2018"
"49143","420845 ITAPOA",1,1,8,260,1,271,"2018"
"49144","420850 ITUPORANGA",1,2,13,407,0,423,"2018"
"49145","420860 JABORA",0,0,1,49,0,50,"2018"
"49146","420870 JACINTO MACHADO",1,0,4,142,0,147,"2018"
"49147","420880 JAGUARUNA",1,0,6,259,0,266,"2018"
"49148","420890 JARAGUA DO SUL",7,7,39,2297,2,2352,"2018"
"49149","420895 JARDINOPOLIS",0,0,0,17,0,17,"2018"
"49150","420900 JOACABA",0,0,3,367,0,370,"2018"
"49151","420910 JOINVILLE",12,34,174,7941,16,8177,"2018"
"49152","420915 JOSE BOITEUX",1,0,1,85,1,88,"2018"
"49153","420917 JUPIA",0,0,0,28,0,28,"2018"
"49154","420920 LACERDOPOLIS",0,1,0,21,0,22,"2018"
"49155","420930 LAGES",5,34,123,2142,16,2320,"2018"
"49156","420940 LAGUNA",0,0,3,436,1,440,"2018"
"49157","420945 LAJEADO GRANDE",0,0,0,21,0,21,"2018"
"49158","420950 LAURENTINO",1,0,1,100,0,102,"2018"
"49159","420960 LAURO MULLER",2,0,4,161,1,168,"2018"
"49160","420970 LEBON REGIS",1,1,0,177,0,179,"2018"
"49161","420980 LEOBERTO LEAL",0,0,1,31,0,32,"2018"
"49162","420985 LINDOIA DO SUL",0,0,0,44,0,44,"2018"
"49163","420990 LONTRAS",0,1,4,188,1,194,"2018"
"49164","421000 LUIZ ALVES",1,2,4,205,2,214,"2018"
"49165","421003 LUZERNA",0,0,1,58,0,59,"2018"
"49166","421005 MACIEIRA",0,0,1,19,0,20,"2018"
"49167","421010 MAFRA",1,4,5,809,1,820,"2018"
"49168","421020 MAJOR GERCINO",0,0,0,50,1,51,"2018"
"49169","421030 MAJOR VIEIRA",0,0,1,94,0,95,"2018"
"49170","421040 MARACAJA",0,0,2,104,0,106,"2018"
"49171","421050 MARAVILHA",0,2,1,400,0,403,"2018"
"49172","421055 MAREMA",0,0,0,16,0,16,"2018"
"49173","421060 MASSARANDUBA",0,0,3,225,0,228,"2018"
"49174","421070 MATOS COSTA",0,0,2,39,0,41,"2018"
"49175","421080 MELEIRO",1,1,2,87,0,91,"2018"
"49176","421085 MIRIM DOCE",0,0,0,27,0,27,"2018"
"49177","421090 MODELO",0,0,1,43,0,44,"2018"
"49178","421100 MONDAI",0,0,3,119,0,122,"2018"
"49179","421105 MONTE CARLO",0,1,3,151,0,155,"2018"
"49180","421110 MONTE CASTELO",0,0,0,129,0,129,"2018"
"49181","421120 MORRO DA FUMACA",1,0,3,228,1,233,"2018"
"49182","421125 MORRO GRANDE",1,0,0,37,1,39,"2018"
"49183","421130 NAVEGANTES",1,2,23,1418,2,1446,"2018"
"49184","421140 NOVA ERECHIM",0,0,0,46,0,46,"2018"
"49185","421145 NOVA ITABERABA",1,0,0,52,0,53,"2018"
"49186","421150 NOVA TRENTO",1,3,0,186,0,190,"2018"
"49187","421160 NOVA VENEZA",0,1,3,170,1,175,"2018"
"49188","421165 NOVO HORIZONTE",0,0,1,24,0,25,"2018"
"49189","421170 ORLEANS",0,2,4,285,0,291,"2018"
"49190","421175 OTACILIO COSTA",1,5,14,244,0,264,"2018"
"49191","421180 OURO",0,0,1,72,0,73,"2018"
"49192","421185 OURO VERDE",0,0,0,28,0,28,"2018"
"49193","421187 PAIAL",0,0,1,24,0,25,"2018"
"49194","421189 PAINEL",0,0,1,25,0,26,"2018"
"49195","421190 PALHOCA",7,8,41,2793,33,2882,"2018"
"49196","421200 PALMA SOLA",0,0,0,99,0,99,"2018"
"49197","421205 PALMEIRA",0,0,0,28,0,28,"2018"
"49198","421210 PALMITOS",1,0,2,176,0,179,"2018"
"49199","421220 PAPANDUVA",1,1,1,255,0,258,"2018"
"49200","421223 PARAISO",0,0,0,47,0,47,"2018"
"49201","421225 PASSO DE TORRES",1,4,2,81,1,89,"2018"
"49202","421227 PASSOS MAIA",0,1,1,59,1,62,"2018"
"49203","421230 PAULO LOPES",0,1,3,93,1,98,"2018"
"49204","421240 PEDRAS GRANDES",0,0,2,36,0,38,"2018"
"49205","421250 PENHA",3,0,9,447,0,459,"2018"
"49206","421260 PERITIBA",0,0,1,31,0,32,"2018"
"49207","421265 PESCARIA BRAVA",0,0,2,96,1,99,"2018"
"49208","421270 PETROLANDIA",0,1,2,66,0,69,"2018"
"49209","421280 BALNEARIO PICARRAS",0,1,7,358,3,369,"2018"
"49210","421290 PINHALZINHO",0,0,3,325,1,329,"2018"
"49211","421300 PINHEIRO PRETO",1,0,1,50,0,52,"2018"
"49212","421310 PIRATUBA",1,0,3,70,0,74,"2018"
"49213","421315 PLANALTO ALEGRE",0,0,0,31,0,31,"2018"
"49214","421320 POMERODE",1,0,5,424,0,430,"2018"
"49215","421330 PONTE ALTA",0,0,4,59,0,63,"2018"
"49216","421335 PONTE ALTA DO NORTE",0,0,1,69,1,71,"2018"
"49217","421340 PONTE SERRADA",0,0,1,175,1,177,"2018"
"49218","421350 PORTO BELO",0,0,4,266,1,271,"2018"
"49219","421360 PORTO UNIAO",0,1,2,421,1,425,"2018"
"49220","421370 POUSO REDONDO",1,1,7,237,2,248,"2018"
"49221","421380 PRAIA GRANDE",0,0,1,94,1,96,"2018"
"49222","421390 PRESIDENTE CASTELLO BRANCO",0,0,0,22,0,22,"2018"
"49223","421400 PRESIDENTE GETULIO",0,0,6,234,0,240,"2018"
"49224","421410 PRESIDENTE NEREU",0,0,0,20,0,20,"2018"
"49225","421415 PRINCESA",0,0,2,34,0,36,"2018"
"49226","421420 QUILOMBO",0,1,1,145,0,147,"2018"
"49227","421430 RANCHO QUEIMADO",0,0,0,27,0,27,"2018"
"49228","421440 RIO DAS ANTAS",0,0,0,75,0,75,"2018"
"49229","421450 RIO DO CAMPO",0,0,1,86,0,87,"2018"
"49230","421460 RIO DO OESTE",0,0,1,74,0,75,"2018"
"49231","421470 RIO DOS CEDROS",1,0,2,124,0,127,"2018"
"49232","421480 RIO DO SUL",1,2,24,893,4,924,"2018"
"49233","421490 RIO FORTUNA",0,0,1,60,0,61,"2018"
"49234","421500 RIO NEGRINHO",1,0,10,568,1,580,"2018"
"49235","421505 RIO RUFINO",0,0,2,24,1,27,"2018"
"49236","421507 RIQUEZA",0,0,3,54,0,57,"2018"
"49237","421510 RODEIO",0,0,2,131,0,133,"2018"
"49238","421520 ROMELANDIA",1,0,3,39,0,43,"2018"
"49239","421530 SALETE",0,1,1,92,3,97,"2018"
"49240","421535 SALTINHO",0,0,0,30,0,30,"2018"
"49241","421540 SALTO VELOSO",0,0,0,52,0,52,"2018"
"49242","421545 SANGAO",0,0,3,170,0,173,"2018"
"49243","421550 SANTA CECILIA",0,0,7,314,0,321,"2018"
"49244","421555 SANTA HELENA",0,0,1,33,0,34,"2018"
"49245","421560 SANTA ROSA DE LIMA",0,0,1,13,0,14,"2018"
"49246","421565 SANTA ROSA DO SUL",0,0,1,129,2,132,"2018"
"49247","421567 SANTA TEREZINHA",0,0,0,98,1,99,"2018"
"49248","421568 SANTA TEREZINHA DO PROGRESSO",1,0,2,41,0,44,"2018"
"49249","421569 SANTIAGO DO SUL",0,0,0,16,0,16,"2018"
"49250","421570 SANTO AMARO DA IMPERATRIZ",0,2,1,331,4,338,"2018"
"49251","421575 SAO BERNARDINO",0,0,2,43,0,45,"2018"
"49252","421580 SAO BENTO DO SUL",1,1,6,1073,0,1081,"2018"
"49253","421590 SAO BONIFACIO",0,0,2,15,0,17,"2018"
"49254","421600 SAO CARLOS",0,1,0,133,0,134,"2018"
"49255","421605 SAO CRISTOVAO DO SUL",0,0,2,85,0,87,"2018"
"49256","421610 SAO DOMINGOS",1,0,2,115,2,120,"2018"
"49257","421620 SAO FRANCISCO DO SUL",3,4,8,642,4,661,"2018"
"49258","421625 SAO JOAO DO OESTE",0,0,1,56,0,57,"2018"
"49259","421630 SAO JOAO BATISTA",1,2,5,503,0,511,"2018"
"49260","421635 SAO JOAO DO ITAPERIU",0,0,2,55,0,57,"2018"
"49261","421640 SAO JOAO DO SUL",0,0,2,88,0,90,"2018"
"49262","421650 SAO JOAQUIM",2,2,17,367,1,389,"2018"
"49263","421660 SAO JOSE",9,13,48,3247,47,3364,"2018"
"49264","421670 SAO JOSE DO CEDRO",1,2,1,186,0,190,"2018"
"49265","421680 SAO JOSE DO CERRITO",0,2,3,85,0,90,"2018"
"49266","421690 SAO LOURENCO DO OESTE",3,2,5,335,0,345,"2018"
"49267","421700 SAO LUDGERO",0,0,4,174,0,178,"2018"
"49268","421710 SAO MARTINHO",0,0,1,37,0,38,"2018"
"49269","421715 SAO MIGUEL DA BOA VISTA",0,0,0,16,0,16,"2018"
"49270","421720 SAO MIGUEL DO OESTE",4,0,5,556,0,565,"2018"
"49271","421725 SAO PEDRO DE ALCANTARA",0,0,1,31,1,33,"2018"
"49272","421730 SAUDADES",1,0,2,132,0,135,"2018"
"49273","421740 SCHROEDER",1,0,2,264,1,268,"2018"
"49274","421750 SEARA",0,0,5,240,0,245,"2018"
"49275","421755 SERRA ALTA",0,1,0,33,0,34,"2018"
"49276","421760 SIDEROPOLIS",0,0,2,148,0,150,"2018"
"49277","421770 SOMBRIO",1,0,6,421,1,429,"2018"
"49278","421775 SUL BRASIL",2,0,0,30,0,32,"2018"
"49279","421780 TAIO",1,1,4,266,1,273,"2018"
"49280","421790 TANGARA",1,0,1,64,0,66,"2018"
"49281","421795 TIGRINHOS",0,0,0,36,0,36,"2018"
"49282","421800 TIJUCAS",0,3,14,594,6,617,"2018"
"49283","421810 TIMBE DO SUL",0,0,0,57,0,57,"2018"
"49284","421820 TIMBO",3,2,5,480,0,490,"2018"
"49285","421825 TIMBO GRANDE",2,2,0,116,1,121,"2018"
"49286","421830 TRES BARRAS",1,1,5,355,0,362,"2018"
"49287","421835 TREVISO",1,0,0,37,0,38,"2018"
"49288","421840 TREZE DE MAIO",0,1,0,90,0,91,"2018"
"49289","421850 TREZE TILIAS",1,0,0,102,0,103,"2018"
"49290","421860 TROMBUDO CENTRAL",0,0,0,81,0,81,"2018"
"49291","421870 TUBARAO",4,6,11,1342,1,1364,"2018"
"49292","421875 TUNAPOLIS",0,0,0,50,0,50,"2018"
"49293","421880 TURVO",0,2,1,155,3,161,"2018"
"49294","421885 UNIAO DO OESTE",0,0,0,30,0,30,"2018"
"49295","421890 URUBICI",1,2,1,129,1,134,"2018"
"49296","421895 URUPEMA",0,0,1,33,1,35,"2018"
"49297","421900 URUSSANGA",2,0,3,217,0,222,"2018"
"49298","421910 VARGEAO",0,0,0,38,0,38,"2018"
"49299","421915 VARGEM",0,0,0,25,0,25,"2018"
"49300","421917 VARGEM BONITA",0,0,1,67,0,68,"2018"
"49301","421920 VIDAL RAMOS",0,0,4,71,0,75,"2018"
"49302","421930 VIDEIRA",1,0,10,764,1,776,"2018"
"49303","421935 VITOR MEIRELES",0,0,2,83,1,86,"2018"
"49304","421940 WITMARSUM",0,0,1,48,0,49,"2018"
"49305","421950 XANXERE",1,6,5,718,1,731,"2018"
"49306","421960 XAVANTINA",0,0,0,33,1,34,"2018"
"49307","421970 XAXIM",1,1,4,537,0,543,"2018"
"49308","421985 ZORTEA",0,0,0,51,0,51,"2018"
"49309","422000 BALNEARIO RINCAO",0,1,3,196,0,200,"2018"
"49310","430003 ACEGUA",1,1,0,67,2,71,"2018"
"49311","430005 AGUA SANTA",0,0,2,34,0,36,"2018"
"49312","430010 AGUDO",0,0,2,173,0,175,"2018"
"49313","430020 AJURICABA",1,0,0,87,0,88,"2018"
"49314","430030 ALECRIM",0,1,0,38,0,39,"2018"
"49315","430040 ALEGRETE",0,3,14,915,2,934,"2018"
"49316","430045 ALEGRIA",0,0,0,43,0,43,"2018"
"49317","430047 ALMIRANTE TAMANDARE DO SUL",0,0,0,16,0,16,"2018"
"49318","430050 ALPESTRE",1,0,1,71,0,73,"2018"
"49319","430055 ALTO ALEGRE",0,0,0,15,0,15,"2018"
"49320","430057 ALTO FELIZ",0,1,0,34,0,35,"2018"
"49321","430060 ALVORADA",8,13,53,2919,2,2995,"2018"
"49322","430063 AMARAL FERRADOR",0,0,3,51,0,54,"2018"
"49323","430064 AMETISTA DO SUL",2,0,3,77,0,82,"2018"
"49324","430066 ANDRE DA ROCHA",0,0,0,15,0,15,"2018"
"49325","430070 ANTA GORDA",0,0,0,56,0,56,"2018"
"49326","430080 ANTONIO PRADO",0,0,2,120,0,122,"2018"
"49327","430085 ARAMBARE",0,0,0,42,0,42,"2018"
"49328","430087 ARARICA",2,0,2,96,0,100,"2018"
"49329","430090 ARATIBA",0,0,0,50,0,50,"2018"
"49330","430100 ARROIO DO MEIO",0,2,0,265,1,268,"2018"
"49331","430105 ARROIO DO SAL",0,1,2,128,0,131,"2018"
"49332","430107 ARROIO DO PADRE",1,0,2,17,0,20,"2018"
"49333","430110 ARROIO DOS RATOS",0,1,0,163,0,164,"2018"
"49334","430120 ARROIO DO TIGRE",0,0,2,125,0,127,"2018"
"49335","430130 ARROIO GRANDE",0,0,14,213,0,227,"2018"
"49336","430140 ARVOREZINHA",1,1,1,116,1,120,"2018"
"49337","430150 AUGUSTO PESTANA",0,0,0,90,0,90,"2018"
"49338","430155 AUREA",0,0,1,32,0,33,"2018"
"49339","430160 BAGE",8,7,14,1550,12,1591,"2018"
"49340","430163 BALNEARIO PINHAL",2,1,2,142,2,149,"2018"
"49341","430165 BARAO",1,0,2,68,2,73,"2018"
"49342","430170 BARAO DE COTEGIPE",0,0,2,69,0,71,"2018"
"49343","430175 BARAO DO TRIUNFO",0,0,1,57,1,59,"2018"
"49344","430180 BARRACAO",0,0,2,46,0,48,"2018"
"49345","430185 BARRA DO GUARITA",0,0,1,41,0,42,"2018"
"49346","430187 BARRA DO QUARAI",0,0,0,11,42,53,"2018"
"49347","430190 BARRA DO RIBEIRO",0,0,2,136,14,152,"2018"
"49348","430192 BARRA DO RIO AZUL",0,0,0,12,0,12,"2018"
"49349","430195 BARRA FUNDA",0,0,0,36,0,36,"2018"
"49350","430200 BARROS CASSAL",0,0,2,112,1,115,"2018"
"49351","430205 BENJAMIN CONSTANT DO SUL",0,0,0,28,0,28,"2018"
"49352","430210 BENTO GONCALVES",0,7,27,1492,2,1528,"2018"
"49353","430215 BOA VISTA DAS MISSOES",0,0,1,22,0,23,"2018"
"49354","430220 BOA VISTA DO BURICA",0,0,1,89,0,90,"2018"
"49355","430222 BOA VISTA DO CADEADO",0,0,2,23,0,25,"2018"
"49356","430223 BOA VISTA DO INCRA",0,0,0,34,0,34,"2018"
"49357","430225 BOA VISTA DO SUL",0,0,0,21,0,21,"2018"
"49358","430230 BOM JESUS",1,1,1,159,8,170,"2018"
"49359","430235 BOM PRINCIPIO",0,0,0,158,0,158,"2018"
"49360","430237 BOM PROGRESSO",0,0,0,18,0,18,"2018"
"49361","430240 BOM RETIRO DO SUL",0,0,1,153,0,154,"2018"
"49362","430245 BOQUEIRAO DO LEAO",0,0,1,78,1,80,"2018"
"49363","430250 BOSSOROCA",0,0,0,62,1,63,"2018"
"49364","430258 BOZANO",0,0,0,18,0,18,"2018"
"49365","430260 BRAGA",0,0,1,42,0,43,"2018"
"49366","430265 BROCHIER",0,0,1,41,0,42,"2018"
"49367","430270 BUTIA",0,1,2,261,1,265,"2018"
"49368","430280 CACAPAVA DO SUL",1,0,5,408,3,417,"2018"
"49369","430290 CACEQUI",0,0,2,93,0,95,"2018"
"49370","430300 CACHOEIRA DO SUL",1,4,15,944,4,968,"2018"
"49371","430310 CACHOEIRINHA",0,10,27,1737,4,1778,"2018"
"49372","430320 CACIQUE DOBLE",0,1,0,53,1,55,"2018"
"49373","430330 CAIBATE",0,1,0,45,0,46,"2018"
"49374","430340 CAICARA",0,0,1,46,0,47,"2018"
"49375","430350 CAMAQUA",3,5,13,827,9,857,"2018"
"49376","430355 CAMARGO",0,0,0,38,1,39,"2018"
"49377","430360 CAMBARA DO SUL",0,0,2,69,0,71,"2018"
"49378","430367 CAMPESTRE DA SERRA",1,0,0,30,0,31,"2018"
"49379","430370 CAMPINA DAS MISSOES",0,0,0,55,0,55,"2018"
"49380","430380 CAMPINAS DO SUL",0,0,2,56,0,58,"2018"
"49381","430390 CAMPO BOM",1,0,7,868,3,879,"2018"
"49382","430400 CAMPO NOVO",3,0,1,70,0,74,"2018"
"49383","430410 CAMPOS BORGES",0,1,0,41,1,43,"2018"
"49384","430420 CANDELARIA",0,1,11,331,0,343,"2018"
"49385","430430 CANDIDO GODOI",0,0,1,62,0,63,"2018"
"49386","430435 CANDIOTA",0,0,1,145,3,149,"2018"
"49387","430440 CANELA",1,1,10,682,2,696,"2018"
"49388","430450 CANGUCU",0,4,11,534,4,553,"2018"
"49389","430460 CANOAS",9,17,74,4800,19,4919,"2018"
"49390","430461 CANUDOS DO VALE",0,0,0,16,0,16,"2018"
"49391","430462 CAPAO BONITO DO SUL",0,1,1,20,1,23,"2018"
"49392","430463 CAPAO DA CANOA",1,6,16,908,0,931,"2018"
"49393","430465 CAPAO DO CIPO",0,0,0,37,0,37,"2018"
"49394","430466 CAPAO DO LEAO",1,5,10,353,1,370,"2018"
"49395","430467 CAPIVARI DO SUL",0,0,0,56,0,56,"2018"
"49396","430468 CAPELA DE SANTANA",0,0,1,141,1,143,"2018"
"49397","430469 CAPITAO",0,1,0,40,0,41,"2018"
"49398","430470 CARAZINHO",3,6,12,769,0,790,"2018"
"49399","430471 CARAA",0,0,0,52,0,52,"2018"
"49400","430480 CARLOS BARBOSA",1,1,9,370,0,381,"2018"
"49401","430485 CARLOS GOMES",0,0,0,10,1,11,"2018"
"49402","430490 CASCA",0,0,3,87,0,90,"2018"
"49403","430495 CASEIROS",0,1,1,40,0,42,"2018"
"49404","430500 CATUIPE",0,1,0,89,0,90,"2018"
"49405","430510 CAXIAS DO SUL",7,25,118,5663,10,5823,"2018"
"49406","430511 CENTENARIO",0,1,0,22,0,23,"2018"
"49407","430512 CERRITO",0,1,2,35,0,38,"2018"
"49408","430513 CERRO BRANCO",0,0,0,17,1,18,"2018"
"49409","430515 CERRO GRANDE",0,1,0,30,0,31,"2018"
"49410","430517 CERRO GRANDE DO SUL",0,1,1,128,0,130,"2018"
"49411","430520 CERRO LARGO",0,0,1,165,0,166,"2018"
"49412","430530 CHAPADA",1,0,1,96,0,98,"2018"
"49413","430535 CHARQUEADAS",1,1,2,356,2,362,"2018"
"49414","430537 CHARRUA",0,0,0,28,0,28,"2018"
"49415","430540 CHIAPETTA",1,0,0,46,0,47,"2018"
"49416","430543 CHUI",2,0,2,44,0,48,"2018"
"49417","430544 CHUVISCA",0,0,0,51,0,51,"2018"
"49418","430545 CIDREIRA",0,1,7,186,1,195,"2018"
"49419","430550 CIRIACO",0,2,0,32,0,34,"2018"
"49420","430558 COLINAS",0,0,2,20,0,22,"2018"
"49421","430560 COLORADO",0,0,0,29,0,29,"2018"
"49422","430570 CONDOR",0,0,1,77,0,78,"2018"
"49423","430580 CONSTANTINA",0,1,1,124,0,126,"2018"
"49424","430583 COQUEIRO BAIXO",0,0,0,14,0,14,"2018"
"49425","430585 COQUEIROS DO SUL",0,0,0,22,0,22,"2018"
"49426","430587 CORONEL BARROS",0,0,0,25,0,25,"2018"
"49427","430590 CORONEL BICACO",2,0,0,102,1,105,"2018"
"49428","430593 CORONEL PILAR",0,0,0,12,0,12,"2018"
"49429","430595 COTIPORA",0,0,0,36,0,36,"2018"
"49430","430597 COXILHA",0,0,0,40,0,40,"2018"
"49431","430600 CRISSIUMAL",1,1,8,129,0,139,"2018"
"49432","430605 CRISTAL",0,0,1,96,1,98,"2018"
"49433","430607 CRISTAL DO SUL",0,0,0,42,0,42,"2018"
"49434","430610 CRUZ ALTA",1,5,15,830,0,851,"2018"
"49435","430613 CRUZALTENSE",0,0,0,15,0,15,"2018"
"49436","430620 CRUZEIRO DO SUL",0,0,4,122,0,126,"2018"
"49437","430630 DAVID CANABARRO",0,2,0,41,0,43,"2018"
"49438","430632 DERRUBADAS",0,0,0,32,0,32,"2018"
"49439","430635 DEZESSEIS DE NOVEMBRO",0,0,0,19,0,19,"2018"
"49440","430637 DILERMANDO DE AGUIAR",0,0,0,25,0,25,"2018"
"49441","430640 DOIS IRMAOS",0,0,7,395,2,404,"2018"
"49442","430642 DOIS IRMAOS DAS MISSOES",0,0,0,29,1,30,"2018"
"49443","430645 DOIS LAJEADOS",0,0,0,31,0,31,"2018"
"49444","430650 DOM FELICIANO",0,0,0,147,2,149,"2018"
"49445","430655 DOM PEDRO DE ALCANTARA",0,0,0,26,0,26,"2018"
"49446","430660 DOM PEDRITO",2,0,6,442,1,451,"2018"
"49447","430670 DONA FRANCISCA",0,0,0,37,0,37,"2018"
"49448","430673 DOUTOR MAURICIO CARDOSO",0,0,0,35,0,35,"2018"
"49449","430675 DOUTOR RICARDO",1,0,0,15,0,16,"2018"
"49450","430676 ELDORADO DO SUL",0,3,10,527,4,544,"2018"
"49451","430680 ENCANTADO",0,0,5,257,0,262,"2018"
"49452","430690 ENCRUZILHADA DO SUL",3,0,3,286,0,292,"2018"
"49453","430692 ENGENHO VELHO",0,0,0,23,0,23,"2018"
"49454","430693 ENTRE-IJUIS",0,0,1,125,1,127,"2018"
"49455","430695 ENTRE RIOS DO SUL",0,0,0,32,0,32,"2018"
"49456","430697 EREBANGO",0,0,1,43,0,44,"2018"
"49457","430700 ERECHIM",1,8,21,1314,4,1348,"2018"
"49458","430705 ERNESTINA",0,0,1,29,0,30,"2018"
"49459","430710 HERVAL",0,1,2,69,0,72,"2018"
"49460","430720 ERVAL GRANDE",0,0,1,49,0,50,"2018"
"49461","430730 ERVAL SECO",0,0,0,80,0,80,"2018"
"49462","430740 ESMERALDA",0,0,1,32,0,33,"2018"
"49463","430745 ESPERANCA DO SUL",0,0,0,36,0,36,"2018"
"49464","430750 ESPUMOSO",0,0,0,177,0,177,"2018"
"49465","430755 ESTACAO",0,0,1,71,0,72,"2018"
"49466","430760 ESTANCIA VELHA",0,1,13,620,0,634,"2018"
"49467","430770 ESTEIO",3,5,13,1108,0,1129,"2018"
"49468","430780 ESTRELA",0,2,13,412,0,427,"2018"
"49469","430781 ESTRELA VELHA",0,0,1,42,0,43,"2018"
"49470","430783 EUGENIO DE CASTRO",0,0,1,29,0,30,"2018"
"49471","430786 FAGUNDES VARELA",0,0,0,26,0,26,"2018"
"49472","430790 FARROUPILHA",2,4,8,902,0,916,"2018"
"49473","430800 FAXINAL DO SOTURNO",0,0,2,61,0,63,"2018"
"49474","430805 FAXINALZINHO",0,0,1,27,0,28,"2018"
"49475","430807 FAZENDA VILANOVA",0,0,5,47,0,52,"2018"
"49476","430810 FELIZ",0,0,0,164,1,165,"2018"
"49477","430820 FLORES DA CUNHA",0,2,2,443,2,449,"2018"
"49478","430825 FLORIANO PEIXOTO",0,0,1,13,0,14,"2018"
"49479","430830 FONTOURA XAVIER",0,0,1,110,0,111,"2018"
"49480","430840 FORMIGUEIRO",0,0,0,63,0,63,"2018"
"49481","430843 FORQUETINHA",0,0,0,17,0,17,"2018"
"49482","430845 FORTALEZA DOS VALOS",0,0,0,46,0,46,"2018"
"49483","430850 FREDERICO WESTPHALEN",0,1,4,460,2,467,"2018"
"49484","430860 GARIBALDI",0,0,1,409,0,410,"2018"
"49485","430865 GARRUCHOS",0,1,0,23,0,24,"2018"
"49486","430870 GAURAMA",0,0,0,40,0,40,"2018"
"49487","430880 GENERAL CAMARA",0,0,4,70,0,74,"2018"
"49488","430885 GENTIL",0,0,0,15,0,15,"2018"
"49489","430890 GETULIO VARGAS",1,0,3,184,0,188,"2018"
"49490","430900 GIRUA",0,0,4,171,1,176,"2018"
"49491","430905 GLORINHA",0,0,1,80,1,82,"2018"
"49492","430910 GRAMADO",1,1,5,581,1,589,"2018"
"49493","430912 GRAMADO DOS LOUREIROS",0,0,1,34,0,35,"2018"
"49494","430915 GRAMADO XAVIER",0,0,1,52,0,53,"2018"
"49495","430920 GRAVATAI",4,19,55,3331,6,3415,"2018"
"49496","430925 GUABIJU",0,0,0,7,0,7,"2018"
"49497","430930 GUAIBA",1,8,24,1203,7,1243,"2018"
"49498","430940 GUAPORE",0,2,4,308,1,315,"2018"
"49499","430950 GUARANI DAS MISSOES",0,0,0,66,0,66,"2018"
"49500","430955 HARMONIA",0,0,1,49,0,50,"2018"
"49501","430957 HERVEIRAS",0,0,0,33,0,33,"2018"
"49502","430960 HORIZONTINA",0,0,0,217,0,217,"2018"
"49503","430965 HULHA NEGRA",1,0,1,60,0,62,"2018"
"49504","430970 HUMAITA",0,0,0,36,0,36,"2018"
"49505","430975 IBARAMA",0,0,1,48,0,49,"2018"
"49506","430980 IBIACA",0,1,0,43,0,44,"2018"
"49507","430990 IBIRAIARAS",0,0,2,70,0,72,"2018"
"49508","430995 IBIRAPUITA",0,0,0,45,0,45,"2018"
"49509","431000 IBIRUBA",0,0,3,250,0,253,"2018"
"49510","431010 IGREJINHA",1,2,7,462,1,473,"2018"
"49511","431020 IJUI",1,2,8,1167,1,1179,"2018"
"49512","431030 ILOPOLIS",0,0,0,42,0,42,"2018"
"49513","431033 IMBE",1,0,6,317,1,325,"2018"
"49514","431036 IMIGRANTE",0,0,1,28,0,29,"2018"
"49515","431040 INDEPENDENCIA",0,0,0,74,0,74,"2018"
"49516","431041 INHACORA",0,0,0,27,0,27,"2018"
"49517","431043 IPE",0,0,0,53,0,53,"2018"
"49518","431046 IPIRANGA DO SUL",0,0,0,12,0,12,"2018"
"49519","431050 IRAI",0,0,0,99,0,99,"2018"
"49520","431053 ITAARA",1,0,2,57,0,60,"2018"
"49521","431055 ITACURUBI",1,1,0,27,0,29,"2018"
"49522","431057 ITAPUCA",0,0,0,13,0,13,"2018"
"49523","431060 ITAQUI",0,2,10,551,0,563,"2018"
"49524","431065 ITATI",0,0,0,33,0,33,"2018"
"49525","431070 ITATIBA DO SUL",0,0,0,39,0,39,"2018"
"49526","431075 IVORA",0,0,0,11,0,11,"2018"
"49527","431080 IVOTI",0,4,6,243,0,253,"2018"
"49528","431085 JABOTICABA",0,0,1,34,0,35,"2018"
"49529","431087 JACUIZINHO",0,0,0,30,0,30,"2018"
"49530","431090 JACUTINGA",0,0,1,28,0,29,"2018"
"49531","431100 JAGUARAO",0,1,4,288,1,294,"2018"
"49532","431110 JAGUARI",1,0,0,77,1,79,"2018"
"49533","431112 JAQUIRANA",0,0,0,40,1,41,"2018"
"49534","431113 JARI",0,0,0,29,0,29,"2018"
"49535","431115 JOIA",0,1,1,88,0,90,"2018"
"49536","431120 JULIO DE CASTILHOS",0,0,1,230,1,232,"2018"
"49537","431123 LAGOA BONITA DO SUL",0,0,0,28,0,28,"2018"
"49538","431125 LAGOAO",0,0,0,53,0,53,"2018"
"49539","431127 LAGOA DOS TRES CANTOS",0,0,0,16,0,16,"2018"
"49540","431130 LAGOA VERMELHA",0,1,4,363,0,368,"2018"
"49541","431140 LAJEADO",2,5,18,1237,1,1263,"2018"
"49542","431142 LAJEADO DO BUGRE",0,0,0,22,0,22,"2018"
"49543","431150 LAVRAS DO SUL",0,0,2,60,0,62,"2018"
"49544","431160 LIBERATO SALZANO",0,0,1,79,0,80,"2018"
"49545","431162 LINDOLFO COLLOR",0,0,1,79,0,80,"2018"
"49546","431164 LINHA NOVA",0,0,0,13,0,13,"2018"
"49547","431170 MACHADINHO",0,0,1,77,0,78,"2018"
"49548","431171 MACAMBARA",0,0,0,48,0,48,"2018"
"49549","431173 MAMPITUBA",0,2,3,34,2,41,"2018"
"49550","431175 MANOEL VIANA",0,0,0,72,0,72,"2018"
"49551","431177 MAQUINE",2,0,1,90,0,93,"2018"
"49552","431179 MARATA",0,0,1,25,0,26,"2018"
"49553","431180 MARAU",2,0,6,572,1,581,"2018"
"49554","431190 MARCELINO RAMOS",1,0,2,36,0,39,"2018"
"49555","431198 MARIANA PIMENTEL",0,0,1,47,2,50,"2018"
"49556","431200 MARIANO MORO",0,0,1,8,0,9,"2018"
"49557","431205 MARQUES DE SOUZA",0,0,0,29,0,29,"2018"
"49558","431210 MATA",0,1,1,47,1,50,"2018"
"49559","431213 MATO CASTELHANO",0,0,1,36,1,38,"2018"
"49560","431215 MATO LEITAO",0,0,0,37,0,37,"2018"
"49561","431217 MATO QUEIMADO",0,0,0,17,0,17,"2018"
"49562","431220 MAXIMILIANO DE ALMEIDA",0,0,0,53,0,53,"2018"
"49563","431225 MINAS DO LEAO",0,0,2,103,0,105,"2018"
"49564","431230 MIRAGUAI",1,0,0,60,0,61,"2018"
"49565","431235 MONTAURI",0,0,0,13,0,13,"2018"
"49566","431237 MONTE ALEGRE DOS CAMPOS",0,0,1,33,0,34,"2018"
"49567","431238 MONTE BELO DO SUL",0,0,0,25,0,25,"2018"
"49568","431240 MONTENEGRO",2,0,11,893,4,910,"2018"
"49569","431242 MORMACO",0,0,1,28,0,29,"2018"
"49570","431244 MORRINHOS DO SUL",0,1,1,33,0,35,"2018"
"49571","431245 MORRO REDONDO",1,0,0,57,1,59,"2018"
"49572","431247 MORRO REUTER",0,0,0,75,0,75,"2018"
"49573","431250 MOSTARDAS",1,1,1,105,0,108,"2018"
"49574","431260 MUCUM",0,0,0,49,1,50,"2018"
"49575","431261 MUITOS CAPOES",0,0,0,45,1,46,"2018"
"49576","431262 MULITERNO",0,0,1,23,0,24,"2018"
"49577","431265 NAO-ME-TOQUE",0,1,1,217,0,219,"2018"
"49578","431267 NICOLAU VERGUEIRO",0,0,1,22,0,23,"2018"
"49579","431270 NONOAI",0,1,4,198,1,204,"2018"
"49580","431275 NOVA ALVORADA",0,0,4,40,0,44,"2018"
"49581","431280 NOVA ARACA",0,0,1,71,0,72,"2018"
"49582","431290 NOVA BASSANO",0,0,0,85,0,85,"2018"
"49583","431295 NOVA BOA VISTA",0,0,0,17,0,17,"2018"
"49584","431300 NOVA BRESCIA",0,0,0,32,0,32,"2018"
"49585","431301 NOVA CANDELARIA",0,0,0,43,0,43,"2018"
"49586","431303 NOVA ESPERANCA DO SUL",0,0,1,49,0,50,"2018"
"49587","431306 NOVA HARTZ",0,1,4,226,0,231,"2018"
"49588","431308 NOVA PADUA",0,0,1,17,0,18,"2018"
"49589","431310 NOVA PALMA",0,0,1,42,0,43,"2018"
"49590","431320 NOVA PETROPOLIS",0,1,2,253,0,256,"2018"
"49591","431330 NOVA PRATA",0,0,4,336,0,340,"2018"
"49592","431333 NOVA RAMADA",0,0,0,23,0,23,"2018"
"49593","431335 NOVA ROMA DO SUL",0,0,0,26,0,26,"2018"
"49594","431337 NOVA SANTA RITA",0,0,5,379,2,386,"2018"
"49595","431339 NOVO CABRAIS",1,0,1,41,1,44,"2018"
"49596","431340 NOVO HAMBURGO",5,6,59,3067,4,3141,"2018"
"49597","431342 NOVO MACHADO",0,0,0,31,0,31,"2018"
"49598","431344 NOVO TIRADENTES",0,0,0,20,0,20,"2018"
"49599","431346 NOVO XINGU",0,0,0,23,0,23,"2018"
"49600","431349 NOVO BARREIRO",0,1,1,42,0,44,"2018"
"49601","431350 OSORIO",2,1,5,663,1,672,"2018"
"49602","431360 PAIM FILHO",0,0,0,36,0,36,"2018"
"49603","431365 PALMARES DO SUL",0,0,2,128,0,130,"2018"
"49604","431370 PALMEIRA DAS MISSOES",1,3,8,479,1,492,"2018"
"49605","431380 PALMITINHO",0,1,3,88,0,92,"2018"
"49606","431390 PANAMBI",1,1,4,561,0,567,"2018"
"49607","431395 PANTANO GRANDE",1,0,1,116,0,118,"2018"
"49608","431400 PARAI",0,0,0,78,0,78,"2018"
"49609","431402 PARAISO DO SUL",0,0,1,67,0,68,"2018"
"49610","431403 PARECI NOVO",0,0,0,46,0,46,"2018"
"49611","431405 PAROBE",1,1,20,790,0,812,"2018"
"49612","431406 PASSA SETE",0,0,0,36,0,36,"2018"
"49613","431407 PASSO DO SOBRADO",0,0,1,55,0,56,"2018"
"49614","431410 PASSO FUNDO",8,12,39,2823,5,2887,"2018"
"49615","431413 PAULO BENTO",0,0,1,14,0,15,"2018"
"49616","431415 PAVERAMA",0,0,1,93,0,94,"2018"
"49617","431417 PEDRAS ALTAS",0,1,1,20,0,22,"2018"
"49618","431420 PEDRO OSORIO",0,1,2,68,1,72,"2018"
"49619","431430 PEJUCARA",0,0,3,40,0,43,"2018"
"49620","431440 PELOTAS",24,30,118,4047,10,4229,"2018"
"49621","431442 PICADA CAFE",0,0,1,53,0,54,"2018"
"49622","431445 PINHAL",0,0,0,36,0,36,"2018"
"49623","431446 PINHAL DA SERRA",0,0,0,21,0,21,"2018"
"49624","431447 PINHAL GRANDE",2,0,0,31,0,33,"2018"
"49625","431449 PINHEIRINHO DO VALE",0,0,0,42,0,42,"2018"
"49626","431450 PINHEIRO MACHADO",0,2,1,97,1,101,"2018"
"49627","431454 PINTO BANDEIRA",0,0,0,19,0,19,"2018"
"49628","431455 PIRAPO",0,0,0,20,0,20,"2018"
"49629","431460 PIRATINI",2,0,6,166,1,175,"2018"
"49630","431470 PLANALTO",1,2,1,141,0,145,"2018"
"49631","431475 POCO DAS ANTAS",0,0,1,30,0,31,"2018"
"49632","431477 PONTAO",0,0,2,43,0,45,"2018"
"49633","431478 PONTE PRETA",0,0,0,15,0,15,"2018"
"49634","431480 PORTAO",0,1,15,400,0,416,"2018"
"49635","431490 PORTO ALEGRE",44,81,345,17038,71,17579,"2018"
"49636","431500 PORTO LUCENA",2,0,1,37,0,40,"2018"
"49637","431505 PORTO MAUA",0,0,0,24,0,24,"2018"
"49638","431507 PORTO VERA CRUZ",0,0,0,13,0,13,"2018"
"49639","431510 PORTO XAVIER",0,1,0,115,0,116,"2018"
"49640","431513 POUSO NOVO",0,0,2,29,0,31,"2018"
"49641","431514 PRESIDENTE LUCENA",0,0,0,40,0,40,"2018"
"49642","431515 PROGRESSO",0,1,2,49,0,52,"2018"
"49643","431517 PROTASIO ALVES",0,0,0,21,0,21,"2018"
"49644","431520 PUTINGA",0,0,1,40,0,41,"2018"
"49645","431530 QUARAI",1,1,2,267,2,273,"2018"
"49646","431531 QUATRO IRMAOS",0,0,0,23,0,23,"2018"
"49647","431532 QUEVEDOS",0,0,0,12,0,12,"2018"
"49648","431535 QUINZE DE NOVEMBRO",0,0,0,39,0,39,"2018"
"49649","431540 REDENTORA",0,0,2,176,5,183,"2018"
"49650","431545 RELVADO",0,0,0,13,0,13,"2018"
"49651","431550 RESTINGA SECA",1,0,1,164,1,167,"2018"
"49652","431555 RIO DOS INDIOS",0,0,0,36,0,36,"2018"
"49653","431560 RIO GRANDE",3,19,78,2582,28,2710,"2018"
"49654","431570 RIO PARDO",1,2,6,362,0,371,"2018"
"49655","431575 RIOZINHO",0,0,0,44,0,44,"2018"
"49656","431580 ROCA SALES",0,0,0,119,1,120,"2018"
"49657","431590 RODEIO BONITO",0,0,0,91,0,91,"2018"
"49658","431595 ROLADOR",0,1,0,21,0,22,"2018"
"49659","431600 ROLANTE",1,1,1,268,1,272,"2018"
"49660","431610 RONDA ALTA",1,1,1,121,0,124,"2018"
"49661","431620 RONDINHA",0,0,1,54,0,55,"2018"
"49662","431630 ROQUE GONZALES",0,0,0,58,0,58,"2018"
"49663","431640 ROSARIO DO SUL",1,2,14,479,1,497,"2018"
"49664","431642 SAGRADA FAMILIA",0,0,2,37,0,39,"2018"
"49665","431643 SALDANHA MARINHO",1,0,0,23,0,24,"2018"
"49666","431645 SALTO DO JACUI",0,1,1,133,0,135,"2018"
"49667","431647 SALVADOR DAS MISSOES",0,0,0,25,0,25,"2018"
"49668","431650 SALVADOR DO SUL",1,0,2,93,1,97,"2018"
"49669","431660 SANANDUVA",0,0,2,183,2,187,"2018"
"49670","431670 SANTA BARBARA DO SUL",0,0,0,87,0,87,"2018"
"49671","431673 SANTA CECILIA DO SUL",0,0,0,17,0,17,"2018"
"49672","431675 SANTA CLARA DO SUL",1,0,1,67,0,69,"2018"
"49673","431680 SANTA CRUZ DO SUL",0,10,21,1675,1,1707,"2018"
"49674","431690 SANTA MARIA",8,17,48,3551,11,3635,"2018"
"49675","431695 SANTA MARIA DO HERVAL",1,0,1,57,1,60,"2018"
"49676","431697 SANTA MARGARIDA DO SUL",0,0,0,17,0,17,"2018"
"49677","431700 SANTANA DA BOA VISTA",0,0,1,56,0,57,"2018"
"49678","431710 SANT'ANA DO LIVRAMENTO",3,3,9,1068,41,1124,"2018"
"49679","431720 SANTA ROSA",3,0,26,1005,3,1037,"2018"
"49680","431725 SANTA TEREZA",0,0,0,10,0,10,"2018"
"49681","431730 SANTA VITORIA DO PALMAR",2,7,10,378,0,397,"2018"
"49682","431740 SANTIAGO",2,2,3,584,1,592,"2018"
"49683","431750 SANTO ANGELO",3,0,6,1026,1,1036,"2018"
"49684","431755 SANTO ANTONIO DO PALMA",0,0,1,28,0,29,"2018"
"49685","431760 SANTO ANTONIO DA PATRULHA",1,5,3,466,1,476,"2018"
"49686","431770 SANTO ANTONIO DAS MISSOES",0,0,0,121,1,122,"2018"
"49687","431775 SANTO ANTONIO DO PLANALTO",0,1,0,19,0,20,"2018"
"49688","431780 SANTO AUGUSTO",0,0,1,172,0,173,"2018"
"49689","431790 SANTO CRISTO",0,2,4,180,2,188,"2018"
"49690","431795 SANTO EXPEDITO DO SUL",0,0,0,18,0,18,"2018"
"49691","431800 SAO BORJA",1,1,5,756,0,763,"2018"
"49692","431805 SAO DOMINGOS DO SUL",0,0,0,20,0,20,"2018"
"49693","431810 SAO FRANCISCO DE ASSIS",0,2,5,143,1,151,"2018"
"49694","431820 SAO FRANCISCO DE PAULA",0,0,4,243,2,249,"2018"
"49695","431830 SAO GABRIEL",5,6,12,766,6,795,"2018"
"49696","431840 SAO JERONIMO",0,1,5,249,2,257,"2018"
"49697","431842 SAO JOAO DA URTIGA",0,0,0,51,0,51,"2018"
"49698","431843 SAO JOAO DO POLESINE",0,2,0,25,0,27,"2018"
"49699","431844 SAO JORGE",0,0,0,24,0,24,"2018"
"49700","431845 SAO JOSE DAS MISSOES",0,0,1,30,0,31,"2018"
"49701","431846 SAO JOSE DO HERVAL",0,1,1,14,0,16,"2018"
"49702","431848 SAO JOSE DO HORTENCIO",0,0,0,40,0,40,"2018"
"49703","431849 SAO JOSE DO INHACORA",0,0,0,19,0,19,"2018"
"49704","431850 SAO JOSE DO NORTE",1,1,8,250,2,262,"2018"
"49705","431860 SAO JOSE DO OURO",2,1,3,82,0,88,"2018"
"49706","431861 SAO JOSE DO SUL",0,1,0,28,0,29,"2018"
"49707","431862 SAO JOSE DOS AUSENTES",0,1,0,61,0,62,"2018"
"49708","431870 SAO LEOPOLDO",2,8,46,2830,4,2890,"2018"
"49709","431880 SAO LOURENCO DO SUL",2,1,11,463,0,477,"2018"
"49710","431890 SAO LUIZ GONZAGA",0,2,2,433,0,437,"2018"
"49711","431900 SAO MARCOS",0,0,5,208,0,213,"2018"
"49712","431910 SAO MARTINHO",0,0,0,65,0,65,"2018"
"49713","431912 SAO MARTINHO DA SERRA",0,0,0,18,0,18,"2018"
"49714","431915 SAO MIGUEL DAS MISSOES",0,0,0,72,0,72,"2018"
"49715","431920 SAO NICOLAU",0,0,0,46,0,46,"2018"
"49716","431930 SAO PAULO DAS MISSOES",0,0,0,55,0,55,"2018"
"49717","431935 SAO PEDRO DA SERRA",0,0,0,41,1,42,"2018"
"49718","431936 SAO PEDRO DAS MISSOES",0,0,1,18,0,19,"2018"
"49719","431937 SAO PEDRO DO BUTIA",0,0,0,25,0,25,"2018"
"49720","431940 SAO PEDRO DO SUL",1,1,2,139,0,143,"2018"
"49721","431950 SAO SEBASTIAO DO CAI",1,4,2,320,1,328,"2018"
"49722","431960 SAO SEPE",1,0,3,250,1,255,"2018"
"49723","431970 SAO VALENTIM",0,0,1,36,0,37,"2018"
"49724","431971 SAO VALENTIM DO SUL",0,0,0,13,0,13,"2018"
"49725","431973 SAO VALERIO DO SUL",0,0,0,45,0,45,"2018"
"49726","431975 SAO VENDELINO",0,0,0,27,0,27,"2018"
"49727","431980 SAO VICENTE DO SUL",0,0,1,72,0,73,"2018"
"49728","431990 SAPIRANGA",1,5,12,1177,3,1198,"2018"
"49729","432000 SAPUCAIA DO SUL",2,5,56,1680,6,1749,"2018"
"49730","432010 SARANDI",1,2,5,300,1,309,"2018"
"49731","432020 SEBERI",0,0,4,166,2,172,"2018"
"49732","432023 SEDE NOVA",0,0,1,36,0,37,"2018"
"49733","432026 SEGREDO",0,0,0,88,2,90,"2018"
"49734","432030 SELBACH",0,0,1,62,0,63,"2018"
"49735","432032 SENADOR SALGADO FILHO",0,0,1,23,0,24,"2018"
"49736","432035 SENTINELA DO SUL",0,1,1,63,0,65,"2018"
"49737","432040 SERAFINA CORREA",1,0,1,174,0,176,"2018"
"49738","432045 SERIO",0,0,0,13,0,13,"2018"
"49739","432050 SERTAO",0,0,0,60,0,60,"2018"
"49740","432055 SERTAO SANTANA",0,0,1,58,3,62,"2018"
"49741","432057 SETE DE SETEMBRO",0,0,0,17,0,17,"2018"
"49742","432060 SEVERIANO DE ALMEIDA",0,0,1,29,0,30,"2018"
"49743","432065 SILVEIRA MARTINS",0,1,1,22,1,25,"2018"
"49744","432067 SINIMBU",0,0,0,72,1,73,"2018"
"49745","432070 SOBRADINHO",1,1,0,193,0,195,"2018"
"49746","432080 SOLEDADE",1,1,2,360,3,367,"2018"
"49747","432085 TABAI",0,0,0,61,0,61,"2018"
"49748","432090 TAPEJARA",2,1,3,378,1,385,"2018"
"49749","432100 TAPERA",0,0,1,117,0,118,"2018"
"49750","432110 TAPES",1,0,3,149,0,153,"2018"
"49751","432120 TAQUARA",1,1,14,676,1,693,"2018"
"49752","432130 TAQUARI",0,0,5,272,1,278,"2018"
"49753","432132 TAQUARUCU DO SUL",0,0,1,24,0,25,"2018"
"49754","432135 TAVARES",0,0,0,46,0,46,"2018"
"49755","432140 TENENTE PORTELA",0,0,4,216,0,220,"2018"
"49756","432143 TERRA DE AREIA",0,0,1,134,0,135,"2018"
"49757","432145 TEUTONIA",0,0,3,437,0,440,"2018"
"49758","432146 TIO HUGO",0,0,0,47,0,47,"2018"
"49759","432147 TIRADENTES DO SUL",0,0,1,43,0,44,"2018"
"49760","432149 TOROPI",1,0,1,16,0,18,"2018"
"49761","432150 TORRES",0,1,10,592,6,609,"2018"
"49762","432160 TRAMANDAI",4,2,11,788,1,806,"2018"
"49763","432162 TRAVESSEIRO",0,1,1,27,0,29,"2018"
"49764","432163 TRES ARROIOS",0,0,0,9,0,9,"2018"
"49765","432166 TRES CACHOEIRAS",0,2,1,132,1,136,"2018"
"49766","432170 TRES COROAS",1,4,6,291,0,302,"2018"
"49767","432180 TRES DE MAIO",0,0,3,294,0,297,"2018"
"49768","432183 TRES FORQUILHAS",0,0,0,30,0,30,"2018"
"49769","432185 TRES PALMEIRAS",0,0,0,47,1,48,"2018"
"49770","432190 TRES PASSOS",0,0,5,313,0,318,"2018"
"49771","432195 TRINDADE DO SUL",0,0,2,69,1,72,"2018"
"49772","432200 TRIUNFO",0,1,2,352,2,357,"2018"
"49773","432210 TUCUNDUVA",0,0,0,58,0,58,"2018"
"49774","432215 TUNAS",0,0,0,35,0,35,"2018"
"49775","432218 TUPANCI DO SUL",0,0,0,13,0,13,"2018"
"49776","432220 TUPANCIRETA",0,4,2,274,1,281,"2018"
"49777","432225 TUPANDI",0,0,1,57,0,58,"2018"
"49778","432230 TUPARENDI",1,0,1,73,0,75,"2018"
"49779","432232 TURUCU",0,0,2,25,0,27,"2018"
"49780","432234 UBIRETAMA",0,0,0,12,0,12,"2018"
"49781","432235 UNIAO DA SERRA",0,0,0,6,0,6,"2018"
"49782","432237 UNISTALDA",0,0,0,27,0,27,"2018"
"49783","432240 URUGUAIANA",1,5,19,536,1156,1717,"2018"
"49784","432250 VACARIA",3,4,5,907,19,938,"2018"
"49785","432252 VALE VERDE",0,3,0,24,0,27,"2018"
"49786","432253 VALE DO SOL",0,0,1,95,0,96,"2018"
"49787","432254 VALE REAL",0,0,2,74,0,76,"2018"
"49788","432255 VANINI",0,0,0,16,0,16,"2018"
"49789","432260 VENANCIO AIRES",0,4,14,796,0,814,"2018"
"49790","432270 VERA CRUZ",0,2,8,284,0,294,"2018"
"49791","432280 VERANOPOLIS",3,1,3,262,0,269,"2018"
"49792","432285 VESPASIANO CORREA",0,0,0,16,0,16,"2018"
"49793","432290 VIADUTOS",0,0,1,38,0,39,"2018"
"49794","432300 VIAMAO",8,14,44,2935,37,3038,"2018"
"49795","432310 VICENTE DUTRA",0,0,0,67,0,67,"2018"
"49796","432320 VICTOR GRAEFF",0,1,1,28,0,30,"2018"
"49797","432330 VILA FLORES",0,0,2,39,0,41,"2018"
"49798","432335 VILA LANGARO",0,0,0,17,0,17,"2018"
"49799","432340 VILA MARIA",0,0,1,38,0,39,"2018"
"49800","432345 VILA NOVA DO SUL",0,0,1,20,0,21,"2018"
"49801","432350 VISTA ALEGRE",0,0,1,40,0,41,"2018"
"49802","432360 VISTA ALEGRE DO PRATA",0,0,1,10,0,11,"2018"
"49803","432370 VISTA GAUCHA",0,0,0,32,0,32,"2018"
"49804","432375 VITORIA DAS MISSOES",0,0,0,30,0,30,"2018"
"49805","432377 WESTFALIA",0,0,0,36,0,36,"2018"
"49806","432380 XANGRI-LA",0,1,5,251,1,258,"2018"
"49807","500020 AGUA CLARA",0,2,0,272,1,275,"2018"
"49808","500025 ALCINOPOLIS",0,0,1,62,0,63,"2018"
"49809","500060 AMAMBAI",2,4,16,620,2,644,"2018"
"49810","500070 ANASTACIO",0,0,4,351,4,359,"2018"
"49811","500080 ANAURILANDIA",0,0,2,76,0,78,"2018"
"49812","500085 ANGELICA",0,0,1,151,0,152,"2018"
"49813","500090 ANTONIO JOAO",0,0,1,153,6,160,"2018"
"49814","500100 APARECIDA DO TABOADO",1,1,2,362,1,367,"2018"
"49815","500110 AQUIDAUANA",5,2,4,755,7,773,"2018"
"49816","500124 ARAL MOREIRA",0,13,18,118,0,149,"2018"
"49817","500150 BANDEIRANTES",0,0,1,110,1,112,"2018"
"49818","500190 BATAGUASSU",1,1,3,446,1,452,"2018"
"49819","500200 BATAYPORA",0,0,0,133,0,133,"2018"
"49820","500210 BELA VISTA",2,0,3,388,1,394,"2018"
"49821","500215 BODOQUENA",0,0,1,127,1,129,"2018"
"49822","500220 BONITO",1,1,3,444,0,449,"2018"
"49823","500230 BRASILANDIA",0,1,1,196,0,198,"2018"
"49824","500240 CAARAPO",0,3,4,543,3,553,"2018"
"49825","500260 CAMAPUA",1,2,1,207,1,212,"2018"
"49826","500270 CAMPO GRANDE",32,34,109,13972,30,14177,"2018"
"49827","500280 CARACOL",0,0,2,79,0,81,"2018"
"49828","500290 CASSILANDIA",0,0,2,249,1,252,"2018"
"49829","500295 CHAPADAO DO SUL",0,0,6,479,0,485,"2018"
"49830","500310 CORGUINHO",0,1,0,45,0,46,"2018"
"49831","500315 CORONEL SAPUCAIA",3,3,1,333,9,349,"2018"
"49832","500320 CORUMBA",1,6,9,1801,3,1820,"2018"
"49833","500325 COSTA RICA",1,1,4,479,0,485,"2018"
"49834","500330 COXIM",1,0,2,550,1,554,"2018"
"49835","500345 DEODAPOLIS",0,1,2,150,0,153,"2018"
"49836","500348 DOIS IRMAOS DO BURITI",0,1,3,127,1,132,"2018"
"49837","500350 DOURADINA",1,0,1,59,3,64,"2018"
"49838","500370 DOURADOS",3,14,59,3980,31,4087,"2018"
"49839","500375 ELDORADO",0,2,12,163,0,177,"2018"
"49840","500380 FATIMA DO SUL",0,2,1,314,0,317,"2018"
"49841","500390 FIGUEIRAO",0,0,0,35,0,35,"2018"
"49842","500400 GLORIA DE DOURADOS",0,0,1,120,0,121,"2018"
"49843","500410 GUIA LOPES DA LAGUNA",0,0,0,137,0,137,"2018"
"49844","500430 IGUATEMI",0,2,4,249,0,255,"2018"
"49845","500440 INOCENCIA",0,1,0,103,0,104,"2018"
"49846","500450 ITAPORA",0,1,0,211,0,212,"2018"
"49847","500460 ITAQUIRAI",0,3,1,269,1,274,"2018"
"49848","500470 IVINHEMA",1,0,7,456,0,464,"2018"
"49849","500480 JAPORA",1,1,18,167,1,188,"2018"
"49850","500490 JARAGUARI",0,1,0,56,1,58,"2018"
"49851","500500 JARDIM",0,0,2,417,2,421,"2018"
"49852","500510 JATEI",0,0,1,66,0,67,"2018"
"49853","500515 JUTI",0,1,2,99,0,102,"2018"
"49854","500520 LADARIO",0,4,7,393,0,404,"2018"
"49855","500525 LAGUNA CARAPA",0,0,1,115,1,117,"2018"
"49856","500540 MARACAJU",0,2,10,767,0,779,"2018"
"49857","500560 MIRANDA",0,2,4,505,2,513,"2018"
"49858","500568 MUNDO NOVO",0,1,55,239,0,295,"2018"
"49859","500570 NAVIRAI",1,0,14,817,1,833,"2018"
"49860","500580 NIOAQUE",2,0,0,167,0,169,"2018"
"49861","500600 NOVA ALVORADA DO SUL",1,1,4,350,0,356,"2018"
"49862","500620 NOVA ANDRADINA",1,1,4,778,0,784,"2018"
"49863","500625 NOVO HORIZONTE DO SUL",0,0,0,82,0,82,"2018"
"49864","500627 PARAISO DAS AGUAS",0,0,0,47,0,47,"2018"
"49865","500630 PARANAIBA",2,1,4,581,0,588,"2018"
"49866","500635 PARANHOS",4,2,6,303,30,345,"2018"
"49867","500640 PEDRO GOMES",0,0,1,84,1,86,"2018"
"49868","500660 PONTA PORA",3,5,27,1549,21,1605,"2018"
"49869","500690 PORTO MURTINHO",0,1,1,237,3,242,"2018"
"49870","500710 RIBAS DO RIO PARDO",1,0,5,341,1,348,"2018"
"49871","500720 RIO BRILHANTE",4,0,7,640,0,651,"2018"
"49872","500730 RIO NEGRO",0,0,1,48,0,49,"2018"
"49873","500740 RIO VERDE DE MATO GROSSO",1,0,2,287,0,290,"2018"
"49874","500750 ROCHEDO",0,0,1,60,0,61,"2018"
"49875","500755 SANTA RITA DO PARDO",1,0,0,23,1,25,"2018"
"49876","500769 SAO GABRIEL DO OESTE",0,1,2,583,0,586,"2018"
"49877","500770 SETE QUEDAS",1,0,1,157,0,159,"2018"
"49878","500780 SELVIRIA",0,1,1,91,0,93,"2018"
"49879","500790 SIDROLANDIA",2,2,8,708,2,722,"2018"
"49880","500793 SONORA",0,0,0,217,0,217,"2018"
"49881","500795 TACURU",1,0,4,190,2,197,"2018"
"49882","500797 TAQUARUSSU",0,0,0,34,0,34,"2018"
"49883","500800 TERENOS",0,0,4,229,0,233,"2018"
"49884","500830 TRES LAGOAS",4,5,23,1993,0,2025,"2018"
"49885","500840 VICENTINA",0,0,1,70,0,71,"2018"
"49886","510010 ACORIZAL",0,2,1,58,0,61,"2018"
"49887","510020 AGUA BOA",0,3,5,447,13,468,"2018"
"49888","510025 ALTA FLORESTA",2,1,6,884,0,893,"2018"
"49889","510030 ALTO ARAGUAIA",0,2,0,202,0,204,"2018"
"49890","510035 ALTO BOA VISTA",0,0,1,71,29,101,"2018"
"49891","510040 ALTO GARCAS",0,0,1,145,0,146,"2018"
"49892","510050 ALTO PARAGUAI",0,0,0,95,1,96,"2018"
"49893","510060 ALTO TAQUARI",0,0,3,184,0,187,"2018"
"49894","510080 APIACAS",0,0,0,125,0,125,"2018"
"49895","510100 ARAGUAIANA",0,0,0,29,1,30,"2018"
"49896","510120 ARAGUAINHA",0,0,0,11,0,11,"2018"
"49897","510125 ARAPUTANGA",0,0,1,245,0,246,"2018"
"49898","510130 ARENAPOLIS",0,0,3,136,0,139,"2018"
"49899","510140 ARIPUANA",0,1,0,366,0,367,"2018"
"49900","510160 BARAO DE MELGACO",0,0,0,61,0,61,"2018"
"49901","510170 BARRA DO BUGRES",1,2,1,505,0,509,"2018"
"49902","510180 BARRA DO GARCAS",0,3,9,1091,5,1108,"2018"
"49903","510185 BOM JESUS DO ARAGUAIA",0,0,0,98,2,100,"2018"
"49904","510190 BRASNORTE",1,1,7,271,35,315,"2018"
"49905","510250 CACERES",7,8,13,1618,12,1658,"2018"
"49906","510260 CAMPINAPOLIS",2,2,10,259,165,438,"2018"
"49907","510263 CAMPO NOVO DO PARECIS",1,1,11,752,2,767,"2018"
"49908","510267 CAMPO VERDE",2,1,7,819,1,830,"2018"
"49909","510268 CAMPOS DE JULIO",0,0,3,140,0,143,"2018"
"49910","510269 CANABRAVA DO NORTE",0,0,2,69,0,71,"2018"
"49911","510270 CANARANA",1,0,0,422,42,465,"2018"
"49912","510279 CARLINDA",0,0,1,127,0,128,"2018"
"49913","510285 CASTANHEIRA",0,0,0,107,0,107,"2018"
"49914","510300 CHAPADA DOS GUIMARAES",1,1,5,219,1,227,"2018"
"49915","510305 CLAUDIA",0,0,1,112,0,113,"2018"
"49916","510310 COCALINHO",0,0,1,65,1,67,"2018"
"49917","510320 COLIDER",0,0,10,490,0,500,"2018"
"49918","510325 COLNIZA",0,2,10,450,1,463,"2018"
"49919","510330 COMODORO",0,3,3,362,3,371,"2018"
"49920","510335 CONFRESA",0,1,6,523,9,539,"2018"
"49921","510336 CONQUISTA D'OESTE",0,0,0,67,0,67,"2018"
"49922","510337 COTRIGUACU",0,0,3,202,1,206,"2018"
"49923","510340 CUIABA",32,29,127,10230,9,10427,"2018"
"49924","510343 CURVELANDIA",0,0,1,63,0,64,"2018"
"49925","510345 DENISE",0,0,1,96,0,97,"2018"
"49926","510350 DIAMANTINO",1,0,4,369,0,374,"2018"
"49927","510360 DOM AQUINO",1,0,0,73,0,74,"2018"
"49928","510370 FELIZ NATAL",0,0,4,171,8,183,"2018"
"49929","510380 FIGUEIROPOLIS D'OESTE",0,0,0,61,1,62,"2018"
"49930","510385 GAUCHA DO NORTE",0,0,1,126,7,134,"2018"
"49931","510390 GENERAL CARNEIRO",0,1,0,132,9,142,"2018"
"49932","510395 GLORIA D'OESTE",1,0,0,34,0,35,"2018"
"49933","510410 GUARANTA DO NORTE",1,1,12,582,0,596,"2018"
"49934","510420 GUIRATINGA",0,0,1,97,0,98,"2018"
"49935","510450 INDIAVAI",0,0,0,33,0,33,"2018"
"49936","510452 IPIRANGA DO NORTE",0,1,2,102,0,105,"2018"
"49937","510454 ITANHANGA",0,0,0,93,0,93,"2018"
"49938","510455 ITAUBA",0,3,0,99,0,102,"2018"
"49939","510460 ITIQUIRA",1,0,1,167,0,169,"2018"
"49940","510480 JACIARA",0,0,2,453,1,456,"2018"
"49941","510490 JANGADA",0,0,1,107,0,108,"2018"
"49942","510500 JAURU",0,0,0,111,0,111,"2018"
"49943","510510 JUARA",1,1,1,619,0,622,"2018"
"49944","510515 JUINA",5,5,8,736,3,757,"2018"
"49945","510517 JURUENA",0,0,1,132,1,134,"2018"
"49946","510520 JUSCIMEIRA",1,0,0,133,2,136,"2018"
"49947","510523 LAMBARI D'OESTE",0,1,0,95,0,96,"2018"
"49948","510525 LUCAS DO RIO VERDE",2,4,19,1436,0,1461,"2018"
"49949","510530 LUCIARA",1,0,0,38,0,39,"2018"
"49950","510550 VILA BELA DA SANTISSIMA TRINDADE",0,2,0,247,13,262,"2018"
"49951","510558 MARCELANDIA",0,4,10,158,2,174,"2018"
"49952","510560 MATUPA",2,0,4,351,0,357,"2018"
"49953","510562 MIRASSOL D'OESTE",0,0,4,401,0,405,"2018"
"49954","510590 NOBRES",4,2,1,292,0,299,"2018"
"49955","510600 NORTELANDIA",0,1,0,94,1,96,"2018"
"49956","510610 NOSSA SENHORA DO LIVRAMENTO",0,1,0,125,1,127,"2018"
"49957","510615 NOVA BANDEIRANTES",0,2,3,180,0,185,"2018"
"49958","510617 NOVA NAZARE",0,0,0,46,33,79,"2018"
"49959","510618 NOVA LACERDA",0,0,1,80,0,81,"2018"
"49960","510619 NOVA SANTA HELENA",0,0,1,59,0,60,"2018"
"49961","510620 NOVA BRASILANDIA",0,1,0,40,0,41,"2018"
"49962","510621 NOVA CANAA DO NORTE",0,1,2,204,0,207,"2018"
"49963","510622 NOVA MUTUM",2,8,9,1061,0,1080,"2018"
"49964","510623 NOVA OLIMPIA",0,2,0,261,0,263,"2018"
"49965","510624 NOVA UBIRATA",0,0,0,176,0,176,"2018"
"49966","510625 NOVA XAVANTINA",0,2,1,334,0,337,"2018"
"49967","510626 NOVO MUNDO",0,0,2,98,0,100,"2018"
"49968","510627 NOVO HORIZONTE DO NORTE",0,0,1,41,0,42,"2018"
"49969","510628 NOVO SAO JOAQUIM",0,0,1,93,1,95,"2018"
"49970","510629 PARANAITA",0,0,3,190,0,193,"2018"
"49971","510630 PARANATINGA",1,1,2,382,10,396,"2018"
"49972","510631 NOVO SANTO ANTONIO",0,0,0,29,0,29,"2018"
"49973","510637 PEDRA PRETA",1,1,1,254,2,259,"2018"
"49974","510642 PEIXOTO DE AZEVEDO",2,2,12,583,0,599,"2018"
"49975","510645 PLANALTO DA SERRA",0,0,0,40,0,40,"2018"
"49976","510650 POCONE",0,1,6,461,3,471,"2018"
"49977","510665 PONTAL DO ARAGUAIA",0,0,0,83,0,83,"2018"
"49978","510670 PONTE BRANCA",0,0,3,16,0,19,"2018"
"49979","510675 PONTES E LACERDA",0,2,9,849,2,862,"2018"
"49980","510677 PORTO ALEGRE DO NORTE",0,1,1,149,2,153,"2018"
"49981","510680 PORTO DOS GAUCHOS",0,0,2,74,0,76,"2018"
"49982","510682 PORTO ESPERIDIAO",0,1,0,149,1,151,"2018"
"49983","510685 PORTO ESTRELA",0,0,0,45,0,45,"2018"
"49984","510700 POXOREO",0,0,2,220,1,223,"2018"
"49985","510704 PRIMAVERA DO LESTE",2,5,9,1420,3,1439,"2018"
"49986","510706 QUERENCIA",1,1,3,422,9,436,"2018"
"49987","510710 SAO JOSE DOS QUATRO MARCOS",0,0,2,275,0,277,"2018"
"49988","510715 RESERVA DO CABACAL",0,0,0,36,0,36,"2018"
"49989","510718 RIBEIRAO CASCALHEIRA",0,0,1,131,33,165,"2018"
"49990","510719 RIBEIRAOZINHO",0,1,0,32,0,33,"2018"
"49991","510720 RIO BRANCO",1,1,1,85,0,88,"2018"
"49992","510724 SANTA CARMEM",0,1,1,89,0,91,"2018"
"49993","510726 SANTO AFONSO",0,0,0,36,0,36,"2018"
"49994","510729 SAO JOSE DO POVO",0,0,0,26,0,26,"2018"
"49995","510730 SAO JOSE DO RIO CLARO",0,0,0,258,0,258,"2018"
"49996","510735 SAO JOSE DO XINGU",0,0,2,104,3,109,"2018"
"49997","510740 SAO PEDRO DA CIPA",0,0,1,72,0,73,"2018"
"49998","510757 RONDOLANDIA",0,0,0,24,0,24,"2018"
"49999","510760 RONDONOPOLIS",15,12,34,3994,14,4069,"2018"
"50000","510770 ROSARIO OESTE",1,0,3,159,0,163,"2018"
"50001","510774 SANTA CRUZ DO XINGU",0,0,0,35,1,36,"2018"
"50002","510775 SALTO DO CEU",0,0,1,53,0,54,"2018"
"50003","510776 SANTA RITA DO TRIVELATO",0,0,0,44,0,44,"2018"
"50004","510777 SANTA TEREZINHA",0,0,1,88,1,90,"2018"
"50005","510779 SANTO ANTONIO DO LESTE",0,0,0,49,8,57,"2018"
"50006","510780 SANTO ANTONIO DO LEVERGER",2,2,4,236,0,244,"2018"
"50007","510785 SAO FELIX DO ARAGUAIA",2,1,1,136,0,140,"2018"
"50008","510787 SAPEZAL",1,3,11,565,0,580,"2018"
"50009","510788 SERRA NOVA DOURADA",0,0,0,18,0,18,"2018"
"50010","510790 SINOP",4,5,22,3015,0,3046,"2018"
"50011","510792 SORRISO",2,4,23,1869,1,1899,"2018"
"50012","510794 TABAPORA",1,0,2,109,0,112,"2018"
"50013","510795 TANGARA DA SERRA",4,3,27,1598,2,1634,"2018"
"50014","510800 TAPURAH",1,0,7,209,0,217,"2018"
"50015","510805 TERRA NOVA DO NORTE",0,0,2,157,0,159,"2018"
"50016","510810 TESOURO",0,0,0,20,2,22,"2018"
"50017","510820 TORIXOREU",0,0,0,45,0,45,"2018"
"50018","510830 UNIAO DO SUL",0,0,3,46,0,49,"2018"
"50019","510835 VALE DE SAO DOMINGOS",0,0,0,37,1,38,"2018"
"50020","510840 VARZEA GRANDE",15,20,53,4806,29,4923,"2018"
"50021","510850 VERA",0,0,2,165,0,167,"2018"
"50022","510860 VILA RICA",2,0,2,313,3,320,"2018"
"50023","510880 NOVA GUARITA",0,0,0,64,0,64,"2018"
"50024","510885 NOVA MARILANDIA",0,0,0,57,0,57,"2018"
"50025","510890 NOVA MARINGA",0,0,0,80,0,80,"2018"
"50026","510895 NOVA MONTE VERDE",1,0,1,129,0,131,"2018"
"50027","MUNICIPIO IGNORADO - GO",0,0,0,6,0,6,"2018"
"50028","520005 ABADIA DE GOIAS",0,3,2,209,3,217,"2018"
"50029","520010 ABADIANIA",1,0,3,172,0,176,"2018"
"50030","520013 ACREUNA",1,2,68,197,0,268,"2018"
"50031","520015 ADELANDIA",0,0,0,26,1,27,"2018"
"50032","520017 AGUA FRIA DE GOIAS",0,0,0,55,0,55,"2018"
"50033","520020 AGUA LIMPA",0,0,0,13,1,14,"2018"
"50034","520025 AGUAS LINDAS DE GOIAS",10,10,59,2416,179,2674,"2018"
"50035","520030 ALEXANIA",0,3,5,404,2,414,"2018"
"50036","520050 ALOANDIA",0,0,0,9,0,9,"2018"
"50037","520055 ALTO HORIZONTE",0,0,4,87,1,92,"2018"
"50038","520060 ALTO PARAISO DE GOIAS",1,1,1,110,8,121,"2018"
"50039","520080 ALVORADA DO NORTE",0,0,3,124,0,127,"2018"
"50040","520082 AMARALINA",0,0,1,12,0,13,"2018"
"50041","520085 AMERICANO DO BRASIL",0,0,1,80,0,81,"2018"
"50042","520090 AMORINOPOLIS",0,0,0,38,0,38,"2018"
"50043","520110 ANAPOLIS",15,19,78,5963,10,6085,"2018"
"50044","520120 ANHANGUERA",0,0,0,5,0,5,"2018"
"50045","520130 ANICUNS",0,0,0,219,1,220,"2018"
"50046","520140 APARECIDA DE GOIANIA",23,21,104,7692,56,7896,"2018"
"50047","520145 APARECIDA DO RIO DOCE",0,0,0,31,0,31,"2018"
"50048","520150 APORE",0,1,3,59,0,63,"2018"
"50049","520160 ARACU",1,0,0,42,0,43,"2018"
"50050","520170 ARAGARCAS",0,0,5,247,0,252,"2018"
"50051","520180 ARAGOIANIA",0,1,2,133,0,136,"2018"
"50052","520215 ARAGUAPAZ",0,0,1,90,0,91,"2018"
"50053","520235 ARENOPOLIS",0,0,0,44,0,44,"2018"
"50054","520250 ARUANA",1,0,1,115,0,117,"2018"
"50055","520260 AURILANDIA",0,0,2,33,0,35,"2018"
"50056","520280 AVELINOPOLIS",0,0,0,26,0,26,"2018"
"50057","520310 BALIZA",0,1,0,29,0,30,"2018"
"50058","520320 BARRO ALTO",0,0,5,145,0,150,"2018"
"50059","520330 BELA VISTA DE GOIAS",3,0,7,452,1,463,"2018"
"50060","520340 BOM JARDIM DE GOIAS",0,0,0,133,1,134,"2018"
"50061","520350 BOM JESUS DE GOIAS",1,3,4,325,1,334,"2018"
"50062","520355 BONFINOPOLIS",0,0,0,117,0,117,"2018"
"50063","520357 BONOPOLIS",0,0,0,36,0,36,"2018"
"50064","520360 BRAZABRANTES",0,0,0,45,1,46,"2018"
"50065","520380 BRITANIA",0,0,0,82,0,82,"2018"
"50066","520390 BURITI ALEGRE",0,0,0,117,1,118,"2018"
"50067","520393 BURITI DE GOIAS",0,0,0,47,0,47,"2018"
"50068","520396 BURITINOPOLIS",0,0,0,51,0,51,"2018"
"50069","520400 CABECEIRAS",0,1,3,106,2,112,"2018"
"50070","520410 CACHOEIRA ALTA",0,0,1,136,0,137,"2018"
"50071","520420 CACHOEIRA DE GOIAS",0,0,0,13,0,13,"2018"
"50072","520425 CACHOEIRA DOURADA",0,0,0,87,0,87,"2018"
"50073","520430 CACU",0,1,2,178,1,182,"2018"
"50074","520440 CAIAPONIA",1,1,5,207,0,214,"2018"
"50075","520450 CALDAS NOVAS",2,7,11,1397,0,1417,"2018"
"50076","520455 CALDAZINHA",0,0,0,46,0,46,"2018"
"50077","520460 CAMPESTRE DE GOIAS",0,1,0,60,0,61,"2018"
"50078","520465 CAMPINACU",0,0,0,37,0,37,"2018"
"50079","520470 CAMPINORTE",0,0,2,170,0,172,"2018"
"50080","520480 CAMPO ALEGRE DE GOIAS",0,0,0,85,1,86,"2018"
"50081","520485 CAMPO LIMPO DE GOIAS",0,1,0,117,0,118,"2018"
"50082","520490 CAMPOS BELOS",0,1,7,312,0,320,"2018"
"50083","520495 CAMPOS VERDES",0,0,0,48,1,49,"2018"
"50084","520500 CARMO DO RIO VERDE",0,0,1,114,0,115,"2018"
"50085","520505 CASTELANDIA",0,0,0,31,0,31,"2018"
"50086","520510 CATALAO",3,4,10,1435,2,1454,"2018"
"50087","520520 CATURAI",0,0,1,61,0,62,"2018"
"50088","520530 CAVALCANTE",0,1,4,144,0,149,"2018"
"50089","520540 CERES",0,2,9,281,0,292,"2018"
"50090","520545 CEZARINA",0,0,1,130,0,131,"2018"
"50091","520547 CHAPADAO DO CEU",0,0,3,235,0,238,"2018"
"50092","520549 CIDADE OCIDENTAL",1,3,20,1032,20,1076,"2018"
"50093","520551 COCALZINHO DE GOIAS",1,1,5,194,19,220,"2018"
"50094","520552 COLINAS DO SUL",0,1,2,35,0,38,"2018"
"50095","520570 CORREGO DO OURO",0,0,0,29,0,29,"2018"
"50096","520580 CORUMBA DE GOIAS",0,1,2,83,1,87,"2018"
"50097","520590 CORUMBAIBA",0,0,0,102,0,102,"2018"
"50098","520620 CRISTALINA",1,7,12,938,7,965,"2018"
"50099","520630 CRISTIANOPOLIS",0,0,0,36,0,36,"2018"
"50100","520640 CRIXAS",1,1,2,217,0,221,"2018"
"50101","520650 CROMINIA",0,0,0,28,0,28,"2018"
"50102","520660 CUMARI",0,0,2,32,0,34,"2018"
"50103","520670 DAMIANOPOLIS",0,0,0,59,0,59,"2018"
"50104","520680 DAMOLANDIA",0,0,0,21,0,21,"2018"
"50105","520690 DAVINOPOLIS",0,0,0,24,0,24,"2018"
"50106","520710 DIORAMA",0,0,0,16,0,16,"2018"
"50107","520725 DOVERLANDIA",0,1,4,84,0,89,"2018"
"50108","520735 EDEALINA",0,0,0,50,0,50,"2018"
"50109","520740 EDEIA",0,2,3,171,0,176,"2018"
"50110","520750 ESTRELA DO NORTE",0,0,0,38,0,38,"2018"
"50111","520753 FAINA",0,0,0,45,1,46,"2018"
"50112","520760 FAZENDA NOVA",0,0,1,55,0,56,"2018"
"50113","520780 FIRMINOPOLIS",0,0,0,89,0,89,"2018"
"50114","520790 FLORES DE GOIAS",1,1,2,96,2,102,"2018"
"50115","520800 FORMOSA",9,10,27,1775,6,1827,"2018"
"50116","520810 FORMOSO",0,0,0,54,0,54,"2018"
"50117","520815 GAMELEIRA DE GOIAS",0,0,0,37,0,37,"2018"
"50118","520830 DIVINOPOLIS DE GOIAS",1,0,1,76,0,78,"2018"
"50119","520840 GOIANAPOLIS",0,1,2,211,0,214,"2018"
"50120","520850 GOIANDIRA",0,0,1,52,0,53,"2018"
"50121","520860 GOIANESIA",3,2,14,1044,0,1063,"2018"
"50122","520870 GOIANIA",69,57,266,20973,88,21453,"2018"
"50123","520880 GOIANIRA",5,3,19,917,1,945,"2018"
"50124","520890 GOIAS",2,1,9,462,2,476,"2018"
"50125","520910 GOIATUBA",1,2,0,437,3,443,"2018"
"50126","520915 GOUVELANDIA",3,0,0,48,0,51,"2018"
"50127","520920 GUAPO",0,0,1,227,0,228,"2018"
"50128","520929 GUARAITA",0,0,0,19,0,19,"2018"
"50129","520940 GUARANI DE GOIAS",0,0,1,36,0,37,"2018"
"50130","520945 GUARINOS",0,0,0,20,0,20,"2018"
"50131","520960 HEITORAI",0,0,0,39,0,39,"2018"
"50132","520970 HIDROLANDIA",1,0,3,331,0,335,"2018"
"50133","520980 HIDROLINA",0,0,1,46,0,47,"2018"
"50134","520990 IACIARA",0,1,1,126,0,128,"2018"
"50135","520993 INACIOLANDIA",1,1,0,53,0,55,"2018"
"50136","520995 INDIARA",1,0,2,243,0,246,"2018"
"50137","521000 INHUMAS",5,4,11,690,1,711,"2018"
"50138","521010 IPAMERI",1,1,2,335,2,341,"2018"
"50139","521015 IPIRANGA DE GOIAS",0,0,0,23,0,23,"2018"
"50140","521020 IPORA",2,1,7,365,0,375,"2018"
"50141","521030 ISRAELANDIA",0,0,0,20,0,20,"2018"
"50142","521040 ITABERAI",1,4,8,593,1,607,"2018"
"50143","521056 ITAGUARI",0,0,2,52,0,54,"2018"
"50144","521060 ITAGUARU",0,2,0,52,0,54,"2018"
"50145","521080 ITAJA",0,1,0,60,0,61,"2018"
"50146","521090 ITAPACI",0,1,6,304,0,311,"2018"
"50147","521100 ITAPIRAPUA",0,0,0,84,0,84,"2018"
"50148","521120 ITAPURANGA",3,2,2,367,0,374,"2018"
"50149","521130 ITARUMA",0,1,0,87,0,88,"2018"
"50150","521140 ITAUCU",1,1,0,84,0,86,"2018"
"50151","521150 ITUMBIARA",2,10,25,1463,3,1503,"2018"
"50152","521160 IVOLANDIA",0,0,0,25,1,26,"2018"
"50153","521170 JANDAIA",0,0,1,69,0,70,"2018"
"50154","521180 JARAGUA",2,4,9,560,0,575,"2018"
"50155","521190 JATAI",5,9,14,1508,0,1536,"2018"
"50156","521200 JAUPACI",0,0,1,30,0,31,"2018"
"50157","521205 JESUPOLIS",0,0,0,25,0,25,"2018"
"50158","521210 JOVIANIA",0,1,0,78,0,79,"2018"
"50159","521220 JUSSARA",1,1,6,251,1,260,"2018"
"50160","521225 LAGOA SANTA",0,0,0,9,0,9,"2018"
"50161","521230 LEOPOLDO DE BULHOES",1,0,2,107,0,110,"2018"
"50162","521250 LUZIANIA",9,11,50,2869,58,2997,"2018"
"50163","521260 MAIRIPOTABA",0,0,0,28,0,28,"2018"
"50164","521270 MAMBAI",1,0,0,124,0,125,"2018"
"50165","521280 MARA ROSA",0,0,3,124,0,127,"2018"
"50166","521290 MARZAGAO",0,1,1,33,0,35,"2018"
"50167","521295 MATRINCHA",0,1,0,57,0,58,"2018"
"50168","521300 MAURILANDIA",0,0,1,187,0,188,"2018"
"50169","521305 MIMOSO DE GOIAS",2,0,0,4,8,14,"2018"
"50170","521308 MINACU",0,1,2,399,0,402,"2018"
"50171","521310 MINEIROS",1,6,4,1154,1,1166,"2018"
"50172","521340 MOIPORA",0,0,0,11,0,11,"2018"
"50173","521350 MONTE ALEGRE DE GOIAS",0,1,2,98,0,101,"2018"
"50174","521370 MONTES CLAROS DE GOIAS",0,1,1,116,0,118,"2018"
"50175","521375 MONTIVIDIU",1,0,2,172,0,175,"2018"
"50176","521377 MONTIVIDIU DO NORTE",0,0,0,51,0,51,"2018"
"50177","521380 MORRINHOS",2,2,4,622,2,632,"2018"
"50178","521385 MORRO AGUDO DE GOIAS",0,0,1,23,1,25,"2018"
"50179","521390 MOSSAMEDES",0,0,1,57,1,59,"2018"
"50180","521400 MOZARLANDIA",1,0,1,237,1,240,"2018"
"50181","521405 MUNDO NOVO",0,0,0,80,0,80,"2018"
"50182","521410 MUTUNOPOLIS",0,0,0,48,0,48,"2018"
"50183","521440 NAZARIO",1,0,3,84,0,88,"2018"
"50184","521450 NEROPOLIS",1,2,9,466,1,479,"2018"
"50185","521460 NIQUELANDIA",0,5,13,441,0,459,"2018"
"50186","521470 NOVA AMERICA",0,0,0,27,0,27,"2018"
"50187","521480 NOVA AURORA",0,0,1,17,0,18,"2018"
"50188","521483 NOVA CRIXAS",0,0,0,178,0,178,"2018"
"50189","521486 NOVA GLORIA",0,0,1,93,0,94,"2018"
"50190","521487 NOVA IGUACU DE GOIAS",0,0,0,32,0,32,"2018"
"50191","521490 NOVA ROMA",0,1,2,42,0,45,"2018"
"50192","521500 NOVA VENEZA",0,0,1,97,0,98,"2018"
"50193","521520 NOVO BRASIL",0,0,1,57,0,58,"2018"
"50194","521523 NOVO GAMA",4,3,31,1437,26,1501,"2018"
"50195","521525 NOVO PLANALTO",0,0,2,47,0,49,"2018"
"50196","521530 ORIZONA",1,1,1,203,0,206,"2018"
"50197","521540 OURO VERDE DE GOIAS",0,1,0,44,1,46,"2018"
"50198","521550 OUVIDOR",0,0,1,78,0,79,"2018"
"50199","521560 PADRE BERNARDO",1,3,5,117,315,441,"2018"
"50200","521565 PALESTINA DE GOIAS",0,0,0,31,0,31,"2018"
"50201","521570 PALMEIRAS DE GOIAS",0,4,5,427,0,436,"2018"
"50202","521580 PALMELO",0,0,0,19,0,19,"2018"
"50203","521590 PALMINOPOLIS",0,1,0,43,0,44,"2018"
"50204","521600 PANAMA",0,0,0,28,0,28,"2018"
"50205","521630 PARANAIGUARA",1,0,0,93,0,94,"2018"
"50206","521640 PARAUNA",2,0,7,162,0,171,"2018"
"50207","521645 PEROLANDIA",0,0,0,33,0,33,"2018"
"50208","521680 PETROLINA DE GOIAS",0,0,1,98,0,99,"2018"
"50209","521690 PILAR DE GOIAS",0,0,0,24,0,24,"2018"
"50210","521710 PIRACANJUBA",0,0,6,235,0,241,"2018"
"50211","521720 PIRANHAS",1,1,5,123,0,130,"2018"
"50212","521730 PIRENOPOLIS",2,3,3,335,1,344,"2018"
"50213","521740 PIRES DO RIO",4,0,8,351,1,364,"2018"
"50214","521760 PLANALTINA",8,4,24,1543,5,1584,"2018"
"50215","521770 PONTALINA",0,0,3,221,0,224,"2018"
"50216","521800 PORANGATU",3,4,18,612,0,637,"2018"
"50217","521805 PORTEIRAO",0,0,0,52,0,52,"2018"
"50218","521810 PORTELANDIA",1,0,1,33,0,35,"2018"
"50219","521830 POSSE",1,3,15,571,1,591,"2018"
"50220","521839 PROFESSOR JAMIL",0,0,1,21,0,22,"2018"
"50221","521850 QUIRINOPOLIS",0,1,5,714,1,721,"2018"
"50222","521860 RIALMA",2,0,2,146,1,151,"2018"
"50223","521870 RIANAPOLIS",0,0,1,70,0,71,"2018"
"50224","521878 RIO QUENTE",1,0,0,53,0,54,"2018"
"50225","521880 RIO VERDE",9,9,39,3444,3,3504,"2018"
"50226","521890 RUBIATABA",0,0,5,243,0,248,"2018"
"50227","521900 SANCLERLANDIA",0,1,2,94,0,97,"2018"
"50228","521910 SANTA BARBARA DE GOIAS",0,0,1,83,0,84,"2018"
"50229","521920 SANTA CRUZ DE GOIAS",0,0,0,23,0,23,"2018"
"50230","521925 SANTA FE DE GOIAS",0,0,0,73,0,73,"2018"
"50231","521930 SANTA HELENA DE GOIAS",1,2,10,534,0,547,"2018"
"50232","521935 SANTA ISABEL",0,0,0,34,0,34,"2018"
"50233","521940 SANTA RITA DO ARAGUAIA",0,0,0,75,0,75,"2018"
"50234","521945 SANTA RITA DO NOVO DESTINO",0,0,0,29,0,29,"2018"
"50235","521950 SANTA ROSA DE GOIAS",0,2,0,47,0,49,"2018"
"50236","521960 SANTA TEREZA DE GOIAS",0,0,2,44,0,46,"2018"
"50237","521970 SANTA TEREZINHA DE GOIAS",1,0,2,105,0,108,"2018"
"50238","521971 SANTO ANTONIO DA BARRA",0,0,1,43,1,45,"2018"
"50239","521973 SANTO ANTONIO DE GOIAS",0,1,3,124,0,128,"2018"
"50240","521975 SANTO ANTONIO DO DESCOBERTO",3,6,11,1016,11,1047,"2018"
"50241","521980 SAO DOMINGOS",1,1,2,118,1,123,"2018"
"50242","521990 SAO FRANCISCO DE GOIAS",0,0,0,65,1,66,"2018"
"50243","522000 SAO JOAO D'ALIANCA",2,1,2,173,0,178,"2018"
"50244","522005 SAO JOAO DA PARAUNA",0,0,0,13,0,13,"2018"
"50245","522010 SAO LUIS DE MONTES BELOS",1,1,4,434,0,440,"2018"
"50246","522015 SAO LUIZ DO NORTE",0,0,1,61,0,62,"2018"
"50247","522020 SAO MIGUEL DO ARAGUAIA",0,2,4,317,1,324,"2018"
"50248","522026 SAO MIGUEL DO PASSA QUATRO",0,1,0,32,0,33,"2018"
"50249","522028 SAO PATRICIO",0,0,1,21,0,22,"2018"
"50250","522040 SAO SIMAO",2,2,1,239,0,244,"2018"
"50251","522045 SENADOR CANEDO",1,8,42,2350,2,2403,"2018"
"50252","522050 SERRANOPOLIS",0,1,1,78,0,80,"2018"
"50253","522060 SILVANIA",0,0,2,220,1,223,"2018"
"50254","522068 SIMOLANDIA",0,1,6,91,0,98,"2018"
"50255","522070 SITIO D'ABADIA",0,0,0,27,0,27,"2018"
"50256","522100 TAQUARAL DE GOIAS",0,0,0,36,0,36,"2018"
"50257","522108 TERESINA DE GOIAS",0,0,0,42,0,42,"2018"
"50258","522119 TEREZOPOLIS DE GOIAS",0,0,2,102,1,105,"2018"
"50259","522130 TRES RANCHOS",0,0,0,23,0,23,"2018"
"50260","522140 TRINDADE",3,6,18,2082,10,2119,"2018"
"50261","522145 TROMBAS",0,1,1,30,0,32,"2018"
"50262","522150 TURVANIA",0,0,1,60,0,61,"2018"
"50263","522155 TURVELANDIA",0,0,1,81,0,82,"2018"
"50264","522157 UIRAPURU",0,0,0,22,0,22,"2018"
"50265","522160 URUACU",1,4,19,532,0,556,"2018"
"50266","522170 URUANA",1,0,4,144,0,149,"2018"
"50267","522180 URUTAI",0,0,0,23,0,23,"2018"
"50268","522185 VALPARAISO DE GOIAS",7,13,46,2425,36,2527,"2018"
"50269","522190 VARJAO",0,0,0,30,0,30,"2018"
"50270","522200 VIANOPOLIS",1,0,1,206,0,208,"2018"
"50271","522205 VICENTINOPOLIS",1,0,0,125,0,126,"2018"
"50272","522220 VILA BOA",0,1,1,55,0,57,"2018"
"50273","522230 VILA PROPICIO",0,1,1,51,0,53,"2018"
"50274","530010 BRASILIA",125,178,678,42081,1133,44195,"2018"
"50275","TOTAL",7529,10855,40899,2743479,46384,2849146,"2019"
"50276","MUNICIPIO IGNORADO - RO",0,0,0,1,0,1,"2019"
"50277","110001 ALTA FLORESTA D'OESTE",2,0,2,363,0,367,"2019"
"50278","110002 ARIQUEMES",3,9,23,1694,0,1729,"2019"
"50279","110003 CABIXI",0,0,0,80,0,80,"2019"
"50280","110004 CACOAL",0,3,12,1358,1,1374,"2019"
"50281","110005 CEREJEIRAS",1,1,1,232,2,237,"2019"
"50282","110006 COLORADO DO OESTE",0,0,3,211,0,214,"2019"
"50283","110007 CORUMBIARA",0,0,1,126,0,127,"2019"
"50284","110008 COSTA MARQUES",1,1,12,218,1,233,"2019"
"50285","110009 ESPIGAO D'OESTE",3,2,8,435,2,450,"2019"
"50286","110010 GUAJARA-MIRIM",3,0,9,755,14,781,"2019"
"50287","110011 JARU",2,1,10,868,0,881,"2019"
"50288","110012 JI-PARANA",6,6,36,2133,1,2182,"2019"
"50289","110013 MACHADINHO D'OESTE",2,5,12,476,5,500,"2019"
"50290","110014 NOVA BRASILANDIA D'OESTE",3,4,4,250,0,261,"2019"
"50291","110015 OURO PRETO DO OESTE",0,2,18,609,2,631,"2019"
"50292","110018 PIMENTA BUENO",1,4,8,603,0,616,"2019"
"50293","110020 PORTO VELHO",15,25,69,8276,52,8437,"2019"
"50294","110025 PRESIDENTE MEDICI",1,1,5,296,1,304,"2019"
"50295","110026 RIO CRESPO",0,0,2,48,0,50,"2019"
"50296","110028 ROLIM DE MOURA",4,0,7,915,1,927,"2019"
"50297","110029 SANTA LUZIA D'OESTE",0,0,1,98,0,99,"2019"
"50298","110030 VILHENA",4,1,7,1572,6,1590,"2019"
"50299","110032 SAO MIGUEL DO GUAPORE",1,3,4,345,0,353,"2019"
"50300","110033 NOVA MAMORE",0,0,4,427,1,432,"2019"
"50301","110034 ALVORADA D'OESTE",0,1,4,200,0,205,"2019"
"50302","110037 ALTO ALEGRE DOS PARECIS",1,0,1,152,0,154,"2019"
"50303","110040 ALTO PARAISO",0,1,0,225,0,226,"2019"
"50304","110045 BURITIS",1,1,3,577,1,583,"2019"
"50305","110050 NOVO HORIZONTE DO OESTE",0,0,0,98,0,98,"2019"
"50306","110060 CACAULANDIA",0,1,2,72,0,75,"2019"
"50307","110070 CAMPO NOVO DE RONDONIA",0,1,5,160,0,166,"2019"
"50308","110080 CANDEIAS DO JAMARI",0,0,1,331,5,337,"2019"
"50309","110090 CASTANHEIRAS",0,1,0,31,0,32,"2019"
"50310","110092 CHUPINGUAIA",1,0,2,157,2,162,"2019"
"50311","110094 CUJUBIM",0,0,7,198,0,205,"2019"
"50312","110100 GOVERNADOR JORGE TEIXEIRA",0,0,1,111,0,112,"2019"
"50313","110110 ITAPUA DO OESTE",0,0,1,107,1,109,"2019"
"50314","110120 MINISTRO ANDREAZZA",0,0,2,82,0,84,"2019"
"50315","110130 MIRANTE DA SERRA",0,1,5,158,0,164,"2019"
"50316","110140 MONTE NEGRO",0,2,4,193,0,199,"2019"
"50317","110143 NOVA UNIAO",1,1,5,97,0,104,"2019"
"50318","110145 PARECIS",0,0,0,44,0,44,"2019"
"50319","110146 PIMENTEIRAS DO OESTE",0,0,0,40,0,40,"2019"
"50320","110147 PRIMAVERA DE RONDONIA",1,0,0,42,0,43,"2019"
"50321","110148 SAO FELIPE D'OESTE",0,0,0,54,0,54,"2019"
"50322","110149 SAO FRANCISCO DO GUAPORE",1,3,12,286,1,303,"2019"
"50323","110150 SERINGUEIRAS",0,0,4,164,0,168,"2019"
"50324","110155 TEIXEIROPOLIS",0,0,1,63,0,64,"2019"
"50325","110160 THEOBROMA",0,0,0,97,0,97,"2019"
"50326","110170 URUPA",0,0,2,164,4,170,"2019"
"50327","110175 VALE DO ANARI",1,1,0,91,0,93,"2019"
"50328","110180 VALE DO PARAISO",0,1,0,80,0,81,"2019"
"50329","120001 ACRELANDIA",2,1,2,250,2,257,"2019"
"50330","120005 ASSIS BRASIL",1,1,3,236,25,266,"2019"
"50331","120010 BRASILEIA",1,2,4,529,4,540,"2019"
"50332","120013 BUJARI",4,0,7,312,6,329,"2019"
"50333","120017 CAPIXABA",5,3,4,201,4,217,"2019"
"50334","120020 CRUZEIRO DO SUL",5,9,22,1757,16,1809,"2019"
"50335","120025 EPITACIOLANDIA",4,1,4,303,2,314,"2019"
"50336","120030 FEIJO",2,2,3,737,127,871,"2019"
"50337","120032 JORDAO",0,0,5,122,91,218,"2019"
"50338","120033 MANCIO LIMA",0,4,5,334,2,345,"2019"
"50339","120034 MANOEL URBANO",1,2,3,221,3,230,"2019"
"50340","120035 MARECHAL THAUMATURGO",3,1,3,269,172,448,"2019"
"50341","120038 PLACIDO DE CASTRO",1,1,2,310,4,318,"2019"
"50342","120039 PORTO WALTER",2,0,5,261,2,270,"2019"
"50343","120040 RIO BRANCO",38,20,73,6143,50,6324,"2019"
"50344","120042 RODRIGUES ALVES",0,4,3,318,9,334,"2019"
"50345","120043 SANTA ROSA DO PURUS",1,1,3,121,60,186,"2019"
"50346","120045 SENADOR GUIOMARD",2,1,5,403,6,417,"2019"
"50347","120050 SENA MADUREIRA",3,4,12,740,9,768,"2019"
"50348","120060 TARAUACA",5,9,19,1014,96,1143,"2019"
"50349","120070 XAPURI",0,4,2,285,6,297,"2019"
"50350","120080 PORTO ACRE",1,0,7,367,4,379,"2019"
"50351","MUNICIPIO IGNORADO - AM",0,0,0,12,0,12,"2019"
"50352","130002 ALVARAES",0,3,4,410,1,418,"2019"
"50353","130006 AMATURA",0,0,2,168,95,265,"2019"
"50354","130008 ANAMA",0,2,0,188,0,190,"2019"
"50355","130010 ANORI",0,0,0,225,8,233,"2019"
"50356","130014 APUI",3,2,0,234,0,239,"2019"
"50357","130020 ATALAIA DO NORTE",1,0,0,186,126,313,"2019"
"50358","130030 AUTAZES",2,7,14,783,66,872,"2019"
"50359","130040 BARCELOS",2,2,2,309,241,556,"2019"
"50360","130050 BARREIRINHA",0,2,5,720,130,857,"2019"
"50361","130060 BENJAMIN CONSTANT",1,1,10,1015,3,1030,"2019"
"50362","130063 BERURI",1,0,8,423,93,525,"2019"
"50363","130068 BOA VISTA DO RAMOS",0,3,5,322,0,330,"2019"
"50364","130070 BOCA DO ACRE",3,4,3,712,3,725,"2019"
"50365","130080 BORBA",0,2,11,714,36,763,"2019"
"50366","130083 CAAPIRANGA",0,2,2,163,2,169,"2019"
"50367","130090 CANUTAMA",1,2,1,186,2,192,"2019"
"50368","130100 CARAUARI",1,9,48,280,297,635,"2019"
"50369","130110 CAREIRO",1,4,8,532,19,564,"2019"
"50370","130115 CAREIRO DA VARZEA",1,0,2,176,19,198,"2019"
"50371","130120 COARI",2,7,13,1676,0,1698,"2019"
"50372","130130 CODAJAS",2,3,2,460,1,468,"2019"
"50373","130140 EIRUNEPE",2,4,22,652,112,792,"2019"
"50374","130150 ENVIRA",1,1,5,365,19,391,"2019"
"50375","130160 FONTE BOA",1,2,9,566,1,579,"2019"
"50376","130165 GUAJARA",0,2,4,273,6,285,"2019"
"50377","130170 HUMAITA",0,2,5,970,1,978,"2019"
"50378","130180 IPIXUNA",1,0,4,330,41,376,"2019"
"50379","130185 IRANDUBA",1,3,10,988,19,1021,"2019"
"50380","130190 ITACOATIARA",11,11,23,1932,57,2034,"2019"
"50381","130195 ITAMARATI",0,1,3,184,59,247,"2019"
"50382","130200 ITAPIRANGA",2,0,3,167,1,173,"2019"
"50383","130210 JAPURA",0,1,1,107,12,121,"2019"
"50384","130220 JURUA",0,0,7,225,3,235,"2019"
"50385","130230 JUTAI",0,0,4,571,71,646,"2019"
"50386","130240 LABREA",1,2,43,822,24,892,"2019"
"50387","130250 MANACAPURU",7,2,14,2087,5,2115,"2019"
"50388","130255 MANAQUIRI",1,1,4,268,2,276,"2019"
"50389","130260 MANAUS",70,95,283,37198,293,37939,"2019"
"50390","130270 MANICORE",1,4,36,857,125,1023,"2019"
"50391","130280 MARAA",2,1,1,360,17,381,"2019"
"50392","130290 MAUES",5,10,21,1251,252,1539,"2019"
"50393","130300 NHAMUNDA",0,1,8,297,40,346,"2019"
"50394","130310 NOVA OLINDA DO NORTE",0,1,12,486,47,546,"2019"
"50395","130320 NOVO AIRAO",0,2,2,294,12,310,"2019"
"50396","130330 NOVO ARIPUANA",3,2,6,358,23,392,"2019"
"50397","130340 PARINTINS",6,10,23,1818,90,1947,"2019"
"50398","130350 PAUINI",1,3,10,305,50,369,"2019"
"50399","130353 PRESIDENTE FIGUEIREDO",1,0,6,502,4,513,"2019"
"50400","130356 RIO PRETO DA EVA",1,2,5,424,8,440,"2019"
"50401","130360 SANTA ISABEL DO RIO NEGRO",1,1,8,167,145,322,"2019"
"50402","130370 SANTO ANTONIO DO ICA",0,1,1,608,163,773,"2019"
"50403","130380 SAO GABRIEL DA CACHOEIRA",3,1,5,399,1028,1436,"2019"
"50404","130390 SAO PAULO DE OLIVENCA",0,1,10,453,492,956,"2019"
"50405","130395 SAO SEBASTIAO DO UATUMA",0,2,2,195,1,200,"2019"
"50406","130400 SILVES",1,2,0,222,4,229,"2019"
"50407","130406 TABATINGA",4,2,8,1232,524,1770,"2019"
"50408","130410 TAPAUA",0,1,2,380,49,432,"2019"
"50409","130420 TEFE",7,7,16,1859,38,1927,"2019"
"50410","130423 TONANTINS",0,0,2,412,15,429,"2019"
"50411","130426 UARINI",0,2,11,332,6,351,"2019"
"50412","130430 URUCARA",1,3,2,302,10,318,"2019"
"50413","130440 URUCURITUBA",1,0,1,295,24,321,"2019"
"50414","140002 AMAJARI",6,0,3,207,230,446,"2019"
"50415","140005 ALTO ALEGRE",3,1,3,251,453,711,"2019"
"50416","140010 BOA VISTA",123,22,102,8643,46,8936,"2019"
"50417","140015 BONFIM",17,0,3,370,80,470,"2019"
"50418","140017 CANTA",16,0,3,344,22,385,"2019"
"50419","140020 CARACARAI",6,0,0,383,56,445,"2019"
"50420","140023 CAROEBE",0,1,4,195,4,204,"2019"
"50421","140028 IRACEMA",1,0,1,142,41,185,"2019"
"50422","140030 MUCAJAI",6,0,3,334,29,372,"2019"
"50423","140040 NORMANDIA",9,1,2,377,100,489,"2019"
"50424","140045 PACARAIMA",7,0,3,479,67,556,"2019"
"50425","140047 RORAINOPOLIS",1,1,4,560,1,567,"2019"
"50426","140050 SAO JOAO DA BALIZA",0,2,0,125,4,131,"2019"
"50427","140060 SAO LUIZ",0,0,1,105,1,107,"2019"
"50428","140070 UIRAMUTA",9,2,3,353,249,616,"2019"
"50429","MUNICIPIO IGNORADO - PA",0,0,0,3,0,3,"2019"
"50430","150010 ABAETETUBA",5,7,35,2553,23,2623,"2019"
"50431","150013 ABEL FIGUEIREDO",0,0,0,131,1,132,"2019"
"50432","150020 ACARA",4,7,11,926,32,980,"2019"
"50433","150030 AFUA",2,5,15,973,19,1014,"2019"
"50434","150034 AGUA AZUL DO NORTE",0,2,3,220,0,225,"2019"
"50435","150040 ALENQUER",7,3,9,1135,40,1194,"2019"
"50436","150050 ALMEIRIM",3,1,17,753,5,779,"2019"
"50437","150060 ALTAMIRA",7,7,17,2286,54,2371,"2019"
"50438","150070 ANAJAS",0,2,20,674,141,837,"2019"
"50439","150080 ANANINDEUA",16,26,59,7275,32,7408,"2019"
"50440","150085 ANAPU",0,6,6,639,1,652,"2019"
"50441","150090 AUGUSTO CORREA",5,7,7,741,49,809,"2019"
"50442","150095 AURORA DO PARA",0,1,20,402,2,425,"2019"
"50443","150100 AVEIRO",0,0,1,129,16,146,"2019"
"50444","150110 BAGRE",6,2,8,332,201,549,"2019"
"50445","150120 BAIAO",1,2,7,467,24,501,"2019"
"50446","150125 BANNACH",0,0,1,44,1,46,"2019"
"50447","150130 BARCARENA",7,14,19,2242,12,2294,"2019"
"50448","150140 BELEM",68,57,181,18175,106,18587,"2019"
"50449","150145 BELTERRA",0,5,13,288,8,314,"2019"
"50450","150150 BENEVIDES",6,8,15,964,6,999,"2019"
"50451","150157 BOM JESUS DO TOCANTINS",0,0,2,290,0,292,"2019"
"50452","150160 BONITO",2,0,1,207,0,210,"2019"
"50453","150170 BRAGANCA",2,6,32,2052,35,2127,"2019"
"50454","150172 BRASIL NOVO",1,2,4,318,0,325,"2019"
"50455","150175 BREJO GRANDE DO ARAGUAIA",0,0,4,90,6,100,"2019"
"50456","150178 BREU BRANCO",1,1,13,689,61,765,"2019"
"50457","150180 BREVES",5,11,70,2677,9,2772,"2019"
"50458","150190 BUJARU",0,1,10,434,18,463,"2019"
"50459","150195 CACHOEIRA DO PIRIA",2,1,4,281,21,309,"2019"
"50460","150200 CACHOEIRA DO ARARI",0,7,4,332,0,343,"2019"
"50461","150210 CAMETA",12,33,154,2194,95,2488,"2019"
"50462","150215 CANAA DOS CARAJAS",1,1,7,1164,1,1174,"2019"
"50463","150220 CAPANEMA",3,5,6,1037,8,1059,"2019"
"50464","150230 CAPITAO POCO",4,1,4,927,10,946,"2019"
"50465","150240 CASTANHAL",3,17,33,3284,10,3347,"2019"
"50466","150250 CHAVES",0,2,2,323,15,342,"2019"
"50467","150260 COLARES",2,1,0,140,14,157,"2019"
"50468","150270 CONCEICAO DO ARAGUAIA",1,2,4,696,4,707,"2019"
"50469","150275 CONCORDIA DO PARA",2,1,7,529,7,546,"2019"
"50470","150276 CUMARU DO NORTE",1,0,7,191,1,200,"2019"
"50471","150277 CURIONOPOLIS",4,0,4,303,1,312,"2019"
"50472","150280 CURRALINHO",2,5,15,587,90,699,"2019"
"50473","150285 CURUA",1,0,0,194,44,239,"2019"
"50474","150290 CURUCA",2,3,5,527,11,548,"2019"
"50475","150293 DOM ELISEU",0,2,11,580,3,596,"2019"
"50476","150295 ELDORADO DOS CARAJAS",1,3,8,470,1,483,"2019"
"50477","150300 FARO",0,3,6,114,1,124,"2019"
"50478","150304 FLORESTA DO ARAGUAIA",2,0,1,343,0,346,"2019"
"50479","150307 GARRAFAO DO NORTE",1,1,6,457,22,487,"2019"
"50480","150309 GOIANESIA DO PARA",1,0,1,541,15,558,"2019"
"50481","150310 GURUPA",1,2,8,716,47,774,"2019"
"50482","150320 IGARAPE-ACU",1,1,3,551,1,557,"2019"
"50483","150330 IGARAPE-MIRI",0,8,29,1055,52,1144,"2019"
"50484","150340 INHANGAPI",2,0,0,160,0,162,"2019"
"50485","150345 IPIXUNA DO PARA",2,3,4,632,1,642,"2019"
"50486","150350 IRITUIA",0,3,4,434,15,456,"2019"
"50487","150360 ITAITUBA",2,19,79,2245,14,2359,"2019"
"50488","150370 ITUPIRANGA",0,9,13,812,12,846,"2019"
"50489","150375 JACAREACANGA",0,0,5,342,241,588,"2019"
"50490","150380 JACUNDA",0,3,13,687,12,715,"2019"
"50491","150390 JURUTI",5,5,20,1034,62,1126,"2019"
"50492","150400 LIMOEIRO DO AJURU",2,8,28,412,19,469,"2019"
"50493","150405 MAE DO RIO",1,1,9,551,2,564,"2019"
"50494","150410 MAGALHAES BARATA",2,0,1,114,0,117,"2019"
"50495","150420 MARABA",8,16,45,4700,53,4822,"2019"
"50496","150430 MARACANA",2,2,2,342,2,350,"2019"
"50497","150440 MARAPANIM",0,1,3,297,3,304,"2019"
"50498","150442 MARITUBA",8,7,28,1762,8,1813,"2019"
"50499","150445 MEDICILANDIA",0,3,7,477,4,491,"2019"
"50500","150450 MELGACO",0,3,9,472,158,642,"2019"
"50501","150460 MOCAJUBA",3,2,4,444,7,460,"2019"
"50502","150470 MOJU",4,5,30,1241,25,1305,"2019"
"50503","150475 MOJUI DOS CAMPOS",1,1,7,319,7,335,"2019"
"50504","150480 MONTE ALEGRE",0,4,27,1019,0,1050,"2019"
"50505","150490 MUANA",2,5,16,591,2,616,"2019"
"50506","150495 NOVA ESPERANCA DO PIRIA",0,2,5,338,2,347,"2019"
"50507","150497 NOVA IPIXUNA",0,1,1,224,3,229,"2019"
"50508","150500 NOVA TIMBOTEUA",0,1,1,128,1,131,"2019"
"50509","150503 NOVO PROGRESSO",1,2,8,573,1,585,"2019"
"50510","150506 NOVO REPARTIMENTO",4,3,11,1152,23,1193,"2019"
"50511","150510 OBIDOS",1,2,6,1004,79,1092,"2019"
"50512","150520 OEIRAS DO PARA",3,4,26,613,27,673,"2019"
"50513","150530 ORIXIMINA",17,10,30,1454,39,1550,"2019"
"50514","150540 OUREM",1,0,1,306,2,310,"2019"
"50515","150543 OURILANDIA DO NORTE",0,7,13,686,1,707,"2019"
"50516","150548 PACAJA",0,6,5,757,8,776,"2019"
"50517","150549 PALESTINA DO PARA",0,1,1,99,4,105,"2019"
"50518","150550 PARAGOMINAS",7,7,22,2023,6,2065,"2019"
"50519","150553 PARAUAPEBAS",7,16,52,4496,6,4577,"2019"
"50520","150555 PAU D'ARCO",1,0,2,117,0,120,"2019"
"50521","150560 PEIXE-BOI",0,0,1,92,2,95,"2019"
"50522","150563 PICARRA",0,0,2,158,5,165,"2019"
"50523","150565 PLACAS",2,3,6,269,2,282,"2019"
"50524","150570 PONTA DE PEDRAS",4,0,6,343,11,364,"2019"
"50525","150580 PORTEL",5,5,13,1274,272,1569,"2019"
"50526","150590 PORTO DE MOZ",4,1,8,752,3,768,"2019"
"50527","150600 PRAINHA",1,4,13,637,100,755,"2019"
"50528","150610 PRIMAVERA",1,0,0,188,2,191,"2019"
"50529","150611 QUATIPURU",0,0,3,155,4,162,"2019"
"50530","150613 REDENCAO",4,12,26,1677,6,1725,"2019"
"50531","150616 RIO MARIA",0,0,6,274,1,281,"2019"
"50532","150618 RONDON DO PARA",1,2,16,507,3,529,"2019"
"50533","150619 RUROPOLIS",0,2,8,377,20,407,"2019"
"50534","150620 SALINOPOLIS",0,0,1,677,2,680,"2019"
"50535","150630 SALVATERRA",2,1,0,333,1,337,"2019"
"50536","150635 SANTA BARBARA DO PARA",2,2,2,319,5,330,"2019"
"50537","150640 SANTA CRUZ DO ARARI",1,1,0,101,7,110,"2019"
"50538","150650 SANTA IZABEL DO PARA",3,1,16,972,4,996,"2019"
"50539","150655 SANTA LUZIA DO PARA",0,0,1,300,5,306,"2019"
"50540","150658 SANTA MARIA DAS BARREIRAS",0,0,6,209,0,215,"2019"
"50541","150660 SANTA MARIA DO PARA",1,0,5,449,0,455,"2019"
"50542","150670 SANTANA DO ARAGUAIA",0,2,14,585,1,602,"2019"
"50543","150680 SANTAREM",14,40,139,6093,373,6659,"2019"
"50544","150690 SANTAREM NOVO",0,0,0,95,0,95,"2019"
"50545","150700 SANTO ANTONIO DO TAUA",3,0,4,496,9,512,"2019"
"50546","150710 SAO CAETANO DE ODIVELAS",1,1,0,214,8,224,"2019"
"50547","150715 SAO DOMINGOS DO ARAGUAIA",1,3,5,341,2,352,"2019"
"50548","150720 SAO DOMINGOS DO CAPIM",0,4,9,447,5,465,"2019"
"50549","150730 SAO FELIX DO XINGU",2,6,52,1009,6,1075,"2019"
"50550","150740 SAO FRANCISCO DO PARA",0,1,2,231,1,235,"2019"
"50551","150745 SAO GERALDO DO ARAGUAIA",1,2,4,428,1,436,"2019"
"50552","150746 SAO JOAO DA PONTA",0,1,2,77,5,85,"2019"
"50553","150747 SAO JOAO DE PIRABAS",1,1,0,300,5,307,"2019"
"50554","150750 SAO JOAO DO ARAGUAIA",0,2,1,180,2,185,"2019"
"50555","150760 SAO MIGUEL DO GUAMA",0,4,15,899,8,926,"2019"
"50556","150770 SAO SEBASTIAO DA BOA VISTA",5,8,24,488,1,526,"2019"
"50557","150775 SAPUCAIA",0,1,1,91,0,93,"2019"
"50558","150780 SENADOR JOSE PORFIRIO",0,0,3,299,3,305,"2019"
"50559","150790 SOURE",2,0,1,382,1,386,"2019"
"50560","150795 TAILANDIA",2,5,18,1427,1,1453,"2019"
"50561","150796 TERRA ALTA",1,0,2,178,1,182,"2019"
"50562","150797 TERRA SANTA",0,1,10,300,0,311,"2019"
"50563","150800 TOME-ACU",4,2,12,1490,7,1515,"2019"
"50564","150803 TRACUATEUA",0,4,5,462,8,479,"2019"
"50565","150805 TRAIRAO",0,1,8,266,0,275,"2019"
"50566","150808 TUCUMA",0,2,13,718,0,733,"2019"
"50567","150810 TUCURUI",1,3,22,1603,161,1790,"2019"
"50568","150812 ULIANOPOLIS",2,3,7,432,0,444,"2019"
"50569","150815 URUARA",0,1,7,774,1,783,"2019"
"50570","150820 VIGIA",1,3,10,695,4,713,"2019"
"50571","150830 VISEU",1,5,14,833,191,1044,"2019"
"50572","150835 VITORIA DO XINGU",1,0,4,360,0,365,"2019"
"50573","150840 XINGUARA",1,6,19,917,2,945,"2019"
"50574","160005 SERRA DO NAVIO",0,0,0,90,2,92,"2019"
"50575","160010 AMAPA",0,1,1,163,4,169,"2019"
"50576","160015 PEDRA BRANCA DO AMAPARI",0,1,2,296,12,311,"2019"
"50577","160020 CALCOENE",0,1,2,210,1,214,"2019"
"50578","160021 CUTIAS",1,1,1,77,10,90,"2019"
"50579","160023 FERREIRA GOMES",1,1,2,163,1,168,"2019"
"50580","160025 ITAUBAL",0,0,0,143,2,145,"2019"
"50581","160027 LARANJAL DO JARI",2,6,11,752,5,776,"2019"
"50582","160030 MACAPA",29,30,63,8629,133,8884,"2019"
"50583","160040 MAZAGAO",2,0,13,521,40,576,"2019"
"50584","160050 OIAPOQUE",2,2,9,525,58,596,"2019"
"50585","160053 PORTO GRANDE",1,1,8,396,5,411,"2019"
"50586","160055 PRACUUBA",0,1,1,52,17,71,"2019"
"50587","160060 SANTANA",3,5,32,2176,14,2230,"2019"
"50588","160070 TARTARUGALZINHO",2,0,6,237,86,331,"2019"
"50589","160080 VITORIA DO JARI",0,0,4,283,5,292,"2019"
"50590","MUNICIPIO IGNORADO - TO",0,0,0,2,0,2,"2019"
"50591","170025 ABREULANDIA",0,0,0,32,0,32,"2019"
"50592","170030 AGUIARNOPOLIS",0,1,0,56,3,60,"2019"
"50593","170035 ALIANCA DO TOCANTINS",0,0,0,71,0,71,"2019"
"50594","170040 ALMAS",0,0,2,115,0,117,"2019"
"50595","170070 ALVORADA",0,1,0,129,0,130,"2019"
"50596","170100 ANANAS",0,2,2,164,2,170,"2019"
"50597","170105 ANGICO",0,0,0,49,0,49,"2019"
"50598","170110 APARECIDA DO RIO NEGRO",0,1,0,72,2,75,"2019"
"50599","170130 ARAGOMINAS",1,0,1,77,1,80,"2019"
"50600","170190 ARAGUACEMA",1,1,0,100,1,103,"2019"
"50601","170200 ARAGUACU",0,0,2,98,1,101,"2019"
"50602","170210 ARAGUAINA",3,12,45,3025,16,3101,"2019"
"50603","170215 ARAGUANA",0,0,0,91,0,91,"2019"
"50604","170220 ARAGUATINS",2,1,5,451,98,557,"2019"
"50605","170230 ARAPOEMA",0,0,1,93,0,94,"2019"
"50606","170240 ARRAIAS",1,1,2,144,0,148,"2019"
"50607","170255 AUGUSTINOPOLIS",0,1,6,275,52,334,"2019"
"50608","170270 AURORA DO TOCANTINS",0,0,1,34,1,36,"2019"
"50609","170290 AXIXA DO TOCANTINS",0,1,5,156,23,185,"2019"
"50610","170300 BABACULANDIA",0,0,2,110,0,112,"2019"
"50611","170305 BANDEIRANTES DO TOCANTINS",0,0,0,50,0,50,"2019"
"50612","170307 BARRA DO OURO",0,1,1,76,2,80,"2019"
"50613","170310 BARROLANDIA",0,0,0,63,2,65,"2019"
"50614","170320 BERNARDO SAYAO",0,0,3,59,0,62,"2019"
"50615","170330 BOM JESUS DO TOCANTINS",0,0,1,72,0,73,"2019"
"50616","170360 BRASILANDIA DO TOCANTINS",0,0,0,24,0,24,"2019"
"50617","170370 BREJINHO DE NAZARE",1,0,0,58,0,59,"2019"
"50618","170380 BURITI DO TOCANTINS",0,0,1,125,32,158,"2019"
"50619","170382 CACHOEIRINHA",0,0,0,28,1,29,"2019"
"50620","170384 CAMPOS LINDOS",0,0,3,154,3,160,"2019"
"50621","170386 CARIRI DO TOCANTINS",0,0,1,46,1,48,"2019"
"50622","170388 CARMOLANDIA",0,1,0,53,0,54,"2019"
"50623","170389 CARRASCO BONITO",0,0,0,41,10,51,"2019"
"50624","170390 CASEARA",0,0,0,87,4,91,"2019"
"50625","170410 CENTENARIO",0,0,3,23,0,26,"2019"
"50626","170460 CHAPADA DE AREIA",0,0,0,21,0,21,"2019"
"50627","170510 CHAPADA DA NATIVIDADE",0,0,1,42,0,43,"2019"
"50628","170550 COLINAS DO TOCANTINS",1,6,8,531,2,548,"2019"
"50629","170555 COMBINADO",0,0,1,53,1,55,"2019"
"50630","170560 CONCEICAO DO TOCANTINS",0,1,1,58,0,60,"2019"
"50631","170600 COUTO MAGALHAES",0,1,1,59,0,61,"2019"
"50632","170610 CRISTALANDIA",0,0,1,84,0,85,"2019"
"50633","170625 CRIXAS DO TOCANTINS",0,0,0,17,0,17,"2019"
"50634","170650 DARCINOPOLIS",0,0,4,95,0,99,"2019"
"50635","170700 DIANOPOLIS",0,3,5,260,3,271,"2019"
"50636","170710 DIVINOPOLIS DO TOCANTINS",0,0,0,104,0,104,"2019"
"50637","170720 DOIS IRMAOS DO TOCANTINS",0,0,1,75,0,76,"2019"
"50638","170730 DUERE",0,0,0,61,0,61,"2019"
"50639","170740 ESPERANTINA",1,1,3,133,27,165,"2019"
"50640","170755 FATIMA",0,0,0,46,0,46,"2019"
"50641","170765 FIGUEIROPOLIS",1,0,2,65,0,68,"2019"
"50642","170770 FILADELFIA",0,0,3,119,4,126,"2019"
"50643","170820 FORMOSO DO ARAGUAIA",2,2,1,298,0,303,"2019"
"50644","170825 FORTALEZA DO TABOCAO",1,0,4,72,0,77,"2019"
"50645","170830 GOIANORTE",1,0,0,59,0,60,"2019"
"50646","170900 GOIATINS",1,0,4,222,15,242,"2019"
"50647","170930 GUARAI",0,1,5,369,0,375,"2019"
"50648","170950 GURUPI",5,2,13,1309,2,1331,"2019"
"50649","170980 IPUEIRAS",0,0,0,22,0,22,"2019"
"50650","171050 ITACAJA",1,1,1,124,4,131,"2019"
"50651","171070 ITAGUATINS",0,0,0,73,7,80,"2019"
"50652","171090 ITAPIRATINS",0,0,1,56,0,57,"2019"
"50653","171110 ITAPORA DO TOCANTINS",0,0,0,37,0,37,"2019"
"50654","171150 JAU DO TOCANTINS",0,0,0,38,0,38,"2019"
"50655","171180 JUARINA",0,0,0,32,0,32,"2019"
"50656","171190 LAGOA DA CONFUSAO",0,1,2,229,4,236,"2019"
"50657","171195 LAGOA DO TOCANTINS",0,0,1,50,8,59,"2019"
"50658","171200 LAJEADO",0,0,0,46,0,46,"2019"
"50659","171215 LAVANDEIRA",0,1,1,22,0,24,"2019"
"50660","171240 LIZARDA",0,0,0,49,0,49,"2019"
"50661","171245 LUZINOPOLIS",0,0,0,42,5,47,"2019"
"50662","171250 MARIANOPOLIS DO TOCANTINS",0,0,0,69,1,70,"2019"
"50663","171270 MATEIROS",0,0,0,48,1,49,"2019"
"50664","171280 MAURILANDIA DO TOCANTINS",0,0,0,27,8,35,"2019"
"50665","171320 MIRACEMA DO TOCANTINS",1,2,4,287,1,295,"2019"
"50666","171330 MIRANORTE",1,4,1,175,0,181,"2019"
"50667","171360 MONTE DO CARMO",0,0,4,77,1,82,"2019"
"50668","171370 MONTE SANTO DO TOCANTINS",0,0,0,25,0,25,"2019"
"50669","171380 PALMEIRAS DO TOCANTINS",0,0,0,67,0,67,"2019"
"50670","171395 MURICILANDIA",0,0,1,53,1,55,"2019"
"50671","171420 NATIVIDADE",0,2,2,129,1,134,"2019"
"50672","171430 NAZARE",0,0,1,59,0,60,"2019"
"50673","171488 NOVA OLINDA",1,0,2,174,3,180,"2019"
"50674","171500 NOVA ROSALANDIA",0,0,0,57,0,57,"2019"
"50675","171510 NOVO ACORDO",0,1,0,60,1,62,"2019"
"50676","171515 NOVO ALEGRE",0,0,0,14,0,14,"2019"
"50677","171525 NOVO JARDIM",0,1,0,33,1,35,"2019"
"50678","171550 OLIVEIRA DE FATIMA",0,0,0,21,0,21,"2019"
"50679","171570 PALMEIRANTE",0,0,0,80,0,80,"2019"
"50680","171575 PALMEIROPOLIS",0,0,0,103,0,103,"2019"
"50681","171610 PARAISO DO TOCANTINS",1,1,4,881,3,890,"2019"
"50682","171620 PARANA",0,0,0,157,2,159,"2019"
"50683","171630 PAU D'ARCO",0,0,1,54,0,55,"2019"
"50684","171650 PEDRO AFONSO",1,1,4,250,1,257,"2019"
"50685","171660 PEIXE",2,1,3,125,0,131,"2019"
"50686","171665 PEQUIZEIRO",0,1,0,67,0,68,"2019"
"50687","171670 COLMEIA",0,0,0,101,0,101,"2019"
"50688","171700 PINDORAMA DO TOCANTINS",1,0,1,49,2,53,"2019"
"50689","171720 PIRAQUE",0,0,0,36,0,36,"2019"
"50690","171750 PIUM",0,0,1,94,1,96,"2019"
"50691","171780 PONTE ALTA DO BOM JESUS",0,0,0,35,3,38,"2019"
"50692","171790 PONTE ALTA DO TOCANTINS",0,0,1,96,3,100,"2019"
"50693","171800 PORTO ALEGRE DO TOCANTINS",0,1,0,35,0,36,"2019"
"50694","171820 PORTO NACIONAL",0,2,19,1078,10,1109,"2019"
"50695","171830 PRAIA NORTE",1,0,4,77,11,93,"2019"
"50696","171840 PRESIDENTE KENNEDY",0,0,0,39,0,39,"2019"
"50697","171845 PUGMIL",0,0,0,31,1,32,"2019"
"50698","171850 RECURSOLANDIA",0,0,1,51,0,52,"2019"
"50699","171855 RIACHINHO",0,0,0,54,0,54,"2019"
"50700","171865 RIO DA CONCEICAO",0,0,0,33,0,33,"2019"
"50701","171870 RIO DOS BOIS",0,1,1,33,0,35,"2019"
"50702","171875 RIO SONO",0,0,2,56,2,60,"2019"
"50703","171880 SAMPAIO",0,0,1,55,10,66,"2019"
"50704","171884 SANDOLANDIA",0,0,0,46,0,46,"2019"
"50705","171886 SANTA FE DO ARAGUAIA",1,0,3,117,1,122,"2019"
"50706","171888 SANTA MARIA DO TOCANTINS",0,0,1,41,0,42,"2019"
"50707","171889 SANTA RITA DO TOCANTINS",0,0,0,26,0,26,"2019"
"50708","171890 SANTA ROSA DO TOCANTINS",1,0,1,71,1,74,"2019"
"50709","171900 SANTA TEREZA DO TOCANTINS",0,0,0,54,1,55,"2019"
"50710","172000 SANTA TEREZINHA DO TOCANTINS",0,0,1,27,0,28,"2019"
"50711","172010 SAO BENTO DO TOCANTINS",0,0,1,73,11,85,"2019"
"50712","172015 SAO FELIX DO TOCANTINS",1,0,0,28,0,29,"2019"
"50713","172020 SAO MIGUEL DO TOCANTINS",0,0,2,145,3,150,"2019"
"50714","172025 SAO SALVADOR DO TOCANTINS",1,1,1,31,0,34,"2019"
"50715","172030 SAO SEBASTIAO DO TOCANTINS",0,0,2,53,10,65,"2019"
"50716","172049 SAO VALERIO",1,0,0,56,0,57,"2019"
"50717","172065 SILVANOPOLIS",0,1,2,87,2,92,"2019"
"50718","172080 SITIO NOVO DO TOCANTINS",0,1,4,121,6,132,"2019"
"50719","172085 SUCUPIRA",0,0,1,12,0,13,"2019"
"50720","172090 TAGUATINGA",1,0,1,128,0,130,"2019"
"50721","172093 TAIPAS DO TOCANTINS",0,0,0,34,0,34,"2019"
"50722","172097 TALISMA",0,0,0,28,0,28,"2019"
"50723","172100 PALMAS",11,8,53,5103,31,5206,"2019"
"50724","172110 TOCANTINIA",0,1,1,186,1,189,"2019"
"50725","172120 TOCANTINOPOLIS",0,2,4,415,6,427,"2019"
"50726","172125 TUPIRAMA",0,0,0,13,0,13,"2019"
"50727","172130 TUPIRATINS",0,0,0,27,1,28,"2019"
"50728","172208 WANDERLANDIA",0,0,0,114,2,116,"2019"
"50729","172210 XAMBIOA",0,1,1,196,2,200,"2019"
"50730","MUNICIPIO IGNORADO - MA",0,0,0,8,0,8,"2019"
"50731","210005 ACAILANDIA",2,8,28,1838,6,1882,"2019"
"50732","210010 AFONSO CUNHA",0,1,0,121,2,124,"2019"
"50733","210015 AGUA DOCE DO MARANHAO",0,0,4,167,6,177,"2019"
"50734","210020 ALCANTARA",0,1,0,168,43,212,"2019"
"50735","210030 ALDEIAS ALTAS",0,2,6,427,4,439,"2019"
"50736","210040 ALTAMIRA DO MARANHAO",0,0,2,80,0,82,"2019"
"50737","210043 ALTO ALEGRE DO MARANHAO",0,0,7,389,1,397,"2019"
"50738","210047 ALTO ALEGRE DO PINDARE",0,1,8,478,5,492,"2019"
"50739","210050 ALTO PARNAIBA",1,1,6,174,0,182,"2019"
"50740","210055 AMAPA DO MARANHAO",0,0,3,116,1,120,"2019"
"50741","210060 AMARANTE DO MARANHAO",1,7,15,785,42,850,"2019"
"50742","210070 ANAJATUBA",1,2,12,335,15,365,"2019"
"50743","210080 ANAPURUS",1,1,5,277,2,286,"2019"
"50744","210083 APICUM-ACU",1,0,0,72,229,302,"2019"
"50745","210087 ARAGUANA",0,1,4,112,2,119,"2019"
"50746","210090 ARAIOSES",1,4,40,519,16,580,"2019"
"50747","210095 ARAME",4,2,5,562,2,575,"2019"
"50748","210100 ARARI",4,1,11,430,3,449,"2019"
"50749","210110 AXIXA",0,0,2,139,4,145,"2019"
"50750","210120 BACABAL",4,6,29,1625,4,1668,"2019"
"50751","210125 BACABEIRA",1,1,10,258,3,273,"2019"
"50752","210130 BACURI",2,0,3,138,129,272,"2019"
"50753","210135 BACURITUBA",0,1,0,57,3,61,"2019"
"50754","210140 BALSAS",8,6,42,1943,9,2008,"2019"
"50755","210150 BARAO DE GRAJAU",0,2,8,272,0,282,"2019"
"50756","210160 BARRA DO CORDA",5,5,8,1485,27,1530,"2019"
"50757","210170 BARREIRINHAS",1,2,2,1195,21,1221,"2019"
"50758","210173 BELAGUA",0,1,0,72,103,176,"2019"
"50759","210177 BELA VISTA DO MARANHAO",0,2,3,204,0,209,"2019"
"50760","210180 BENEDITO LEITE",0,0,3,61,5,69,"2019"
"50761","210190 BEQUIMAO",1,1,3,94,185,284,"2019"
"50762","210193 BERNARDO DO MEARIM",0,0,0,57,1,58,"2019"
"50763","210197 BOA VISTA DO GURUPI",0,0,0,146,1,147,"2019"
"50764","210200 BOM JARDIM",1,1,5,562,9,578,"2019"
"50765","210203 BOM JESUS DAS SELVAS",1,8,10,480,1,500,"2019"
"50766","210207 BOM LUGAR",0,0,2,142,0,144,"2019"
"50767","210210 BREJO",2,3,12,547,6,570,"2019"
"50768","210215 BREJO DE AREIA",0,1,1,151,4,157,"2019"
"50769","210220 BURITI",3,7,8,538,5,561,"2019"
"50770","210230 BURITI BRAVO",7,7,7,386,4,411,"2019"
"50771","210232 BURITICUPU",0,12,5,1174,11,1202,"2019"
"50772","210235 BURITIRANA",0,2,10,203,6,221,"2019"
"50773","210237 CACHOEIRA GRANDE",0,0,2,128,11,141,"2019"
"50774","210240 CAJAPIO",0,0,0,25,128,153,"2019"
"50775","210250 CAJARI",0,3,5,102,207,317,"2019"
"50776","210255 CAMPESTRE DO MARANHAO",0,1,14,186,0,201,"2019"
"50777","210260 CANDIDO MENDES",2,1,4,291,63,361,"2019"
"50778","210270 CANTANHEDE",1,2,4,258,2,267,"2019"
"50779","210275 CAPINZAL DO NORTE",0,0,3,120,4,127,"2019"
"50780","210280 CAROLINA",0,1,9,366,1,377,"2019"
"50781","210290 CARUTAPERA",0,3,11,418,6,438,"2019"
"50782","210300 CAXIAS",5,4,34,2589,12,2644,"2019"
"50783","210310 CEDRAL",1,1,1,59,35,97,"2019"
"50784","210312 CENTRAL DO MARANHAO",1,0,1,121,23,146,"2019"
"50785","210315 CENTRO DO GUILHERME",0,6,1,201,9,217,"2019"
"50786","210317 CENTRO NOVO DO MARANHAO",0,1,3,291,9,304,"2019"
"50787","210320 CHAPADINHA",2,7,26,1474,12,1521,"2019"
"50788","210325 CIDELANDIA",1,1,5,119,19,145,"2019"
"50789","210330 CODO",13,9,44,1856,15,1937,"2019"
"50790","210340 COELHO NETO",0,4,16,718,19,757,"2019"
"50791","210350 COLINAS",1,4,9,680,8,702,"2019"
"50792","210355 CONCEICAO DO LAGO-ACU",0,3,13,244,12,272,"2019"
"50793","210360 COROATA",3,3,21,1107,9,1143,"2019"
"50794","210370 CURURUPU",2,0,2,301,184,489,"2019"
"50795","210375 DAVINOPOLIS",0,0,5,234,2,241,"2019"
"50796","210380 DOM PEDRO",0,0,3,317,2,322,"2019"
"50797","210390 DUQUE BACELAR",0,0,4,190,3,197,"2019"
"50798","210400 ESPERANTINOPOLIS",2,0,4,331,2,339,"2019"
"50799","210405 ESTREITO",0,2,6,175,421,604,"2019"
"50800","210407 FEIRA NOVA DO MARANHAO",0,1,2,93,1,97,"2019"
"50801","210408 FERNANDO FALCAO",0,2,1,162,85,250,"2019"
"50802","210409 FORMOSA DA SERRA NEGRA",0,0,4,126,132,262,"2019"
"50803","210410 FORTALEZA DOS NOGUEIRAS",0,1,3,230,21,255,"2019"
"50804","210420 FORTUNA",0,1,3,267,1,272,"2019"
"50805","210430 GODOFREDO VIANA",0,1,2,128,9,140,"2019"
"50806","210440 GONCALVES DIAS",0,0,2,150,81,233,"2019"
"50807","210450 GOVERNADOR ARCHER",0,0,3,147,1,151,"2019"
"50808","210455 GOVERNADOR EDISON LOBAO",1,1,8,332,3,345,"2019"
"50809","210460 GOVERNADOR EUGENIO BARROS",0,0,8,231,0,239,"2019"
"50810","210462 GOVERNADOR LUIZ ROCHA",0,0,1,93,3,97,"2019"
"50811","210465 GOVERNADOR NEWTON BELLO",0,0,2,160,4,166,"2019"
"50812","210467 GOVERNADOR NUNES FREIRE",1,1,0,461,3,466,"2019"
"50813","210470 GRACA ARANHA",0,0,1,78,10,89,"2019"
"50814","210480 GRAJAU",0,6,37,1489,16,1548,"2019"
"50815","210490 GUIMARAES",1,1,2,129,12,145,"2019"
"50816","210500 HUMBERTO DE CAMPOS",2,0,4,430,47,483,"2019"
"50817","210510 ICATU",1,2,8,330,22,363,"2019"
"50818","210515 IGARAPE DO MEIO",3,1,4,230,6,244,"2019"
"50819","210520 IGARAPE GRANDE",0,0,2,184,3,189,"2019"
"50820","210530 IMPERATRIZ",16,16,125,5008,27,5192,"2019"
"50821","210535 ITAIPAVA DO GRAJAU",1,2,6,276,2,287,"2019"
"50822","210540 ITAPECURU MIRIM",4,3,12,1217,7,1243,"2019"
"50823","210542 ITINGA DO MARANHAO",0,3,7,342,1,353,"2019"
"50824","210545 JATOBA",0,0,2,141,1,144,"2019"
"50825","210547 JENIPAPO DOS VIEIRAS",0,1,4,305,32,342,"2019"
"50826","210550 JOAO LISBOA",1,0,17,474,1,493,"2019"
"50827","210560 JOSELANDIA",2,1,2,211,3,219,"2019"
"50828","210565 JUNCO DO MARANHAO",0,2,2,107,0,111,"2019"
"50829","210570 LAGO DA PEDRA",7,2,7,748,0,764,"2019"
"50830","210580 LAGO DO JUNCO",2,0,2,173,0,177,"2019"
"50831","210590 LAGO VERDE",0,1,10,261,1,273,"2019"
"50832","210592 LAGOA DO MATO",0,0,1,122,0,123,"2019"
"50833","210594 LAGO DOS RODRIGUES",0,1,2,103,0,106,"2019"
"50834","210596 LAGOA GRANDE DO MARANHAO",2,0,0,218,0,220,"2019"
"50835","210598 LAJEADO NOVO",0,2,4,96,0,102,"2019"
"50836","210600 LIMA CAMPOS",0,2,4,185,0,191,"2019"
"50837","210610 LORETO",1,0,4,91,51,147,"2019"
"50838","210620 LUIS DOMINGUES",0,0,5,66,49,120,"2019"
"50839","210630 MAGALHAES DE ALMEIDA",1,3,2,196,3,205,"2019"
"50840","210632 MARACACUME",2,0,3,370,4,379,"2019"
"50841","210635 MARAJA DO SENA",0,0,1,92,0,93,"2019"
"50842","210637 MARANHAOZINHO",0,1,1,188,2,192,"2019"
"50843","210640 MATA ROMA",2,2,2,256,7,269,"2019"
"50844","210650 MATINHA",2,0,0,54,285,341,"2019"
"50845","210660 MATOES",0,2,5,485,0,492,"2019"
"50846","210663 MATOES DO NORTE",1,0,3,115,1,120,"2019"
"50847","210667 MILAGRES DO MARANHAO",0,0,4,90,2,96,"2019"
"50848","210670 MIRADOR",0,0,12,345,3,360,"2019"
"50849","210675 MIRANDA DO NORTE",3,0,0,336,1,340,"2019"
"50850","210680 MIRINZAL",1,0,1,101,159,262,"2019"
"50851","210690 MONCAO",0,0,7,566,7,580,"2019"
"50852","210700 MONTES ALTOS",0,3,4,148,4,159,"2019"
"50853","210710 MORROS",3,1,11,326,17,358,"2019"
"50854","210720 NINA RODRIGUES",1,0,2,237,3,243,"2019"
"50855","210725 NOVA COLINAS",0,1,1,78,0,80,"2019"
"50856","210730 NOVA IORQUE",0,1,0,31,2,34,"2019"
"50857","210735 NOVA OLINDA DO MARANHAO",0,0,12,272,7,291,"2019"
"50858","210740 OLHO D'AGUA DAS CUNHAS",0,0,2,247,0,249,"2019"
"50859","210745 OLINDA NOVA DO MARANHAO",0,0,3,26,194,223,"2019"
"50860","210750 PACO DO LUMIAR",8,7,38,1755,33,1841,"2019"
"50861","210760 PALMEIRANDIA",1,1,3,298,7,310,"2019"
"50862","210770 PARAIBANO",0,1,8,303,2,314,"2019"
"50863","210780 PARNARAMA",1,0,5,395,31,432,"2019"
"50864","210790 PASSAGEM FRANCA",0,0,4,299,0,303,"2019"
"50865","210800 PASTOS BONS",1,2,1,78,220,302,"2019"
"50866","210805 PAULINO NEVES",1,2,2,352,23,380,"2019"
"50867","210810 PAULO RAMOS",2,0,2,362,0,366,"2019"
"50868","210820 PEDREIRAS",1,2,4,576,8,591,"2019"
"50869","210825 PEDRO DO ROSARIO",3,0,15,356,41,415,"2019"
"50870","210830 PENALVA",1,5,4,600,31,641,"2019"
"50871","210840 PERI MIRIM",2,2,3,117,9,133,"2019"
"50872","210845 PERITORO",2,3,3,322,9,339,"2019"
"50873","210850 PINDARE-MIRIM",1,0,3,522,4,530,"2019"
"50874","210860 PINHEIRO",14,4,26,1444,43,1531,"2019"
"50875","210870 PIO XII",0,0,3,422,1,426,"2019"
"50876","210880 PIRAPEMAS",0,4,7,268,3,282,"2019"
"50877","210890 POCAO DE PEDRAS",1,1,0,239,2,243,"2019"
"50878","210900 PORTO FRANCO",0,3,13,409,1,426,"2019"
"50879","210905 PORTO RICO DO MARANHAO",0,0,1,67,12,80,"2019"
"50880","210910 PRESIDENTE DUTRA",3,2,6,811,1,823,"2019"
"50881","210920 PRESIDENTE JUSCELINO",1,0,5,176,13,195,"2019"
"50882","210923 PRESIDENTE MEDICI",0,1,1,98,2,102,"2019"
"50883","210927 PRESIDENTE SARNEY",2,3,5,307,37,354,"2019"
"50884","210930 PRESIDENTE VARGAS",1,0,4,224,12,241,"2019"
"50885","210940 PRIMEIRA CRUZ",0,0,2,175,20,197,"2019"
"50886","210945 RAPOSA",1,1,8,469,8,487,"2019"
"50887","210950 RIACHAO",0,0,5,359,0,364,"2019"
"50888","210955 RIBAMAR FIQUENE",0,1,3,120,0,124,"2019"
"50889","210960 ROSARIO",7,3,10,607,8,635,"2019"
"50890","210970 SAMBAIBA",0,0,1,76,1,78,"2019"
"50891","210975 SANTA FILOMENA DO MARANHAO",0,0,0,79,1,80,"2019"
"50892","210980 SANTA HELENA",6,1,11,478,54,550,"2019"
"50893","210990 SANTA INES",9,4,15,1560,2,1590,"2019"
"50894","211000 SANTA LUZIA",3,5,40,1125,29,1202,"2019"
"50895","211003 SANTA LUZIA DO PARUA",1,5,4,316,3,329,"2019"
"50896","211010 SANTA QUITERIA DO MARANHAO",2,2,30,390,5,429,"2019"
"50897","211020 SANTA RITA",2,3,26,515,3,549,"2019"
"50898","211023 SANTANA DO MARANHAO",0,1,3,127,2,133,"2019"
"50899","211027 SANTO AMARO DO MARANHAO",2,0,2,142,42,188,"2019"
"50900","211030 SANTO ANTONIO DOS LOPES",1,1,2,254,0,258,"2019"
"50901","211040 SAO BENEDITO DO RIO PRETO",2,3,5,347,21,378,"2019"
"50902","211050 SAO BENTO",4,2,2,492,5,505,"2019"
"50903","211060 SAO BERNARDO",0,3,6,404,11,424,"2019"
"50904","211065 SAO DOMINGOS DO AZEITAO",0,1,2,21,53,77,"2019"
"50905","211070 SAO DOMINGOS DO MARANHAO",1,2,7,637,2,649,"2019"
"50906","211080 SAO FELIX DE BALSAS",0,0,0,26,26,52,"2019"
"50907","211085 SAO FRANCISCO DO BREJAO",0,0,2,93,4,99,"2019"
"50908","211090 SAO FRANCISCO DO MARANHAO",1,0,2,126,31,160,"2019"
"50909","211100 SAO JOAO BATISTA",1,2,28,177,59,267,"2019"
"50910","211102 SAO JOAO DO CARU",0,3,4,239,1,247,"2019"
"50911","211105 SAO JOAO DO PARAISO",0,4,3,153,1,161,"2019"
"50912","211107 SAO JOAO DO SOTER",0,0,6,260,7,273,"2019"
"50913","211110 SAO JOAO DOS PATOS",0,1,0,369,1,371,"2019"
"50914","211120 SAO JOSE DE RIBAMAR",25,16,87,3553,72,3753,"2019"
"50915","211125 SAO JOSE DOS BASILIOS",0,0,2,102,0,104,"2019"
"50916","211130 SAO LUIS",68,72,272,15113,160,15685,"2019"
"50917","211140 SAO LUIS GONZAGA DO MARANHAO",0,1,8,280,1,290,"2019"
"50918","211150 SAO MATEUS DO MARANHAO",0,1,6,622,4,633,"2019"
"50919","211153 SAO PEDRO DA AGUA BRANCA",1,0,5,157,1,164,"2019"
"50920","211157 SAO PEDRO DOS CRENTES",0,0,0,77,1,78,"2019"
"50921","211160 SAO RAIMUNDO DAS MANGABEIRAS",1,2,5,259,45,312,"2019"
"50922","211163 SAO RAIMUNDO DO DOCA BEZERRA",0,0,0,87,1,88,"2019"
"50923","211167 SAO ROBERTO",1,1,0,83,5,90,"2019"
"50924","211170 SAO VICENTE FERRER",2,0,2,26,238,268,"2019"
"50925","211172 SATUBINHA",0,0,1,77,1,79,"2019"
"50926","211174 SENADOR ALEXANDRE COSTA",0,2,4,154,10,170,"2019"
"50927","211176 SENADOR LA ROCQUE",0,1,13,254,4,272,"2019"
"50928","211178 SERRANO DO MARANHAO",3,0,1,100,67,171,"2019"
"50929","211180 SITIO NOVO",0,0,2,342,1,345,"2019"
"50930","211190 SUCUPIRA DO NORTE",0,0,3,197,2,202,"2019"
"50931","211195 SUCUPIRA DO RIACHAO",0,1,0,45,1,47,"2019"
"50932","211200 TASSO FRAGOSO",0,1,4,143,2,150,"2019"
"50933","211210 TIMBIRAS",4,2,5,511,2,524,"2019"
"50934","211220 TIMON",11,6,33,3144,2,3196,"2019"
"50935","211223 TRIZIDELA DO VALE",1,1,4,265,28,299,"2019"
"50936","211227 TUFILANDIA",0,2,1,96,2,101,"2019"
"50937","211230 TUNTUM",1,2,9,526,2,540,"2019"
"50938","211240 TURIACU",0,0,3,45,665,713,"2019"
"50939","211245 TURILANDIA",2,0,5,248,75,330,"2019"
"50940","211250 TUTOIA",5,5,9,1009,40,1068,"2019"
"50941","211260 URBANO SANTOS",1,2,0,212,450,665,"2019"
"50942","211270 VARGEM GRANDE",4,2,13,756,20,795,"2019"
"50943","211280 VIANA",3,2,17,840,86,948,"2019"
"50944","211285 VILA NOVA DOS MARTIRIOS",1,0,6,164,0,171,"2019"
"50945","211290 VITORIA DO MEARIM",4,3,7,485,11,510,"2019"
"50946","211300 VITORINO FREIRE",1,3,1,510,0,515,"2019"
"50947","211400 ZE DOCA",4,1,19,701,6,731,"2019"
"50948","MUNICIPIO IGNORADO - PI",0,0,0,2,0,2,"2019"
"50949","220005 ACAUA",0,1,5,79,4,89,"2019"
"50950","220010 AGRICOLANDIA",0,0,1,72,1,74,"2019"
"50951","220020 AGUA BRANCA",1,1,5,322,0,329,"2019"
"50952","220025 ALAGOINHA DO PIAUI",0,0,0,91,0,91,"2019"
"50953","220027 ALEGRETE DO PIAUI",0,0,0,48,0,48,"2019"
"50954","220030 ALTO LONGA",0,0,2,110,0,112,"2019"
"50955","220040 ALTOS",1,2,11,650,8,672,"2019"
"50956","220045 ALVORADA DO GURGUEIA",0,0,1,61,11,73,"2019"
"50957","220050 AMARANTE",0,1,4,292,9,306,"2019"
"50958","220060 ANGICAL DO PIAUI",0,1,1,91,0,93,"2019"
"50959","220070 ANISIO DE ABREU",1,1,1,119,13,135,"2019"
"50960","220080 ANTONIO ALMEIDA",0,1,1,55,0,57,"2019"
"50961","220090 AROAZES",0,0,2,63,0,65,"2019"
"50962","220095 AROEIRAS DO ITAIM",1,0,0,34,0,35,"2019"
"50963","220100 ARRAIAL",0,0,1,58,1,60,"2019"
"50964","220105 ASSUNCAO DO PIAUI",0,0,4,104,9,117,"2019"
"50965","220110 AVELINO LOPES",0,1,1,111,99,212,"2019"
"50966","220115 BAIXA GRANDE DO RIBEIRO",0,1,2,195,86,284,"2019"
"50967","220117 BARRA D'ALCANTARA",1,0,1,34,0,36,"2019"
"50968","220120 BARRAS",3,6,6,659,4,678,"2019"
"50969","220130 BARREIRAS DO PIAUI",0,0,0,25,18,43,"2019"
"50970","220140 BARRO DURO",1,1,2,66,3,73,"2019"
"50971","220150 BATALHA",1,1,5,336,1,344,"2019"
"50972","220155 BELA VISTA DO PIAUI",1,1,4,55,0,61,"2019"
"50973","220157 BELEM DO PIAUI",0,0,1,33,0,34,"2019"
"50974","220160 BENEDITINOS",0,0,0,111,2,113,"2019"
"50975","220170 BERTOLINIA",0,1,2,70,0,73,"2019"
"50976","220173 BETANIA DO PIAUI",0,0,3,88,14,105,"2019"
"50977","220177 BOA HORA",1,1,0,78,5,85,"2019"
"50978","220180 BOCAINA",0,0,1,51,0,52,"2019"
"50979","220190 BOM JESUS",1,7,11,492,58,569,"2019"
"50980","220191 BOM PRINCIPIO DO PIAUI",0,0,1,87,1,89,"2019"
"50981","220192 BONFIM DO PIAUI",1,0,1,54,19,75,"2019"
"50982","220194 BOQUEIRAO DO PIAUI",0,0,0,67,6,73,"2019"
"50983","220196 BRASILEIRA",0,0,0,87,1,88,"2019"
"50984","220198 BREJO DO PIAUI",0,0,0,60,3,63,"2019"
"50985","220200 BURITI DOS LOPES",1,0,4,321,0,326,"2019"
"50986","220202 BURITI DOS MONTES",0,0,1,48,14,63,"2019"
"50987","220205 CABECEIRAS DO PIAUI",2,1,1,116,10,130,"2019"
"50988","220207 CAJAZEIRAS DO PIAUI",0,0,2,43,0,45,"2019"
"50989","220208 CAJUEIRO DA PRAIA",0,0,0,110,2,112,"2019"
"50990","220209 CALDEIRAO GRANDE DO PIAUI",0,0,0,67,0,67,"2019"
"50991","220210 CAMPINAS DO PIAUI",0,0,0,58,0,58,"2019"
"50992","220211 CAMPO ALEGRE DO FIDALGO",0,0,0,47,0,47,"2019"
"50993","220213 CAMPO GRANDE DO PIAUI",0,0,0,90,1,91,"2019"
"50994","220217 CAMPO LARGO DO PIAUI",0,1,2,102,1,106,"2019"
"50995","220220 CAMPO MAIOR",5,2,1,572,34,614,"2019"
"50996","220225 CANAVIEIRA",1,0,1,47,1,50,"2019"
"50997","220230 CANTO DO BURITI",0,1,5,273,16,295,"2019"
"50998","220240 CAPITAO DE CAMPOS",0,0,0,148,8,156,"2019"
"50999","220245 CAPITAO GERVASIO OLIVEIRA",1,0,1,38,1,41,"2019"
"51000","220250 CARACOL",0,7,38,109,35,189,"2019"
"51001","220253 CARAUBAS DO PIAUI",0,0,0,71,1,72,"2019"
"51002","220255 CARIDADE DO PIAUI",0,0,0,79,0,79,"2019"
"51003","220260 CASTELO DO PIAUI",0,2,1,174,120,297,"2019"
"51004","220265 CAXINGO",0,2,0,93,3,98,"2019"
"51005","220270 COCAL",1,3,2,409,3,418,"2019"
"51006","220271 COCAL DE TELHA",0,1,1,46,5,53,"2019"
"51007","220272 COCAL DOS ALVES",0,0,3,89,1,93,"2019"
"51008","220273 COIVARAS",0,0,0,51,1,52,"2019"
"51009","220275 COLONIA DO GURGUEIA",0,1,1,64,2,68,"2019"
"51010","220277 COLONIA DO PIAUI",0,0,1,77,0,78,"2019"
"51011","220280 CONCEICAO DO CANINDE",0,0,2,67,1,70,"2019"
"51012","220285 CORONEL JOSE DIAS",0,0,0,39,9,48,"2019"
"51013","220290 CORRENTE",0,0,2,108,325,435,"2019"
"51014","220300 CRISTALANDIA DO PIAUI",1,0,1,27,62,91,"2019"
"51015","220310 CRISTINO CASTRO",0,0,3,164,18,185,"2019"
"51016","220320 CURIMATA",1,1,0,54,146,202,"2019"
"51017","220323 CURRAIS",0,0,1,57,13,71,"2019"
"51018","220325 CURRALINHOS",0,0,0,69,1,70,"2019"
"51019","220327 CURRAL NOVO DO PIAUI",0,0,1,92,0,93,"2019"
"51020","220330 DEMERVAL LOBAO",1,0,3,259,4,267,"2019"
"51021","220335 DIRCEU ARCOVERDE",0,2,11,77,15,105,"2019"
"51022","220340 DOM EXPEDITO LOPES",0,2,0,74,0,76,"2019"
"51023","220342 DOMINGOS MOURAO",0,0,1,43,0,44,"2019"
"51024","220345 DOM INOCENCIO",0,2,15,58,19,94,"2019"
"51025","220350 ELESBAO VELOSO",0,0,4,146,3,153,"2019"
"51026","220360 ELISEU MARTINS",0,2,2,46,3,53,"2019"
"51027","220370 ESPERANTINA",1,6,10,602,0,619,"2019"
"51028","220375 FARTURA DO PIAUI",1,2,7,58,22,90,"2019"
"51029","220380 FLORES DO PIAUI",0,1,1,58,0,60,"2019"
"51030","220385 FLORESTA DO PIAUI",0,0,1,22,0,23,"2019"
"51031","220390 FLORIANO",2,2,14,884,1,903,"2019"
"51032","220400 FRANCINOPOLIS",0,0,0,58,0,58,"2019"
"51033","220410 FRANCISCO AYRES",0,1,4,58,1,64,"2019"
"51034","220415 FRANCISCO MACEDO",0,0,0,24,0,24,"2019"
"51035","220420 FRANCISCO SANTOS",0,0,2,83,1,86,"2019"
"51036","220430 FRONTEIRAS",0,1,5,130,1,137,"2019"
"51037","220435 GEMINIANO",0,0,1,82,0,83,"2019"
"51038","220440 GILBUES",0,0,3,101,97,201,"2019"
"51039","220450 GUADALUPE",0,1,7,168,0,176,"2019"
"51040","220455 GUARIBAS",0,3,16,42,6,67,"2019"
"51041","220460 HUGO NAPOLEAO",0,1,0,42,1,44,"2019"
"51042","220465 ILHA GRANDE",0,1,2,134,1,138,"2019"
"51043","220470 INHUMA",1,0,0,171,1,173,"2019"
"51044","220480 IPIRANGA DO PIAUI",0,1,2,127,2,132,"2019"
"51045","220490 ISAIAS COELHO",0,0,0,97,1,98,"2019"
"51046","220500 ITAINOPOLIS",0,0,4,113,1,118,"2019"
"51047","220510 ITAUEIRA",0,1,3,139,0,143,"2019"
"51048","220515 JACOBINA DO PIAUI",0,0,3,56,5,64,"2019"
"51049","220520 JAICOS",1,1,2,288,0,292,"2019"
"51050","220525 JARDIM DO MULATO",0,0,0,46,1,47,"2019"
"51051","220527 JATOBA DO PIAUI",0,1,0,35,13,49,"2019"
"51052","220530 JERUMENHA",1,0,2,56,1,60,"2019"
"51053","220535 JOAO COSTA",0,0,3,37,0,40,"2019"
"51054","220540 JOAQUIM PIRES",0,1,1,215,4,221,"2019"
"51055","220545 JOCA MARQUES",0,0,2,71,4,77,"2019"
"51056","220550 JOSE DE FREITAS",1,2,9,606,7,625,"2019"
"51057","220551 JUAZEIRO DO PIAUI",1,0,1,42,10,54,"2019"
"51058","220552 JULIO BORGES",0,0,2,33,53,88,"2019"
"51059","220553 JUREMA",0,1,4,68,17,90,"2019"
"51060","220554 LAGOINHA DO PIAUI",0,0,0,35,0,35,"2019"
"51061","220555 LAGOA ALEGRE",1,0,3,98,10,112,"2019"
"51062","220556 LAGOA DO BARRO DO PIAUI",0,11,9,39,4,63,"2019"
"51063","220557 LAGOA DE SAO FRANCISCO",1,0,1,89,0,91,"2019"
"51064","220558 LAGOA DO PIAUI",0,0,1,61,0,62,"2019"
"51065","220559 LAGOA DO SITIO",0,0,1,49,0,50,"2019"
"51066","220560 LANDRI SALES",0,1,0,69,0,70,"2019"
"51067","220570 LUIS CORREIA",0,3,6,499,1,509,"2019"
"51068","220580 LUZILANDIA",0,1,5,301,24,331,"2019"
"51069","220585 MADEIRO",0,1,1,109,2,113,"2019"
"51070","220590 MANOEL EMIDIO",1,0,2,55,0,58,"2019"
"51071","220595 MARCOLANDIA",1,0,1,109,0,111,"2019"
"51072","220600 MARCOS PARENTE",0,1,0,78,0,79,"2019"
"51073","220605 MASSAPE DO PIAUI",0,0,0,69,0,69,"2019"
"51074","220610 MATIAS OLIMPIO",0,1,3,173,1,178,"2019"
"51075","220620 MIGUEL ALVES",1,0,3,516,17,537,"2019"
"51076","220630 MIGUEL LEAO",0,0,0,21,0,21,"2019"
"51077","220635 MILTON BRANDAO",0,1,3,64,0,68,"2019"
"51078","220640 MONSENHOR GIL",0,0,1,115,3,119,"2019"
"51079","220650 MONSENHOR HIPOLITO",0,0,1,86,1,88,"2019"
"51080","220660 MONTE ALEGRE DO PIAUI",0,0,1,159,34,194,"2019"
"51081","220665 MORRO CABECA NO TEMPO",0,0,0,21,31,52,"2019"
"51082","220667 MORRO DO CHAPEU DO PIAUI",0,1,2,81,0,84,"2019"
"51083","220669 MURICI DOS PORTELAS",0,0,2,112,2,116,"2019"
"51084","220670 NAZARE DO PIAUI",0,0,3,101,0,104,"2019"
"51085","220672 NAZARIA",0,0,0,174,6,180,"2019"
"51086","220675 NOSSA SENHORA DE NAZARE",1,0,1,56,3,61,"2019"
"51087","220680 NOSSA SENHORA DOS REMEDIOS",0,1,2,129,0,132,"2019"
"51088","220690 NOVO ORIENTE DO PIAUI",1,0,0,60,1,62,"2019"
"51089","220695 NOVO SANTO ANTONIO",0,0,0,40,0,40,"2019"
"51090","220700 OEIRAS",1,1,6,485,1,494,"2019"
"51091","220710 OLHO D'AGUA DO PIAUI",0,0,0,45,1,46,"2019"
"51092","220720 PADRE MARCOS",0,1,1,92,0,94,"2019"
"51093","220730 PAES LANDIM",0,1,0,50,0,51,"2019"
"51094","220735 PAJEU DO PIAUI",0,0,4,22,0,26,"2019"
"51095","220740 PALMEIRA DO PIAUI",0,1,0,55,7,63,"2019"
"51096","220750 PALMEIRAIS",1,0,3,144,51,199,"2019"
"51097","220755 PAQUETA",0,0,1,52,0,53,"2019"
"51098","220760 PARNAGUA",0,0,1,30,133,164,"2019"
"51099","220770 PARNAIBA",8,12,32,2463,2,2517,"2019"
"51100","220775 PASSAGEM FRANCA DO PIAUI",0,0,0,46,1,47,"2019"
"51101","220777 PATOS DO PIAUI",0,0,0,55,0,55,"2019"
"51102","220779 PAU D'ARCO DO PIAUI",0,0,2,41,0,43,"2019"
"51103","220780 PAULISTANA",1,2,7,269,38,317,"2019"
"51104","220785 PAVUSSU",0,0,0,42,2,44,"2019"
"51105","220790 PEDRO II",0,1,10,498,6,515,"2019"
"51106","220793 PEDRO LAURENTINO",0,0,0,32,0,32,"2019"
"51107","220795 NOVA SANTA RITA",0,0,1,59,0,60,"2019"
"51108","220800 PICOS",0,4,14,1075,1,1094,"2019"
"51109","220810 PIMENTEIRAS",1,1,0,124,0,126,"2019"
"51110","220820 PIO IX",0,2,1,209,4,216,"2019"
"51111","220830 PIRACURUCA",1,1,4,398,0,404,"2019"
"51112","220840 PIRIPIRI",2,4,13,854,5,878,"2019"
"51113","220850 PORTO",0,1,4,227,1,233,"2019"
"51114","220855 PORTO ALEGRE DO PIAUI",0,0,0,43,0,43,"2019"
"51115","220860 PRATA DO PIAUI",0,0,0,26,0,26,"2019"
"51116","220865 QUEIMADA NOVA",0,1,1,84,14,100,"2019"
"51117","220870 REDENCAO DO GURGUEIA",0,0,3,136,19,158,"2019"
"51118","220880 REGENERACAO",0,2,3,231,1,237,"2019"
"51119","220885 RIACHO FRIO",0,0,0,8,52,60,"2019"
"51120","220887 RIBEIRA DO PIAUI",0,3,0,53,1,57,"2019"
"51121","220890 RIBEIRO GONCALVES",0,0,0,22,66,88,"2019"
"51122","220900 RIO GRANDE DO PIAUI",0,3,3,63,3,72,"2019"
"51123","220910 SANTA CRUZ DO PIAUI",0,0,0,83,3,86,"2019"
"51124","220915 SANTA CRUZ DOS MILAGRES",0,0,0,30,0,30,"2019"
"51125","220920 SANTA FILOMENA",0,2,1,96,5,104,"2019"
"51126","220930 SANTA LUZ",0,0,2,72,5,79,"2019"
"51127","220935 SANTANA DO PIAUI",0,0,2,40,0,42,"2019"
"51128","220937 SANTA ROSA DO PIAUI",1,0,2,54,0,57,"2019"
"51129","220940 SANTO ANTONIO DE LISBOA",0,0,2,83,0,85,"2019"
"51130","220945 SANTO ANTONIO DOS MILAGRES",0,1,0,25,0,26,"2019"
"51131","220950 SANTO INACIO DO PIAUI",0,1,0,52,1,54,"2019"
"51132","220955 SAO BRAZ DO PIAUI",0,0,0,43,9,52,"2019"
"51133","220960 SAO FELIX DO PIAUI",0,0,0,23,0,23,"2019"
"51134","220965 SAO FRANCISCO DE ASSIS DO PIAUI",2,1,1,73,1,78,"2019"
"51135","220970 SAO FRANCISCO DO PIAUI",0,0,3,60,0,63,"2019"
"51136","220975 SAO GONCALO DO GURGUEIA",0,0,0,18,16,34,"2019"
"51137","220980 SAO GONCALO DO PIAUI",0,1,2,70,0,73,"2019"
"51138","220985 SAO JOAO DA CANABRAVA",0,0,0,51,0,51,"2019"
"51139","220987 SAO JOAO DA FRONTEIRA",0,1,3,69,3,76,"2019"
"51140","220990 SAO JOAO DA SERRA",0,0,0,57,25,82,"2019"
"51141","220995 SAO JOAO DA VARJOTA",0,0,0,52,0,52,"2019"
"51142","220997 SAO JOAO DO ARRAIAL",0,0,4,120,1,125,"2019"
"51143","221000 SAO JOAO DO PIAUI",1,0,10,343,2,356,"2019"
"51144","221005 SAO JOSE DO DIVINO",1,0,1,59,0,61,"2019"
"51145","221010 SAO JOSE DO PEIXE",0,0,0,42,1,43,"2019"
"51146","221020 SAO JOSE DO PIAUI",0,0,1,82,0,83,"2019"
"51147","221030 SAO JULIAO",0,0,0,65,1,66,"2019"
"51148","221035 SAO LOURENCO DO PIAUI",0,0,0,29,11,40,"2019"
"51149","221037 SAO LUIS DO PIAUI",0,0,0,28,0,28,"2019"
"51150","221038 SAO MIGUEL DA BAIXA GRANDE",0,0,0,24,2,26,"2019"
"51151","221039 SAO MIGUEL DO FIDALGO",0,0,0,51,1,52,"2019"
"51152","221040 SAO MIGUEL DO TAPUIO",0,2,0,188,35,225,"2019"
"51153","221050 SAO PEDRO DO PIAUI",0,0,3,195,1,199,"2019"
"51154","221060 SAO RAIMUNDO NONATO",2,2,17,473,124,618,"2019"
"51155","221062 SEBASTIAO BARROS",0,0,0,16,29,45,"2019"
"51156","221063 SEBASTIAO LEAL",0,1,2,60,0,63,"2019"
"51157","221065 SIGEFREDO PACHECO",0,0,1,87,9,97,"2019"
"51158","221070 SIMOES",0,0,2,170,0,172,"2019"
"51159","221080 SIMPLICIO MENDES",0,1,3,192,0,196,"2019"
"51160","221090 SOCORRO DO PIAUI",0,0,0,48,1,49,"2019"
"51161","221093 SUSSUAPARA",0,1,1,93,0,95,"2019"
"51162","221095 TAMBORIL DO PIAUI",0,0,2,35,4,41,"2019"
"51163","221097 TANQUE DO PIAUI",0,1,0,36,0,37,"2019"
"51164","221100 TERESINA",38,49,125,13333,79,13624,"2019"
"51165","221110 UNIAO",3,0,12,554,167,736,"2019"
"51166","221120 URUCUI",3,0,8,381,7,399,"2019"
"51167","221130 VALENCA DO PIAUI",1,0,0,284,2,287,"2019"
"51168","221135 VARZEA BRANCA",0,0,0,51,6,57,"2019"
"51169","221140 VARZEA GRANDE",0,0,0,56,0,56,"2019"
"51170","221150 VERA MENDES",0,0,1,42,0,43,"2019"
"51171","221160 VILA NOVA DO PIAUI",0,0,0,27,0,27,"2019"
"51172","221170 WALL FERRAZ",1,1,0,29,1,32,"2019"
"51173","230010 ABAIARA",0,1,1,144,0,146,"2019"
"51174","230015 ACARAPE",1,2,4,208,0,215,"2019"
"51175","230020 ACARAU",7,4,17,1046,1,1075,"2019"
"51176","230030 ACOPIARA",1,2,34,565,1,603,"2019"
"51177","230040 AIUABA",0,1,6,168,0,175,"2019"
"51178","230050 ALCANTARAS",0,1,1,146,0,148,"2019"
"51179","230060 ALTANEIRA",0,1,1,128,0,130,"2019"
"51180","230070 ALTO SANTO",0,0,3,173,2,178,"2019"
"51181","230075 AMONTADA",1,2,8,433,255,699,"2019"
"51182","230080 ANTONINA DO NORTE",0,0,4,99,0,103,"2019"
"51183","230090 APUIARES",1,0,4,174,1,180,"2019"
"51184","230100 AQUIRAZ",3,3,17,1157,9,1189,"2019"
"51185","230110 ARACATI",1,6,11,996,5,1019,"2019"
"51186","230120 ARACOIABA",1,1,8,362,3,375,"2019"
"51187","230125 ARARENDA",1,0,1,145,2,149,"2019"
"51188","230130 ARARIPE",0,2,14,350,0,366,"2019"
"51189","230140 ARATUBA",3,0,7,165,1,176,"2019"
"51190","230150 ARNEIROZ",0,1,5,107,1,114,"2019"
"51191","230160 ASSARE",3,0,6,288,1,298,"2019"
"51192","230170 AURORA",1,1,5,312,2,321,"2019"
"51193","230180 BAIXIO",0,0,0,67,0,67,"2019"
"51194","230185 BANABUIU",0,3,4,256,1,264,"2019"
"51195","230190 BARBALHA",6,5,37,1180,32,1260,"2019"
"51196","230195 BARREIRA",1,4,2,324,0,331,"2019"
"51197","230200 BARRO",0,0,7,224,2,233,"2019"
"51198","230205 BARROQUINHA",1,1,7,210,0,219,"2019"
"51199","230210 BATURITE",1,6,15,519,2,543,"2019"
"51200","230220 BEBERIBE",2,4,10,682,4,702,"2019"
"51201","230230 BELA CRUZ",1,1,6,418,1,427,"2019"
"51202","230240 BOA VIAGEM",2,5,15,587,7,616,"2019"
"51203","230250 BREJO SANTO",2,0,15,780,1,798,"2019"
"51204","230260 CAMOCIM",1,6,30,976,1,1014,"2019"
"51205","230270 CAMPOS SALES",1,4,10,405,0,420,"2019"
"51206","230280 CANINDE",3,2,22,1098,8,1133,"2019"
"51207","230290 CAPISTRANO",0,2,6,241,1,250,"2019"
"51208","230300 CARIDADE",1,0,7,265,4,277,"2019"
"51209","230310 CARIRE",0,0,5,239,0,244,"2019"
"51210","230320 CARIRIACU",1,2,15,439,1,458,"2019"
"51211","230330 CARIUS",0,0,9,193,1,203,"2019"
"51212","230340 CARNAUBAL",1,3,5,256,1,266,"2019"
"51213","230350 CASCAVEL",3,2,17,1042,11,1075,"2019"
"51214","230360 CATARINA",0,1,6,84,0,91,"2019"
"51215","230365 CATUNDA",0,1,2,106,2,111,"2019"
"51216","230370 CAUCAIA",18,16,76,5203,33,5346,"2019"
"51217","230380 CEDRO",1,1,4,313,0,319,"2019"
"51218","230390 CHAVAL",0,1,6,196,0,203,"2019"
"51219","230393 CHORO",1,1,1,163,2,168,"2019"
"51220","230395 CHOROZINHO",1,1,2,306,2,312,"2019"
"51221","230400 COREAU",2,2,10,289,0,303,"2019"
"51222","230410 CRATEUS",2,5,18,1074,1,1100,"2019"
"51223","230420 CRATO",12,11,57,2125,7,2212,"2019"
"51224","230423 CROATA",3,1,3,257,1,265,"2019"
"51225","230425 CRUZ",2,0,13,482,1,498,"2019"
"51226","230426 DEPUTADO IRAPUAN PINHEIRO",1,0,2,84,0,87,"2019"
"51227","230427 ERERE",1,0,2,29,2,34,"2019"
"51228","230428 EUSEBIO",5,6,17,1195,5,1228,"2019"
"51229","230430 FARIAS BRITO",2,1,7,257,0,267,"2019"
"51230","230435 FORQUILHA",4,1,1,319,2,327,"2019"
"51231","230440 FORTALEZA",102,130,513,34025,187,34957,"2019"
"51232","230445 FORTIM",2,0,1,193,1,197,"2019"
"51233","230450 FRECHEIRINHA",2,1,6,252,2,263,"2019"
"51234","230460 GENERAL SAMPAIO",0,0,3,106,0,109,"2019"
"51235","230465 GRACA",0,0,8,162,0,170,"2019"
"51236","230470 GRANJA",0,4,15,793,0,812,"2019"
"51237","230480 GRANJEIRO",0,0,1,72,0,73,"2019"
"51238","230490 GROAIRAS",0,1,1,161,1,164,"2019"
"51239","230495 GUAIUBA",0,1,7,322,5,335,"2019"
"51240","230500 GUARACIABA DO NORTE",3,8,12,669,1,693,"2019"
"51241","230510 GUARAMIRANGA",0,0,1,66,0,67,"2019"
"51242","230520 HIDROLANDIA",0,0,2,252,1,255,"2019"
"51243","230523 HORIZONTE",1,3,19,1193,4,1220,"2019"
"51244","230526 IBARETAMA",1,0,7,195,0,203,"2019"
"51245","230530 IBIAPINA",2,4,2,364,4,376,"2019"
"51246","230533 IBICUITINGA",0,0,2,143,4,149,"2019"
"51247","230535 ICAPUI",1,1,3,238,2,245,"2019"
"51248","230540 ICO",3,2,8,879,1,893,"2019"
"51249","230550 IGUATU",7,9,62,1285,5,1368,"2019"
"51250","230560 INDEPENDENCIA",1,1,8,253,4,267,"2019"
"51251","230565 IPAPORANGA",0,0,2,144,0,146,"2019"
"51252","230570 IPAUMIRIM",0,1,1,145,0,147,"2019"
"51253","230580 IPU",2,3,16,645,5,671,"2019"
"51254","230590 IPUEIRAS",1,1,7,473,1,483,"2019"
"51255","230600 IRACEMA",0,0,4,173,0,177,"2019"
"51256","230610 IRAUCUBA",1,1,4,354,0,360,"2019"
"51257","230620 ITAICABA",2,0,2,87,1,92,"2019"
"51258","230625 ITAITINGA",1,2,10,660,0,673,"2019"
"51259","230630 ITAPAGE",0,5,15,757,3,780,"2019"
"51260","230640 ITAPIPOCA",3,7,29,1389,778,2206,"2019"
"51261","230650 ITAPIUNA",0,3,6,212,1,222,"2019"
"51262","230655 ITAREMA",3,1,17,687,3,711,"2019"
"51263","230660 ITATIRA",0,0,9,316,3,328,"2019"
"51264","230670 JAGUARETAMA",2,1,7,203,2,215,"2019"
"51265","230680 JAGUARIBARA",0,0,2,141,0,143,"2019"
"51266","230690 JAGUARIBE",1,3,6,448,1,459,"2019"
"51267","230700 JAGUARUANA",0,0,3,365,2,370,"2019"
"51268","230710 JARDIM",1,4,7,393,10,415,"2019"
"51269","230720 JATI",0,0,2,130,0,132,"2019"
"51270","230725 JIJOCA DE JERICOACOARA",1,1,11,403,1,417,"2019"
"51271","230730 JUAZEIRO DO NORTE",8,8,122,4002,18,4158,"2019"
"51272","230740 JUCAS",2,0,10,290,2,304,"2019"
"51273","230750 LAVRAS DA MANGABEIRA",1,1,6,342,0,350,"2019"
"51274","230760 LIMOEIRO DO NORTE",3,5,11,710,1,730,"2019"
"51275","230763 MADALENA",0,1,3,194,0,198,"2019"
"51276","230765 MARACANAU",10,17,39,4465,12,4543,"2019"
"51277","230770 MARANGUAPE",7,3,21,1472,13,1516,"2019"
"51278","230780 MARCO",4,3,8,519,0,534,"2019"
"51279","230790 MARTINOPOLE",0,2,2,168,0,172,"2019"
"51280","230800 MASSAPE",3,1,11,604,0,619,"2019"
"51281","230810 MAURITI",2,5,8,701,0,716,"2019"
"51282","230820 MERUOCA",0,2,4,241,0,247,"2019"
"51283","230830 MILAGRES",0,1,5,377,1,384,"2019"
"51284","230835 MILHA",0,1,1,148,0,150,"2019"
"51285","230837 MIRAIMA",0,0,3,119,86,208,"2019"
"51286","230840 MISSAO VELHA",2,4,17,557,15,595,"2019"
"51287","230850 MOMBACA",0,1,13,493,2,509,"2019"
"51288","230860 MONSENHOR TABOSA",1,0,2,237,6,246,"2019"
"51289","230870 MORADA NOVA",0,6,18,744,1,769,"2019"
"51290","230880 MORAUJO",0,0,2,137,0,139,"2019"
"51291","230890 MORRINHOS",1,1,3,314,1,320,"2019"
"51292","230900 MUCAMBO",2,2,1,153,0,158,"2019"
"51293","230910 MULUNGU",1,0,1,125,0,127,"2019"
"51294","230920 NOVA OLINDA",1,0,4,267,1,273,"2019"
"51295","230930 NOVA RUSSAS",0,1,5,361,1,368,"2019"
"51296","230940 NOVO ORIENTE",0,4,2,373,0,379,"2019"
"51297","230945 OCARA",0,3,9,274,0,286,"2019"
"51298","230950 OROS",0,1,7,261,0,269,"2019"
"51299","230960 PACAJUS",4,2,19,911,2,938,"2019"
"51300","230970 PACATUBA",3,2,11,997,6,1019,"2019"
"51301","230980 PACOTI",0,0,0,152,1,153,"2019"
"51302","230990 PACUJA",0,0,0,68,0,68,"2019"
"51303","231000 PALHANO",1,1,4,104,1,111,"2019"
"51304","231010 PALMACIA",0,1,0,130,1,132,"2019"
"51305","231020 PARACURU",2,4,11,589,0,606,"2019"
"51306","231025 PARAIPABA",0,3,9,395,3,410,"2019"
"51307","231030 PARAMBU",3,4,14,405,14,440,"2019"
"51308","231040 PARAMOTI",1,0,3,105,0,109,"2019"
"51309","231050 PEDRA BRANCA",0,3,8,470,3,484,"2019"
"51310","231060 PENAFORTE",3,0,6,197,3,209,"2019"
"51311","231070 PENTECOSTE",1,2,9,526,4,542,"2019"
"51312","231080 PEREIRO",0,0,7,215,0,222,"2019"
"51313","231085 PINDORETAMA",2,0,4,331,4,341,"2019"
"51314","231090 PIQUET CARNEIRO",1,1,3,157,0,162,"2019"
"51315","231095 PIRES FERREIRA",0,0,2,75,0,77,"2019"
"51316","231100 PORANGA",1,1,3,155,1,161,"2019"
"51317","231110 PORTEIRAS",4,2,2,257,1,266,"2019"
"51318","231120 POTENGI",0,1,1,138,0,140,"2019"
"51319","231123 POTIRETAMA",0,0,0,75,1,76,"2019"
"51320","231126 QUITERIANOPOLIS",0,3,5,251,1,260,"2019"
"51321","231130 QUIXADA",3,7,20,1339,6,1375,"2019"
"51322","231135 QUIXELO",1,3,7,163,0,174,"2019"
"51323","231140 QUIXERAMOBIM",4,10,33,1173,11,1231,"2019"
"51324","231150 QUIXERE",0,0,3,238,1,242,"2019"
"51325","231160 REDENCAO",2,2,6,359,1,370,"2019"
"51326","231170 RERIUTABA",2,3,2,237,0,244,"2019"
"51327","231180 RUSSAS",2,8,15,927,0,952,"2019"
"51328","231190 SABOEIRO",0,1,10,176,1,188,"2019"
"51329","231195 SALITRE",1,2,8,254,0,265,"2019"
"51330","231200 SANTANA DO ACARAU",1,3,8,412,5,429,"2019"
"51331","231210 SANTANA DO CARIRI",1,1,10,275,0,287,"2019"
"51332","231220 SANTA QUITERIA",3,4,7,534,1,549,"2019"
"51333","231230 SAO BENEDITO",4,4,15,805,0,828,"2019"
"51334","231240 SAO GONCALO DO AMARANTE",3,4,17,840,8,872,"2019"
"51335","231250 SAO JOAO DO JAGUARIBE",0,1,1,79,0,81,"2019"
"51336","231260 SAO LUIS DO CURU",0,0,1,171,0,172,"2019"
"51337","231270 SENADOR POMPEU",2,0,11,262,1,276,"2019"
"51338","231280 SENADOR SA",0,0,3,105,0,108,"2019"
"51339","231290 SOBRAL",2,8,49,3196,7,3262,"2019"
"51340","231300 SOLONOPOLE",2,1,5,208,1,217,"2019"
"51341","231310 TABULEIRO DO NORTE",0,2,5,381,0,388,"2019"
"51342","231320 TAMBORIL",1,1,6,330,1,339,"2019"
"51343","231325 TARRAFAS",0,1,2,96,0,99,"2019"
"51344","231330 TAUA",0,3,25,745,0,773,"2019"
"51345","231335 TEJUCUOCA",1,3,6,211,1,222,"2019"
"51346","231340 TIANGUA",6,2,18,1442,3,1471,"2019"
"51347","231350 TRAIRI",1,3,9,527,194,734,"2019"
"51348","231355 TURURU",2,1,0,146,94,243,"2019"
"51349","231360 UBAJARA",3,0,8,583,2,596,"2019"
"51350","231370 UMARI",0,0,2,84,1,87,"2019"
"51351","231375 UMIRIM",0,1,5,180,96,282,"2019"
"51352","231380 URUBURETAMA",0,3,5,244,135,387,"2019"
"51353","231390 URUOCA",1,1,6,191,0,199,"2019"
"51354","231395 VARJOTA",0,2,5,265,1,273,"2019"
"51355","231400 VARZEA ALEGRE",0,3,8,487,0,498,"2019"
"51356","231410 VICOSA DO CEARA",1,0,13,970,2,986,"2019"
"51357","240010 ACARI",1,0,1,99,0,101,"2019"
"51358","240020 ACU",2,7,7,709,0,725,"2019"
"51359","240030 AFONSO BEZERRA",0,0,1,95,0,96,"2019"
"51360","240040 AGUA NOVA",1,1,1,34,0,37,"2019"
"51361","240050 ALEXANDRIA",0,1,0,181,0,182,"2019"
"51362","240060 ALMINO AFONSO",0,0,1,47,0,48,"2019"
"51363","240070 ALTO DO RODRIGUES",0,1,1,166,2,170,"2019"
"51364","240080 ANGICOS",1,0,0,126,1,128,"2019"
"51365","240090 ANTONIO MARTINS",1,0,1,67,2,71,"2019"
"51366","240100 APODI",0,4,9,395,0,408,"2019"
"51367","240110 AREIA BRANCA",0,1,6,311,2,320,"2019"
"51368","240120 ARES",1,0,3,180,3,187,"2019"
"51369","240130 AUGUSTO SEVERO",1,0,0,90,0,91,"2019"
"51370","240140 BAIA FORMOSA",1,1,2,107,2,113,"2019"
"51371","240145 BARAUNA",2,0,2,347,1,352,"2019"
"51372","240150 BARCELONA",0,1,1,47,1,50,"2019"
"51373","240160 BENTO FERNANDES",0,0,1,66,0,67,"2019"
"51374","240165 BODO",0,0,5,49,0,54,"2019"
"51375","240170 BOM JESUS",0,1,2,117,1,121,"2019"
"51376","240180 BREJINHO",4,0,3,160,1,168,"2019"
"51377","240185 CAICARA DO NORTE",0,0,0,74,2,76,"2019"
"51378","240190 CAICARA DO RIO DO VENTO",1,1,0,42,0,44,"2019"
"51379","240200 CAICO",8,6,24,633,0,671,"2019"
"51380","240210 CAMPO REDONDO",0,0,4,135,0,139,"2019"
"51381","240220 CANGUARETAMA",1,1,5,514,5,526,"2019"
"51382","240230 CARAUBAS",1,0,3,229,3,236,"2019"
"51383","240240 CARNAUBA DOS DANTAS",1,1,5,86,0,93,"2019"
"51384","240250 CARNAUBAIS",0,1,2,131,0,134,"2019"
"51385","240260 CEARA-MIRIM",5,1,6,1027,2,1041,"2019"
"51386","240270 CERRO CORA",0,0,7,122,3,132,"2019"
"51387","240280 CORONEL EZEQUIEL",0,0,1,75,0,76,"2019"
"51388","240290 CORONEL JOAO PESSOA",0,0,0,58,0,58,"2019"
"51389","240300 CRUZETA",0,0,1,69,0,70,"2019"
"51390","240310 CURRAIS NOVOS",0,2,24,472,1,499,"2019"
"51391","240320 DOUTOR SEVERIANO",0,1,1,97,0,99,"2019"
"51392","240325 PARNAMIRIM",7,11,38,3383,10,3449,"2019"
"51393","240330 ENCANTO",0,0,2,87,0,89,"2019"
"51394","240340 EQUADOR",0,0,1,59,0,60,"2019"
"51395","240350 ESPIRITO SANTO",0,0,1,110,1,112,"2019"
"51396","240360 EXTREMOZ",2,1,8,543,6,560,"2019"
"51397","240370 FELIPE GUERRA",0,0,2,39,0,41,"2019"
"51398","240375 FERNANDO PEDROZA",1,0,0,34,0,35,"2019"
"51399","240380 FLORANIA",0,0,9,95,2,106,"2019"
"51400","240390 FRANCISCO DANTAS",0,0,0,32,0,32,"2019"
"51401","240400 FRUTUOSO GOMES",0,0,0,50,0,50,"2019"
"51402","240410 GALINHOS",0,0,0,39,0,39,"2019"
"51403","240420 GOIANINHA",1,1,12,475,2,491,"2019"
"51404","240430 GOVERNADOR DIX-SEPT ROSADO",2,1,2,134,0,139,"2019"
"51405","240440 GROSSOS",0,0,1,124,0,125,"2019"
"51406","240450 GUAMARE",1,1,5,268,1,276,"2019"
"51407","240460 IELMO MARINHO",2,1,2,131,0,136,"2019"
"51408","240470 IPANGUACU",0,1,2,193,0,196,"2019"
"51409","240480 IPUEIRA",0,0,2,13,0,15,"2019"
"51410","240485 ITAJA",0,1,0,85,0,86,"2019"
"51411","240490 ITAU",0,0,0,48,0,48,"2019"
"51412","240500 JACANA",0,1,2,104,1,108,"2019"
"51413","240510 JANDAIRA",0,0,1,75,3,79,"2019"
"51414","240520 JANDUIS",0,0,0,58,0,58,"2019"
"51415","240530 JANUARIO CICCO",0,1,5,164,3,173,"2019"
"51416","240540 JAPI",0,1,1,114,0,116,"2019"
"51417","240550 JARDIM DE ANGICOS",0,1,0,37,0,38,"2019"
"51418","240560 JARDIM DE PIRANHAS",0,1,4,162,0,167,"2019"
"51419","240570 JARDIM DO SERIDO",0,0,0,101,0,101,"2019"
"51420","240580 JOAO CAMARA",0,2,9,485,4,500,"2019"
"51421","240590 JOAO DIAS",0,0,0,35,0,35,"2019"
"51422","240600 JOSE DA PENHA",0,0,1,78,0,79,"2019"
"51423","240610 JUCURUTU",1,0,3,219,1,224,"2019"
"51424","240615 JUNDIA",0,0,0,12,0,12,"2019"
"51425","240620 LAGOA D'ANTA",0,0,4,110,1,115,"2019"
"51426","240630 LAGOA DE PEDRAS",0,0,4,95,0,99,"2019"
"51427","240640 LAGOA DE VELHOS",0,0,1,41,0,42,"2019"
"51428","240650 LAGOA NOVA",1,1,6,210,0,218,"2019"
"51429","240660 LAGOA SALGADA",1,0,2,152,0,155,"2019"
"51430","240670 LAJES",0,0,0,112,1,113,"2019"
"51431","240680 LAJES PINTADAS",0,1,1,63,1,66,"2019"
"51432","240690 LUCRECIA",0,0,1,45,0,46,"2019"
"51433","240700 LUIS GOMES",1,1,0,149,0,151,"2019"
"51434","240710 MACAIBA",2,0,9,990,6,1007,"2019"
"51435","240720 MACAU",3,2,6,305,2,318,"2019"
"51436","240725 MAJOR SALES",2,1,0,53,0,56,"2019"
"51437","240730 MARCELINO VIEIRA",0,0,1,102,0,103,"2019"
"51438","240740 MARTINS",0,1,0,105,0,106,"2019"
"51439","240750 MAXARANGUAPE",1,0,2,127,2,132,"2019"
"51440","240760 MESSIAS TARGINO",1,0,0,53,0,54,"2019"
"51441","240770 MONTANHAS",1,0,1,161,3,166,"2019"
"51442","240780 MONTE ALEGRE",0,1,3,258,1,263,"2019"
"51443","240790 MONTE DAS GAMELEIRAS",0,1,2,45,1,49,"2019"
"51444","240800 MOSSORO",6,16,30,3646,2,3700,"2019"
"51445","240810 NATAL",32,49,180,10338,41,10640,"2019"
"51446","240820 NISIA FLORESTA",1,1,1,359,0,362,"2019"
"51447","240830 NOVA CRUZ",2,3,11,475,1,492,"2019"
"51448","240840 OLHO-D'AGUA DO BORGES",0,1,0,35,0,36,"2019"
"51449","240850 OURO BRANCO",0,0,4,45,0,49,"2019"
"51450","240860 PARANA",0,0,1,45,0,46,"2019"
"51451","240870 PARAU",0,0,1,49,0,50,"2019"
"51452","240880 PARAZINHO",1,1,0,107,3,112,"2019"
"51453","240890 PARELHAS",0,1,3,257,0,261,"2019"
"51454","240895 RIO DO FOGO",0,0,2,157,0,159,"2019"
"51455","240910 PASSA E FICA",0,1,2,145,0,148,"2019"
"51456","240920 PASSAGEM",0,0,1,38,1,40,"2019"
"51457","240930 PATU",0,0,0,121,0,121,"2019"
"51458","240933 SANTA MARIA",1,0,0,70,2,73,"2019"
"51459","240940 PAU DOS FERROS",3,3,0,362,0,368,"2019"
"51460","240950 PEDRA GRANDE",0,0,0,58,0,58,"2019"
"51461","240960 PEDRA PRETA",0,0,0,33,0,33,"2019"
"51462","240970 PEDRO AVELINO",0,1,0,58,2,61,"2019"
"51463","240980 PEDRO VELHO",0,1,4,216,1,222,"2019"
"51464","240990 PENDENCIAS",1,1,0,145,0,147,"2019"
"51465","241000 PILOES",0,0,2,48,1,51,"2019"
"51466","241010 POCO BRANCO",0,0,1,167,4,172,"2019"
"51467","241020 PORTALEGRE",0,1,1,110,0,112,"2019"
"51468","241025 PORTO DO MANGUE",0,1,0,78,0,79,"2019"
"51469","241030 SERRA CAIADA",0,1,4,161,1,167,"2019"
"51470","241040 PUREZA",0,0,2,121,1,124,"2019"
"51471","241050 RAFAEL FERNANDES",0,3,0,61,0,64,"2019"
"51472","241060 RAFAEL GODEIRO",0,0,0,22,0,22,"2019"
"51473","241070 RIACHO DA CRUZ",0,0,0,42,0,42,"2019"
"51474","241080 RIACHO DE SANTANA",0,0,0,43,0,43,"2019"
"51475","241090 RIACHUELO",0,0,3,100,0,103,"2019"
"51476","241100 RODOLFO FERNANDES",0,0,0,52,0,52,"2019"
"51477","241105 TIBAU",0,0,1,69,1,71,"2019"
"51478","241110 RUY BARBOSA",0,0,2,37,0,39,"2019"
"51479","241120 SANTA CRUZ",0,2,12,514,1,529,"2019"
"51480","241140 SANTANA DO MATOS",0,1,3,124,0,128,"2019"
"51481","241142 SANTANA DO SERIDO",0,0,1,24,0,25,"2019"
"51482","241150 SANTO ANTONIO",3,3,5,301,1,313,"2019"
"51483","241160 SAO BENTO DO NORTE",0,0,1,52,1,54,"2019"
"51484","241170 SAO BENTO DO TRAIRI",0,0,1,46,1,48,"2019"
"51485","241180 SAO FERNANDO",0,0,2,37,0,39,"2019"
"51486","241190 SAO FRANCISCO DO OESTE",1,0,1,48,0,50,"2019"
"51487","241200 SAO GONCALO DO AMARANTE",2,5,23,1377,3,1410,"2019"
"51488","241210 SAO JOAO DO SABUGI",0,0,2,55,0,57,"2019"
"51489","241220 SAO JOSE DE MIPIBU",1,3,11,710,1,726,"2019"
"51490","241230 SAO JOSE DO CAMPESTRE",0,0,2,146,0,148,"2019"
"51491","241240 SAO JOSE DO SERIDO",0,2,2,46,1,51,"2019"
"51492","241250 SAO MIGUEL",3,0,4,294,3,304,"2019"
"51493","241255 SAO MIGUEL DO GOSTOSO",0,2,3,128,3,136,"2019"
"51494","241260 SAO PAULO DO POTENGI",0,0,5,202,0,207,"2019"
"51495","241270 SAO PEDRO",0,0,1,73,2,76,"2019"
"51496","241280 SAO RAFAEL",0,0,0,76,0,76,"2019"
"51497","241290 SAO TOME",0,0,3,109,2,114,"2019"
"51498","241300 SAO VICENTE",0,3,2,60,0,65,"2019"
"51499","241310 SENADOR ELOI DE SOUZA",1,0,5,82,1,89,"2019"
"51500","241320 SENADOR GEORGINO AVELINO",0,0,3,76,4,83,"2019"
"51501","241330 SERRA DE SAO BENTO",0,1,2,88,2,93,"2019"
"51502","241335 SERRA DO MEL",2,2,2,205,0,211,"2019"
"51503","241340 SERRA NEGRA DO NORTE",0,0,1,78,0,79,"2019"
"51504","241350 SERRINHA",1,1,3,68,0,73,"2019"
"51505","241355 SERRINHA DOS PINTOS",0,0,0,62,0,62,"2019"
"51506","241360 SEVERIANO MELO",0,1,0,65,0,66,"2019"
"51507","241370 SITIO NOVO",0,1,2,55,0,58,"2019"
"51508","241380 TABOLEIRO GRANDE",0,0,0,35,0,35,"2019"
"51509","241390 TAIPU",0,0,0,128,1,129,"2019"
"51510","241400 TANGARA",0,0,4,165,1,170,"2019"
"51511","241410 TENENTE ANANIAS",0,0,3,144,0,147,"2019"
"51512","241415 TENENTE LAURENTINO CRUZ",0,0,2,72,2,76,"2019"
"51513","241420 TIBAU DO SUL",1,0,1,220,1,223,"2019"
"51514","241430 TIMBAUBA DOS BATISTAS",0,0,1,14,0,15,"2019"
"51515","241440 TOUROS",1,2,5,453,5,466,"2019"
"51516","241445 TRIUNFO POTIGUAR",0,2,1,41,0,44,"2019"
"51517","241450 UMARIZAL",0,0,0,94,1,95,"2019"
"51518","241460 UPANEMA",3,1,2,177,0,183,"2019"
"51519","241470 VARZEA",0,0,1,76,0,77,"2019"
"51520","241475 VENHA-VER",0,0,0,49,0,49,"2019"
"51521","241480 VERA CRUZ",0,0,4,159,2,165,"2019"
"51522","241490 VICOSA",0,0,0,11,0,11,"2019"
"51523","241500 VILA FLOR",0,0,0,39,1,40,"2019"
"51524","250010 AGUA BRANCA",0,1,3,116,2,122,"2019"
"51525","250020 AGUIAR",0,0,0,45,0,45,"2019"
"51526","250030 ALAGOA GRANDE",0,4,5,406,2,417,"2019"
"51527","250040 ALAGOA NOVA",0,0,3,310,3,316,"2019"
"51528","250050 ALAGOINHA",0,2,1,212,0,215,"2019"
"51529","250053 ALCANTIL",0,0,1,85,3,89,"2019"
"51530","250057 ALGODAO DE JANDAIRA",0,0,1,58,2,61,"2019"
"51531","250060 ALHANDRA",1,2,4,354,6,367,"2019"
"51532","250070 SAO JOAO DO RIO DO PEIXE",1,0,3,172,1,177,"2019"
"51533","250073 AMPARO",0,1,0,36,0,37,"2019"
"51534","250077 APARECIDA",0,0,0,83,0,83,"2019"
"51535","250080 ARACAGI",0,0,2,196,2,200,"2019"
"51536","250090 ARARA",0,0,1,120,6,127,"2019"
"51537","250100 ARARUNA",0,0,3,252,2,257,"2019"
"51538","250110 AREIA",0,0,5,361,5,371,"2019"
"51539","250115 AREIA DE BARAUNAS",1,0,0,36,2,39,"2019"
"51540","250120 AREIAL",0,0,3,97,2,102,"2019"
"51541","250130 AROEIRAS",1,0,4,251,4,260,"2019"
"51542","250135 ASSUNCAO",0,0,0,63,0,63,"2019"
"51543","250140 BAIA DA TRAICAO",0,1,2,179,0,182,"2019"
"51544","250150 BANANEIRAS",2,0,2,256,3,263,"2019"
"51545","250153 BARAUNA",1,0,0,67,0,68,"2019"
"51546","250157 BARRA DE SANTANA",0,1,2,99,0,102,"2019"
"51547","250160 BARRA DE SANTA ROSA",0,1,0,128,0,129,"2019"
"51548","250170 BARRA DE SAO MIGUEL",0,1,0,133,1,135,"2019"
"51549","250180 BAYEUX",3,6,38,1279,7,1333,"2019"
"51550","250190 BELEM",1,1,2,220,1,225,"2019"
"51551","250200 BELEM DO BREJO DO CRUZ",1,1,0,71,0,73,"2019"
"51552","250205 BERNARDINO BATISTA",0,0,0,41,2,43,"2019"
"51553","250210 BOA VENTURA",0,0,3,99,0,102,"2019"
"51554","250215 BOA VISTA",0,0,1,98,2,101,"2019"
"51555","250220 BOM JESUS",0,0,0,47,1,48,"2019"
"51556","250230 BOM SUCESSO",0,1,0,36,1,38,"2019"
"51557","250240 BONITO DE SANTA FE",0,0,3,158,3,164,"2019"
"51558","250250 BOQUEIRAO",1,1,3,267,3,275,"2019"
"51559","250260 IGARACY",0,0,1,74,0,75,"2019"
"51560","250270 BORBOREMA",0,0,1,72,0,73,"2019"
"51561","250280 BREJO DO CRUZ",2,0,4,182,3,191,"2019"
"51562","250290 BREJO DOS SANTOS",0,0,1,79,1,81,"2019"
"51563","250300 CAAPORA",0,1,11,353,2,367,"2019"
"51564","250310 CABACEIRAS",0,0,0,68,0,68,"2019"
"51565","250320 CABEDELO",1,4,19,924,1,949,"2019"
"51566","250330 CACHOEIRA DOS INDIOS",0,1,1,112,1,115,"2019"
"51567","250340 CACIMBA DE AREIA",0,0,1,45,1,47,"2019"
"51568","250350 CACIMBA DE DENTRO",0,1,5,184,1,191,"2019"
"51569","250355 CACIMBAS",0,1,8,137,11,157,"2019"
"51570","250360 CAICARA",0,1,1,92,0,94,"2019"
"51571","250370 CAJAZEIRAS",5,4,10,876,3,898,"2019"
"51572","250375 CAJAZEIRINHAS",0,0,1,47,0,48,"2019"
"51573","250380 CALDAS BRANDAO",0,0,5,100,0,105,"2019"
"51574","250390 CAMALAU",0,0,0,87,1,88,"2019"
"51575","250400 CAMPINA GRANDE",8,20,79,5936,61,6104,"2019"
"51576","250403 CAPIM",1,0,1,109,0,111,"2019"
"51577","250407 CARAUBAS",0,0,0,63,1,64,"2019"
"51578","250410 CARRAPATEIRA",0,0,0,30,0,30,"2019"
"51579","250415 CASSERENGUE",0,0,2,73,0,75,"2019"
"51580","250420 CATINGUEIRA",0,0,1,53,2,56,"2019"
"51581","250430 CATOLE DO ROCHA",1,3,6,410,1,421,"2019"
"51582","250435 CATURITE",0,1,1,82,1,85,"2019"
"51583","250440 CONCEICAO",0,2,7,226,0,235,"2019"
"51584","250450 CONDADO",0,0,1,91,1,93,"2019"
"51585","250460 CONDE",2,4,9,520,13,548,"2019"
"51586","250470 CONGO",0,0,2,102,1,105,"2019"
"51587","250480 COREMAS",0,1,8,187,0,196,"2019"
"51588","250485 COXIXOLA",0,1,0,24,0,25,"2019"
"51589","250490 CRUZ DO ESPIRITO SANTO",0,2,5,263,0,270,"2019"
"51590","250500 CUBATI",0,0,2,102,0,104,"2019"
"51591","250510 CUITE",0,1,5,253,2,261,"2019"
"51592","250520 CUITEGI",1,0,1,108,1,111,"2019"
"51593","250523 CUITE DE MAMANGUAPE",0,0,3,99,1,103,"2019"
"51594","250527 CURRAL DE CIMA",0,0,1,66,0,67,"2019"
"51595","250530 CURRAL VELHO",0,0,1,20,0,21,"2019"
"51596","250535 DAMIAO",0,0,0,52,2,54,"2019"
"51597","250540 DESTERRO",2,1,4,105,4,116,"2019"
"51598","250550 VISTA SERRANA",0,0,1,39,1,41,"2019"
"51599","250560 DIAMANTE",0,1,2,93,1,97,"2019"
"51600","250570 DONA INES",0,1,1,132,1,135,"2019"
"51601","250580 DUAS ESTRADAS",0,0,1,55,1,57,"2019"
"51602","250590 EMAS",0,0,0,40,2,42,"2019"
"51603","250600 ESPERANCA",0,1,7,506,4,518,"2019"
"51604","250610 FAGUNDES",0,0,4,169,4,177,"2019"
"51605","250620 FREI MARTINHO",0,0,3,30,0,33,"2019"
"51606","250625 GADO BRAVO",0,0,1,122,2,125,"2019"
"51607","250630 GUARABIRA",3,1,9,850,3,866,"2019"
"51608","250640 GURINHEM",1,3,1,185,0,190,"2019"
"51609","250650 GURJAO",0,0,1,42,0,43,"2019"
"51610","250660 IBIARA",0,0,0,60,0,60,"2019"
"51611","250670 IMACULADA",0,0,0,154,8,162,"2019"
"51612","250680 INGA",0,1,8,244,2,255,"2019"
"51613","250690 ITABAIANA",0,0,5,355,1,361,"2019"
"51614","250700 ITAPORANGA",0,0,14,350,1,365,"2019"
"51615","250710 ITAPOROROCA",1,3,6,264,1,275,"2019"
"51616","250720 ITATUBA",0,0,2,129,3,134,"2019"
"51617","250730 JACARAU",0,0,4,217,0,221,"2019"
"51618","250740 JERICO",0,1,1,75,0,77,"2019"
"51619","250750 JOAO PESSOA",23,54,164,11796,54,12091,"2019"
"51620","250760 JUAREZ TAVORA",0,1,1,114,1,117,"2019"
"51621","250770 JUAZEIRINHO",0,3,8,274,5,290,"2019"
"51622","250780 JUNCO DO SERIDO",0,1,0,86,0,87,"2019"
"51623","250790 JURIPIRANGA",1,0,3,182,0,186,"2019"
"51624","250800 JURU",0,1,5,117,2,125,"2019"
"51625","250810 LAGOA",0,0,1,51,0,52,"2019"
"51626","250820 LAGOA DE DENTRO",0,1,0,100,1,102,"2019"
"51627","250830 LAGOA SECA",0,1,7,404,5,417,"2019"
"51628","250840 LASTRO",0,0,0,37,1,38,"2019"
"51629","250850 LIVRAMENTO",0,0,3,110,2,115,"2019"
"51630","250855 LOGRADOURO",0,0,1,58,0,59,"2019"
"51631","250860 LUCENA",0,4,6,211,1,222,"2019"
"51632","250870 MAE D'AGUA",0,0,1,45,1,47,"2019"
"51633","250880 MALTA",0,1,4,73,3,81,"2019"
"51634","250890 MAMANGUAPE",1,8,12,797,0,818,"2019"
"51635","250900 MANAIRA",0,1,2,104,0,107,"2019"
"51636","250905 MARCACAO",0,0,4,176,1,181,"2019"
"51637","250910 MARI",0,0,8,301,1,310,"2019"
"51638","250915 MARIZOPOLIS",0,0,1,78,0,79,"2019"
"51639","250920 MASSARANDUBA",0,3,3,172,2,180,"2019"
"51640","250930 MATARACA",0,3,5,157,2,167,"2019"
"51641","250933 MATINHAS",1,1,1,62,2,67,"2019"
"51642","250937 MATO GROSSO",0,0,0,36,0,36,"2019"
"51643","250939 MATUREIA",0,2,4,99,7,112,"2019"
"51644","250940 MOGEIRO",0,0,2,233,0,235,"2019"
"51645","250950 MONTADAS",1,0,2,76,3,82,"2019"
"51646","250960 MONTE HOREBE",0,0,1,75,1,77,"2019"
"51647","250970 MONTEIRO",1,2,5,494,2,504,"2019"
"51648","250980 MULUNGU",0,0,1,118,2,121,"2019"
"51649","250990 NATUBA",0,0,2,119,1,122,"2019"
"51650","251000 NAZAREZINHO",0,0,0,80,1,81,"2019"
"51651","251010 NOVA FLORESTA",0,1,2,115,1,119,"2019"
"51652","251020 NOVA OLINDA",0,0,3,72,1,76,"2019"
"51653","251030 NOVA PALMEIRA",0,0,0,38,0,38,"2019"
"51654","251040 OLHO D'AGUA",0,0,0,86,0,86,"2019"
"51655","251050 OLIVEDOS",0,0,0,38,0,38,"2019"
"51656","251060 OURO VELHO",0,0,0,39,2,41,"2019"
"51657","251065 PARARI",0,0,0,18,0,18,"2019"
"51658","251070 PASSAGEM",0,1,2,35,0,38,"2019"
"51659","251080 PATOS",2,9,30,1432,24,1497,"2019"
"51660","251090 PAULISTA",0,0,1,143,0,144,"2019"
"51661","251100 PEDRA BRANCA",0,0,1,54,1,56,"2019"
"51662","251110 PEDRA LAVRADA",2,0,1,71,1,75,"2019"
"51663","251120 PEDRAS DE FOGO",0,1,4,490,1,496,"2019"
"51664","251130 PIANCO",1,1,3,143,4,152,"2019"
"51665","251140 PICUI",0,0,1,254,0,255,"2019"
"51666","251150 PILAR",1,1,3,208,0,213,"2019"
"51667","251160 PILOES",0,0,0,128,1,129,"2019"
"51668","251170 PILOEZINHOS",0,1,0,96,2,99,"2019"
"51669","251180 PIRPIRITUBA",0,0,3,120,0,123,"2019"
"51670","251190 PITIMBU",0,2,6,282,3,293,"2019"
"51671","251200 POCINHOS",2,2,2,264,4,274,"2019"
"51672","251203 POCO DANTAS",0,0,0,41,0,41,"2019"
"51673","251207 POCO DE JOSE DE MOURA",0,0,2,32,0,34,"2019"
"51674","251210 POMBAL",0,4,7,392,0,403,"2019"
"51675","251220 PRATA",0,0,1,46,0,47,"2019"
"51676","251230 PRINCESA ISABEL",1,4,2,274,3,284,"2019"
"51677","251240 PUXINANA",0,1,3,209,1,214,"2019"
"51678","251250 QUEIMADAS",1,2,8,705,5,721,"2019"
"51679","251260 QUIXABA",0,0,0,24,1,25,"2019"
"51680","251270 REMIGIO",0,0,5,274,2,281,"2019"
"51681","251272 PEDRO REGIS",0,1,1,77,0,79,"2019"
"51682","251274 RIACHAO",1,1,0,50,0,52,"2019"
"51683","251275 RIACHAO DO BACAMARTE",0,0,0,73,0,73,"2019"
"51684","251276 RIACHAO DO POCO",1,1,0,83,0,85,"2019"
"51685","251278 RIACHO DE SANTO ANTONIO",0,0,0,41,0,41,"2019"
"51686","251280 RIACHO DOS CAVALOS",0,1,2,100,0,103,"2019"
"51687","251290 RIO TINTO",4,2,5,353,0,364,"2019"
"51688","251300 SALGADINHO",0,0,0,28,2,30,"2019"
"51689","251310 SALGADO DE SAO FELIX",0,2,2,154,1,159,"2019"
"51690","251315 SANTA CECILIA",0,0,3,87,0,90,"2019"
"51691","251320 SANTA CRUZ",0,0,1,66,0,67,"2019"
"51692","251330 SANTA HELENA",1,0,1,58,1,61,"2019"
"51693","251335 SANTA INES",0,1,1,30,0,32,"2019"
"51694","251340 SANTA LUZIA",0,1,4,174,0,179,"2019"
"51695","251350 SANTANA DE MANGUEIRA",0,0,3,56,4,63,"2019"
"51696","251360 SANTANA DOS GARROTES",0,0,3,66,5,74,"2019"
"51697","251365 JOCA CLAUDINO",0,0,1,21,0,22,"2019"
"51698","251370 SANTA RITA",3,15,32,2254,1,2305,"2019"
"51699","251380 SANTA TERESINHA",0,0,0,69,4,73,"2019"
"51700","251385 SANTO ANDRE",0,0,1,22,0,23,"2019"
"51701","251390 SAO BENTO",1,3,5,458,2,469,"2019"
"51702","251392 SAO BENTINHO",0,1,0,54,0,55,"2019"
"51703","251394 SAO DOMINGOS DO CARIRI",0,0,0,35,1,36,"2019"
"51704","251396 SAO DOMINGOS",0,0,0,29,0,29,"2019"
"51705","251398 SAO FRANCISCO",0,1,0,44,0,45,"2019"
"51706","251400 SAO JOAO DO CARIRI",0,0,0,50,0,50,"2019"
"51707","251410 SAO JOAO DO TIGRE",0,0,0,71,0,71,"2019"
"51708","251420 SAO JOSE DA LAGOA TAPADA",2,1,2,66,1,72,"2019"
"51709","251430 SAO JOSE DE CAIANA",0,0,5,75,1,81,"2019"
"51710","251440 SAO JOSE DE ESPINHARAS",0,1,3,39,1,44,"2019"
"51711","251445 SAO JOSE DOS RAMOS",0,0,4,91,0,95,"2019"
"51712","251450 SAO JOSE DE PIRANHAS",0,3,3,258,2,266,"2019"
"51713","251455 SAO JOSE DE PRINCESA",0,0,1,27,0,28,"2019"
"51714","251460 SAO JOSE DO BONFIM",0,1,0,50,0,51,"2019"
"51715","251465 SAO JOSE DO BREJO DO CRUZ",0,0,0,22,0,22,"2019"
"51716","251470 SAO JOSE DO SABUGI",0,1,1,43,0,45,"2019"
"51717","251480 SAO JOSE DOS CORDEIROS",0,0,0,39,0,39,"2019"
"51718","251490 SAO MAMEDE",0,1,2,95,1,99,"2019"
"51719","251500 SAO MIGUEL DE TAIPU",0,0,0,112,0,112,"2019"
"51720","251510 SAO SEBASTIAO DE LAGOA DE ROCA",0,3,2,156,3,164,"2019"
"51721","251520 SAO SEBASTIAO DO UMBUZEIRO",0,0,0,44,0,44,"2019"
"51722","251530 SAPE",0,4,7,613,1,625,"2019"
"51723","251540 SAO VICENTE DO SERIDO",0,2,3,158,8,171,"2019"
"51724","251550 SERRA BRANCA",0,1,1,162,0,164,"2019"
"51725","251560 SERRA DA RAIZ",1,1,0,31,0,33,"2019"
"51726","251570 SERRA GRANDE",1,1,2,48,0,52,"2019"
"51727","251580 SERRA REDONDA",1,0,2,94,1,98,"2019"
"51728","251590 SERRARIA",1,0,0,50,1,52,"2019"
"51729","251593 SERTAOZINHO",0,0,1,56,0,57,"2019"
"51730","251597 SOBRADO",0,1,1,137,0,139,"2019"
"51731","251600 SOLANEA",1,1,7,394,0,403,"2019"
"51732","251610 SOLEDADE",0,0,3,181,5,189,"2019"
"51733","251615 SOSSEGO",0,0,0,44,0,44,"2019"
"51734","251620 SOUSA",0,4,10,961,7,982,"2019"
"51735","251630 SUME",1,1,2,285,2,291,"2019"
"51736","251640 TACIMA",1,0,1,91,0,93,"2019"
"51737","251650 TAPEROA",0,3,4,193,2,202,"2019"
"51738","251660 TAVARES",1,2,1,155,2,161,"2019"
"51739","251670 TEIXEIRA",1,1,7,219,12,240,"2019"
"51740","251675 TENORIO",0,0,0,37,1,38,"2019"
"51741","251680 TRIUNFO",0,3,6,103,5,117,"2019"
"51742","251690 UIRAUNA",0,0,4,156,1,161,"2019"
"51743","251700 UMBUZEIRO",0,0,1,107,3,111,"2019"
"51744","251710 VARZEA",0,0,0,18,0,18,"2019"
"51745","251720 VIEIROPOLIS",0,0,0,50,1,51,"2019"
"51746","251740 ZABELE",0,0,0,34,0,34,"2019"
"51747","MUNICIPIO IGNORADO - PE",0,0,0,12,1,13,"2019"
"51748","260005 ABREU E LIMA",2,7,16,1321,6,1352,"2019"
"51749","260010 AFOGADOS DA INGAZEIRA",1,0,3,582,0,586,"2019"
"51750","260020 AFRANIO",3,3,5,236,7,254,"2019"
"51751","260030 AGRESTINA",4,1,5,314,1,325,"2019"
"51752","260040 AGUA PRETA",2,0,8,410,5,425,"2019"
"51753","260050 AGUAS BELAS",2,3,14,743,6,768,"2019"
"51754","260060 ALAGOINHA",1,1,4,183,1,190,"2019"
"51755","260070 ALIANCA",2,1,10,504,3,520,"2019"
"51756","260080 ALTINHO",0,0,2,244,1,247,"2019"
"51757","260090 AMARAJI",2,2,2,255,0,261,"2019"
"51758","260100 ANGELIM",0,2,2,139,0,143,"2019"
"51759","260105 ARACOIABA",2,1,4,304,7,318,"2019"
"51760","260110 ARARIPINA",6,13,29,1581,3,1632,"2019"
"51761","260120 ARCOVERDE",2,5,10,1154,6,1177,"2019"
"51762","260130 BARRA DE GUABIRABA",1,2,3,192,0,198,"2019"
"51763","260140 BARREIROS",5,2,10,641,3,661,"2019"
"51764","260150 BELEM DE MARIA",1,1,2,146,1,151,"2019"
"51765","260160 BELEM DE SAO FRANCISCO",1,1,9,292,1,304,"2019"
"51766","260170 BELO JARDIM",0,7,12,1207,3,1229,"2019"
"51767","260180 BETANIA",0,1,2,144,5,152,"2019"
"51768","260190 BEZERROS",2,3,5,761,0,771,"2019"
"51769","260200 BODOCO",2,1,7,507,3,520,"2019"
"51770","260210 BOM CONSELHO",0,2,3,402,5,412,"2019"
"51771","260220 BOM JARDIM",1,1,6,447,0,455,"2019"
"51772","260230 BONITO",3,2,3,586,1,595,"2019"
"51773","260240 BREJAO",0,1,2,168,0,171,"2019"
"51774","260250 BREJINHO",0,0,1,109,2,112,"2019"
"51775","260260 BREJO DA MADRE DE DEUS",3,2,8,739,3,755,"2019"
"51776","260270 BUENOS AIRES",2,0,2,181,2,187,"2019"
"51777","260280 BUIQUE",2,6,7,831,4,850,"2019"
"51778","260290 CABO DE SANTO AGOSTINHO",6,10,25,2897,14,2952,"2019"
"51779","260300 CABROBO",0,2,8,498,1,509,"2019"
"51780","260310 CACHOEIRINHA",1,1,5,299,6,312,"2019"
"51781","260320 CAETES",2,2,6,425,2,437,"2019"
"51782","260330 CALCADO",0,1,1,125,2,129,"2019"
"51783","260340 CALUMBI",0,0,2,53,22,77,"2019"
"51784","260345 CAMARAGIBE",9,11,29,2087,10,2146,"2019"
"51785","260350 CAMOCIM DE SAO FELIX",1,1,2,242,2,248,"2019"
"51786","260360 CAMUTANGA",1,0,4,113,3,121,"2019"
"51787","260370 CANHOTINHO",1,1,4,324,1,331,"2019"
"51788","260380 CAPOEIRAS",0,2,5,267,1,275,"2019"
"51789","260390 CARNAIBA",0,2,2,281,1,286,"2019"
"51790","260392 CARNAUBEIRA DA PENHA",0,2,5,239,3,249,"2019"
"51791","260400 CARPINA",2,3,8,1003,2,1018,"2019"
"51792","260410 CARUARU",16,26,66,5904,19,6031,"2019"
"51793","260415 CASINHAS",1,1,2,173,0,177,"2019"
"51794","260420 CATENDE",3,0,2,456,1,462,"2019"
"51795","260430 CEDRO",2,0,2,161,0,165,"2019"
"51796","260440 CHA DE ALEGRIA",0,2,1,239,1,243,"2019"
"51797","260450 CHA GRANDE",1,0,5,299,2,307,"2019"
"51798","260460 CONDADO",1,1,6,358,4,370,"2019"
"51799","260470 CORRENTES",0,0,2,216,3,221,"2019"
"51800","260480 CORTES",0,2,5,153,0,160,"2019"
"51801","260490 CUMARU",1,2,2,177,1,183,"2019"
"51802","260500 CUPIRA",1,1,2,315,1,320,"2019"
"51803","260510 CUSTODIA",2,1,3,454,1,461,"2019"
"51804","260515 DORMENTES",0,0,1,244,5,250,"2019"
"51805","260520 ESCADA",4,2,8,849,7,870,"2019"
"51806","260530 EXU",4,1,8,494,4,511,"2019"
"51807","260540 FEIRA NOVA",0,0,5,308,3,316,"2019"
"51808","260545 FERNANDO DE NORONHA",0,1,1,30,0,32,"2019"
"51809","260550 FERREIROS",1,0,1,146,1,149,"2019"
"51810","260560 FLORES",1,1,2,257,8,269,"2019"
"51811","260570 FLORESTA",1,1,9,466,8,485,"2019"
"51812","260580 FREI MIGUELINHO",0,0,1,156,0,157,"2019"
"51813","260590 GAMELEIRA",0,1,1,263,2,267,"2019"
"51814","260600 GARANHUNS",7,6,16,2236,3,2268,"2019"
"51815","260610 GLORIA DO GOITA",2,1,1,358,2,364,"2019"
"51816","260620 GOIANA",5,5,10,1120,6,1146,"2019"
"51817","260630 GRANITO",0,0,0,107,1,108,"2019"
"51818","260640 GRAVATA",6,2,9,1112,8,1137,"2019"
"51819","260650 IATI",0,2,3,265,0,270,"2019"
"51820","260660 IBIMIRIM",4,3,7,424,3,441,"2019"
"51821","260670 IBIRAJUBA",0,0,1,100,1,102,"2019"
"51822","260680 IGARASSU",2,3,27,1519,18,1569,"2019"
"51823","260690 IGUARACY",0,1,1,126,1,129,"2019"
"51824","260700 INAJA",2,1,4,307,16,330,"2019"
"51825","260710 INGAZEIRA",0,0,2,72,0,74,"2019"
"51826","260720 IPOJUCA",4,8,21,1696,2,1731,"2019"
"51827","260730 IPUBI",1,5,6,529,1,542,"2019"
"51828","260740 ITACURUBA",0,2,2,62,2,68,"2019"
"51829","260750 ITAIBA",1,2,6,346,4,359,"2019"
"51830","260760 ILHA DE ITAMARACA",1,0,2,324,4,331,"2019"
"51831","260765 ITAMBE",1,1,8,367,1,378,"2019"
"51832","260770 ITAPETIM",1,0,1,174,1,177,"2019"
"51833","260775 ITAPISSUMA",1,1,9,349,4,364,"2019"
"51834","260780 ITAQUITINGA",2,1,5,221,2,231,"2019"
"51835","260790 JABOATAO DOS GUARARAPES",29,26,93,9029,58,9235,"2019"
"51836","260795 JAQUEIRA",1,0,0,160,0,161,"2019"
"51837","260800 JATAUBA",0,1,4,244,1,250,"2019"
"51838","260805 JATOBA",0,0,4,207,1,212,"2019"
"51839","260810 JOAO ALFREDO",1,2,2,313,3,321,"2019"
"51840","260820 JOAQUIM NABUCO",0,2,1,196,3,202,"2019"
"51841","260825 JUCATI",1,1,1,196,0,199,"2019"
"51842","260830 JUPI",1,0,5,270,1,277,"2019"
"51843","260840 JUREMA",0,1,5,203,0,209,"2019"
"51844","260845 LAGOA DO CARRO",0,1,4,226,1,232,"2019"
"51845","260850 LAGOA DE ITAENGA",1,0,3,302,2,308,"2019"
"51846","260860 LAGOA DO OURO",1,0,0,171,0,172,"2019"
"51847","260870 LAGOA DOS GATOS",1,2,1,193,3,200,"2019"
"51848","260875 LAGOA GRANDE",2,1,9,371,4,387,"2019"
"51849","260880 LAJEDO",2,1,11,634,4,652,"2019"
"51850","260890 LIMOEIRO",2,0,10,728,3,743,"2019"
"51851","260900 MACAPARANA",1,0,6,351,2,360,"2019"
"51852","260910 MACHADOS",0,1,2,202,0,205,"2019"
"51853","260915 MANARI",1,4,1,262,2,270,"2019"
"51854","260920 MARAIAL",3,0,4,216,0,223,"2019"
"51855","260930 MIRANDIBA",0,1,1,255,3,260,"2019"
"51856","260940 MORENO",5,4,4,742,9,764,"2019"
"51857","260950 NAZARE DA MATA",0,1,1,401,0,403,"2019"
"51858","260960 OLINDA",12,16,72,5127,31,5258,"2019"
"51859","260970 OROBO",1,1,1,262,0,265,"2019"
"51860","260980 OROCO",0,0,3,283,2,288,"2019"
"51861","260990 OURICURI",5,7,18,1071,7,1108,"2019"
"51862","261000 PALMARES",4,2,9,1053,6,1074,"2019"
"51863","261010 PALMEIRINA",0,1,0,99,1,101,"2019"
"51864","261020 PANELAS",0,2,4,318,0,324,"2019"
"51865","261030 PARANATAMA",0,2,2,195,2,201,"2019"
"51866","261040 PARNAMIRIM",1,2,6,295,0,304,"2019"
"51867","261050 PASSIRA",1,1,3,368,3,376,"2019"
"51868","261060 PAUDALHO",0,5,9,806,5,825,"2019"
"51869","261070 PAULISTA",9,19,37,3846,19,3930,"2019"
"51870","261080 PEDRA",2,0,3,322,2,329,"2019"
"51871","261090 PESQUEIRA",5,5,7,910,4,931,"2019"
"51872","261100 PETROLANDIA",1,4,9,687,1,702,"2019"
"51873","261110 PETROLINA",30,43,122,6155,70,6420,"2019"
"51874","261120 POCAO",1,2,2,134,0,139,"2019"
"51875","261130 POMBOS",1,1,5,401,3,411,"2019"
"51876","261140 PRIMAVERA",0,1,1,168,4,174,"2019"
"51877","261150 QUIPAPA",3,1,2,274,0,280,"2019"
"51878","261153 QUIXABA",0,0,0,105,0,105,"2019"
"51879","261160 RECIFE",58,70,243,20619,142,21132,"2019"
"51880","261170 RIACHO DAS ALMAS",0,1,2,307,0,310,"2019"
"51881","261180 RIBEIRAO",4,1,5,460,4,474,"2019"
"51882","261190 RIO FORMOSO",2,0,2,320,3,327,"2019"
"51883","261200 SAIRE",0,0,4,123,0,127,"2019"
"51884","261210 SALGADINHO",0,0,3,64,0,67,"2019"
"51885","261220 SALGUEIRO",2,3,18,1017,2,1042,"2019"
"51886","261230 SALOA",0,0,2,187,0,189,"2019"
"51887","261240 SANHARO",0,0,5,276,4,285,"2019"
"51888","261245 SANTA CRUZ",0,1,5,244,0,250,"2019"
"51889","261247 SANTA CRUZ DA BAIXA VERDE",0,2,5,167,30,204,"2019"
"51890","261250 SANTA CRUZ DO CAPIBARIBE",1,1,14,1335,4,1355,"2019"
"51891","261255 SANTA FILOMENA",0,1,4,192,0,197,"2019"
"51892","261260 SANTA MARIA DA BOA VISTA",4,4,15,675,12,710,"2019"
"51893","261270 SANTA MARIA DO CAMBUCA",1,0,2,209,3,215,"2019"
"51894","261280 SANTA TEREZINHA",0,0,1,138,1,140,"2019"
"51895","261290 SAO BENEDITO DO SUL",1,1,0,138,4,144,"2019"
"51896","261300 SAO BENTO DO UNA",2,2,6,728,8,746,"2019"
"51897","261310 SAO CAITANO",4,3,4,580,3,594,"2019"
"51898","261320 SAO JOAO",0,1,1,351,1,354,"2019"
"51899","261330 SAO JOAQUIM DO MONTE",1,1,3,267,3,275,"2019"
"51900","261340 SAO JOSE DA COROA GRANDE",0,3,1,296,2,302,"2019"
"51901","261350 SAO JOSE DO BELMONTE",2,3,5,481,22,513,"2019"
"51902","261360 SAO JOSE DO EGITO",0,0,3,413,0,416,"2019"
"51903","261370 SAO LOURENCO DA MATA",0,6,25,1532,8,1571,"2019"
"51904","261380 SAO VICENTE FERRER",0,2,1,257,1,261,"2019"
"51905","261390 SERRA TALHADA",4,5,21,1179,316,1525,"2019"
"51906","261400 SERRITA",0,1,6,238,1,246,"2019"
"51907","261410 SERTANIA",1,2,7,411,1,422,"2019"
"51908","261420 SIRINHAEM",1,1,11,560,2,575,"2019"
"51909","261430 MOREILANDIA",2,1,6,149,1,159,"2019"
"51910","261440 SOLIDAO",0,0,2,80,0,82,"2019"
"51911","261450 SURUBIM",4,1,8,860,6,879,"2019"
"51912","261460 TABIRA",1,1,3,455,4,464,"2019"
"51913","261470 TACAIMBO",1,3,1,170,1,176,"2019"
"51914","261480 TACARATU",1,3,4,307,2,317,"2019"
"51915","261485 TAMANDARE",0,0,6,418,2,426,"2019"
"51916","261500 TAQUARITINGA DO NORTE",0,2,2,355,1,360,"2019"
"51917","261510 TEREZINHA",0,1,1,132,0,134,"2019"
"51918","261520 TERRA NOVA",0,0,4,141,1,146,"2019"
"51919","261530 TIMBAUBA",0,2,8,658,2,670,"2019"
"51920","261540 TORITAMA",0,0,6,695,3,704,"2019"
"51921","261550 TRACUNHAEM",0,0,2,182,3,187,"2019"
"51922","261560 TRINDADE",2,3,15,548,2,570,"2019"
"51923","261570 TRIUNFO",0,0,1,163,27,191,"2019"
"51924","261580 TUPANATINGA",2,2,13,322,8,347,"2019"
"51925","261590 TUPARETAMA",1,2,1,119,0,123,"2019"
"51926","261600 VENTUROSA",1,1,5,279,0,286,"2019"
"51927","261610 VERDEJANTE",0,0,2,134,0,136,"2019"
"51928","261618 VERTENTE DO LERIO",0,0,1,102,0,103,"2019"
"51929","261620 VERTENTES",0,0,1,289,0,290,"2019"
"51930","261630 VICENCIA",1,3,7,374,2,387,"2019"
"51931","261640 VITORIA DE SANTO ANTAO",5,2,15,1870,9,1901,"2019"
"51932","261650 XEXEU",1,0,4,207,2,214,"2019"
"51933","270010 AGUA BRANCA",0,1,1,317,4,323,"2019"
"51934","270020 ANADIA",0,1,2,199,4,206,"2019"
"51935","270030 ARAPIRACA",5,19,21,3438,11,3494,"2019"
"51936","270040 ATALAIA",1,2,4,593,20,620,"2019"
"51937","270050 BARRA DE SANTO ANTONIO",0,0,1,278,4,283,"2019"
"51938","270060 BARRA DE SAO MIGUEL",1,0,2,161,0,164,"2019"
"51939","270070 BATALHA",0,1,4,277,0,282,"2019"
"51940","270080 BELEM",0,0,0,79,0,79,"2019"
"51941","270090 BELO MONTE",1,1,0,93,0,95,"2019"
"51942","270100 BOCA DA MATA",1,2,8,318,1,330,"2019"
"51943","270110 BRANQUINHA",0,0,1,183,1,185,"2019"
"51944","270120 CACIMBINHAS",0,0,1,169,0,170,"2019"
"51945","270130 CAJUEIRO",1,1,6,283,22,313,"2019"
"51946","270135 CAMPESTRE",0,0,0,93,0,93,"2019"
"51947","270140 CAMPO ALEGRE",1,3,10,498,9,521,"2019"
"51948","270150 CAMPO GRANDE",0,0,1,140,1,142,"2019"
"51949","270160 CANAPI",0,1,1,278,9,289,"2019"
"51950","270170 CAPELA",1,0,2,224,24,251,"2019"
"51951","270180 CARNEIROS",0,0,3,156,0,159,"2019"
"51952","270190 CHA PRETA",0,0,2,84,3,89,"2019"
"51953","270200 COITE DO NOIA",0,1,1,159,1,162,"2019"
"51954","270210 COLONIA LEOPOLDINA",0,3,1,261,2,267,"2019"
"51955","270220 COQUEIRO SECO",0,1,2,73,0,76,"2019"
"51956","270230 CORURIPE",3,5,7,907,11,933,"2019"
"51957","270235 CRAIBAS",1,1,3,429,2,436,"2019"
"51958","270240 DELMIRO GOUVEIA",3,3,13,776,4,799,"2019"
"51959","270250 DOIS RIACHOS",0,0,0,134,2,136,"2019"
"51960","270255 ESTRELA DE ALAGOAS",2,0,3,210,1,216,"2019"
"51961","270260 FEIRA GRANDE",0,1,3,337,0,341,"2019"
"51962","270270 FELIZ DESERTO",0,0,0,75,1,76,"2019"
"51963","270280 FLEXEIRAS",0,0,1,173,0,174,"2019"
"51964","270290 GIRAU DO PONCIANO",1,2,2,529,1,535,"2019"
"51965","270300 IBATEGUARA",0,2,2,263,2,269,"2019"
"51966","270310 IGACI",1,1,3,377,0,382,"2019"
"51967","270320 IGREJA NOVA",0,0,0,318,2,320,"2019"
"51968","270330 INHAPI",0,0,6,265,38,309,"2019"
"51969","270340 JACARE DOS HOMENS",0,0,0,85,0,85,"2019"
"51970","270350 JACUIPE",0,0,1,57,0,58,"2019"
"51971","270360 JAPARATINGA",3,0,1,149,2,155,"2019"
"51972","270370 JARAMATAIA",0,0,2,106,1,109,"2019"
"51973","270375 JEQUIA DA PRAIA",0,0,4,136,3,143,"2019"
"51974","270380 JOAQUIM GOMES",1,0,8,333,5,347,"2019"
"51975","270390 JUNDIA",0,0,1,47,0,48,"2019"
"51976","270400 JUNQUEIRO",0,2,2,349,1,354,"2019"
"51977","270410 LAGOA DA CANOA",0,0,0,289,2,291,"2019"
"51978","270420 LIMOEIRO DE ANADIA",1,0,2,348,0,351,"2019"
"51979","270430 MACEIO",34,53,188,14069,212,14556,"2019"
"51980","270440 MAJOR ISIDORO",0,0,2,252,2,256,"2019"
"51981","270450 MARAGOGI",3,2,7,579,5,596,"2019"
"51982","270460 MARAVILHA",0,1,1,169,2,173,"2019"
"51983","270470 MARECHAL DEODORO",3,3,13,878,12,909,"2019"
"51984","270480 MARIBONDO",0,1,3,178,0,182,"2019"
"51985","270490 MAR VERMELHO",0,0,0,22,0,22,"2019"
"51986","270500 MATA GRANDE",0,0,1,300,34,335,"2019"
"51987","270510 MATRIZ DE CAMARAGIBE",1,1,6,373,6,387,"2019"
"51988","270520 MESSIAS",0,0,1,261,7,269,"2019"
"51989","270530 MINADOR DO NEGRAO",0,0,3,72,0,75,"2019"
"51990","270540 MONTEIROPOLIS",0,1,2,106,0,109,"2019"
"51991","270550 MURICI",1,4,7,439,2,453,"2019"
"51992","270560 NOVO LINO",2,0,1,133,1,137,"2019"
"51993","270570 OLHO D'AGUA DAS FLORES",2,1,6,357,3,369,"2019"
"51994","270580 OLHO D'AGUA DO CASADO",0,0,4,127,0,131,"2019"
"51995","270590 OLHO D'AGUA GRANDE",0,0,0,88,1,89,"2019"
"51996","270600 OLIVENCA",0,0,3,171,0,174,"2019"
"51997","270610 OURO BRANCO",0,0,2,203,1,206,"2019"
"51998","270620 PALESTINA",1,0,1,75,0,77,"2019"
"51999","270630 PALMEIRA DOS INDIOS",2,2,19,1259,1,1283,"2019"
"52000","270640 PAO DE ACUCAR",0,1,7,370,0,378,"2019"
"52001","270642 PARICONHA",0,0,4,175,0,179,"2019"
"52002","270644 PARIPUEIRA",1,0,1,211,4,217,"2019"
"52003","270650 PASSO DE CAMARAGIBE",0,2,3,190,1,196,"2019"
"52004","270660 PAULO JACINTO",0,1,2,75,0,78,"2019"
"52005","270670 PENEDO",3,0,19,914,2,938,"2019"
"52006","270680 PIACABUCU",1,0,5,295,0,301,"2019"
"52007","270690 PILAR",2,1,3,522,9,537,"2019"
"52008","270700 PINDOBA",0,0,0,24,1,25,"2019"
"52009","270710 PIRANHAS",2,2,4,416,3,427,"2019"
"52010","270720 POCO DAS TRINCHEIRAS",0,1,4,191,0,196,"2019"
"52011","270730 PORTO CALVO",1,1,3,377,5,387,"2019"
"52012","270740 PORTO DE PEDRAS",0,1,3,146,1,151,"2019"
"52013","270750 PORTO REAL DO COLEGIO",1,1,6,276,1,285,"2019"
"52014","270760 QUEBRANGULO",0,1,2,179,0,182,"2019"
"52015","270770 RIO LARGO",0,4,19,1366,20,1409,"2019"
"52016","270780 ROTEIRO",0,0,1,97,1,99,"2019"
"52017","270790 SANTA LUZIA DO NORTE",0,1,3,100,5,109,"2019"
"52018","270800 SANTANA DO IPANEMA",0,3,8,850,5,866,"2019"
"52019","270810 SANTANA DO MUNDAU",0,0,1,200,0,201,"2019"
"52020","270820 SAO BRAS",0,0,2,85,0,87,"2019"
"52021","270830 SAO JOSE DA LAJE",0,3,5,370,10,388,"2019"
"52022","270840 SAO JOSE DA TAPERA",0,2,8,567,3,580,"2019"
"52023","270850 SAO LUIS DO QUITUNDE",1,5,4,507,4,521,"2019"
"52024","270860 SAO MIGUEL DOS CAMPOS",1,10,10,859,5,885,"2019"
"52025","270870 SAO MIGUEL DOS MILAGRES",0,0,3,133,0,136,"2019"
"52026","270880 SAO SEBASTIAO",0,2,6,491,1,500,"2019"
"52027","270890 SATUBA",0,0,4,302,7,313,"2019"
"52028","270895 SENADOR RUI PALMEIRA",2,0,5,196,2,205,"2019"
"52029","270900 TANQUE D'ARCA",0,1,2,59,1,63,"2019"
"52030","270910 TAQUARANA",0,2,2,257,1,262,"2019"
"52031","270915 TEOTONIO VILELA",1,5,6,622,2,636,"2019"
"52032","270920 TRAIPU",1,2,2,341,3,349,"2019"
"52033","270930 UNIAO DOS PALMARES",0,4,11,1095,5,1115,"2019"
"52034","270940 VICOSA",2,1,6,341,4,354,"2019"
"52035","280010 AMPARO DE SAO FRANCISCO",1,0,0,36,1,38,"2019"
"52036","280020 AQUIDABA",2,0,6,226,8,242,"2019"
"52037","280030 ARACAJU",41,34,123,8356,63,8617,"2019"
"52038","280040 ARAUA",0,1,2,126,4,133,"2019"
"52039","280050 AREIA BRANCA",1,2,2,282,7,294,"2019"
"52040","280060 BARRA DOS COQUEIROS",0,0,11,539,6,556,"2019"
"52041","280067 BOQUIM",2,2,9,294,2,309,"2019"
"52042","280070 BREJO GRANDE",0,0,2,110,8,120,"2019"
"52043","280100 CAMPO DO BRITO",2,0,2,251,7,262,"2019"
"52044","280110 CANHOBA",0,0,0,61,5,66,"2019"
"52045","280120 CANINDE DE SAO FRANCISCO",2,1,13,519,19,554,"2019"
"52046","280130 CAPELA",4,3,8,487,36,538,"2019"
"52047","280140 CARIRA",2,0,5,280,5,292,"2019"
"52048","280150 CARMOPOLIS",1,2,4,234,9,250,"2019"
"52049","280160 CEDRO DE SAO JOAO",0,0,0,66,3,69,"2019"
"52050","280170 CRISTINAPOLIS",0,0,2,294,4,300,"2019"
"52051","280190 CUMBE",0,0,0,44,4,48,"2019"
"52052","280200 DIVINA PASTORA",0,0,1,58,2,61,"2019"
"52053","280210 ESTANCIA",4,4,15,942,22,987,"2019"
"52054","280220 FEIRA NOVA",0,0,1,96,13,110,"2019"
"52055","280230 FREI PAULO",1,1,2,264,9,277,"2019"
"52056","280240 GARARU",0,0,2,115,13,130,"2019"
"52057","280250 GENERAL MAYNARD",0,0,1,49,1,51,"2019"
"52058","280260 GRACHO CARDOSO",1,0,0,61,12,74,"2019"
"52059","280270 ILHA DAS FLORES",0,1,4,118,6,129,"2019"
"52060","280280 INDIAROBA",2,0,0,278,8,288,"2019"
"52061","280290 ITABAIANA",2,2,18,1414,21,1457,"2019"
"52062","280300 ITABAIANINHA",0,2,7,555,8,572,"2019"
"52063","280310 ITABI",0,0,1,48,5,54,"2019"
"52064","280320 ITAPORANGA D'AJUDA",2,2,9,470,14,497,"2019"
"52065","280330 JAPARATUBA",0,0,7,207,7,221,"2019"
"52066","280340 JAPOATA",0,0,2,198,7,207,"2019"
"52067","280350 LAGARTO",3,7,18,1516,15,1559,"2019"
"52068","280360 LARANJEIRAS",0,0,5,358,12,375,"2019"
"52069","280370 MACAMBIRA",0,0,1,91,2,94,"2019"
"52070","280380 MALHADA DOS BOIS",0,1,1,60,1,63,"2019"
"52071","280390 MALHADOR",1,0,2,164,4,171,"2019"
"52072","280400 MARUIM",5,2,0,219,4,230,"2019"
"52073","280410 MOITA BONITA",1,0,2,124,4,131,"2019"
"52074","280420 MONTE ALEGRE DE SERGIPE",0,0,2,224,15,241,"2019"
"52075","280430 MURIBECA",1,0,4,103,4,112,"2019"
"52076","280440 NEOPOLIS",1,2,4,224,7,238,"2019"
"52077","280445 NOSSA SENHORA APARECIDA",0,0,1,100,0,101,"2019"
"52078","280450 NOSSA SENHORA DA GLORIA",2,2,9,567,41,621,"2019"
"52079","280460 NOSSA SENHORA DAS DORES",1,1,3,312,19,336,"2019"
"52080","280470 NOSSA SENHORA DE LOURDES",0,0,2,71,0,73,"2019"
"52081","280480 NOSSA SENHORA DO SOCORRO",12,13,41,2922,44,3032,"2019"
"52082","280490 PACATUBA",0,1,7,216,10,234,"2019"
"52083","280500 PEDRA MOLE",0,0,0,29,0,29,"2019"
"52084","280510 PEDRINHAS",0,1,0,121,1,123,"2019"
"52085","280520 PINHAO",0,0,0,78,1,79,"2019"
"52086","280530 PIRAMBU",2,0,3,122,1,128,"2019"
"52087","280540 POCO REDONDO",2,4,2,462,30,500,"2019"
"52088","280550 POCO VERDE",2,0,4,302,10,318,"2019"
"52089","280560 PORTO DA FOLHA",2,1,8,368,23,402,"2019"
"52090","280570 PROPRIA",0,1,8,447,16,472,"2019"
"52091","280580 RIACHAO DO DANTAS",0,1,4,258,13,276,"2019"
"52092","280590 RIACHUELO",1,0,1,163,3,168,"2019"
"52093","280600 RIBEIROPOLIS",0,2,6,178,5,191,"2019"
"52094","280610 ROSARIO DO CATETE",1,1,2,151,2,157,"2019"
"52095","280620 SALGADO",1,1,3,236,5,246,"2019"
"52096","280630 SANTA LUZIA DO ITANHY",1,4,2,206,10,223,"2019"
"52097","280640 SANTANA DO SAO FRANCISCO",1,2,0,92,4,99,"2019"
"52098","280650 SANTA ROSA DE LIMA",0,0,2,57,1,60,"2019"
"52099","280660 SANTO AMARO DAS BROTAS",0,0,2,170,0,172,"2019"
"52100","280670 SAO CRISTOVAO",4,4,18,1233,29,1288,"2019"
"52101","280680 SAO DOMINGOS",0,5,0,120,4,129,"2019"
"52102","280690 SAO FRANCISCO",0,0,0,44,1,45,"2019"
"52103","280700 SAO MIGUEL DO ALEIXO",0,0,1,41,2,44,"2019"
"52104","280710 SIMAO DIAS",1,2,18,652,18,691,"2019"
"52105","280720 SIRIRI",0,0,4,124,4,132,"2019"
"52106","280730 TELHA",0,2,0,50,4,56,"2019"
"52107","280740 TOBIAS BARRETO",2,3,9,698,9,721,"2019"
"52108","280750 TOMAR DO GERU",2,2,3,180,2,189,"2019"
"52109","280760 UMBAUBA",1,0,3,334,7,345,"2019"
"52110","290010 ABAIRA",0,0,3,46,0,49,"2019"
"52111","290020 ABARE",2,5,10,264,3,284,"2019"
"52112","290030 ACAJUTIBA",2,0,5,168,1,176,"2019"
"52113","290035 ADUSTINA",2,0,5,139,15,161,"2019"
"52114","290040 AGUA FRIA",0,1,0,135,1,137,"2019"
"52115","290050 ERICO CARDOSO",0,2,2,94,0,98,"2019"
"52116","290060 AIQUARA",0,0,1,58,0,59,"2019"
"52117","290070 ALAGOINHAS",10,6,23,2056,43,2138,"2019"
"52118","290080 ALCOBACA",0,3,5,282,4,294,"2019"
"52119","290090 ALMADINA",0,1,0,54,0,55,"2019"
"52120","290100 AMARGOSA",3,4,16,420,2,445,"2019"
"52121","290110 AMELIA RODRIGUES",0,1,5,184,7,197,"2019"
"52122","290115 AMERICA DOURADA",0,0,3,195,5,203,"2019"
"52123","290120 ANAGE",2,1,6,214,3,226,"2019"
"52124","290130 ANDARAI",3,1,1,193,3,201,"2019"
"52125","290135 ANDORINHA",0,0,4,173,0,177,"2019"
"52126","290140 ANGICAL",0,0,4,186,0,190,"2019"
"52127","290150 ANGUERA",0,0,1,42,1,44,"2019"
"52128","290160 ANTAS",1,0,1,125,6,133,"2019"
"52129","290170 ANTONIO CARDOSO",0,0,1,96,2,99,"2019"
"52130","290180 ANTONIO GONCALVES",0,1,3,159,2,165,"2019"
"52131","290190 APORA",1,1,0,172,3,177,"2019"
"52132","290195 APUAREMA",0,0,4,97,3,104,"2019"
"52133","290200 ARACATU",0,2,3,158,0,163,"2019"
"52134","290205 ARACAS",0,3,1,157,3,164,"2019"
"52135","290210 ARACI",2,3,13,597,14,629,"2019"
"52136","290220 ARAMARI",0,1,4,102,3,110,"2019"
"52137","290225 ARATACA",2,1,2,102,1,108,"2019"
"52138","290230 ARATUIPE",0,2,3,119,0,124,"2019"
"52139","290240 AURELINO LEAL",0,0,3,134,41,178,"2019"
"52140","290250 BAIANOPOLIS",1,0,6,160,1,168,"2019"
"52141","290260 BAIXA GRANDE",1,1,5,197,2,206,"2019"
"52142","290265 BANZAE",0,0,0,36,148,184,"2019"
"52143","290270 BARRA",4,5,6,920,1,936,"2019"
"52144","290280 BARRA DA ESTIVA",6,2,10,373,0,391,"2019"
"52145","290290 BARRA DO CHOCA",2,2,6,470,4,484,"2019"
"52146","290300 BARRA DO MENDES",2,2,5,172,1,182,"2019"
"52147","290310 BARRA DO ROCHA",0,1,1,75,0,77,"2019"
"52148","290320 BARREIRAS",10,10,36,2653,4,2713,"2019"
"52149","290323 BARRO ALTO",3,3,4,147,0,157,"2019"
"52150","290327 BARROCAS",0,0,17,187,2,206,"2019"
"52151","290330 BARRO PRETO",0,1,5,64,3,73,"2019"
"52152","290340 BELMONTE",0,1,3,297,6,307,"2019"
"52153","290350 BELO CAMPO",1,1,5,215,0,222,"2019"
"52154","290360 BIRITINGA",1,1,13,189,6,210,"2019"
"52155","290370 BOA NOVA",0,1,2,172,6,181,"2019"
"52156","290380 BOA VISTA DO TUPIM",0,1,3,188,3,195,"2019"
"52157","290390 BOM JESUS DA LAPA",2,7,11,1062,15,1097,"2019"
"52158","290395 BOM JESUS DA SERRA",1,1,3,106,0,111,"2019"
"52159","290400 BONINAL",1,0,3,171,6,181,"2019"
"52160","290405 BONITO",1,0,4,237,12,254,"2019"
"52161","290410 BOQUIRA",0,1,2,282,3,288,"2019"
"52162","290420 BOTUPORA",0,0,2,135,0,137,"2019"
"52163","290430 BREJOES",0,2,3,141,2,148,"2019"
"52164","290440 BREJOLANDIA",0,0,1,100,1,102,"2019"
"52165","290450 BROTAS DE MACAUBAS",2,1,0,111,0,114,"2019"
"52166","290460 BRUMADO",3,7,16,821,3,850,"2019"
"52167","290470 BUERAREMA",1,0,5,208,1,215,"2019"
"52168","290475 BURITIRAMA",0,1,7,339,2,349,"2019"
"52169","290480 CAATIBA",0,0,0,77,7,84,"2019"
"52170","290485 CABACEIRAS DO PARAGUACU",0,1,8,198,31,238,"2019"
"52171","290490 CACHOEIRA",2,0,2,112,242,358,"2019"
"52172","290500 CACULE",1,1,3,284,2,291,"2019"
"52173","290510 CAEM",0,0,1,125,0,126,"2019"
"52174","290515 CAETANOS",0,0,4,125,0,129,"2019"
"52175","290520 CAETITE",0,1,13,651,8,673,"2019"
"52176","290530 CAFARNAUM",1,2,9,296,2,310,"2019"
"52177","290540 CAIRU",3,1,9,296,6,315,"2019"
"52178","290550 CALDEIRAO GRANDE",0,1,3,215,1,220,"2019"
"52179","290560 CAMACAN",4,1,12,316,4,337,"2019"
"52180","290570 CAMACARI",11,15,63,4118,48,4255,"2019"
"52181","290580 CAMAMU",4,5,23,529,17,578,"2019"
"52182","290590 CAMPO ALEGRE DE LOURDES",2,5,11,479,3,500,"2019"
"52183","290600 CAMPO FORMOSO",4,5,14,1123,36,1182,"2019"
"52184","290610 CANAPOLIS",2,0,0,97,31,130,"2019"
"52185","290620 CANARANA",2,1,4,342,31,380,"2019"
"52186","290630 CANAVIEIRAS",0,0,8,363,27,398,"2019"
"52187","290640 CANDEAL",0,2,1,58,5,66,"2019"
"52188","290650 CANDEIAS",5,6,21,976,5,1013,"2019"
"52189","290660 CANDIBA",1,1,9,130,1,142,"2019"
"52190","290670 CANDIDO SALES",3,2,4,284,0,293,"2019"
"52191","290680 CANSANCAO",2,5,3,457,2,469,"2019"
"52192","290682 CANUDOS",1,3,5,232,0,241,"2019"
"52193","290685 CAPELA DO ALTO ALEGRE",0,1,1,93,4,99,"2019"
"52194","290687 CAPIM GROSSO",0,4,5,465,2,476,"2019"
"52195","290689 CARAIBAS",1,0,1,80,2,84,"2019"
"52196","290690 CARAVELAS",0,3,2,267,1,273,"2019"
"52197","290700 CARDEAL DA SILVA",0,2,2,119,1,124,"2019"
"52198","290710 CARINHANHA",4,1,5,405,3,418,"2019"
"52199","290720 CASA NOVA",3,7,13,1033,5,1061,"2019"
"52200","290730 CASTRO ALVES",0,0,0,288,2,290,"2019"
"52201","290740 CATOLANDIA",0,0,4,46,0,50,"2019"
"52202","290750 CATU",4,4,11,507,1,527,"2019"
"52203","290755 CATURAMA",0,0,4,85,1,90,"2019"
"52204","290760 CENTRAL",3,0,6,208,0,217,"2019"
"52205","290770 CHORROCHO",0,1,7,137,0,145,"2019"
"52206","290780 CICERO DANTAS",1,2,3,248,58,312,"2019"
"52207","290790 CIPO",0,1,3,195,109,308,"2019"
"52208","290800 COARACI",4,0,3,216,5,228,"2019"
"52209","290810 COCOS",0,2,3,228,54,287,"2019"
"52210","290820 CONCEICAO DA FEIRA",0,1,4,102,137,244,"2019"
"52211","290830 CONCEICAO DO ALMEIDA",0,2,6,138,0,146,"2019"
"52212","290840 CONCEICAO DO COITE",3,4,25,985,5,1022,"2019"
"52213","290850 CONCEICAO DO JACUIPE",0,0,2,289,18,309,"2019"
"52214","290860 CONDE",1,1,5,320,10,337,"2019"
"52215","290870 CONDEUBA",0,1,7,190,3,201,"2019"
"52216","290880 CONTENDAS DO SINCORA",0,0,0,46,1,47,"2019"
"52217","290890 CORACAO DE MARIA",0,1,1,225,9,236,"2019"
"52218","290900 CORDEIROS",0,0,1,80,0,81,"2019"
"52219","290910 CORIBE",1,0,2,193,1,197,"2019"
"52220","290920 CORONEL JOAO SA",0,0,2,198,13,213,"2019"
"52221","290930 CORRENTINA",0,1,1,95,303,400,"2019"
"52222","290940 COTEGIPE",0,1,3,163,1,168,"2019"
"52223","290950 CRAVOLANDIA",0,0,0,57,1,58,"2019"
"52224","290960 CRISOPOLIS",0,2,4,202,1,209,"2019"
"52225","290970 CRISTOPOLIS",0,1,5,190,1,197,"2019"
"52226","290980 CRUZ DAS ALMAS",1,5,17,685,9,717,"2019"
"52227","290990 CURACA",1,4,6,567,8,586,"2019"
"52228","291000 DARIO MEIRA",2,1,0,147,3,153,"2019"
"52229","291005 DIAS D'AVILA",3,6,9,1047,9,1074,"2019"
"52230","291010 DOM BASILIO",1,0,3,125,1,130,"2019"
"52231","291020 DOM MACEDO COSTA",0,0,4,50,0,54,"2019"
"52232","291030 ELISIO MEDRADO",0,0,1,82,0,83,"2019"
"52233","291040 ENCRUZILHADA",0,2,4,259,3,268,"2019"
"52234","291050 ENTRE RIOS",3,2,11,505,8,529,"2019"
"52235","291060 ESPLANADA",2,1,9,472,1,485,"2019"
"52236","291070 EUCLIDES DA CUNHA",1,2,5,767,14,789,"2019"
"52237","291072 EUNAPOLIS",12,10,25,1913,13,1973,"2019"
"52238","291075 FATIMA",1,0,1,155,25,182,"2019"
"52239","291077 FEIRA DA MATA",0,2,1,35,8,46,"2019"
"52240","291080 FEIRA DE SANTANA",15,32,131,9453,185,9816,"2019"
"52241","291085 FILADELFIA",2,3,9,239,0,253,"2019"
"52242","291090 FIRMINO ALVES",0,0,0,47,1,48,"2019"
"52243","291100 FLORESTA AZUL",0,0,5,94,0,99,"2019"
"52244","291110 FORMOSA DO RIO PRETO",1,2,3,426,16,448,"2019"
"52245","291120 GANDU",3,5,9,429,0,446,"2019"
"52246","291125 GAVIAO",0,0,1,39,0,40,"2019"
"52247","291130 GENTIO DO OURO",0,2,5,104,1,112,"2019"
"52248","291140 GLORIA",0,1,6,239,5,251,"2019"
"52249","291150 GONGOGI",0,1,3,68,1,73,"2019"
"52250","291160 GOVERNADOR MANGABEIRA",0,0,6,183,64,253,"2019"
"52251","291165 GUAJERU",0,0,3,73,1,77,"2019"
"52252","291170 GUANAMBI",5,4,16,1220,28,1273,"2019"
"52253","291180 GUARATINGA",0,0,2,213,9,224,"2019"
"52254","291185 HELIOPOLIS",0,0,1,66,62,129,"2019"
"52255","291190 IACU",4,1,7,362,0,374,"2019"
"52256","291200 IBIASSUCE",0,0,1,80,0,81,"2019"
"52257","291210 IBICARAI",0,2,8,236,2,248,"2019"
"52258","291220 IBICOARA",3,0,4,264,2,273,"2019"
"52259","291230 IBICUI",0,0,4,137,1,142,"2019"
"52260","291240 IBIPEBA",1,0,2,203,0,206,"2019"
"52261","291250 IBIPITANGA",0,1,3,148,1,153,"2019"
"52262","291260 IBIQUERA",0,0,0,43,1,44,"2019"
"52263","291270 IBIRAPITANGA",0,2,18,300,20,340,"2019"
"52264","291280 IBIRAPUA",0,1,3,110,1,115,"2019"
"52265","291290 IBIRATAIA",3,1,2,272,0,278,"2019"
"52266","291300 IBITIARA",1,0,6,133,1,141,"2019"
"52267","291310 IBITITA",0,2,5,188,0,195,"2019"
"52268","291320 IBOTIRAMA",2,2,9,384,8,405,"2019"
"52269","291330 ICHU",0,0,2,33,1,36,"2019"
"52270","291340 IGAPORA",1,1,4,166,5,177,"2019"
"52271","291345 IGRAPIUNA",0,2,9,179,3,193,"2019"
"52272","291350 IGUAI",9,2,12,407,0,430,"2019"
"52273","291360 ILHEUS",8,14,41,1972,380,2415,"2019"
"52274","291370 INHAMBUPE",1,2,6,404,13,426,"2019"
"52275","291380 IPECAETA",0,1,4,140,11,156,"2019"
"52276","291390 IPIAU",2,3,12,606,0,623,"2019"
"52277","291400 IPIRA",5,4,6,763,3,781,"2019"
"52278","291410 IPUPIARA",2,1,4,100,0,107,"2019"
"52279","291420 IRAJUBA",0,0,5,75,1,81,"2019"
"52280","291430 IRAMAIA",0,0,1,82,0,83,"2019"
"52281","291440 IRAQUARA",0,1,4,380,2,387,"2019"
"52282","291450 IRARA",1,4,6,234,15,260,"2019"
"52283","291460 IRECE",3,8,18,1161,0,1190,"2019"
"52284","291465 ITABELA",0,4,11,503,0,518,"2019"
"52285","291470 ITABERABA",2,5,8,956,0,971,"2019"
"52286","291480 ITABUNA",9,15,48,2625,24,2721,"2019"
"52287","291490 ITACARE",2,2,3,296,54,357,"2019"
"52288","291500 ITAETE",2,0,3,198,2,205,"2019"
"52289","291510 ITAGI",0,0,5,178,1,184,"2019"
"52290","291520 ITAGIBA",0,0,3,163,0,166,"2019"
"52291","291530 ITAGIMIRIM",1,0,0,46,8,55,"2019"
"52292","291535 ITAGUACU DA BAHIA",1,0,4,152,0,157,"2019"
"52293","291540 ITAJU DO COLONIA",1,0,0,95,2,98,"2019"
"52294","291550 ITAJUIPE",0,1,2,237,1,241,"2019"
"52295","291560 ITAMARAJU",4,3,29,921,11,968,"2019"
"52296","291570 ITAMARI",0,1,2,89,2,94,"2019"
"52297","291580 ITAMBE",1,1,6,255,6,269,"2019"
"52298","291590 ITANAGRA",0,0,0,74,2,76,"2019"
"52299","291600 ITANHEM",0,1,7,164,2,174,"2019"
"52300","291610 ITAPARICA",0,2,4,237,24,267,"2019"
"52301","291620 ITAPE",0,0,1,125,0,126,"2019"
"52302","291630 ITAPEBI",2,0,2,111,3,118,"2019"
"52303","291640 ITAPETINGA",4,7,16,858,114,999,"2019"
"52304","291650 ITAPICURU",1,0,5,364,19,389,"2019"
"52305","291660 ITAPITANGA",1,1,1,76,0,79,"2019"
"52306","291670 ITAQUARA",0,1,2,83,6,92,"2019"
"52307","291680 ITARANTIM",1,2,5,189,7,204,"2019"
"52308","291685 ITATIM",0,0,2,141,2,145,"2019"
"52309","291690 ITIRUCU",0,2,1,130,0,133,"2019"
"52310","291700 ITIUBA",1,5,15,492,4,517,"2019"
"52311","291710 ITORORO",2,1,2,171,42,218,"2019"
"52312","291720 ITUACU",0,2,7,209,3,221,"2019"
"52313","291730 ITUBERA",3,4,18,273,1,299,"2019"
"52314","291733 IUIU",0,1,2,133,1,137,"2019"
"52315","291735 JABORANDI",0,0,1,155,3,159,"2019"
"52316","291740 JACARACI",1,0,0,129,0,130,"2019"
"52317","291750 JACOBINA",8,4,19,1317,3,1351,"2019"
"52318","291760 JAGUAQUARA",1,2,12,760,0,775,"2019"
"52319","291770 JAGUARARI",3,1,5,358,33,400,"2019"
"52320","291780 JAGUARIPE",0,1,3,215,0,219,"2019"
"52321","291790 JANDAIRA",1,1,3,128,2,135,"2019"
"52322","291800 JEQUIE",4,8,20,2298,19,2349,"2019"
"52323","291810 JEREMOABO",1,5,10,500,5,521,"2019"
"52324","291820 JIQUIRICA",0,0,3,160,0,163,"2019"
"52325","291830 JITAUNA",2,0,2,162,5,171,"2019"
"52326","291835 JOAO DOURADO",2,1,6,373,2,384,"2019"
"52327","291840 JUAZEIRO",14,25,74,4200,58,4371,"2019"
"52328","291845 JUCURUCU",0,0,1,88,5,94,"2019"
"52329","291850 JUSSARA",1,0,5,198,0,204,"2019"
"52330","291855 JUSSARI",0,0,3,64,1,68,"2019"
"52331","291860 JUSSIAPE",0,1,1,55,0,57,"2019"
"52332","291870 LAFAIETE COUTINHO",0,0,0,43,2,45,"2019"
"52333","291875 LAGOA REAL",0,1,2,118,1,122,"2019"
"52334","291880 LAJE",1,5,12,297,3,318,"2019"
"52335","291890 LAJEDAO",0,0,0,38,1,39,"2019"
"52336","291900 LAJEDINHO",0,0,0,39,1,40,"2019"
"52337","291905 LAJEDO DO TABOCAL",0,1,0,78,0,79,"2019"
"52338","291910 LAMARAO",0,1,3,71,2,77,"2019"
"52339","291915 LAPAO",1,3,11,416,1,432,"2019"
"52340","291920 LAURO DE FREITAS",12,9,66,2940,30,3057,"2019"
"52341","291930 LENCOIS",0,1,2,101,31,135,"2019"
"52342","291940 LICINIO DE ALMEIDA",0,0,2,107,0,109,"2019"
"52343","291950 LIVRAMENTO DE NOSSA SENHORA",0,0,8,563,3,574,"2019"
"52344","291955 LUIS EDUARDO MAGALHAES",10,10,35,1950,8,2013,"2019"
"52345","291960 MACAJUBA",0,1,2,140,0,143,"2019"
"52346","291970 MACARANI",1,0,3,147,14,165,"2019"
"52347","291980 MACAUBAS",6,5,5,501,2,519,"2019"
"52348","291990 MACURURE",0,0,0,100,0,100,"2019"
"52349","291992 MADRE DE DEUS",1,1,3,274,0,279,"2019"
"52350","291995 MAETINGA",0,0,0,84,0,84,"2019"
"52351","292000 MAIQUINIQUE",0,0,0,84,4,88,"2019"
"52352","292010 MAIRI",1,0,2,150,0,153,"2019"
"52353","292020 MALHADA",1,1,1,197,14,214,"2019"
"52354","292030 MALHADA DE PEDRAS",0,1,2,91,0,94,"2019"
"52355","292040 MANOEL VITORINO",2,0,2,165,4,173,"2019"
"52356","292045 MANSIDAO",1,0,5,70,1,77,"2019"
"52357","292050 MARACAS",0,2,3,333,1,339,"2019"
"52358","292060 MARAGOGIPE",0,1,1,205,225,432,"2019"
"52359","292070 MARAU",2,1,6,247,26,282,"2019"
"52360","292080 MARCIONILIO SOUZA",0,2,2,131,1,136,"2019"
"52361","292090 MASCOTE",0,1,2,130,9,142,"2019"
"52362","292100 MATA DE SAO JOAO",5,7,15,713,6,746,"2019"
"52363","292105 MATINA",0,1,1,140,1,143,"2019"
"52364","292110 MEDEIROS NETO",0,0,11,251,1,263,"2019"
"52365","292120 MIGUEL CALMON",2,2,4,338,1,347,"2019"
"52366","292130 MILAGRES",2,0,1,128,0,131,"2019"
"52367","292140 MIRANGABA",1,2,8,173,2,186,"2019"
"52368","292145 MIRANTE",1,0,0,82,2,85,"2019"
"52369","292150 MONTE SANTO",1,2,15,629,7,654,"2019"
"52370","292160 MORPARA",0,1,0,92,1,94,"2019"
"52371","292170 MORRO DO CHAPEU",2,1,6,530,6,545,"2019"
"52372","292180 MORTUGABA",1,0,4,119,0,124,"2019"
"52373","292190 MUCUGE",0,0,1,107,55,163,"2019"
"52374","292200 MUCURI",0,4,6,557,0,567,"2019"
"52375","292205 MULUNGU DO MORRO",2,1,5,200,0,208,"2019"
"52376","292210 MUNDO NOVO",0,2,5,192,3,202,"2019"
"52377","292220 MUNIZ FERREIRA",1,0,1,77,0,79,"2019"
"52378","292225 MUQUEM DE SAO FRANCISCO",0,0,9,143,4,156,"2019"
"52379","292230 MURITIBA",4,0,4,219,84,311,"2019"
"52380","292240 MUTUIPE",0,2,3,265,0,270,"2019"
"52381","292250 NAZARE",1,0,7,284,0,292,"2019"
"52382","292260 NILO PECANHA",0,1,10,165,2,178,"2019"
"52383","292265 NORDESTINA",0,1,2,137,0,140,"2019"
"52384","292270 NOVA CANAA",0,2,5,145,0,152,"2019"
"52385","292273 NOVA FATIMA",0,0,3,68,0,71,"2019"
"52386","292275 NOVA IBIA",0,0,2,51,0,53,"2019"
"52387","292280 NOVA ITARANA",1,1,1,121,4,128,"2019"
"52388","292285 NOVA REDENCAO",0,0,0,48,57,105,"2019"
"52389","292290 NOVA SOURE",0,1,2,214,124,341,"2019"
"52390","292300 NOVA VICOSA",0,1,12,443,4,460,"2019"
"52391","292303 NOVO HORIZONTE",0,0,4,127,3,134,"2019"
"52392","292305 NOVO TRIUNFO",0,0,0,86,7,93,"2019"
"52393","292310 OLINDINA",0,2,2,249,41,294,"2019"
"52394","292320 OLIVEIRA DOS BREJINHOS",0,0,3,266,4,273,"2019"
"52395","292330 OURICANGAS",0,0,1,70,3,74,"2019"
"52396","292335 OUROLANDIA",1,0,7,265,0,273,"2019"
"52397","292340 PALMAS DE MONTE ALTO",0,1,3,245,5,254,"2019"
"52398","292350 PALMEIRAS",0,0,2,133,15,150,"2019"
"52399","292360 PARAMIRIM",2,0,1,218,0,221,"2019"
"52400","292370 PARATINGA",1,2,5,428,8,444,"2019"
"52401","292380 PARIPIRANGA",0,1,2,269,10,282,"2019"
"52402","292390 PAU BRASIL",0,0,4,127,8,139,"2019"
"52403","292400 PAULO AFONSO",4,8,47,1789,5,1853,"2019"
"52404","292405 PE DE SERRA",0,2,1,135,0,138,"2019"
"52405","292410 PEDRAO",0,0,0,57,3,60,"2019"
"52406","292420 PEDRO ALEXANDRE",0,1,3,180,8,192,"2019"
"52407","292430 PIATA",2,1,6,227,0,236,"2019"
"52408","292440 PILAO ARCADO",0,2,1,556,8,567,"2019"
"52409","292450 PINDAI",0,2,0,181,18,201,"2019"
"52410","292460 PINDOBACU",1,3,5,266,1,276,"2019"
"52411","292465 PINTADAS",0,1,0,93,2,96,"2019"
"52412","292467 PIRAI DO NORTE",0,3,4,118,3,128,"2019"
"52413","292470 PIRIPA",0,0,3,104,3,110,"2019"
"52414","292480 PIRITIBA",0,1,5,193,0,199,"2019"
"52415","292490 PLANALTINO",0,1,0,80,0,81,"2019"
"52416","292500 PLANALTO",0,2,8,285,2,297,"2019"
"52417","292510 POCOES",0,0,6,609,2,617,"2019"
"52418","292520 POJUCA",1,4,12,451,2,470,"2019"
"52419","292525 PONTO NOVO",1,3,8,265,3,280,"2019"
"52420","292530 PORTO SEGURO",8,7,31,2806,68,2920,"2019"
"52421","292540 POTIRAGUA",0,3,7,90,7,107,"2019"
"52422","292550 PRADO",3,1,10,491,15,520,"2019"
"52423","292560 PRESIDENTE DUTRA",0,1,3,140,1,145,"2019"
"52424","292570 PRESIDENTE JANIO QUADROS",1,3,1,108,2,115,"2019"
"52425","292575 PRESIDENTE TANCREDO NEVES",0,3,12,371,36,422,"2019"
"52426","292580 QUEIMADAS",1,0,4,294,0,299,"2019"
"52427","292590 QUIJINGUE",1,1,5,317,11,335,"2019"
"52428","292593 QUIXABEIRA",0,2,2,103,0,107,"2019"
"52429","292595 RAFAEL JAMBEIRO",0,0,4,254,7,265,"2019"
"52430","292600 REMANSO",5,4,5,655,3,672,"2019"
"52431","292610 RETIROLANDIA",0,0,3,206,1,210,"2019"
"52432","292620 RIACHAO DAS NEVES",2,1,5,320,3,331,"2019"
"52433","292630 RIACHAO DO JACUIPE",0,1,7,386,0,394,"2019"
"52434","292640 RIACHO DE SANTANA",0,0,3,342,9,354,"2019"
"52435","292650 RIBEIRA DO AMPARO",2,1,1,52,123,179,"2019"
"52436","292660 RIBEIRA DO POMBAL",0,1,9,158,554,722,"2019"
"52437","292665 RIBEIRAO DO LARGO",2,1,1,76,5,85,"2019"
"52438","292670 RIO DE CONTAS",0,0,3,135,1,139,"2019"
"52439","292680 RIO DO ANTONIO",0,0,1,119,2,122,"2019"
"52440","292690 RIO DO PIRES",0,1,1,78,0,80,"2019"
"52441","292700 RIO REAL",1,2,8,512,11,534,"2019"
"52442","292710 RODELAS",0,1,7,159,0,167,"2019"
"52443","292720 RUY BARBOSA",1,1,8,419,0,429,"2019"
"52444","292730 SALINAS DA MARGARIDA",4,0,7,131,2,144,"2019"
"52445","292740 SALVADOR",185,133,542,31847,281,32988,"2019"
"52446","292750 SANTA BARBARA",0,0,0,240,6,246,"2019"
"52447","292760 SANTA BRIGIDA",0,2,9,225,6,242,"2019"
"52448","292770 SANTA CRUZ CABRALIA",2,0,9,447,3,461,"2019"
"52449","292780 SANTA CRUZ DA VITORIA",1,0,1,52,2,56,"2019"
"52450","292790 SANTA INES",0,0,1,111,2,114,"2019"
"52451","292800 SANTALUZ",0,2,6,517,0,525,"2019"
"52452","292805 SANTA LUZIA",0,1,7,158,5,171,"2019"
"52453","292810 SANTA MARIA DA VITORIA",2,2,7,471,20,502,"2019"
"52454","292820 SANTANA",0,3,6,288,4,301,"2019"
"52455","292830 SANTANOPOLIS",0,0,0,41,4,45,"2019"
"52456","292840 SANTA RITA DE CASSIA",3,7,14,376,6,406,"2019"
"52457","292850 SANTA TERESINHA",1,1,2,104,1,109,"2019"
"52458","292860 SANTO AMARO",2,3,10,576,15,606,"2019"
"52459","292870 SANTO ANTONIO DE JESUS",2,3,20,1340,1,1366,"2019"
"52460","292880 SANTO ESTEVAO",1,1,13,607,18,640,"2019"
"52461","292890 SAO DESIDERIO",3,2,7,583,1,596,"2019"
"52462","292895 SAO DOMINGOS",0,0,2,71,0,73,"2019"
"52463","292900 SAO FELIX",0,0,0,30,116,146,"2019"
"52464","292905 SAO FELIX DO CORIBE",0,0,3,295,4,302,"2019"
"52465","292910 SAO FELIPE",0,3,6,200,0,209,"2019"
"52466","292920 SAO FRANCISCO DO CONDE",3,2,4,552,2,563,"2019"
"52467","292925 SAO GABRIEL",3,0,5,232,0,240,"2019"
"52468","292930 SAO GONCALO DOS CAMPOS",0,1,7,341,13,362,"2019"
"52469","292935 SAO JOSE DA VITORIA",1,0,1,104,1,107,"2019"
"52470","292937 SAO JOSE DO JACUIPE",1,0,0,119,1,121,"2019"
"52471","292940 SAO MIGUEL DAS MATAS",0,0,2,106,1,109,"2019"
"52472","292950 SAO SEBASTIAO DO PASSE",1,4,6,468,4,483,"2019"
"52473","292960 SAPEACU",0,1,0,225,9,235,"2019"
"52474","292970 SATIRO DIAS",0,3,5,196,0,204,"2019"
"52475","292975 SAUBARA",1,2,1,107,0,111,"2019"
"52476","292980 SAUDE",0,1,5,97,0,103,"2019"
"52477","292990 SEABRA",1,3,2,618,4,628,"2019"
"52478","293000 SEBASTIAO LARANJEIRAS",1,0,5,94,1,101,"2019"
"52479","293010 SENHOR DO BONFIM",14,3,18,1031,0,1066,"2019"
"52480","293015 SERRA DO RAMALHO",4,3,5,543,6,561,"2019"
"52481","293020 SENTO SE",2,3,12,454,8,479,"2019"
"52482","293030 SERRA DOURADA",0,0,4,234,6,244,"2019"
"52483","293040 SERRA PRETA",0,0,1,76,2,79,"2019"
"52484","293050 SERRINHA",3,7,108,1065,5,1188,"2019"
"52485","293060 SERROLANDIA",0,0,2,157,0,159,"2019"
"52486","293070 SIMOES FILHO",13,5,26,1839,12,1895,"2019"
"52487","293075 SITIO DO MATO",0,2,5,183,8,198,"2019"
"52488","293076 SITIO DO QUINTO",0,0,0,115,4,119,"2019"
"52489","293077 SOBRADINHO",0,1,14,399,18,432,"2019"
"52490","293080 SOUTO SOARES",2,0,8,228,2,240,"2019"
"52491","293090 TABOCAS DO BREJO VELHO",0,1,2,179,2,184,"2019"
"52492","293100 TANHACU",1,0,1,252,1,255,"2019"
"52493","293105 TANQUE NOVO",0,2,4,224,3,233,"2019"
"52494","293110 TANQUINHO",0,1,0,89,1,91,"2019"
"52495","293120 TAPEROA",0,2,5,247,15,269,"2019"
"52496","293130 TAPIRAMUTA",2,2,8,224,0,236,"2019"
"52497","293135 TEIXEIRA DE FREITAS",1,6,56,2556,16,2635,"2019"
"52498","293140 TEODORO SAMPAIO",0,2,0,35,2,39,"2019"
"52499","293150 TEOFILANDIA",2,1,22,242,1,268,"2019"
"52500","293160 TEOLANDIA",0,2,5,174,8,189,"2019"
"52501","293170 TERRA NOVA",0,1,2,122,3,128,"2019"
"52502","293180 TREMEDAL",0,1,5,173,0,179,"2019"
"52503","293190 TUCANO",1,2,6,519,57,585,"2019"
"52504","293200 UAUA",0,3,9,290,6,308,"2019"
"52505","293210 UBAIRA",1,2,7,220,1,231,"2019"
"52506","293220 UBAITABA",2,2,13,279,17,313,"2019"
"52507","293230 UBATA",1,3,2,239,0,245,"2019"
"52508","293240 UIBAI",0,0,2,158,0,160,"2019"
"52509","293245 UMBURANAS",0,2,3,196,0,201,"2019"
"52510","293250 UNA",0,1,5,194,48,248,"2019"
"52511","293260 URANDI",0,0,2,170,3,175,"2019"
"52512","293270 URUCUCA",1,1,4,257,47,310,"2019"
"52513","293280 UTINGA",2,3,2,140,104,251,"2019"
"52514","293290 VALENCA",8,18,50,1369,3,1448,"2019"
"52515","293300 VALENTE",0,2,2,271,2,277,"2019"
"52516","293305 VARZEA DA ROCA",0,0,0,126,1,127,"2019"
"52517","293310 VARZEA DO POCO",1,1,1,83,1,87,"2019"
"52518","293315 VARZEA NOVA",0,1,2,181,1,185,"2019"
"52519","293317 VARZEDO",0,1,2,111,0,114,"2019"
"52520","293320 VERA CRUZ",2,7,11,548,19,587,"2019"
"52521","293325 VEREDA",0,0,1,58,0,59,"2019"
"52522","293330 VITORIA DA CONQUISTA",16,21,89,5366,49,5541,"2019"
"52523","293340 WAGNER",0,0,2,16,92,110,"2019"
"52524","293345 WANDERLEY",0,2,6,182,1,191,"2019"
"52525","293350 WENCESLAU GUIMARAES",1,1,9,380,7,398,"2019"
"52526","293360 XIQUE-XIQUE",2,8,12,835,13,870,"2019"
"52527","MUNICIPIO IGNORADO - MG",0,0,0,2,0,2,"2019"
"52528","310010 ABADIA DOS DOURADOS",1,1,0,54,0,56,"2019"
"52529","310020 ABAETE",0,0,1,235,1,237,"2019"
"52530","310030 ABRE CAMPO",0,0,0,154,8,162,"2019"
"52531","310040 ACAIACA",0,0,1,49,2,52,"2019"
"52532","310050 ACUCENA",0,1,0,90,2,93,"2019"
"52533","310060 AGUA BOA",0,2,3,149,1,155,"2019"
"52534","310070 AGUA COMPRIDA",1,0,0,18,0,19,"2019"
"52535","310080 AGUANIL",1,0,1,30,0,32,"2019"
"52536","310090 AGUAS FORMOSAS",0,3,2,266,1,272,"2019"
"52537","310100 AGUAS VERMELHAS",0,0,5,135,5,145,"2019"
"52538","310110 AIMORES",0,0,6,310,0,316,"2019"
"52539","310120 AIURUOCA",0,0,0,52,0,52,"2019"
"52540","310130 ALAGOA",0,0,0,21,0,21,"2019"
"52541","310140 ALBERTINA",0,0,0,27,0,27,"2019"
"52542","310150 ALEM PARAIBA",1,4,6,388,1,400,"2019"
"52543","310160 ALFENAS",3,4,14,994,3,1018,"2019"
"52544","310163 ALFREDO VASCONCELOS",0,0,1,70,0,71,"2019"
"52545","310170 ALMENARA",22,10,7,522,4,565,"2019"
"52546","310180 ALPERCATA",0,0,0,104,6,110,"2019"
"52547","310190 ALPINOPOLIS",0,0,4,201,2,207,"2019"
"52548","310200 ALTEROSA",0,0,1,159,0,160,"2019"
"52549","310205 ALTO CAPARAO",0,1,0,91,3,95,"2019"
"52550","310210 ALTO RIO DOCE",1,0,1,103,1,106,"2019"
"52551","310220 ALVARENGA",0,0,1,60,0,61,"2019"
"52552","310230 ALVINOPOLIS",1,0,0,136,0,137,"2019"
"52553","310240 ALVORADA DE MINAS",1,0,1,39,2,43,"2019"
"52554","310250 AMPARO DO SERRA",0,0,1,34,0,35,"2019"
"52555","310260 ANDRADAS",2,1,7,453,5,468,"2019"
"52556","310270 CACHOEIRA DE PAJEU",0,0,5,74,11,90,"2019"
"52557","310280 ANDRELANDIA",0,0,1,134,0,135,"2019"
"52558","310285 ANGELANDIA",0,0,3,94,1,98,"2019"
"52559","310290 ANTONIO CARLOS",0,0,2,124,1,127,"2019"
"52560","310300 ANTONIO DIAS",0,0,2,110,1,113,"2019"
"52561","310310 ANTONIO PRADO DE MINAS",0,0,0,10,0,10,"2019"
"52562","310320 ARACAI",0,0,0,24,0,24,"2019"
"52563","310330 ARACITABA",0,0,0,23,1,24,"2019"
"52564","310340 ARACUAI",0,0,6,375,1,382,"2019"
"52565","310350 ARAGUARI",3,6,15,1290,5,1319,"2019"
"52566","310360 ARANTINA",0,0,0,23,0,23,"2019"
"52567","310370 ARAPONGA",0,0,2,98,3,103,"2019"
"52568","310375 ARAPORA",0,0,2,126,1,129,"2019"
"52569","310380 ARAPUA",0,0,1,14,0,15,"2019"
"52570","310390 ARAUJOS",0,0,5,120,0,125,"2019"
"52571","310400 ARAXA",4,6,13,1458,2,1483,"2019"
"52572","310410 ARCEBURGO",0,1,2,71,0,74,"2019"
"52573","310420 ARCOS",0,0,9,511,2,522,"2019"
"52574","310430 AREADO",0,0,4,135,1,140,"2019"
"52575","310440 ARGIRITA",0,1,0,33,0,34,"2019"
"52576","310445 ARICANDUVA",0,0,0,53,0,53,"2019"
"52577","310450 ARINOS",1,0,0,180,1,182,"2019"
"52578","310460 ASTOLFO DUTRA",0,0,5,135,0,140,"2019"
"52579","310470 ATALEIA",0,0,2,106,16,124,"2019"
"52580","310480 AUGUSTO DE LIMA",0,0,0,46,0,46,"2019"
"52581","310490 BAEPENDI",1,0,2,209,0,212,"2019"
"52582","310500 BALDIM",0,0,1,73,0,74,"2019"
"52583","310510 BAMBUI",1,4,3,226,0,234,"2019"
"52584","310520 BANDEIRA",1,1,1,36,0,39,"2019"
"52585","310530 BANDEIRA DO SUL",0,0,0,73,0,73,"2019"
"52586","310540 BARAO DE COCAIS",1,4,2,389,5,401,"2019"
"52587","310550 BARAO DE MONTE ALTO",0,0,0,38,1,39,"2019"
"52588","310560 BARBACENA",0,4,4,1399,3,1410,"2019"
"52589","310570 BARRA LONGA",0,0,1,47,1,49,"2019"
"52590","310590 BARROSO",0,0,0,258,0,258,"2019"
"52591","310600 BELA VISTA DE MINAS",0,1,1,107,1,110,"2019"
"52592","310610 BELMIRO BRAGA",0,0,0,19,0,19,"2019"
"52593","310620 BELO HORIZONTE",88,115,456,27830,121,28610,"2019"
"52594","310630 BELO ORIENTE",1,0,3,345,4,353,"2019"
"52595","310640 BELO VALE",0,1,2,90,0,93,"2019"
"52596","310650 BERILO",0,0,3,93,3,99,"2019"
"52597","310660 BERTOPOLIS",0,0,2,59,15,76,"2019"
"52598","310665 BERIZAL",1,0,0,63,0,64,"2019"
"52599","310670 BETIM",22,23,98,5484,37,5664,"2019"
"52600","310680 BIAS FORTES",0,0,0,20,2,22,"2019"
"52601","310690 BICAS",0,1,3,139,0,143,"2019"
"52602","310700 BIQUINHAS",0,0,0,12,1,13,"2019"
"52603","310710 BOA ESPERANCA",0,0,5,571,0,576,"2019"
"52604","310720 BOCAINA DE MINAS",0,0,0,29,1,30,"2019"
"52605","310730 BOCAIUVA",3,2,10,647,4,666,"2019"
"52606","310740 BOM DESPACHO",1,2,18,620,0,641,"2019"
"52607","310750 BOM JARDIM DE MINAS",0,1,0,47,0,48,"2019"
"52608","310760 BOM JESUS DA PENHA",0,0,0,50,0,50,"2019"
"52609","310770 BOM JESUS DO AMPARO",0,1,4,68,1,74,"2019"
"52610","310780 BOM JESUS DO GALHO",0,0,1,150,2,153,"2019"
"52611","310790 BOM REPOUSO",0,0,0,148,1,149,"2019"
"52612","310800 BOM SUCESSO",0,2,1,152,0,155,"2019"
"52613","310810 BONFIM",0,0,2,46,1,49,"2019"
"52614","310820 BONFINOPOLIS DE MINAS",0,0,1,74,0,75,"2019"
"52615","310825 BONITO DE MINAS",1,0,0,62,49,112,"2019"
"52616","310830 BORDA DA MATA",0,0,0,146,2,148,"2019"
"52617","310840 BOTELHOS",0,1,1,136,0,138,"2019"
"52618","310850 BOTUMIRIM",0,1,2,57,1,61,"2019"
"52619","310855 BRASILANDIA DE MINAS",0,1,1,202,0,204,"2019"
"52620","310860 BRASILIA DE MINAS",0,0,5,477,1,483,"2019"
"52621","310870 BRAS PIRES",0,0,0,43,0,43,"2019"
"52622","310880 BRAUNAS",0,1,0,56,2,59,"2019"
"52623","310890 BRAZOPOLIS",0,0,1,148,1,150,"2019"
"52624","310900 BRUMADINHO",8,1,10,445,1,465,"2019"
"52625","310910 BUENO BRANDAO",1,0,1,88,1,91,"2019"
"52626","310920 BUENOPOLIS",0,1,6,100,2,109,"2019"
"52627","310925 BUGRE",0,0,0,57,0,57,"2019"
"52628","310930 BURITIS",4,1,3,331,1,340,"2019"
"52629","310940 BURITIZEIRO",2,1,4,323,18,348,"2019"
"52630","310945 CABECEIRA GRANDE",0,1,0,93,0,94,"2019"
"52631","310950 CABO VERDE",0,0,2,120,0,122,"2019"
"52632","310960 CACHOEIRA DA PRATA",0,0,0,40,0,40,"2019"
"52633","310970 CACHOEIRA DE MINAS",0,0,1,126,2,129,"2019"
"52634","310980 CACHOEIRA DOURADA",0,0,0,13,0,13,"2019"
"52635","310990 CAETANOPOLIS",0,1,3,124,0,128,"2019"
"52636","311000 CAETE",3,3,5,469,13,493,"2019"
"52637","311010 CAIANA",0,0,0,70,2,72,"2019"
"52638","311020 CAJURI",1,0,1,34,2,38,"2019"
"52639","311030 CALDAS",0,0,2,122,1,125,"2019"
"52640","311040 CAMACHO",0,0,1,31,0,32,"2019"
"52641","311050 CAMANDUCAIA",0,1,4,271,2,278,"2019"
"52642","311060 CAMBUI",1,0,1,329,1,332,"2019"
"52643","311070 CAMBUQUIRA",1,0,2,132,0,135,"2019"
"52644","311080 CAMPANARIO",0,3,1,36,0,40,"2019"
"52645","311090 CAMPANHA",0,2,0,175,1,178,"2019"
"52646","311100 CAMPESTRE",0,0,1,177,0,178,"2019"
"52647","311110 CAMPINA VERDE",0,0,2,162,0,164,"2019"
"52648","311115 CAMPO AZUL",0,1,0,43,0,44,"2019"
"52649","311120 CAMPO BELO",1,1,8,577,2,589,"2019"
"52650","311130 CAMPO DO MEIO",0,0,2,120,1,123,"2019"
"52651","311140 CAMPO FLORIDO",0,0,0,110,1,111,"2019"
"52652","311150 CAMPOS ALTOS",0,2,3,193,1,199,"2019"
"52653","311160 CAMPOS GERAIS",0,0,2,292,1,295,"2019"
"52654","311170 CANAA",0,0,0,46,1,47,"2019"
"52655","311180 CANAPOLIS",1,0,0,103,4,108,"2019"
"52656","311190 CANA VERDE",0,0,1,57,0,58,"2019"
"52657","311200 CANDEIAS",0,1,2,104,0,107,"2019"
"52658","311205 CANTAGALO",1,0,0,53,1,55,"2019"
"52659","311210 CAPARAO",0,0,0,87,2,89,"2019"
"52660","311220 CAPELA NOVA",0,0,0,50,0,50,"2019"
"52661","311230 CAPELINHA",2,0,9,573,2,586,"2019"
"52662","311240 CAPETINGA",0,1,0,73,0,74,"2019"
"52663","311250 CAPIM BRANCO",0,1,1,105,4,111,"2019"
"52664","311260 CAPINOPOLIS",0,1,0,154,0,155,"2019"
"52665","311265 CAPITAO ANDRADE",0,0,0,51,3,54,"2019"
"52666","311270 CAPITAO ENEAS",0,0,2,190,2,194,"2019"
"52667","311280 CAPITOLIO",1,1,2,99,1,104,"2019"
"52668","311290 CAPUTIRA",0,0,0,99,11,110,"2019"
"52669","311300 CARAI",0,6,2,242,7,257,"2019"
"52670","311310 CARANAIBA",3,0,1,28,1,33,"2019"
"52671","311320 CARANDAI",0,0,5,286,0,291,"2019"
"52672","311330 CARANGOLA",0,0,2,386,4,392,"2019"
"52673","311340 CARATINGA",4,4,3,1103,38,1152,"2019"
"52674","311350 CARBONITA",1,0,1,88,0,90,"2019"
"52675","311360 CAREACU",0,0,1,71,0,72,"2019"
"52676","311370 CARLOS CHAGAS",1,2,2,221,1,227,"2019"
"52677","311380 CARMESIA",0,0,2,26,0,28,"2019"
"52678","311390 CARMO DA CACHOEIRA",0,2,1,138,1,142,"2019"
"52679","311400 CARMO DA MATA",0,2,0,91,1,94,"2019"
"52680","311410 CARMO DE MINAS",0,0,4,132,0,136,"2019"
"52681","311420 CARMO DO CAJURU",1,0,2,276,6,285,"2019"
"52682","311430 CARMO DO PARANAIBA",0,1,3,356,0,360,"2019"
"52683","311440 CARMO DO RIO CLARO",0,1,6,218,0,225,"2019"
"52684","311450 CARMOPOLIS DE MINAS",1,0,2,213,0,216,"2019"
"52685","311455 CARNEIRINHO",1,0,2,96,0,99,"2019"
"52686","311460 CARRANCAS",2,0,0,44,1,47,"2019"
"52687","311470 CARVALHOPOLIS",0,0,0,38,0,38,"2019"
"52688","311480 CARVALHOS",0,0,0,43,0,43,"2019"
"52689","311490 CASA GRANDE",0,0,0,18,0,18,"2019"
"52690","311500 CASCALHO RICO",0,0,0,36,0,36,"2019"
"52691","311510 CASSIA",1,3,6,202,0,212,"2019"
"52692","311520 CONCEICAO DA BARRA DE MINAS",0,0,0,33,0,33,"2019"
"52693","311530 CATAGUASES",3,8,22,715,1,749,"2019"
"52694","311535 CATAS ALTAS",0,0,2,79,0,81,"2019"
"52695","311540 CATAS ALTAS DA NORUEGA",0,0,1,34,0,35,"2019"
"52696","311545 CATUJI",1,0,3,128,0,132,"2019"
"52697","311547 CATUTI",0,0,0,20,30,50,"2019"
"52698","311550 CAXAMBU",0,0,4,226,2,232,"2019"
"52699","311560 CEDRO DO ABAETE",0,0,0,2,0,2,"2019"
"52700","311570 CENTRAL DE MINAS",0,0,1,72,1,74,"2019"
"52701","311580 CENTRALINA",0,0,0,74,6,80,"2019"
"52702","311590 CHACARA",0,0,0,27,0,27,"2019"
"52703","311600 CHALE",0,0,2,83,7,92,"2019"
"52704","311610 CHAPADA DO NORTE",1,1,0,108,0,110,"2019"
"52705","311615 CHAPADA GAUCHA",1,0,2,200,2,205,"2019"
"52706","311620 CHIADOR",0,1,0,38,0,39,"2019"
"52707","311630 CIPOTANEA",0,0,0,53,0,53,"2019"
"52708","311640 CLARAVAL",0,2,0,21,0,23,"2019"
"52709","311650 CLARO DOS POCOES",0,0,0,57,1,58,"2019"
"52710","311660 CLAUDIO",0,1,11,385,1,398,"2019"
"52711","311670 COIMBRA",0,0,1,73,0,74,"2019"
"52712","311680 COLUNA",0,1,2,80,1,84,"2019"
"52713","311690 COMENDADOR GOMES",0,0,0,39,1,40,"2019"
"52714","311700 COMERCINHO",0,2,3,44,2,51,"2019"
"52715","311710 CONCEICAO DA APARECIDA",0,0,1,122,0,123,"2019"
"52716","311720 CONCEICAO DAS PEDRAS",0,0,0,25,1,26,"2019"
"52717","311730 CONCEICAO DAS ALAGOAS",2,3,2,352,1,360,"2019"
"52718","311740 CONCEICAO DE IPANEMA",0,0,0,31,1,32,"2019"
"52719","311750 CONCEICAO DO MATO DENTRO",0,2,4,274,1,281,"2019"
"52720","311760 CONCEICAO DO PARA",1,0,0,57,0,58,"2019"
"52721","311770 CONCEICAO DO RIO VERDE",0,0,1,158,0,159,"2019"
"52722","311780 CONCEICAO DOS OUROS",2,0,0,119,0,121,"2019"
"52723","311783 CONEGO MARINHO",0,0,0,37,28,65,"2019"
"52724","311787 CONFINS",0,0,1,86,4,91,"2019"
"52725","311790 CONGONHAL",0,0,3,106,2,111,"2019"
"52726","311800 CONGONHAS",0,2,11,677,1,691,"2019"
"52727","311810 CONGONHAS DO NORTE",0,0,2,39,2,43,"2019"
"52728","311820 CONQUISTA",1,0,1,65,0,67,"2019"
"52729","311830 CONSELHEIRO LAFAIETE",4,0,13,1702,7,1726,"2019"
"52730","311840 CONSELHEIRO PENA",0,3,4,230,5,242,"2019"
"52731","311850 CONSOLACAO",0,0,0,17,0,17,"2019"
"52732","311860 CONTAGEM",23,39,116,8042,36,8256,"2019"
"52733","311870 COQUEIRAL",0,0,5,95,2,102,"2019"
"52734","311880 CORACAO DE JESUS",0,0,2,269,1,272,"2019"
"52735","311890 CORDISBURGO",0,0,1,75,1,77,"2019"
"52736","311900 CORDISLANDIA",1,1,1,31,0,34,"2019"
"52737","311910 CORINTO",0,3,20,241,1,265,"2019"
"52738","311920 COROACI",0,0,1,67,4,72,"2019"
"52739","311930 COROMANDEL",1,0,2,341,0,344,"2019"
"52740","311940 CORONEL FABRICIANO",3,2,10,1323,5,1343,"2019"
"52741","311950 CORONEL MURTA",0,0,0,94,8,102,"2019"
"52742","311960 CORONEL PACHECO",0,0,0,21,0,21,"2019"
"52743","311970 CORONEL XAVIER CHAVES",0,0,0,25,0,25,"2019"
"52744","311980 CORREGO DANTA",0,0,0,27,0,27,"2019"
"52745","311990 CORREGO DO BOM JESUS",0,0,0,26,0,26,"2019"
"52746","311995 CORREGO FUNDO",0,0,0,70,0,70,"2019"
"52747","312000 CORREGO NOVO",0,0,0,39,2,41,"2019"
"52748","312010 COUTO DE MAGALHAES DE MINAS",0,0,0,56,0,56,"2019"
"52749","312015 CRISOLITA",0,0,2,92,4,98,"2019"
"52750","312020 CRISTAIS",0,2,3,131,0,136,"2019"
"52751","312030 CRISTALIA",0,0,1,75,0,76,"2019"
"52752","312040 CRISTIANO OTONI",0,0,0,70,0,70,"2019"
"52753","312050 CRISTINA",0,0,0,94,0,94,"2019"
"52754","312060 CRUCILANDIA",0,0,2,51,0,53,"2019"
"52755","312070 CRUZEIRO DA FORTALEZA",1,0,0,61,0,62,"2019"
"52756","312080 CRUZILIA",2,0,1,199,0,202,"2019"
"52757","312083 CUPARAQUE",2,0,1,53,1,57,"2019"
"52758","312087 CURRAL DE DENTRO",0,0,0,117,6,123,"2019"
"52759","312090 CURVELO",9,5,35,942,4,995,"2019"
"52760","312100 DATAS",0,0,1,77,0,78,"2019"
"52761","312110 DELFIM MOREIRA",0,0,1,58,0,59,"2019"
"52762","312120 DELFINOPOLIS",0,1,0,81,0,82,"2019"
"52763","312125 DELTA",0,1,3,112,1,117,"2019"
"52764","312130 DESCOBERTO",1,0,0,53,0,54,"2019"
"52765","312140 DESTERRO DE ENTRE RIOS",0,0,2,77,0,79,"2019"
"52766","312150 DESTERRO DO MELO",0,0,0,27,0,27,"2019"
"52767","312160 DIAMANTINA",4,6,14,619,4,647,"2019"
"52768","312170 DIOGO DE VASCONCELOS",0,0,0,39,1,40,"2019"
"52769","312180 DIONISIO",1,0,2,54,0,57,"2019"
"52770","312190 DIVINESIA",0,0,0,46,0,46,"2019"
"52771","312200 DIVINO",0,0,0,319,4,323,"2019"
"52772","312210 DIVINO DAS LARANJEIRAS",1,0,0,59,2,62,"2019"
"52773","312220 DIVINOLANDIA DE MINAS",0,1,1,82,0,84,"2019"
"52774","312230 DIVINOPOLIS",6,15,56,2713,5,2795,"2019"
"52775","312235 DIVISA ALEGRE",0,2,0,101,1,104,"2019"
"52776","312240 DIVISA NOVA",0,1,2,85,0,88,"2019"
"52777","312245 DIVISOPOLIS",0,0,2,90,0,92,"2019"
"52778","312247 DOM BOSCO",0,0,1,39,0,40,"2019"
"52779","312250 DOM CAVATI",0,1,0,51,0,52,"2019"
"52780","312260 DOM JOAQUIM",0,1,1,57,1,60,"2019"
"52781","312270 DOM SILVERIO",1,0,0,33,0,34,"2019"
"52782","312280 DOM VICOSO",0,0,0,31,0,31,"2019"
"52783","312290 DONA EUSEBIA",0,0,1,79,0,80,"2019"
"52784","312300 DORES DE CAMPOS",0,0,2,98,0,100,"2019"
"52785","312310 DORES DE GUANHAES",0,0,1,61,0,62,"2019"
"52786","312320 DORES DO INDAIA",0,1,2,91,0,94,"2019"
"52787","312330 DORES DO TURVO",0,0,0,49,0,49,"2019"
"52788","312340 DORESOPOLIS",0,0,0,22,0,22,"2019"
"52789","312350 DOURADOQUARA",0,0,0,19,0,19,"2019"
"52790","312352 DURANDE",0,0,1,109,18,128,"2019"
"52791","312360 ELOI MENDES",1,0,3,319,0,323,"2019"
"52792","312370 ENGENHEIRO CALDAS",0,0,2,106,10,118,"2019"
"52793","312380 ENGENHEIRO NAVARRO",0,0,0,65,2,67,"2019"
"52794","312385 ENTRE FOLHAS",0,0,0,65,6,71,"2019"
"52795","312390 ENTRE RIOS DE MINAS",0,0,1,149,0,150,"2019"
"52796","312400 ERVALIA",0,1,1,232,2,236,"2019"
"52797","312410 ESMERALDAS",2,9,22,1098,15,1146,"2019"
"52798","312420 ESPERA FELIZ",0,1,2,352,1,356,"2019"
"52799","312430 ESPINOSA",1,1,5,386,24,417,"2019"
"52800","312440 ESPIRITO SANTO DO DOURADO",0,0,0,91,0,91,"2019"
"52801","312450 ESTIVA",0,0,2,110,0,112,"2019"
"52802","312460 ESTRELA DALVA",0,0,0,20,0,20,"2019"
"52803","312470 ESTRELA DO INDAIA",0,0,1,21,0,22,"2019"
"52804","312480 ESTRELA DO SUL",1,0,0,64,0,65,"2019"
"52805","312490 EUGENOPOLIS",0,1,1,94,0,96,"2019"
"52806","312500 EWBANK DA CAMARA",0,0,1,46,0,47,"2019"
"52807","312510 EXTREMA",1,3,6,681,1,692,"2019"
"52808","312520 FAMA",0,0,0,13,0,13,"2019"
"52809","312530 FARIA LEMOS",0,0,0,39,0,39,"2019"
"52810","312540 FELICIO DOS SANTOS",0,1,5,55,2,63,"2019"
"52811","312550 SAO GONCALO DO RIO PRETO",0,1,0,28,0,29,"2019"
"52812","312560 FELISBURGO",0,0,2,101,0,103,"2019"
"52813","312570 FELIXLANDIA",0,2,4,118,0,124,"2019"
"52814","312580 FERNANDES TOURINHO",0,1,0,26,2,29,"2019"
"52815","312590 FERROS",1,2,2,97,1,103,"2019"
"52816","312595 FERVEDOURO",1,1,1,156,1,160,"2019"
"52817","312600 FLORESTAL",0,0,0,63,0,63,"2019"
"52818","312610 FORMIGA",2,2,16,671,0,691,"2019"
"52819","312620 FORMOSO",0,1,1,82,1,85,"2019"
"52820","312630 FORTALEZA DE MINAS",0,0,0,29,1,30,"2019"
"52821","312640 FORTUNA DE MINAS",0,0,0,30,0,30,"2019"
"52822","312650 FRANCISCO BADARO",0,0,0,67,1,68,"2019"
"52823","312660 FRANCISCO DUMONT",0,0,3,50,1,54,"2019"
"52824","312670 FRANCISCO SA",1,2,3,281,2,289,"2019"
"52825","312675 FRANCISCOPOLIS",0,0,0,50,0,50,"2019"
"52826","312680 FREI GASPAR",0,0,2,83,1,86,"2019"
"52827","312690 FREI INOCENCIO",0,0,2,89,3,94,"2019"
"52828","312695 FREI LAGONEGRO",0,0,1,37,0,38,"2019"
"52829","312700 FRONTEIRA",0,0,3,131,0,134,"2019"
"52830","312705 FRONTEIRA DOS VALES",0,0,1,46,1,48,"2019"
"52831","312707 FRUTA DE LEITE",0,0,0,9,45,54,"2019"
"52832","312710 FRUTAL",0,7,7,753,0,767,"2019"
"52833","312720 FUNILANDIA",0,0,0,35,0,35,"2019"
"52834","312730 GALILEIA",0,0,0,72,8,80,"2019"
"52835","312733 GAMELEIRAS",1,0,0,16,55,72,"2019"
"52836","312735 GLAUCILANDIA",0,0,1,34,1,36,"2019"
"52837","312737 GOIABEIRA",0,1,0,33,0,34,"2019"
"52838","312738 GOIANA",0,0,1,39,0,40,"2019"
"52839","312740 GONCALVES",0,0,1,30,0,31,"2019"
"52840","312750 GONZAGA",0,0,1,69,1,71,"2019"
"52841","312760 GOUVEIA",0,0,4,127,1,132,"2019"
"52842","312770 GOVERNADOR VALADARES",13,11,60,3646,136,3866,"2019"
"52843","312780 GRAO MOGOL",1,0,3,139,24,167,"2019"
"52844","312790 GRUPIARA",0,0,0,11,0,11,"2019"
"52845","312800 GUANHAES",2,1,12,438,0,453,"2019"
"52846","312810 GUAPE",0,0,2,140,0,142,"2019"
"52847","312820 GUARACIABA",1,0,1,98,0,100,"2019"
"52848","312825 GUARACIAMA",0,0,2,60,0,62,"2019"
"52849","312830 GUARANESIA",1,0,4,232,2,239,"2019"
"52850","312840 GUARANI",0,0,2,91,2,95,"2019"
"52851","312850 GUARARA",0,0,1,34,1,36,"2019"
"52852","312860 GUARDA-MOR",0,1,0,83,1,85,"2019"
"52853","312870 GUAXUPE",0,2,11,569,3,585,"2019"
"52854","312880 GUIDOVAL",0,0,2,75,0,77,"2019"
"52855","312890 GUIMARANIA",0,0,1,105,0,106,"2019"
"52856","312900 GUIRICEMA",0,0,0,79,0,79,"2019"
"52857","312910 GURINHATA",0,0,0,30,1,31,"2019"
"52858","312920 HELIODORA",0,0,1,60,0,61,"2019"
"52859","312930 IAPU",0,1,1,117,0,119,"2019"
"52860","312940 IBERTIOGA",0,0,0,56,0,56,"2019"
"52861","312950 IBIA",0,2,4,274,0,280,"2019"
"52862","312960 IBIAI",1,0,1,90,5,97,"2019"
"52863","312965 IBIRACATU",0,0,0,73,0,73,"2019"
"52864","312970 IBIRACI",0,1,7,142,0,150,"2019"
"52865","312980 IBIRITE",10,11,31,2432,11,2495,"2019"
"52866","312990 IBITIURA DE MINAS",0,0,0,31,1,32,"2019"
"52867","313000 IBITURUNA",0,0,1,17,0,18,"2019"
"52868","313005 ICARAI DE MINAS",0,0,1,115,0,116,"2019"
"52869","313010 IGARAPE",3,4,11,574,8,600,"2019"
"52870","313020 IGARATINGA",0,3,2,123,3,131,"2019"
"52871","313030 IGUATAMA",1,0,0,70,0,71,"2019"
"52872","313040 IJACI",0,0,1,88,0,89,"2019"
"52873","313050 ILICINEA",0,1,2,151,0,154,"2019"
"52874","313055 IMBE DE MINAS",1,0,1,75,4,81,"2019"
"52875","313060 INCONFIDENTES",1,0,0,56,2,59,"2019"
"52876","313065 INDAIABIRA",0,0,1,69,0,70,"2019"
"52877","313070 INDIANOPOLIS",0,1,2,67,1,71,"2019"
"52878","313080 INGAI",0,0,1,26,0,27,"2019"
"52879","313090 INHAPIM",1,0,1,247,4,253,"2019"
"52880","313100 INHAUMA",0,1,0,60,0,61,"2019"
"52881","313110 INIMUTABA",0,0,4,58,0,62,"2019"
"52882","313115 IPABA",0,2,2,224,1,229,"2019"
"52883","313120 IPANEMA",0,1,2,239,2,244,"2019"
"52884","313130 IPATINGA",6,6,27,2931,7,2977,"2019"
"52885","313140 IPIACU",0,0,1,24,2,27,"2019"
"52886","313150 IPUIUNA",0,0,3,95,4,102,"2019"
"52887","313160 IRAI DE MINAS",0,0,0,88,0,88,"2019"
"52888","313170 ITABIRA",6,6,9,1340,9,1370,"2019"
"52889","313180 ITABIRINHA",2,0,0,125,6,133,"2019"
"52890","313190 ITABIRITO",2,0,25,713,0,740,"2019"
"52891","313200 ITACAMBIRA",0,0,0,43,1,44,"2019"
"52892","313210 ITACARAMBI",2,2,3,226,46,279,"2019"
"52893","313220 ITAGUARA",0,0,0,152,1,153,"2019"
"52894","313230 ITAIPE",0,0,3,179,0,182,"2019"
"52895","313240 ITAJUBA",1,2,6,1199,2,1210,"2019"
"52896","313250 ITAMARANDIBA",1,1,9,402,0,413,"2019"
"52897","313260 ITAMARATI DE MINAS",0,0,4,33,0,37,"2019"
"52898","313270 ITAMBACURI",0,3,6,279,3,291,"2019"
"52899","313280 ITAMBE DO MATO DENTRO",0,2,0,20,0,22,"2019"
"52900","313290 ITAMOGI",0,1,1,135,0,137,"2019"
"52901","313300 ITAMONTE",0,0,2,170,1,173,"2019"
"52902","313310 ITANHANDU",0,0,0,166,1,167,"2019"
"52903","313320 ITANHOMI",2,0,0,139,1,142,"2019"
"52904","313330 ITAOBIM",0,0,1,246,0,247,"2019"
"52905","313340 ITAPAGIPE",0,0,0,112,0,112,"2019"
"52906","313350 ITAPECERICA",1,0,4,179,0,184,"2019"
"52907","313360 ITAPEVA",0,0,2,139,0,141,"2019"
"52908","313370 ITATIAIUCU",1,0,1,127,0,129,"2019"
"52909","313375 ITAU DE MINAS",0,0,5,153,0,158,"2019"
"52910","313380 ITAUNA",2,4,6,1069,1,1082,"2019"
"52911","313390 ITAVERAVA",0,0,0,48,0,48,"2019"
"52912","313400 ITINGA",0,1,1,129,4,135,"2019"
"52913","313410 ITUETA",0,1,2,70,1,74,"2019"
"52914","313420 ITUIUTABA",7,2,6,1185,3,1203,"2019"
"52915","313430 ITUMIRIM",0,0,0,72,0,72,"2019"
"52916","313440 ITURAMA",3,0,5,513,0,521,"2019"
"52917","313450 ITUTINGA",0,0,0,44,0,44,"2019"
"52918","313460 JABOTICATUBAS",2,0,2,180,5,189,"2019"
"52919","313470 JACINTO",3,1,13,88,3,108,"2019"
"52920","313480 JACUI",0,1,1,99,0,101,"2019"
"52921","313490 JACUTINGA",0,0,4,340,1,345,"2019"
"52922","313500 JAGUARACU",0,1,0,32,0,33,"2019"
"52923","313505 JAIBA",2,4,13,559,64,642,"2019"
"52924","313507 JAMPRUCA",0,0,1,49,3,53,"2019"
"52925","313510 JANAUBA",1,10,21,1012,4,1048,"2019"
"52926","313520 JANUARIA",1,1,4,544,363,913,"2019"
"52927","313530 JAPARAIBA",0,0,3,47,0,50,"2019"
"52928","313535 JAPONVAR",0,0,2,106,0,108,"2019"
"52929","313540 JECEABA",0,0,3,64,0,67,"2019"
"52930","313545 JENIPAPO DE MINAS",0,0,0,68,0,68,"2019"
"52931","313550 JEQUERI",0,1,1,149,4,155,"2019"
"52932","313560 JEQUITAI",0,1,1,68,3,73,"2019"
"52933","313570 JEQUITIBA",0,0,0,61,1,62,"2019"
"52934","313580 JEQUITINHONHA",3,0,2,279,1,285,"2019"
"52935","313590 JESUANIA",0,0,1,48,1,50,"2019"
"52936","313600 JOAIMA",1,1,3,183,1,189,"2019"
"52937","313610 JOANESIA",0,0,1,55,1,57,"2019"
"52938","313620 JOAO MONLEVADE",1,2,6,943,3,955,"2019"
"52939","313630 JOAO PINHEIRO",1,2,7,718,3,731,"2019"
"52940","313640 JOAQUIM FELICIO",0,0,1,43,0,44,"2019"
"52941","313650 JORDANIA",2,2,6,98,2,110,"2019"
"52942","313652 JOSE GONCALVES DE MINAS",0,0,0,34,1,35,"2019"
"52943","313655 JOSE RAYDAN",0,0,0,47,0,47,"2019"
"52944","313657 JOSENOPOLIS",0,0,0,15,24,39,"2019"
"52945","313660 NOVA UNIAO",0,0,3,87,2,92,"2019"
"52946","313665 JUATUBA",2,3,3,396,4,408,"2019"
"52947","313670 JUIZ DE FORA",11,28,77,6308,34,6458,"2019"
"52948","313680 JURAMENTO",0,0,0,40,0,40,"2019"
"52949","313690 JURUAIA",0,0,0,131,0,131,"2019"
"52950","313695 JUVENILIA",1,0,0,14,41,56,"2019"
"52951","313700 LADAINHA",0,1,4,209,4,218,"2019"
"52952","313710 LAGAMAR",0,0,1,45,0,46,"2019"
"52953","313720 LAGOA DA PRATA",0,2,33,626,2,663,"2019"
"52954","313730 LAGOA DOS PATOS",2,0,0,44,2,48,"2019"
"52955","313740 LAGOA DOURADA",0,0,1,139,0,140,"2019"
"52956","313750 LAGOA FORMOSA",0,0,2,205,0,207,"2019"
"52957","313753 LAGOA GRANDE",0,1,0,96,1,98,"2019"
"52958","313760 LAGOA SANTA",2,1,12,778,12,805,"2019"
"52959","313770 LAJINHA",3,0,2,336,11,352,"2019"
"52960","313780 LAMBARI",1,1,0,204,0,206,"2019"
"52961","313790 LAMIM",0,0,0,36,0,36,"2019"
"52962","313800 LARANJAL",1,0,1,36,0,38,"2019"
"52963","313810 LASSANCE",1,0,0,74,6,81,"2019"
"52964","313820 LAVRAS",3,1,11,1439,2,1456,"2019"
"52965","313830 LEANDRO FERREIRA",0,0,0,24,0,24,"2019"
"52966","313835 LEME DO PRADO",0,1,0,36,0,37,"2019"
"52967","313840 LEOPOLDINA",0,2,6,602,0,610,"2019"
"52968","313850 LIBERDADE",0,1,0,40,0,41,"2019"
"52969","313860 LIMA DUARTE",0,0,2,179,0,181,"2019"
"52970","313862 LIMEIRA DO OESTE",0,0,0,103,0,103,"2019"
"52971","313865 LONTRA",0,0,0,107,1,108,"2019"
"52972","313867 LUISBURGO",0,0,1,101,11,113,"2019"
"52973","313868 LUISLANDIA",0,0,2,71,0,73,"2019"
"52974","313870 LUMINARIAS",0,0,2,54,0,56,"2019"
"52975","313880 LUZ",1,0,6,180,0,187,"2019"
"52976","313890 MACHACALIS",1,1,0,81,1,84,"2019"
"52977","313900 MACHADO",0,0,10,459,0,469,"2019"
"52978","313910 MADRE DE DEUS DE MINAS",1,0,1,49,0,51,"2019"
"52979","313920 MALACACHETA",0,0,1,214,1,216,"2019"
"52980","313925 MAMONAS",0,0,1,7,48,56,"2019"
"52981","313930 MANGA",1,0,2,58,230,291,"2019"
"52982","313940 MANHUACU",2,3,7,1185,175,1372,"2019"
"52983","313950 MANHUMIRIM",0,0,4,248,36,288,"2019"
"52984","313960 MANTENA",0,2,5,328,3,338,"2019"
"52985","313970 MARAVILHAS",1,2,2,80,1,86,"2019"
"52986","313980 MAR DE ESPANHA",1,0,5,151,0,157,"2019"
"52987","313990 MARIA DA FE",1,0,2,169,1,173,"2019"
"52988","314000 MARIANA",2,2,16,743,3,766,"2019"
"52989","314010 MARILAC",1,0,1,54,4,60,"2019"
"52990","314015 MARIO CAMPOS",1,1,4,196,1,203,"2019"
"52991","314020 MARIPA DE MINAS",0,1,0,38,0,39,"2019"
"52992","314030 MARLIERIA",0,0,1,53,0,54,"2019"
"52993","314040 MARMELOPOLIS",0,0,0,45,0,45,"2019"
"52994","314050 MARTINHO CAMPOS",1,1,2,130,3,137,"2019"
"52995","314053 MARTINS SOARES",0,0,2,141,16,159,"2019"
"52996","314055 MATA VERDE",3,0,7,94,0,104,"2019"
"52997","314060 MATERLANDIA",1,0,1,34,2,38,"2019"
"52998","314070 MATEUS LEME",0,1,5,414,3,423,"2019"
"52999","314080 MATIAS BARBOSA",0,2,3,149,2,156,"2019"
"53000","314085 MATIAS CARDOSO",0,0,0,103,19,122,"2019"
"53001","314090 MATIPO",0,1,3,223,30,257,"2019"
"53002","314100 MATO VERDE",0,1,1,44,106,152,"2019"
"53003","314110 MATOZINHOS",1,0,3,459,24,487,"2019"
"53004","314120 MATUTINA",0,0,1,31,0,32,"2019"
"53005","314130 MEDEIROS",0,0,0,41,0,41,"2019"
"53006","314140 MEDINA",1,3,8,236,1,249,"2019"
"53007","314150 MENDES PIMENTEL",1,0,3,45,1,50,"2019"
"53008","314160 MERCES",2,0,2,72,1,77,"2019"
"53009","314170 MESQUITA",0,0,0,58,0,58,"2019"
"53010","314180 MINAS NOVAS",1,0,1,268,6,276,"2019"
"53011","314190 MINDURI",0,0,0,49,0,49,"2019"
"53012","314200 MIRABELA",0,1,0,152,1,154,"2019"
"53013","314210 MIRADOURO",0,0,3,92,5,100,"2019"
"53014","314220 MIRAI",0,2,0,144,3,149,"2019"
"53015","314225 MIRAVANIA",0,0,0,16,36,52,"2019"
"53016","314230 MOEDA",0,1,1,54,0,56,"2019"
"53017","314240 MOEMA",0,0,2,78,0,80,"2019"
"53018","314250 MONJOLOS",0,0,1,20,0,21,"2019"
"53019","314260 MONSENHOR PAULO",0,0,2,62,0,64,"2019"
"53020","314270 MONTALVANIA",2,0,1,43,146,192,"2019"
"53021","314280 MONTE ALEGRE DE MINAS",2,0,1,176,41,220,"2019"
"53022","314290 MONTE AZUL",0,1,3,32,192,228,"2019"
"53023","314300 MONTE BELO",0,0,3,131,1,135,"2019"
"53024","314310 MONTE CARMELO",2,1,2,589,0,594,"2019"
"53025","314315 MONTE FORMOSO",0,0,0,83,0,83,"2019"
"53026","314320 MONTE SANTO DE MINAS",0,0,2,238,1,241,"2019"
"53027","314330 MONTES CLAROS",14,19,80,6058,36,6207,"2019"
"53028","314340 MONTE SIAO",0,0,4,185,5,194,"2019"
"53029","314345 MONTEZUMA",0,0,0,70,1,71,"2019"
"53030","314350 MORADA NOVA DE MINAS",0,0,1,85,0,86,"2019"
"53031","314360 MORRO DA GARCA",0,0,1,21,0,22,"2019"
"53032","314370 MORRO DO PILAR",1,1,0,32,1,35,"2019"
"53033","314380 MUNHOZ",0,0,1,49,0,50,"2019"
"53034","314390 MURIAE",3,3,16,1224,46,1292,"2019"
"53035","314400 MUTUM",0,0,4,332,25,361,"2019"
"53036","314410 MUZAMBINHO",1,1,2,259,0,263,"2019"
"53037","314420 NACIP RAYDAN",0,0,0,36,4,40,"2019"
"53038","314430 NANUQUE",0,5,16,453,1,475,"2019"
"53039","314435 NAQUE",0,0,2,113,3,118,"2019"
"53040","314437 NATALANDIA",0,1,2,34,0,37,"2019"
"53041","314440 NATERCIA",0,0,0,33,1,34,"2019"
"53042","314450 NAZARENO",0,0,0,73,0,73,"2019"
"53043","314460 NEPOMUCENO",0,1,2,255,0,258,"2019"
"53044","314465 NINHEIRA",0,0,1,91,21,113,"2019"
"53045","314467 NOVA BELEM",0,1,1,48,1,51,"2019"
"53046","314470 NOVA ERA",1,1,1,188,0,191,"2019"
"53047","314480 NOVA LIMA",2,0,20,1385,4,1411,"2019"
"53048","314490 NOVA MODICA",0,0,0,33,0,33,"2019"
"53049","314500 NOVA PONTE",0,0,5,203,5,213,"2019"
"53050","314505 NOVA PORTEIRINHA",0,0,3,95,0,98,"2019"
"53051","314510 NOVA RESENDE",2,2,8,211,0,223,"2019"
"53052","314520 NOVA SERRANA",5,3,19,1790,11,1828,"2019"
"53053","314530 NOVO CRUZEIRO",1,2,2,387,2,394,"2019"
"53054","314535 NOVO ORIENTE DE MINAS",0,0,0,137,2,139,"2019"
"53055","314537 NOVORIZONTE",0,0,0,21,25,46,"2019"
"53056","314540 OLARIA",0,0,0,18,0,18,"2019"
"53057","314545 OLHOS-D'AGUA",0,0,4,76,2,82,"2019"
"53058","314550 OLIMPIO NORONHA",0,0,0,34,0,34,"2019"
"53059","314560 OLIVEIRA",2,2,5,432,0,441,"2019"
"53060","314570 OLIVEIRA FORTES",0,0,0,17,0,17,"2019"
"53061","314580 ONCA DE PITANGUI",1,0,1,24,0,26,"2019"
"53062","314585 ORATORIOS",0,0,1,50,0,51,"2019"
"53063","314587 ORIZANIA",0,0,0,107,3,110,"2019"
"53064","314590 OURO BRANCO",3,0,5,541,2,551,"2019"
"53065","314600 OURO FINO",0,0,3,311,14,328,"2019"
"53066","314610 OURO PRETO",2,3,41,720,2,768,"2019"
"53067","314620 OURO VERDE DE MINAS",0,0,0,84,5,89,"2019"
"53068","314625 PADRE CARVALHO",0,0,0,14,46,60,"2019"
"53069","314630 PADRE PARAISO",0,1,1,237,0,239,"2019"
"53070","314640 PAINEIRAS",0,0,0,34,0,34,"2019"
"53071","314650 PAINS",0,2,3,101,0,106,"2019"
"53072","314655 PAI PEDRO",0,0,0,51,6,57,"2019"
"53073","314660 PAIVA",0,0,0,12,0,12,"2019"
"53074","314670 PALMA",0,0,1,55,0,56,"2019"
"53075","314675 PALMOPOLIS",1,0,0,71,1,73,"2019"
"53076","314690 PAPAGAIOS",1,0,0,166,1,168,"2019"
"53077","314700 PARACATU",1,4,16,1426,1,1448,"2019"
"53078","314710 PARA DE MINAS",0,0,21,1083,11,1115,"2019"
"53079","314720 PARAGUACU",1,0,0,249,0,250,"2019"
"53080","314730 PARAISOPOLIS",0,0,2,191,4,197,"2019"
"53081","314740 PARAOPEBA",1,1,4,332,5,343,"2019"
"53082","314750 PASSABEM",0,0,0,11,0,11,"2019"
"53083","314760 PASSA QUATRO",1,2,3,183,0,189,"2019"
"53084","314770 PASSA TEMPO",0,0,3,53,0,56,"2019"
"53085","314780 PASSA-VINTE",0,0,0,11,0,11,"2019"
"53086","314790 PASSOS",0,1,17,1352,4,1374,"2019"
"53087","314795 PATIS",0,0,0,56,0,56,"2019"
"53088","314800 PATOS DE MINAS",3,6,11,1830,2,1852,"2019"
"53089","314810 PATROCINIO",4,3,13,1303,2,1325,"2019"
"53090","314820 PATROCINIO DO MURIAE",0,0,0,30,0,30,"2019"
"53091","314830 PAULA CANDIDO",0,1,1,102,0,104,"2019"
"53092","314840 PAULISTAS",1,0,0,40,0,41,"2019"
"53093","314850 PAVAO",0,0,2,82,3,87,"2019"
"53094","314860 PECANHA",2,1,1,226,0,230,"2019"
"53095","314870 PEDRA AZUL",0,2,4,319,1,326,"2019"
"53096","314875 PEDRA BONITA",0,0,0,108,3,111,"2019"
"53097","314880 PEDRA DO ANTA",0,0,1,20,0,21,"2019"
"53098","314890 PEDRA DO INDAIA",0,0,2,27,0,29,"2019"
"53099","314900 PEDRA DOURADA",0,0,1,30,1,32,"2019"
"53100","314910 PEDRALVA",0,0,0,128,0,128,"2019"
"53101","314915 PEDRAS DE MARIA DA CRUZ",0,1,0,76,47,124,"2019"
"53102","314920 PEDRINOPOLIS",1,0,0,24,0,25,"2019"
"53103","314930 PEDRO LEOPOLDO",2,2,7,674,47,732,"2019"
"53104","314940 PEDRO TEIXEIRA",0,0,1,15,0,16,"2019"
"53105","314950 PEQUERI",0,1,0,38,0,39,"2019"
"53106","314960 PEQUI",0,0,1,40,0,41,"2019"
"53107","314970 PERDIGAO",0,0,2,169,0,171,"2019"
"53108","314980 PERDIZES",1,1,2,230,1,235,"2019"
"53109","314990 PERDOES",1,0,1,195,2,199,"2019"
"53110","314995 PERIQUITO",0,1,0,97,10,108,"2019"
"53111","315000 PESCADOR",0,0,1,52,0,53,"2019"
"53112","315010 PIAU",0,0,0,21,0,21,"2019"
"53113","315015 PIEDADE DE CARATINGA",1,1,1,123,3,129,"2019"
"53114","315020 PIEDADE DE PONTE NOVA",0,0,0,62,1,63,"2019"
"53115","315030 PIEDADE DO RIO GRANDE",0,0,0,43,1,44,"2019"
"53116","315040 PIEDADE DOS GERAIS",0,0,1,38,0,39,"2019"
"53117","315050 PIMENTA",0,0,2,70,0,72,"2019"
"53118","315053 PINGO-D'AGUA",1,0,2,55,1,59,"2019"
"53119","315057 PINTOPOLIS",0,0,0,98,0,98,"2019"
"53120","315060 PIRACEMA",0,0,0,65,2,67,"2019"
"53121","315070 PIRAJUBA",0,0,3,68,0,71,"2019"
"53122","315080 PIRANGA",1,2,4,139,2,148,"2019"
"53123","315090 PIRANGUCU",0,0,0,64,0,64,"2019"
"53124","315100 PIRANGUINHO",2,1,1,119,0,123,"2019"
"53125","315110 PIRAPETINGA",1,0,0,162,0,163,"2019"
"53126","315120 PIRAPORA",3,1,12,713,28,757,"2019"
"53127","315130 PIRAUBA",1,1,1,120,0,123,"2019"
"53128","315140 PITANGUI",0,2,3,326,6,337,"2019"
"53129","315150 PIUMHI",0,4,7,425,1,437,"2019"
"53130","315160 PLANURA",1,2,3,124,0,130,"2019"
"53131","315170 POCO FUNDO",0,1,0,175,0,176,"2019"
"53132","315180 POCOS DE CALDAS",6,9,35,1853,1,1904,"2019"
"53133","315190 POCRANE",0,0,1,81,4,86,"2019"
"53134","315200 POMPEU",2,2,1,423,1,429,"2019"
"53135","315210 PONTE NOVA",0,2,3,706,3,714,"2019"
"53136","315213 PONTO CHIQUE",0,1,0,63,4,68,"2019"
"53137","315217 PONTO DOS VOLANTES",1,1,0,158,0,160,"2019"
"53138","315220 PORTEIRINHA",2,1,6,446,2,457,"2019"
"53139","315230 PORTO FIRME",0,0,2,87,2,91,"2019"
"53140","315240 POTE",0,0,3,173,0,176,"2019"
"53141","315250 POUSO ALEGRE",1,2,15,1885,17,1920,"2019"
"53142","315260 POUSO ALTO",0,0,1,64,0,65,"2019"
"53143","315270 PRADOS",0,0,0,76,0,76,"2019"
"53144","315280 PRATA",0,1,1,297,2,301,"2019"
"53145","315290 PRATAPOLIS",0,1,2,66,0,69,"2019"
"53146","315300 PRATINHA",0,0,2,39,0,41,"2019"
"53147","315310 PRESIDENTE BERNARDES",0,0,1,31,0,32,"2019"
"53148","315320 PRESIDENTE JUSCELINO",1,0,2,37,1,41,"2019"
"53149","315330 PRESIDENTE KUBITSCHEK",0,0,0,41,1,42,"2019"
"53150","315340 PRESIDENTE OLEGARIO",0,1,1,171,0,173,"2019"
"53151","315350 ALTO JEQUITIBA",0,0,0,113,10,123,"2019"
"53152","315360 PRUDENTE DE MORAIS",1,0,2,128,4,135,"2019"
"53153","315370 QUARTEL GERAL",0,1,0,32,0,33,"2019"
"53154","315380 QUELUZITO",0,0,1,18,1,20,"2019"
"53155","315390 RAPOSOS",1,0,2,183,1,187,"2019"
"53156","315400 RAUL SOARES",0,0,0,269,0,269,"2019"
"53157","315410 RECREIO",0,0,0,87,0,87,"2019"
"53158","315415 REDUTO",0,3,1,120,11,135,"2019"
"53159","315420 RESENDE COSTA",0,0,1,88,0,89,"2019"
"53160","315430 RESPLENDOR",0,1,2,203,4,210,"2019"
"53161","315440 RESSAQUINHA",0,0,1,59,0,60,"2019"
"53162","315445 RIACHINHO",1,0,2,81,0,84,"2019"
"53163","315450 RIACHO DOS MACHADOS",0,0,2,125,3,130,"2019"
"53164","315460 RIBEIRAO DAS NEVES",18,27,74,4324,43,4486,"2019"
"53165","315470 RIBEIRAO VERMELHO",0,0,1,39,0,40,"2019"
"53166","315480 RIO ACIMA",0,1,2,118,2,123,"2019"
"53167","315490 RIO CASCA",0,0,1,153,2,156,"2019"
"53168","315500 RIO DOCE",0,0,1,26,1,28,"2019"
"53169","315510 RIO DO PRADO",1,0,0,62,0,63,"2019"
"53170","315520 RIO ESPERA",0,0,0,44,1,45,"2019"
"53171","315530 RIO MANSO",0,0,2,47,1,50,"2019"
"53172","315540 RIO NOVO",0,0,2,93,2,97,"2019"
"53173","315550 RIO PARANAIBA",0,1,2,166,0,169,"2019"
"53174","315560 RIO PARDO DE MINAS",0,1,6,371,5,383,"2019"
"53175","315570 RIO PIRACICABA",0,2,2,144,1,149,"2019"
"53176","315580 RIO POMBA",1,1,0,170,2,174,"2019"
"53177","315590 RIO PRETO",0,0,3,33,2,38,"2019"
"53178","315600 RIO VERMELHO",0,2,2,128,0,132,"2019"
"53179","315610 RITAPOLIS",0,0,0,48,0,48,"2019"
"53180","315620 ROCHEDO DE MINAS",0,0,0,26,0,26,"2019"
"53181","315630 RODEIRO",0,1,1,122,0,124,"2019"
"53182","315640 ROMARIA",0,1,1,37,0,39,"2019"
"53183","315645 ROSARIO DA LIMEIRA",0,1,0,39,5,45,"2019"
"53184","315650 RUBELITA",0,0,2,7,49,58,"2019"
"53185","315660 RUBIM",0,0,1,104,0,105,"2019"
"53186","315670 SABARA",9,11,28,1574,17,1639,"2019"
"53187","315680 SABINOPOLIS",1,0,5,157,2,165,"2019"
"53188","315690 SACRAMENTO",0,0,2,317,0,319,"2019"
"53189","315700 SALINAS",1,0,1,127,384,513,"2019"
"53190","315710 SALTO DA DIVISA",0,1,7,53,1,62,"2019"
"53191","315720 SANTA BARBARA",2,0,5,384,0,391,"2019"
"53192","315725 SANTA BARBARA DO LESTE",0,0,1,116,4,121,"2019"
"53193","315727 SANTA BARBARA DO MONTE VERDE",0,0,0,32,1,33,"2019"
"53194","315730 SANTA BARBARA DO TUGURIO",0,0,0,39,0,39,"2019"
"53195","315733 SANTA CRUZ DE MINAS",0,0,0,95,0,95,"2019"
"53196","315737 SANTA CRUZ DE SALINAS",0,0,0,15,30,45,"2019"
"53197","315740 SANTA CRUZ DO ESCALVADO",0,1,0,45,0,46,"2019"
"53198","315750 SANTA EFIGENIA DE MINAS",0,1,2,45,3,51,"2019"
"53199","315760 SANTA FE DE MINAS",0,0,0,46,0,46,"2019"
"53200","315765 SANTA HELENA DE MINAS",0,0,0,76,18,94,"2019"
"53201","315770 SANTA JULIANA",4,1,2,199,0,206,"2019"
"53202","315780 SANTA LUZIA",5,17,41,2911,18,2992,"2019"
"53203","315790 SANTA MARGARIDA",1,1,3,222,23,250,"2019"
"53204","315800 SANTA MARIA DE ITABIRA",0,2,0,118,3,123,"2019"
"53205","315810 SANTA MARIA DO SALTO",0,0,3,63,0,66,"2019"
"53206","315820 SANTA MARIA DO SUACUI",1,2,3,166,1,173,"2019"
"53207","315830 SANTANA DA VARGEM",0,0,1,77,0,78,"2019"
"53208","315840 SANTANA DE CATAGUASES",0,1,0,25,0,26,"2019"
"53209","315850 SANTANA DE PIRAPAMA",0,0,3,58,0,61,"2019"
"53210","315860 SANTANA DO DESERTO",0,0,0,29,1,30,"2019"
"53211","315870 SANTANA DO GARAMBEU",0,0,0,18,0,18,"2019"
"53212","315880 SANTANA DO JACARE",0,1,0,52,0,53,"2019"
"53213","315890 SANTANA DO MANHUACU",3,0,4,113,16,136,"2019"
"53214","315895 SANTANA DO PARAISO",1,2,7,725,3,738,"2019"
"53215","315900 SANTANA DO RIACHO",0,0,2,47,1,50,"2019"
"53216","315910 SANTANA DOS MONTES",0,0,1,27,0,28,"2019"
"53217","315920 SANTA RITA DE CALDAS",0,0,2,84,0,86,"2019"
"53218","315930 SANTA RITA DE JACUTINGA",0,1,0,35,0,36,"2019"
"53219","315935 SANTA RITA DE MINAS",1,0,0,105,4,110,"2019"
"53220","315940 SANTA RITA DE IBITIPOCA",0,0,0,25,0,25,"2019"
"53221","315950 SANTA RITA DO ITUETO",1,2,2,79,1,85,"2019"
"53222","315960 SANTA RITA DO SAPUCAI",0,1,4,465,2,472,"2019"
"53223","315970 SANTA ROSA DA SERRA",0,0,0,31,0,31,"2019"
"53224","315980 SANTA VITORIA",1,1,0,255,0,257,"2019"
"53225","315990 SANTO ANTONIO DO AMPARO",0,0,2,208,2,212,"2019"
"53226","316000 SANTO ANTONIO DO AVENTUREIRO",0,0,0,24,0,24,"2019"
"53227","316010 SANTO ANTONIO DO GRAMA",0,0,1,51,1,53,"2019"
"53228","316020 SANTO ANTONIO DO ITAMBE",0,0,1,46,0,47,"2019"
"53229","316030 SANTO ANTONIO DO JACINTO",0,1,8,115,3,127,"2019"
"53230","316040 SANTO ANTONIO DO MONTE",1,4,47,259,1,312,"2019"
"53231","316045 SANTO ANTONIO DO RETIRO",0,0,1,62,23,86,"2019"
"53232","316050 SANTO ANTONIO DO RIO ABAIXO",0,0,0,13,0,13,"2019"
"53233","316060 SANTO HIPOLITO",0,0,0,23,0,23,"2019"
"53234","316070 SANTOS DUMONT",0,1,5,475,8,489,"2019"
"53235","316080 SAO BENTO ABADE",2,0,0,73,0,75,"2019"
"53236","316090 SAO BRAS DO SUACUI",0,0,0,29,0,29,"2019"
"53237","316095 SAO DOMINGOS DAS DORES",0,0,0,102,1,103,"2019"
"53238","316100 SAO DOMINGOS DO PRATA",0,1,1,148,2,152,"2019"
"53239","316105 SAO FELIX DE MINAS",0,0,0,30,2,32,"2019"
"53240","316110 SAO FRANCISCO",0,2,16,762,7,787,"2019"
"53241","316120 SAO FRANCISCO DE PAULA",0,0,1,74,0,75,"2019"
"53242","316130 SAO FRANCISCO DE SALES",0,0,1,42,0,43,"2019"
"53243","316140 SAO FRANCISCO DO GLORIA",0,0,2,47,0,49,"2019"
"53244","316150 SAO GERALDO",0,0,0,106,1,107,"2019"
"53245","316160 SAO GERALDO DA PIEDADE",0,0,1,27,3,31,"2019"
"53246","316165 SAO GERALDO DO BAIXIO",0,0,0,47,1,48,"2019"
"53247","316170 SAO GONCALO DO ABAETE",2,0,1,61,0,64,"2019"
"53248","316180 SAO GONCALO DO PARA",0,0,4,140,0,144,"2019"
"53249","316190 SAO GONCALO DO RIO ABAIXO",1,0,2,157,0,160,"2019"
"53250","316200 SAO GONCALO DO SAPUCAI",3,1,7,329,0,340,"2019"
"53251","316210 SAO GOTARDO",2,2,2,754,0,760,"2019"
"53252","316220 SAO JOAO BATISTA DO GLORIA",0,1,0,79,0,80,"2019"
"53253","316225 SAO JOAO DA LAGOA",0,0,0,62,1,63,"2019"
"53254","316230 SAO JOAO DA MATA",0,1,1,29,0,31,"2019"
"53255","316240 SAO JOAO DA PONTE",3,1,8,247,2,261,"2019"
"53256","316245 SAO JOAO DAS MISSOES",0,0,5,101,140,246,"2019"
"53257","316250 SAO JOAO DEL REI",2,4,2,977,2,987,"2019"
"53258","316255 SAO JOAO DO MANHUACU",0,0,0,162,9,171,"2019"
"53259","316257 SAO JOAO DO MANTENINHA",0,0,0,83,0,83,"2019"
"53260","316260 SAO JOAO DO ORIENTE",0,0,0,112,4,116,"2019"
"53261","316265 SAO JOAO DO PACUI",0,0,1,44,2,47,"2019"
"53262","316270 SAO JOAO DO PARAISO",0,1,4,218,31,254,"2019"
"53263","316280 SAO JOAO EVANGELISTA",1,0,0,239,1,241,"2019"
"53264","316290 SAO JOAO NEPOMUCENO",0,0,2,289,3,294,"2019"
"53265","316292 SAO JOAQUIM DE BICAS",0,5,3,441,4,453,"2019"
"53266","316294 SAO JOSE DA BARRA",0,0,2,88,1,91,"2019"
"53267","316295 SAO JOSE DA LAPA",2,0,4,332,7,345,"2019"
"53268","316300 SAO JOSE DA SAFIRA",0,0,2,56,5,63,"2019"
"53269","316310 SAO JOSE DA VARGINHA",0,0,0,53,0,53,"2019"
"53270","316320 SAO JOSE DO ALEGRE",0,0,0,59,0,59,"2019"
"53271","316330 SAO JOSE DO DIVINO",0,0,0,34,0,34,"2019"
"53272","316340 SAO JOSE DO GOIABAL",0,0,0,61,1,62,"2019"
"53273","316350 SAO JOSE DO JACURI",0,0,0,45,0,45,"2019"
"53274","316360 SAO JOSE DO MANTIMENTO",0,0,0,39,5,44,"2019"
"53275","316370 SAO LOURENCO",1,3,5,488,3,500,"2019"
"53276","316380 SAO MIGUEL DO ANTA",0,0,1,57,0,58,"2019"
"53277","316390 SAO PEDRO DA UNIAO",1,1,1,52,0,55,"2019"
"53278","316400 SAO PEDRO DOS FERROS",0,0,2,87,0,89,"2019"
"53279","316410 SAO PEDRO DO SUACUI",2,0,1,60,0,63,"2019"
"53280","316420 SAO ROMAO",0,1,2,92,0,95,"2019"
"53281","316430 SAO ROQUE DE MINAS",1,1,2,65,1,70,"2019"
"53282","316440 SAO SEBASTIAO DA BELA VISTA",0,0,2,70,0,72,"2019"
"53283","316443 SAO SEBASTIAO DA VARGEM ALEGRE",0,1,0,38,0,39,"2019"
"53284","316447 SAO SEBASTIAO DO ANTA",1,0,0,80,4,85,"2019"
"53285","316450 SAO SEBASTIAO DO MARANHAO",1,1,3,102,0,107,"2019"
"53286","316460 SAO SEBASTIAO DO OESTE",0,0,1,135,1,137,"2019"
"53287","316470 SAO SEBASTIAO DO PARAISO",3,7,6,947,2,965,"2019"
"53288","316480 SAO SEBASTIAO DO RIO PRETO",0,0,0,9,0,9,"2019"
"53289","316490 SAO SEBASTIAO DO RIO VERDE",0,0,0,24,0,24,"2019"
"53290","316500 SAO TIAGO",1,0,1,114,0,116,"2019"
"53291","316510 SAO TOMAS DE AQUINO",0,1,1,80,2,84,"2019"
"53292","316520 SAO THOME DAS LETRAS",0,0,0,90,1,91,"2019"
"53293","316530 SAO VICENTE DE MINAS",0,1,2,76,0,79,"2019"
"53294","316540 SAPUCAI-MIRIM",0,0,3,69,1,73,"2019"
"53295","316550 SARDOA",0,0,0,75,5,80,"2019"
"53296","316553 SARZEDO",1,3,4,507,1,516,"2019"
"53297","316555 SETUBINHA",1,0,4,140,3,148,"2019"
"53298","316556 SEM-PEIXE",0,0,0,19,0,19,"2019"
"53299","316557 SENADOR AMARAL",0,0,1,108,0,109,"2019"
"53300","316560 SENADOR CORTES",0,0,0,25,0,25,"2019"
"53301","316570 SENADOR FIRMINO",0,0,0,85,1,86,"2019"
"53302","316580 SENADOR JOSE BENTO",0,0,0,11,0,11,"2019"
"53303","316590 SENADOR MODESTINO GONCALVES",0,0,0,39,1,40,"2019"
"53304","316600 SENHORA DE OLIVEIRA",0,1,1,56,0,58,"2019"
"53305","316610 SENHORA DO PORTO",0,0,5,38,1,44,"2019"
"53306","316620 SENHORA DOS REMEDIOS",0,0,0,93,1,94,"2019"
"53307","316630 SERICITA",0,0,2,105,1,108,"2019"
"53308","316640 SERITINGA",0,0,1,25,0,26,"2019"
"53309","316650 SERRA AZUL DE MINAS",0,0,2,53,1,56,"2019"
"53310","316660 SERRA DA SAUDADE",0,0,0,6,0,6,"2019"
"53311","316670 SERRA DOS AIMORES",1,1,3,90,0,95,"2019"
"53312","316680 SERRA DO SALITRE",0,0,1,177,0,178,"2019"
"53313","316690 SERRANIA",0,1,1,83,0,85,"2019"
"53314","316695 SERRANOPOLIS DE MINAS",0,0,0,48,1,49,"2019"
"53315","316700 SERRANOS",0,0,0,20,0,20,"2019"
"53316","316710 SERRO",0,1,4,256,0,261,"2019"
"53317","316720 SETE LAGOAS",11,6,36,2618,6,2677,"2019"
"53318","316730 SILVEIRANIA",0,0,0,19,1,20,"2019"
"53319","316740 SILVIANOPOLIS",0,0,0,64,0,64,"2019"
"53320","316750 SIMAO PEREIRA",0,0,0,28,2,30,"2019"
"53321","316760 SIMONESIA",0,0,4,317,43,364,"2019"
"53322","316770 SOBRALIA",0,0,1,50,4,55,"2019"
"53323","316780 SOLEDADE DE MINAS",0,0,0,55,0,55,"2019"
"53324","316790 TABULEIRO",0,0,0,42,1,43,"2019"
"53325","316800 TAIOBEIRAS",0,2,4,441,1,448,"2019"
"53326","316805 TAPARUBA",0,1,0,35,1,37,"2019"
"53327","316810 TAPIRA",1,0,0,61,0,62,"2019"
"53328","316820 TAPIRAI",0,0,0,14,1,15,"2019"
"53329","316830 TAQUARACU DE MINAS",0,0,1,46,1,48,"2019"
"53330","316840 TARUMIRIM",0,0,1,112,3,116,"2019"
"53331","316850 TEIXEIRAS",0,1,1,111,2,115,"2019"
"53332","316860 TEOFILO OTONI",2,7,21,1836,13,1879,"2019"
"53333","316870 TIMOTEO",0,1,13,946,1,961,"2019"
"53334","316880 TIRADENTES",0,0,1,86,0,87,"2019"
"53335","316890 TIROS",0,0,0,87,0,87,"2019"
"53336","316900 TOCANTINS",0,0,2,184,1,187,"2019"
"53337","316905 TOCOS DO MOJI",0,0,0,38,0,38,"2019"
"53338","316910 TOLEDO",0,0,1,91,0,92,"2019"
"53339","316920 TOMBOS",0,1,1,81,1,84,"2019"
"53340","316930 TRES CORACOES",3,0,10,995,2,1010,"2019"
"53341","316935 TRES MARIAS",0,0,4,373,2,379,"2019"
"53342","316940 TRES PONTAS",1,2,8,672,9,692,"2019"
"53343","316950 TUMIRITINGA",1,0,0,71,4,76,"2019"
"53344","316960 TUPACIGUARA",0,0,4,233,14,251,"2019"
"53345","316970 TURMALINA",0,0,1,249,0,250,"2019"
"53346","316980 TURVOLANDIA",0,0,0,64,0,64,"2019"
"53347","316990 UBA",0,2,13,1324,3,1342,"2019"
"53348","317000 UBAI",0,0,0,131,2,133,"2019"
"53349","317005 UBAPORANGA",0,1,2,147,5,155,"2019"
"53350","317010 UBERABA",45,19,67,4041,15,4187,"2019"
"53351","317020 UBERLANDIA",24,26,82,9453,91,9676,"2019"
"53352","317030 UMBURATIBA",0,0,1,39,0,40,"2019"
"53353","317040 UNAI",3,4,5,1199,3,1214,"2019"
"53354","317043 UNIAO DE MINAS",1,0,2,37,0,40,"2019"
"53355","317047 URUANA DE MINAS",0,0,1,23,0,24,"2019"
"53356","317050 URUCANIA",0,1,1,137,0,139,"2019"
"53357","317052 URUCUIA",0,1,1,105,0,107,"2019"
"53358","317057 VARGEM ALEGRE",0,0,0,68,1,69,"2019"
"53359","317060 VARGEM BONITA",0,0,0,22,0,22,"2019"
"53360","317065 VARGEM GRANDE DO RIO PARDO",0,0,0,70,1,71,"2019"
"53361","317070 VARGINHA",2,5,14,1773,5,1799,"2019"
"53362","317075 VARJAO DE MINAS",2,0,1,118,0,121,"2019"
"53363","317080 VARZEA DA PALMA",0,2,7,398,16,423,"2019"
"53364","317090 VARZELANDIA",0,1,5,254,2,262,"2019"
"53365","317100 VAZANTE",3,1,3,242,1,250,"2019"
"53366","317103 VERDELANDIA",0,1,1,112,2,116,"2019"
"53367","317107 VEREDINHA",0,0,0,57,3,60,"2019"
"53368","317110 VERISSIMO",0,1,0,17,0,18,"2019"
"53369","317115 VERMELHO NOVO",0,0,1,53,2,56,"2019"
"53370","317120 VESPASIANO",2,13,25,1746,18,1804,"2019"
"53371","317130 VICOSA",2,4,13,978,12,1009,"2019"
"53372","317140 VIEIRAS",0,0,1,36,0,37,"2019"
"53373","317150 MATHIAS LOBATO",0,1,1,35,1,38,"2019"
"53374","317160 VIRGEM DA LAPA",0,1,0,122,2,125,"2019"
"53375","317170 VIRGINIA",1,0,1,92,0,94,"2019"
"53376","317180 VIRGINOPOLIS",0,0,1,135,0,136,"2019"
"53377","317190 VIRGOLANDIA",0,0,0,40,3,43,"2019"
"53378","317200 VISCONDE DO RIO BRANCO",0,3,3,523,0,529,"2019"
"53379","317210 VOLTA GRANDE",0,1,0,60,0,61,"2019"
"53380","317220 WENCESLAU BRAZ",0,0,0,19,0,19,"2019"
"53381","320010 AFONSO CLAUDIO",1,6,8,363,0,378,"2019"
"53382","320013 AGUIA BRANCA",0,0,1,125,0,126,"2019"
"53383","320016 AGUA DOCE DO NORTE",0,0,0,190,0,190,"2019"
"53384","320020 ALEGRE",0,1,4,381,0,386,"2019"
"53385","320030 ALFREDO CHAVES",1,0,3,149,2,155,"2019"
"53386","320035 ALTO RIO NOVO",0,0,2,96,2,100,"2019"
"53387","320040 ANCHIETA",0,1,10,386,0,397,"2019"
"53388","320050 APIACA",1,0,1,62,0,64,"2019"
"53389","320060 ARACRUZ",2,3,19,1486,2,1512,"2019"
"53390","320070 ATILIO VIVACQUA",0,0,2,146,1,149,"2019"
"53391","320080 BAIXO GUANDU",1,2,6,387,1,397,"2019"
"53392","320090 BARRA DE SAO FRANCISCO",3,3,11,622,2,641,"2019"
"53393","320100 BOA ESPERANCA",2,0,3,180,0,185,"2019"
"53394","320110 BOM JESUS DO NORTE",0,0,0,87,0,87,"2019"
"53395","320115 BREJETUBA",0,0,7,234,0,241,"2019"
"53396","320120 CACHOEIRO DE ITAPEMIRIM",4,10,43,2518,4,2579,"2019"
"53397","320130 CARIACICA",14,12,57,5522,45,5650,"2019"
"53398","320140 CASTELO",2,4,3,425,1,435,"2019"
"53399","320150 COLATINA",5,4,23,1541,2,1575,"2019"
"53400","320160 CONCEICAO DA BARRA",1,1,1,396,7,406,"2019"
"53401","320170 CONCEICAO DO CASTELO",0,0,2,178,0,180,"2019"
"53402","320180 DIVINO DE SAO LOURENCO",0,2,0,56,0,58,"2019"
"53403","320190 DOMINGOS MARTINS",0,1,7,493,4,505,"2019"
"53404","320200 DORES DO RIO PRETO",0,1,2,81,0,84,"2019"
"53405","320210 ECOPORANGA",0,2,7,276,2,287,"2019"
"53406","320220 FUNDAO",0,0,0,264,3,267,"2019"
"53407","320225 GOVERNADOR LINDENBERG",1,1,2,129,0,133,"2019"
"53408","320230 GUACUI",1,4,15,396,2,418,"2019"
"53409","320240 GUARAPARI",2,3,31,1742,11,1789,"2019"
"53410","320245 IBATIBA",1,0,4,387,5,397,"2019"
"53411","320250 IBIRACU",0,1,3,186,0,190,"2019"
"53412","320255 IBITIRAMA",0,0,1,135,1,137,"2019"
"53413","320260 ICONHA",0,0,1,134,0,135,"2019"
"53414","320265 IRUPI",0,0,2,213,3,218,"2019"
"53415","320270 ITAGUACU",1,0,3,135,1,140,"2019"
"53416","320280 ITAPEMIRIM",1,1,10,606,2,620,"2019"
"53417","320290 ITARANA",0,0,1,110,1,112,"2019"
"53418","320300 IUNA",0,2,2,365,12,381,"2019"
"53419","320305 JAGUARE",1,3,11,461,0,476,"2019"
"53420","320310 JERONIMO MONTEIRO",0,1,2,140,1,144,"2019"
"53421","320313 JOAO NEIVA",1,0,1,169,0,171,"2019"
"53422","320316 LARANJA DA TERRA",0,1,1,116,0,118,"2019"
"53423","320320 LINHARES",10,8,36,2446,18,2518,"2019"
"53424","320330 MANTENOPOLIS",0,1,1,161,0,163,"2019"
"53425","320332 MARATAIZES",0,2,5,566,1,574,"2019"
"53426","320334 MARECHAL FLORIANO",0,0,5,219,1,225,"2019"
"53427","320335 MARILANDIA",1,0,5,165,0,171,"2019"
"53428","320340 MIMOSO DO SUL",2,0,2,273,3,280,"2019"
"53429","320350 MONTANHA",3,1,9,255,1,269,"2019"
"53430","320360 MUCURICI",1,0,1,68,2,72,"2019"
"53431","320370 MUNIZ FREIRE",0,0,4,258,2,264,"2019"
"53432","320380 MUQUI",1,0,4,162,2,169,"2019"
"53433","320390 NOVA VENECIA",1,4,5,714,0,724,"2019"
"53434","320400 PANCAS",0,1,5,232,0,238,"2019"
"53435","320405 PEDRO CANARIO",0,4,2,373,1,380,"2019"
"53436","320410 PINHEIROS",0,0,4,338,31,373,"2019"
"53437","320420 PIUMA",1,1,5,332,0,339,"2019"
"53438","320425 PONTO BELO",0,0,2,73,2,77,"2019"
"53439","320430 PRESIDENTE KENNEDY",0,2,4,213,2,221,"2019"
"53440","320435 RIO BANANAL",1,0,4,286,3,294,"2019"
"53441","320440 RIO NOVO DO SUL",0,0,2,155,0,157,"2019"
"53442","320450 SANTA LEOPOLDINA",0,0,1,112,0,113,"2019"
"53443","320455 SANTA MARIA DE JETIBA",0,2,5,679,1,687,"2019"
"53444","320460 SANTA TERESA",0,0,6,292,0,298,"2019"
"53445","320465 SAO DOMINGOS DO NORTE",1,0,1,109,1,112,"2019"
"53446","320470 SAO GABRIEL DA PALHA",0,2,5,404,2,413,"2019"
"53447","320480 SAO JOSE DO CALCADO",0,0,0,128,0,128,"2019"
"53448","320490 SAO MATEUS",5,4,21,1775,8,1813,"2019"
"53449","320495 SAO ROQUE DO CANAA",0,0,5,103,1,109,"2019"
"53450","320500 SERRA",40,26,100,7464,36,7666,"2019"
"53451","320501 SOORETAMA",5,2,7,429,1,444,"2019"
"53452","320503 VARGEM ALTA",0,2,7,266,3,278,"2019"
"53453","320506 VENDA NOVA DO IMIGRANTE",1,0,3,355,1,360,"2019"
"53454","320510 VIANA",3,1,19,1045,5,1073,"2019"
"53455","320515 VILA PAVAO",0,2,1,92,1,96,"2019"
"53456","320517 VILA VALERIO",1,1,1,225,1,229,"2019"
"53457","320520 VILA VELHA",20,15,86,6343,38,6502,"2019"
"53458","320530 VITORIA",18,4,54,4387,20,4483,"2019"
"53459","MUNICIPIO IGNORADO - RJ",1,0,0,16,6,23,"2019"
"53460","330010 ANGRA DOS REIS",5,7,73,2231,21,2337,"2019"
"53461","330015 APERIBE",0,1,2,135,0,138,"2019"
"53462","330020 ARARUAMA",5,9,36,1540,22,1612,"2019"
"53463","330022 AREAL",1,2,3,147,1,154,"2019"
"53464","330023 ARMACAO DOS BUZIOS",4,2,13,692,11,722,"2019"
"53465","330025 ARRAIAL DO CABO",3,4,10,392,42,451,"2019"
"53466","330030 BARRA DO PIRAI",0,4,18,1014,4,1040,"2019"
"53467","330040 BARRA MANSA",7,22,40,1960,4,2033,"2019"
"53468","330045 BELFORD ROXO",12,26,126,6196,91,6451,"2019"
"53469","330050 BOM JARDIM",0,1,3,341,1,346,"2019"
"53470","330060 BOM JESUS DO ITABAPOANA",3,2,5,513,2,525,"2019"
"53471","330070 CABO FRIO",9,14,48,2573,7,2651,"2019"
"53472","330080 CACHOEIRAS DE MACACU",0,5,21,673,13,712,"2019"
"53473","330090 CAMBUCI",1,0,1,155,0,157,"2019"
"53474","330093 CARAPEBUS",0,0,2,139,0,141,"2019"
"53475","330095 COMENDADOR LEVY GASPARIAN",0,1,1,111,0,113,"2019"
"53476","330100 CAMPOS DOS GOYTACAZES",20,28,121,6958,39,7166,"2019"
"53477","330110 CANTAGALO",1,1,2,202,3,209,"2019"
"53478","330115 CARDOSO MOREIRA",0,1,2,119,1,123,"2019"
"53479","330120 CARMO",2,0,1,202,1,206,"2019"
"53480","330130 CASIMIRO DE ABREU",1,0,7,575,1,584,"2019"
"53481","330140 CONCEICAO DE MACABU",0,2,7,238,3,250,"2019"
"53482","330150 CORDEIRO",1,2,3,230,0,236,"2019"
"53483","330160 DUAS BARRAS",0,0,2,137,0,139,"2019"
"53484","330170 DUQUE DE CAXIAS",11,56,281,11813,96,12257,"2019"
"53485","330180 ENGENHEIRO PAULO DE FRONTIN",0,1,3,137,1,142,"2019"
"53486","330185 GUAPIMIRIM",1,2,14,668,5,690,"2019"
"53487","330187 IGUABA GRANDE",1,3,6,353,2,365,"2019"
"53488","330190 ITABORAI",10,7,46,2767,20,2850,"2019"
"53489","330200 ITAGUAI",6,9,39,1676,12,1742,"2019"
"53490","330205 ITALVA",1,0,2,167,2,172,"2019"
"53491","330210 ITAOCARA",0,2,1,274,2,279,"2019"
"53492","330220 ITAPERUNA",1,9,25,1203,4,1242,"2019"
"53493","330225 ITATIAIA",1,3,12,367,2,385,"2019"
"53494","330227 JAPERI",2,9,26,1211,27,1275,"2019"
"53495","330230 LAJE DO MURIAE",1,0,2,67,0,70,"2019"
"53496","330240 MACAE",3,10,51,3600,20,3684,"2019"
"53497","330245 MACUCO",0,0,1,112,0,113,"2019"
"53498","330250 MAGE",6,13,50,3417,9,3495,"2019"
"53499","330260 MANGARATIBA",1,4,7,519,2,533,"2019"
"53500","330270 MARICA",6,9,31,1421,559,2026,"2019"
"53501","330280 MENDES",0,0,0,195,2,197,"2019"
"53502","330285 MESQUITA",7,13,33,2195,26,2274,"2019"
"53503","330290 MIGUEL PEREIRA",2,1,7,329,6,345,"2019"
"53504","330300 MIRACEMA",0,3,2,382,0,387,"2019"
"53505","330310 NATIVIDADE",1,1,6,165,0,173,"2019"
"53506","330320 NILOPOLIS",2,11,34,1659,19,1725,"2019"
"53507","330330 NITEROI",13,20,78,5874,26,6011,"2019"
"53508","330340 NOVA FRIBURGO",2,3,35,2105,12,2157,"2019"
"53509","330350 NOVA IGUACU",19,73,222,11043,133,11490,"2019"
"53510","330360 PARACAMBI",0,2,3,476,4,485,"2019"
"53511","330370 PARAIBA DO SUL",3,6,8,510,4,531,"2019"
"53512","330380 PARATY",1,1,12,626,8,648,"2019"
"53513","330385 PATY DO ALFERES",0,1,12,364,6,383,"2019"
"53514","330390 PETROPOLIS",8,18,72,3694,40,3832,"2019"
"53515","330395 PINHEIRAL",1,2,4,328,0,335,"2019"
"53516","330400 PIRAI",0,0,5,371,1,377,"2019"
"53517","330410 PORCIUNCULA",1,0,2,242,0,245,"2019"
"53518","330411 PORTO REAL",0,0,5,243,0,248,"2019"
"53519","330412 QUATIS",0,2,2,160,0,164,"2019"
"53520","330414 QUEIMADOS",2,13,38,1997,38,2088,"2019"
"53521","330415 QUISSAMA",0,2,8,299,0,309,"2019"
"53522","330420 RESENDE",2,3,33,1619,2,1659,"2019"
"53523","330430 RIO BONITO",3,2,9,741,0,755,"2019"
"53524","330440 RIO CLARO",0,0,6,212,0,218,"2019"
"53525","330450 RIO DAS FLORES",0,0,5,96,0,101,"2019"
"53526","330452 RIO DAS OSTRAS",4,4,47,1979,10,2044,"2019"
"53527","330455 RIO DE JANEIRO",154,297,1231,74337,784,76803,"2019"
"53528","330460 SANTA MARIA MADALENA",0,2,5,101,1,109,"2019"
"53529","330470 SANTO ANTONIO DE PADUA",3,4,5,448,0,460,"2019"
"53530","330475 SAO FRANCISCO DE ITABAPOANA",1,3,8,615,8,635,"2019"
"53531","330480 SAO FIDELIS",2,2,9,368,41,422,"2019"
"53532","330490 SAO GONCALO",30,43,133,10206,20,10432,"2019"
"53533","330500 SAO JOAO DA BARRA",3,4,3,522,4,536,"2019"
"53534","330510 SAO JOAO DE MERITI",16,24,107,5589,57,5793,"2019"
"53535","330513 SAO JOSE DE UBA",0,0,1,100,0,101,"2019"
"53536","330515 SAO JOSE DO VALE DO RIO PRETO",1,2,4,295,3,305,"2019"
"53537","330520 SAO PEDRO DA ALDEIA",8,14,47,1741,22,1832,"2019"
"53538","330530 SAO SEBASTIAO DO ALTO",0,0,1,97,1,99,"2019"
"53539","330540 SAPUCAIA",0,1,1,184,1,187,"2019"
"53540","330550 SAQUAREMA",3,7,23,1210,9,1252,"2019"
"53541","330555 SEROPEDICA",0,3,24,1098,10,1135,"2019"
"53542","330560 SILVA JARDIM",3,0,0,268,0,271,"2019"
"53543","330570 SUMIDOURO",0,0,2,244,1,247,"2019"
"53544","330575 TANGUA",3,1,8,433,3,448,"2019"
"53545","330580 TERESOPOLIS",4,12,38,2101,13,2168,"2019"
"53546","330590 TRAJANO DE MORAES",2,0,0,105,0,107,"2019"
"53547","330600 TRES RIOS",0,1,19,1024,7,1051,"2019"
"53548","330610 VALENCA",1,7,24,799,5,836,"2019"
"53549","330615 VARRE-SAI",1,1,1,149,0,152,"2019"
"53550","330620 VASSOURAS",3,1,7,480,1,492,"2019"
"53551","330630 VOLTA REDONDA",2,15,51,3016,12,3096,"2019"
"53552","MUNICIPIO IGNORADO - SP",0,0,1,4,3,8,"2019"
"53553","350010 ADAMANTINA",0,0,4,389,0,393,"2019"
"53554","350020 ADOLFO",0,0,0,41,0,41,"2019"
"53555","350030 AGUAI",2,0,1,415,2,420,"2019"
"53556","350040 AGUAS DA PRATA",0,1,1,50,0,52,"2019"
"53557","350050 AGUAS DE LINDOIA",0,2,3,253,0,258,"2019"
"53558","350055 AGUAS DE SANTA BARBARA",0,0,0,68,0,68,"2019"
"53559","350060 AGUAS DE SAO PEDRO",0,0,0,19,0,19,"2019"
"53560","350070 AGUDOS",1,0,4,525,0,530,"2019"
"53561","350075 ALAMBARI",0,0,2,78,0,80,"2019"
"53562","350080 ALFREDO MARCONDES",2,0,0,42,0,44,"2019"
"53563","350090 ALTAIR",0,0,1,43,1,45,"2019"
"53564","350100 ALTINOPOLIS",0,1,1,194,1,197,"2019"
"53565","350110 ALTO ALEGRE",0,2,1,31,0,34,"2019"
"53566","350115 ALUMINIO",0,0,6,237,0,243,"2019"
"53567","350120 ALVARES FLORENCE",0,0,0,32,0,32,"2019"
"53568","350130 ALVARES MACHADO",1,0,3,322,0,326,"2019"
"53569","350140 ALVARO DE CARVALHO",0,0,1,51,0,52,"2019"
"53570","350150 ALVINLANDIA",0,2,2,40,0,44,"2019"
"53571","350160 AMERICANA",6,9,31,2590,6,2642,"2019"
"53572","350170 AMERICO BRASILIENSE",1,5,6,446,1,459,"2019"
"53573","350180 AMERICO DE CAMPOS",0,0,0,58,0,58,"2019"
"53574","350190 AMPARO",1,1,12,819,1,834,"2019"
"53575","350200 ANALANDIA",0,0,1,37,1,39,"2019"
"53576","350210 ANDRADINA",2,0,6,658,1,667,"2019"
"53577","350220 ANGATUBA",2,1,2,301,1,307,"2019"
"53578","350230 ANHEMBI",0,1,6,75,0,82,"2019"
"53579","350240 ANHUMAS",0,0,1,50,0,51,"2019"
"53580","350250 APARECIDA",0,0,4,406,7,417,"2019"
"53581","350260 APARECIDA D'OESTE",0,0,0,40,0,40,"2019"
"53582","350270 APIAI",0,4,4,324,1,333,"2019"
"53583","350275 ARACARIGUAMA",0,2,4,379,0,385,"2019"
"53584","350280 ARACATUBA",2,11,19,2362,0,2394,"2019"
"53585","350290 ARACOIABA DA SERRA",2,1,8,359,1,371,"2019"
"53586","350300 ARAMINA",0,0,1,63,0,64,"2019"
"53587","350310 ARANDU",1,2,2,85,0,90,"2019"
"53588","350315 ARAPEI",0,0,0,12,0,12,"2019"
"53589","350320 ARARAQUARA",4,7,20,2562,5,2598,"2019"
"53590","350330 ARARAS",3,6,14,1529,2,1554,"2019"
"53591","350335 ARCO-IRIS",0,0,0,19,0,19,"2019"
"53592","350340 AREALVA",0,0,0,76,1,77,"2019"
"53593","350350 AREIAS",0,1,1,37,0,39,"2019"
"53594","350360 AREIOPOLIS",0,0,3,117,0,120,"2019"
"53595","350370 ARIRANHA",0,0,1,84,1,86,"2019"
"53596","350380 ARTUR NOGUEIRA",1,2,7,595,1,606,"2019"
"53597","350390 ARUJA",3,6,30,1347,3,1389,"2019"
"53598","350395 ASPASIA",0,0,0,21,0,21,"2019"
"53599","350400 ASSIS",4,1,6,1192,0,1203,"2019"
"53600","350410 ATIBAIA",4,5,17,2058,5,2089,"2019"
"53601","350420 AURIFLAMA",0,1,0,152,0,153,"2019"
"53602","350430 AVAI",0,0,0,56,2,58,"2019"
"53603","350440 AVANHANDAVA",1,0,1,124,1,127,"2019"
"53604","350450 AVARE",6,3,3,1163,10,1185,"2019"
"53605","350460 BADY BASSITT",1,0,4,302,0,307,"2019"
"53606","350470 BALBINOS",0,0,1,7,0,8,"2019"
"53607","350480 BALSAMO",1,1,1,89,1,93,"2019"
"53608","350490 BANANAL",0,0,0,88,0,88,"2019"
"53609","350500 BARAO DE ANTONINA",1,0,0,28,1,30,"2019"
"53610","350510 BARBOSA",0,0,1,82,0,83,"2019"
"53611","350520 BARIRI",0,2,2,398,1,403,"2019"
"53612","350530 BARRA BONITA",0,1,1,308,1,311,"2019"
"53613","350535 BARRA DO CHAPEU",0,0,2,71,1,74,"2019"
"53614","350540 BARRA DO TURVO",0,0,1,87,0,88,"2019"
"53615","350550 BARRETOS",5,2,15,1412,1,1435,"2019"
"53616","350560 BARRINHA",1,1,6,418,2,428,"2019"
"53617","350570 BARUERI",12,15,78,5612,12,5729,"2019"
"53618","350580 BASTOS",3,3,4,288,0,298,"2019"
"53619","350590 BATATAIS",3,1,6,719,17,746,"2019"
"53620","350600 BAURU",9,16,58,4470,29,4582,"2019"
"53621","350610 BEBEDOURO",1,0,3,914,0,918,"2019"
"53622","350620 BENTO DE ABREU",0,0,0,34,0,34,"2019"
"53623","350630 BERNARDINO DE CAMPOS",0,1,0,149,0,150,"2019"
"53624","350635 BERTIOGA",2,2,17,942,0,963,"2019"
"53625","350640 BILAC",0,0,0,83,0,83,"2019"
"53626","350650 BIRIGUI",1,5,13,1383,0,1402,"2019"
"53627","350660 BIRITIBA-MIRIM",1,0,4,394,7,406,"2019"
"53628","350670 BOA ESPERANCA DO SUL",2,0,3,163,1,169,"2019"
"53629","350680 BOCAINA",0,0,1,124,2,127,"2019"
"53630","350690 BOFETE",0,1,3,115,2,121,"2019"
"53631","350700 BOITUVA",2,2,10,741,1,756,"2019"
"53632","350710 BOM JESUS DOS PERDOES",0,0,5,316,1,322,"2019"
"53633","350715 BOM SUCESSO DE ITARARE",1,0,2,62,1,66,"2019"
"53634","350720 BORA",0,0,0,12,0,12,"2019"
"53635","350730 BORACEIA",3,0,0,62,0,65,"2019"
"53636","350740 BORBOREMA",1,0,1,137,0,139,"2019"
"53637","350745 BOREBI",0,0,0,22,0,22,"2019"
"53638","350750 BOTUCATU",4,12,48,1653,5,1722,"2019"
"53639","350760 BRAGANCA PAULISTA",0,4,15,2094,3,2116,"2019"
"53640","350770 BRAUNA",0,0,1,64,0,65,"2019"
"53641","350775 BREJO ALEGRE",0,0,1,26,0,27,"2019"
"53642","350780 BRODOWSKI",1,4,4,300,2,311,"2019"
"53643","350790 BROTAS",2,0,3,294,1,300,"2019"
"53644","350800 BURI",3,3,14,277,4,301,"2019"
"53645","350810 BURITAMA",0,1,3,198,0,202,"2019"
"53646","350820 BURITIZAL",0,0,0,48,0,48,"2019"
"53647","350830 CABRALIA PAULISTA",0,0,0,56,0,56,"2019"
"53648","350840 CABREUVA",1,3,19,691,0,714,"2019"
"53649","350850 CACAPAVA",2,0,11,1228,1,1242,"2019"
"53650","350860 CACHOEIRA PAULISTA",1,1,5,367,13,387,"2019"
"53651","350870 CACONDE",1,2,4,194,0,201,"2019"
"53652","350880 CAFELANDIA",0,2,2,241,0,245,"2019"
"53653","350890 CAIABU",0,0,0,38,0,38,"2019"
"53654","350900 CAIEIRAS",1,3,15,1348,0,1367,"2019"
"53655","350910 CAIUA",0,0,0,43,0,43,"2019"
"53656","350920 CAJAMAR",1,3,11,1317,0,1332,"2019"
"53657","350925 CAJATI",0,2,4,425,0,431,"2019"
"53658","350930 CAJOBI",1,0,3,110,0,114,"2019"
"53659","350940 CAJURU",0,0,3,321,0,324,"2019"
"53660","350945 CAMPINA DO MONTE ALEGRE",0,0,0,66,0,66,"2019"
"53661","350950 CAMPINAS",53,44,127,14284,75,14583,"2019"
"53662","350960 CAMPO LIMPO PAULISTA",2,4,16,921,0,943,"2019"
"53663","350970 CAMPOS DO JORDAO",3,2,4,714,1,724,"2019"
"53664","350980 CAMPOS NOVOS PAULISTA",2,0,2,60,0,64,"2019"
"53665","350990 CANANEIA",0,1,1,172,0,174,"2019"
"53666","350995 CANAS",0,0,0,67,5,72,"2019"
"53667","351000 CANDIDO MOTA",1,2,2,333,0,338,"2019"
"53668","351010 CANDIDO RODRIGUES",0,0,0,30,0,30,"2019"
"53669","351015 CANITAR",0,0,0,73,0,73,"2019"
"53670","351020 CAPAO BONITO",0,0,4,634,0,638,"2019"
"53671","351030 CAPELA DO ALTO",0,0,4,239,0,243,"2019"
"53672","351040 CAPIVARI",1,2,9,648,24,684,"2019"
"53673","351050 CARAGUATATUBA",6,3,17,1682,6,1714,"2019"
"53674","351060 CARAPICUIBA",12,23,78,6417,31,6561,"2019"
"53675","351070 CARDOSO",1,0,4,97,1,103,"2019"
"53676","351080 CASA BRANCA",0,1,7,286,2,296,"2019"
"53677","351090 CASSIA DOS COQUEIROS",0,0,1,20,0,21,"2019"
"53678","351100 CASTILHO",1,3,3,249,1,257,"2019"
"53679","351110 CATANDUVA",2,2,16,1308,1,1329,"2019"
"53680","351120 CATIGUA",0,1,1,62,0,64,"2019"
"53681","351130 CEDRAL",0,0,2,115,1,118,"2019"
"53682","351140 CERQUEIRA CESAR",0,1,1,265,0,267,"2019"
"53683","351150 CERQUILHO",0,2,8,498,0,508,"2019"
"53684","351160 CESARIO LANGE",1,2,5,225,0,233,"2019"
"53685","351170 CHARQUEADA",0,0,1,174,0,175,"2019"
"53686","351190 CLEMENTINA",0,1,1,96,0,98,"2019"
"53687","351200 COLINA",0,2,1,198,0,201,"2019"
"53688","351210 COLOMBIA",0,1,0,89,0,90,"2019"
"53689","351220 CONCHAL",1,4,7,435,0,447,"2019"
"53690","351230 CONCHAS",2,1,7,199,0,209,"2019"
"53691","351240 CORDEIROPOLIS",0,1,1,288,0,290,"2019"
"53692","351250 COROADOS",0,1,0,53,0,54,"2019"
"53693","351260 CORONEL MACEDO",0,1,0,51,0,52,"2019"
"53694","351270 CORUMBATAI",1,0,1,56,0,58,"2019"
"53695","351280 COSMOPOLIS",6,2,10,634,1,653,"2019"
"53696","351290 COSMORAMA",0,0,0,93,1,94,"2019"
"53697","351300 COTIA",13,11,33,4121,11,4189,"2019"
"53698","351310 CRAVINHOS",1,2,3,393,1,400,"2019"
"53699","351320 CRISTAIS PAULISTA",1,0,1,112,1,115,"2019"
"53700","351330 CRUZALIA",0,0,0,14,0,14,"2019"
"53701","351340 CRUZEIRO",3,6,15,850,11,885,"2019"
"53702","351350 CUBATAO",5,6,21,1453,4,1489,"2019"
"53703","351360 CUNHA",0,0,3,257,2,262,"2019"
"53704","351370 DESCALVADO",0,2,0,339,0,341,"2019"
"53705","351380 DIADEMA",11,22,81,5279,19,5412,"2019"
"53706","351385 DIRCE REIS",0,0,0,15,0,15,"2019"
"53707","351390 DIVINOLANDIA",0,0,1,138,0,139,"2019"
"53708","351400 DOBRADA",0,1,0,98,0,99,"2019"
"53709","351410 DOIS CORREGOS",0,0,1,300,2,303,"2019"
"53710","351420 DOLCINOPOLIS",0,0,0,22,0,22,"2019"
"53711","351430 DOURADO",0,0,0,90,0,90,"2019"
"53712","351440 DRACENA",2,0,3,491,0,496,"2019"
"53713","351450 DUARTINA",0,1,1,148,0,150,"2019"
"53714","351460 DUMONT",0,1,2,104,1,108,"2019"
"53715","351470 ECHAPORA",0,0,0,81,0,81,"2019"
"53716","351480 ELDORADO",0,0,1,181,1,183,"2019"
"53717","351490 ELIAS FAUSTO",0,0,2,193,9,204,"2019"
"53718","351492 ELISIARIO",0,0,0,35,0,35,"2019"
"53719","351495 EMBAUBA",0,0,1,22,0,23,"2019"
"53720","351500 EMBU DAS ARTES",12,10,30,3957,15,4024,"2019"
"53721","351510 EMBU-GUACU",0,3,15,835,4,857,"2019"
"53722","351512 EMILIANOPOLIS",0,1,0,32,0,33,"2019"
"53723","351515 ENGENHEIRO COELHO",0,1,3,257,0,261,"2019"
"53724","351518 ESPIRITO SANTO DO PINHAL",2,1,6,432,0,441,"2019"
"53725","351519 ESPIRITO SANTO DO TURVO",0,0,0,75,1,76,"2019"
"53726","351520 ESTRELA D'OESTE",1,0,0,94,0,95,"2019"
"53727","351530 ESTRELA DO NORTE",0,0,0,42,0,42,"2019"
"53728","351535 EUCLIDES DA CUNHA PAULISTA",0,0,2,100,0,102,"2019"
"53729","351540 FARTURA",0,1,3,221,1,226,"2019"
"53730","351550 FERNANDOPOLIS",1,2,8,743,0,754,"2019"
"53731","351560 FERNANDO PRESTES",0,0,1,47,0,48,"2019"
"53732","351565 FERNAO",0,1,0,14,0,15,"2019"
"53733","351570 FERRAZ DE VASCONCELOS",5,11,30,2715,16,2777,"2019"
"53734","351580 FLORA RICA",0,1,0,14,0,15,"2019"
"53735","351590 FLOREAL",0,0,0,14,0,14,"2019"
"53736","351600 FLORIDA PAULISTA",0,0,2,110,0,112,"2019"
"53737","351610 FLORINIA",0,0,0,31,0,31,"2019"
"53738","351620 FRANCA",8,17,72,4549,11,4657,"2019"
"53739","351630 FRANCISCO MORATO",7,13,27,2771,20,2838,"2019"
"53740","351640 FRANCO DA ROCHA",3,3,16,2129,9,2160,"2019"
"53741","351650 GABRIEL MONTEIRO",0,0,0,22,0,22,"2019"
"53742","351660 GALIA",1,0,2,59,2,64,"2019"
"53743","351670 GARCA",3,2,17,492,2,516,"2019"
"53744","351680 GASTAO VIDIGAL",0,0,0,29,0,29,"2019"
"53745","351685 GAVIAO PEIXOTO",0,0,0,77,1,78,"2019"
"53746","351690 GENERAL SALGADO",0,1,1,91,0,93,"2019"
"53747","351700 GETULINA",1,1,2,87,0,91,"2019"
"53748","351710 GLICERIO",0,0,0,51,0,51,"2019"
"53749","351720 GUAICARA",0,0,3,139,0,142,"2019"
"53750","351730 GUAIMBE",0,1,1,70,0,72,"2019"
"53751","351740 GUAIRA",2,2,4,478,1,487,"2019"
"53752","351750 GUAPIACU",0,0,2,236,0,238,"2019"
"53753","351760 GUAPIARA",0,3,5,239,1,248,"2019"
"53754","351770 GUARA",0,0,6,213,0,219,"2019"
"53755","351780 GUARACAI",0,0,0,75,0,75,"2019"
"53756","351790 GUARACI",0,0,1,113,0,114,"2019"
"53757","351800 GUARANI D'OESTE",0,0,0,24,0,24,"2019"
"53758","351810 GUARANTA",0,0,1,62,0,63,"2019"
"53759","351820 GUARARAPES",0,2,5,350,0,357,"2019"
"53760","351830 GUARAREMA",0,1,4,407,0,412,"2019"
"53761","351840 GUARATINGUETA",5,13,17,1526,6,1567,"2019"
"53762","351850 GUAREI",0,2,2,154,0,158,"2019"
"53763","351860 GUARIBA",0,5,10,460,5,480,"2019"
"53764","351870 GUARUJA",13,17,62,4037,10,4139,"2019"
"53765","351880 GUARULHOS",49,79,265,20015,71,20479,"2019"
"53766","351885 GUATAPARA",0,1,1,102,0,104,"2019"
"53767","351890 GUZOLANDIA",0,0,1,48,0,49,"2019"
"53768","351900 HERCULANDIA",2,1,1,112,0,116,"2019"
"53769","351905 HOLAMBRA",0,0,4,181,0,185,"2019"
"53770","351907 HORTOLANDIA",8,6,21,2912,7,2954,"2019"
"53771","351910 IACANGA",0,0,0,154,0,154,"2019"
"53772","351920 IACRI",0,1,0,62,0,63,"2019"
"53773","351925 IARAS",0,1,1,74,1,77,"2019"
"53774","351930 IBATE",2,3,4,503,2,514,"2019"
"53775","351940 IBIRA",0,2,2,137,0,141,"2019"
"53776","351950 IBIRAREMA",0,1,1,58,0,60,"2019"
"53777","351960 IBITINGA",1,1,2,747,6,757,"2019"
"53778","351970 IBIUNA",4,6,11,1028,1,1050,"2019"
"53779","351980 ICEM",0,0,2,87,0,89,"2019"
"53780","351990 IEPE",0,0,0,77,0,77,"2019"
"53781","352000 IGARACU DO TIETE",0,1,0,277,1,279,"2019"
"53782","352010 IGARAPAVA",2,1,2,289,0,294,"2019"
"53783","352020 IGARATA",1,1,2,132,3,139,"2019"
"53784","352030 IGUAPE",0,2,3,324,1,330,"2019"
"53785","352040 ILHABELA",2,6,15,515,3,541,"2019"
"53786","352042 ILHA COMPRIDA",2,0,0,148,0,150,"2019"
"53787","352044 ILHA SOLTEIRA",2,1,3,249,0,255,"2019"
"53788","352050 INDAIATUBA",5,10,56,3150,6,3227,"2019"
"53789","352060 INDIANA",0,0,2,54,0,56,"2019"
"53790","352070 INDIAPORA",0,0,0,34,0,34,"2019"
"53791","352080 INUBIA PAULISTA",0,1,1,23,0,25,"2019"
"53792","352090 IPAUSSU",3,5,2,176,1,187,"2019"
"53793","352100 IPERO",3,2,6,355,1,367,"2019"
"53794","352110 IPEUNA",0,0,2,79,0,81,"2019"
"53795","352115 IPIGUA",0,0,0,83,0,83,"2019"
"53796","352120 IPORANGA",0,0,1,44,0,45,"2019"
"53797","352130 IPUA",1,0,0,168,0,169,"2019"
"53798","352140 IRACEMAPOLIS",1,0,2,248,1,252,"2019"
"53799","352150 IRAPUA",0,0,1,73,0,74,"2019"
"53800","352160 IRAPURU",2,1,0,63,0,66,"2019"
"53801","352170 ITABERA",2,1,8,245,3,259,"2019"
"53802","352180 ITAI",0,1,6,317,3,327,"2019"
"53803","352190 ITAJOBI",0,0,3,225,1,229,"2019"
"53804","352200 ITAJU",0,0,1,33,1,35,"2019"
"53805","352210 ITANHAEM",3,10,22,1298,7,1340,"2019"
"53806","352215 ITAOCA",0,0,0,39,0,39,"2019"
"53807","352220 ITAPECERICA DA SERRA",3,10,37,2498,6,2554,"2019"
"53808","352230 ITAPETININGA",3,4,40,2052,1,2100,"2019"
"53809","352240 ITAPEVA",3,8,61,1389,2,1463,"2019"
"53810","352250 ITAPEVI",10,14,43,3926,8,4001,"2019"
"53811","352260 ITAPIRA",1,1,10,809,0,821,"2019"
"53812","352265 ITAPIRAPUA PAULISTA",0,0,2,71,1,74,"2019"
"53813","352270 ITAPOLIS",2,0,11,454,0,467,"2019"
"53814","352280 ITAPORANGA",1,4,1,171,0,177,"2019"
"53815","352290 ITAPUI",1,0,0,192,0,193,"2019"
"53816","352300 ITAPURA",0,0,0,49,0,49,"2019"
"53817","352310 ITAQUAQUECETUBA",15,25,73,5717,37,5867,"2019"
"53818","352320 ITARARE",1,4,11,604,1,621,"2019"
"53819","352330 ITARIRI",0,2,2,153,2,159,"2019"
"53820","352340 ITATIBA",3,2,8,1404,1,1418,"2019"
"53821","352350 ITATINGA",1,2,8,252,1,264,"2019"
"53822","352360 ITIRAPINA",0,2,1,158,0,161,"2019"
"53823","352370 ITIRAPUA",0,0,0,73,1,74,"2019"
"53824","352380 ITOBI",0,0,0,85,0,85,"2019"
"53825","352390 ITU",2,6,29,2199,12,2248,"2019"
"53826","352400 ITUPEVA",1,4,13,851,0,869,"2019"
"53827","352410 ITUVERAVA",0,1,10,423,0,434,"2019"
"53828","352420 JABORANDI",0,0,1,60,1,62,"2019"
"53829","352430 JABOTICABAL",5,7,10,744,0,766,"2019"
"53830","352440 JACAREI",7,7,43,2819,13,2889,"2019"
"53831","352450 JACI",0,0,0,94,0,94,"2019"
"53832","352460 JACUPIRANGA",0,2,2,223,1,228,"2019"
"53833","352470 JAGUARIUNA",0,3,6,766,3,778,"2019"
"53834","352480 JALES",5,1,1,522,0,529,"2019"
"53835","352490 JAMBEIRO",1,0,0,66,0,67,"2019"
"53836","352500 JANDIRA",1,3,22,1568,2,1596,"2019"
"53837","352510 JARDINOPOLIS",0,1,13,575,4,593,"2019"
"53838","352520 JARINU",3,1,7,484,0,495,"2019"
"53839","352530 JAU",4,2,9,1515,4,1534,"2019"
"53840","352540 JERIQUARA",0,0,0,27,0,27,"2019"
"53841","352550 JOANOPOLIS",0,0,1,154,0,155,"2019"
"53842","352560 JOAO RAMALHO",0,0,0,49,0,49,"2019"
"53843","352570 JOSE BONIFACIO",2,1,5,441,0,449,"2019"
"53844","352580 JULIO MESQUITA",0,0,0,63,0,63,"2019"
"53845","352585 JUMIRIM",0,0,1,39,0,40,"2019"
"53846","352590 JUNDIAI",12,27,70,6025,10,6144,"2019"
"53847","352600 JUNQUEIROPOLIS",1,0,0,232,2,235,"2019"
"53848","352610 JUQUIA",0,2,4,275,0,281,"2019"
"53849","352620 JUQUITIBA",0,2,7,438,5,452,"2019"
"53850","352630 LAGOINHA",0,0,1,52,2,55,"2019"
"53851","352640 LARANJAL PAULISTA",1,1,3,357,0,362,"2019"
"53852","352650 LAVINIA",0,0,0,45,0,45,"2019"
"53853","352660 LAVRINHAS",0,1,4,77,0,82,"2019"
"53854","352670 LEME",1,4,7,1108,5,1125,"2019"
"53855","352680 LENCOIS PAULISTA",1,5,36,769,3,814,"2019"
"53856","352690 LIMEIRA",10,6,30,3448,5,3499,"2019"
"53857","352700 LINDOIA",0,0,0,73,0,73,"2019"
"53858","352710 LINS",3,5,6,891,0,905,"2019"
"53859","352720 LORENA",4,7,11,1053,23,1098,"2019"
"53860","352725 LOURDES",1,0,0,12,0,13,"2019"
"53861","352730 LOUVEIRA",0,3,18,786,1,808,"2019"
"53862","352740 LUCELIA",0,0,6,197,0,203,"2019"
"53863","352750 LUCIANOPOLIS",0,0,0,25,0,25,"2019"
"53864","352760 LUIS ANTONIO",0,0,1,152,1,154,"2019"
"53865","352770 LUIZIANIA",0,0,1,55,0,56,"2019"
"53866","352780 LUPERCIO",0,0,2,41,0,43,"2019"
"53867","352790 LUTECIA",0,0,1,35,0,36,"2019"
"53868","352800 MACATUBA",1,1,5,194,0,201,"2019"
"53869","352810 MACAUBAL",2,0,0,77,0,79,"2019"
"53870","352820 MACEDONIA",0,0,0,39,0,39,"2019"
"53871","352830 MAGDA",0,0,0,29,0,29,"2019"
"53872","352840 MAIRINQUE",2,2,13,667,1,685,"2019"
"53873","352850 MAIRIPORA",0,1,14,1005,0,1020,"2019"
"53874","352860 MANDURI",0,1,1,111,2,115,"2019"
"53875","352870 MARABA PAULISTA",0,0,0,39,0,39,"2019"
"53876","352880 MARACAI",0,0,1,142,1,144,"2019"
"53877","352885 MARAPOAMA",0,0,0,31,0,31,"2019"
"53878","352890 MARIAPOLIS",0,0,0,43,0,43,"2019"
"53879","352900 MARILIA",7,17,56,2962,9,3051,"2019"
"53880","352910 MARINOPOLIS",1,0,0,13,0,14,"2019"
"53881","352920 MARTINOPOLIS",1,1,6,302,1,311,"2019"
"53882","352930 MATAO",3,6,8,925,1,943,"2019"
"53883","352940 MAUA",6,13,54,4993,25,5091,"2019"
"53884","352950 MENDONCA",0,0,0,82,0,82,"2019"
"53885","352960 MERIDIANO",0,0,0,35,0,35,"2019"
"53886","352965 MESOPOLIS",0,0,1,31,0,32,"2019"
"53887","352970 MIGUELOPOLIS",1,0,1,226,0,228,"2019"
"53888","352980 MINEIROS DO TIETE",1,0,1,146,5,153,"2019"
"53889","352990 MIRACATU",1,2,4,300,0,307,"2019"
"53890","353000 MIRA ESTRELA",0,0,0,26,0,26,"2019"
"53891","353010 MIRANDOPOLIS",0,0,5,234,0,239,"2019"
"53892","353020 MIRANTE DO PARANAPANEMA",0,0,1,173,0,174,"2019"
"53893","353030 MIRASSOL",2,3,8,719,0,732,"2019"
"53894","353040 MIRASSOLANDIA",0,0,0,62,0,62,"2019"
"53895","353050 MOCOCA",3,2,9,733,3,750,"2019"
"53896","353060 MOGI DAS CRUZES",6,19,62,6249,34,6370,"2019"
"53897","353070 MOGI GUACU",6,9,32,1867,0,1914,"2019"
"53898","353080 MOGI MIRIM",0,1,7,1030,5,1043,"2019"
"53899","353090 MOMBUCA",0,0,0,48,2,50,"2019"
"53900","353100 MONCOES",0,0,0,21,0,21,"2019"
"53901","353110 MONGAGUA",1,4,18,697,0,720,"2019"
"53902","353120 MONTE ALEGRE DO SUL",0,0,0,86,0,86,"2019"
"53903","353130 MONTE ALTO",1,0,4,565,0,570,"2019"
"53904","353140 MONTE APRAZIVEL",0,0,0,241,0,241,"2019"
"53905","353150 MONTE AZUL PAULISTA",0,0,0,217,0,217,"2019"
"53906","353160 MONTE CASTELO",0,1,0,56,0,57,"2019"
"53907","353170 MONTEIRO LOBATO",0,0,1,33,0,34,"2019"
"53908","353180 MONTE MOR",4,2,7,949,2,964,"2019"
"53909","353190 MORRO AGUDO",0,1,6,374,0,381,"2019"
"53910","353200 MORUNGABA",1,2,0,153,0,156,"2019"
"53911","353205 MOTUCA",0,0,0,52,0,52,"2019"
"53912","353210 MURUTINGA DO SUL",0,0,0,27,0,27,"2019"
"53913","353215 NANTES",0,0,0,39,0,39,"2019"
"53914","353220 NARANDIBA",0,0,1,78,1,80,"2019"
"53915","353230 NATIVIDADE DA SERRA",0,0,1,54,0,55,"2019"
"53916","353240 NAZARE PAULISTA",0,0,1,221,1,223,"2019"
"53917","353250 NEVES PAULISTA",0,0,0,87,0,87,"2019"
"53918","353260 NHANDEARA",0,0,0,71,0,71,"2019"
"53919","353270 NIPOA",0,0,0,57,0,57,"2019"
"53920","353280 NOVA ALIANCA",1,0,0,88,0,89,"2019"
"53921","353282 NOVA CAMPINA",0,1,5,136,0,142,"2019"
"53922","353284 NOVA CANAA PAULISTA",0,0,0,18,0,18,"2019"
"53923","353286 NOVA CASTILHO",0,0,0,7,0,7,"2019"
"53924","353290 NOVA EUROPA",0,0,0,114,0,114,"2019"
"53925","353300 NOVA GRANADA",0,0,5,244,0,249,"2019"
"53926","353310 NOVA GUATAPORANGA",0,0,0,26,0,26,"2019"
"53927","353320 NOVA INDEPENDENCIA",0,0,1,59,0,60,"2019"
"53928","353325 NOVAIS",0,0,2,56,0,58,"2019"
"53929","353330 NOVA LUZITANIA",1,0,0,22,0,23,"2019"
"53930","353340 NOVA ODESSA",3,3,8,668,3,685,"2019"
"53931","353350 NOVO HORIZONTE",0,0,1,489,0,490,"2019"
"53932","353360 NUPORANGA",0,0,1,82,0,83,"2019"
"53933","353370 OCAUCU",1,0,3,67,0,71,"2019"
"53934","353380 OLEO",0,0,1,23,0,24,"2019"
"53935","353390 OLIMPIA",0,4,13,672,1,690,"2019"
"53936","353400 ONDA VERDE",0,1,0,68,0,69,"2019"
"53937","353410 ORIENTE",3,0,1,63,0,67,"2019"
"53938","353420 ORINDIUVA",0,1,1,79,1,82,"2019"
"53939","353430 ORLANDIA",1,0,2,471,0,474,"2019"
"53940","353440 OSASCO",37,33,123,9345,26,9564,"2019"
"53941","353450 OSCAR BRESSANE",0,0,1,17,0,18,"2019"
"53942","353460 OSVALDO CRUZ",0,0,3,293,0,296,"2019"
"53943","353470 OURINHOS",2,4,24,1245,7,1282,"2019"
"53944","353475 OUROESTE",0,1,1,147,0,149,"2019"
"53945","353480 OURO VERDE",0,0,1,102,0,103,"2019"
"53946","353490 PACAEMBU",0,2,1,105,0,108,"2019"
"53947","353500 PALESTINA",1,0,0,122,0,123,"2019"
"53948","353510 PALMARES PAULISTA",1,2,1,99,0,103,"2019"
"53949","353520 PALMEIRA D'OESTE",0,0,0,62,0,62,"2019"
"53950","353530 PALMITAL",0,1,0,227,0,228,"2019"
"53951","353540 PANORAMA",1,0,2,170,2,175,"2019"
"53952","353550 PARAGUACU PAULISTA",2,0,4,482,0,488,"2019"
"53953","353560 PARAIBUNA",0,0,2,176,0,178,"2019"
"53954","353570 PARAISO",0,1,1,61,0,63,"2019"
"53955","353580 PARANAPANEMA",0,1,3,248,2,254,"2019"
"53956","353590 PARANAPUA",0,0,1,48,0,49,"2019"
"53957","353600 PARAPUA",0,0,0,97,0,97,"2019"
"53958","353610 PARDINHO",0,1,3,102,1,107,"2019"
"53959","353620 PARIQUERA-ACU",1,2,1,273,1,278,"2019"
"53960","353625 PARISI",0,1,0,31,0,32,"2019"
"53961","353630 PATROCINIO PAULISTA",0,0,2,189,1,192,"2019"
"53962","353640 PAULICEIA",0,2,3,103,0,108,"2019"
"53963","353650 PAULINIA",8,6,19,1490,3,1526,"2019"
"53964","353657 PAULISTANIA",0,0,0,24,0,24,"2019"
"53965","353660 PAULO DE FARIA",0,0,1,72,1,74,"2019"
"53966","353670 PEDERNEIRAS",1,1,5,536,4,547,"2019"
"53967","353680 PEDRA BELA",1,0,1,77,1,80,"2019"
"53968","353690 PEDRANOPOLIS",0,0,0,18,0,18,"2019"
"53969","353700 PEDREGULHO",0,1,1,206,1,209,"2019"
"53970","353710 PEDREIRA",2,0,7,476,3,488,"2019"
"53971","353715 PEDRINHAS PAULISTA",0,0,0,31,0,31,"2019"
"53972","353720 PEDRO DE TOLEDO",0,0,0,107,1,108,"2019"
"53973","353730 PENAPOLIS",2,1,3,752,2,760,"2019"
"53974","353740 PEREIRA BARRETO",1,2,13,237,2,255,"2019"
"53975","353750 PEREIRAS",0,0,2,93,0,95,"2019"
"53976","353760 PERUIBE",3,4,17,915,2,941,"2019"
"53977","353770 PIACATU",0,0,0,59,0,59,"2019"
"53978","353780 PIEDADE",1,3,10,670,1,685,"2019"
"53979","353790 PILAR DO SUL",2,2,8,402,0,414,"2019"
"53980","353800 PINDAMONHANGABA",1,9,32,2256,2,2300,"2019"
"53981","353810 PINDORAMA",0,0,2,127,1,130,"2019"
"53982","353820 PINHALZINHO",0,0,0,171,1,172,"2019"
"53983","353830 PIQUEROBI",0,0,2,26,0,28,"2019"
"53984","353850 PIQUETE",1,0,2,122,5,130,"2019"
"53985","353860 PIRACAIA",0,0,4,318,0,322,"2019"
"53986","353870 PIRACICABA",7,14,50,4839,18,4928,"2019"
"53987","353880 PIRAJU",3,1,2,341,0,347,"2019"
"53988","353890 PIRAJUI",1,2,6,235,0,244,"2019"
"53989","353900 PIRANGI",0,1,3,134,1,139,"2019"
"53990","353910 PIRAPORA DO BOM JESUS",2,1,4,249,2,258,"2019"
"53991","353920 PIRAPOZINHO",0,1,5,317,0,323,"2019"
"53992","353930 PIRASSUNUNGA",2,5,7,853,1,868,"2019"
"53993","353940 PIRATININGA",0,0,4,162,0,166,"2019"
"53994","353950 PITANGUEIRAS",2,1,3,462,3,471,"2019"
"53995","353960 PLANALTO",0,0,0,51,0,51,"2019"
"53996","353970 PLATINA",0,0,0,33,0,33,"2019"
"53997","353980 POA",1,6,17,1429,3,1456,"2019"
"53998","353990 POLONI",0,0,0,66,0,66,"2019"
"53999","354000 POMPEIA",1,0,8,214,1,224,"2019"
"54000","354010 PONGAI",0,1,1,26,0,28,"2019"
"54001","354020 PONTAL",1,3,3,513,0,520,"2019"
"54002","354025 PONTALINDA",0,0,0,52,0,52,"2019"
"54003","354030 PONTES GESTAL",0,0,0,31,0,31,"2019"
"54004","354040 POPULINA",0,0,1,46,0,47,"2019"
"54005","354050 PORANGABA",0,3,2,89,0,94,"2019"
"54006","354060 PORTO FELIZ",2,3,13,678,2,698,"2019"
"54007","354070 PORTO FERREIRA",0,1,11,583,1,596,"2019"
"54008","354075 POTIM",0,0,5,217,9,231,"2019"
"54009","354080 POTIRENDABA",0,0,1,228,0,229,"2019"
"54010","354085 PRACINHA",0,0,0,7,0,7,"2019"
"54011","354090 PRADOPOLIS",1,2,3,204,1,211,"2019"
"54012","354100 PRAIA GRANDE",10,21,91,4108,15,4245,"2019"
"54013","354105 PRATANIA",0,0,1,79,0,80,"2019"
"54014","354110 PRESIDENTE ALVES",0,0,1,34,0,35,"2019"
"54015","354120 PRESIDENTE BERNARDES",0,0,1,111,0,112,"2019"
"54016","354130 PRESIDENTE EPITACIO",1,0,2,448,0,451,"2019"
"54017","354140 PRESIDENTE PRUDENTE",9,6,34,2717,4,2770,"2019"
"54018","354150 PRESIDENTE VENCESLAU",1,0,4,364,1,370,"2019"
"54019","354160 PROMISSAO",0,1,5,422,0,428,"2019"
"54020","354165 QUADRA",0,0,0,44,0,44,"2019"
"54021","354170 QUATA",0,1,3,174,0,178,"2019"
"54022","354180 QUEIROZ",0,0,0,44,0,44,"2019"
"54023","354190 QUELUZ",0,2,2,100,1,105,"2019"
"54024","354200 QUINTANA",3,0,4,82,0,89,"2019"
"54025","354210 RAFARD",0,0,1,111,2,114,"2019"
"54026","354220 RANCHARIA",1,4,2,357,0,364,"2019"
"54027","354230 REDENCAO DA SERRA",0,0,2,48,1,51,"2019"
"54028","354240 REGENTE FEIJO",1,1,0,220,1,223,"2019"
"54029","354250 REGINOPOLIS",1,0,2,40,1,44,"2019"
"54030","354260 REGISTRO",4,5,6,863,1,879,"2019"
"54031","354270 RESTINGA",2,0,2,83,0,87,"2019"
"54032","354280 RIBEIRA",0,0,0,41,0,41,"2019"
"54033","354290 RIBEIRAO BONITO",1,0,1,155,1,158,"2019"
"54034","354300 RIBEIRAO BRANCO",4,0,11,271,1,287,"2019"
"54035","354310 RIBEIRAO CORRENTE",0,0,0,77,1,78,"2019"
"54036","354320 RIBEIRAO DO SUL",0,1,2,52,0,55,"2019"
"54037","354323 RIBEIRAO DOS INDIOS",0,0,0,22,0,22,"2019"
"54038","354325 RIBEIRAO GRANDE",0,0,2,98,0,100,"2019"
"54039","354330 RIBEIRAO PIRES",2,4,21,1400,5,1432,"2019"
"54040","354340 RIBEIRAO PRETO",24,38,112,7941,38,8153,"2019"
"54041","354350 RIVERSUL",0,1,1,78,1,81,"2019"
"54042","354360 RIFAINA",0,1,1,54,0,56,"2019"
"54043","354370 RINCAO",2,0,1,103,0,106,"2019"
"54044","354380 RINOPOLIS",1,0,0,96,0,97,"2019"
"54045","354390 RIO CLARO",5,11,33,2468,5,2522,"2019"
"54046","354400 RIO DAS PEDRAS",0,0,5,401,1,407,"2019"
"54047","354410 RIO GRANDE DA SERRA",2,4,7,484,4,501,"2019"
"54048","354420 RIOLANDIA",1,0,2,107,0,110,"2019"
"54049","354425 ROSANA",0,0,3,201,0,204,"2019"
"54050","354430 ROSEIRA",0,1,3,137,1,142,"2019"
"54051","354440 RUBIACEA",0,0,0,21,0,21,"2019"
"54052","354450 RUBINEIA",0,0,0,32,0,32,"2019"
"54053","354460 SABINO",0,0,0,57,0,57,"2019"
"54054","354470 SAGRES",0,1,0,27,0,28,"2019"
"54055","354480 SALES",0,0,2,51,0,53,"2019"
"54056","354490 SALES OLIVEIRA",0,1,0,110,2,113,"2019"
"54057","354500 SALESOPOLIS",0,0,2,209,1,212,"2019"
"54058","354510 SALMOURAO",0,0,0,75,1,76,"2019"
"54059","354515 SALTINHO",0,0,0,93,0,93,"2019"
"54060","354520 SALTO",5,6,10,1636,6,1663,"2019"
"54061","354530 SALTO DE PIRAPORA",2,4,12,496,1,515,"2019"
"54062","354540 SALTO GRANDE",0,3,2,89,0,94,"2019"
"54063","354550 SANDOVALINA",0,0,0,47,0,47,"2019"
"54064","354560 SANTA ADELIA",0,0,3,146,1,150,"2019"
"54065","354570 SANTA ALBERTINA",1,0,0,81,0,82,"2019"
"54066","354580 SANTA BARBARA D'OESTE",3,12,28,2141,4,2188,"2019"
"54067","354600 SANTA BRANCA",0,1,4,148,0,153,"2019"
"54068","354610 SANTA CLARA D'OESTE",0,0,0,33,0,33,"2019"
"54069","354620 SANTA CRUZ DA CONCEICAO",0,0,0,27,0,27,"2019"
"54070","354625 SANTA CRUZ DA ESPERANCA",0,0,0,14,0,14,"2019"
"54071","354630 SANTA CRUZ DAS PALMEIRAS",1,0,5,362,3,371,"2019"
"54072","354640 SANTA CRUZ DO RIO PARDO",2,0,6,597,0,605,"2019"
"54073","354650 SANTA ERNESTINA",1,0,0,63,1,65,"2019"
"54074","354660 SANTA FE DO SUL",0,1,4,408,0,413,"2019"
"54075","354670 SANTA GERTRUDES",4,0,4,302,0,310,"2019"
"54076","354680 SANTA ISABEL",2,2,20,705,0,729,"2019"
"54077","354690 SANTA LUCIA",1,0,1,83,1,86,"2019"
"54078","354700 SANTA MARIA DA SERRA",0,0,0,68,0,68,"2019"
"54079","354710 SANTA MERCEDES",0,0,0,28,0,28,"2019"
"54080","354720 SANTANA DA PONTE PENSA",0,0,0,12,0,12,"2019"
"54081","354730 SANTANA DE PARNAIBA",3,8,24,2294,4,2333,"2019"
"54082","354740 SANTA RITA D'OESTE",0,0,0,27,0,27,"2019"
"54083","354750 SANTA RITA DO PASSA QUATRO",2,1,1,224,0,228,"2019"
"54084","354760 SANTA ROSA DE VITERBO",2,1,6,223,0,232,"2019"
"54085","354765 SANTA SALETE",0,0,0,15,0,15,"2019"
"54086","354770 SANTO ANASTACIO",0,0,5,196,1,202,"2019"
"54087","354780 SANTO ANDRE",20,24,106,8823,17,8990,"2019"
"54088","354790 SANTO ANTONIO DA ALEGRIA",0,0,0,75,0,75,"2019"
"54089","354800 SANTO ANTONIO DE POSSE",0,1,1,266,1,269,"2019"
"54090","354805 SANTO ANTONIO DO ARACANGUA",0,0,2,110,0,112,"2019"
"54091","354810 SANTO ANTONIO DO JARDIM",0,1,0,63,0,64,"2019"
"54092","354820 SANTO ANTONIO DO PINHAL",3,0,2,82,1,88,"2019"
"54093","354830 SANTO EXPEDITO",0,0,1,33,0,34,"2019"
"54094","354840 SANTOPOLIS DO AGUAPEI",0,0,1,51,0,52,"2019"
"54095","354850 SANTOS",7,13,74,4253,17,4364,"2019"
"54096","354860 SAO BENTO DO SAPUCAI",0,1,2,103,0,106,"2019"
"54097","354870 SAO BERNARDO DO CAMPO",19,29,116,9703,22,9889,"2019"
"54098","354880 SAO CAETANO DO SUL",0,4,16,1608,3,1631,"2019"
"54099","354890 SAO CARLOS",5,10,31,2899,16,2961,"2019"
"54100","354900 SAO FRANCISCO",1,0,0,21,0,22,"2019"
"54101","354910 SAO JOAO DA BOA VISTA",0,3,11,990,1,1005,"2019"
"54102","354920 SAO JOAO DAS DUAS PONTES",0,0,0,33,0,33,"2019"
"54103","354925 SAO JOAO DE IRACEMA",0,0,0,16,0,16,"2019"
"54104","354930 SAO JOAO DO PAU D'ALHO",1,0,0,30,0,31,"2019"
"54105","354940 SAO JOAQUIM DA BARRA",1,5,7,539,1,553,"2019"
"54106","354950 SAO JOSE DA BELA VISTA",1,0,0,86,0,87,"2019"
"54107","354960 SAO JOSE DO BARREIRO",0,0,0,39,0,39,"2019"
"54108","354970 SAO JOSE DO RIO PARDO",1,0,1,658,1,661,"2019"
"54109","354980 SAO JOSE DO RIO PRETO",8,17,28,5618,7,5678,"2019"
"54110","354990 SAO JOSE DOS CAMPOS",34,22,99,8889,32,9076,"2019"
"54111","354995 SAO LOURENCO DA SERRA",0,0,2,194,0,196,"2019"
"54112","355000 SAO LUIS DO PARAITINGA",0,0,2,95,0,97,"2019"
"54113","355010 SAO MANUEL",1,2,9,414,0,426,"2019"
"54114","355020 SAO MIGUEL ARCANJO",0,1,13,392,1,407,"2019"
"54115","355030 SAO PAULO",385,598,1980,154959,665,158587,"2019"
"54116","355040 SAO PEDRO",2,0,0,417,0,419,"2019"
"54117","355050 SAO PEDRO DO TURVO",0,0,0,92,1,93,"2019"
"54118","355060 SAO ROQUE",1,4,22,1035,1,1063,"2019"
"54119","355070 SAO SEBASTIAO",5,2,25,1195,4,1231,"2019"
"54120","355080 SAO SEBASTIAO DA GRAMA",1,0,1,100,0,102,"2019"
"54121","355090 SAO SIMAO",2,1,2,140,0,145,"2019"
"54122","355100 SAO VICENTE",10,25,117,4123,23,4298,"2019"
"54123","355110 SARAPUI",0,0,1,108,0,109,"2019"
"54124","355120 SARUTAIA",0,0,0,50,0,50,"2019"
"54125","355130 SEBASTIANOPOLIS DO SUL",1,0,0,36,0,37,"2019"
"54126","355140 SERRA AZUL",3,1,1,105,1,111,"2019"
"54127","355150 SERRANA",0,4,15,591,5,615,"2019"
"54128","355160 SERRA NEGRA",1,0,4,310,1,316,"2019"
"54129","355170 SERTAOZINHO",4,1,7,1613,4,1629,"2019"
"54130","355180 SETE BARRAS",0,1,1,193,0,195,"2019"
"54131","355190 SEVERINIA",2,1,4,197,1,205,"2019"
"54132","355200 SILVEIRAS",0,2,2,62,1,67,"2019"
"54133","355210 SOCORRO",0,1,1,435,0,437,"2019"
"54134","355220 SOROCABA",15,32,173,8669,25,8914,"2019"
"54135","355230 SUD MENNUCCI",0,0,1,85,0,86,"2019"
"54136","355240 SUMARE",3,12,46,3813,15,3889,"2019"
"54137","355250 SUZANO",17,17,69,4173,11,4287,"2019"
"54138","355255 SUZANAPOLIS",0,0,0,29,0,29,"2019"
"54139","355260 TABAPUA",0,0,2,110,1,113,"2019"
"54140","355270 TABATINGA",0,1,2,197,0,200,"2019"
"54141","355280 TABOAO DA SERRA",8,15,44,3975,13,4055,"2019"
"54142","355290 TACIBA",1,0,0,76,0,77,"2019"
"54143","355300 TAGUAI",3,0,3,193,1,200,"2019"
"54144","355310 TAIACU",0,0,1,71,0,72,"2019"
"54145","355320 TAIUVA",0,0,0,47,0,47,"2019"
"54146","355330 TAMBAU",0,0,2,281,0,283,"2019"
"54147","355340 TANABI",0,0,1,280,0,281,"2019"
"54148","355350 TAPIRAI",0,0,0,95,2,97,"2019"
"54149","355360 TAPIRATIBA",1,0,1,110,0,112,"2019"
"54150","355365 TAQUARAL",0,1,0,27,0,28,"2019"
"54151","355370 TAQUARITINGA",1,3,9,555,0,568,"2019"
"54152","355380 TAQUARITUBA",2,1,5,323,0,331,"2019"
"54153","355385 TAQUARIVAI",0,0,1,107,0,108,"2019"
"54154","355390 TARABAI",0,2,1,82,0,85,"2019"
"54155","355395 TARUMA",1,0,2,186,1,190,"2019"
"54156","355400 TATUI",6,6,23,1567,0,1602,"2019"
"54157","355410 TAUBATE",6,18,68,3744,15,3851,"2019"
"54158","355420 TEJUPA",0,0,1,73,0,74,"2019"
"54159","355430 TEODORO SAMPAIO",0,0,2,326,0,328,"2019"
"54160","355440 TERRA ROXA",0,0,3,62,29,94,"2019"
"54161","355450 TIETE",2,1,7,476,0,486,"2019"
"54162","355460 TIMBURI",0,0,1,20,0,21,"2019"
"54163","355465 TORRE DE PEDRA",0,0,1,28,0,29,"2019"
"54164","355470 TORRINHA",0,0,0,96,1,97,"2019"
"54165","355475 TRABIJU",0,0,0,27,0,27,"2019"
"54166","355480 TREMEMBE",3,2,8,557,4,574,"2019"
"54167","355490 TRES FRONTEIRAS",1,0,2,67,0,70,"2019"
"54168","355495 TUIUTI",0,0,0,64,0,64,"2019"
"54169","355500 TUPA",0,3,9,683,0,695,"2019"
"54170","355510 TUPI PAULISTA",0,0,3,123,0,126,"2019"
"54171","355520 TURIUBA",0,0,0,15,0,15,"2019"
"54172","355530 TURMALINA",0,0,0,11,0,11,"2019"
"54173","355535 UBARANA",0,0,1,88,0,89,"2019"
"54174","355540 UBATUBA",2,7,24,1272,7,1312,"2019"
"54175","355550 UBIRAJARA",0,0,1,63,2,66,"2019"
"54176","355560 UCHOA",0,0,2,109,0,111,"2019"
"54177","355570 UNIAO PAULISTA",0,1,0,23,0,24,"2019"
"54178","355580 URANIA",1,1,0,88,0,90,"2019"
"54179","355590 URU",0,0,0,11,0,11,"2019"
"54180","355600 URUPES",0,0,4,114,0,118,"2019"
"54181","355610 VALENTIM GENTIL",1,0,1,176,0,178,"2019"
"54182","355620 VALINHOS",6,4,16,1335,1,1362,"2019"
"54183","355630 VALPARAISO",2,1,0,300,1,304,"2019"
"54184","355635 VARGEM",1,0,0,107,0,108,"2019"
"54185","355640 VARGEM GRANDE DO SUL",2,2,4,521,0,529,"2019"
"54186","355645 VARGEM GRANDE PAULISTA",3,0,5,803,5,816,"2019"
"54187","355650 VARZEA PAULISTA",3,3,16,1342,4,1368,"2019"
"54188","355660 VERA CRUZ",0,0,3,107,0,110,"2019"
"54189","355670 VINHEDO",4,3,6,925,1,939,"2019"
"54190","355680 VIRADOURO",0,1,3,229,0,233,"2019"
"54191","355690 VISTA ALEGRE DO ALTO",1,0,0,114,0,115,"2019"
"54192","355695 VITORIA BRASIL",0,0,0,19,0,19,"2019"
"54193","355700 VOTORANTIM",0,5,30,1605,2,1642,"2019"
"54194","355710 VOTUPORANGA",1,6,5,1153,1,1166,"2019"
"54195","355715 ZACARIAS",0,0,0,25,0,25,"2019"
"54196","355720 CHAVANTES",0,0,2,152,0,154,"2019"
"54197","355730 ESTIVA GERBI",0,0,1,143,1,145,"2019"
"54198","MUNICIPIO IGNORADO - PR",0,0,0,0,1,1,"2019"
"54199","410010 ABATIA",2,0,1,115,0,118,"2019"
"54200","410020 ADRIANOPOLIS",0,0,1,62,1,64,"2019"
"54201","410030 AGUDOS DO SUL",0,0,0,113,0,113,"2019"
"54202","410040 ALMIRANTE TAMANDARE",4,5,31,1610,15,1665,"2019"
"54203","410045 ALTAMIRA DO PARANA",0,1,3,45,0,49,"2019"
"54204","410050 ALTONIA",0,1,4,224,0,229,"2019"
"54205","410060 ALTO PARANA",0,0,0,156,0,156,"2019"
"54206","410070 ALTO PIQUIRI",0,0,3,130,0,133,"2019"
"54207","410080 ALVORADA DO SUL",1,0,4,108,1,114,"2019"
"54208","410090 AMAPORA",0,0,1,93,0,94,"2019"
"54209","410100 AMPERE",2,0,2,282,0,286,"2019"
"54210","410105 ANAHY",0,0,1,25,0,26,"2019"
"54211","410110 ANDIRA",0,2,1,236,0,239,"2019"
"54212","410115 ANGULO",1,0,1,46,0,48,"2019"
"54213","410120 ANTONINA",0,1,2,231,1,235,"2019"
"54214","410130 ANTONIO OLINTO",0,0,0,64,0,64,"2019"
"54215","410140 APUCARANA",4,10,27,1665,6,1712,"2019"
"54216","410150 ARAPONGAS",6,5,20,1478,0,1509,"2019"
"54217","410160 ARAPOTI",1,1,6,350,0,358,"2019"
"54218","410165 ARAPUA",0,0,0,36,0,36,"2019"
"54219","410170 ARARUNA",1,2,2,196,1,202,"2019"
"54220","410180 ARAUCARIA",6,4,34,2213,5,2262,"2019"
"54221","410185 ARIRANHA DO IVAI",0,0,3,31,0,34,"2019"
"54222","410190 ASSAI",0,1,2,138,0,141,"2019"
"54223","410200 ASSIS CHATEAUBRIAND",2,5,11,459,0,477,"2019"
"54224","410210 ASTORGA",0,3,5,339,2,349,"2019"
"54225","410220 ATALAIA",0,0,1,51,1,53,"2019"
"54226","410230 BALSA NOVA",2,2,3,162,1,170,"2019"
"54227","410240 BANDEIRANTES",1,0,5,438,1,445,"2019"
"54228","410250 BARBOSA FERRAZ",1,0,0,108,0,109,"2019"
"54229","410260 BARRACAO",0,0,0,163,0,163,"2019"
"54230","410270 BARRA DO JACARE",0,0,0,27,0,27,"2019"
"54231","410275 BELA VISTA DA CAROBA",0,0,0,35,0,35,"2019"
"54232","410280 BELA VISTA DO PARAISO",3,3,1,183,1,191,"2019"
"54233","410290 BITURUNA",1,0,4,274,1,280,"2019"
"54234","410300 BOA ESPERANCA",0,0,0,53,0,53,"2019"
"54235","410302 BOA ESPERANCA DO IGUACU",0,0,0,31,0,31,"2019"
"54236","410304 BOA VENTURA DE SAO ROQUE",0,1,1,89,0,91,"2019"
"54237","410305 BOA VISTA DA APARECIDA",0,0,5,103,1,109,"2019"
"54238","410310 BOCAIUVA DO SUL",2,0,0,170,0,172,"2019"
"54239","410315 BOM JESUS DO SUL",0,0,1,55,0,56,"2019"
"54240","410320 BOM SUCESSO",0,0,1,98,0,99,"2019"
"54241","410322 BOM SUCESSO DO SUL",0,0,0,37,0,37,"2019"
"54242","410330 BORRAZOPOLIS",0,0,1,69,0,70,"2019"
"54243","410335 BRAGANEY",0,0,3,77,0,80,"2019"
"54244","410337 BRASILANDIA DO SUL",0,1,0,52,0,53,"2019"
"54245","410340 CAFEARA",0,0,0,24,1,25,"2019"
"54246","410345 CAFELANDIA",1,3,9,325,0,338,"2019"
"54247","410347 CAFEZAL DO SUL",0,0,1,60,0,61,"2019"
"54248","410350 CALIFORNIA",1,0,0,120,0,121,"2019"
"54249","410360 CAMBARA",0,0,4,297,1,302,"2019"
"54250","410370 CAMBE",2,6,16,1225,2,1251,"2019"
"54251","410380 CAMBIRA",0,1,1,101,0,103,"2019"
"54252","410390 CAMPINA DA LAGOA",1,1,1,216,0,219,"2019"
"54253","410395 CAMPINA DO SIMAO",0,0,0,69,0,69,"2019"
"54254","410400 CAMPINA GRANDE DO SUL",2,2,7,726,2,739,"2019"
"54255","410405 CAMPO BONITO",0,0,7,53,0,60,"2019"
"54256","410410 CAMPO DO TENENTE",0,0,2,119,0,121,"2019"
"54257","410420 CAMPO LARGO",3,11,41,1592,9,1656,"2019"
"54258","410425 CAMPO MAGRO",1,1,14,385,3,404,"2019"
"54259","410430 CAMPO MOURAO",0,3,12,1221,2,1238,"2019"
"54260","410440 CANDIDO DE ABREU",0,1,3,191,0,195,"2019"
"54261","410442 CANDOI",0,0,3,231,0,234,"2019"
"54262","410445 CANTAGALO",0,1,5,158,0,164,"2019"
"54263","410450 CAPANEMA",1,0,4,242,3,250,"2019"
"54264","410460 CAPITAO LEONIDAS MARQUES",0,3,8,231,0,242,"2019"
"54265","410465 CARAMBEI",4,0,5,334,1,344,"2019"
"54266","410470 CARLOPOLIS",1,0,3,193,1,198,"2019"
"54267","410480 CASCAVEL",10,20,120,5059,0,5209,"2019"
"54268","410490 CASTRO",5,2,25,1151,4,1187,"2019"
"54269","410500 CATANDUVAS",0,1,1,111,0,113,"2019"
"54270","410510 CENTENARIO DO SUL",0,0,3,126,1,130,"2019"
"54271","410520 CERRO AZUL",0,0,1,237,1,239,"2019"
"54272","410530 CEU AZUL",0,1,0,128,0,129,"2019"
"54273","410540 CHOPINZINHO",1,1,8,307,0,317,"2019"
"54274","410550 CIANORTE",1,4,3,1097,0,1105,"2019"
"54275","410560 CIDADE GAUCHA",0,1,0,166,0,167,"2019"
"54276","410570 CLEVELANDIA",3,2,3,256,0,264,"2019"
"54277","410580 COLOMBO",14,13,46,3371,14,3458,"2019"
"54278","410590 COLORADO",1,1,7,254,0,263,"2019"
"54279","410600 CONGONHINHAS",0,0,1,99,1,101,"2019"
"54280","410610 CONSELHEIRO MAIRINCK",0,0,0,35,0,35,"2019"
"54281","410620 CONTENDA",1,1,6,247,4,259,"2019"
"54282","410630 CORBELIA",1,2,8,201,0,212,"2019"
"54283","410640 CORNELIO PROCOPIO",1,3,4,482,2,492,"2019"
"54284","410645 CORONEL DOMINGOS SOARES",0,0,1,82,0,83,"2019"
"54285","410650 CORONEL VIVIDA",0,1,8,314,1,324,"2019"
"54286","410655 CORUMBATAI DO SUL",0,0,1,44,0,45,"2019"
"54287","410657 CRUZEIRO DO IGUACU",0,1,0,49,0,50,"2019"
"54288","410660 CRUZEIRO DO OESTE",0,1,3,296,1,301,"2019"
"54289","410670 CRUZEIRO DO SUL",0,0,0,69,0,69,"2019"
"54290","410680 CRUZ MACHADO",1,0,2,180,0,183,"2019"
"54291","410685 CRUZMALTINA",0,0,0,51,0,51,"2019"
"54292","410690 CURITIBA",42,90,345,20841,75,21393,"2019"
"54293","410700 CURIUVA",0,2,6,174,1,183,"2019"
"54294","410710 DIAMANTE DO NORTE",0,0,1,49,0,50,"2019"
"54295","410712 DIAMANTE DO SUL",0,0,2,41,0,43,"2019"
"54296","410715 DIAMANTE D'OESTE",0,0,1,64,1,66,"2019"
"54297","410720 DOIS VIZINHOS",0,2,9,620,1,632,"2019"
"54298","410725 DOURADINA",0,0,0,121,0,121,"2019"
"54299","410730 DOUTOR CAMARGO",0,0,2,64,0,66,"2019"
"54300","410740 ENEAS MARQUES",0,0,1,62,0,63,"2019"
"54301","410750 ENGENHEIRO BELTRAO",0,0,3,144,0,147,"2019"
"54302","410752 ESPERANCA NOVA",0,0,0,21,0,21,"2019"
"54303","410753 ENTRE RIOS DO OESTE",0,0,2,54,0,56,"2019"
"54304","410754 ESPIGAO ALTO DO IGUACU",0,0,0,63,0,63,"2019"
"54305","410755 FAROL",0,0,0,35,0,35,"2019"
"54306","410760 FAXINAL",0,1,4,247,1,253,"2019"
"54307","410765 FAZENDA RIO GRANDE",8,8,44,1830,11,1901,"2019"
"54308","410770 FENIX",0,0,0,56,0,56,"2019"
"54309","410773 FERNANDES PINHEIRO",0,0,3,83,0,86,"2019"
"54310","410775 FIGUEIRA",0,0,1,114,0,115,"2019"
"54311","410780 FLORAI",0,0,0,60,0,60,"2019"
"54312","410785 FLOR DA SERRA DO SUL",0,0,1,63,0,64,"2019"
"54313","410790 FLORESTA",0,0,2,119,1,122,"2019"
"54314","410800 FLORESTOPOLIS",0,0,3,130,0,133,"2019"
"54315","410810 FLORIDA",0,0,1,39,0,40,"2019"
"54316","410820 FORMOSA DO OESTE",1,0,1,82,0,84,"2019"
"54317","410830 FOZ DO IGUACU",7,12,61,4334,9,4423,"2019"
"54318","410832 FRANCISCO ALVES",0,1,0,98,0,99,"2019"
"54319","410840 FRANCISCO BELTRAO",3,2,18,1325,0,1348,"2019"
"54320","410845 FOZ DO JORDAO",0,1,1,70,0,72,"2019"
"54321","410850 GENERAL CARNEIRO",0,0,2,188,4,194,"2019"
"54322","410855 GODOY MOREIRA",0,0,0,20,0,20,"2019"
"54323","410860 GOIOERE",1,2,3,361,0,367,"2019"
"54324","410865 GOIOXIM",0,1,2,88,0,91,"2019"
"54325","410870 GRANDES RIOS",0,0,0,85,0,85,"2019"
"54326","410880 GUAIRA",3,2,6,487,2,500,"2019"
"54327","410890 GUAIRACA",0,0,0,98,0,98,"2019"
"54328","410895 GUAMIRANGA",0,0,3,100,0,103,"2019"
"54329","410900 GUAPIRAMA",0,0,0,51,0,51,"2019"
"54330","410910 GUAPOREMA",0,0,0,26,0,26,"2019"
"54331","410920 GUARACI",0,0,0,62,0,62,"2019"
"54332","410930 GUARANIACU",1,2,4,157,0,164,"2019"
"54333","410940 GUARAPUAVA",1,9,31,2972,1,3014,"2019"
"54334","410950 GUARAQUECABA",0,0,0,121,1,122,"2019"
"54335","410960 GUARATUBA",0,3,7,489,1,500,"2019"
"54336","410965 HONORIO SERPA",0,0,2,63,0,65,"2019"
"54337","410970 IBAITI",1,2,5,383,0,391,"2019"
"54338","410975 IBEMA",0,0,0,91,0,91,"2019"
"54339","410980 IBIPORA",1,3,6,637,2,649,"2019"
"54340","410990 ICARAIMA",0,1,1,143,0,145,"2019"
"54341","411000 IGUARACU",0,0,2,82,0,84,"2019"
"54342","411005 IGUATU",0,1,1,21,0,23,"2019"
"54343","411007 IMBAU",0,1,5,177,0,183,"2019"
"54344","411010 IMBITUVA",3,1,16,464,0,484,"2019"
"54345","411020 INACIO MARTINS",0,0,1,157,0,158,"2019"
"54346","411030 INAJA",0,0,0,36,0,36,"2019"
"54347","411040 INDIANOPOLIS",0,0,0,57,0,57,"2019"
"54348","411050 IPIRANGA",0,1,9,200,1,211,"2019"
"54349","411060 IPORA",0,2,4,201,0,207,"2019"
"54350","411065 IRACEMA DO OESTE",0,0,1,25,0,26,"2019"
"54351","411070 IRATI",1,6,22,776,0,805,"2019"
"54352","411080 IRETAMA",0,0,2,126,0,128,"2019"
"54353","411090 ITAGUAJE",0,0,1,47,0,48,"2019"
"54354","411095 ITAIPULANDIA",0,0,3,157,6,166,"2019"
"54355","411100 ITAMBARACA",0,1,1,85,0,87,"2019"
"54356","411110 ITAMBE",0,0,1,68,0,69,"2019"
"54357","411120 ITAPEJARA D'OESTE",1,0,1,177,0,179,"2019"
"54358","411125 ITAPERUCU",0,0,6,498,2,506,"2019"
"54359","411130 ITAUNA DO SUL",1,0,0,46,0,47,"2019"
"54360","411140 IVAI",0,1,2,161,2,166,"2019"
"54361","411150 IVAIPORA",1,1,6,405,1,414,"2019"
"54362","411155 IVATE",0,0,1,80,1,82,"2019"
"54363","411160 IVATUBA",0,0,1,35,0,36,"2019"
"54364","411170 JABOTI",0,0,0,62,0,62,"2019"
"54365","411180 JACAREZINHO",2,1,3,599,1,606,"2019"
"54366","411190 JAGUAPITA",1,1,2,162,0,166,"2019"
"54367","411200 JAGUARIAIVA",3,4,9,483,0,499,"2019"
"54368","411210 JANDAIA DO SUL",0,1,5,259,0,265,"2019"
"54369","411220 JANIOPOLIS",0,0,0,46,1,47,"2019"
"54370","411230 JAPIRA",0,1,0,56,0,57,"2019"
"54371","411240 JAPURA",0,0,0,96,0,96,"2019"
"54372","411250 JARDIM ALEGRE",1,2,0,143,0,146,"2019"
"54373","411260 JARDIM OLINDA",1,0,0,12,0,13,"2019"
"54374","411270 JATAIZINHO",0,0,1,151,0,152,"2019"
"54375","411275 JESUITAS",0,0,4,94,0,98,"2019"
"54376","411280 JOAQUIM TAVORA",0,0,1,167,0,168,"2019"
"54377","411290 JUNDIAI DO SUL",0,0,0,39,0,39,"2019"
"54378","411295 JURANDA",0,0,1,102,0,103,"2019"
"54379","411300 JUSSARA",0,0,1,84,0,85,"2019"
"54380","411310 KALORE",0,0,2,47,1,50,"2019"
"54381","411320 LAPA",0,0,12,566,1,579,"2019"
"54382","411325 LARANJAL",0,1,1,83,0,85,"2019"
"54383","411330 LARANJEIRAS DO SUL",2,1,9,500,0,512,"2019"
"54384","411340 LEOPOLIS",0,0,0,46,0,46,"2019"
"54385","411342 LIDIANOPOLIS",0,0,0,50,1,51,"2019"
"54386","411345 LINDOESTE",0,0,0,87,0,87,"2019"
"54387","411350 LOANDA",1,0,0,317,0,318,"2019"
"54388","411360 LOBATO",0,0,2,46,0,48,"2019"
"54389","411370 LONDRINA",22,33,109,6729,14,6907,"2019"
"54390","411373 LUIZIANA",0,0,0,94,0,94,"2019"
"54391","411375 LUNARDELLI",0,0,2,52,0,54,"2019"
"54392","411380 LUPIONOPOLIS",0,0,2,40,1,43,"2019"
"54393","411390 MALLET",0,0,2,160,0,162,"2019"
"54394","411400 MAMBORE",0,0,0,149,1,150,"2019"
"54395","411410 MANDAGUACU",0,1,6,425,1,433,"2019"
"54396","411420 MANDAGUARI",0,1,7,512,1,521,"2019"
"54397","411430 MANDIRITUBA",1,1,7,361,0,370,"2019"
"54398","411435 MANFRINOPOLIS",1,0,0,28,0,29,"2019"
"54399","411440 MANGUEIRINHA",3,0,4,269,0,276,"2019"
"54400","411450 MANOEL RIBAS",0,1,2,182,1,186,"2019"
"54401","411460 MARECHAL CANDIDO RONDON",5,2,13,732,1,753,"2019"
"54402","411470 MARIA HELENA",0,1,0,72,0,73,"2019"
"54403","411480 MARIALVA",1,4,4,545,1,555,"2019"
"54404","411490 MARILANDIA DO SUL",0,0,4,145,1,150,"2019"
"54405","411500 MARILENA",0,0,0,114,0,114,"2019"
"54406","411510 MARILUZ",1,1,4,142,0,148,"2019"
"54407","411520 MARINGA",5,26,86,4999,4,5120,"2019"
"54408","411530 MARIOPOLIS",0,1,3,84,0,88,"2019"
"54409","411535 MARIPA",0,0,1,90,0,91,"2019"
"54410","411540 MARMELEIRO",0,0,2,189,0,191,"2019"
"54411","411545 MARQUINHO",0,0,2,65,1,68,"2019"
"54412","411550 MARUMBI",1,0,2,53,0,56,"2019"
"54413","411560 MATELANDIA",1,0,3,258,0,262,"2019"
"54414","411570 MATINHOS",2,3,11,502,5,523,"2019"
"54415","411573 MATO RICO",0,0,0,50,0,50,"2019"
"54416","411575 MAUA DA SERRA",2,0,0,164,1,167,"2019"
"54417","411580 MEDIANEIRA",0,4,20,798,1,823,"2019"
"54418","411585 MERCEDES",1,0,0,73,0,74,"2019"
"54419","411590 MIRADOR",0,0,0,31,0,31,"2019"
"54420","411600 MIRASELVA",0,0,0,22,0,22,"2019"
"54421","411605 MISSAL",1,2,1,147,1,152,"2019"
"54422","411610 MOREIRA SALES",0,0,0,134,2,136,"2019"
"54423","411620 MORRETES",0,0,3,237,3,243,"2019"
"54424","411630 MUNHOZ DE MELO",1,0,0,41,0,42,"2019"
"54425","411640 NOSSA SENHORA DAS GRACAS",0,0,0,36,0,36,"2019"
"54426","411650 NOVA ALIANCA DO IVAI",0,0,0,24,0,24,"2019"
"54427","411660 NOVA AMERICA DA COLINA",0,0,0,49,0,49,"2019"
"54428","411670 NOVA AURORA",0,1,2,137,0,140,"2019"
"54429","411680 NOVA CANTU",0,0,0,81,0,81,"2019"
"54430","411690 NOVA ESPERANCA",2,1,4,359,0,366,"2019"
"54431","411695 NOVA ESPERANCA DO SUDOESTE",0,0,1,73,2,76,"2019"
"54432","411700 NOVA FATIMA",0,0,0,80,0,80,"2019"
"54433","411705 NOVA LARANJEIRAS",0,2,3,174,0,179,"2019"
"54434","411710 NOVA LONDRINA",0,0,0,174,0,174,"2019"
"54435","411720 NOVA OLIMPIA",0,1,3,48,0,52,"2019"
"54436","411721 NOVA SANTA BARBARA",0,0,0,47,0,47,"2019"
"54437","411722 NOVA SANTA ROSA",1,0,0,107,0,108,"2019"
"54438","411725 NOVA PRATA DO IGUACU",0,0,3,115,0,118,"2019"
"54439","411727 NOVA TEBAS",0,0,0,96,2,98,"2019"
"54440","411729 NOVO ITACOLOMI",0,0,1,27,0,28,"2019"
"54441","411730 ORTIGUEIRA",1,1,5,321,2,330,"2019"
"54442","411740 OURIZONA",0,0,0,27,0,27,"2019"
"54443","411745 OURO VERDE DO OESTE",1,0,1,79,1,82,"2019"
"54444","411750 PAICANDU",0,4,12,662,0,678,"2019"
"54445","411760 PALMAS",1,2,9,855,0,867,"2019"
"54446","411770 PALMEIRA",1,3,6,494,2,506,"2019"
"54447","411780 PALMITAL",0,1,11,181,1,194,"2019"
"54448","411790 PALOTINA",0,1,5,535,0,541,"2019"
"54449","411800 PARAISO DO NORTE",0,2,4,164,0,170,"2019"
"54450","411810 PARANACITY",2,0,0,130,0,132,"2019"
"54451","411820 PARANAGUA",2,7,29,2274,11,2323,"2019"
"54452","411830 PARANAPOEMA",0,0,0,34,0,34,"2019"
"54453","411840 PARANAVAI",0,8,7,1272,0,1287,"2019"
"54454","411845 PATO BRAGADO",1,0,0,72,0,73,"2019"
"54455","411850 PATO BRANCO",2,14,23,1268,0,1307,"2019"
"54456","411860 PAULA FREITAS",0,0,0,64,1,65,"2019"
"54457","411870 PAULO FRONTIN",0,0,2,67,0,69,"2019"
"54458","411880 PEABIRU",0,0,3,162,0,165,"2019"
"54459","411885 PEROBAL",0,0,0,107,0,107,"2019"
"54460","411890 PEROLA",1,0,1,156,0,158,"2019"
"54461","411900 PEROLA D'OESTE",0,1,1,83,0,85,"2019"
"54462","411910 PIEN",0,1,2,151,3,157,"2019"
"54463","411915 PINHAIS",4,9,45,1590,7,1655,"2019"
"54464","411920 PINHALAO",1,0,1,88,0,90,"2019"
"54465","411925 PINHAL DE SAO BENTO",0,0,0,25,0,25,"2019"
"54466","411930 PINHAO",0,5,12,518,2,537,"2019"
"54467","411940 PIRAI DO SUL",1,1,12,328,3,345,"2019"
"54468","411950 PIRAQUARA",9,7,23,1565,4,1608,"2019"
"54469","411960 PITANGA",0,6,9,453,0,468,"2019"
"54470","411965 PITANGUEIRAS",0,0,0,23,0,23,"2019"
"54471","411970 PLANALTINA DO PARANA",0,0,0,69,0,69,"2019"
"54472","411980 PLANALTO",0,1,1,157,0,159,"2019"
"54473","411990 PONTA GROSSA",17,36,121,4795,26,4995,"2019"
"54474","411995 PONTAL DO PARANA",0,2,5,338,0,345,"2019"
"54475","412000 PORECATU",0,3,2,106,1,112,"2019"
"54476","412010 PORTO AMAZONAS",0,0,1,51,0,52,"2019"
"54477","412015 PORTO BARREIRO",0,2,1,44,0,47,"2019"
"54478","412020 PORTO RICO",0,0,0,37,0,37,"2019"
"54479","412030 PORTO VITORIA",0,0,0,39,0,39,"2019"
"54480","412033 PRADO FERREIRA",0,1,4,59,0,64,"2019"
"54481","412035 PRANCHITA",0,0,3,87,0,90,"2019"
"54482","412040 PRESIDENTE CASTELO BRANCO",0,0,1,70,1,72,"2019"
"54483","412050 PRIMEIRO DE MAIO",0,0,2,83,0,85,"2019"
"54484","412060 PRUDENTOPOLIS",0,4,8,577,2,591,"2019"
"54485","412065 QUARTO CENTENARIO",0,0,0,55,0,55,"2019"
"54486","412070 QUATIGUA",0,1,0,94,0,95,"2019"
"54487","412080 QUATRO BARRAS",0,1,5,295,1,302,"2019"
"54488","412085 QUATRO PONTES",0,0,0,51,0,51,"2019"
"54489","412090 QUEDAS DO IGUACU",2,2,21,419,0,444,"2019"
"54490","412100 QUERENCIA DO NORTE",1,0,1,160,0,162,"2019"
"54491","412110 QUINTA DO SOL",0,0,1,53,0,54,"2019"
"54492","412120 QUITANDINHA",0,2,1,228,0,231,"2019"
"54493","412125 RAMILANDIA",1,0,2,74,0,77,"2019"
"54494","412130 RANCHO ALEGRE",0,0,0,32,0,32,"2019"
"54495","412135 RANCHO ALEGRE D'OESTE",0,0,0,32,0,32,"2019"
"54496","412140 REALEZA",0,2,4,206,0,212,"2019"
"54497","412150 REBOUCAS",0,0,2,195,0,197,"2019"
"54498","412160 RENASCENCA",0,1,1,95,0,97,"2019"
"54499","412170 RESERVA",0,0,7,365,2,374,"2019"
"54500","412175 RESERVA DO IGUACU",0,0,1,102,0,103,"2019"
"54501","412180 RIBEIRAO CLARO",2,0,2,137,1,142,"2019"
"54502","412190 RIBEIRAO DO PINHAL",0,0,2,163,0,165,"2019"
"54503","412200 RIO AZUL",0,1,0,170,0,171,"2019"
"54504","412210 RIO BOM",0,0,1,33,0,34,"2019"
"54505","412215 RIO BONITO DO IGUACU",0,0,8,228,2,238,"2019"
"54506","412217 RIO BRANCO DO IVAI",1,0,1,50,0,52,"2019"
"54507","412220 RIO BRANCO DO SUL",1,2,9,542,5,559,"2019"
"54508","412230 RIO NEGRO",1,1,3,378,2,385,"2019"
"54509","412240 ROLANDIA",7,5,14,895,2,923,"2019"
"54510","412250 RONCADOR",0,0,1,146,1,148,"2019"
"54511","412260 RONDON",0,0,2,104,1,107,"2019"
"54512","412265 ROSARIO DO IVAI",0,0,2,64,0,66,"2019"
"54513","412270 SABAUDIA",0,0,0,108,0,108,"2019"
"54514","412280 SALGADO FILHO",0,0,0,50,0,50,"2019"
"54515","412290 SALTO DO ITARARE",0,1,1,69,0,71,"2019"
"54516","412300 SALTO DO LONTRA",0,1,1,186,0,188,"2019"
"54517","412310 SANTA AMELIA",0,0,0,36,0,36,"2019"
"54518","412320 SANTA CECILIA DO PAVAO",0,0,1,45,0,46,"2019"
"54519","412330 SANTA CRUZ DE MONTE CASTELO",1,0,0,122,0,123,"2019"
"54520","412340 SANTA FE",1,3,3,124,1,132,"2019"
"54521","412350 SANTA HELENA",2,1,9,329,2,343,"2019"
"54522","412360 SANTA INES",0,0,0,21,0,21,"2019"
"54523","412370 SANTA ISABEL DO IVAI",0,0,1,95,1,97,"2019"
"54524","412380 SANTA IZABEL DO OESTE",0,1,3,156,0,160,"2019"
"54525","412382 SANTA LUCIA",0,0,0,48,0,48,"2019"
"54526","412385 SANTA MARIA DO OESTE",0,0,2,138,0,140,"2019"
"54527","412390 SANTA MARIANA",0,0,2,147,0,149,"2019"
"54528","412395 SANTA MONICA",0,1,0,51,0,52,"2019"
"54529","412400 SANTANA DO ITARARE",1,0,0,81,0,82,"2019"
"54530","412402 SANTA TEREZA DO OESTE",0,0,6,174,0,180,"2019"
"54531","412405 SANTA TEREZINHA DE ITAIPU",1,3,8,325,6,343,"2019"
"54532","412410 SANTO ANTONIO DA PLATINA",1,3,3,597,0,604,"2019"
"54533","412420 SANTO ANTONIO DO CAIUA",0,0,0,32,0,32,"2019"
"54534","412430 SANTO ANTONIO DO PARAISO",0,0,0,20,0,20,"2019"
"54535","412440 SANTO ANTONIO DO SUDOESTE",0,2,2,268,2,274,"2019"
"54536","412450 SANTO INACIO",0,1,1,87,0,89,"2019"
"54537","412460 SAO CARLOS DO IVAI",0,1,0,99,0,100,"2019"
"54538","412470 SAO JERONIMO DA SERRA",0,0,2,142,0,144,"2019"
"54539","412480 SAO JOAO",0,0,4,150,0,154,"2019"
"54540","412490 SAO JOAO DO CAIUA",0,0,1,70,0,71,"2019"
"54541","412500 SAO JOAO DO IVAI",0,0,1,110,0,111,"2019"
"54542","412510 SAO JOAO DO TRIUNFO",0,1,5,189,2,197,"2019"
"54543","412520 SAO JORGE D'OESTE",0,0,2,123,1,126,"2019"
"54544","412530 SAO JORGE DO IVAI",0,0,0,41,0,41,"2019"
"54545","412535 SAO JORGE DO PATROCINIO",0,0,1,82,0,83,"2019"
"54546","412540 SAO JOSE DA BOA VISTA",0,0,1,77,0,78,"2019"
"54547","412545 SAO JOSE DAS PALMEIRAS",0,0,2,58,0,60,"2019"
"54548","412550 SAO JOSE DOS PINHAIS",5,26,116,4389,15,4551,"2019"
"54549","412555 SAO MANOEL DO PARANA",0,0,0,20,0,20,"2019"
"54550","412560 SAO MATEUS DO SUL",1,2,7,566,3,579,"2019"
"54551","412570 SAO MIGUEL DO IGUACU",0,5,9,415,1,430,"2019"
"54552","412575 SAO PEDRO DO IGUACU",0,0,0,90,0,90,"2019"
"54553","412580 SAO PEDRO DO IVAI",1,0,1,90,2,94,"2019"
"54554","412590 SAO PEDRO DO PARANA",1,0,0,35,0,36,"2019"
"54555","412600 SAO SEBASTIAO DA AMOREIRA",0,1,1,89,0,91,"2019"
"54556","412610 SAO TOME",1,0,1,61,0,63,"2019"
"54557","412620 SAPOPEMA",0,0,1,79,0,80,"2019"
"54558","412625 SARANDI",2,4,18,1628,3,1655,"2019"
"54559","412627 SAUDADE DO IGUACU",0,0,1,86,0,87,"2019"
"54560","412630 SENGES",0,1,4,256,2,263,"2019"
"54561","412635 SERRANOPOLIS DO IGUACU",0,0,2,60,0,62,"2019"
"54562","412640 SERTANEJA",0,0,0,53,0,53,"2019"
"54563","412650 SERTANOPOLIS",0,0,1,202,0,203,"2019"
"54564","412660 SIQUEIRA CAMPOS",1,2,4,290,2,299,"2019"
"54565","412665 SULINA",0,0,0,31,0,31,"2019"
"54566","412667 TAMARANA",1,1,3,170,1,176,"2019"
"54567","412670 TAMBOARA",0,0,0,70,0,70,"2019"
"54568","412680 TAPEJARA",1,0,1,214,0,216,"2019"
"54569","412690 TAPIRA",0,2,0,75,0,77,"2019"
"54570","412700 TEIXEIRA SOARES",0,0,1,132,1,134,"2019"
"54571","412710 TELEMACO BORBA",6,6,19,1097,0,1128,"2019"
"54572","412720 TERRA BOA",2,3,5,221,2,233,"2019"
"54573","412730 TERRA RICA",1,0,0,182,0,183,"2019"
"54574","412740 TERRA ROXA",1,0,3,254,1,259,"2019"
"54575","412750 TIBAGI",0,1,14,288,1,304,"2019"
"54576","412760 TIJUCAS DO SUL",1,2,2,240,4,249,"2019"
"54577","412770 TOLEDO",25,8,40,1994,4,2071,"2019"
"54578","412780 TOMAZINA",0,1,0,80,0,81,"2019"
"54579","412785 TRES BARRAS DO PARANA",1,1,4,170,1,177,"2019"
"54580","412788 TUNAS DO PARANA",0,0,2,130,1,133,"2019"
"54581","412790 TUNEIRAS DO OESTE",0,1,0,102,0,103,"2019"
"54582","412795 TUPASSI",1,0,1,89,0,91,"2019"
"54583","412796 TURVO",0,0,5,184,0,189,"2019"
"54584","412800 UBIRATA",1,0,3,305,1,310,"2019"
"54585","412810 UMUARAMA",1,7,19,1583,0,1610,"2019"
"54586","412820 UNIAO DA VITORIA",1,1,6,836,4,848,"2019"
"54587","412830 UNIFLOR",0,1,1,25,0,27,"2019"
"54588","412840 URAI",1,0,0,99,0,100,"2019"
"54589","412850 WENCESLAU BRAZ",0,1,4,281,0,286,"2019"
"54590","412853 VENTANIA",0,0,4,132,0,136,"2019"
"54591","412855 VERA CRUZ DO OESTE",0,1,1,105,0,107,"2019"
"54592","412860 VERE",0,0,0,93,1,94,"2019"
"54593","412862 ALTO PARAISO",0,1,1,56,0,58,"2019"
"54594","412863 DOUTOR ULYSSES",0,1,1,65,1,68,"2019"
"54595","412865 VIRMOND",0,0,1,59,1,61,"2019"
"54596","412870 VITORINO",0,0,2,117,0,119,"2019"
"54597","412880 XAMBRE",1,0,0,73,0,74,"2019"
"54598","MUNICIPIO IGNORADO - SC",0,0,0,3,0,3,"2019"
"54599","420005 ABDON BATISTA",0,0,0,25,0,25,"2019"
"54600","420010 ABELARDO LUZ",1,1,3,280,0,285,"2019"
"54601","420020 AGROLANDIA",0,0,0,121,3,124,"2019"
"54602","420030 AGRONOMICA",0,0,1,68,1,70,"2019"
"54603","420040 AGUA DOCE",0,0,0,112,0,112,"2019"
"54604","420050 AGUAS DE CHAPECO",0,0,1,91,0,92,"2019"
"54605","420055 AGUAS FRIAS",0,0,0,33,0,33,"2019"
"54606","420060 AGUAS MORNAS",0,0,1,73,0,74,"2019"
"54607","420070 ALFREDO WAGNER",0,0,1,96,2,99,"2019"
"54608","420075 ALTO BELA VISTA",0,0,0,21,0,21,"2019"
"54609","420080 ANCHIETA",0,1,0,57,0,58,"2019"
"54610","420090 ANGELINA",0,0,2,62,0,64,"2019"
"54611","420100 ANITA GARIBALDI",0,1,5,90,0,96,"2019"
"54612","420110 ANITAPOLIS",0,0,1,34,0,35,"2019"
"54613","420120 ANTONIO CARLOS",0,0,3,125,2,130,"2019"
"54614","420125 APIUNA",1,0,2,122,2,127,"2019"
"54615","420127 ARABUTA",0,0,2,52,0,54,"2019"
"54616","420130 ARAQUARI",1,2,12,551,6,572,"2019"
"54617","420140 ARARANGUA",3,3,11,983,4,1004,"2019"
"54618","420150 ARMAZEM",0,1,1,114,1,117,"2019"
"54619","420160 ARROIO TRINTA",0,0,0,41,0,41,"2019"
"54620","420165 ARVOREDO",0,0,1,22,0,23,"2019"
"54621","420170 ASCURRA",0,0,1,99,0,100,"2019"
"54622","420180 ATALANTA",0,2,1,41,0,44,"2019"
"54623","420190 AURORA",0,0,5,79,0,84,"2019"
"54624","420195 BALNEARIO ARROIO DO SILVA",0,0,1,165,0,166,"2019"
"54625","420200 BALNEARIO CAMBORIU",3,7,28,1553,4,1595,"2019"
"54626","420205 BALNEARIO BARRA DO SUL",1,1,3,135,2,142,"2019"
"54627","420207 BALNEARIO GAIVOTA",0,1,2,147,1,151,"2019"
"54628","420208 BANDEIRANTE",0,0,0,44,0,44,"2019"
"54629","420209 BARRA BONITA",0,0,1,19,0,20,"2019"
"54630","420210 BARRA VELHA",1,1,7,493,4,506,"2019"
"54631","420213 BELA VISTA DO TOLDO",0,0,1,64,0,65,"2019"
"54632","420215 BELMONTE",0,0,0,33,0,33,"2019"
"54633","420220 BENEDITO NOVO",0,0,0,96,1,97,"2019"
"54634","420230 BIGUACU",0,3,25,936,1,965,"2019"
"54635","420240 BLUMENAU",9,11,50,4333,8,4411,"2019"
"54636","420243 BOCAINA DO SUL",0,1,5,27,0,33,"2019"
"54637","420245 BOMBINHAS",0,0,3,294,5,302,"2019"
"54638","420250 BOM JARDIM DA SERRA",1,1,2,31,0,35,"2019"
"54639","420253 BOM JESUS",0,0,0,36,0,36,"2019"
"54640","420257 BOM JESUS DO OESTE",0,0,0,22,0,22,"2019"
"54641","420260 BOM RETIRO",0,1,13,110,0,124,"2019"
"54642","420270 BOTUVERA",0,0,0,71,1,72,"2019"
"54643","420280 BRACO DO NORTE",3,1,2,565,2,573,"2019"
"54644","420285 BRACO DO TROMBUDO",0,0,0,44,0,44,"2019"
"54645","420287 BRUNOPOLIS",1,1,1,29,0,32,"2019"
"54646","420290 BRUSQUE",10,3,14,1931,2,1960,"2019"
"54647","420300 CACADOR",2,2,12,1143,2,1161,"2019"
"54648","420310 CAIBI",0,0,1,87,1,89,"2019"
"54649","420315 CALMON",0,0,0,62,1,63,"2019"
"54650","420320 CAMBORIU",6,6,12,1427,2,1453,"2019"
"54651","420325 CAPAO ALTO",1,0,1,34,0,36,"2019"
"54652","420330 CAMPO ALEGRE",0,0,1,151,1,153,"2019"
"54653","420340 CAMPO BELO DO SUL",0,1,4,73,1,79,"2019"
"54654","420350 CAMPO ERE",0,1,1,141,1,144,"2019"
"54655","420360 CAMPOS NOVOS",0,0,7,549,0,556,"2019"
"54656","420370 CANELINHA",0,0,3,157,0,160,"2019"
"54657","420380 CANOINHAS",0,12,30,771,1,814,"2019"
"54658","420390 CAPINZAL",3,0,2,303,1,309,"2019"
"54659","420395 CAPIVARI DE BAIXO",1,0,6,340,0,347,"2019"
"54660","420400 CATANDUVAS",0,0,3,184,0,187,"2019"
"54661","420410 CAXAMBU DO SUL",0,0,1,63,0,64,"2019"
"54662","420415 CELSO RAMOS",0,0,1,29,0,30,"2019"
"54663","420417 CERRO NEGRO",0,0,5,35,0,40,"2019"
"54664","420419 CHAPADAO DO LAGEADO",0,0,3,41,0,44,"2019"
"54665","420420 CHAPECO",9,13,57,3577,1,3657,"2019"
"54666","420425 COCAL DO SUL",0,1,2,190,0,193,"2019"
"54667","420430 CONCORDIA",4,5,27,1075,0,1111,"2019"
"54668","420435 CORDILHEIRA ALTA",0,1,2,58,0,61,"2019"
"54669","420440 CORONEL FREITAS",0,0,1,135,1,137,"2019"
"54670","420445 CORONEL MARTINS",0,0,0,17,0,17,"2019"
"54671","420450 CORUPA",0,0,0,177,0,177,"2019"
"54672","420455 CORREIA PINTO",2,1,11,223,0,237,"2019"
"54673","420460 CRICIUMA",5,7,31,2681,4,2728,"2019"
"54674","420470 CUNHA PORA",0,0,2,128,0,130,"2019"
"54675","420475 CUNHATAI",0,0,0,27,0,27,"2019"
"54676","420480 CURITIBANOS",2,4,5,634,1,646,"2019"
"54677","420490 DESCANSO",0,0,1,95,0,96,"2019"
"54678","420500 DIONISIO CERQUEIRA",0,2,1,237,0,240,"2019"
"54679","420510 DONA EMMA",0,1,0,63,1,65,"2019"
"54680","420515 DOUTOR PEDRINHO",0,0,1,38,0,39,"2019"
"54681","420517 ENTRE RIOS",0,0,1,57,0,58,"2019"
"54682","420519 ERMO",0,0,0,34,0,34,"2019"
"54683","420520 ERVAL VELHO",0,1,2,63,0,66,"2019"
"54684","420530 FAXINAL DOS GUEDES",1,0,1,159,0,161,"2019"
"54685","420535 FLOR DO SERTAO",0,0,0,23,0,23,"2019"
"54686","420540 FLORIANOPOLIS",12,16,75,6003,28,6134,"2019"
"54687","420543 FORMOSA DO SUL",0,0,0,25,0,25,"2019"
"54688","420545 FORQUILHINHA",0,1,4,440,1,446,"2019"
"54689","420550 FRAIBURGO",2,3,4,512,0,521,"2019"
"54690","420555 FREI ROGERIO",0,1,0,21,0,22,"2019"
"54691","420560 GALVAO",1,1,0,30,0,32,"2019"
"54692","420570 GAROPABA",0,1,8,309,2,320,"2019"
"54693","420580 GARUVA",2,0,13,263,3,281,"2019"
"54694","420590 GASPAR",6,2,15,972,0,995,"2019"
"54695","420600 GOVERNADOR CELSO RAMOS",0,2,4,154,2,162,"2019"
"54696","420610 GRAO PARA",0,0,1,82,1,84,"2019"
"54697","420620 GRAVATAL",0,0,2,138,0,140,"2019"
"54698","420630 GUABIRUBA",0,2,1,331,1,335,"2019"
"54699","420640 GUARACIABA",0,1,0,137,0,138,"2019"
"54700","420650 GUARAMIRIM",0,2,9,591,0,602,"2019"
"54701","420660 GUARUJA DO SUL",0,0,1,61,0,62,"2019"
"54702","420665 GUATAMBU",0,0,2,104,0,106,"2019"
"54703","420670 HERVAL D'OESTE",0,0,2,320,0,322,"2019"
"54704","420675 IBIAM",0,0,0,15,0,15,"2019"
"54705","420680 IBICARE",0,0,0,26,0,26,"2019"
"54706","420690 IBIRAMA",0,0,3,223,0,226,"2019"
"54707","420700 ICARA",0,3,6,743,3,755,"2019"
"54708","420710 ILHOTA",1,0,0,192,1,194,"2019"
"54709","420720 IMARUI",0,0,2,104,0,106,"2019"
"54710","420730 IMBITUBA",0,0,15,624,1,640,"2019"
"54711","420740 IMBUIA",0,0,4,93,0,97,"2019"
"54712","420750 INDAIAL",1,1,8,900,0,910,"2019"
"54713","420757 IOMERE",0,0,3,40,0,43,"2019"
"54714","420760 IPIRA",0,0,1,51,0,52,"2019"
"54715","420765 IPORA DO OESTE",0,1,1,118,0,120,"2019"
"54716","420768 IPUACU",1,1,3,125,0,130,"2019"
"54717","420770 IPUMIRIM",0,1,0,95,0,96,"2019"
"54718","420775 IRACEMINHA",0,1,1,35,0,37,"2019"
"54719","420780 IRANI",0,0,1,153,0,154,"2019"
"54720","420785 IRATI",0,0,1,31,0,32,"2019"
"54721","420790 IRINEOPOLIS",0,2,1,140,0,143,"2019"
"54722","420800 ITA",0,0,1,86,1,88,"2019"
"54723","420810 ITAIOPOLIS",0,2,6,288,0,296,"2019"
"54724","420820 ITAJAI",13,14,58,3579,3,3667,"2019"
"54725","420830 ITAPEMA",4,5,9,904,4,926,"2019"
"54726","420840 ITAPIRANGA",0,0,6,214,0,220,"2019"
"54727","420845 ITAPOA",0,3,6,283,1,293,"2019"
"54728","420850 ITUPORANGA",2,0,16,406,0,424,"2019"
"54729","420860 JABORA",0,0,0,57,0,57,"2019"
"54730","420870 JACINTO MACHADO",1,0,2,127,0,130,"2019"
"54731","420880 JAGUARUNA",0,1,1,257,1,260,"2019"
"54732","420890 JARAGUA DO SUL",3,7,34,2266,1,2311,"2019"
"54733","420895 JARDINOPOLIS",0,0,0,23,0,23,"2019"
"54734","420900 JOACABA",0,0,3,350,0,353,"2019"
"54735","420910 JOINVILLE",11,47,148,7579,30,7815,"2019"
"54736","420915 JOSE BOITEUX",0,2,2,94,1,99,"2019"
"54737","420917 JUPIA",1,0,0,33,0,34,"2019"
"54738","420920 LACERDOPOLIS",0,0,0,27,0,27,"2019"
"54739","420930 LAGES",4,31,132,2108,12,2287,"2019"
"54740","420940 LAGUNA",0,2,6,445,0,453,"2019"
"54741","420945 LAJEADO GRANDE",0,0,0,26,0,26,"2019"
"54742","420950 LAURENTINO",0,0,6,92,1,99,"2019"
"54743","420960 LAURO MULLER",0,0,1,168,1,170,"2019"
"54744","420970 LEBON REGIS",1,2,1,156,1,161,"2019"
"54745","420980 LEOBERTO LEAL",0,0,1,36,0,37,"2019"
"54746","420985 LINDOIA DO SUL",0,1,3,54,0,58,"2019"
"54747","420990 LONTRAS",0,1,3,149,1,154,"2019"
"54748","421000 LUIZ ALVES",1,1,4,192,0,198,"2019"
"54749","421003 LUZERNA",0,0,2,58,0,60,"2019"
"54750","421005 MACIEIRA",0,0,0,24,0,24,"2019"
"54751","421010 MAFRA",1,3,21,727,2,754,"2019"
"54752","421020 MAJOR GERCINO",0,1,0,28,1,30,"2019"
"54753","421030 MAJOR VIEIRA",0,1,2,98,0,101,"2019"
"54754","421040 MARACAJA",0,0,0,104,1,105,"2019"
"54755","421050 MARAVILHA",3,1,9,357,1,371,"2019"
"54756","421055 MAREMA",0,0,0,26,0,26,"2019"
"54757","421060 MASSARANDUBA",1,1,2,211,0,215,"2019"
"54758","421070 MATOS COSTA",0,1,0,36,1,38,"2019"
"54759","421080 MELEIRO",0,0,1,78,0,79,"2019"
"54760","421085 MIRIM DOCE",1,0,1,34,0,36,"2019"
"54761","421090 MODELO",0,0,0,48,1,49,"2019"
"54762","421100 MONDAI",0,1,1,118,0,120,"2019"
"54763","421105 MONTE CARLO",0,1,3,138,0,142,"2019"
"54764","421110 MONTE CASTELO",0,1,2,127,1,131,"2019"
"54765","421120 MORRO DA FUMACA",0,0,3,213,1,217,"2019"
"54766","421125 MORRO GRANDE",0,0,1,36,0,37,"2019"
"54767","421130 NAVEGANTES",1,6,13,1415,0,1435,"2019"
"54768","421140 NOVA ERECHIM",0,0,1,73,0,74,"2019"
"54769","421145 NOVA ITABERABA",0,0,1,57,0,58,"2019"
"54770","421150 NOVA TRENTO",0,0,2,191,1,194,"2019"
"54771","421160 NOVA VENEZA",1,1,1,157,0,160,"2019"
"54772","421165 NOVO HORIZONTE",0,0,0,24,0,24,"2019"
"54773","421170 ORLEANS",1,1,8,312,0,322,"2019"
"54774","421175 OTACILIO COSTA",1,3,12,217,1,234,"2019"
"54775","421180 OURO",0,0,0,71,0,71,"2019"
"54776","421185 OURO VERDE",0,0,1,23,0,24,"2019"
"54777","421187 PAIAL",0,0,1,27,0,28,"2019"
"54778","421189 PAINEL",0,0,3,28,0,31,"2019"
"54779","421190 PALHOCA",4,8,47,2700,25,2784,"2019"
"54780","421200 PALMA SOLA",1,0,1,116,0,118,"2019"
"54781","421205 PALMEIRA",0,1,1,21,0,23,"2019"
"54782","421210 PALMITOS",0,1,0,172,0,173,"2019"
"54783","421220 PAPANDUVA",0,0,3,246,0,249,"2019"
"54784","421223 PARAISO",1,0,0,40,0,41,"2019"
"54785","421225 PASSO DE TORRES",0,1,0,88,1,90,"2019"
"54786","421227 PASSOS MAIA",0,0,2,64,0,66,"2019"
"54787","421230 PAULO LOPES",0,0,1,94,3,98,"2019"
"54788","421240 PEDRAS GRANDES",0,0,1,39,0,40,"2019"
"54789","421250 PENHA",2,2,4,425,0,433,"2019"
"54790","421260 PERITIBA",0,0,1,33,0,34,"2019"
"54791","421265 PESCARIA BRAVA",0,0,1,118,0,119,"2019"
"54792","421270 PETROLANDIA",0,1,6,80,0,87,"2019"
"54793","421280 BALNEARIO PICARRAS",5,1,4,343,1,354,"2019"
"54794","421290 PINHALZINHO",0,0,0,318,0,318,"2019"
"54795","421300 PINHEIRO PRETO",0,0,0,46,0,46,"2019"
"54796","421310 PIRATUBA",0,2,3,46,0,51,"2019"
"54797","421315 PLANALTO ALEGRE",0,0,2,49,0,51,"2019"
"54798","421320 POMERODE",1,0,1,390,0,392,"2019"
"54799","421330 PONTE ALTA",1,1,1,60,0,63,"2019"
"54800","421335 PONTE ALTA DO NORTE",0,0,0,57,0,57,"2019"
"54801","421340 PONTE SERRADA",0,0,4,144,0,148,"2019"
"54802","421350 PORTO BELO",0,2,6,328,1,337,"2019"
"54803","421360 PORTO UNIAO",0,0,7,416,0,423,"2019"
"54804","421370 POUSO REDONDO",0,1,5,230,2,238,"2019"
"54805","421380 PRAIA GRANDE",0,0,3,98,0,101,"2019"
"54806","421390 PRESIDENTE CASTELLO BRANCO",0,0,0,16,0,16,"2019"
"54807","421400 PRESIDENTE GETULIO",3,0,10,259,1,273,"2019"
"54808","421410 PRESIDENTE NEREU",0,0,0,27,0,27,"2019"
"54809","421415 PRINCESA",1,0,0,41,0,42,"2019"
"54810","421420 QUILOMBO",0,0,0,127,0,127,"2019"
"54811","421430 RANCHO QUEIMADO",0,0,2,42,0,44,"2019"
"54812","421440 RIO DAS ANTAS",0,0,1,68,0,69,"2019"
"54813","421450 RIO DO CAMPO",0,0,0,82,2,84,"2019"
"54814","421460 RIO DO OESTE",1,0,2,103,1,107,"2019"
"54815","421470 RIO DOS CEDROS",0,0,0,109,0,109,"2019"
"54816","421480 RIO DO SUL",3,1,14,911,2,931,"2019"
"54817","421490 RIO FORTUNA",0,0,0,56,0,56,"2019"
"54818","421500 RIO NEGRINHO",1,6,2,530,1,540,"2019"
"54819","421505 RIO RUFINO",0,0,5,36,0,41,"2019"
"54820","421507 RIQUEZA",1,0,0,51,0,52,"2019"
"54821","421510 RODEIO",1,1,1,125,0,128,"2019"
"54822","421520 ROMELANDIA",0,0,0,50,0,50,"2019"
"54823","421530 SALETE",0,0,1,95,8,104,"2019"
"54824","421535 SALTINHO",0,1,0,41,1,43,"2019"
"54825","421540 SALTO VELOSO",0,1,0,54,0,55,"2019"
"54826","421545 SANGAO",0,0,0,192,0,192,"2019"
"54827","421550 SANTA CECILIA",0,2,7,287,1,297,"2019"
"54828","421555 SANTA HELENA",0,0,0,25,0,25,"2019"
"54829","421560 SANTA ROSA DE LIMA",0,0,0,22,0,22,"2019"
"54830","421565 SANTA ROSA DO SUL",0,0,2,111,0,113,"2019"
"54831","421567 SANTA TEREZINHA",0,0,3,85,2,90,"2019"
"54832","421568 SANTA TEREZINHA DO PROGRESSO",0,0,1,20,0,21,"2019"
"54833","421569 SANTIAGO DO SUL",0,0,0,18,0,18,"2019"
"54834","421570 SANTO AMARO DA IMPERATRIZ",1,2,5,309,3,320,"2019"
"54835","421575 SAO BERNARDINO",0,0,1,37,0,38,"2019"
"54836","421580 SAO BENTO DO SUL",1,2,8,1030,0,1041,"2019"
"54837","421590 SAO BONIFACIO",0,0,0,24,0,24,"2019"
"54838","421600 SAO CARLOS",0,0,1,149,0,150,"2019"
"54839","421605 SAO CRISTOVAO DO SUL",0,0,3,79,0,82,"2019"
"54840","421610 SAO DOMINGOS",1,0,3,127,0,131,"2019"
"54841","421620 SAO FRANCISCO DO SUL",1,4,7,679,5,696,"2019"
"54842","421625 SAO JOAO DO OESTE",0,0,0,55,0,55,"2019"
"54843","421630 SAO JOAO BATISTA",1,2,7,454,1,465,"2019"
"54844","421635 SAO JOAO DO ITAPERIU",0,0,1,60,1,62,"2019"
"54845","421640 SAO JOAO DO SUL",1,0,0,90,0,91,"2019"
"54846","421650 SAO JOAQUIM",1,4,18,365,1,389,"2019"
"54847","421660 SAO JOSE",9,12,57,3181,10,3269,"2019"
"54848","421670 SAO JOSE DO CEDRO",0,0,2,174,0,176,"2019"
"54849","421680 SAO JOSE DO CERRITO",0,1,4,67,1,73,"2019"
"54850","421690 SAO LOURENCO DO OESTE",0,3,5,346,0,354,"2019"
"54851","421700 SAO LUDGERO",0,0,0,142,0,142,"2019"
"54852","421710 SAO MARTINHO",0,0,0,49,0,49,"2019"
"54853","421715 SAO MIGUEL DA BOA VISTA",0,0,0,17,0,17,"2019"
"54854","421720 SAO MIGUEL DO OESTE",1,1,3,564,1,570,"2019"
"54855","421725 SAO PEDRO DE ALCANTARA",0,0,0,42,1,43,"2019"
"54856","421730 SAUDADES",0,1,0,109,0,110,"2019"
"54857","421740 SCHROEDER",2,1,0,268,0,271,"2019"
"54858","421750 SEARA",1,0,1,242,1,245,"2019"
"54859","421755 SERRA ALTA",0,0,0,36,0,36,"2019"
"54860","421760 SIDEROPOLIS",0,0,1,141,2,144,"2019"
"54861","421770 SOMBRIO",1,0,6,414,2,423,"2019"
"54862","421775 SUL BRASIL",0,0,1,23,0,24,"2019"
"54863","421780 TAIO",0,0,1,196,27,224,"2019"
"54864","421790 TANGARA",1,0,3,80,1,85,"2019"
"54865","421795 TIGRINHOS",0,0,0,41,0,41,"2019"
"54866","421800 TIJUCAS",1,4,16,674,3,698,"2019"
"54867","421810 TIMBE DO SUL",0,0,0,67,0,67,"2019"
"54868","421820 TIMBO",3,2,3,482,0,490,"2019"
"54869","421825 TIMBO GRANDE",0,1,2,115,3,121,"2019"
"54870","421830 TRES BARRAS",0,2,5,316,0,323,"2019"
"54871","421835 TREVISO",0,0,2,47,0,49,"2019"
"54872","421840 TREZE DE MAIO",0,0,2,103,0,105,"2019"
"54873","421850 TREZE TILIAS",0,1,2,118,1,122,"2019"
"54874","421860 TROMBUDO CENTRAL",0,0,0,80,0,80,"2019"
"54875","421870 TUBARAO",7,8,18,1335,0,1368,"2019"
"54876","421875 TUNAPOLIS",1,0,1,66,0,68,"2019"
"54877","421880 TURVO",0,0,1,173,0,174,"2019"
"54878","421885 UNIAO DO OESTE",0,0,0,34,0,34,"2019"
"54879","421890 URUBICI",1,0,7,129,0,137,"2019"
"54880","421895 URUPEMA",0,0,3,35,0,38,"2019"
"54881","421900 URUSSANGA",0,0,2,202,0,204,"2019"
"54882","421910 VARGEAO",0,0,0,69,0,69,"2019"
"54883","421915 VARGEM",0,0,0,34,0,34,"2019"
"54884","421917 VARGEM BONITA",1,0,2,58,0,61,"2019"
"54885","421920 VIDAL RAMOS",0,0,3,91,0,94,"2019"
"54886","421930 VIDEIRA",1,2,5,762,1,771,"2019"
"54887","421935 VITOR MEIRELES",0,1,2,78,0,81,"2019"
"54888","421940 WITMARSUM",1,0,0,46,0,47,"2019"
"54889","421950 XANXERE",3,0,4,677,0,684,"2019"
"54890","421960 XAVANTINA",0,0,0,25,0,25,"2019"
"54891","421970 XAXIM",0,1,3,468,0,472,"2019"
"54892","421985 ZORTEA",0,0,2,64,0,66,"2019"
"54893","422000 BALNEARIO RINCAO",0,1,2,191,0,194,"2019"
"54894","430003 ACEGUA",1,0,0,55,0,56,"2019"
"54895","430005 AGUA SANTA",0,0,0,51,0,51,"2019"
"54896","430010 AGUDO",0,1,2,162,0,165,"2019"
"54897","430020 AJURICABA",0,0,1,58,0,59,"2019"
"54898","430030 ALECRIM",0,0,1,48,0,49,"2019"
"54899","430040 ALEGRETE",1,2,15,809,1,828,"2019"
"54900","430045 ALEGRIA",0,0,0,40,0,40,"2019"
"54901","430047 ALMIRANTE TAMANDARE DO SUL",0,0,1,16,0,17,"2019"
"54902","430050 ALPESTRE",0,1,0,49,0,50,"2019"
"54903","430055 ALTO ALEGRE",0,0,0,16,0,16,"2019"
"54904","430057 ALTO FELIZ",0,0,0,16,0,16,"2019"
"54905","430060 ALVORADA",15,16,48,2679,6,2764,"2019"
"54906","430063 AMARAL FERRADOR",0,0,2,58,1,61,"2019"
"54907","430064 AMETISTA DO SUL",0,0,2,82,0,84,"2019"
"54908","430066 ANDRE DA ROCHA",0,0,0,6,0,6,"2019"
"54909","430070 ANTA GORDA",0,0,0,61,0,61,"2019"
"54910","430080 ANTONIO PRADO",0,0,2,125,0,127,"2019"
"54911","430085 ARAMBARE",1,0,2,42,1,46,"2019"
"54912","430087 ARARICA",1,0,3,85,0,89,"2019"
"54913","430090 ARATIBA",0,0,1,66,0,67,"2019"
"54914","430100 ARROIO DO MEIO",1,0,5,265,0,271,"2019"
"54915","430105 ARROIO DO SAL",0,0,2,97,1,100,"2019"
"54916","430107 ARROIO DO PADRE",1,0,1,18,0,20,"2019"
"54917","430110 ARROIO DOS RATOS",0,0,5,159,1,165,"2019"
"54918","430120 ARROIO DO TIGRE",1,1,1,114,0,117,"2019"
"54919","430130 ARROIO GRANDE",0,0,6,182,0,188,"2019"
"54920","430140 ARVOREZINHA",0,2,0,114,0,116,"2019"
"54921","430150 AUGUSTO PESTANA",0,1,0,74,1,76,"2019"
"54922","430155 AUREA",0,0,0,30,1,31,"2019"
"54923","430160 BAGE",6,8,26,1625,11,1676,"2019"
"54924","430163 BALNEARIO PINHAL",0,0,4,143,4,151,"2019"
"54925","430165 BARAO",0,0,2,55,0,57,"2019"
"54926","430170 BARAO DE COTEGIPE",0,0,0,76,0,76,"2019"
"54927","430175 BARAO DO TRIUNFO",0,1,1,36,0,38,"2019"
"54928","430180 BARRACAO",0,0,0,63,0,63,"2019"
"54929","430185 BARRA DO GUARITA",0,0,0,46,1,47,"2019"
"54930","430187 BARRA DO QUARAI",0,1,0,6,33,40,"2019"
"54931","430190 BARRA DO RIBEIRO",1,0,1,140,9,151,"2019"
"54932","430192 BARRA DO RIO AZUL",0,0,0,9,0,9,"2019"
"54933","430195 BARRA FUNDA",0,0,0,34,0,34,"2019"
"54934","430200 BARROS CASSAL",0,0,2,94,2,98,"2019"
"54935","430205 BENJAMIN CONSTANT DO SUL",1,1,0,25,0,27,"2019"
"54936","430210 BENTO GONCALVES",3,11,32,1508,3,1557,"2019"
"54937","430215 BOA VISTA DAS MISSOES",0,0,0,30,0,30,"2019"
"54938","430220 BOA VISTA DO BURICA",0,0,0,79,0,79,"2019"
"54939","430222 BOA VISTA DO CADEADO",0,0,0,21,0,21,"2019"
"54940","430223 BOA VISTA DO INCRA",0,0,0,35,0,35,"2019"
"54941","430225 BOA VISTA DO SUL",0,0,0,26,0,26,"2019"
"54942","430230 BOM JESUS",0,0,0,157,3,160,"2019"
"54943","430235 BOM PRINCIPIO",1,1,0,190,0,192,"2019"
"54944","430237 BOM PROGRESSO",0,0,1,32,0,33,"2019"
"54945","430240 BOM RETIRO DO SUL",1,0,2,156,0,159,"2019"
"54946","430245 BOQUEIRAO DO LEAO",0,0,0,104,0,104,"2019"
"54947","430250 BOSSOROCA",0,0,1,62,0,63,"2019"
"54948","430258 BOZANO",1,0,0,24,0,25,"2019"
"54949","430260 BRAGA",0,1,0,39,0,40,"2019"
"54950","430265 BROCHIER",0,2,1,42,1,46,"2019"
"54951","430270 BUTIA",1,0,4,228,0,233,"2019"
"54952","430280 CACAPAVA DO SUL",0,1,8,382,3,394,"2019"
"54953","430290 CACEQUI",1,0,1,116,0,118,"2019"
"54954","430300 CACHOEIRA DO SUL",3,5,12,958,6,984,"2019"
"54955","430310 CACHOEIRINHA",5,6,26,1630,6,1673,"2019"
"54956","430320 CACIQUE DOBLE",0,0,0,52,0,52,"2019"
"54957","430330 CAIBATE",0,0,0,53,0,53,"2019"
"54958","430340 CAICARA",0,0,0,43,0,43,"2019"
"54959","430350 CAMAQUA",6,3,16,828,3,856,"2019"
"54960","430355 CAMARGO",0,0,0,48,0,48,"2019"
"54961","430360 CAMBARA DO SUL",0,1,0,73,0,74,"2019"
"54962","430367 CAMPESTRE DA SERRA",0,0,0,22,0,22,"2019"
"54963","430370 CAMPINA DAS MISSOES",0,0,2,43,0,45,"2019"
"54964","430380 CAMPINAS DO SUL",0,1,1,56,0,58,"2019"
"54965","430390 CAMPO BOM",2,4,12,763,1,782,"2019"
"54966","430400 CAMPO NOVO",1,0,0,64,0,65,"2019"
"54967","430410 CAMPOS BORGES",0,0,0,28,0,28,"2019"
"54968","430420 CANDELARIA",1,0,3,326,2,332,"2019"
"54969","430430 CANDIDO GODOI",0,0,0,68,0,68,"2019"
"54970","430435 CANDIOTA",0,2,1,115,4,122,"2019"
"54971","430440 CANELA",0,5,10,700,0,715,"2019"
"54972","430450 CANGUCU",2,0,5,517,2,526,"2019"
"54973","430460 CANOAS",26,17,94,4674,17,4828,"2019"
"54974","430461 CANUDOS DO VALE",0,0,0,12,0,12,"2019"
"54975","430462 CAPAO BONITO DO SUL",0,0,1,12,0,13,"2019"
"54976","430463 CAPAO DA CANOA",3,3,10,856,2,874,"2019"
"54977","430465 CAPAO DO CIPO",0,0,0,20,0,20,"2019"
"54978","430466 CAPAO DO LEAO",2,1,7,368,3,381,"2019"
"54979","430467 CAPIVARI DO SUL",0,1,0,52,0,53,"2019"
"54980","430468 CAPELA DE SANTANA",1,0,4,123,1,129,"2019"
"54981","430469 CAPITAO",0,0,0,36,0,36,"2019"
"54982","430470 CARAZINHO",2,2,11,811,4,830,"2019"
"54983","430471 CARAA",0,0,1,62,0,63,"2019"
"54984","430480 CARLOS BARBOSA",1,1,10,360,1,373,"2019"
"54985","430485 CARLOS GOMES",0,0,0,12,0,12,"2019"
"54986","430490 CASCA",0,0,2,91,0,93,"2019"
"54987","430495 CASEIROS",0,0,0,27,0,27,"2019"
"54988","430500 CATUIPE",0,0,2,78,0,80,"2019"
"54989","430510 CAXIAS DO SUL",13,19,100,5542,6,5680,"2019"
"54990","430511 CENTENARIO",0,0,0,25,0,25,"2019"
"54991","430512 CERRITO",0,0,0,42,0,42,"2019"
"54992","430513 CERRO BRANCO",0,0,0,22,0,22,"2019"
"54993","430515 CERRO GRANDE",0,0,0,29,0,29,"2019"
"54994","430517 CERRO GRANDE DO SUL",1,0,2,116,0,119,"2019"
"54995","430520 CERRO LARGO",0,0,0,113,1,114,"2019"
"54996","430530 CHAPADA",0,1,2,89,0,92,"2019"
"54997","430535 CHARQUEADAS",2,2,7,335,0,346,"2019"
"54998","430537 CHARRUA",0,0,1,31,0,32,"2019"
"54999","430540 CHIAPETTA",0,0,1,41,0,42,"2019"
"55000","430543 CHUI",0,2,1,37,0,40,"2019"
"55001","430544 CHUVISCA",0,0,0,61,0,61,"2019"
"55002","430545 CIDREIRA",3,1,3,193,2,202,"2019"
"55003","430550 CIRIACO",0,0,1,37,0,38,"2019"
"55004","430558 COLINAS",0,0,0,19,0,19,"2019"
"55005","430560 COLORADO",0,0,1,31,0,32,"2019"
"55006","430570 CONDOR",0,0,2,77,0,79,"2019"
"55007","430580 CONSTANTINA",0,1,0,153,0,154,"2019"
"55008","430583 COQUEIRO BAIXO",0,0,0,9,0,9,"2019"
"55009","430585 COQUEIROS DO SUL",0,0,1,18,0,19,"2019"
"55010","430587 CORONEL BARROS",0,0,1,30,0,31,"2019"
"55011","430590 CORONEL BICACO",0,0,2,79,2,83,"2019"
"55012","430593 CORONEL PILAR",0,0,0,9,0,9,"2019"
"55013","430595 COTIPORA",0,0,0,35,0,35,"2019"
"55014","430597 COXILHA",0,1,1,41,0,43,"2019"
"55015","430600 CRISSIUMAL",0,1,11,127,0,139,"2019"
"55016","430605 CRISTAL",0,0,3,82,0,85,"2019"
"55017","430607 CRISTAL DO SUL",0,0,0,30,0,30,"2019"
"55018","430610 CRUZ ALTA",1,1,13,786,0,801,"2019"
"55019","430613 CRUZALTENSE",0,0,0,13,0,13,"2019"
"55020","430620 CRUZEIRO DO SUL",0,0,0,114,1,115,"2019"
"55021","430630 DAVID CANABARRO",0,1,1,30,0,32,"2019"
"55022","430632 DERRUBADAS",0,0,0,26,0,26,"2019"
"55023","430635 DEZESSEIS DE NOVEMBRO",0,0,0,19,0,19,"2019"
"55024","430637 DILERMANDO DE AGUIAR",0,0,0,20,0,20,"2019"
"55025","430640 DOIS IRMAOS",0,0,7,352,0,359,"2019"
"55026","430642 DOIS IRMAOS DAS MISSOES",0,0,0,23,0,23,"2019"
"55027","430645 DOIS LAJEADOS",0,0,0,31,0,31,"2019"
"55028","430650 DOM FELICIANO",0,1,3,152,1,157,"2019"
"55029","430655 DOM PEDRO DE ALCANTARA",0,1,0,30,0,31,"2019"
"55030","430660 DOM PEDRITO",0,3,3,406,2,414,"2019"
"55031","430670 DONA FRANCISCA",0,0,1,37,0,38,"2019"
"55032","430673 DOUTOR MAURICIO CARDOSO",0,0,1,36,0,37,"2019"
"55033","430675 DOUTOR RICARDO",0,0,0,13,0,13,"2019"
"55034","430676 ELDORADO DO SUL",0,4,9,507,2,522,"2019"
"55035","430680 ENCANTADO",0,1,3,280,1,285,"2019"
"55036","430690 ENCRUZILHADA DO SUL",2,4,10,272,1,289,"2019"
"55037","430692 ENGENHO VELHO",0,0,1,22,0,23,"2019"
"55038","430693 ENTRE-IJUIS",0,2,2,102,2,108,"2019"
"55039","430695 ENTRE RIOS DO SUL",0,0,0,28,0,28,"2019"
"55040","430697 EREBANGO",0,0,0,36,0,36,"2019"
"55041","430700 ERECHIM",5,1,24,1247,3,1280,"2019"
"55042","430705 ERNESTINA",0,0,0,23,0,23,"2019"
"55043","430710 HERVAL",0,0,1,62,0,63,"2019"
"55044","430720 ERVAL GRANDE",0,1,0,62,0,63,"2019"
"55045","430730 ERVAL SECO",1,1,3,82,0,87,"2019"
"55046","430740 ESMERALDA",0,0,0,39,0,39,"2019"
"55047","430745 ESPERANCA DO SUL",0,0,1,25,0,26,"2019"
"55048","430750 ESPUMOSO",0,1,0,182,0,183,"2019"
"55049","430755 ESTACAO",0,0,2,77,0,79,"2019"
"55050","430760 ESTANCIA VELHA",0,0,13,539,0,552,"2019"
"55051","430770 ESTEIO",4,5,21,1031,1,1062,"2019"
"55052","430780 ESTRELA",1,1,5,402,0,409,"2019"
"55053","430781 ESTRELA VELHA",0,0,0,36,0,36,"2019"
"55054","430783 EUGENIO DE CASTRO",0,0,0,25,0,25,"2019"
"55055","430786 FAGUNDES VARELA",0,0,0,19,0,19,"2019"
"55056","430790 FARROUPILHA",0,2,25,821,0,848,"2019"
"55057","430800 FAXINAL DO SOTURNO",3,0,1,67,1,72,"2019"
"55058","430805 FAXINALZINHO",0,0,0,28,0,28,"2019"
"55059","430807 FAZENDA VILANOVA",0,1,0,51,0,52,"2019"
"55060","430810 FELIZ",0,0,1,146,0,147,"2019"
"55061","430820 FLORES DA CUNHA",0,1,3,373,0,377,"2019"
"55062","430825 FLORIANO PEIXOTO",0,0,0,19,0,19,"2019"
"55063","430830 FONTOURA XAVIER",0,0,1,89,0,90,"2019"
"55064","430840 FORMIGUEIRO",2,1,2,82,1,88,"2019"
"55065","430843 FORQUETINHA",0,0,0,14,0,14,"2019"
"55066","430845 FORTALEZA DOS VALOS",0,0,0,57,0,57,"2019"
"55067","430850 FREDERICO WESTPHALEN",1,4,2,453,0,460,"2019"
"55068","430860 GARIBALDI",1,1,5,372,0,379,"2019"
"55069","430865 GARRUCHOS",0,1,1,21,0,23,"2019"
"55070","430870 GAURAMA",0,0,2,53,0,55,"2019"
"55071","430880 GENERAL CAMARA",0,0,2,80,0,82,"2019"
"55072","430885 GENTIL",0,0,0,18,0,18,"2019"
"55073","430890 GETULIO VARGAS",0,1,2,165,0,168,"2019"
"55074","430900 GIRUA",1,0,5,182,0,188,"2019"
"55075","430905 GLORINHA",0,0,2,95,0,97,"2019"
"55076","430910 GRAMADO",1,1,5,597,0,604,"2019"
"55077","430912 GRAMADO DOS LOUREIROS",0,0,0,44,0,44,"2019"
"55078","430915 GRAMADO XAVIER",0,0,4,42,1,47,"2019"
"55079","430920 GRAVATAI",7,12,46,3250,7,3322,"2019"
"55080","430925 GUABIJU",0,0,1,18,0,19,"2019"
"55081","430930 GUAIBA",2,6,19,1126,7,1160,"2019"
"55082","430940 GUAPORE",1,1,5,319,0,326,"2019"
"55083","430950 GUARANI DAS MISSOES",0,0,3,64,0,67,"2019"
"55084","430955 HARMONIA",0,0,0,65,0,65,"2019"
"55085","430957 HERVEIRAS",1,0,0,44,0,45,"2019"
"55086","430960 HORIZONTINA",0,0,3,242,2,247,"2019"
"55087","430965 HULHA NEGRA",0,1,0,60,0,61,"2019"
"55088","430970 HUMAITA",0,0,0,43,0,43,"2019"
"55089","430975 IBARAMA",0,0,0,37,0,37,"2019"
"55090","430980 IBIACA",0,0,0,45,0,45,"2019"
"55091","430990 IBIRAIARAS",1,0,0,69,0,70,"2019"
"55092","430995 IBIRAPUITA",0,1,0,47,0,48,"2019"
"55093","431000 IBIRUBA",0,2,0,271,0,273,"2019"
"55094","431010 IGREJINHA",0,1,5,482,1,489,"2019"
"55095","431020 IJUI",1,5,19,1026,1,1052,"2019"
"55096","431030 ILOPOLIS",0,0,1,47,0,48,"2019"
"55097","431033 IMBE",0,1,4,282,2,289,"2019"
"55098","431036 IMIGRANTE",0,0,0,28,0,28,"2019"
"55099","431040 INDEPENDENCIA",2,0,1,58,0,61,"2019"
"55100","431041 INHACORA",0,0,0,38,0,38,"2019"
"55101","431043 IPE",0,0,0,56,0,56,"2019"
"55102","431046 IPIRANGA DO SUL",0,0,0,20,0,20,"2019"
"55103","431050 IRAI",0,0,0,90,0,90,"2019"
"55104","431053 ITAARA",0,0,0,63,1,64,"2019"
"55105","431055 ITACURUBI",0,0,1,22,0,23,"2019"
"55106","431057 ITAPUCA",1,0,0,23,0,24,"2019"
"55107","431060 ITAQUI",0,4,6,478,1,489,"2019"
"55108","431065 ITATI",0,0,0,28,0,28,"2019"
"55109","431070 ITATIBA DO SUL",0,0,2,27,1,30,"2019"
"55110","431075 IVORA",0,0,0,14,0,14,"2019"
"55111","431080 IVOTI",1,0,4,234,0,239,"2019"
"55112","431085 JABOTICABA",0,0,0,27,0,27,"2019"
"55113","431087 JACUIZINHO",0,0,0,15,0,15,"2019"
"55114","431090 JACUTINGA",0,0,1,40,0,41,"2019"
"55115","431100 JAGUARAO",3,3,3,297,0,306,"2019"
"55116","431110 JAGUARI",0,1,0,70,0,71,"2019"
"55117","431112 JAQUIRANA",0,0,0,60,0,60,"2019"
"55118","431113 JARI",0,0,0,40,0,40,"2019"
"55119","431115 JOIA",0,0,4,79,0,83,"2019"
"55120","431120 JULIO DE CASTILHOS",1,1,4,227,3,236,"2019"
"55121","431123 LAGOA BONITA DO SUL",0,1,0,18,0,19,"2019"
"55122","431125 LAGOAO",0,0,0,50,0,50,"2019"
"55123","431127 LAGOA DOS TRES CANTOS",0,0,0,13,0,13,"2019"
"55124","431130 LAGOA VERMELHA",0,2,3,353,0,358,"2019"
"55125","431140 LAJEADO",0,2,13,1251,0,1266,"2019"
"55126","431142 LAJEADO DO BUGRE",0,0,0,35,0,35,"2019"
"55127","431150 LAVRAS DO SUL",0,1,2,76,2,81,"2019"
"55128","431160 LIBERATO SALZANO",0,0,0,56,0,56,"2019"
"55129","431162 LINDOLFO COLLOR",0,0,3,66,0,69,"2019"
"55130","431164 LINHA NOVA",0,0,0,4,0,4,"2019"
"55131","431170 MACHADINHO",0,1,0,67,0,68,"2019"
"55132","431171 MACAMBARA",0,0,0,57,0,57,"2019"
"55133","431173 MAMPITUBA",0,0,0,42,0,42,"2019"
"55134","431175 MANOEL VIANA",1,1,0,63,0,65,"2019"
"55135","431177 MAQUINE",0,0,0,66,1,67,"2019"
"55136","431179 MARATA",0,0,0,26,0,26,"2019"
"55137","431180 MARAU",2,2,6,499,1,510,"2019"
"55138","431190 MARCELINO RAMOS",0,0,1,36,1,38,"2019"
"55139","431198 MARIANA PIMENTEL",0,0,0,27,6,33,"2019"
"55140","431200 MARIANO MORO",0,0,0,24,0,24,"2019"
"55141","431205 MARQUES DE SOUZA",0,0,1,31,0,32,"2019"
"55142","431210 MATA",0,0,1,47,0,48,"2019"
"55143","431213 MATO CASTELHANO",0,0,1,28,0,29,"2019"
"55144","431215 MATO LEITAO",0,1,0,45,0,46,"2019"
"55145","431217 MATO QUEIMADO",0,0,0,14,0,14,"2019"
"55146","431220 MAXIMILIANO DE ALMEIDA",0,0,0,50,0,50,"2019"
"55147","431225 MINAS DO LEAO",0,0,0,99,0,99,"2019"
"55148","431230 MIRAGUAI",1,0,0,66,1,68,"2019"
"55149","431235 MONTAURI",0,0,1,18,0,19,"2019"
"55150","431237 MONTE ALEGRE DOS CAMPOS",0,0,0,39,0,39,"2019"
"55151","431238 MONTE BELO DO SUL",0,0,1,23,0,24,"2019"
"55152","431240 MONTENEGRO",0,4,7,862,0,873,"2019"
"55153","431242 MORMACO",0,0,0,31,0,31,"2019"
"55154","431244 MORRINHOS DO SUL",0,1,0,23,0,24,"2019"
"55155","431245 MORRO REDONDO",0,0,2,46,0,48,"2019"
"55156","431247 MORRO REUTER",0,0,1,60,0,61,"2019"
"55157","431250 MOSTARDAS",0,0,5,141,0,146,"2019"
"55158","431260 MUCUM",0,0,1,46,0,47,"2019"
"55159","431261 MUITOS CAPOES",0,0,1,27,0,28,"2019"
"55160","431262 MULITERNO",0,0,0,19,0,19,"2019"
"55161","431265 NAO-ME-TOQUE",0,0,0,234,0,234,"2019"
"55162","431267 NICOLAU VERGUEIRO",0,1,0,22,0,23,"2019"
"55163","431270 NONOAI",0,1,1,179,0,181,"2019"
"55164","431275 NOVA ALVORADA",0,0,0,36,0,36,"2019"
"55165","431280 NOVA ARACA",0,0,0,74,0,74,"2019"
"55166","431290 NOVA BASSANO",1,1,1,80,0,83,"2019"
"55167","431295 NOVA BOA VISTA",0,0,0,19,0,19,"2019"
"55168","431300 NOVA BRESCIA",0,0,1,27,0,28,"2019"
"55169","431301 NOVA CANDELARIA",0,1,0,43,0,44,"2019"
"55170","431303 NOVA ESPERANCA DO SUL",0,0,1,44,0,45,"2019"
"55171","431306 NOVA HARTZ",0,0,5,238,0,243,"2019"
"55172","431308 NOVA PADUA",0,0,0,23,0,23,"2019"
"55173","431310 NOVA PALMA",0,0,0,57,0,57,"2019"
"55174","431320 NOVA PETROPOLIS",0,0,2,239,0,241,"2019"
"55175","431330 NOVA PRATA",0,1,2,325,0,328,"2019"
"55176","431333 NOVA RAMADA",0,0,0,12,0,12,"2019"
"55177","431335 NOVA ROMA DO SUL",0,0,0,20,0,20,"2019"
"55178","431337 NOVA SANTA RITA",3,2,6,352,0,363,"2019"
"55179","431339 NOVO CABRAIS",0,0,0,34,0,34,"2019"
"55180","431340 NOVO HAMBURGO",5,7,58,3011,4,3085,"2019"
"55181","431342 NOVO MACHADO",0,0,0,20,0,20,"2019"
"55182","431344 NOVO TIRADENTES",0,0,0,19,0,19,"2019"
"55183","431346 NOVO XINGU",0,1,0,19,0,20,"2019"
"55184","431349 NOVO BARREIRO",0,0,1,41,2,44,"2019"
"55185","431350 OSORIO",1,3,7,568,0,579,"2019"
"55186","431360 PAIM FILHO",2,0,0,26,0,28,"2019"
"55187","431365 PALMARES DO SUL",0,0,3,125,0,128,"2019"
"55188","431370 PALMEIRA DAS MISSOES",3,2,6,485,1,497,"2019"
"55189","431380 PALMITINHO",0,0,2,81,0,83,"2019"
"55190","431390 PANAMBI",1,1,7,560,0,569,"2019"
"55191","431395 PANTANO GRANDE",0,0,4,111,1,116,"2019"
"55192","431400 PARAI",1,0,1,63,1,66,"2019"
"55193","431402 PARAISO DO SUL",0,1,0,55,0,56,"2019"
"55194","431403 PARECI NOVO",0,0,2,50,0,52,"2019"
"55195","431405 PAROBE",2,5,18,729,0,754,"2019"
"55196","431406 PASSA SETE",0,0,0,38,1,39,"2019"
"55197","431407 PASSO DO SOBRADO",1,0,0,59,0,60,"2019"
"55198","431410 PASSO FUNDO",3,11,34,2773,4,2825,"2019"
"55199","431413 PAULO BENTO",0,1,0,26,0,27,"2019"
"55200","431415 PAVERAMA",0,0,1,81,0,82,"2019"
"55201","431417 PEDRAS ALTAS",0,0,0,19,1,20,"2019"
"55202","431420 PEDRO OSORIO",0,0,0,76,1,77,"2019"
"55203","431430 PEJUCARA",0,0,0,46,0,46,"2019"
"55204","431440 PELOTAS",18,28,120,3809,11,3986,"2019"
"55205","431442 PICADA CAFE",0,0,3,57,1,61,"2019"
"55206","431445 PINHAL",0,1,0,30,0,31,"2019"
"55207","431446 PINHAL DA SERRA",0,0,0,22,0,22,"2019"
"55208","431447 PINHAL GRANDE",1,0,0,31,0,32,"2019"
"55209","431449 PINHEIRINHO DO VALE",0,0,0,44,0,44,"2019"
"55210","431450 PINHEIRO MACHADO",0,1,4,93,2,100,"2019"
"55211","431454 PINTO BANDEIRA",0,0,1,28,0,29,"2019"
"55212","431455 PIRAPO",0,0,0,15,0,15,"2019"
"55213","431460 PIRATINI",1,2,7,138,2,150,"2019"
"55214","431470 PLANALTO",0,1,0,103,1,105,"2019"
"55215","431475 POCO DAS ANTAS",0,0,0,26,0,26,"2019"
"55216","431477 PONTAO",0,1,0,45,0,46,"2019"
"55217","431478 PONTE PRETA",1,0,0,15,0,16,"2019"
"55218","431480 PORTAO",1,1,4,337,1,344,"2019"
"55219","431490 PORTO ALEGRE",39,62,340,16021,58,16520,"2019"
"55220","431500 PORTO LUCENA",0,0,0,32,0,32,"2019"
"55221","431505 PORTO MAUA",0,0,0,17,0,17,"2019"
"55222","431507 PORTO VERA CRUZ",0,0,0,17,0,17,"2019"
"55223","431510 PORTO XAVIER",0,0,3,129,0,132,"2019"
"55224","431513 POUSO NOVO",0,0,0,20,0,20,"2019"
"55225","431514 PRESIDENTE LUCENA",0,0,0,24,0,24,"2019"
"55226","431515 PROGRESSO",0,2,0,55,1,58,"2019"
"55227","431517 PROTASIO ALVES",0,0,0,14,0,14,"2019"
"55228","431520 PUTINGA",0,0,0,30,0,30,"2019"
"55229","431530 QUARAI",0,1,2,253,0,256,"2019"
"55230","431531 QUATRO IRMAOS",0,0,1,18,0,19,"2019"
"55231","431532 QUEVEDOS",0,0,0,24,0,24,"2019"
"55232","431535 QUINZE DE NOVEMBRO",0,0,0,40,0,40,"2019"
"55233","431540 REDENTORA",1,0,2,188,1,192,"2019"
"55234","431545 RELVADO",0,0,1,20,0,21,"2019"
"55235","431550 RESTINGA SECA",1,0,1,164,0,166,"2019"
"55236","431555 RIO DOS INDIOS",0,0,0,21,0,21,"2019"
"55237","431560 RIO GRANDE",4,10,62,2423,22,2521,"2019"
"55238","431570 RIO PARDO",1,2,9,370,0,382,"2019"
"55239","431575 RIOZINHO",0,0,2,47,0,49,"2019"
"55240","431580 ROCA SALES",0,1,0,123,1,125,"2019"
"55241","431590 RODEIO BONITO",0,0,0,97,0,97,"2019"
"55242","431595 ROLADOR",0,0,0,17,0,17,"2019"
"55243","431600 ROLANTE",1,0,4,253,0,258,"2019"
"55244","431610 RONDA ALTA",0,0,2,119,0,121,"2019"
"55245","431620 RONDINHA",0,1,1,39,0,41,"2019"
"55246","431630 ROQUE GONZALES",1,0,0,66,0,67,"2019"
"55247","431640 ROSARIO DO SUL",0,4,9,472,0,485,"2019"
"55248","431642 SAGRADA FAMILIA",0,0,0,19,0,19,"2019"
"55249","431643 SALDANHA MARINHO",0,0,0,32,0,32,"2019"
"55250","431645 SALTO DO JACUI",0,1,1,124,0,126,"2019"
"55251","431647 SALVADOR DAS MISSOES",0,0,0,20,0,20,"2019"
"55252","431650 SALVADOR DO SUL",0,1,2,70,0,73,"2019"
"55253","431660 SANANDUVA",1,0,1,160,0,162,"2019"
"55254","431670 SANTA BARBARA DO SUL",1,1,1,78,0,81,"2019"
"55255","431673 SANTA CECILIA DO SUL",0,0,0,20,0,20,"2019"
"55256","431675 SANTA CLARA DO SUL",0,0,3,68,0,71,"2019"
"55257","431680 SANTA CRUZ DO SUL",3,8,25,1574,3,1613,"2019"
"55258","431690 SANTA MARIA",9,13,55,3369,8,3454,"2019"
"55259","431695 SANTA MARIA DO HERVAL",0,0,0,53,0,53,"2019"
"55260","431697 SANTA MARGARIDA DO SUL",0,0,0,23,0,23,"2019"
"55261","431700 SANTANA DA BOA VISTA",0,1,3,62,3,69,"2019"
"55262","431710 SANT'ANA DO LIVRAMENTO",1,5,8,1054,12,1080,"2019"
"55263","431720 SANTA ROSA",2,2,29,1022,5,1060,"2019"
"55264","431725 SANTA TEREZA",0,0,1,11,0,12,"2019"
"55265","431730 SANTA VITORIA DO PALMAR",0,3,10,361,0,374,"2019"
"55266","431740 SANTIAGO",3,0,2,589,1,595,"2019"
"55267","431750 SANTO ANGELO",1,2,10,1084,1,1098,"2019"
"55268","431755 SANTO ANTONIO DO PALMA",0,0,0,21,0,21,"2019"
"55269","431760 SANTO ANTONIO DA PATRULHA",0,1,7,433,2,443,"2019"
"55270","431770 SANTO ANTONIO DAS MISSOES",0,0,0,108,0,108,"2019"
"55271","431775 SANTO ANTONIO DO PLANALTO",0,0,0,22,1,23,"2019"
"55272","431780 SANTO AUGUSTO",0,0,2,167,1,170,"2019"
"55273","431790 SANTO CRISTO",0,0,7,164,0,171,"2019"
"55274","431795 SANTO EXPEDITO DO SUL",0,0,0,14,0,14,"2019"
"55275","431800 SAO BORJA",1,1,5,804,1,812,"2019"
"55276","431805 SAO DOMINGOS DO SUL",0,0,0,28,0,28,"2019"
"55277","431810 SAO FRANCISCO DE ASSIS",0,1,3,170,0,174,"2019"
"55278","431820 SAO FRANCISCO DE PAULA",0,2,2,263,2,269,"2019"
"55279","431830 SAO GABRIEL",0,3,13,775,1,792,"2019"
"55280","431840 SAO JERONIMO",1,0,2,291,0,294,"2019"
"55281","431842 SAO JOAO DA URTIGA",0,0,1,38,0,39,"2019"
"55282","431843 SAO JOAO DO POLESINE",0,0,1,27,0,28,"2019"
"55283","431844 SAO JORGE",0,0,0,22,0,22,"2019"
"55284","431845 SAO JOSE DAS MISSOES",0,0,0,21,0,21,"2019"
"55285","431846 SAO JOSE DO HERVAL",0,0,0,20,0,20,"2019"
"55286","431848 SAO JOSE DO HORTENCIO",0,0,0,40,0,40,"2019"
"55287","431849 SAO JOSE DO INHACORA",0,0,0,17,0,17,"2019"
"55288","431850 SAO JOSE DO NORTE",1,1,8,258,3,271,"2019"
"55289","431860 SAO JOSE DO OURO",0,1,0,72,0,73,"2019"
"55290","431861 SAO JOSE DO SUL",0,1,0,28,0,29,"2019"
"55291","431862 SAO JOSE DOS AUSENTES",0,0,1,66,0,67,"2019"
"55292","431870 SAO LEOPOLDO",4,9,50,2643,4,2710,"2019"
"55293","431880 SAO LOURENCO DO SUL",1,1,4,390,0,396,"2019"
"55294","431890 SAO LUIZ GONZAGA",0,1,2,518,0,521,"2019"
"55295","431900 SAO MARCOS",0,0,4,236,1,241,"2019"
"55296","431910 SAO MARTINHO",0,0,2,54,0,56,"2019"
"55297","431912 SAO MARTINHO DA SERRA",0,0,0,29,0,29,"2019"
"55298","431915 SAO MIGUEL DAS MISSOES",0,0,2,71,0,73,"2019"
"55299","431920 SAO NICOLAU",0,0,0,54,0,54,"2019"
"55300","431930 SAO PAULO DAS MISSOES",0,0,1,45,0,46,"2019"
"55301","431935 SAO PEDRO DA SERRA",0,0,0,31,0,31,"2019"
"55302","431936 SAO PEDRO DAS MISSOES",0,0,1,17,0,18,"2019"
"55303","431937 SAO PEDRO DO BUTIA",0,0,0,36,0,36,"2019"
"55304","431940 SAO PEDRO DO SUL",2,0,5,174,0,181,"2019"
"55305","431950 SAO SEBASTIAO DO CAI",0,2,3,292,1,298,"2019"
"55306","431960 SAO SEPE",0,1,2,243,1,247,"2019"
"55307","431970 SAO VALENTIM",0,1,0,30,0,31,"2019"
"55308","431971 SAO VALENTIM DO SUL",0,0,0,14,0,14,"2019"
"55309","431973 SAO VALERIO DO SUL",1,0,0,36,0,37,"2019"
"55310","431975 SAO VENDELINO",0,0,0,23,0,23,"2019"
"55311","431980 SAO VICENTE DO SUL",0,0,2,77,0,79,"2019"
"55312","431990 SAPIRANGA",0,4,12,1158,0,1174,"2019"
"55313","432000 SAPUCAIA DO SUL",3,8,27,1511,2,1551,"2019"
"55314","432010 SARANDI",0,2,1,321,0,324,"2019"
"55315","432020 SEBERI",1,1,2,180,0,184,"2019"
"55316","432023 SEDE NOVA",0,0,1,36,1,38,"2019"
"55317","432026 SEGREDO",0,0,0,71,0,71,"2019"
"55318","432030 SELBACH",0,0,0,44,0,44,"2019"
"55319","432032 SENADOR SALGADO FILHO",0,0,2,28,0,30,"2019"
"55320","432035 SENTINELA DO SUL",0,0,0,39,1,40,"2019"
"55321","432040 SERAFINA CORREA",2,0,5,194,1,202,"2019"
"55322","432045 SERIO",0,0,0,14,0,14,"2019"
"55323","432050 SERTAO",0,0,2,59,0,61,"2019"
"55324","432055 SERTAO SANTANA",0,0,1,46,0,47,"2019"
"55325","432057 SETE DE SETEMBRO",0,0,1,18,0,19,"2019"
"55326","432060 SEVERIANO DE ALMEIDA",0,0,0,31,1,32,"2019"
"55327","432065 SILVEIRA MARTINS",0,0,0,9,0,9,"2019"
"55328","432067 SINIMBU",0,0,0,77,0,77,"2019"
"55329","432070 SOBRADINHO",0,0,1,211,2,214,"2019"
"55330","432080 SOLEDADE",0,0,2,347,1,350,"2019"
"55331","432085 TABAI",0,0,1,50,0,51,"2019"
"55332","432090 TAPEJARA",2,0,6,337,1,346,"2019"
"55333","432100 TAPERA",0,1,1,111,0,113,"2019"
"55334","432110 TAPES",0,3,5,136,0,144,"2019"
"55335","432120 TAQUARA",0,3,10,622,2,637,"2019"
"55336","432130 TAQUARI",1,1,7,223,1,233,"2019"
"55337","432132 TAQUARUCU DO SUL",0,0,1,40,0,41,"2019"
"55338","432135 TAVARES",0,0,0,49,0,49,"2019"
"55339","432140 TENENTE PORTELA",0,1,1,207,0,209,"2019"
"55340","432143 TERRA DE AREIA",0,2,1,127,1,131,"2019"
"55341","432145 TEUTONIA",0,0,3,412,0,415,"2019"
"55342","432146 TIO HUGO",0,0,0,31,0,31,"2019"
"55343","432147 TIRADENTES DO SUL",2,1,2,60,0,65,"2019"
"55344","432149 TOROPI",0,1,2,17,0,20,"2019"
"55345","432150 TORRES",1,2,6,558,1,568,"2019"
"55346","432160 TRAMANDAI",2,1,12,741,5,761,"2019"
"55347","432162 TRAVESSEIRO",0,0,0,11,0,11,"2019"
"55348","432163 TRES ARROIOS",0,0,0,14,0,14,"2019"
"55349","432166 TRES CACHOEIRAS",0,0,1,134,0,135,"2019"
"55350","432170 TRES COROAS",1,0,2,309,0,312,"2019"
"55351","432180 TRES DE MAIO",0,0,2,297,0,299,"2019"
"55352","432183 TRES FORQUILHAS",0,0,0,27,0,27,"2019"
"55353","432185 TRES PALMEIRAS",0,0,2,54,0,56,"2019"
"55354","432190 TRES PASSOS",0,1,8,289,0,298,"2019"
"55355","432195 TRINDADE DO SUL",0,0,4,84,0,88,"2019"
"55356","432200 TRIUNFO",0,2,3,336,0,341,"2019"
"55357","432210 TUCUNDUVA",0,0,0,44,0,44,"2019"
"55358","432215 TUNAS",0,0,0,41,0,41,"2019"
"55359","432218 TUPANCI DO SUL",0,0,0,10,0,10,"2019"
"55360","432220 TUPANCIRETA",1,0,10,231,2,244,"2019"
"55361","432225 TUPANDI",0,1,1,74,0,76,"2019"
"55362","432230 TUPARENDI",0,0,1,70,0,71,"2019"
"55363","432232 TURUCU",0,0,0,30,0,30,"2019"
"55364","432234 UBIRETAMA",0,0,0,14,0,14,"2019"
"55365","432235 UNIAO DA SERRA",0,0,0,8,0,8,"2019"
"55366","432237 UNISTALDA",0,0,0,28,0,28,"2019"
"55367","432240 URUGUAIANA",1,7,14,508,1193,1723,"2019"
"55368","432250 VACARIA",7,5,13,908,10,943,"2019"
"55369","432252 VALE VERDE",0,0,0,25,0,25,"2019"
"55370","432253 VALE DO SOL",0,0,3,86,0,89,"2019"
"55371","432254 VALE REAL",0,1,2,62,0,65,"2019"
"55372","432255 VANINI",0,0,0,19,0,19,"2019"
"55373","432260 VENANCIO AIRES",2,3,12,789,2,808,"2019"
"55374","432270 VERA CRUZ",0,2,5,264,0,271,"2019"
"55375","432280 VERANOPOLIS",0,1,5,263,0,269,"2019"
"55376","432285 VESPASIANO CORREA",1,0,1,9,0,11,"2019"
"55377","432290 VIADUTOS",0,1,0,44,0,45,"2019"
"55378","432300 VIAMAO",7,14,58,2630,30,2739,"2019"
"55379","432310 VICENTE DUTRA",0,0,1,65,0,66,"2019"
"55380","432320 VICTOR GRAEFF",0,0,0,25,0,25,"2019"
"55381","432330 VILA FLORES",0,0,0,32,0,32,"2019"
"55382","432335 VILA LANGARO",0,0,0,25,0,25,"2019"
"55383","432340 VILA MARIA",0,0,1,44,0,45,"2019"
"55384","432345 VILA NOVA DO SUL",1,0,0,30,0,31,"2019"
"55385","432350 VISTA ALEGRE",0,1,0,37,0,38,"2019"
"55386","432360 VISTA ALEGRE DO PRATA",0,0,1,17,0,18,"2019"
"55387","432370 VISTA GAUCHA",0,0,0,28,0,28,"2019"
"55388","432375 VITORIA DAS MISSOES",0,0,0,33,0,33,"2019"
"55389","432377 WESTFALIA",0,0,1,27,0,28,"2019"
"55390","432380 XANGRI-LA",1,4,0,240,1,246,"2019"
"55391","500020 AGUA CLARA",2,1,3,283,0,289,"2019"
"55392","500025 ALCINOPOLIS",1,1,2,41,0,45,"2019"
"55393","500060 AMAMBAI",3,0,7,598,1,609,"2019"
"55394","500070 ANASTACIO",1,0,4,416,2,423,"2019"
"55395","500080 ANAURILANDIA",0,0,2,79,0,81,"2019"
"55396","500085 ANGELICA",0,0,2,161,0,163,"2019"
"55397","500090 ANTONIO JOAO",1,1,3,157,1,163,"2019"
"55398","500100 APARECIDA DO TABOADO",0,1,1,328,1,331,"2019"
"55399","500110 AQUIDAUANA",3,2,4,743,2,754,"2019"
"55400","500124 ARAL MOREIRA",1,4,16,131,3,155,"2019"
"55401","500150 BANDEIRANTES",0,1,0,93,2,96,"2019"
"55402","500190 BATAGUASSU",2,0,2,431,3,438,"2019"
"55403","500200 BATAYPORA",0,2,0,136,0,138,"2019"
"55404","500210 BELA VISTA",0,0,1,400,0,401,"2019"
"55405","500215 BODOQUENA",0,1,0,139,1,141,"2019"
"55406","500220 BONITO",0,1,5,352,0,358,"2019"
"55407","500230 BRASILANDIA",0,0,7,158,0,165,"2019"
"55408","500240 CAARAPO",2,6,4,542,2,556,"2019"
"55409","500260 CAMAPUA",0,0,1,175,1,177,"2019"
"55410","500270 CAMPO GRANDE",15,20,135,13830,39,14039,"2019"
"55411","500280 CARACOL",1,0,0,73,0,74,"2019"
"55412","500290 CASSILANDIA",0,0,4,235,0,239,"2019"
"55413","500295 CHAPADAO DO SUL",2,0,7,467,0,476,"2019"
"55414","500310 CORGUINHO",0,0,0,42,0,42,"2019"
"55415","500315 CORONEL SAPUCAIA",1,0,4,297,18,320,"2019"
"55416","500320 CORUMBA",6,4,13,1752,2,1777,"2019"
"55417","500325 COSTA RICA",1,1,3,474,0,479,"2019"
"55418","500330 COXIM",2,2,5,500,1,510,"2019"
"55419","500345 DEODAPOLIS",0,1,4,161,0,166,"2019"
"55420","500348 DOIS IRMAOS DO BURITI",1,0,3,134,0,138,"2019"
"55421","500350 DOURADINA",0,0,0,66,1,67,"2019"
"55422","500370 DOURADOS",11,18,58,3960,28,4075,"2019"
"55423","500375 ELDORADO",0,0,1,175,0,176,"2019"
"55424","500380 FATIMA DO SUL",2,0,4,292,0,298,"2019"
"55425","500390 FIGUEIRAO",0,0,0,32,0,32,"2019"
"55426","500400 GLORIA DE DOURADOS",0,0,1,135,0,136,"2019"
"55427","500410 GUIA LOPES DA LAGUNA",0,0,1,131,0,132,"2019"
"55428","500430 IGUATEMI",0,0,8,233,3,244,"2019"
"55429","500440 INOCENCIA",0,1,0,122,1,124,"2019"
"55430","500450 ITAPORA",1,0,1,248,0,250,"2019"
"55431","500460 ITAQUIRAI",0,5,3,264,1,273,"2019"
"55432","500470 IVINHEMA",0,1,5,439,0,445,"2019"
"55433","500480 JAPORA",0,0,9,156,3,168,"2019"
"55434","500490 JARAGUARI",0,1,1,42,0,44,"2019"
"55435","500500 JARDIM",1,0,0,388,1,390,"2019"
"55436","500510 JATEI",0,0,0,53,0,53,"2019"
"55437","500515 JUTI",0,1,0,104,1,106,"2019"
"55438","500520 LADARIO",2,2,2,356,0,362,"2019"
"55439","500525 LAGUNA CARAPA",2,2,0,104,1,109,"2019"
"55440","500540 MARACAJU",1,2,5,816,1,825,"2019"
"55441","500560 MIRANDA",0,4,1,462,0,467,"2019"
"55442","500568 MUNDO NOVO",1,2,46,273,0,322,"2019"
"55443","500570 NAVIRAI",4,2,14,856,0,876,"2019"
"55444","500580 NIOAQUE",1,1,2,177,2,183,"2019"
"55445","500600 NOVA ALVORADA DO SUL",0,1,5,342,0,348,"2019"
"55446","500620 NOVA ANDRADINA",4,2,1,788,1,796,"2019"
"55447","500625 NOVO HORIZONTE DO SUL",0,1,0,70,0,71,"2019"
"55448","500627 PARAISO DAS AGUAS",0,1,0,71,0,72,"2019"
"55449","500630 PARANAIBA",1,2,5,610,1,619,"2019"
"55450","500635 PARANHOS",0,0,5,268,43,316,"2019"
"55451","500640 PEDRO GOMES",0,0,2,89,0,91,"2019"
"55452","500660 PONTA PORA",1,6,30,1639,10,1686,"2019"
"55453","500690 PORTO MURTINHO",0,1,2,210,2,215,"2019"
"55454","500710 RIBAS DO RIO PARDO",0,2,4,292,0,298,"2019"
"55455","500720 RIO BRILHANTE",1,2,7,638,0,648,"2019"
"55456","500730 RIO NEGRO",0,0,0,53,0,53,"2019"
"55457","500740 RIO VERDE DE MATO GROSSO",1,1,3,296,0,301,"2019"
"55458","500750 ROCHEDO",0,0,1,71,0,72,"2019"
"55459","500755 SANTA RITA DO PARDO",0,0,0,25,2,27,"2019"
"55460","500769 SAO GABRIEL DO OESTE",1,2,7,521,1,532,"2019"
"55461","500770 SETE QUEDAS",0,0,4,135,1,140,"2019"
"55462","500780 SELVIRIA",0,1,0,73,0,74,"2019"
"55463","500790 SIDROLANDIA",0,1,6,698,4,709,"2019"
"55464","500793 SONORA",0,1,2,256,1,260,"2019"
"55465","500795 TACURU",1,0,0,181,3,185,"2019"
"55466","500797 TAQUARUSSU",0,0,1,35,0,36,"2019"
"55467","500800 TERENOS",0,1,1,181,1,184,"2019"
"55468","500830 TRES LAGOAS",2,6,24,1950,2,1984,"2019"
"55469","500840 VICENTINA",0,0,0,77,1,78,"2019"
"55470","510010 ACORIZAL",0,0,1,72,0,73,"2019"
"55471","510020 AGUA BOA",1,0,4,394,16,415,"2019"
"55472","510025 ALTA FLORESTA",2,3,11,940,0,956,"2019"
"55473","510030 ALTO ARAGUAIA",0,1,1,186,2,190,"2019"
"55474","510035 ALTO BOA VISTA",0,0,0,44,37,81,"2019"
"55475","510040 ALTO GARCAS",0,1,1,144,3,149,"2019"
"55476","510050 ALTO PARAGUAI",2,0,0,81,0,83,"2019"
"55477","510060 ALTO TAQUARI",0,1,1,184,0,186,"2019"
"55478","510080 APIACAS",0,0,0,94,1,95,"2019"
"55479","510100 ARAGUAIANA",0,0,0,32,0,32,"2019"
"55480","510120 ARAGUAINHA",0,0,0,5,0,5,"2019"
"55481","510125 ARAPUTANGA",0,0,2,255,0,257,"2019"
"55482","510130 ARENAPOLIS",0,2,0,136,0,138,"2019"
"55483","510140 ARIPUANA",0,2,1,359,1,363,"2019"
"55484","510160 BARAO DE MELGACO",0,0,0,69,0,69,"2019"
"55485","510170 BARRA DO BUGRES",0,2,7,517,1,527,"2019"
"55486","510180 BARRA DO GARCAS",1,1,4,1141,5,1152,"2019"
"55487","510185 BOM JESUS DO ARAGUAIA",0,1,0,98,0,99,"2019"
"55488","510190 BRASNORTE",0,4,4,297,30,335,"2019"
"55489","510250 CACERES",5,6,15,1633,4,1663,"2019"
"55490","510260 CAMPINAPOLIS",1,0,14,279,160,454,"2019"
"55491","510263 CAMPO NOVO DO PARECIS",4,3,16,721,2,746,"2019"
"55492","510267 CAMPO VERDE",3,1,8,747,1,760,"2019"
"55493","510268 CAMPOS DE JULIO",0,0,2,124,0,126,"2019"
"55494","510269 CANABRAVA DO NORTE",0,0,2,61,0,63,"2019"
"55495","510270 CANARANA",4,0,3,378,35,420,"2019"
"55496","510279 CARLINDA",0,0,3,131,0,134,"2019"
"55497","510285 CASTANHEIRA",0,1,1,99,0,101,"2019"
"55498","510300 CHAPADA DOS GUIMARAES",0,1,3,261,0,265,"2019"
"55499","510305 CLAUDIA",0,0,3,134,0,137,"2019"
"55500","510310 COCALINHO",0,0,1,62,0,63,"2019"
"55501","510320 COLIDER",1,5,9,473,0,488,"2019"
"55502","510325 COLNIZA",0,0,9,398,1,408,"2019"
"55503","510330 COMODORO",0,2,1,355,8,366,"2019"
"55504","510335 CONFRESA",0,3,8,680,9,700,"2019"
"55505","510336 CONQUISTA D'OESTE",0,0,0,64,1,65,"2019"
"55506","510337 COTRIGUACU",0,1,1,164,0,166,"2019"
"55507","510340 CUIABA",23,31,121,9948,8,10131,"2019"
"55508","510343 CURVELANDIA",0,0,0,69,0,69,"2019"
"55509","510345 DENISE",0,0,2,83,0,85,"2019"
"55510","510350 DIAMANTINO",3,0,3,406,0,412,"2019"
"55511","510360 DOM AQUINO",0,1,1,81,0,83,"2019"
"55512","510370 FELIZ NATAL",0,1,10,195,3,209,"2019"
"55513","510380 FIGUEIROPOLIS D'OESTE",0,1,0,50,1,52,"2019"
"55514","510385 GAUCHA DO NORTE",0,0,1,153,6,160,"2019"
"55515","510390 GENERAL CARNEIRO",0,0,0,111,7,118,"2019"
"55516","510395 GLORIA D'OESTE",0,0,0,30,0,30,"2019"
"55517","510410 GUARANTA DO NORTE",0,1,9,519,0,529,"2019"
"55518","510420 GUIRATINGA",1,0,0,113,0,114,"2019"
"55519","510450 INDIAVAI",0,0,0,47,0,47,"2019"
"55520","510452 IPIRANGA DO NORTE",0,0,2,119,0,121,"2019"
"55521","510454 ITANHANGA",0,0,0,92,0,92,"2019"
"55522","510455 ITAUBA",0,0,1,90,0,91,"2019"
"55523","510460 ITIQUIRA",0,0,1,198,0,199,"2019"
"55524","510480 JACIARA",0,1,2,447,0,450,"2019"
"55525","510490 JANGADA",0,0,0,103,0,103,"2019"
"55526","510500 JAURU",0,0,3,124,1,128,"2019"
"55527","510510 JUARA",1,3,9,613,5,631,"2019"
"55528","510515 JUINA",0,6,22,699,1,728,"2019"
"55529","510517 JURUENA",1,1,2,146,1,151,"2019"
"55530","510520 JUSCIMEIRA",1,0,0,130,2,133,"2019"
"55531","510523 LAMBARI D'OESTE",0,1,1,72,1,75,"2019"
"55532","510525 LUCAS DO RIO VERDE",0,6,20,1390,0,1416,"2019"
"55533","510530 LUCIARA",0,0,0,22,0,22,"2019"
"55534","510550 VILA BELA DA SANTISSIMA TRINDADE",1,1,2,258,9,271,"2019"
"55535","510558 MARCELANDIA",2,3,6,172,6,189,"2019"
"55536","510560 MATUPA",2,0,3,358,0,363,"2019"
"55537","510562 MIRASSOL D'OESTE",1,2,4,445,2,454,"2019"
"55538","510590 NOBRES",1,1,0,262,0,264,"2019"
"55539","510600 NORTELANDIA",1,1,1,99,1,103,"2019"
"55540","510610 NOSSA SENHORA DO LIVRAMENTO",0,1,2,150,0,153,"2019"
"55541","510615 NOVA BANDEIRANTES",1,0,2,185,0,188,"2019"
"55542","510617 NOVA NAZARE",0,1,1,59,39,100,"2019"
"55543","510618 NOVA LACERDA",0,1,0,84,1,86,"2019"
"55544","510619 NOVA SANTA HELENA",0,1,3,57,0,61,"2019"
"55545","510620 NOVA BRASILANDIA",0,1,0,46,0,47,"2019"
"55546","510621 NOVA CANAA DO NORTE",0,0,2,181,0,183,"2019"
"55547","510622 NOVA MUTUM",5,2,5,978,2,992,"2019"
"55548","510623 NOVA OLIMPIA",0,1,2,262,0,265,"2019"
"55549","510624 NOVA UBIRATA",0,1,4,191,0,196,"2019"
"55550","510625 NOVA XAVANTINA",0,1,2,328,0,331,"2019"
"55551","510626 NOVO MUNDO",0,1,2,107,0,110,"2019"
"55552","510627 NOVO HORIZONTE DO NORTE",0,0,1,46,0,47,"2019"
"55553","510628 NOVO SAO JOAQUIM",0,0,2,103,0,105,"2019"
"55554","510629 PARANAITA",0,1,1,170,0,172,"2019"
"55555","510630 PARANATINGA",1,2,10,334,20,367,"2019"
"55556","510631 NOVO SANTO ANTONIO",0,0,0,29,0,29,"2019"
"55557","510637 PEDRA PRETA",1,1,5,253,0,260,"2019"
"55558","510642 PEIXOTO DE AZEVEDO",0,5,10,596,0,611,"2019"
"55559","510645 PLANALTO DA SERRA",0,0,0,48,0,48,"2019"
"55560","510650 POCONE",0,1,9,486,0,496,"2019"
"55561","510665 PONTAL DO ARAGUAIA",0,0,0,87,0,87,"2019"
"55562","510670 PONTE BRANCA",0,0,0,16,0,16,"2019"
"55563","510675 PONTES E LACERDA",4,2,8,822,4,840,"2019"
"55564","510677 PORTO ALEGRE DO NORTE",0,1,2,148,1,152,"2019"
"55565","510680 PORTO DOS GAUCHOS",0,0,4,74,0,78,"2019"
"55566","510682 PORTO ESPERIDIAO",0,1,0,166,2,169,"2019"
"55567","510685 PORTO ESTRELA",0,0,1,37,1,39,"2019"
"55568","510700 POXOREO",2,0,0,259,2,263,"2019"
"55569","510704 PRIMAVERA DO LESTE",3,6,8,1402,1,1420,"2019"
"55570","510706 QUERENCIA",0,1,2,479,10,492,"2019"
"55571","510710 SAO JOSE DOS QUATRO MARCOS",1,1,2,229,0,233,"2019"
"55572","510715 RESERVA DO CABACAL",0,0,0,23,0,23,"2019"
"55573","510718 RIBEIRAO CASCALHEIRA",0,0,3,152,20,175,"2019"
"55574","510719 RIBEIRAOZINHO",0,0,0,33,0,33,"2019"
"55575","510720 RIO BRANCO",1,0,3,82,0,86,"2019"
"55576","510724 SANTA CARMEM",1,0,0,82,0,83,"2019"
"55577","510726 SANTO AFONSO",0,0,0,26,0,26,"2019"
"55578","510729 SAO JOSE DO POVO",0,0,0,20,0,20,"2019"
"55579","510730 SAO JOSE DO RIO CLARO",0,2,4,297,0,303,"2019"
"55580","510735 SAO JOSE DO XINGU",0,1,1,88,2,92,"2019"
"55581","510740 SAO PEDRO DA CIPA",0,1,1,69,0,71,"2019"
"55582","510757 RONDOLANDIA",0,0,0,24,1,25,"2019"
"55583","510760 RONDONOPOLIS",13,10,33,3957,13,4026,"2019"
"55584","510770 ROSARIO OESTE",1,0,3,193,0,197,"2019"
"55585","510774 SANTA CRUZ DO XINGU",0,0,2,34,1,37,"2019"
"55586","510775 SALTO DO CEU",0,0,2,56,0,58,"2019"
"55587","510776 SANTA RITA DO TRIVELATO",0,0,1,42,0,43,"2019"
"55588","510777 SANTA TEREZINHA",1,0,3,107,0,111,"2019"
"55589","510779 SANTO ANTONIO DO LESTE",1,0,0,52,13,66,"2019"
"55590","510780 SANTO ANTONIO DO LEVERGER",0,1,4,220,0,225,"2019"
"55591","510785 SAO FELIX DO ARAGUAIA",0,0,1,99,5,105,"2019"
"55592","510787 SAPEZAL",2,0,3,558,0,563,"2019"
"55593","510788 SERRA NOVA DOURADA",0,0,0,20,0,20,"2019"
"55594","510790 SINOP",7,17,19,3124,2,3169,"2019"
"55595","510792 SORRISO",3,2,30,1982,2,2019,"2019"
"55596","510794 TABAPORA",0,0,7,135,1,143,"2019"
"55597","510795 TANGARA DA SERRA",3,4,29,1702,4,1742,"2019"
"55598","510800 TAPURAH",0,0,4,223,0,227,"2019"
"55599","510805 TERRA NOVA DO NORTE",0,1,7,191,0,199,"2019"
"55600","510810 TESOURO",0,0,1,17,1,19,"2019"
"55601","510820 TORIXOREU",0,0,2,39,0,41,"2019"
"55602","510830 UNIAO DO SUL",0,0,0,49,0,49,"2019"
"55603","510835 VALE DE SAO DOMINGOS",0,0,1,50,0,51,"2019"
"55604","510840 VARZEA GRANDE",6,24,88,4892,41,5051,"2019"
"55605","510850 VERA",0,0,3,150,0,153,"2019"
"55606","510860 VILA RICA",3,0,4,296,0,303,"2019"
"55607","510880 NOVA GUARITA",0,0,1,71,0,72,"2019"
"55608","510885 NOVA MARILANDIA",0,0,0,45,0,45,"2019"
"55609","510890 NOVA MARINGA",0,0,2,72,0,74,"2019"
"55610","510895 NOVA MONTE VERDE",0,1,0,117,0,118,"2019"
"55611","MUNICIPIO IGNORADO - GO",0,1,0,2,1,4,"2019"
"55612","520005 ABADIA DE GOIAS",0,1,2,231,3,237,"2019"
"55613","520010 ABADIANIA",0,0,3,174,1,178,"2019"
"55614","520013 ACREUNA",1,1,60,193,0,255,"2019"
"55615","520015 ADELANDIA",0,1,0,23,0,24,"2019"
"55616","520017 AGUA FRIA DE GOIAS",2,1,1,47,1,52,"2019"
"55617","520020 AGUA LIMPA",0,0,0,11,0,11,"2019"
"55618","520025 AGUAS LINDAS DE GOIAS",9,15,58,2555,124,2761,"2019"
"55619","520030 ALEXANIA",2,0,8,427,2,439,"2019"
"55620","520050 ALOANDIA",0,0,0,15,0,15,"2019"
"55621","520055 ALTO HORIZONTE",0,0,4,107,0,111,"2019"
"55622","520060 ALTO PARAISO DE GOIAS",0,0,2,106,5,113,"2019"
"55623","520080 ALVORADA DO NORTE",2,0,1,146,0,149,"2019"
"55624","520082 AMARALINA",0,0,0,27,0,27,"2019"
"55625","520085 AMERICANO DO BRASIL",0,0,0,83,0,83,"2019"
"55626","520090 AMORINOPOLIS",0,0,1,36,0,37,"2019"
"55627","520110 ANAPOLIS",11,23,102,5930,11,6077,"2019"
"55628","520120 ANHANGUERA",0,0,0,8,0,8,"2019"
"55629","520130 ANICUNS",1,1,2,203,2,209,"2019"
"55630","520140 APARECIDA DE GOIANIA",21,28,79,7458,43,7629,"2019"
"55631","520145 APARECIDA DO RIO DOCE",0,0,0,36,0,36,"2019"
"55632","520150 APORE",0,0,1,67,0,68,"2019"
"55633","520160 ARACU",0,0,1,40,0,41,"2019"
"55634","520170 ARAGARCAS",0,1,3,237,0,241,"2019"
"55635","520180 ARAGOIANIA",1,0,2,129,1,133,"2019"
"55636","520215 ARAGUAPAZ",0,0,1,53,0,54,"2019"
"55637","520235 ARENOPOLIS",0,0,0,42,0,42,"2019"
"55638","520250 ARUANA",1,0,2,97,0,100,"2019"
"55639","520260 AURILANDIA",0,0,0,25,0,25,"2019"
"55640","520280 AVELINOPOLIS",0,0,0,25,0,25,"2019"
"55641","520310 BALIZA",0,1,0,30,0,31,"2019"
"55642","520320 BARRO ALTO",0,1,4,159,0,164,"2019"
"55643","520330 BELA VISTA DE GOIAS",1,1,6,459,0,467,"2019"
"55644","520340 BOM JARDIM DE GOIAS",0,0,1,106,0,107,"2019"
"55645","520350 BOM JESUS DE GOIAS",0,2,5,361,0,368,"2019"
"55646","520355 BONFINOPOLIS",0,1,0,112,2,115,"2019"
"55647","520357 BONOPOLIS",0,0,1,49,0,50,"2019"
"55648","520360 BRAZABRANTES",0,0,0,33,0,33,"2019"
"55649","520380 BRITANIA",1,0,0,77,1,79,"2019"
"55650","520390 BURITI ALEGRE",0,0,1,124,4,129,"2019"
"55651","520393 BURITI DE GOIAS",0,0,0,23,0,23,"2019"
"55652","520396 BURITINOPOLIS",0,0,0,49,0,49,"2019"
"55653","520400 CABECEIRAS",0,0,0,113,2,115,"2019"
"55654","520410 CACHOEIRA ALTA",1,1,0,149,0,151,"2019"
"55655","520420 CACHOEIRA DE GOIAS",0,0,0,14,0,14,"2019"
"55656","520425 CACHOEIRA DOURADA",0,0,0,87,0,87,"2019"
"55657","520430 CACU",0,2,0,165,0,167,"2019"
"55658","520440 CAIAPONIA",0,1,9,183,0,193,"2019"
"55659","520450 CALDAS NOVAS",4,2,24,1324,0,1354,"2019"
"55660","520455 CALDAZINHA",0,0,2,43,0,45,"2019"
"55661","520460 CAMPESTRE DE GOIAS",0,0,0,41,1,42,"2019"
"55662","520465 CAMPINACU",0,0,0,25,0,25,"2019"
"55663","520470 CAMPINORTE",0,0,2,146,0,148,"2019"
"55664","520480 CAMPO ALEGRE DE GOIAS",0,0,2,85,0,87,"2019"
"55665","520485 CAMPO LIMPO DE GOIAS",0,0,2,102,0,104,"2019"
"55666","520490 CAMPOS BELOS",1,3,3,329,1,337,"2019"
"55667","520495 CAMPOS VERDES",0,2,1,46,0,49,"2019"
"55668","520500 CARMO DO RIO VERDE",0,0,0,107,0,107,"2019"
"55669","520505 CASTELANDIA",0,0,0,40,0,40,"2019"
"55670","520510 CATALAO",4,2,22,1390,0,1418,"2019"
"55671","520520 CATURAI",0,0,0,49,0,49,"2019"
"55672","520530 CAVALCANTE",1,1,2,122,0,126,"2019"
"55673","520540 CERES",2,3,3,315,0,323,"2019"
"55674","520545 CEZARINA",1,0,2,112,0,115,"2019"
"55675","520547 CHAPADAO DO CEU",0,2,3,251,0,256,"2019"
"55676","520549 CIDADE OCIDENTAL",5,5,14,1026,22,1072,"2019"
"55677","520551 COCALZINHO DE GOIAS",1,0,2,211,41,255,"2019"
"55678","520552 COLINAS DO SUL",0,0,0,31,0,31,"2019"
"55679","520570 CORREGO DO OURO",0,0,0,35,0,35,"2019"
"55680","520580 CORUMBA DE GOIAS",0,0,0,94,2,96,"2019"
"55681","520590 CORUMBAIBA",0,0,3,79,0,82,"2019"
"55682","520620 CRISTALINA",1,4,11,963,11,990,"2019"
"55683","520630 CRISTIANOPOLIS",0,0,1,30,0,31,"2019"
"55684","520640 CRIXAS",3,1,5,233,0,242,"2019"
"55685","520650 CROMINIA",0,0,0,23,0,23,"2019"
"55686","520660 CUMARI",0,1,0,35,0,36,"2019"
"55687","520670 DAMIANOPOLIS",0,0,0,60,0,60,"2019"
"55688","520680 DAMOLANDIA",0,0,1,35,0,36,"2019"
"55689","520690 DAVINOPOLIS",0,0,2,14,0,16,"2019"
"55690","520710 DIORAMA",0,0,0,22,0,22,"2019"
"55691","520725 DOVERLANDIA",0,0,0,64,0,64,"2019"
"55692","520735 EDEALINA",0,0,0,42,0,42,"2019"
"55693","520740 EDEIA",2,0,1,168,0,171,"2019"
"55694","520750 ESTRELA DO NORTE",0,0,0,29,0,29,"2019"
"55695","520753 FAINA",1,0,2,53,0,56,"2019"
"55696","520760 FAZENDA NOVA",1,1,1,48,0,51,"2019"
"55697","520780 FIRMINOPOLIS",1,1,0,74,0,76,"2019"
"55698","520790 FLORES DE GOIAS",0,0,2,100,1,103,"2019"
"55699","520800 FORMOSA",1,9,36,1627,4,1677,"2019"
"55700","520810 FORMOSO",0,0,0,71,0,71,"2019"
"55701","520815 GAMELEIRA DE GOIAS",0,0,0,35,0,35,"2019"
"55702","520830 DIVINOPOLIS DE GOIAS",2,1,2,55,1,61,"2019"
"55703","520840 GOIANAPOLIS",0,0,3,171,1,175,"2019"
"55704","520850 GOIANDIRA",0,0,0,27,0,27,"2019"
"55705","520860 GOIANESIA",0,11,14,1068,0,1093,"2019"
"55706","520870 GOIANIA",66,62,242,20125,70,20565,"2019"
"55707","520880 GOIANIRA",3,3,13,1015,3,1037,"2019"
"55708","520890 GOIAS",1,1,2,327,1,332,"2019"
"55709","520910 GOIATUBA",1,0,5,415,0,421,"2019"
"55710","520915 GOUVELANDIA",0,0,1,51,0,52,"2019"
"55711","520920 GUAPO",1,1,2,220,1,225,"2019"
"55712","520929 GUARAITA",0,0,0,14,0,14,"2019"
"55713","520940 GUARANI DE GOIAS",1,0,0,41,0,42,"2019"
"55714","520945 GUARINOS",0,0,0,12,0,12,"2019"
"55715","520960 HEITORAI",0,0,0,50,0,50,"2019"
"55716","520970 HIDROLANDIA",1,2,2,329,0,334,"2019"
"55717","520980 HIDROLINA",0,0,0,37,0,37,"2019"
"55718","520990 IACIARA",0,0,2,121,0,123,"2019"
"55719","520993 INACIOLANDIA",0,1,0,50,0,51,"2019"
"55720","520995 INDIARA",0,0,4,230,0,234,"2019"
"55721","521000 INHUMAS",2,1,8,659,0,670,"2019"
"55722","521010 IPAMERI",0,0,2,309,0,311,"2019"
"55723","521015 IPIRANGA DE GOIAS",0,0,0,33,0,33,"2019"
"55724","521020 IPORA",0,0,8,450,0,458,"2019"
"55725","521030 ISRAELANDIA",0,0,0,28,0,28,"2019"
"55726","521040 ITABERAI",0,2,10,570,0,582,"2019"
"55727","521056 ITAGUARI",0,0,0,61,0,61,"2019"
"55728","521060 ITAGUARU",0,0,0,39,0,39,"2019"
"55729","521080 ITAJA",0,0,0,50,0,50,"2019"
"55730","521090 ITAPACI",0,0,4,282,1,287,"2019"
"55731","521100 ITAPIRAPUA",0,0,1,68,1,70,"2019"
"55732","521120 ITAPURANGA",2,0,3,298,0,303,"2019"
"55733","521130 ITARUMA",1,0,2,95,0,98,"2019"
"55734","521140 ITAUCU",0,0,2,97,0,99,"2019"
"55735","521150 ITUMBIARA",2,4,20,1327,0,1353,"2019"
"55736","521160 IVOLANDIA",0,0,0,21,0,21,"2019"
"55737","521170 JANDAIA",0,0,0,72,0,72,"2019"
"55738","521180 JARAGUA",3,3,10,552,2,570,"2019"
"55739","521190 JATAI",4,7,13,1444,2,1470,"2019"
"55740","521200 JAUPACI",0,0,0,42,0,42,"2019"
"55741","521205 JESUPOLIS",0,0,0,25,0,25,"2019"
"55742","521210 JOVIANIA",0,0,0,85,0,85,"2019"
"55743","521220 JUSSARA",1,0,2,251,1,255,"2019"
"55744","521225 LAGOA SANTA",0,0,0,10,0,10,"2019"
"55745","521230 LEOPOLDO DE BULHOES",0,1,2,102,2,107,"2019"
"55746","521250 LUZIANIA",10,13,41,2822,79,2965,"2019"
"55747","521260 MAIRIPOTABA",0,1,0,20,0,21,"2019"
"55748","521270 MAMBAI",0,1,1,146,2,150,"2019"
"55749","521280 MARA ROSA",0,1,1,169,0,171,"2019"
"55750","521290 MARZAGAO",0,0,1,31,0,32,"2019"
"55751","521295 MATRINCHA",0,0,1,49,1,51,"2019"
"55752","521300 MAURILANDIA",0,1,0,163,0,164,"2019"
"55753","521305 MIMOSO DE GOIAS",0,0,0,16,8,24,"2019"
"55754","521308 MINACU",0,0,12,366,3,381,"2019"
"55755","521310 MINEIROS",3,0,5,1099,1,1108,"2019"
"55756","521340 MOIPORA",0,0,0,16,0,16,"2019"
"55757","521350 MONTE ALEGRE DE GOIAS",0,2,2,95,0,99,"2019"
"55758","521370 MONTES CLAROS DE GOIAS",0,0,1,94,0,95,"2019"
"55759","521375 MONTIVIDIU",0,1,5,182,0,188,"2019"
"55760","521377 MONTIVIDIU DO NORTE",0,0,1,49,0,50,"2019"
"55761","521380 MORRINHOS",3,1,5,641,2,652,"2019"
"55762","521385 MORRO AGUDO DE GOIAS",0,0,0,22,0,22,"2019"
"55763","521390 MOSSAMEDES",0,0,0,43,0,43,"2019"
"55764","521400 MOZARLANDIA",1,1,2,265,1,270,"2019"
"55765","521405 MUNDO NOVO",0,0,0,93,0,93,"2019"
"55766","521410 MUTUNOPOLIS",0,0,0,36,0,36,"2019"
"55767","521440 NAZARIO",0,0,0,85,0,85,"2019"
"55768","521450 NEROPOLIS",2,0,5,458,1,466,"2019"
"55769","521460 NIQUELANDIA",1,3,3,388,1,396,"2019"
"55770","521470 NOVA AMERICA",0,0,0,28,1,29,"2019"
"55771","521480 NOVA AURORA",0,0,0,12,0,12,"2019"
"55772","521483 NOVA CRIXAS",0,0,0,175,1,176,"2019"
"55773","521486 NOVA GLORIA",0,0,0,76,0,76,"2019"
"55774","521487 NOVA IGUACU DE GOIAS",0,0,0,18,0,18,"2019"
"55775","521490 NOVA ROMA",0,0,0,27,0,27,"2019"
"55776","521500 NOVA VENEZA",1,0,2,83,0,86,"2019"
"55777","521520 NOVO BRASIL",0,0,0,47,0,47,"2019"
"55778","521523 NOVO GAMA",3,8,19,1478,13,1521,"2019"
"55779","521525 NOVO PLANALTO",0,0,1,36,0,37,"2019"
"55780","521530 ORIZONA",0,1,6,187,0,194,"2019"
"55781","521540 OURO VERDE DE GOIAS",0,0,2,54,0,56,"2019"
"55782","521550 OUVIDOR",0,0,1,83,0,84,"2019"
"55783","521560 PADRE BERNARDO",0,2,3,150,270,425,"2019"
"55784","521565 PALESTINA DE GOIAS",0,0,0,40,0,40,"2019"
"55785","521570 PALMEIRAS DE GOIAS",2,3,5,419,1,430,"2019"
"55786","521580 PALMELO",1,0,1,19,0,21,"2019"
"55787","521590 PALMINOPOLIS",0,0,1,47,0,48,"2019"
"55788","521600 PANAMA",0,0,0,26,1,27,"2019"
"55789","521630 PARANAIGUARA",0,0,1,92,0,93,"2019"
"55790","521640 PARAUNA",1,1,2,146,2,152,"2019"
"55791","521645 PEROLANDIA",0,0,1,44,0,45,"2019"
"55792","521680 PETROLINA DE GOIAS",0,0,3,74,0,77,"2019"
"55793","521690 PILAR DE GOIAS",0,0,0,34,0,34,"2019"
"55794","521710 PIRACANJUBA",0,1,1,232,1,235,"2019"
"55795","521720 PIRANHAS",0,1,1,106,0,108,"2019"
"55796","521730 PIRENOPOLIS",1,3,4,294,5,307,"2019"
"55797","521740 PIRES DO RIO",0,2,8,320,1,331,"2019"
"55798","521760 PLANALTINA",4,3,26,1439,9,1481,"2019"
"55799","521770 PONTALINA",1,0,0,186,1,188,"2019"
"55800","521800 PORANGATU",1,1,14,562,3,581,"2019"
"55801","521805 PORTEIRAO",0,0,1,48,0,49,"2019"
"55802","521810 PORTELANDIA",0,0,0,47,0,47,"2019"
"55803","521830 POSSE",0,4,12,586,0,602,"2019"
"55804","521839 PROFESSOR JAMIL",0,0,1,22,0,23,"2019"
"55805","521850 QUIRINOPOLIS",1,4,10,678,0,693,"2019"
"55806","521860 RIALMA",0,1,1,136,0,138,"2019"
"55807","521870 RIANAPOLIS",0,0,0,54,0,54,"2019"
"55808","521878 RIO QUENTE",0,0,0,51,0,51,"2019"
"55809","521880 RIO VERDE",6,14,29,3379,4,3432,"2019"
"55810","521890 RUBIATABA",1,1,4,247,1,254,"2019"
"55811","521900 SANCLERLANDIA",0,0,2,86,0,88,"2019"
"55812","521910 SANTA BARBARA DE GOIAS",0,0,2,91,0,93,"2019"
"55813","521920 SANTA CRUZ DE GOIAS",0,0,0,28,0,28,"2019"
"55814","521925 SANTA FE DE GOIAS",0,0,0,83,0,83,"2019"
"55815","521930 SANTA HELENA DE GOIAS",1,1,6,524,0,532,"2019"
"55816","521935 SANTA ISABEL",0,0,0,43,0,43,"2019"
"55817","521940 SANTA RITA DO ARAGUAIA",0,0,1,102,0,103,"2019"
"55818","521945 SANTA RITA DO NOVO DESTINO",0,0,0,18,0,18,"2019"
"55819","521950 SANTA ROSA DE GOIAS",0,0,0,28,0,28,"2019"
"55820","521960 SANTA TEREZA DE GOIAS",0,0,0,38,0,38,"2019"
"55821","521970 SANTA TEREZINHA DE GOIAS",0,1,2,119,0,122,"2019"
"55822","521971 SANTO ANTONIO DA BARRA",0,0,1,44,0,45,"2019"
"55823","521973 SANTO ANTONIO DE GOIAS",0,1,2,74,0,77,"2019"
"55824","521975 SANTO ANTONIO DO DESCOBERTO",0,4,12,934,10,960,"2019"
"55825","521980 SAO DOMINGOS",1,0,0,112,0,113,"2019"
"55826","521990 SAO FRANCISCO DE GOIAS",0,1,2,64,0,67,"2019"
"55827","522000 SAO JOAO D'ALIANCA",1,0,3,145,3,152,"2019"
"55828","522005 SAO JOAO DA PARAUNA",0,1,0,13,0,14,"2019"
"55829","522010 SAO LUIS DE MONTES BELOS",0,0,1,417,0,418,"2019"
"55830","522015 SAO LUIZ DO NORTE",0,1,0,67,0,68,"2019"
"55831","522020 SAO MIGUEL DO ARAGUAIA",1,1,10,302,0,314,"2019"
"55832","522026 SAO MIGUEL DO PASSA QUATRO",0,0,2,29,0,31,"2019"
"55833","522028 SAO PATRICIO",0,0,1,19,0,20,"2019"
"55834","522040 SAO SIMAO",0,0,3,234,0,237,"2019"
"55835","522045 SENADOR CANEDO",7,14,28,2313,2,2364,"2019"
"55836","522050 SERRANOPOLIS",0,0,0,93,0,93,"2019"
"55837","522060 SILVANIA",1,1,3,235,0,240,"2019"
"55838","522068 SIMOLANDIA",0,1,3,94,0,98,"2019"
"55839","522070 SITIO D'ABADIA",0,0,0,28,0,28,"2019"
"55840","522100 TAQUARAL DE GOIAS",0,0,1,44,0,45,"2019"
"55841","522108 TERESINA DE GOIAS",1,0,1,43,0,45,"2019"
"55842","522119 TEREZOPOLIS DE GOIAS",0,2,0,99,3,104,"2019"
"55843","522130 TRES RANCHOS",1,0,0,26,0,27,"2019"
"55844","522140 TRINDADE",8,7,27,2017,9,2068,"2019"
"55845","522145 TROMBAS",0,0,0,23,0,23,"2019"
"55846","522150 TURVANIA",0,0,0,38,0,38,"2019"
"55847","522155 TURVELANDIA",1,0,0,54,0,55,"2019"
"55848","522157 UIRAPURU",0,1,0,24,0,25,"2019"
"55849","522160 URUACU",0,7,21,560,0,588,"2019"
"55850","522170 URUANA",0,2,3,147,0,152,"2019"
"55851","522180 URUTAI",1,0,0,12,0,13,"2019"
"55852","522185 VALPARAISO DE GOIAS",10,11,42,2402,44,2509,"2019"
"55853","522190 VARJAO",0,0,2,30,0,32,"2019"
"55854","522200 VIANOPOLIS",1,1,3,191,0,196,"2019"
"55855","522205 VICENTINOPOLIS",0,2,1,109,0,112,"2019"
"55856","522220 VILA BOA",0,0,3,47,0,50,"2019"
"55857","522230 VILA PROPICIO",0,0,2,68,1,71,"2019"
"55858","530010 BRASILIA",111,149,645,40592,925,42422,"2019"
"55859","TOTAL",7137,10549,38166,2631215,43078,2730145,"2020"
"55860","110001 ALTA FLORESTA D'OESTE",0,0,0,333,0,333,"2020"
"55861","110002 ARIQUEMES",2,4,41,1458,2,1507,"2020"
"55862","110003 CABIXI",0,1,0,67,1,69,"2020"
"55863","110004 CACOAL",9,5,13,1297,1,1325,"2020"
"55864","110005 CEREJEIRAS",0,1,1,265,2,269,"2020"
"55865","110006 COLORADO DO OESTE",0,0,2,199,2,203,"2020"
"55866","110007 CORUMBIARA",0,0,1,106,0,107,"2020"
"55867","110008 COSTA MARQUES",0,2,8,178,2,190,"2020"
"55868","110009 ESPIGAO D'OESTE",0,0,7,463,1,471,"2020"
"55869","110010 GUAJARA-MIRIM",4,3,19,812,20,858,"2020"
"55870","110011 JARU",1,3,6,878,4,892,"2020"
"55871","110012 JI-PARANA",6,5,40,2077,5,2133,"2020"
"55872","110013 MACHADINHO D'OESTE",0,8,15,536,2,561,"2020"
"55873","110014 NOVA BRASILANDIA D'OESTE",0,1,1,228,0,230,"2020"
"55874","110015 OURO PRETO DO OESTE",0,3,12,584,1,600,"2020"
"55875","110018 PIMENTA BUENO",1,1,9,568,0,579,"2020"
"55876","110020 PORTO VELHO",8,15,79,7733,58,7893,"2020"
"55877","110025 PRESIDENTE MEDICI",0,3,6,250,0,259,"2020"
"55878","110026 RIO CRESPO",0,0,1,47,0,48,"2020"
"55879","110028 ROLIM DE MOURA",1,4,12,859,1,877,"2020"
"55880","110029 SANTA LUZIA D'OESTE",0,0,0,97,2,99,"2020"
"55881","110030 VILHENA",3,1,9,1536,4,1553,"2020"
"55882","110032 SAO MIGUEL DO GUAPORE",1,3,2,357,0,363,"2020"
"55883","110033 NOVA MAMORE",1,0,4,413,5,423,"2020"
"55884","110034 ALVORADA D'OESTE",0,1,4,205,0,210,"2020"
"55885","110037 ALTO ALEGRE DOS PARECIS",0,0,1,145,0,146,"2020"
"55886","110040 ALTO PARAISO",0,1,3,213,1,218,"2020"
"55887","110045 BURITIS",2,3,5,497,1,508,"2020"
"55888","110050 NOVO HORIZONTE DO OESTE",0,0,3,75,0,78,"2020"
"55889","110060 CACAULANDIA",0,0,0,70,0,70,"2020"
"55890","110070 CAMPO NOVO DE RONDONIA",0,1,2,170,0,173,"2020"
"55891","110080 CANDEIAS DO JAMARI",2,1,3,336,2,344,"2020"
"55892","110090 CASTANHEIRAS",0,0,0,37,0,37,"2020"
"55893","110092 CHUPINGUAIA",0,0,0,161,1,162,"2020"
"55894","110094 CUJUBIM",0,2,6,235,3,246,"2020"
"55895","110100 GOVERNADOR JORGE TEIXEIRA",0,0,2,83,1,86,"2020"
"55896","110110 ITAPUA DO OESTE",0,0,0,115,4,119,"2020"
"55897","110120 MINISTRO ANDREAZZA",0,0,0,74,0,74,"2020"
"55898","110130 MIRANTE DA SERRA",1,1,1,165,0,168,"2020"
"55899","110140 MONTE NEGRO",0,2,3,162,0,167,"2020"
"55900","110143 NOVA UNIAO",0,0,4,83,0,87,"2020"
"55901","110145 PARECIS",0,0,2,57,0,59,"2020"
"55902","110146 PIMENTEIRAS DO OESTE",0,0,0,39,0,39,"2020"
"55903","110147 PRIMAVERA DE RONDONIA",0,0,1,37,0,38,"2020"
"55904","110148 SAO FELIPE D'OESTE",0,0,0,65,0,65,"2020"
"55905","110149 SAO FRANCISCO DO GUAPORE",1,1,9,255,0,266,"2020"
"55906","110150 SERINGUEIRAS",1,0,3,158,0,162,"2020"
"55907","110155 TEIXEIROPOLIS",1,0,1,40,0,42,"2020"
"55908","110160 THEOBROMA",0,2,0,111,2,115,"2020"
"55909","110170 URUPA",2,0,2,139,0,143,"2020"
"55910","110175 VALE DO ANARI",0,0,0,72,0,72,"2020"
"55911","110180 VALE DO PARAISO",1,0,1,60,0,62,"2020"
"55912","120001 ACRELANDIA",0,0,3,229,5,237,"2020"
"55913","120005 ASSIS BRASIL",0,1,2,188,24,215,"2020"
"55914","120010 BRASILEIA",1,4,6,516,0,527,"2020"
"55915","120013 BUJARI",0,0,6,228,7,241,"2020"
"55916","120017 CAPIXABA",0,1,1,181,7,190,"2020"
"55917","120020 CRUZEIRO DO SUL",3,8,36,1629,15,1691,"2020"
"55918","120025 EPITACIOLANDIA",0,0,3,287,3,293,"2020"
"55919","120030 FEIJO",1,3,9,701,75,789,"2020"
"55920","120032 JORDAO",0,0,1,121,83,205,"2020"
"55921","120033 MANCIO LIMA",2,1,7,398,12,420,"2020"
"55922","120034 MANOEL URBANO",0,0,4,237,39,280,"2020"
"55923","120035 MARECHAL THAUMATURGO",1,3,1,291,38,334,"2020"
"55924","120038 PLACIDO DE CASTRO",0,1,4,276,4,285,"2020"
"55925","120039 PORTO WALTER",1,1,7,251,27,287,"2020"
"55926","120040 RIO BRANCO",9,22,79,5542,93,5745,"2020"
"55927","120042 RODRIGUES ALVES",0,4,3,332,8,347,"2020"
"55928","120043 SANTA ROSA DO PURUS",0,1,1,105,42,149,"2020"
"55929","120045 SENADOR GUIOMARD",0,3,5,386,7,401,"2020"
"55930","120050 SENA MADUREIRA",0,6,7,630,25,668,"2020"
"55931","120060 TARAUACA",4,5,17,1042,93,1161,"2020"
"55932","120070 XAPURI",0,2,6,302,6,316,"2020"
"55933","120080 PORTO ACRE",0,0,12,344,5,361,"2020"
"55934","MUNICIPIO IGNORADO - AM",0,0,1,39,1,41,"2020"
"55935","130002 ALVARAES",0,4,7,384,2,397,"2020"
"55936","130006 AMATURA",2,3,2,179,79,265,"2020"
"55937","130008 ANAMA",1,2,6,218,1,228,"2020"
"55938","130010 ANORI",0,0,5,244,9,258,"2020"
"55939","130014 APUI",1,0,4,260,0,265,"2020"
"55940","130020 ATALAIA DO NORTE",0,2,1,182,95,280,"2020"
"55941","130030 AUTAZES",2,5,12,798,89,906,"2020"
"55942","130040 BARCELOS",2,0,6,269,220,497,"2020"
"55943","130050 BARREIRINHA",0,4,3,641,198,846,"2020"
"55944","130060 BENJAMIN CONSTANT",1,0,8,973,2,984,"2020"
"55945","130063 BERURI",0,2,8,414,86,510,"2020"
"55946","130068 BOA VISTA DO RAMOS",0,1,0,298,0,299,"2020"
"55947","130070 BOCA DO ACRE",4,2,9,703,0,718,"2020"
"55948","130080 BORBA",4,0,16,736,18,774,"2020"
"55949","130083 CAAPIRANGA",1,3,12,186,2,204,"2020"
"55950","130090 CANUTAMA",1,0,1,193,2,197,"2020"
"55951","130100 CARAUARI",0,2,7,265,311,585,"2020"
"55952","130110 CAREIRO",1,1,2,541,20,565,"2020"
"55953","130115 CAREIRO DA VARZEA",0,0,1,162,27,190,"2020"
"55954","130120 COARI",1,3,15,1582,0,1601,"2020"
"55955","130130 CODAJAS",5,0,3,462,4,474,"2020"
"55956","130140 EIRUNEPE",0,1,23,590,103,717,"2020"
"55957","130150 ENVIRA",1,0,1,357,8,367,"2020"
"55958","130160 FONTE BOA",0,1,8,619,0,628,"2020"
"55959","130165 GUAJARA",0,4,2,275,10,291,"2020"
"55960","130170 HUMAITA",2,3,8,972,1,986,"2020"
"55961","130180 IPIXUNA",0,1,4,279,58,342,"2020"
"55962","130185 IRANDUBA",0,4,4,887,18,913,"2020"
"55963","130190 ITACOATIARA",6,7,20,1822,74,1929,"2020"
"55964","130195 ITAMARATI",0,0,2,171,67,240,"2020"
"55965","130200 ITAPIRANGA",1,0,2,185,0,188,"2020"
"55966","130210 JAPURA",0,0,0,177,11,188,"2020"
"55967","130220 JURUA",1,1,4,212,7,225,"2020"
"55968","130230 JUTAI",0,0,0,504,150,654,"2020"
"55969","130240 LABREA",4,13,49,711,24,801,"2020"
"55970","130250 MANACAPURU",7,3,11,2074,2,2097,"2020"
"55971","130255 MANAQUIRI",0,1,3,243,2,249,"2020"
"55972","130260 MANAUS",58,94,222,36550,350,37274,"2020"
"55973","130270 MANICORE",1,7,28,842,118,996,"2020"
"55974","130280 MARAA",0,0,2,379,36,417,"2020"
"55975","130290 MAUES",6,11,17,1104,265,1403,"2020"
"55976","130300 NHAMUNDA",0,3,4,270,50,327,"2020"
"55977","130310 NOVA OLINDA DO NORTE",0,1,19,524,52,596,"2020"
"55978","130320 NOVO AIRAO",0,0,4,275,11,290,"2020"
"55979","130330 NOVO ARIPUANA",3,2,6,342,16,369,"2020"
"55980","130340 PARINTINS",7,5,22,1689,82,1805,"2020"
"55981","130350 PAUINI",2,2,11,291,50,356,"2020"
"55982","130353 PRESIDENTE FIGUEIREDO",3,0,7,534,7,551,"2020"
"55983","130356 RIO PRETO DA EVA",2,0,3,384,4,393,"2020"
"55984","130360 SANTA ISABEL DO RIO NEGRO",0,2,1,163,154,320,"2020"
"55985","130370 SANTO ANTONIO DO ICA",1,1,1,586,144,733,"2020"
"55986","130380 SAO GABRIEL DA CACHOEIRA",0,3,2,164,1209,1378,"2020"
"55987","130390 SAO PAULO DE OLIVENCA",0,1,6,453,459,919,"2020"
"55988","130395 SAO SEBASTIAO DO UATUMA",0,2,1,202,0,205,"2020"
"55989","130400 SILVES",0,2,0,177,2,181,"2020"
"55990","130406 TABATINGA",2,0,9,1166,476,1653,"2020"
"55991","130410 TAPAUA",0,0,3,385,64,452,"2020"
"55992","130420 TEFE",7,7,17,1735,26,1792,"2020"
"55993","130423 TONANTINS",0,0,11,396,5,412,"2020"
"55994","130426 UARINI",0,2,9,308,15,334,"2020"
"55995","130430 URUCARA",1,4,4,271,9,289,"2020"
"55996","130440 URUCURITUBA",0,0,2,272,17,291,"2020"
"55997","MUNICIPIO IGNORADO - RR",0,0,0,1,0,1,"2020"
"55998","140002 AMAJARI",7,1,0,192,195,395,"2020"
"55999","140005 ALTO ALEGRE",1,1,5,255,475,737,"2020"
"56000","140010 BOA VISTA",117,26,88,7948,16,8195,"2020"
"56001","140015 BONFIM",15,1,5,371,72,464,"2020"
"56002","140017 CANTA",14,1,4,329,25,373,"2020"
"56003","140020 CARACARAI",2,0,4,352,73,431,"2020"
"56004","140023 CAROEBE",1,1,0,178,3,183,"2020"
"56005","140028 IRACEMA",8,0,2,104,35,149,"2020"
"56006","140030 MUCAJAI",5,2,5,299,26,337,"2020"
"56007","140040 NORMANDIA",4,1,5,364,180,554,"2020"
"56008","140045 PACARAIMA",13,3,5,410,77,508,"2020"
"56009","140047 RORAINOPOLIS",2,1,5,586,4,598,"2020"
"56010","140050 SAO JOAO DA BALIZA",1,1,2,122,0,126,"2020"
"56011","140060 SAO LUIZ",0,0,3,98,5,106,"2020"
"56012","140070 UIRAMUTA",10,3,4,294,292,603,"2020"
"56013","MUNICIPIO IGNORADO - PA",0,0,0,1,0,1,"2020"
"56014","150010 ABAETETUBA",3,12,38,2476,23,2552,"2020"
"56015","150013 ABEL FIGUEIREDO",0,0,2,96,0,98,"2020"
"56016","150020 ACARA",6,1,17,899,24,947,"2020"
"56017","150030 AFUA",1,5,16,896,46,964,"2020"
"56018","150034 AGUA AZUL DO NORTE",1,0,2,166,0,169,"2020"
"56019","150040 ALENQUER",8,5,13,1010,34,1070,"2020"
"56020","150050 ALMEIRIM",1,5,11,756,6,779,"2020"
"56021","150060 ALTAMIRA",2,4,18,2227,81,2332,"2020"
"56022","150070 ANAJAS",2,6,20,644,149,821,"2020"
"56023","150080 ANANINDEUA",12,12,68,6836,25,6953,"2020"
"56024","150085 ANAPU",1,0,4,612,14,631,"2020"
"56025","150090 AUGUSTO CORREA",0,4,9,803,44,860,"2020"
"56026","150095 AURORA DO PARA",0,3,18,341,2,364,"2020"
"56027","150100 AVEIRO",0,1,3,124,18,146,"2020"
"56028","150110 BAGRE",1,4,6,143,374,528,"2020"
"56029","150120 BAIAO",4,2,6,465,34,511,"2020"
"56030","150125 BANNACH",0,0,0,57,0,57,"2020"
"56031","150130 BARCARENA",1,11,21,2233,5,2271,"2020"
"56032","150140 BELEM",52,59,159,16592,104,16966,"2020"
"56033","150145 BELTERRA",0,3,12,275,19,309,"2020"
"56034","150150 BENEVIDES",0,2,10,866,6,884,"2020"
"56035","150157 BOM JESUS DO TOCANTINS",1,0,1,249,3,254,"2020"
"56036","150160 BONITO",2,1,1,196,2,202,"2020"
"56037","150170 BRAGANCA",2,10,23,1980,41,2056,"2020"
"56038","150172 BRASIL NOVO",1,0,4,286,1,292,"2020"
"56039","150175 BREJO GRANDE DO ARAGUAIA",0,0,1,102,4,107,"2020"
"56040","150178 BREU BRANCO",0,4,15,677,13,709,"2020"
"56041","150180 BREVES",5,20,82,2638,16,2761,"2020"
"56042","150190 BUJARU",0,0,3,388,18,409,"2020"
"56043","150195 CACHOEIRA DO PIRIA",2,0,2,258,32,294,"2020"
"56044","150200 CACHOEIRA DO ARARI",0,6,9,299,0,314,"2020"
"56045","150210 CAMETA",12,50,186,2003,96,2347,"2020"
"56046","150215 CANAA DOS CARAJAS",1,3,13,1283,0,1300,"2020"
"56047","150220 CAPANEMA",0,1,10,969,5,985,"2020"
"56048","150230 CAPITAO POCO",1,0,7,898,5,911,"2020"
"56049","150240 CASTANHAL",8,13,26,3020,7,3074,"2020"
"56050","150250 CHAVES",0,3,3,397,25,428,"2020"
"56051","150260 COLARES",0,1,0,118,16,135,"2020"
"56052","150270 CONCEICAO DO ARAGUAIA",3,4,10,694,2,713,"2020"
"56053","150275 CONCORDIA DO PARA",3,2,3,448,5,461,"2020"
"56054","150276 CUMARU DO NORTE",0,0,0,218,3,221,"2020"
"56055","150277 CURIONOPOLIS",1,1,2,306,1,311,"2020"
"56056","150280 CURRALINHO",3,4,6,566,120,699,"2020"
"56057","150285 CURUA",2,0,0,173,61,236,"2020"
"56058","150290 CURUCA",1,1,4,456,12,474,"2020"
"56059","150293 DOM ELISEU",0,4,11,609,3,627,"2020"
"56060","150295 ELDORADO DOS CARAJAS",0,0,5,453,0,458,"2020"
"56061","150300 FARO",0,1,0,147,1,149,"2020"
"56062","150304 FLORESTA DO ARAGUAIA",0,1,1,296,0,298,"2020"
"56063","150307 GARRAFAO DO NORTE",0,1,10,428,11,450,"2020"
"56064","150309 GOIANESIA DO PARA",1,1,1,575,6,584,"2020"
"56065","150310 GURUPA",2,3,6,646,64,721,"2020"
"56066","150320 IGARAPE-ACU",3,1,13,530,2,549,"2020"
"56067","150330 IGARAPE-MIRI",2,5,15,936,55,1013,"2020"
"56068","150340 INHANGAPI",1,1,1,176,0,179,"2020"
"56069","150345 IPIXUNA DO PARA",1,3,6,564,3,577,"2020"
"56070","150350 IRITUIA",1,1,4,399,14,419,"2020"
"56071","150360 ITAITUBA",4,17,47,2273,23,2364,"2020"
"56072","150370 ITUPIRANGA",2,2,9,814,15,842,"2020"
"56073","150375 JACAREACANGA",0,2,6,354,303,665,"2020"
"56074","150380 JACUNDA",1,3,8,656,6,674,"2020"
"56075","150390 JURUTI",3,10,26,976,60,1075,"2020"
"56076","150400 LIMOEIRO DO AJURU",3,5,27,399,27,461,"2020"
"56077","150405 MAE DO RIO",0,2,5,529,2,538,"2020"
"56078","150410 MAGALHAES BARATA",0,0,1,89,0,90,"2020"
"56079","150420 MARABA",6,12,35,4498,43,4594,"2020"
"56080","150430 MARACANA",1,0,1,355,0,357,"2020"
"56081","150440 MARAPANIM",0,2,1,301,7,311,"2020"
"56082","150442 MARITUBA",3,6,20,1629,8,1666,"2020"
"56083","150445 MEDICILANDIA",0,0,4,463,9,476,"2020"
"56084","150450 MELGACO",0,4,9,413,168,594,"2020"
"56085","150460 MOCAJUBA",1,0,6,463,11,481,"2020"
"56086","150470 MOJU",6,3,21,1248,29,1307,"2020"
"56087","150475 MOJUI DOS CAMPOS",1,1,2,270,10,284,"2020"
"56088","150480 MONTE ALEGRE",6,6,10,1048,1,1071,"2020"
"56089","150490 MUANA",7,7,30,555,0,599,"2020"
"56090","150495 NOVA ESPERANCA DO PIRIA",1,2,5,352,1,361,"2020"
"56091","150497 NOVA IPIXUNA",1,2,1,217,4,225,"2020"
"56092","150500 NOVA TIMBOTEUA",0,1,2,133,1,137,"2020"
"56093","150503 NOVO PROGRESSO",1,1,2,612,1,617,"2020"
"56094","150506 NOVO REPARTIMENTO",2,5,8,1176,3,1194,"2020"
"56095","150510 OBIDOS",2,4,8,969,80,1063,"2020"
"56096","150520 OEIRAS DO PARA",2,8,28,574,50,662,"2020"
"56097","150530 ORIXIMINA",29,6,35,1402,40,1512,"2020"
"56098","150540 OUREM",1,1,4,290,0,296,"2020"
"56099","150543 OURILANDIA DO NORTE",4,3,17,656,0,680,"2020"
"56100","150548 PACAJA",2,2,8,682,5,699,"2020"
"56101","150549 PALESTINA DO PARA",0,1,1,113,1,116,"2020"
"56102","150550 PARAGOMINAS",9,5,18,1848,0,1880,"2020"
"56103","150553 PARAUAPEBAS",6,15,49,4594,3,4667,"2020"
"56104","150555 PAU D'ARCO",0,0,2,126,1,129,"2020"
"56105","150560 PEIXE-BOI",0,0,0,85,0,85,"2020"
"56106","150563 PICARRA",0,1,0,165,1,167,"2020"
"56107","150565 PLACAS",1,0,8,286,1,296,"2020"
"56108","150570 PONTA DE PEDRAS",0,3,4,284,22,313,"2020"
"56109","150580 PORTEL",3,2,10,1251,323,1589,"2020"
"56110","150590 PORTO DE MOZ",1,0,15,709,7,732,"2020"
"56111","150600 PRAINHA",3,4,11,669,90,777,"2020"
"56112","150610 PRIMAVERA",0,0,3,164,1,168,"2020"
"56113","150611 QUATIPURU",0,0,0,150,0,150,"2020"
"56114","150613 REDENCAO",3,8,30,1602,2,1645,"2020"
"56115","150616 RIO MARIA",0,1,3,285,0,289,"2020"
"56116","150618 RONDON DO PARA",1,1,11,524,0,537,"2020"
"56117","150619 RUROPOLIS",1,3,6,383,56,449,"2020"
"56118","150620 SALINOPOLIS",0,2,0,700,0,702,"2020"
"56119","150630 SALVATERRA",2,0,3,342,1,348,"2020"
"56120","150635 SANTA BARBARA DO PARA",2,1,3,274,4,284,"2020"
"56121","150640 SANTA CRUZ DO ARARI",0,1,0,69,10,80,"2020"
"56122","150650 SANTA IZABEL DO PARA",3,2,10,922,2,939,"2020"
"56123","150655 SANTA LUZIA DO PARA",0,0,5,303,8,316,"2020"
"56124","150658 SANTA MARIA DAS BARREIRAS",1,2,1,223,0,227,"2020"
"56125","150660 SANTA MARIA DO PARA",0,3,3,399,0,405,"2020"
"56126","150670 SANTANA DO ARAGUAIA",4,3,13,562,0,582,"2020"
"56127","150680 SANTAREM",28,30,135,5925,412,6530,"2020"
"56128","150690 SANTAREM NOVO",0,0,2,74,1,77,"2020"
"56129","150700 SANTO ANTONIO DO TAUA",0,0,10,458,7,475,"2020"
"56130","150710 SAO CAETANO DE ODIVELAS",3,1,2,227,2,235,"2020"
"56131","150715 SAO DOMINGOS DO ARAGUAIA",1,2,5,310,2,320,"2020"
"56132","150720 SAO DOMINGOS DO CAPIM",1,1,11,460,15,488,"2020"
"56133","150730 SAO FELIX DO XINGU",1,7,37,1008,24,1077,"2020"
"56134","150740 SAO FRANCISCO DO PARA",0,0,0,255,0,255,"2020"
"56135","150745 SAO GERALDO DO ARAGUAIA",0,2,3,373,1,379,"2020"
"56136","150746 SAO JOAO DA PONTA",0,0,3,76,4,83,"2020"
"56137","150747 SAO JOAO DE PIRABAS",0,0,1,302,1,304,"2020"
"56138","150750 SAO JOAO DO ARAGUAIA",0,0,3,218,1,222,"2020"
"56139","150760 SAO MIGUEL DO GUAMA",3,1,8,880,3,895,"2020"
"56140","150770 SAO SEBASTIAO DA BOA VISTA",1,4,18,548,5,576,"2020"
"56141","150775 SAPUCAIA",1,2,0,82,0,85,"2020"
"56142","150780 SENADOR JOSE PORFIRIO",0,0,0,283,4,287,"2020"
"56143","150790 SOURE",0,0,1,401,1,403,"2020"
"56144","150795 TAILANDIA",1,3,17,1399,2,1422,"2020"
"56145","150796 TERRA ALTA",0,0,1,196,0,197,"2020"
"56146","150797 TERRA SANTA",0,3,11,291,0,305,"2020"
"56147","150800 TOME-ACU",4,3,15,1445,2,1469,"2020"
"56148","150803 TRACUATEUA",0,1,5,387,6,399,"2020"
"56149","150805 TRAIRAO",0,0,3,247,0,250,"2020"
"56150","150808 TUCUMA",0,2,9,698,1,710,"2020"
"56151","150810 TUCURUI",2,4,28,1590,75,1699,"2020"
"56152","150812 ULIANOPOLIS",0,1,8,398,0,407,"2020"
"56153","150815 URUARA",6,5,6,752,2,771,"2020"
"56154","150820 VIGIA",0,1,11,641,2,655,"2020"
"56155","150830 VISEU",0,1,6,858,197,1062,"2020"
"56156","150835 VITORIA DO XINGU",0,1,4,350,0,355,"2020"
"56157","150840 XINGUARA",4,2,16,826,1,849,"2020"
"56158","160005 SERRA DO NAVIO",0,0,1,92,1,94,"2020"
"56159","160010 AMAPA",1,0,2,189,4,196,"2020"
"56160","160015 PEDRA BRANCA DO AMAPARI",0,0,1,318,11,330,"2020"
"56161","160020 CALCOENE",0,0,2,198,3,203,"2020"
"56162","160021 CUTIAS",1,1,1,96,14,113,"2020"
"56163","160023 FERREIRA GOMES",0,0,0,174,3,177,"2020"
"56164","160025 ITAUBAL",0,0,0,146,5,151,"2020"
"56165","160027 LARANJAL DO JARI",2,4,18,711,1,736,"2020"
"56166","160030 MACAPA",21,28,62,8247,88,8446,"2020"
"56167","160040 MAZAGAO",1,0,8,471,47,527,"2020"
"56168","160050 OIAPOQUE",3,2,8,520,59,592,"2020"
"56169","160053 PORTO GRANDE",2,0,4,361,7,374,"2020"
"56170","160055 PRACUUBA",0,0,1,71,26,98,"2020"
"56171","160060 SANTANA",2,5,30,1946,12,1995,"2020"
"56172","160070 TARTARUGALZINHO",0,0,3,249,85,337,"2020"
"56173","160080 VITORIA DO JARI",0,1,0,262,1,264,"2020"
"56174","MUNICIPIO IGNORADO - TO",0,0,0,1,0,1,"2020"
"56175","170025 ABREULANDIA",0,0,0,36,1,37,"2020"
"56176","170030 AGUIARNOPOLIS",1,0,1,48,6,56,"2020"
"56177","170035 ALIANCA DO TOCANTINS",0,0,1,68,0,69,"2020"
"56178","170040 ALMAS",0,0,2,104,0,106,"2020"
"56179","170070 ALVORADA",0,0,4,129,0,133,"2020"
"56180","170100 ANANAS",1,1,4,138,1,145,"2020"
"56181","170105 ANGICO",0,0,1,26,1,28,"2020"
"56182","170110 APARECIDA DO RIO NEGRO",0,1,1,66,2,70,"2020"
"56183","170130 ARAGOMINAS",0,0,2,83,2,87,"2020"
"56184","170190 ARAGUACEMA",0,0,2,79,0,81,"2020"
"56185","170200 ARAGUACU",0,0,0,97,1,98,"2020"
"56186","170210 ARAGUAINA",1,6,66,3002,14,3089,"2020"
"56187","170215 ARAGUANA",0,0,3,76,3,82,"2020"
"56188","170220 ARAGUATINS",0,2,7,438,65,512,"2020"
"56189","170230 ARAPOEMA",0,0,0,106,0,106,"2020"
"56190","170240 ARRAIAS",0,2,2,134,0,138,"2020"
"56191","170255 AUGUSTINOPOLIS",0,1,5,288,32,326,"2020"
"56192","170270 AURORA DO TOCANTINS",0,0,3,32,0,35,"2020"
"56193","170290 AXIXA DO TOCANTINS",0,0,1,158,13,172,"2020"
"56194","170300 BABACULANDIA",0,0,3,99,2,104,"2020"
"56195","170305 BANDEIRANTES DO TOCANTINS",0,0,0,55,1,56,"2020"
"56196","170307 BARRA DO OURO",0,1,2,65,2,70,"2020"
"56197","170310 BARROLANDIA",0,0,0,58,1,59,"2020"
"56198","170320 BERNARDO SAYAO",0,0,0,66,1,67,"2020"
"56199","170330 BOM JESUS DO TOCANTINS",0,0,0,72,0,72,"2020"
"56200","170360 BRASILANDIA DO TOCANTINS",0,0,0,35,0,35,"2020"
"56201","170370 BREJINHO DE NAZARE",1,0,0,56,0,57,"2020"
"56202","170380 BURITI DO TOCANTINS",0,1,1,132,14,148,"2020"
"56203","170382 CACHOEIRINHA",0,0,0,23,3,26,"2020"
"56204","170384 CAMPOS LINDOS",0,0,2,144,8,154,"2020"
"56205","170386 CARIRI DO TOCANTINS",1,0,1,39,0,41,"2020"
"56206","170388 CARMOLANDIA",0,0,0,43,0,43,"2020"
"56207","170389 CARRASCO BONITO",0,0,2,64,6,72,"2020"
"56208","170390 CASEARA",0,0,1,82,1,84,"2020"
"56209","170410 CENTENARIO",0,0,0,22,0,22,"2020"
"56210","170460 CHAPADA DE AREIA",0,0,0,17,0,17,"2020"
"56211","170510 CHAPADA DA NATIVIDADE",0,0,1,30,0,31,"2020"
"56212","170550 COLINAS DO TOCANTINS",2,2,7,557,4,572,"2020"
"56213","170555 COMBINADO",0,0,1,58,1,60,"2020"
"56214","170560 CONCEICAO DO TOCANTINS",1,1,1,52,0,55,"2020"
"56215","170600 COUTO MAGALHAES",0,0,1,65,0,66,"2020"
"56216","170610 CRISTALANDIA",0,1,3,80,0,84,"2020"
"56217","170625 CRIXAS DO TOCANTINS",0,0,0,21,0,21,"2020"
"56218","170650 DARCINOPOLIS",0,0,1,91,6,98,"2020"
"56219","170700 DIANOPOLIS",3,1,8,300,1,313,"2020"
"56220","170710 DIVINOPOLIS DO TOCANTINS",0,0,0,89,0,89,"2020"
"56221","170720 DOIS IRMAOS DO TOCANTINS",0,0,0,62,1,63,"2020"
"56222","170730 DUERE",0,0,1,72,0,73,"2020"
"56223","170740 ESPERANTINA",0,1,6,122,16,145,"2020"
"56224","170755 FATIMA",0,0,0,43,3,46,"2020"
"56225","170765 FIGUEIROPOLIS",0,0,0,55,0,55,"2020"
"56226","170770 FILADELFIA",0,1,2,95,2,100,"2020"
"56227","170820 FORMOSO DO ARAGUAIA",1,0,4,242,0,247,"2020"
"56228","170825 FORTALEZA DO TABOCAO",0,0,0,62,0,62,"2020"
"56229","170830 GOIANORTE",0,0,0,65,0,65,"2020"
"56230","170900 GOIATINS",1,2,4,219,10,236,"2020"
"56231","170930 GUARAI",0,1,2,366,1,370,"2020"
"56232","170950 GURUPI",4,2,8,1269,0,1283,"2020"
"56233","170980 IPUEIRAS",0,0,1,19,0,20,"2020"
"56234","171050 ITACAJA",0,1,0,117,4,122,"2020"
"56235","171070 ITAGUATINS",0,0,0,63,4,67,"2020"
"56236","171090 ITAPIRATINS",0,0,1,56,0,57,"2020"
"56237","171110 ITAPORA DO TOCANTINS",0,0,0,33,0,33,"2020"
"56238","171150 JAU DO TOCANTINS",0,0,1,32,0,33,"2020"
"56239","171180 JUARINA",0,0,1,33,0,34,"2020"
"56240","171190 LAGOA DA CONFUSAO",1,1,1,260,0,263,"2020"
"56241","171195 LAGOA DO TOCANTINS",0,0,0,56,0,56,"2020"
"56242","171200 LAJEADO",1,0,0,55,0,56,"2020"
"56243","171215 LAVANDEIRA",0,0,1,20,0,21,"2020"
"56244","171240 LIZARDA",0,0,1,41,3,45,"2020"
"56245","171245 LUZINOPOLIS",0,0,1,32,2,35,"2020"
"56246","171250 MARIANOPOLIS DO TOCANTINS",0,0,0,65,1,66,"2020"
"56247","171270 MATEIROS",0,0,1,40,1,42,"2020"
"56248","171280 MAURILANDIA DO TOCANTINS",0,0,1,32,4,37,"2020"
"56249","171320 MIRACEMA DO TOCANTINS",1,1,3,318,1,324,"2020"
"56250","171330 MIRANORTE",1,0,3,182,0,186,"2020"
"56251","171360 MONTE DO CARMO",0,0,0,72,0,72,"2020"
"56252","171370 MONTE SANTO DO TOCANTINS",0,0,1,24,0,25,"2020"
"56253","171380 PALMEIRAS DO TOCANTINS",0,0,1,60,0,61,"2020"
"56254","171395 MURICILANDIA",0,0,2,57,0,59,"2020"
"56255","171420 NATIVIDADE",0,1,2,128,0,131,"2020"
"56256","171430 NAZARE",0,0,0,51,0,51,"2020"
"56257","171488 NOVA OLINDA",0,0,3,151,1,155,"2020"
"56258","171500 NOVA ROSALANDIA",0,0,0,41,0,41,"2020"
"56259","171510 NOVO ACORDO",0,1,1,70,2,74,"2020"
"56260","171515 NOVO ALEGRE",0,0,0,18,1,19,"2020"
"56261","171525 NOVO JARDIM",1,0,0,28,0,29,"2020"
"56262","171550 OLIVEIRA DE FATIMA",0,0,0,16,1,17,"2020"
"56263","171570 PALMEIRANTE",0,0,1,55,0,56,"2020"
"56264","171575 PALMEIROPOLIS",0,0,1,72,0,73,"2020"
"56265","171610 PARAISO DO TOCANTINS",3,2,5,816,0,826,"2020"
"56266","171620 PARANA",0,1,1,169,0,171,"2020"
"56267","171630 PAU D'ARCO",0,0,0,65,1,66,"2020"
"56268","171650 PEDRO AFONSO",1,1,2,247,0,251,"2020"
"56269","171660 PEIXE",1,1,0,132,0,134,"2020"
"56270","171665 PEQUIZEIRO",0,0,0,60,0,60,"2020"
"56271","171670 COLMEIA",0,1,0,103,0,104,"2020"
"56272","171700 PINDORAMA DO TOCANTINS",0,1,2,46,0,49,"2020"
"56273","171720 PIRAQUE",0,0,1,28,1,30,"2020"
"56274","171750 PIUM",0,0,0,84,2,86,"2020"
"56275","171780 PONTE ALTA DO BOM JESUS",0,0,0,49,2,51,"2020"
"56276","171790 PONTE ALTA DO TOCANTINS",0,0,3,93,1,97,"2020"
"56277","171800 PORTO ALEGRE DO TOCANTINS",0,0,2,42,0,44,"2020"
"56278","171820 PORTO NACIONAL",2,5,12,1161,5,1185,"2020"
"56279","171830 PRAIA NORTE",0,0,1,67,13,81,"2020"
"56280","171840 PRESIDENTE KENNEDY",0,0,0,40,0,40,"2020"
"56281","171845 PUGMIL",0,0,0,27,1,28,"2020"
"56282","171850 RECURSOLANDIA",0,1,0,36,0,37,"2020"
"56283","171855 RIACHINHO",1,0,2,50,1,54,"2020"
"56284","171865 RIO DA CONCEICAO",0,0,0,28,0,28,"2020"
"56285","171870 RIO DOS BOIS",0,0,1,37,0,38,"2020"
"56286","171875 RIO SONO",0,0,2,61,1,64,"2020"
"56287","171880 SAMPAIO",0,0,1,71,9,81,"2020"
"56288","171884 SANDOLANDIA",0,1,1,45,0,47,"2020"
"56289","171886 SANTA FE DO ARAGUAIA",1,0,2,121,3,127,"2020"
"56290","171888 SANTA MARIA DO TOCANTINS",1,1,0,36,0,38,"2020"
"56291","171889 SANTA RITA DO TOCANTINS",0,0,1,37,0,38,"2020"
"56292","171890 SANTA ROSA DO TOCANTINS",0,0,2,78,1,81,"2020"
"56293","171900 SANTA TEREZA DO TOCANTINS",1,0,4,55,3,63,"2020"
"56294","172000 SANTA TEREZINHA DO TOCANTINS",0,0,0,21,1,22,"2020"
"56295","172010 SAO BENTO DO TOCANTINS",0,0,1,57,10,68,"2020"
"56296","172015 SAO FELIX DO TOCANTINS",0,0,0,23,1,24,"2020"
"56297","172020 SAO MIGUEL DO TOCANTINS",0,0,1,120,5,126,"2020"
"56298","172025 SAO SALVADOR DO TOCANTINS",0,0,0,36,0,36,"2020"
"56299","172030 SAO SEBASTIAO DO TOCANTINS",0,0,5,66,12,83,"2020"
"56300","172049 SAO VALERIO",0,0,2,42,0,44,"2020"
"56301","172065 SILVANOPOLIS",0,0,3,78,0,81,"2020"
"56302","172080 SITIO NOVO DO TOCANTINS",0,1,1,141,8,151,"2020"
"56303","172085 SUCUPIRA",0,0,0,27,0,27,"2020"
"56304","172090 TAGUATINGA",1,1,3,111,0,116,"2020"
"56305","172093 TAIPAS DO TOCANTINS",0,0,0,30,0,30,"2020"
"56306","172097 TALISMA",0,0,0,23,0,23,"2020"
"56307","172100 PALMAS",27,11,66,4818,24,4946,"2020"
"56308","172110 TOCANTINIA",1,0,1,186,3,191,"2020"
"56309","172120 TOCANTINOPOLIS",0,0,4,365,4,373,"2020"
"56310","172125 TUPIRAMA",0,1,0,37,0,38,"2020"
"56311","172130 TUPIRATINS",0,0,0,28,0,28,"2020"
"56312","172208 WANDERLANDIA",0,1,1,135,1,138,"2020"
"56313","172210 XAMBIOA",3,1,5,182,2,193,"2020"
"56314","MUNICIPIO IGNORADO - MA",0,0,0,6,0,6,"2020"
"56315","210005 ACAILANDIA",3,4,35,1710,12,1764,"2020"
"56316","210010 AFONSO CUNHA",0,2,5,98,2,107,"2020"
"56317","210015 AGUA DOCE DO MARANHAO",0,1,5,159,4,169,"2020"
"56318","210020 ALCANTARA",0,2,4,172,34,212,"2020"
"56319","210030 ALDEIAS ALTAS",1,1,17,410,1,430,"2020"
"56320","210040 ALTAMIRA DO MARANHAO",0,0,1,74,0,75,"2020"
"56321","210043 ALTO ALEGRE DO MARANHAO",1,2,5,387,2,397,"2020"
"56322","210047 ALTO ALEGRE DO PINDARE",4,2,2,410,22,440,"2020"
"56323","210050 ALTO PARNAIBA",1,1,10,176,3,191,"2020"
"56324","210055 AMAPA DO MARANHAO",0,0,2,117,7,126,"2020"
"56325","210060 AMARANTE DO MARANHAO",2,9,16,646,56,729,"2020"
"56326","210070 ANAJATUBA",1,0,3,269,2,275,"2020"
"56327","210080 ANAPURUS",0,1,2,298,2,303,"2020"
"56328","210083 APICUM-ACU",4,0,2,80,169,255,"2020"
"56329","210087 ARAGUANA",0,0,4,171,7,182,"2020"
"56330","210090 ARAIOSES",1,3,11,530,7,552,"2020"
"56331","210095 ARAME",3,4,12,560,3,582,"2020"
"56332","210100 ARARI",2,3,17,385,3,410,"2020"
"56333","210110 AXIXA",0,0,0,157,3,160,"2020"
"56334","210120 BACABAL",6,8,33,1548,3,1598,"2020"
"56335","210125 BACABEIRA",1,2,8,273,2,286,"2020"
"56336","210130 BACURI",1,1,1,123,136,262,"2020"
"56337","210135 BACURITUBA",0,0,0,49,0,49,"2020"
"56338","210140 BALSAS",5,6,27,1802,2,1842,"2020"
"56339","210150 BARAO DE GRAJAU",2,1,5,259,0,267,"2020"
"56340","210160 BARRA DO CORDA",3,2,11,192,1237,1445,"2020"
"56341","210170 BARREIRINHAS",6,4,13,1217,30,1270,"2020"
"56342","210173 BELAGUA",0,1,0,38,169,208,"2020"
"56343","210177 BELA VISTA DO MARANHAO",0,1,1,186,1,189,"2020"
"56344","210180 BENEDITO LEITE",0,0,2,58,6,66,"2020"
"56345","210190 BEQUIMAO",0,0,4,69,155,228,"2020"
"56346","210193 BERNARDO DO MEARIM",0,0,1,70,0,71,"2020"
"56347","210197 BOA VISTA DO GURUPI",0,0,1,130,2,133,"2020"
"56348","210200 BOM JARDIM",2,2,4,573,32,613,"2020"
"56349","210203 BOM JESUS DAS SELVAS",0,5,11,479,3,498,"2020"
"56350","210207 BOM LUGAR",0,2,2,161,0,165,"2020"
"56351","210210 BREJO",0,2,9,503,1,515,"2020"
"56352","210215 BREJO DE AREIA",0,0,0,153,4,157,"2020"
"56353","210220 BURITI",1,4,8,512,1,526,"2020"
"56354","210230 BURITI BRAVO",11,1,6,323,2,343,"2020"
"56355","210232 BURITICUPU",2,5,19,1142,6,1174,"2020"
"56356","210235 BURITIRANA",0,0,5,195,11,211,"2020"
"56357","210237 CACHOEIRA GRANDE",0,1,2,148,12,163,"2020"
"56358","210240 CAJAPIO",2,1,27,76,16,122,"2020"
"56359","210250 CAJARI",0,1,3,96,155,255,"2020"
"56360","210255 CAMPESTRE DO MARANHAO",1,0,7,197,5,210,"2020"
"56361","210260 CANDIDO MENDES",0,2,3,306,33,344,"2020"
"56362","210270 CANTANHEDE",0,1,5,283,3,292,"2020"
"56363","210275 CAPINZAL DO NORTE",0,0,3,143,1,147,"2020"
"56364","210280 CAROLINA",2,3,9,373,3,390,"2020"
"56365","210290 CARUTAPERA",3,4,11,397,18,433,"2020"
"56366","210300 CAXIAS",5,7,77,2400,25,2514,"2020"
"56367","210310 CEDRAL",0,0,1,63,38,102,"2020"
"56368","210312 CENTRAL DO MARANHAO",0,0,0,103,25,128,"2020"
"56369","210315 CENTRO DO GUILHERME",1,9,5,189,10,214,"2020"
"56370","210317 CENTRO NOVO DO MARANHAO",3,5,4,293,27,332,"2020"
"56371","210320 CHAPADINHA",2,11,20,1408,7,1448,"2020"
"56372","210325 CIDELANDIA",0,1,3,78,48,130,"2020"
"56373","210330 CODO",5,9,38,1736,20,1808,"2020"
"56374","210340 COELHO NETO",6,3,10,581,6,606,"2020"
"56375","210350 COLINAS",1,2,13,612,5,633,"2020"
"56376","210355 CONCEICAO DO LAGO-ACU",1,1,9,211,19,241,"2020"
"56377","210360 COROATA",1,3,16,972,16,1008,"2020"
"56378","210370 CURURUPU",1,0,1,242,263,507,"2020"
"56379","210375 DAVINOPOLIS",1,0,6,202,2,211,"2020"
"56380","210380 DOM PEDRO",0,0,7,334,4,345,"2020"
"56381","210390 DUQUE BACELAR",1,1,4,162,0,168,"2020"
"56382","210400 ESPERANTINOPOLIS",0,1,3,287,2,293,"2020"
"56383","210405 ESTREITO",0,0,4,97,445,546,"2020"
"56384","210407 FEIRA NOVA DO MARANHAO",0,0,1,103,16,120,"2020"
"56385","210408 FERNANDO FALCAO",0,3,1,21,210,235,"2020"
"56386","210409 FORMOSA DA SERRA NEGRA",1,0,2,185,28,216,"2020"
"56387","210410 FORTALEZA DOS NOGUEIRAS",0,0,3,206,5,214,"2020"
"56388","210420 FORTUNA",1,1,2,235,0,239,"2020"
"56389","210430 GODOFREDO VIANA",0,2,4,151,8,165,"2020"
"56390","210440 GONCALVES DIAS",0,0,2,93,119,214,"2020"
"56391","210450 GOVERNADOR ARCHER",0,1,1,160,5,167,"2020"
"56392","210455 GOVERNADOR EDISON LOBAO",0,1,9,308,9,327,"2020"
"56393","210460 GOVERNADOR EUGENIO BARROS",0,0,2,231,7,240,"2020"
"56394","210462 GOVERNADOR LUIZ ROCHA",0,2,0,86,13,101,"2020"
"56395","210465 GOVERNADOR NEWTON BELLO",0,0,2,150,1,153,"2020"
"56396","210467 GOVERNADOR NUNES FREIRE",7,4,3,415,3,432,"2020"
"56397","210470 GRACA ARANHA",0,2,1,66,0,69,"2020"
"56398","210480 GRAJAU",1,4,17,1404,15,1441,"2020"
"56399","210490 GUIMARAES",1,0,0,110,19,130,"2020"
"56400","210500 HUMBERTO DE CAMPOS",2,1,5,403,102,513,"2020"
"56401","210510 ICATU",0,1,8,299,41,349,"2020"
"56402","210515 IGARAPE DO MEIO",0,0,4,278,3,285,"2020"
"56403","210520 IGARAPE GRANDE",2,0,0,166,3,171,"2020"
"56404","210530 IMPERATRIZ",6,5,85,4676,21,4793,"2020"
"56405","210535 ITAIPAVA DO GRAJAU",1,0,3,198,8,210,"2020"
"56406","210540 ITAPECURU MIRIM",1,1,6,1162,5,1175,"2020"
"56407","210542 ITINGA DO MARANHAO",0,3,4,246,0,253,"2020"
"56408","210545 JATOBA",0,1,3,123,1,128,"2020"
"56409","210547 JENIPAPO DOS VIEIRAS",0,1,4,105,234,344,"2020"
"56410","210550 JOAO LISBOA",2,6,9,399,3,419,"2020"
"56411","210560 JOSELANDIA",0,1,0,197,0,198,"2020"
"56412","210565 JUNCO DO MARANHAO",0,0,0,98,0,98,"2020"
"56413","210570 LAGO DA PEDRA",4,1,6,744,6,761,"2020"
"56414","210580 LAGO DO JUNCO",0,0,0,144,0,144,"2020"
"56415","210590 LAGO VERDE",0,2,3,230,5,240,"2020"
"56416","210592 LAGOA DO MATO",1,0,2,126,2,131,"2020"
"56417","210594 LAGO DOS RODRIGUES",0,0,1,87,0,88,"2020"
"56418","210596 LAGOA GRANDE DO MARANHAO",0,0,0,199,6,205,"2020"
"56419","210598 LAJEADO NOVO",0,1,4,90,0,95,"2020"
"56420","210600 LIMA CAMPOS",0,0,4,167,1,172,"2020"
"56421","210610 LORETO",1,1,1,120,25,148,"2020"
"56422","210620 LUIS DOMINGUES",0,0,3,65,64,132,"2020"
"56423","210630 MAGALHAES DE ALMEIDA",1,1,3,167,1,173,"2020"
"56424","210632 MARACACUME",2,1,2,351,3,359,"2020"
"56425","210635 MARAJA DO SENA",0,0,1,103,3,107,"2020"
"56426","210637 MARANHAOZINHO",2,0,0,179,7,188,"2020"
"56427","210640 MATA ROMA",2,1,5,277,5,290,"2020"
"56428","210650 MATINHA",2,0,3,41,311,357,"2020"
"56429","210660 MATOES",1,8,8,404,0,421,"2020"
"56430","210663 MATOES DO NORTE",1,1,3,137,3,145,"2020"
"56431","210667 MILAGRES DO MARANHAO",0,1,1,69,2,73,"2020"
"56432","210670 MIRADOR",0,0,5,279,11,295,"2020"
"56433","210675 MIRANDA DO NORTE",0,1,6,251,5,263,"2020"
"56434","210680 MIRINZAL",1,0,0,89,133,223,"2020"
"56435","210690 MONCAO",1,0,7,469,0,477,"2020"
"56436","210700 MONTES ALTOS",0,0,4,124,8,136,"2020"
"56437","210710 MORROS",3,1,4,308,35,351,"2020"
"56438","210720 NINA RODRIGUES",1,3,3,214,3,224,"2020"
"56439","210725 NOVA COLINAS",0,0,1,76,0,77,"2020"
"56440","210730 NOVA IORQUE",0,1,0,41,2,44,"2020"
"56441","210735 NOVA OLINDA DO MARANHAO",0,0,12,258,7,277,"2020"
"56442","210740 OLHO D'AGUA DAS CUNHAS",0,2,0,280,0,282,"2020"
"56443","210745 OLINDA NOVA DO MARANHAO",1,0,1,31,147,180,"2020"
"56444","210750 PACO DO LUMIAR",11,11,21,1727,27,1797,"2020"
"56445","210760 PALMEIRANDIA",1,2,5,192,45,245,"2020"
"56446","210770 PARAIBANO",3,1,7,262,3,276,"2020"
"56447","210780 PARNARAMA",0,1,5,425,16,447,"2020"
"56448","210790 PASSAGEM FRANCA",2,0,1,295,1,299,"2020"
"56449","210800 PASTOS BONS",0,1,2,98,176,277,"2020"
"56450","210805 PAULINO NEVES",0,1,3,314,13,331,"2020"
"56451","210810 PAULO RAMOS",4,1,2,360,2,369,"2020"
"56452","210820 PEDREIRAS",3,0,1,517,2,523,"2020"
"56453","210825 PEDRO DO ROSARIO",1,0,9,328,22,360,"2020"
"56454","210830 PENALVA",1,5,3,584,41,634,"2020"
"56455","210840 PERI MIRIM",0,0,1,120,12,133,"2020"
"56456","210845 PERITORO",0,1,6,326,1,334,"2020"
"56457","210850 PINDARE-MIRIM",0,0,6,452,4,462,"2020"
"56458","210860 PINHEIRO",1,7,23,1332,48,1411,"2020"
"56459","210870 PIO XII",0,0,3,375,0,378,"2020"
"56460","210880 PIRAPEMAS",1,2,6,236,4,249,"2020"
"56461","210890 POCAO DE PEDRAS",0,1,3,226,5,235,"2020"
"56462","210900 PORTO FRANCO",1,2,16,399,10,428,"2020"
"56463","210905 PORTO RICO DO MARANHAO",0,0,0,53,11,64,"2020"
"56464","210910 PRESIDENTE DUTRA",1,3,9,744,3,760,"2020"
"56465","210920 PRESIDENTE JUSCELINO",1,2,1,166,24,194,"2020"
"56466","210923 PRESIDENTE MEDICI",0,0,0,77,1,78,"2020"
"56467","210927 PRESIDENTE SARNEY",0,2,6,328,17,353,"2020"
"56468","210930 PRESIDENTE VARGAS",0,0,2,191,14,207,"2020"
"56469","210940 PRIMEIRA CRUZ",0,0,1,171,34,206,"2020"
"56470","210945 RAPOSA",3,1,13,445,5,467,"2020"
"56471","210950 RIACHAO",0,0,3,344,1,348,"2020"
"56472","210955 RIBAMAR FIQUENE",0,0,2,96,3,101,"2020"
"56473","210960 ROSARIO",1,3,20,550,6,580,"2020"
"56474","210970 SAMBAIBA",0,1,3,69,1,74,"2020"
"56475","210975 SANTA FILOMENA DO MARANHAO",0,0,3,77,1,81,"2020"
"56476","210980 SANTA HELENA",1,1,8,417,32,459,"2020"
"56477","210990 SANTA INES",3,8,11,1474,5,1501,"2020"
"56478","211000 SANTA LUZIA",0,3,24,1041,16,1084,"2020"
"56479","211003 SANTA LUZIA DO PARUA",2,2,6,351,1,362,"2020"
"56480","211010 SANTA QUITERIA DO MARANHAO",0,2,9,387,17,415,"2020"
"56481","211020 SANTA RITA",3,2,17,524,5,551,"2020"
"56482","211023 SANTANA DO MARANHAO",1,1,0,108,1,111,"2020"
"56483","211027 SANTO AMARO DO MARANHAO",0,1,2,117,80,200,"2020"
"56484","211030 SANTO ANTONIO DOS LOPES",1,0,6,233,1,241,"2020"
"56485","211040 SAO BENEDITO DO RIO PRETO",1,1,2,340,35,379,"2020"
"56486","211050 SAO BENTO",1,1,3,460,9,474,"2020"
"56487","211060 SAO BERNARDO",1,2,7,372,2,384,"2020"
"56488","211065 SAO DOMINGOS DO AZEITAO",0,0,1,37,29,67,"2020"
"56489","211070 SAO DOMINGOS DO MARANHAO",0,4,2,586,0,592,"2020"
"56490","211080 SAO FELIX DE BALSAS",0,0,0,32,34,66,"2020"
"56491","211085 SAO FRANCISCO DO BREJAO",0,0,3,101,1,105,"2020"
"56492","211090 SAO FRANCISCO DO MARANHAO",1,1,1,113,17,133,"2020"
"56493","211100 SAO JOAO BATISTA",2,2,10,157,58,229,"2020"
"56494","211102 SAO JOAO DO CARU",0,0,0,245,2,247,"2020"
"56495","211105 SAO JOAO DO PARAISO",1,0,6,130,10,147,"2020"
"56496","211107 SAO JOAO DO SOTER",1,0,8,212,2,223,"2020"
"56497","211110 SAO JOAO DOS PATOS",0,4,5,358,5,372,"2020"
"56498","211120 SAO JOSE DE RIBAMAR",22,20,59,3401,54,3556,"2020"
"56499","211125 SAO JOSE DOS BASILIOS",0,0,1,96,0,97,"2020"
"56500","211130 SAO LUIS",90,57,260,13741,139,14287,"2020"
"56501","211140 SAO LUIS GONZAGA DO MARANHAO",2,4,5,279,2,292,"2020"
"56502","211150 SAO MATEUS DO MARANHAO",0,3,6,574,4,587,"2020"
"56503","211153 SAO PEDRO DA AGUA BRANCA",1,0,2,138,1,142,"2020"
"56504","211157 SAO PEDRO DOS CRENTES",0,0,0,116,1,117,"2020"
"56505","211160 SAO RAIMUNDO DAS MANGABEIRAS",0,1,4,267,52,324,"2020"
"56506","211163 SAO RAIMUNDO DO DOCA BEZERRA",0,2,0,43,46,91,"2020"
"56507","211167 SAO ROBERTO",2,1,0,68,17,88,"2020"
"56508","211170 SAO VICENTE FERRER",1,0,1,26,227,255,"2020"
"56509","211172 SATUBINHA",0,0,1,73,3,77,"2020"
"56510","211174 SENADOR ALEXANDRE COSTA",0,1,4,147,1,153,"2020"
"56511","211176 SENADOR LA ROCQUE",0,0,4,249,2,255,"2020"
"56512","211178 SERRANO DO MARANHAO",0,0,0,81,77,158,"2020"
"56513","211180 SITIO NOVO",0,1,1,236,2,240,"2020"
"56514","211190 SUCUPIRA DO NORTE",0,0,1,191,3,195,"2020"
"56515","211195 SUCUPIRA DO RIACHAO",0,0,1,24,0,25,"2020"
"56516","211200 TASSO FRAGOSO",1,1,3,146,3,154,"2020"
"56517","211210 TIMBIRAS",1,1,3,469,0,474,"2020"
"56518","211220 TIMON",3,8,37,2834,6,2888,"2020"
"56519","211223 TRIZIDELA DO VALE",1,1,4,314,0,320,"2020"
"56520","211227 TUFILANDIA",0,0,3,79,0,82,"2020"
"56521","211230 TUNTUM",1,1,2,447,36,487,"2020"
"56522","211240 TURIACU",0,0,2,37,631,670,"2020"
"56523","211245 TURILANDIA",2,1,5,242,84,334,"2020"
"56524","211250 TUTOIA",1,3,9,972,27,1012,"2020"
"56525","211260 URBANO SANTOS",1,0,2,79,520,602,"2020"
"56526","211270 VARGEM GRANDE",0,3,16,788,11,818,"2020"
"56527","211280 VIANA",4,2,12,811,95,924,"2020"
"56528","211285 VILA NOVA DOS MARTIRIOS",0,0,4,155,1,160,"2020"
"56529","211290 VITORIA DO MEARIM",6,5,8,436,4,459,"2020"
"56530","211300 VITORINO FREIRE",2,1,1,427,0,431,"2020"
"56531","211400 ZE DOCA",3,5,8,734,4,754,"2020"
"56532","MUNICIPIO IGNORADO - PI",0,0,0,4,0,4,"2020"
"56533","220005 ACAUA",0,0,1,81,2,84,"2020"
"56534","220010 AGRICOLANDIA",0,0,0,60,0,60,"2020"
"56535","220020 AGUA BRANCA",0,1,7,246,1,255,"2020"
"56536","220025 ALAGOINHA DO PIAUI",0,1,1,90,0,92,"2020"
"56537","220027 ALEGRETE DO PIAUI",0,0,1,55,0,56,"2020"
"56538","220030 ALTO LONGA",0,1,3,120,1,125,"2020"
"56539","220040 ALTOS",2,2,5,584,2,595,"2020"
"56540","220045 ALVORADA DO GURGUEIA",0,0,1,61,6,68,"2020"
"56541","220050 AMARANTE",1,0,3,259,4,267,"2020"
"56542","220060 ANGICAL DO PIAUI",0,0,2,77,2,81,"2020"
"56543","220070 ANISIO DE ABREU",1,0,1,97,41,140,"2020"
"56544","220080 ANTONIO ALMEIDA",0,1,0,40,0,41,"2020"
"56545","220090 AROAZES",0,0,0,65,0,65,"2020"
"56546","220095 AROEIRAS DO ITAIM",0,0,0,23,0,23,"2020"
"56547","220100 ARRAIAL",0,2,0,45,0,47,"2020"
"56548","220105 ASSUNCAO DO PIAUI",0,1,4,117,4,126,"2020"
"56549","220110 AVELINO LOPES",0,0,0,101,68,169,"2020"
"56550","220115 BAIXA GRANDE DO RIBEIRO",1,3,3,180,78,265,"2020"
"56551","220117 BARRA D'ALCANTARA",1,0,0,45,0,46,"2020"
"56552","220120 BARRAS",4,4,13,658,3,682,"2020"
"56553","220130 BARREIRAS DO PIAUI",0,0,0,19,33,52,"2020"
"56554","220140 BARRO DURO",0,1,0,80,1,82,"2020"
"56555","220150 BATALHA",0,1,5,314,5,325,"2020"
"56556","220155 BELA VISTA DO PIAUI",0,0,1,59,0,60,"2020"
"56557","220157 BELEM DO PIAUI",0,0,0,39,1,40,"2020"
"56558","220160 BENEDITINOS",1,1,2,114,0,118,"2020"
"56559","220170 BERTOLINIA",1,1,3,64,1,70,"2020"
"56560","220173 BETANIA DO PIAUI",1,0,1,85,16,103,"2020"
"56561","220177 BOA HORA",0,1,0,80,0,81,"2020"
"56562","220180 BOCAINA",0,0,0,33,0,33,"2020"
"56563","220190 BOM JESUS",0,1,3,464,40,508,"2020"
"56564","220191 BOM PRINCIPIO DO PIAUI",0,0,1,93,0,94,"2020"
"56565","220192 BONFIM DO PIAUI",0,0,1,57,20,78,"2020"
"56566","220194 BOQUEIRAO DO PIAUI",0,0,2,79,2,83,"2020"
"56567","220196 BRASILEIRA",0,1,0,91,1,93,"2020"
"56568","220198 BREJO DO PIAUI",0,0,0,28,1,29,"2020"
"56569","220200 BURITI DOS LOPES",0,0,4,306,0,310,"2020"
"56570","220202 BURITI DOS MONTES",1,0,0,46,11,58,"2020"
"56571","220205 CABECEIRAS DO PIAUI",0,1,3,105,2,111,"2020"
"56572","220207 CAJAZEIRAS DO PIAUI",0,0,1,28,0,29,"2020"
"56573","220208 CAJUEIRO DA PRAIA",0,0,1,127,0,128,"2020"
"56574","220209 CALDEIRAO GRANDE DO PIAUI",0,0,1,73,0,74,"2020"
"56575","220210 CAMPINAS DO PIAUI",0,1,0,71,0,72,"2020"
"56576","220211 CAMPO ALEGRE DO FIDALGO",0,0,2,56,1,59,"2020"
"56577","220213 CAMPO GRANDE DO PIAUI",0,1,0,74,0,75,"2020"
"56578","220217 CAMPO LARGO DO PIAUI",0,0,3,96,1,100,"2020"
"56579","220220 CAMPO MAIOR",1,2,8,495,10,516,"2020"
"56580","220225 CANAVIEIRA",0,0,0,35,0,35,"2020"
"56581","220230 CANTO DO BURITI",2,7,5,237,15,266,"2020"
"56582","220240 CAPITAO DE CAMPOS",0,1,2,121,3,127,"2020"
"56583","220245 CAPITAO GERVASIO OLIVEIRA",0,0,0,51,1,52,"2020"
"56584","220250 CARACOL",0,20,14,95,42,171,"2020"
"56585","220253 CARAUBAS DO PIAUI",0,0,0,71,0,71,"2020"
"56586","220255 CARIDADE DO PIAUI",0,0,4,58,0,62,"2020"
"56587","220260 CASTELO DO PIAUI",0,1,4,180,43,228,"2020"
"56588","220265 CAXINGO",0,0,3,88,0,91,"2020"
"56589","220270 COCAL",2,3,4,451,1,461,"2020"
"56590","220271 COCAL DE TELHA",0,0,0,45,2,47,"2020"
"56591","220272 COCAL DOS ALVES",0,0,2,53,0,55,"2020"
"56592","220273 COIVARAS",0,0,0,52,0,52,"2020"
"56593","220275 COLONIA DO GURGUEIA",1,1,2,65,2,71,"2020"
"56594","220277 COLONIA DO PIAUI",0,1,2,80,0,83,"2020"
"56595","220280 CONCEICAO DO CANINDE",0,0,1,53,2,56,"2020"
"56596","220285 CORONEL JOSE DIAS",0,0,1,36,10,47,"2020"
"56597","220290 CORRENTE",1,0,3,183,276,463,"2020"
"56598","220300 CRISTALANDIA DO PIAUI",0,0,1,33,58,92,"2020"
"56599","220310 CRISTINO CASTRO",0,0,2,167,16,185,"2020"
"56600","220320 CURIMATA",0,0,0,55,127,182,"2020"
"56601","220323 CURRAIS",0,0,2,62,3,67,"2020"
"56602","220325 CURRALINHOS",0,0,1,62,0,63,"2020"
"56603","220327 CURRAL NOVO DO PIAUI",0,0,0,82,4,86,"2020"
"56604","220330 DEMERVAL LOBAO",2,0,0,200,0,202,"2020"
"56605","220335 DIRCEU ARCOVERDE",0,9,5,54,22,90,"2020"
"56606","220340 DOM EXPEDITO LOPES",0,0,0,61,0,61,"2020"
"56607","220342 DOMINGOS MOURAO",0,0,0,48,0,48,"2020"
"56608","220345 DOM INOCENCIO",1,8,5,54,27,95,"2020"
"56609","220350 ELESBAO VELOSO",0,2,2,153,5,162,"2020"
"56610","220360 ELISEU MARTINS",2,2,1,45,1,51,"2020"
"56611","220370 ESPERANTINA",4,3,7,609,1,624,"2020"
"56612","220375 FARTURA DO PIAUI",2,0,0,55,19,76,"2020"
"56613","220380 FLORES DO PIAUI",1,0,2,46,1,50,"2020"
"56614","220385 FLORESTA DO PIAUI",1,1,0,17,0,19,"2020"
"56615","220390 FLORIANO",1,8,10,862,0,881,"2020"
"56616","220400 FRANCINOPOLIS",0,0,1,45,0,46,"2020"
"56617","220410 FRANCISCO AYRES",0,2,0,54,0,56,"2020"
"56618","220415 FRANCISCO MACEDO",0,0,0,30,1,31,"2020"
"56619","220420 FRANCISCO SANTOS",0,1,1,87,0,89,"2020"
"56620","220430 FRONTEIRAS",0,1,1,132,0,134,"2020"
"56621","220435 GEMINIANO",0,0,1,92,0,93,"2020"
"56622","220440 GILBUES",0,0,1,101,83,185,"2020"
"56623","220450 GUADALUPE",1,3,3,144,0,151,"2020"
"56624","220455 GUARIBAS",2,5,6,41,15,69,"2020"
"56625","220460 HUGO NAPOLEAO",0,0,2,60,1,63,"2020"
"56626","220465 ILHA GRANDE",0,0,2,155,0,157,"2020"
"56627","220470 INHUMA",1,0,1,176,1,179,"2020"
"56628","220480 IPIRANGA DO PIAUI",0,1,1,105,0,107,"2020"
"56629","220490 ISAIAS COELHO",0,0,1,88,0,89,"2020"
"56630","220500 ITAINOPOLIS",0,2,3,106,0,111,"2020"
"56631","220510 ITAUEIRA",0,1,2,98,0,101,"2020"
"56632","220515 JACOBINA DO PIAUI",0,2,1,65,10,78,"2020"
"56633","220520 JAICOS",0,0,9,236,0,245,"2020"
"56634","220525 JARDIM DO MULATO",0,0,1,44,0,45,"2020"
"56635","220527 JATOBA DO PIAUI",0,0,1,45,2,48,"2020"
"56636","220530 JERUMENHA",0,0,0,49,0,49,"2020"
"56637","220535 JOAO COSTA",0,0,0,37,0,37,"2020"
"56638","220540 JOAQUIM PIRES",0,1,2,195,2,200,"2020"
"56639","220545 JOCA MARQUES",0,1,1,70,0,72,"2020"
"56640","220550 JOSE DE FREITAS",1,1,4,612,2,620,"2020"
"56641","220551 JUAZEIRO DO PIAUI",0,0,1,50,1,52,"2020"
"56642","220552 JULIO BORGES",0,0,1,20,58,79,"2020"
"56643","220553 JUREMA",1,2,0,48,16,67,"2020"
"56644","220554 LAGOINHA DO PIAUI",0,0,1,31,1,33,"2020"
"56645","220555 LAGOA ALEGRE",1,0,0,92,2,95,"2020"
"56646","220556 LAGOA DO BARRO DO PIAUI",1,12,9,48,6,76,"2020"
"56647","220557 LAGOA DE SAO FRANCISCO",0,0,1,58,0,59,"2020"
"56648","220558 LAGOA DO PIAUI",0,0,0,71,0,71,"2020"
"56649","220559 LAGOA DO SITIO",0,1,1,45,1,48,"2020"
"56650","220560 LANDRI SALES",3,0,0,75,0,78,"2020"
"56651","220570 LUIS CORREIA",1,3,8,436,7,455,"2020"
"56652","220580 LUZILANDIA",4,1,5,321,17,348,"2020"
"56653","220585 MADEIRO",1,1,2,95,2,101,"2020"
"56654","220590 MANOEL EMIDIO",0,0,1,65,0,66,"2020"
"56655","220595 MARCOLANDIA",0,0,3,131,0,134,"2020"
"56656","220600 MARCOS PARENTE",0,0,1,62,1,64,"2020"
"56657","220605 MASSAPE DO PIAUI",0,0,1,52,0,53,"2020"
"56658","220610 MATIAS OLIMPIO",0,1,1,157,2,161,"2020"
"56659","220620 MIGUEL ALVES",1,1,8,467,5,482,"2020"
"56660","220630 MIGUEL LEAO",0,0,0,15,0,15,"2020"
"56661","220635 MILTON BRANDAO",0,1,1,75,0,77,"2020"
"56662","220640 MONSENHOR GIL",1,0,2,141,2,146,"2020"
"56663","220650 MONSENHOR HIPOLITO",0,1,1,92,0,94,"2020"
"56664","220660 MONTE ALEGRE DO PIAUI",0,1,2,135,35,173,"2020"
"56665","220665 MORRO CABECA NO TEMPO",0,0,1,29,34,64,"2020"
"56666","220667 MORRO DO CHAPEU DO PIAUI",0,0,2,92,1,95,"2020"
"56667","220669 MURICI DOS PORTELAS",0,0,3,83,0,86,"2020"
"56668","220670 NAZARE DO PIAUI",0,0,2,84,0,86,"2020"
"56669","220672 NAZARIA",3,1,3,129,1,137,"2020"
"56670","220675 NOSSA SENHORA DE NAZARE",0,1,0,56,2,59,"2020"
"56671","220680 NOSSA SENHORA DOS REMEDIOS",0,2,0,135,3,140,"2020"
"56672","220690 NOVO ORIENTE DO PIAUI",0,0,1,55,0,56,"2020"
"56673","220695 NOVO SANTO ANTONIO",0,0,1,27,1,29,"2020"
"56674","220700 OEIRAS",0,3,8,488,2,501,"2020"
"56675","220710 OLHO D'AGUA DO PIAUI",0,0,1,38,0,39,"2020"
"56676","220720 PADRE MARCOS",0,0,0,72,1,73,"2020"
"56677","220730 PAES LANDIM",0,0,0,68,0,68,"2020"
"56678","220735 PAJEU DO PIAUI",0,3,1,19,3,26,"2020"
"56679","220740 PALMEIRA DO PIAUI",0,0,1,62,8,71,"2020"
"56680","220750 PALMEIRAIS",0,1,1,128,38,168,"2020"
"56681","220755 PAQUETA",0,0,1,40,0,41,"2020"
"56682","220760 PARNAGUA",0,1,2,30,119,152,"2020"
"56683","220770 PARNAIBA",3,7,41,2473,6,2530,"2020"
"56684","220775 PASSAGEM FRANCA DO PIAUI",0,0,0,47,1,48,"2020"
"56685","220777 PATOS DO PIAUI",0,0,0,58,2,60,"2020"
"56686","220779 PAU D'ARCO DO PIAUI",0,1,1,46,1,49,"2020"
"56687","220780 PAULISTANA",0,0,5,227,73,305,"2020"
"56688","220785 PAVUSSU",0,0,1,33,2,36,"2020"
"56689","220790 PEDRO II",2,2,11,496,2,513,"2020"
"56690","220793 PEDRO LAURENTINO",0,0,0,31,0,31,"2020"
"56691","220795 NOVA SANTA RITA",0,0,1,43,0,44,"2020"
"56692","220800 PICOS",2,3,14,1007,0,1026,"2020"
"56693","220810 PIMENTEIRAS",0,0,0,119,0,119,"2020"
"56694","220820 PIO IX",0,1,2,221,3,227,"2020"
"56695","220830 PIRACURUCA",0,1,1,362,0,364,"2020"
"56696","220840 PIRIPIRI",3,1,11,877,0,892,"2020"
"56697","220850 PORTO",0,1,4,202,1,208,"2020"
"56698","220855 PORTO ALEGRE DO PIAUI",0,0,1,39,0,40,"2020"
"56699","220860 PRATA DO PIAUI",0,2,0,47,1,50,"2020"
"56700","220865 QUEIMADA NOVA",0,1,4,72,25,102,"2020"
"56701","220870 REDENCAO DO GURGUEIA",1,0,2,113,8,124,"2020"
"56702","220880 REGENERACAO",0,0,1,243,2,246,"2020"
"56703","220885 RIACHO FRIO",0,0,0,21,35,56,"2020"
"56704","220887 RIBEIRA DO PIAUI",0,0,0,47,0,47,"2020"
"56705","220890 RIBEIRO GONCALVES",0,0,1,15,71,87,"2020"
"56706","220900 RIO GRANDE DO PIAUI",0,0,0,58,6,64,"2020"
"56707","220910 SANTA CRUZ DO PIAUI",0,0,4,66,0,70,"2020"
"56708","220915 SANTA CRUZ DOS MILAGRES",0,0,1,30,0,31,"2020"
"56709","220920 SANTA FILOMENA",0,1,2,94,1,98,"2020"
"56710","220930 SANTA LUZ",0,0,0,62,7,69,"2020"
"56711","220935 SANTANA DO PIAUI",0,0,0,37,0,37,"2020"
"56712","220937 SANTA ROSA DO PIAUI",0,0,0,63,1,64,"2020"
"56713","220940 SANTO ANTONIO DE LISBOA",0,0,1,67,0,68,"2020"
"56714","220945 SANTO ANTONIO DOS MILAGRES",0,0,0,28,1,29,"2020"
"56715","220950 SANTO INACIO DO PIAUI",0,0,1,47,0,48,"2020"
"56716","220955 SAO BRAZ DO PIAUI",0,0,0,34,7,41,"2020"
"56717","220960 SAO FELIX DO PIAUI",0,0,1,20,1,22,"2020"
"56718","220965 SAO FRANCISCO DE ASSIS DO PIAUI",0,3,1,68,1,73,"2020"
"56719","220970 SAO FRANCISCO DO PIAUI",0,2,2,57,0,61,"2020"
"56720","220975 SAO GONCALO DO GURGUEIA",0,0,1,19,20,40,"2020"
"56721","220980 SAO GONCALO DO PIAUI",0,1,1,61,0,63,"2020"
"56722","220985 SAO JOAO DA CANABRAVA",0,0,0,48,0,48,"2020"
"56723","220987 SAO JOAO DA FRONTEIRA",0,1,2,69,0,72,"2020"
"56724","220990 SAO JOAO DA SERRA",1,0,0,61,2,64,"2020"
"56725","220995 SAO JOAO DA VARJOTA",0,0,0,49,0,49,"2020"
"56726","220997 SAO JOAO DO ARRAIAL",0,4,2,142,0,148,"2020"
"56727","221000 SAO JOAO DO PIAUI",2,3,0,321,3,329,"2020"
"56728","221005 SAO JOSE DO DIVINO",0,0,0,55,0,55,"2020"
"56729","221010 SAO JOSE DO PEIXE",0,0,1,33,0,34,"2020"
"56730","221020 SAO JOSE DO PIAUI",0,0,1,90,0,91,"2020"
"56731","221030 SAO JULIAO",0,0,0,76,0,76,"2020"
"56732","221035 SAO LOURENCO DO PIAUI",0,2,1,27,10,40,"2020"
"56733","221037 SAO LUIS DO PIAUI",0,1,0,24,0,25,"2020"
"56734","221038 SAO MIGUEL DA BAIXA GRANDE",0,0,3,17,1,21,"2020"
"56735","221039 SAO MIGUEL DO FIDALGO",0,1,1,38,0,40,"2020"
"56736","221040 SAO MIGUEL DO TAPUIO",1,1,2,217,10,231,"2020"
"56737","221050 SAO PEDRO DO PIAUI",1,1,4,180,1,187,"2020"
"56738","221060 SAO RAIMUNDO NONATO",6,6,8,428,115,563,"2020"
"56739","221062 SEBASTIAO BARROS",0,0,0,21,36,57,"2020"
"56740","221063 SEBASTIAO LEAL",0,0,0,48,0,48,"2020"
"56741","221065 SIGEFREDO PACHECO",1,0,0,74,5,80,"2020"
"56742","221070 SIMOES",0,0,0,197,0,197,"2020"
"56743","221080 SIMPLICIO MENDES",0,2,4,137,0,143,"2020"
"56744","221090 SOCORRO DO PIAUI",0,1,0,35,1,37,"2020"
"56745","221093 SUSSUAPARA",0,1,1,81,0,83,"2020"
"56746","221095 TAMBORIL DO PIAUI",1,0,1,34,11,47,"2020"
"56747","221097 TANQUE DO PIAUI",0,0,0,27,0,27,"2020"
"56748","221100 TERESINA",26,31,101,12523,44,12725,"2020"
"56749","221110 UNIAO",0,2,2,567,8,579,"2020"
"56750","221120 URUCUI",1,1,5,428,7,442,"2020"
"56751","221130 VALENCA DO PIAUI",1,0,5,263,1,270,"2020"
"56752","221135 VARZEA BRANCA",0,0,0,68,17,85,"2020"
"56753","221140 VARZEA GRANDE",1,0,1,33,0,35,"2020"
"56754","221150 VERA MENDES",0,1,0,40,0,41,"2020"
"56755","221160 VILA NOVA DO PIAUI",0,0,0,19,0,19,"2020"
"56756","221170 WALL FERRAZ",0,0,0,42,0,42,"2020"
"56757","230010 ABAIARA",0,0,6,145,0,151,"2020"
"56758","230015 ACARAPE",0,1,1,184,1,187,"2020"
"56759","230020 ACARAU",4,5,7,998,0,1014,"2020"
"56760","230030 ACOPIARA",1,3,11,527,3,545,"2020"
"56761","230040 AIUABA",0,0,5,193,1,199,"2020"
"56762","230050 ALCANTARAS",0,0,3,154,1,158,"2020"
"56763","230060 ALTANEIRA",0,2,0,104,0,106,"2020"
"56764","230070 ALTO SANTO",1,0,2,162,0,165,"2020"
"56765","230075 AMONTADA",2,3,19,601,63,688,"2020"
"56766","230080 ANTONINA DO NORTE",1,1,1,87,0,90,"2020"
"56767","230090 APUIARES",1,0,2,149,1,153,"2020"
"56768","230100 AQUIRAZ",2,6,23,1091,2,1124,"2020"
"56769","230110 ARACATI",1,7,18,938,1,965,"2020"
"56770","230120 ARACOIABA",3,0,3,337,2,345,"2020"
"56771","230125 ARARENDA",0,1,2,137,2,142,"2020"
"56772","230130 ARARIPE",3,1,9,320,0,333,"2020"
"56773","230140 ARATUBA",0,0,1,147,0,148,"2020"
"56774","230150 ARNEIROZ",0,1,1,90,0,92,"2020"
"56775","230160 ASSARE",0,2,5,263,1,271,"2020"
"56776","230170 AURORA",1,0,3,324,1,329,"2020"
"56777","230180 BAIXIO",0,0,1,60,0,61,"2020"
"56778","230185 BANABUIU",0,3,2,241,0,246,"2020"
"56779","230190 BARBALHA",3,4,32,1227,12,1278,"2020"
"56780","230195 BARREIRA",2,3,5,344,2,356,"2020"
"56781","230200 BARRO",0,1,3,215,0,219,"2020"
"56782","230205 BARROQUINHA",1,1,5,196,1,204,"2020"
"56783","230210 BATURITE",2,3,11,472,0,488,"2020"
"56784","230220 BEBERIBE",2,1,10,564,2,579,"2020"
"56785","230230 BELA CRUZ",0,2,10,374,0,386,"2020"
"56786","230240 BOA VIAGEM",1,4,5,635,1,646,"2020"
"56787","230250 BREJO SANTO",1,3,10,766,2,782,"2020"
"56788","230260 CAMOCIM",1,5,28,914,2,950,"2020"
"56789","230270 CAMPOS SALES",1,4,12,313,0,330,"2020"
"56790","230280 CANINDE",2,2,19,1018,2,1043,"2020"
"56791","230290 CAPISTRANO",0,2,1,245,1,249,"2020"
"56792","230300 CARIDADE",0,1,5,205,1,212,"2020"
"56793","230310 CARIRE",1,0,3,249,1,254,"2020"
"56794","230320 CARIRIACU",1,2,9,383,1,396,"2020"
"56795","230330 CARIUS",0,0,6,162,1,169,"2020"
"56796","230340 CARNAUBAL",0,3,8,214,0,225,"2020"
"56797","230350 CASCAVEL",1,2,14,985,6,1008,"2020"
"56798","230360 CATARINA",0,1,4,130,0,135,"2020"
"56799","230365 CATUNDA",0,2,1,101,0,104,"2020"
"56800","230370 CAUCAIA",14,20,78,4988,24,5124,"2020"
"56801","230380 CEDRO",0,0,10,260,0,270,"2020"
"56802","230390 CHAVAL",0,4,4,158,0,166,"2020"
"56803","230393 CHORO",1,0,1,138,1,141,"2020"
"56804","230395 CHOROZINHO",1,1,4,264,0,270,"2020"
"56805","230400 COREAU",0,1,4,317,3,325,"2020"
"56806","230410 CRATEUS",0,2,10,959,10,981,"2020"
"56807","230420 CRATO",6,12,53,2030,0,2101,"2020"
"56808","230423 CROATA",2,2,4,247,1,256,"2020"
"56809","230425 CRUZ",1,1,7,430,1,440,"2020"
"56810","230426 DEPUTADO IRAPUAN PINHEIRO",1,1,2,73,0,77,"2020"
"56811","230427 ERERE",0,0,1,35,0,36,"2020"
"56812","230428 EUSEBIO",2,1,11,1178,7,1199,"2020"
"56813","230430 FARIAS BRITO",1,1,4,236,0,242,"2020"
"56814","230435 FORQUILHA",1,1,4,324,1,331,"2020"
"56815","230440 FORTALEZA",107,113,450,31547,159,32376,"2020"
"56816","230445 FORTIM",0,4,4,174,1,183,"2020"
"56817","230450 FRECHEIRINHA",1,2,8,263,0,274,"2020"
"56818","230460 GENERAL SAMPAIO",1,2,1,104,0,108,"2020"
"56819","230465 GRACA",0,2,4,174,0,180,"2020"
"56820","230470 GRANJA",5,2,13,762,3,785,"2020"
"56821","230480 GRANJEIRO",0,2,0,71,0,73,"2020"
"56822","230490 GROAIRAS",0,0,1,144,1,146,"2020"
"56823","230495 GUAIUBA",0,2,3,300,4,309,"2020"
"56824","230500 GUARACIABA DO NORTE",4,4,17,629,5,659,"2020"
"56825","230510 GUARAMIRANGA",1,0,0,75,0,76,"2020"
"56826","230520 HIDROLANDIA",0,0,2,238,0,240,"2020"
"56827","230523 HORIZONTE",2,3,19,1104,6,1134,"2020"
"56828","230526 IBARETAMA",0,2,3,176,1,182,"2020"
"56829","230530 IBIAPINA",2,3,5,372,1,383,"2020"
"56830","230533 IBICUITINGA",0,1,2,127,1,131,"2020"
"56831","230535 ICAPUI",0,0,2,262,1,265,"2020"
"56832","230540 ICO",0,2,10,818,2,832,"2020"
"56833","230550 IGUATU",5,13,49,1265,8,1340,"2020"
"56834","230560 INDEPENDENCIA",0,3,6,287,5,301,"2020"
"56835","230565 IPAPORANGA",0,1,1,125,2,129,"2020"
"56836","230570 IPAUMIRIM",0,0,3,113,0,116,"2020"
"56837","230580 IPU",2,4,12,674,0,692,"2020"
"56838","230590 IPUEIRAS",1,4,10,506,2,523,"2020"
"56839","230600 IRACEMA",1,2,2,165,0,170,"2020"
"56840","230610 IRAUCUBA",0,2,9,354,0,365,"2020"
"56841","230620 ITAICABA",0,0,2,89,0,91,"2020"
"56842","230625 ITAITINGA",0,4,6,691,1,702,"2020"
"56843","230630 ITAPAGE",1,4,9,641,4,659,"2020"
"56844","230640 ITAPIPOCA",5,9,29,1803,227,2073,"2020"
"56845","230650 ITAPIUNA",0,0,1,202,0,203,"2020"
"56846","230655 ITAREMA",3,5,11,772,2,793,"2020"
"56847","230660 ITATIRA",2,2,9,302,4,319,"2020"
"56848","230670 JAGUARETAMA",1,0,3,219,2,225,"2020"
"56849","230680 JAGUARIBARA",0,3,5,129,0,137,"2020"
"56850","230690 JAGUARIBE",1,2,4,441,3,451,"2020"
"56851","230700 JAGUARUANA",1,1,4,347,0,353,"2020"
"56852","230710 JARDIM",2,2,17,417,6,444,"2020"
"56853","230720 JATI",0,0,0,118,1,119,"2020"
"56854","230725 JIJOCA DE JERICOACOARA",3,2,3,384,0,392,"2020"
"56855","230730 JUAZEIRO DO NORTE",16,20,66,3868,13,3983,"2020"
"56856","230740 JUCAS",0,4,7,273,0,284,"2020"
"56857","230750 LAVRAS DA MANGABEIRA",2,2,10,318,2,334,"2020"
"56858","230760 LIMOEIRO DO NORTE",4,0,12,714,1,731,"2020"
"56859","230763 MADALENA",0,2,4,168,1,175,"2020"
"56860","230765 MARACANAU",9,13,37,4053,25,4137,"2020"
"56861","230770 MARANGUAPE",5,2,17,1293,8,1325,"2020"
"56862","230780 MARCO",6,4,8,531,0,549,"2020"
"56863","230790 MARTINOPOLE",0,0,6,181,2,189,"2020"
"56864","230800 MASSAPE",3,2,8,576,1,590,"2020"
"56865","230810 MAURITI",4,1,15,606,4,630,"2020"
"56866","230820 MERUOCA",0,1,3,187,1,192,"2020"
"56867","230830 MILAGRES",0,2,4,340,1,347,"2020"
"56868","230835 MILHA",3,0,1,136,0,140,"2020"
"56869","230837 MIRAIMA",0,0,4,162,23,189,"2020"
"56870","230840 MISSAO VELHA",1,3,8,560,7,579,"2020"
"56871","230850 MOMBACA",1,4,19,445,1,470,"2020"
"56872","230860 MONSENHOR TABOSA",1,2,2,196,1,202,"2020"
"56873","230870 MORADA NOVA",3,3,12,669,4,691,"2020"
"56874","230880 MORAUJO",1,0,1,110,0,112,"2020"
"56875","230890 MORRINHOS",1,3,8,321,0,333,"2020"
"56876","230900 MUCAMBO",0,1,3,168,0,172,"2020"
"56877","230910 MULUNGU",0,1,2,137,2,142,"2020"
"56878","230920 NOVA OLINDA",1,3,4,242,0,250,"2020"
"56879","230930 NOVA RUSSAS",2,3,9,355,0,369,"2020"
"56880","230940 NOVO ORIENTE",1,3,7,316,2,329,"2020"
"56881","230945 OCARA",2,0,6,266,0,274,"2020"
"56882","230950 OROS",2,2,4,214,0,222,"2020"
"56883","230960 PACAJUS",1,2,19,893,5,920,"2020"
"56884","230970 PACATUBA",1,4,5,945,11,966,"2020"
"56885","230980 PACOTI",1,1,4,115,0,121,"2020"
"56886","230990 PACUJA",0,0,1,82,0,83,"2020"
"56887","231000 PALHANO",0,1,1,120,1,123,"2020"
"56888","231010 PALMACIA",1,1,2,113,0,117,"2020"
"56889","231020 PARACURU",2,1,11,592,1,607,"2020"
"56890","231025 PARAIPABA",1,2,7,459,3,472,"2020"
"56891","231030 PARAMBU",0,2,8,400,3,413,"2020"
"56892","231040 PARAMOTI",0,0,1,115,0,116,"2020"
"56893","231050 PEDRA BRANCA",1,1,7,465,2,476,"2020"
"56894","231060 PENAFORTE",0,0,2,173,1,176,"2020"
"56895","231070 PENTECOSTE",0,1,3,504,4,512,"2020"
"56896","231080 PEREIRO",0,2,4,186,0,192,"2020"
"56897","231085 PINDORETAMA",1,3,8,298,3,313,"2020"
"56898","231090 PIQUET CARNEIRO",0,2,2,116,0,120,"2020"
"56899","231095 PIRES FERREIRA",0,1,4,89,0,94,"2020"
"56900","231100 PORANGA",0,0,2,159,0,161,"2020"
"56901","231110 PORTEIRAS",0,1,3,234,1,239,"2020"
"56902","231120 POTENGI",0,0,4,110,0,114,"2020"
"56903","231123 POTIRETAMA",0,1,1,66,0,68,"2020"
"56904","231126 QUITERIANOPOLIS",0,0,7,218,3,228,"2020"
"56905","231130 QUIXADA",4,5,20,1230,8,1267,"2020"
"56906","231135 QUIXELO",1,0,7,177,1,186,"2020"
"56907","231140 QUIXERAMOBIM",9,8,43,1059,11,1130,"2020"
"56908","231150 QUIXERE",1,1,0,260,1,263,"2020"
"56909","231160 REDENCAO",1,4,6,428,2,441,"2020"
"56910","231170 RERIUTABA",0,0,6,223,1,230,"2020"
"56911","231180 RUSSAS",1,2,21,904,1,929,"2020"
"56912","231190 SABOEIRO",0,1,3,160,0,164,"2020"
"56913","231195 SALITRE",1,4,5,273,0,283,"2020"
"56914","231200 SANTANA DO ACARAU",3,3,16,416,1,439,"2020"
"56915","231210 SANTANA DO CARIRI",1,1,6,234,2,244,"2020"
"56916","231220 SANTA QUITERIA",1,0,5,513,0,519,"2020"
"56917","231230 SAO BENEDITO",1,6,14,746,0,767,"2020"
"56918","231240 SAO GONCALO DO AMARANTE",3,1,10,807,5,826,"2020"
"56919","231250 SAO JOAO DO JAGUARIBE",0,0,0,59,0,59,"2020"
"56920","231260 SAO LUIS DO CURU",1,0,2,158,0,161,"2020"
"56921","231270 SENADOR POMPEU",0,0,6,252,1,259,"2020"
"56922","231280 SENADOR SA",0,1,5,104,0,110,"2020"
"56923","231290 SOBRAL",6,17,49,3028,7,3107,"2020"
"56924","231300 SOLONOPOLE",0,2,3,150,1,156,"2020"
"56925","231310 TABULEIRO DO NORTE",1,1,5,342,0,349,"2020"
"56926","231320 TAMBORIL",1,0,8,315,1,325,"2020"
"56927","231325 TARRAFAS",1,0,0,101,1,103,"2020"
"56928","231330 TAUA",0,4,14,722,3,743,"2020"
"56929","231335 TEJUCUOCA",1,1,2,231,3,238,"2020"
"56930","231340 TIANGUA",3,5,18,1392,4,1422,"2020"
"56931","231350 TRAIRI",0,4,17,769,65,855,"2020"
"56932","231355 TURURU",0,0,5,214,34,253,"2020"
"56933","231360 UBAJARA",2,5,13,476,0,496,"2020"
"56934","231370 UMARI",0,0,0,79,0,79,"2020"
"56935","231375 UMIRIM",1,2,1,253,20,277,"2020"
"56936","231380 URUBURETAMA",0,2,3,318,30,353,"2020"
"56937","231390 URUOCA",0,0,5,157,0,162,"2020"
"56938","231395 VARJOTA",0,2,3,265,0,270,"2020"
"56939","231400 VARZEA ALEGRE",0,2,7,459,0,468,"2020"
"56940","231410 VICOSA DO CEARA",3,3,13,964,0,983,"2020"
"56941","240010 ACARI",0,0,2,90,0,92,"2020"
"56942","240020 ACU",1,3,8,667,1,680,"2020"
"56943","240030 AFONSO BEZERRA",0,0,0,106,0,106,"2020"
"56944","240040 AGUA NOVA",0,0,0,36,0,36,"2020"
"56945","240050 ALEXANDRIA",0,0,0,161,0,161,"2020"
"56946","240060 ALMINO AFONSO",0,0,0,55,0,55,"2020"
"56947","240070 ALTO DO RODRIGUES",0,0,2,179,0,181,"2020"
"56948","240080 ANGICOS",0,0,1,141,1,143,"2020"
"56949","240090 ANTONIO MARTINS",1,2,1,83,1,88,"2020"
"56950","240100 APODI",2,2,1,436,0,441,"2020"
"56951","240110 AREIA BRANCA",0,1,1,316,1,319,"2020"
"56952","240120 ARES",0,0,4,168,0,172,"2020"
"56953","240130 AUGUSTO SEVERO",1,0,1,80,0,82,"2020"
"56954","240140 BAIA FORMOSA",0,2,1,88,2,93,"2020"
"56955","240145 BARAUNA",2,0,2,337,2,343,"2020"
"56956","240150 BARCELONA",1,0,0,52,0,53,"2020"
"56957","240160 BENTO FERNANDES",0,0,2,65,0,67,"2020"
"56958","240165 BODO",0,0,3,48,0,51,"2020"
"56959","240170 BOM JESUS",0,0,1,119,0,120,"2020"
"56960","240180 BREJINHO",1,1,0,168,2,172,"2020"
"56961","240185 CAICARA DO NORTE",0,2,1,81,1,85,"2020"
"56962","240190 CAICARA DO RIO DO VENTO",0,0,1,51,1,53,"2020"
"56963","240200 CAICO",3,4,16,643,2,668,"2020"
"56964","240210 CAMPO REDONDO",1,1,1,117,1,121,"2020"
"56965","240220 CANGUARETAMA",5,1,8,486,5,505,"2020"
"56966","240230 CARAUBAS",0,1,1,261,3,266,"2020"
"56967","240240 CARNAUBA DOS DANTAS",0,1,2,102,0,105,"2020"
"56968","240250 CARNAUBAIS",0,0,1,89,0,90,"2020"
"56969","240260 CEARA-MIRIM",3,6,21,1084,4,1118,"2020"
"56970","240270 CERRO CORA",0,0,5,116,1,122,"2020"
"56971","240280 CORONEL EZEQUIEL",0,1,2,62,0,65,"2020"
"56972","240290 CORONEL JOAO PESSOA",1,0,0,68,0,69,"2020"
"56973","240300 CRUZETA",0,0,1,90,2,93,"2020"
"56974","240310 CURRAIS NOVOS",1,1,10,451,0,463,"2020"
"56975","240320 DOUTOR SEVERIANO",0,1,0,110,0,111,"2020"
"56976","240325 PARNAMIRIM",3,13,28,3404,14,3462,"2020"
"56977","240330 ENCANTO",0,1,2,82,0,85,"2020"
"56978","240340 EQUADOR",0,2,0,68,0,70,"2020"
"56979","240350 ESPIRITO SANTO",0,0,2,114,1,117,"2020"
"56980","240360 EXTREMOZ",7,2,5,493,5,512,"2020"
"56981","240370 FELIPE GUERRA",0,0,0,53,0,53,"2020"
"56982","240375 FERNANDO PEDROZA",0,0,1,28,0,29,"2020"
"56983","240380 FLORANIA",0,0,3,105,1,109,"2020"
"56984","240390 FRANCISCO DANTAS",0,0,0,34,0,34,"2020"
"56985","240400 FRUTUOSO GOMES",0,1,0,56,0,57,"2020"
"56986","240410 GALINHOS",0,1,0,35,0,36,"2020"
"56987","240420 GOIANINHA",4,2,9,464,3,482,"2020"
"56988","240430 GOVERNADOR DIX-SEPT ROSADO",1,1,0,115,1,118,"2020"
"56989","240440 GROSSOS",0,1,1,103,0,105,"2020"
"56990","240450 GUAMARE",1,0,4,320,2,327,"2020"
"56991","240460 IELMO MARINHO",1,0,4,112,0,117,"2020"
"56992","240470 IPANGUACU",2,1,5,194,0,202,"2020"
"56993","240480 IPUEIRA",0,0,1,18,0,19,"2020"
"56994","240485 ITAJA",1,0,0,88,0,89,"2020"
"56995","240490 ITAU",0,2,1,63,0,66,"2020"
"56996","240500 JACANA",0,0,3,127,0,130,"2020"
"56997","240510 JANDAIRA",1,0,3,89,0,93,"2020"
"56998","240520 JANDUIS",0,0,0,58,1,59,"2020"
"56999","240530 JANUARIO CICCO",0,1,2,150,4,157,"2020"
"57000","240540 JAPI",0,0,4,85,3,92,"2020"
"57001","240550 JARDIM DE ANGICOS",0,0,2,27,0,29,"2020"
"57002","240560 JARDIM DE PIRANHAS",0,3,6,151,1,161,"2020"
"57003","240570 JARDIM DO SERIDO",1,0,1,99,2,103,"2020"
"57004","240580 JOAO CAMARA",4,5,7,484,5,505,"2020"
"57005","240590 JOAO DIAS",0,0,0,21,0,21,"2020"
"57006","240600 JOSE DA PENHA",0,1,0,70,0,71,"2020"
"57007","240610 JUCURUTU",1,0,7,182,2,192,"2020"
"57008","240615 JUNDIA",0,0,2,11,0,13,"2020"
"57009","240620 LAGOA D'ANTA",1,0,1,84,2,88,"2020"
"57010","240630 LAGOA DE PEDRAS",0,1,2,78,0,81,"2020"
"57011","240640 LAGOA DE VELHOS",0,0,2,43,0,45,"2020"
"57012","240650 LAGOA NOVA",0,3,3,192,0,198,"2020"
"57013","240660 LAGOA SALGADA",0,2,2,155,1,160,"2020"
"57014","240670 LAJES",0,3,2,111,1,117,"2020"
"57015","240680 LAJES PINTADAS",0,0,1,64,0,65,"2020"
"57016","240690 LUCRECIA",0,0,0,27,0,27,"2020"
"57017","240700 LUIS GOMES",0,0,2,137,0,139,"2020"
"57018","240710 MACAIBA",3,6,13,940,2,964,"2020"
"57019","240720 MACAU",1,1,4,272,3,281,"2020"
"57020","240725 MAJOR SALES",0,0,1,54,0,55,"2020"
"57021","240730 MARCELINO VIEIRA",0,0,0,98,0,98,"2020"
"57022","240740 MARTINS",0,1,1,86,0,88,"2020"
"57023","240750 MAXARANGUAPE",0,0,3,153,3,159,"2020"
"57024","240760 MESSIAS TARGINO",1,2,0,37,0,40,"2020"
"57025","240770 MONTANHAS",0,1,6,159,2,168,"2020"
"57026","240780 MONTE ALEGRE",0,4,7,284,0,295,"2020"
"57027","240790 MONTE DAS GAMELEIRAS",0,1,0,41,2,44,"2020"
"57028","240800 MOSSORO",14,15,28,3401,11,3469,"2020"
"57029","240810 NATAL",32,56,150,10545,42,10825,"2020"
"57030","240820 NISIA FLORESTA",0,2,6,343,6,357,"2020"
"57031","240830 NOVA CRUZ",1,5,6,465,6,483,"2020"
"57032","240840 OLHO-D'AGUA DO BORGES",0,0,0,29,1,30,"2020"
"57033","240850 OURO BRANCO",0,0,1,43,0,44,"2020"
"57034","240860 PARANA",0,0,0,56,0,56,"2020"
"57035","240870 PARAU",1,0,0,37,0,38,"2020"
"57036","240880 PARAZINHO",0,0,3,87,1,91,"2020"
"57037","240890 PARELHAS",0,1,7,280,0,288,"2020"
"57038","240895 RIO DO FOGO",1,1,2,153,2,159,"2020"
"57039","240910 PASSA E FICA",0,0,6,137,1,144,"2020"
"57040","240920 PASSAGEM",0,0,0,39,2,41,"2020"
"57041","240930 PATU",1,0,0,113,1,115,"2020"
"57042","240933 SANTA MARIA",0,0,1,61,1,63,"2020"
"57043","240940 PAU DOS FERROS",0,3,2,355,0,360,"2020"
"57044","240950 PEDRA GRANDE",0,0,1,64,0,65,"2020"
"57045","240960 PEDRA PRETA",0,0,0,28,0,28,"2020"
"57046","240970 PEDRO AVELINO",1,0,0,78,0,79,"2020"
"57047","240980 PEDRO VELHO",1,2,2,186,1,192,"2020"
"57048","240990 PENDENCIAS",1,0,1,149,3,154,"2020"
"57049","241000 PILOES",0,0,1,36,0,37,"2020"
"57050","241010 POCO BRANCO",0,0,2,151,0,153,"2020"
"57051","241020 PORTALEGRE",0,1,1,76,0,78,"2020"
"57052","241025 PORTO DO MANGUE",0,1,2,78,0,81,"2020"
"57053","241030 SERRA CAIADA",0,1,4,138,1,144,"2020"
"57054","241040 PUREZA",0,0,0,124,0,124,"2020"
"57055","241050 RAFAEL FERNANDES",0,0,0,66,0,66,"2020"
"57056","241060 RAFAEL GODEIRO",0,0,0,43,0,43,"2020"
"57057","241070 RIACHO DA CRUZ",0,0,1,28,1,30,"2020"
"57058","241080 RIACHO DE SANTANA",0,0,0,38,0,38,"2020"
"57059","241090 RIACHUELO",2,1,1,71,0,75,"2020"
"57060","241100 RODOLFO FERNANDES",0,1,2,76,0,79,"2020"
"57061","241105 TIBAU",1,1,0,82,0,84,"2020"
"57062","241110 RUY BARBOSA",1,1,0,51,0,53,"2020"
"57063","241120 SANTA CRUZ",3,9,10,501,3,526,"2020"
"57064","241140 SANTANA DO MATOS",0,2,3,116,0,121,"2020"
"57065","241142 SANTANA DO SERIDO",0,0,0,35,0,35,"2020"
"57066","241150 SANTO ANTONIO",0,1,5,291,0,297,"2020"
"57067","241160 SAO BENTO DO NORTE",0,0,0,41,2,43,"2020"
"57068","241170 SAO BENTO DO TRAIRI",0,0,1,59,0,60,"2020"
"57069","241180 SAO FERNANDO",0,0,3,30,0,33,"2020"
"57070","241190 SAO FRANCISCO DO OESTE",1,0,0,76,0,77,"2020"
"57071","241200 SAO GONCALO DO AMARANTE",6,5,22,1313,4,1350,"2020"
"57072","241210 SAO JOAO DO SABUGI",0,0,2,52,0,54,"2020"
"57073","241220 SAO JOSE DE MIPIBU",2,1,13,675,3,694,"2020"
"57074","241230 SAO JOSE DO CAMPESTRE",1,1,2,121,3,128,"2020"
"57075","241240 SAO JOSE DO SERIDO",0,1,4,53,0,58,"2020"
"57076","241250 SAO MIGUEL",1,1,3,288,0,293,"2020"
"57077","241255 SAO MIGUEL DO GOSTOSO",0,1,4,134,5,144,"2020"
"57078","241260 SAO PAULO DO POTENGI",0,1,9,188,3,201,"2020"
"57079","241270 SAO PEDRO",0,0,0,93,1,94,"2020"
"57080","241280 SAO RAFAEL",0,0,1,74,0,75,"2020"
"57081","241290 SAO TOME",2,1,3,97,3,106,"2020"
"57082","241300 SAO VICENTE",0,1,1,67,0,69,"2020"
"57083","241310 SENADOR ELOI DE SOUZA",0,0,1,76,0,77,"2020"
"57084","241320 SENADOR GEORGINO AVELINO",0,2,1,60,0,63,"2020"
"57085","241330 SERRA DE SAO BENTO",0,0,2,66,0,68,"2020"
"57086","241335 SERRA DO MEL",2,1,1,203,4,211,"2020"
"57087","241340 SERRA NEGRA DO NORTE",0,1,1,77,0,79,"2020"
"57088","241350 SERRINHA",0,0,2,88,1,91,"2020"
"57089","241355 SERRINHA DOS PINTOS",0,0,0,49,0,49,"2020"
"57090","241360 SEVERIANO MELO",0,0,1,76,1,78,"2020"
"57091","241370 SITIO NOVO",0,0,1,56,2,59,"2020"
"57092","241380 TABOLEIRO GRANDE",0,0,0,24,0,24,"2020"
"57093","241390 TAIPU",2,1,1,122,1,127,"2020"
"57094","241400 TANGARA",0,3,5,190,0,198,"2020"
"57095","241410 TENENTE ANANIAS",1,0,4,144,0,149,"2020"
"57096","241415 TENENTE LAURENTINO CRUZ",1,2,4,73,0,80,"2020"
"57097","241420 TIBAU DO SUL",1,3,2,217,4,227,"2020"
"57098","241430 TIMBAUBA DOS BATISTAS",0,0,0,25,0,25,"2020"
"57099","241440 TOUROS",0,1,6,409,2,418,"2020"
"57100","241445 TRIUNFO POTIGUAR",1,0,0,44,1,46,"2020"
"57101","241450 UMARIZAL",0,0,0,90,0,90,"2020"
"57102","241460 UPANEMA",2,0,0,152,0,154,"2020"
"57103","241470 VARZEA",0,0,1,55,1,57,"2020"
"57104","241475 VENHA-VER",0,0,0,52,0,52,"2020"
"57105","241480 VERA CRUZ",0,0,2,193,0,195,"2020"
"57106","241490 VICOSA",0,0,0,20,0,20,"2020"
"57107","241500 VILA FLOR",0,0,0,53,1,54,"2020"
"57108","250010 AGUA BRANCA",0,1,2,125,1,129,"2020"
"57109","250020 AGUIAR",0,0,0,57,0,57,"2020"
"57110","250030 ALAGOA GRANDE",0,0,2,397,11,410,"2020"
"57111","250040 ALAGOA NOVA",0,5,5,316,7,333,"2020"
"57112","250050 ALAGOINHA",0,1,1,191,3,196,"2020"
"57113","250053 ALCANTIL",0,0,1,82,3,86,"2020"
"57114","250057 ALGODAO DE JANDAIRA",0,0,0,34,1,35,"2020"
"57115","250060 ALHANDRA",0,4,4,378,5,391,"2020"
"57116","250070 SAO JOAO DO RIO DO PEIXE",0,1,4,162,13,180,"2020"
"57117","250073 AMPARO",0,0,0,31,0,31,"2020"
"57118","250077 APARECIDA",0,0,2,74,0,76,"2020"
"57119","250080 ARACAGI",0,1,1,203,1,206,"2020"
"57120","250090 ARARA",0,0,1,136,4,141,"2020"
"57121","250100 ARARUNA",1,0,3,206,4,214,"2020"
"57122","250110 AREIA",0,1,8,315,5,329,"2020"
"57123","250115 AREIA DE BARAUNAS",0,0,1,21,1,23,"2020"
"57124","250120 AREIAL",0,1,1,123,3,128,"2020"
"57125","250130 AROEIRAS",0,2,4,257,8,271,"2020"
"57126","250135 ASSUNCAO",1,0,0,66,2,69,"2020"
"57127","250140 BAIA DA TRAICAO",2,0,1,168,1,172,"2020"
"57128","250150 BANANEIRAS",0,2,3,272,1,278,"2020"
"57129","250153 BARAUNA",0,0,1,51,0,52,"2020"
"57130","250157 BARRA DE SANTANA",0,1,1,96,0,98,"2020"
"57131","250160 BARRA DE SANTA ROSA",0,1,2,146,1,150,"2020"
"57132","250170 BARRA DE SAO MIGUEL",1,0,0,94,2,97,"2020"
"57133","250180 BAYEUX",2,3,13,1287,9,1314,"2020"
"57134","250190 BELEM",1,3,3,201,1,209,"2020"
"57135","250200 BELEM DO BREJO DO CRUZ",0,0,1,90,0,91,"2020"
"57136","250205 BERNARDINO BATISTA",0,0,1,37,2,40,"2020"
"57137","250210 BOA VENTURA",0,0,3,85,0,88,"2020"
"57138","250215 BOA VISTA",0,0,0,74,3,77,"2020"
"57139","250220 BOM JESUS",0,0,0,36,1,37,"2020"
"57140","250230 BOM SUCESSO",0,1,0,46,0,47,"2020"
"57141","250240 BONITO DE SANTA FE",0,1,3,139,5,148,"2020"
"57142","250250 BOQUEIRAO",0,1,2,283,1,287,"2020"
"57143","250260 IGARACY",0,1,0,71,2,74,"2020"
"57144","250270 BORBOREMA",0,0,1,71,0,72,"2020"
"57145","250280 BREJO DO CRUZ",0,2,2,176,3,183,"2020"
"57146","250290 BREJO DOS SANTOS",0,0,0,69,0,69,"2020"
"57147","250300 CAAPORA",0,4,8,342,3,357,"2020"
"57148","250310 CABACEIRAS",0,0,1,77,0,78,"2020"
"57149","250320 CABEDELO",5,8,14,968,2,997,"2020"
"57150","250330 CACHOEIRA DOS INDIOS",2,0,1,133,11,147,"2020"
"57151","250340 CACIMBA DE AREIA",0,0,0,52,0,52,"2020"
"57152","250350 CACIMBA DE DENTRO",0,1,2,233,2,238,"2020"
"57153","250355 CACIMBAS",0,1,3,137,6,147,"2020"
"57154","250360 CAICARA",0,0,1,107,0,108,"2020"
"57155","250370 CAJAZEIRAS",5,13,17,818,57,910,"2020"
"57156","250375 CAJAZEIRINHAS",0,0,1,49,0,50,"2020"
"57157","250380 CALDAS BRANDAO",0,0,0,90,0,90,"2020"
"57158","250390 CAMALAU",1,1,1,90,0,93,"2020"
"57159","250400 CAMPINA GRANDE",7,18,78,5859,73,6035,"2020"
"57160","250403 CAPIM",0,1,3,102,0,106,"2020"
"57161","250407 CARAUBAS",0,0,0,47,1,48,"2020"
"57162","250410 CARRAPATEIRA",0,2,0,29,1,32,"2020"
"57163","250415 CASSERENGUE",0,0,0,74,1,75,"2020"
"57164","250420 CATINGUEIRA",0,0,4,54,3,61,"2020"
"57165","250430 CATOLE DO ROCHA",1,0,3,383,3,390,"2020"
"57166","250435 CATURITE",0,1,1,90,1,93,"2020"
"57167","250440 CONCEICAO",2,2,4,250,3,261,"2020"
"57168","250450 CONDADO",0,0,1,69,1,71,"2020"
"57169","250460 CONDE",1,1,9,484,8,503,"2020"
"57170","250470 CONGO",0,0,2,100,0,102,"2020"
"57171","250480 COREMAS",0,1,4,163,2,170,"2020"
"57172","250485 COXIXOLA",0,0,0,19,1,20,"2020"
"57173","250490 CRUZ DO ESPIRITO SANTO",0,1,9,300,0,310,"2020"
"57174","250500 CUBATI",1,0,0,109,0,110,"2020"
"57175","250510 CUITE",2,1,2,245,0,250,"2020"
"57176","250520 CUITEGI",0,0,0,109,1,110,"2020"
"57177","250523 CUITE DE MAMANGUAPE",1,1,0,97,0,99,"2020"
"57178","250527 CURRAL DE CIMA",0,2,1,82,0,85,"2020"
"57179","250530 CURRAL VELHO",0,0,1,24,0,25,"2020"
"57180","250535 DAMIAO",0,0,0,70,1,71,"2020"
"57181","250540 DESTERRO",0,1,4,119,2,126,"2020"
"57182","250550 VISTA SERRANA",0,0,0,39,0,39,"2020"
"57183","250560 DIAMANTE",0,0,4,85,0,89,"2020"
"57184","250570 DONA INES",0,1,1,134,2,138,"2020"
"57185","250580 DUAS ESTRADAS",0,0,0,48,2,50,"2020"
"57186","250590 EMAS",0,0,0,33,1,34,"2020"
"57187","250600 ESPERANCA",0,0,8,469,6,483,"2020"
"57188","250610 FAGUNDES",0,1,3,165,4,173,"2020"
"57189","250620 FREI MARTINHO",0,0,0,25,0,25,"2020"
"57190","250625 GADO BRAVO",1,0,2,130,2,135,"2020"
"57191","250630 GUARABIRA",1,1,5,807,6,820,"2020"
"57192","250640 GURINHEM",0,2,5,188,0,195,"2020"
"57193","250650 GURJAO",0,0,0,38,2,40,"2020"
"57194","250660 IBIARA",1,0,0,77,1,79,"2020"
"57195","250670 IMACULADA",0,0,2,150,3,155,"2020"
"57196","250680 INGA",0,0,5,221,8,234,"2020"
"57197","250690 ITABAIANA",1,1,2,384,0,388,"2020"
"57198","250700 ITAPORANGA",0,1,7,305,0,313,"2020"
"57199","250710 ITAPOROROCA",1,1,5,274,0,281,"2020"
"57200","250720 ITATUBA",0,3,4,144,7,158,"2020"
"57201","250730 JACARAU",0,0,4,219,1,224,"2020"
"57202","250740 JERICO",1,0,0,98,0,99,"2020"
"57203","250750 JOAO PESSOA",20,33,147,11165,44,11409,"2020"
"57204","250760 JUAREZ TAVORA",1,0,0,109,2,112,"2020"
"57205","250770 JUAZEIRINHO",0,2,3,271,4,280,"2020"
"57206","250780 JUNCO DO SERIDO",0,0,1,94,0,95,"2020"
"57207","250790 JURIPIRANGA",0,4,3,202,0,209,"2020"
"57208","250800 JURU",0,1,1,83,1,86,"2020"
"57209","250810 LAGOA",0,0,0,55,0,55,"2020"
"57210","250820 LAGOA DE DENTRO",0,3,1,106,3,113,"2020"
"57211","250830 LAGOA SECA",0,2,4,379,1,386,"2020"
"57212","250840 LASTRO",0,1,1,54,0,56,"2020"
"57213","250850 LIVRAMENTO",0,1,1,87,3,92,"2020"
"57214","250855 LOGRADOURO",0,0,1,52,1,54,"2020"
"57215","250860 LUCENA",0,3,2,205,1,211,"2020"
"57216","250870 MAE D'AGUA",0,1,0,52,0,53,"2020"
"57217","250880 MALTA",0,1,2,80,2,85,"2020"
"57218","250890 MAMANGUAPE",2,6,20,717,1,746,"2020"
"57219","250900 MANAIRA",0,0,1,150,0,151,"2020"
"57220","250905 MARCACAO",2,1,3,161,0,167,"2020"
"57221","250910 MARI",1,2,1,269,0,273,"2020"
"57222","250915 MARIZOPOLIS",0,0,0,76,0,76,"2020"
"57223","250920 MASSARANDUBA",0,0,2,175,1,178,"2020"
"57224","250930 MATARACA",2,3,3,177,0,185,"2020"
"57225","250933 MATINHAS",0,0,1,68,2,71,"2020"
"57226","250937 MATO GROSSO",0,0,0,40,0,40,"2020"
"57227","250939 MATUREIA",0,0,1,113,4,118,"2020"
"57228","250940 MOGEIRO",2,1,1,206,0,210,"2020"
"57229","250950 MONTADAS",4,0,3,91,0,98,"2020"
"57230","250960 MONTE HOREBE",0,0,0,71,5,76,"2020"
"57231","250970 MONTEIRO",3,1,5,494,3,506,"2020"
"57232","250980 MULUNGU",0,0,1,138,2,141,"2020"
"57233","250990 NATUBA",0,0,2,81,1,84,"2020"
"57234","251000 NAZAREZINHO",0,0,0,89,0,89,"2020"
"57235","251010 NOVA FLORESTA",0,1,2,128,1,132,"2020"
"57236","251020 NOVA OLINDA",0,0,2,66,2,70,"2020"
"57237","251030 NOVA PALMEIRA",0,0,1,45,0,46,"2020"
"57238","251040 OLHO D'AGUA",0,0,0,83,0,83,"2020"
"57239","251050 OLIVEDOS",0,0,0,38,0,38,"2020"
"57240","251060 OURO VELHO",0,0,0,42,0,42,"2020"
"57241","251065 PARARI",0,0,1,20,0,21,"2020"
"57242","251070 PASSAGEM",0,0,1,29,1,31,"2020"
"57243","251080 PATOS",1,5,48,1334,34,1422,"2020"
"57244","251090 PAULISTA",0,0,2,137,1,140,"2020"
"57245","251100 PEDRA BRANCA",0,0,1,55,1,57,"2020"
"57246","251110 PEDRA LAVRADA",0,1,1,72,0,74,"2020"
"57247","251120 PEDRAS DE FOGO",0,5,3,453,0,461,"2020"
"57248","251130 PIANCO",0,1,7,164,4,176,"2020"
"57249","251140 PICUI",1,1,3,252,0,257,"2020"
"57250","251150 PILAR",0,0,2,195,0,197,"2020"
"57251","251160 PILOES",0,0,1,145,4,150,"2020"
"57252","251170 PILOEZINHOS",0,0,0,73,1,74,"2020"
"57253","251180 PIRPIRITUBA",1,1,2,136,3,143,"2020"
"57254","251190 PITIMBU",2,2,3,281,3,291,"2020"
"57255","251200 POCINHOS",0,2,4,272,3,281,"2020"
"57256","251203 POCO DANTAS",0,0,2,43,0,45,"2020"
"57257","251207 POCO DE JOSE DE MOURA",0,0,0,47,4,51,"2020"
"57258","251210 POMBAL",1,1,8,401,0,411,"2020"
"57259","251220 PRATA",0,1,2,52,0,55,"2020"
"57260","251230 PRINCESA ISABEL",0,1,6,275,4,286,"2020"
"57261","251240 PUXINANA",1,1,2,223,1,228,"2020"
"57262","251250 QUEIMADAS",2,4,11,620,12,649,"2020"
"57263","251260 QUIXABA",0,0,0,28,1,29,"2020"
"57264","251270 REMIGIO",0,0,1,261,7,269,"2020"
"57265","251272 PEDRO REGIS",1,0,1,53,1,56,"2020"
"57266","251274 RIACHAO",0,0,1,46,0,47,"2020"
"57267","251275 RIACHAO DO BACAMARTE",0,0,0,57,0,57,"2020"
"57268","251276 RIACHAO DO POCO",0,1,2,69,0,72,"2020"
"57269","251278 RIACHO DE SANTO ANTONIO",0,0,0,35,1,36,"2020"
"57270","251280 RIACHO DOS CAVALOS",1,0,3,117,2,123,"2020"
"57271","251290 RIO TINTO",0,3,6,316,0,325,"2020"
"57272","251300 SALGADINHO",0,0,1,35,1,37,"2020"
"57273","251310 SALGADO DE SAO FELIX",0,1,2,141,0,144,"2020"
"57274","251315 SANTA CECILIA",0,0,1,114,2,117,"2020"
"57275","251320 SANTA CRUZ",1,0,1,73,0,75,"2020"
"57276","251330 SANTA HELENA",0,0,0,42,2,44,"2020"
"57277","251335 SANTA INES",0,1,0,39,1,41,"2020"
"57278","251340 SANTA LUZIA",1,0,8,178,3,190,"2020"
"57279","251350 SANTANA DE MANGUEIRA",0,0,2,60,0,62,"2020"
"57280","251360 SANTANA DOS GARROTES",0,1,3,80,1,85,"2020"
"57281","251365 JOCA CLAUDINO",0,0,0,13,1,14,"2020"
"57282","251370 SANTA RITA",3,11,30,2251,2,2297,"2020"
"57283","251380 SANTA TERESINHA",0,1,2,55,1,59,"2020"
"57284","251385 SANTO ANDRE",0,0,2,21,0,23,"2020"
"57285","251390 SAO BENTO",0,2,6,477,1,486,"2020"
"57286","251392 SAO BENTINHO",1,0,2,40,0,43,"2020"
"57287","251394 SAO DOMINGOS DO CARIRI",0,0,1,29,0,30,"2020"
"57288","251396 SAO DOMINGOS",0,0,0,32,1,33,"2020"
"57289","251398 SAO FRANCISCO",0,0,0,45,0,45,"2020"
"57290","251400 SAO JOAO DO CARIRI",0,0,0,52,0,52,"2020"
"57291","251410 SAO JOAO DO TIGRE",0,0,4,53,1,58,"2020"
"57292","251420 SAO JOSE DA LAGOA TAPADA",1,0,2,82,0,85,"2020"
"57293","251430 SAO JOSE DE CAIANA",0,0,2,70,0,72,"2020"
"57294","251440 SAO JOSE DE ESPINHARAS",1,0,1,41,0,43,"2020"
"57295","251445 SAO JOSE DOS RAMOS",0,2,1,95,1,99,"2020"
"57296","251450 SAO JOSE DE PIRANHAS",0,2,3,241,7,253,"2020"
"57297","251455 SAO JOSE DE PRINCESA",0,0,0,43,0,43,"2020"
"57298","251460 SAO JOSE DO BONFIM",0,1,1,66,5,73,"2020"
"57299","251465 SAO JOSE DO BREJO DO CRUZ",0,0,0,25,0,25,"2020"
"57300","251470 SAO JOSE DO SABUGI",0,1,1,41,0,43,"2020"
"57301","251480 SAO JOSE DOS CORDEIROS",0,0,0,38,1,39,"2020"
"57302","251490 SAO MAMEDE",0,1,2,98,3,104,"2020"
"57303","251500 SAO MIGUEL DE TAIPU",0,0,1,116,0,117,"2020"
"57304","251510 SAO SEBASTIAO DE LAGOA DE ROCA",0,0,1,124,1,126,"2020"
"57305","251520 SAO SEBASTIAO DO UMBUZEIRO",1,0,0,42,0,43,"2020"
"57306","251530 SAPE",1,2,8,560,4,575,"2020"
"57307","251540 SAO VICENTE DO SERIDO",1,0,3,170,2,176,"2020"
"57308","251550 SERRA BRANCA",2,0,3,121,0,126,"2020"
"57309","251560 SERRA DA RAIZ",1,0,0,49,3,53,"2020"
"57310","251570 SERRA GRANDE",0,1,1,49,0,51,"2020"
"57311","251580 SERRA REDONDA",0,0,3,77,1,81,"2020"
"57312","251590 SERRARIA",1,0,3,52,0,56,"2020"
"57313","251593 SERTAOZINHO",0,0,1,59,1,61,"2020"
"57314","251597 SOBRADO",0,0,4,121,1,126,"2020"
"57315","251600 SOLANEA",1,3,7,376,4,391,"2020"
"57316","251610 SOLEDADE",0,1,3,199,2,205,"2020"
"57317","251615 SOSSEGO",0,0,0,58,1,59,"2020"
"57318","251620 SOUSA",0,3,8,932,3,946,"2020"
"57319","251630 SUME",0,2,1,200,1,204,"2020"
"57320","251640 TACIMA",0,0,2,100,1,103,"2020"
"57321","251650 TAPEROA",1,1,5,200,5,212,"2020"
"57322","251660 TAVARES",0,0,2,161,1,164,"2020"
"57323","251670 TEIXEIRA",0,2,5,200,13,220,"2020"
"57324","251675 TENORIO",0,0,0,41,0,41,"2020"
"57325","251680 TRIUNFO",0,0,1,82,11,94,"2020"
"57326","251690 UIRAUNA",0,1,1,172,14,188,"2020"
"57327","251700 UMBUZEIRO",2,0,4,125,5,136,"2020"
"57328","251710 VARZEA",0,0,1,25,1,27,"2020"
"57329","251720 VIEIROPOLIS",0,0,0,60,0,60,"2020"
"57330","251740 ZABELE",0,0,1,33,0,34,"2020"
"57331","MUNICIPIO IGNORADO - PE",0,0,0,11,0,11,"2020"
"57332","260005 ABREU E LIMA",6,7,22,1250,6,1291,"2020"
"57333","260010 AFOGADOS DA INGAZEIRA",2,4,5,598,0,609,"2020"
"57334","260020 AFRANIO",3,1,3,226,20,253,"2020"
"57335","260030 AGRESTINA",1,1,3,341,0,346,"2020"
"57336","260040 AGUA PRETA",0,1,4,384,6,395,"2020"
"57337","260050 AGUAS BELAS",1,3,5,668,2,679,"2020"
"57338","260060 ALAGOINHA",2,1,0,224,0,227,"2020"
"57339","260070 ALIANCA",3,4,9,481,1,498,"2020"
"57340","260080 ALTINHO",0,2,1,260,1,264,"2020"
"57341","260090 AMARAJI",5,1,7,258,1,272,"2020"
"57342","260100 ANGELIM",1,1,0,135,0,137,"2020"
"57343","260105 ARACOIABA",0,8,2,276,2,288,"2020"
"57344","260110 ARARIPINA",4,12,28,1513,1,1558,"2020"
"57345","260120 ARCOVERDE",8,3,6,1152,17,1186,"2020"
"57346","260130 BARRA DE GUABIRABA",0,0,1,159,1,161,"2020"
"57347","260140 BARREIROS",2,0,14,609,10,635,"2020"
"57348","260150 BELEM DE MARIA",1,4,1,144,0,150,"2020"
"57349","260160 BELEM DE SAO FRANCISCO",1,0,2,292,2,297,"2020"
"57350","260170 BELO JARDIM",3,2,11,1122,4,1142,"2020"
"57351","260180 BETANIA",1,0,5,167,5,178,"2020"
"57352","260190 BEZERROS",0,5,11,780,5,801,"2020"
"57353","260200 BODOCO",5,2,14,511,0,532,"2020"
"57354","260210 BOM CONSELHO",1,3,7,415,3,429,"2020"
"57355","260220 BOM JARDIM",2,2,3,468,2,477,"2020"
"57356","260230 BONITO",3,2,9,582,3,599,"2020"
"57357","260240 BREJAO",0,1,2,169,2,174,"2020"
"57358","260250 BREJINHO",0,0,2,100,0,102,"2020"
"57359","260260 BREJO DA MADRE DE DEUS",1,4,7,716,7,735,"2020"
"57360","260270 BUENOS AIRES",0,0,2,176,0,178,"2020"
"57361","260280 BUIQUE",5,4,6,804,2,821,"2020"
"57362","260290 CABO DE SANTO AGOSTINHO",10,6,31,2686,151,2884,"2020"
"57363","260300 CABROBO",1,1,17,443,0,462,"2020"
"57364","260310 CACHOEIRINHA",0,0,4,266,3,273,"2020"
"57365","260320 CAETES",0,1,6,368,3,378,"2020"
"57366","260330 CALCADO",0,0,2,119,1,122,"2020"
"57367","260340 CALUMBI",1,1,3,52,12,69,"2020"
"57368","260345 CAMARAGIBE",10,10,44,2136,5,2205,"2020"
"57369","260350 CAMOCIM DE SAO FELIX",0,1,2,219,1,223,"2020"
"57370","260360 CAMUTANGA",0,0,0,92,1,93,"2020"
"57371","260370 CANHOTINHO",1,0,6,330,3,340,"2020"
"57372","260380 CAPOEIRAS",3,1,2,284,3,293,"2020"
"57373","260390 CARNAIBA",1,4,6,267,0,278,"2020"
"57374","260392 CARNAUBEIRA DA PENHA",0,1,5,243,3,252,"2020"
"57375","260400 CARPINA",3,5,14,980,3,1005,"2020"
"57376","260410 CARUARU",14,14,66,5708,48,5850,"2020"
"57377","260415 CASINHAS",0,1,2,180,4,187,"2020"
"57378","260420 CATENDE",1,0,9,448,8,466,"2020"
"57379","260430 CEDRO",0,0,1,138,0,139,"2020"
"57380","260440 CHA DE ALEGRIA",1,2,3,194,1,201,"2020"
"57381","260450 CHA GRANDE",0,2,5,288,0,295,"2020"
"57382","260460 CONDADO",0,3,2,335,2,342,"2020"
"57383","260470 CORRENTES",1,1,1,196,6,205,"2020"
"57384","260480 CORTES",4,0,1,142,0,147,"2020"
"57385","260490 CUMARU",1,0,0,154,0,155,"2020"
"57386","260500 CUPIRA",1,0,4,357,1,363,"2020"
"57387","260510 CUSTODIA",1,0,4,517,1,523,"2020"
"57388","260515 DORMENTES",2,0,5,244,9,260,"2020"
"57389","260520 ESCADA",18,2,5,772,12,809,"2020"
"57390","260530 EXU",0,0,6,429,4,439,"2020"
"57391","260540 FEIRA NOVA",1,1,3,315,1,321,"2020"
"57392","260545 FERNANDO DE NORONHA",0,0,0,33,0,33,"2020"
"57393","260550 FERREIROS",0,0,3,119,1,123,"2020"
"57394","260560 FLORES",3,0,3,253,6,265,"2020"
"57395","260570 FLORESTA",3,1,5,480,3,492,"2020"
"57396","260580 FREI MIGUELINHO",2,1,3,103,2,111,"2020"
"57397","260590 GAMELEIRA",3,1,4,274,3,285,"2020"
"57398","260600 GARANHUNS",2,3,19,2156,13,2193,"2020"
"57399","260610 GLORIA DO GOITA",3,0,4,373,2,382,"2020"
"57400","260620 GOIANA",6,3,12,1104,18,1143,"2020"
"57401","260630 GRANITO",0,0,3,105,0,108,"2020"
"57402","260640 GRAVATA",2,0,6,960,6,974,"2020"
"57403","260650 IATI",0,1,3,325,1,330,"2020"
"57404","260660 IBIMIRIM",1,1,1,432,2,437,"2020"
"57405","260670 IBIRAJUBA",0,0,2,94,0,96,"2020"
"57406","260680 IGARASSU",5,3,14,1505,8,1535,"2020"
"57407","260690 IGUARACY",0,0,0,137,0,137,"2020"
"57408","260700 INAJA",0,0,7,331,23,361,"2020"
"57409","260710 INGAZEIRA",0,0,0,54,0,54,"2020"
"57410","260720 IPOJUCA",3,6,27,1718,5,1759,"2020"
"57411","260730 IPUBI",2,2,8,559,3,574,"2020"
"57412","260740 ITACURUBA",0,1,2,85,0,88,"2020"
"57413","260750 ITAIBA",2,0,6,318,4,330,"2020"
"57414","260760 ILHA DE ITAMARACA",1,1,8,278,2,290,"2020"
"57415","260765 ITAMBE",5,4,7,375,3,394,"2020"
"57416","260770 ITAPETIM",0,0,2,178,0,180,"2020"
"57417","260775 ITAPISSUMA",1,2,4,349,2,358,"2020"
"57418","260780 ITAQUITINGA",0,2,4,193,2,201,"2020"
"57419","260790 JABOATAO DOS GUARARAPES",33,37,82,8468,77,8697,"2020"
"57420","260795 JAQUEIRA",0,0,5,164,3,172,"2020"
"57421","260800 JATAUBA",0,1,3,223,0,227,"2020"
"57422","260805 JATOBA",0,1,6,193,1,201,"2020"
"57423","260810 JOAO ALFREDO",0,0,2,314,1,317,"2020"
"57424","260820 JOAQUIM NABUCO",2,0,0,209,4,215,"2020"
"57425","260825 JUCATI",0,0,1,171,0,172,"2020"
"57426","260830 JUPI",0,1,3,271,1,276,"2020"
"57427","260840 JUREMA",0,1,3,193,1,198,"2020"
"57428","260845 LAGOA DO CARRO",0,3,3,221,5,232,"2020"
"57429","260850 LAGOA DE ITAENGA",1,0,4,317,2,324,"2020"
"57430","260860 LAGOA DO OURO",1,0,2,157,1,161,"2020"
"57431","260870 LAGOA DOS GATOS",1,0,0,207,0,208,"2020"
"57432","260875 LAGOA GRANDE",1,4,4,363,0,372,"2020"
"57433","260880 LAJEDO",0,4,10,636,4,654,"2020"
"57434","260890 LIMOEIRO",3,1,3,692,2,701,"2020"
"57435","260900 MACAPARANA",0,1,4,340,2,347,"2020"
"57436","260910 MACHADOS",1,1,2,177,1,182,"2020"
"57437","260915 MANARI",0,2,2,278,5,287,"2020"
"57438","260920 MARAIAL",0,1,1,160,3,165,"2020"
"57439","260930 MIRANDIBA",0,0,5,234,1,240,"2020"
"57440","260940 MORENO",3,3,5,703,2,716,"2020"
"57441","260950 NAZARE DA MATA",2,2,6,404,3,417,"2020"
"57442","260960 OLINDA",12,19,53,4743,22,4849,"2020"
"57443","260970 OROBO",0,0,3,254,2,259,"2020"
"57444","260980 OROCO",0,2,4,268,5,279,"2020"
"57445","260990 OURICURI",1,3,9,1041,4,1058,"2020"
"57446","261000 PALMARES",4,0,14,826,7,851,"2020"
"57447","261010 PALMEIRINA",0,0,0,93,5,98,"2020"
"57448","261020 PANELAS",1,1,3,304,3,312,"2020"
"57449","261030 PARANATAMA",2,0,0,192,0,194,"2020"
"57450","261040 PARNAMIRIM",0,1,11,285,0,297,"2020"
"57451","261050 PASSIRA",0,0,2,391,3,396,"2020"
"57452","261060 PAUDALHO",2,2,9,847,5,865,"2020"
"57453","261070 PAULISTA",10,12,44,3806,26,3898,"2020"
"57454","261080 PEDRA",4,2,4,318,4,332,"2020"
"57455","261090 PESQUEIRA",2,3,8,911,3,927,"2020"
"57456","261100 PETROLANDIA",0,2,4,651,4,661,"2020"
"57457","261110 PETROLINA",27,44,99,5978,57,6205,"2020"
"57458","261120 POCAO",2,0,2,158,2,164,"2020"
"57459","261130 POMBOS",2,1,4,365,5,377,"2020"
"57460","261140 PRIMAVERA",1,1,2,164,2,170,"2020"
"57461","261150 QUIPAPA",3,0,2,233,1,239,"2020"
"57462","261153 QUIXABA",0,1,2,108,0,111,"2020"
"57463","261160 RECIFE",48,70,236,19066,127,19547,"2020"
"57464","261170 RIACHO DAS ALMAS",2,2,3,339,2,348,"2020"
"57465","261180 RIBEIRAO",13,1,3,437,3,457,"2020"
"57466","261190 RIO FORMOSO",2,1,3,318,2,326,"2020"
"57467","261200 SAIRE",0,0,1,131,0,132,"2020"
"57468","261210 SALGADINHO",1,0,0,71,2,74,"2020"
"57469","261220 SALGUEIRO",2,8,15,1000,3,1028,"2020"
"57470","261230 SALOA",0,1,2,182,1,186,"2020"
"57471","261240 SANHARO",1,2,4,281,7,295,"2020"
"57472","261245 SANTA CRUZ",1,0,2,209,1,213,"2020"
"57473","261247 SANTA CRUZ DA BAIXA VERDE",0,1,2,146,6,155,"2020"
"57474","261250 SANTA CRUZ DO CAPIBARIBE",3,2,17,1339,5,1366,"2020"
"57475","261255 SANTA FILOMENA",0,0,3,165,1,169,"2020"
"57476","261260 SANTA MARIA DA BOA VISTA",0,6,14,683,6,709,"2020"
"57477","261270 SANTA MARIA DO CAMBUCA",0,0,3,196,0,199,"2020"
"57478","261280 SANTA TEREZINHA",1,1,0,101,0,103,"2020"
"57479","261290 SAO BENEDITO DO SUL",1,0,2,145,8,156,"2020"
"57480","261300 SAO BENTO DO UNA",2,6,7,772,8,795,"2020"
"57481","261310 SAO CAITANO",4,2,8,497,2,513,"2020"
"57482","261320 SAO JOAO",0,2,1,314,2,319,"2020"
"57483","261330 SAO JOAQUIM DO MONTE",4,3,3,293,3,306,"2020"
"57484","261340 SAO JOSE DA COROA GRANDE",2,2,1,263,3,271,"2020"
"57485","261350 SAO JOSE DO BELMONTE",1,2,7,507,10,527,"2020"
"57486","261360 SAO JOSE DO EGITO",1,1,2,396,0,400,"2020"
"57487","261370 SAO LOURENCO DA MATA",9,4,25,1478,4,1520,"2020"
"57488","261380 SAO VICENTE FERRER",0,1,6,244,0,251,"2020"
"57489","261390 SERRA TALHADA",4,6,18,1317,179,1524,"2020"
"57490","261400 SERRITA",0,1,9,256,3,269,"2020"
"57491","261410 SERTANIA",1,3,5,439,2,450,"2020"
"57492","261420 SIRINHAEM",2,2,8,542,2,556,"2020"
"57493","261430 MOREILANDIA",0,0,2,117,0,119,"2020"
"57494","261440 SOLIDAO",1,0,0,96,0,97,"2020"
"57495","261450 SURUBIM",1,4,13,838,5,861,"2020"
"57496","261460 TABIRA",3,1,7,414,1,426,"2020"
"57497","261470 TACAIMBO",0,0,3,188,0,191,"2020"
"57498","261480 TACARATU",1,1,7,290,3,302,"2020"
"57499","261485 TAMANDARE",2,0,3,406,5,416,"2020"
"57500","261500 TAQUARITINGA DO NORTE",1,1,3,340,3,348,"2020"
"57501","261510 TEREZINHA",0,3,2,82,0,87,"2020"
"57502","261520 TERRA NOVA",0,0,3,109,0,112,"2020"
"57503","261530 TIMBAUBA",2,1,7,620,4,634,"2020"
"57504","261540 TORITAMA",6,2,7,692,3,710,"2020"
"57505","261550 TRACUNHAEM",0,2,4,197,0,203,"2020"
"57506","261560 TRINDADE",3,3,5,581,2,594,"2020"
"57507","261570 TRIUNFO",0,0,5,163,7,175,"2020"
"57508","261580 TUPANATINGA",5,2,4,283,2,296,"2020"
"57509","261590 TUPARETAMA",0,1,2,131,0,134,"2020"
"57510","261600 VENTUROSA",1,2,2,257,0,262,"2020"
"57511","261610 VERDEJANTE",0,3,2,137,3,145,"2020"
"57512","261618 VERTENTE DO LERIO",1,0,0,113,0,114,"2020"
"57513","261620 VERTENTES",0,1,0,298,1,300,"2020"
"57514","261630 VICENCIA",0,1,3,382,3,389,"2020"
"57515","261640 VITORIA DE SANTO ANTAO",3,7,17,1892,10,1929,"2020"
"57516","261650 XEXEU",0,1,3,206,3,213,"2020"
"57517","270010 AGUA BRANCA",2,2,4,260,4,272,"2020"
"57518","270020 ANADIA",1,0,1,198,4,204,"2020"
"57519","270030 ARAPIRACA",8,12,34,3898,12,3964,"2020"
"57520","270040 ATALAIA",1,2,8,542,9,562,"2020"
"57521","270050 BARRA DE SANTO ANTONIO",1,0,3,278,8,290,"2020"
"57522","270060 BARRA DE SAO MIGUEL",1,0,0,136,2,139,"2020"
"57523","270070 BATALHA",0,0,3,248,0,251,"2020"
"57524","270080 BELEM",0,0,4,86,0,90,"2020"
"57525","270090 BELO MONTE",1,0,3,87,0,91,"2020"
"57526","270100 BOCA DA MATA",0,3,1,282,2,288,"2020"
"57527","270110 BRANQUINHA",1,3,1,167,1,173,"2020"
"57528","270120 CACIMBINHAS",0,1,2,158,0,161,"2020"
"57529","270130 CAJUEIRO",0,2,2,294,7,305,"2020"
"57530","270135 CAMPESTRE",1,0,0,101,0,102,"2020"
"57531","270140 CAMPO ALEGRE",0,1,5,515,1,522,"2020"
"57532","270150 CAMPO GRANDE",1,1,2,121,0,125,"2020"
"57533","270160 CANAPI",0,1,1,246,11,259,"2020"
"57534","270170 CAPELA",0,1,7,207,6,221,"2020"
"57535","270180 CARNEIROS",0,0,1,153,1,155,"2020"
"57536","270190 CHA PRETA",0,0,0,85,4,89,"2020"
"57537","270200 COITE DO NOIA",0,0,1,149,0,150,"2020"
"57538","270210 COLONIA LEOPOLDINA",1,0,9,273,2,285,"2020"
"57539","270220 COQUEIRO SECO",0,0,5,69,2,76,"2020"
"57540","270230 CORURIPE",6,1,6,803,5,821,"2020"
"57541","270235 CRAIBAS",0,1,2,412,5,420,"2020"
"57542","270240 DELMIRO GOUVEIA",1,2,5,769,1,778,"2020"
"57543","270250 DOIS RIACHOS",0,1,2,144,0,147,"2020"
"57544","270255 ESTRELA DE ALAGOAS",0,0,4,198,0,202,"2020"
"57545","270260 FEIRA GRANDE",1,1,2,317,2,323,"2020"
"57546","270270 FELIZ DESERTO",0,0,0,76,4,80,"2020"
"57547","270280 FLEXEIRAS",1,1,1,170,3,176,"2020"
"57548","270290 GIRAU DO PONCIANO",1,2,7,561,4,575,"2020"
"57549","270300 IBATEGUARA",1,0,2,267,2,272,"2020"
"57550","270310 IGACI",0,2,4,308,0,314,"2020"
"57551","270320 IGREJA NOVA",1,0,6,290,1,298,"2020"
"57552","270330 INHAPI",0,1,3,239,32,275,"2020"
"57553","270340 JACARE DOS HOMENS",0,0,0,81,0,81,"2020"
"57554","270350 JACUIPE",0,1,4,64,0,69,"2020"
"57555","270360 JAPARATINGA",0,0,3,126,1,130,"2020"
"57556","270370 JARAMATAIA",0,1,1,87,0,89,"2020"
"57557","270375 JEQUIA DA PRAIA",0,0,2,132,0,134,"2020"
"57558","270380 JOAQUIM GOMES",0,0,3,295,2,300,"2020"
"57559","270390 JUNDIA",0,0,0,58,1,59,"2020"
"57560","270400 JUNQUEIRO",2,1,4,341,0,348,"2020"
"57561","270410 LAGOA DA CANOA",1,1,2,314,0,318,"2020"
"57562","270420 LIMOEIRO DE ANADIA",0,1,1,341,1,344,"2020"
"57563","270430 MACEIO",39,56,190,13259,166,13710,"2020"
"57564","270440 MAJOR ISIDORO",1,0,2,258,2,263,"2020"
"57565","270450 MARAGOGI",2,3,7,574,5,591,"2020"
"57566","270460 MARAVILHA",1,0,0,145,1,147,"2020"
"57567","270470 MARECHAL DEODORO",2,2,16,884,8,912,"2020"
"57568","270480 MARIBONDO",0,1,3,161,0,165,"2020"
"57569","270490 MAR VERMELHO",0,0,1,40,1,42,"2020"
"57570","270500 MATA GRANDE",0,4,5,288,24,321,"2020"
"57571","270510 MATRIZ DE CAMARAGIBE",1,2,5,364,1,373,"2020"
"57572","270520 MESSIAS",2,0,4,287,4,297,"2020"
"57573","270530 MINADOR DO NEGRAO",0,1,1,58,0,60,"2020"
"57574","270540 MONTEIROPOLIS",1,0,0,103,0,104,"2020"
"57575","270550 MURICI",2,3,1,418,6,430,"2020"
"57576","270560 NOVO LINO",0,1,1,131,2,135,"2020"
"57577","270570 OLHO D'AGUA DAS FLORES",1,2,2,352,0,357,"2020"
"57578","270580 OLHO D'AGUA DO CASADO",0,0,3,144,0,147,"2020"
"57579","270590 OLHO D'AGUA GRANDE",0,0,0,67,0,67,"2020"
"57580","270600 OLIVENCA",0,2,2,178,0,182,"2020"
"57581","270610 OURO BRANCO",0,0,1,180,0,181,"2020"
"57582","270620 PALESTINA",0,0,1,77,0,78,"2020"
"57583","270630 PALMEIRA DOS INDIOS",2,5,16,1248,0,1271,"2020"
"57584","270640 PAO DE ACUCAR",0,1,7,345,0,353,"2020"
"57585","270642 PARICONHA",1,0,3,138,1,143,"2020"
"57586","270644 PARIPUEIRA",1,1,3,233,4,242,"2020"
"57587","270650 PASSO DE CAMARAGIBE",0,0,6,197,5,208,"2020"
"57588","270660 PAULO JACINTO",0,0,1,85,0,86,"2020"
"57589","270670 PENEDO",2,5,15,905,3,930,"2020"
"57590","270680 PIACABUCU",0,2,7,266,2,277,"2020"
"57591","270690 PILAR",2,3,6,587,3,601,"2020"
"57592","270700 PINDOBA",0,0,0,36,0,36,"2020"
"57593","270710 PIRANHAS",0,3,4,372,3,382,"2020"
"57594","270720 POCO DAS TRINCHEIRAS",0,2,1,217,1,221,"2020"
"57595","270730 PORTO CALVO",2,0,7,348,2,359,"2020"
"57596","270740 PORTO DE PEDRAS",0,0,2,131,0,133,"2020"
"57597","270750 PORTO REAL DO COLEGIO",0,0,2,258,5,265,"2020"
"57598","270760 QUEBRANGULO",0,0,1,200,0,201,"2020"
"57599","270770 RIO LARGO",3,9,15,1264,22,1313,"2020"
"57600","270780 ROTEIRO",0,1,1,124,1,127,"2020"
"57601","270790 SANTA LUZIA DO NORTE",0,1,1,113,3,118,"2020"
"57602","270800 SANTANA DO IPANEMA",2,1,8,819,1,831,"2020"
"57603","270810 SANTANA DO MUNDAU",0,0,0,170,2,172,"2020"
"57604","270820 SAO BRAS",0,0,2,83,0,85,"2020"
"57605","270830 SAO JOSE DA LAJE",0,2,4,344,3,353,"2020"
"57606","270840 SAO JOSE DA TAPERA",1,2,5,546,0,554,"2020"
"57607","270850 SAO LUIS DO QUITUNDE",2,1,11,436,2,452,"2020"
"57608","270860 SAO MIGUEL DOS CAMPOS",2,0,7,787,3,799,"2020"
"57609","270870 SAO MIGUEL DOS MILAGRES",1,0,3,141,0,145,"2020"
"57610","270880 SAO SEBASTIAO",0,1,4,489,3,497,"2020"
"57611","270890 SATUBA",2,0,9,325,2,338,"2020"
"57612","270895 SENADOR RUI PALMEIRA",0,1,2,173,1,177,"2020"
"57613","270900 TANQUE D'ARCA",0,0,0,70,0,70,"2020"
"57614","270910 TAQUARANA",0,2,3,272,4,281,"2020"
"57615","270915 TEOTONIO VILELA",2,3,5,612,1,623,"2020"
"57616","270920 TRAIPU",1,1,6,321,6,335,"2020"
"57617","270930 UNIAO DOS PALMARES",2,1,5,1079,2,1089,"2020"
"57618","270940 VICOSA",0,1,3,373,8,385,"2020"
"57619","280010 AMPARO DE SAO FRANCISCO",0,0,2,41,1,44,"2020"
"57620","280020 AQUIDABA",1,1,3,219,7,231,"2020"
"57621","280030 ARACAJU",37,35,97,8022,65,8256,"2020"
"57622","280040 ARAUA",0,0,0,144,1,145,"2020"
"57623","280050 AREIA BRANCA",0,0,2,242,7,251,"2020"
"57624","280060 BARRA DOS COQUEIROS",1,3,9,516,5,534,"2020"
"57625","280067 BOQUIM",0,1,7,301,5,314,"2020"
"57626","280070 BREJO GRANDE",1,1,3,153,8,166,"2020"
"57627","280100 CAMPO DO BRITO",0,0,5,223,2,230,"2020"
"57628","280110 CANHOBA",0,0,1,67,4,72,"2020"
"57629","280120 CANINDE DE SAO FRANCISCO",2,2,17,474,14,509,"2020"
"57630","280130 CAPELA",1,0,9,482,41,533,"2020"
"57631","280140 CARIRA",1,1,6,253,4,265,"2020"
"57632","280150 CARMOPOLIS",1,1,2,211,7,222,"2020"
"57633","280160 CEDRO DE SAO JOAO",1,0,1,60,2,64,"2020"
"57634","280170 CRISTINAPOLIS",0,1,4,290,7,302,"2020"
"57635","280190 CUMBE",0,1,0,43,1,45,"2020"
"57636","280200 DIVINA PASTORA",0,1,1,66,4,72,"2020"
"57637","280210 ESTANCIA",2,4,16,1052,8,1082,"2020"
"57638","280220 FEIRA NOVA",1,0,1,86,9,97,"2020"
"57639","280230 FREI PAULO",2,2,1,211,0,216,"2020"
"57640","280240 GARARU",0,3,1,108,8,120,"2020"
"57641","280250 GENERAL MAYNARD",0,0,1,26,1,28,"2020"
"57642","280260 GRACHO CARDOSO",0,0,2,59,2,63,"2020"
"57643","280270 ILHA DAS FLORES",0,0,2,139,3,144,"2020"
"57644","280280 INDIAROBA",0,0,4,276,3,283,"2020"
"57645","280290 ITABAIANA",3,4,15,1303,13,1338,"2020"
"57646","280300 ITABAIANINHA",1,4,7,532,9,553,"2020"
"57647","280310 ITABI",0,2,0,53,2,57,"2020"
"57648","280320 ITAPORANGA D'AJUDA",0,2,7,499,32,540,"2020"
"57649","280330 JAPARATUBA",1,0,4,198,12,215,"2020"
"57650","280340 JAPOATA",0,0,1,205,10,216,"2020"
"57651","280350 LAGARTO",4,8,19,1427,18,1476,"2020"
"57652","280360 LARANJEIRAS",0,4,4,421,10,439,"2020"
"57653","280370 MACAMBIRA",1,0,2,83,0,86,"2020"
"57654","280380 MALHADA DOS BOIS",0,0,1,65,5,71,"2020"
"57655","280390 MALHADOR",0,1,1,159,2,163,"2020"
"57656","280400 MARUIM",2,2,3,231,10,248,"2020"
"57657","280410 MOITA BONITA",0,0,0,125,2,127,"2020"
"57658","280420 MONTE ALEGRE DE SERGIPE",1,0,5,228,14,248,"2020"
"57659","280430 MURIBECA",0,0,1,111,5,117,"2020"
"57660","280440 NEOPOLIS",1,1,4,202,4,212,"2020"
"57661","280445 NOSSA SENHORA APARECIDA",2,0,1,94,1,98,"2020"
"57662","280450 NOSSA SENHORA DA GLORIA",2,1,6,560,35,604,"2020"
"57663","280460 NOSSA SENHORA DAS DORES",1,3,8,302,17,331,"2020"
"57664","280470 NOSSA SENHORA DE LOURDES",0,0,4,58,5,67,"2020"
"57665","280480 NOSSA SENHORA DO SOCORRO",20,12,34,2934,32,3032,"2020"
"57666","280490 PACATUBA",1,1,3,198,8,211,"2020"
"57667","280500 PEDRA MOLE",0,0,0,40,1,41,"2020"
"57668","280510 PEDRINHAS",0,0,1,108,3,112,"2020"
"57669","280520 PINHAO",1,0,2,69,2,74,"2020"
"57670","280530 PIRAMBU",1,0,2,137,2,142,"2020"
"57671","280540 POCO REDONDO",2,3,9,494,24,532,"2020"
"57672","280550 POCO VERDE",1,1,2,250,9,263,"2020"
"57673","280560 PORTO DA FOLHA",1,2,7,359,19,388,"2020"
"57674","280570 PROPRIA",0,3,4,413,12,432,"2020"
"57675","280580 RIACHAO DO DANTAS",1,2,4,219,4,230,"2020"
"57676","280590 RIACHUELO",0,0,3,132,11,146,"2020"
"57677","280600 RIBEIROPOLIS",1,3,2,186,3,195,"2020"
"57678","280610 ROSARIO DO CATETE",0,0,4,159,4,167,"2020"
"57679","280620 SALGADO",0,0,4,247,8,259,"2020"
"57680","280630 SANTA LUZIA DO ITANHY",0,0,1,204,2,207,"2020"
"57681","280640 SANTANA DO SAO FRANCISCO",0,1,0,108,7,116,"2020"
"57682","280650 SANTA ROSA DE LIMA",0,1,1,65,1,68,"2020"
"57683","280660 SANTO AMARO DAS BROTAS",2,2,4,143,5,156,"2020"
"57684","280670 SAO CRISTOVAO",3,13,17,1213,26,1272,"2020"
"57685","280680 SAO DOMINGOS",0,0,0,111,3,114,"2020"
"57686","280690 SAO FRANCISCO",0,0,0,51,3,54,"2020"
"57687","280700 SAO MIGUEL DO ALEIXO",0,0,0,51,3,54,"2020"
"57688","280710 SIMAO DIAS",0,1,7,590,12,610,"2020"
"57689","280720 SIRIRI",2,0,1,102,7,112,"2020"
"57690","280730 TELHA",0,0,0,47,0,47,"2020"
"57691","280740 TOBIAS BARRETO",4,3,8,658,8,681,"2020"
"57692","280750 TOMAR DO GERU",1,1,2,149,2,155,"2020"
"57693","280760 UMBAUBA",1,0,6,409,4,420,"2020"
"57694","290010 ABAIRA",0,1,0,45,0,46,"2020"
"57695","290020 ABARE",3,2,9,303,1,318,"2020"
"57696","290030 ACAJUTIBA",0,2,3,153,1,159,"2020"
"57697","290035 ADUSTINA",0,1,2,135,5,143,"2020"
"57698","290040 AGUA FRIA",1,1,6,117,2,127,"2020"
"57699","290050 ERICO CARDOSO",0,0,0,108,0,108,"2020"
"57700","290060 AIQUARA",0,0,0,43,1,44,"2020"
"57701","290070 ALAGOINHAS",5,11,23,2075,22,2136,"2020"
"57702","290080 ALCOBACA",1,0,6,325,1,333,"2020"
"57703","290090 ALMADINA",1,1,1,55,1,59,"2020"
"57704","290100 AMARGOSA",0,0,16,440,3,459,"2020"
"57705","290110 AMELIA RODRIGUES",0,0,2,169,4,175,"2020"
"57706","290115 AMERICA DOURADA",3,1,1,203,1,209,"2020"
"57707","290120 ANAGE",3,0,6,228,4,241,"2020"
"57708","290130 ANDARAI",0,1,2,173,4,180,"2020"
"57709","290135 ANDORINHA",4,0,4,169,0,177,"2020"
"57710","290140 ANGICAL",0,3,3,178,0,184,"2020"
"57711","290150 ANGUERA",0,0,1,51,1,53,"2020"
"57712","290160 ANTAS",2,0,1,149,1,153,"2020"
"57713","290170 ANTONIO CARDOSO",0,2,3,133,3,141,"2020"
"57714","290180 ANTONIO GONCALVES",0,2,3,153,2,160,"2020"
"57715","290190 APORA",0,2,0,166,1,169,"2020"
"57716","290195 APUAREMA",0,0,0,101,2,103,"2020"
"57717","290200 ARACATU",1,2,2,153,0,158,"2020"
"57718","290205 ARACAS",0,0,1,148,2,151,"2020"
"57719","290210 ARACI",1,6,18,624,12,661,"2020"
"57720","290220 ARAMARI",0,2,0,97,1,100,"2020"
"57721","290225 ARATACA",2,1,4,126,6,139,"2020"
"57722","290230 ARATUIPE",0,0,5,130,0,135,"2020"
"57723","290240 AURELINO LEAL",1,2,4,140,43,190,"2020"
"57724","290250 BAIANOPOLIS",0,0,3,182,1,186,"2020"
"57725","290260 BAIXA GRANDE",0,2,9,193,0,204,"2020"
"57726","290265 BANZAE",0,0,0,133,28,161,"2020"
"57727","290270 BARRA",2,8,9,814,1,834,"2020"
"57728","290280 BARRA DA ESTIVA",1,4,3,412,1,421,"2020"
"57729","290290 BARRA DO CHOCA",4,3,10,519,4,540,"2020"
"57730","290300 BARRA DO MENDES",1,1,3,143,0,148,"2020"
"57731","290310 BARRA DO ROCHA",0,0,1,58,0,59,"2020"
"57732","290320 BARREIRAS",4,6,34,2498,3,2545,"2020"
"57733","290323 BARRO ALTO",1,2,1,152,0,156,"2020"
"57734","290327 BARROCAS",2,0,10,158,0,170,"2020"
"57735","290330 BARRO PRETO",0,0,1,60,0,61,"2020"
"57736","290340 BELMONTE",2,3,1,301,9,316,"2020"
"57737","290350 BELO CAMPO",3,1,3,212,0,219,"2020"
"57738","290360 BIRITINGA",0,1,6,201,6,214,"2020"
"57739","290370 BOA NOVA",1,0,1,172,2,176,"2020"
"57740","290380 BOA VISTA DO TUPIM",4,0,1,229,0,234,"2020"
"57741","290390 BOM JESUS DA LAPA",3,4,12,1056,12,1087,"2020"
"57742","290395 BOM JESUS DA SERRA",1,0,4,116,4,125,"2020"
"57743","290400 BONINAL",1,0,3,169,7,180,"2020"
"57744","290405 BONITO",0,1,3,210,31,245,"2020"
"57745","290410 BOQUIRA",0,1,3,243,0,247,"2020"
"57746","290420 BOTUPORA",0,1,0,131,0,132,"2020"
"57747","290430 BREJOES",0,2,3,134,0,139,"2020"
"57748","290440 BREJOLANDIA",0,0,3,93,2,98,"2020"
"57749","290450 BROTAS DE MACAUBAS",0,0,1,142,3,146,"2020"
"57750","290460 BRUMADO",2,6,13,833,2,856,"2020"
"57751","290470 BUERAREMA",0,3,2,193,4,202,"2020"
"57752","290475 BURITIRAMA",1,3,6,299,1,310,"2020"
"57753","290480 CAATIBA",0,0,0,66,0,66,"2020"
"57754","290485 CABACEIRAS DO PARAGUACU",2,2,10,189,5,208,"2020"
"57755","290490 CACHOEIRA",2,0,4,194,160,360,"2020"
"57756","290500 CACULE",0,3,9,295,3,310,"2020"
"57757","290510 CAEM",0,0,3,144,2,149,"2020"
"57758","290515 CAETANOS",0,0,3,117,2,122,"2020"
"57759","290520 CAETITE",0,1,10,661,4,676,"2020"
"57760","290530 CAFARNAUM",1,0,7,232,1,241,"2020"
"57761","290540 CAIRU",2,3,9,287,2,303,"2020"
"57762","290550 CALDEIRAO GRANDE",0,1,3,186,1,191,"2020"
"57763","290560 CAMACAN",5,4,6,328,2,345,"2020"
"57764","290570 CAMACARI",15,17,60,3751,50,3893,"2020"
"57765","290580 CAMAMU",2,4,23,528,13,570,"2020"
"57766","290590 CAMPO ALEGRE DE LOURDES",2,2,8,500,4,516,"2020"
"57767","290600 CAMPO FORMOSO",4,4,23,1056,35,1122,"2020"
"57768","290610 CANAPOLIS",0,0,0,118,10,128,"2020"
"57769","290620 CANARANA",0,2,7,274,23,306,"2020"
"57770","290630 CANAVIEIRAS",0,2,9,371,49,431,"2020"
"57771","290640 CANDEAL",1,0,2,59,0,62,"2020"
"57772","290650 CANDEIAS",7,5,15,942,6,975,"2020"
"57773","290660 CANDIBA",0,0,8,161,0,169,"2020"
"57774","290670 CANDIDO SALES",0,4,4,332,1,341,"2020"
"57775","290680 CANSANCAO",0,2,10,452,2,466,"2020"
"57776","290682 CANUDOS",0,1,2,201,6,210,"2020"
"57777","290685 CAPELA DO ALTO ALEGRE",1,1,0,101,0,103,"2020"
"57778","290687 CAPIM GROSSO",3,2,6,434,2,447,"2020"
"57779","290689 CARAIBAS",1,0,1,83,3,88,"2020"
"57780","290690 CARAVELAS",1,1,7,257,1,267,"2020"
"57781","290700 CARDEAL DA SILVA",0,0,2,104,2,108,"2020"
"57782","290710 CARINHANHA",0,0,4,431,4,439,"2020"
"57783","290720 CASA NOVA",5,5,17,951,7,985,"2020"
"57784","290730 CASTRO ALVES",0,0,1,303,1,305,"2020"
"57785","290740 CATOLANDIA",0,0,0,42,0,42,"2020"
"57786","290750 CATU",0,5,9,452,1,467,"2020"
"57787","290755 CATURAMA",1,0,2,80,0,83,"2020"
"57788","290760 CENTRAL",2,2,4,194,0,202,"2020"
"57789","290770 CHORROCHO",1,3,3,133,1,141,"2020"
"57790","290780 CICERO DANTAS",0,1,5,288,21,315,"2020"
"57791","290790 CIPO",2,2,3,252,15,274,"2020"
"57792","290800 COARACI",0,2,5,184,4,195,"2020"
"57793","290810 COCOS",0,0,8,212,54,274,"2020"
"57794","290820 CONCEICAO DA FEIRA",1,1,2,132,102,238,"2020"
"57795","290830 CONCEICAO DO ALMEIDA",0,2,0,159,0,161,"2020"
"57796","290840 CONCEICAO DO COITE",3,6,12,947,3,971,"2020"
"57797","290850 CONCEICAO DO JACUIPE",0,1,2,336,10,349,"2020"
"57798","290860 CONDE",0,0,6,307,10,323,"2020"
"57799","290870 CONDEUBA",0,2,3,207,0,212,"2020"
"57800","290880 CONTENDAS DO SINCORA",0,0,1,41,0,42,"2020"
"57801","290890 CORACAO DE MARIA",1,0,4,212,6,223,"2020"
"57802","290900 CORDEIROS",0,0,3,76,1,80,"2020"
"57803","290910 CORIBE",1,0,3,142,2,148,"2020"
"57804","290920 CORONEL JOAO SA",1,0,0,193,9,203,"2020"
"57805","290930 CORRENTINA",1,3,1,108,308,421,"2020"
"57806","290940 COTEGIPE",2,0,6,164,0,172,"2020"
"57807","290950 CRAVOLANDIA",0,0,0,73,0,73,"2020"
"57808","290960 CRISOPOLIS",0,0,6,220,0,226,"2020"
"57809","290970 CRISTOPOLIS",0,1,4,162,1,168,"2020"
"57810","290980 CRUZ DAS ALMAS",0,0,13,766,7,786,"2020"
"57811","290990 CURACA",1,3,9,534,4,551,"2020"
"57812","291000 DARIO MEIRA",0,1,4,128,3,136,"2020"
"57813","291005 DIAS D'AVILA",3,2,16,1021,4,1046,"2020"
"57814","291010 DOM BASILIO",0,0,2,120,0,122,"2020"
"57815","291020 DOM MACEDO COSTA",0,0,1,51,0,52,"2020"
"57816","291030 ELISIO MEDRADO",1,0,2,81,0,84,"2020"
"57817","291040 ENCRUZILHADA",0,0,11,260,2,273,"2020"
"57818","291050 ENTRE RIOS",4,7,11,480,8,510,"2020"
"57819","291060 ESPLANADA",0,3,13,480,1,497,"2020"
"57820","291070 EUCLIDES DA CUNHA",3,3,5,803,10,824,"2020"
"57821","291072 EUNAPOLIS",7,5,18,1770,9,1809,"2020"
"57822","291075 FATIMA",0,2,4,202,5,213,"2020"
"57823","291077 FEIRA DA MATA",0,0,3,45,12,60,"2020"
"57824","291080 FEIRA DE SANTANA",18,45,159,9103,140,9465,"2020"
"57825","291085 FILADELFIA",1,5,10,215,2,233,"2020"
"57826","291090 FIRMINO ALVES",0,0,2,47,1,50,"2020"
"57827","291100 FLORESTA AZUL",0,0,1,88,1,90,"2020"
"57828","291110 FORMOSA DO RIO PRETO",0,0,7,407,10,424,"2020"
"57829","291120 GANDU",1,3,7,417,1,429,"2020"
"57830","291125 GAVIAO",0,0,0,47,0,47,"2020"
"57831","291130 GENTIO DO OURO",0,1,1,139,0,141,"2020"
"57832","291140 GLORIA",0,2,11,208,2,223,"2020"
"57833","291150 GONGOGI",0,2,1,66,1,70,"2020"
"57834","291160 GOVERNADOR MANGABEIRA",1,0,2,248,27,278,"2020"
"57835","291165 GUAJERU",0,1,2,60,0,63,"2020"
"57836","291170 GUANAMBI",1,4,32,1194,34,1265,"2020"
"57837","291180 GUARATINGA",0,0,4,210,6,220,"2020"
"57838","291185 HELIOPOLIS",0,1,0,111,20,132,"2020"
"57839","291190 IACU",2,1,6,325,0,334,"2020"
"57840","291200 IBIASSUCE",0,0,1,97,0,98,"2020"
"57841","291210 IBICARAI",0,2,7,219,1,229,"2020"
"57842","291220 IBICOARA",0,3,6,304,9,322,"2020"
"57843","291230 IBICUI",1,3,5,142,0,151,"2020"
"57844","291240 IBIPEBA",1,1,4,191,0,197,"2020"
"57845","291250 IBIPITANGA",0,0,1,137,2,140,"2020"
"57846","291260 IBIQUERA",0,1,1,53,2,57,"2020"
"57847","291270 IBIRAPITANGA",2,3,12,308,6,331,"2020"
"57848","291280 IBIRAPUA",1,0,4,120,1,126,"2020"
"57849","291290 IBIRATAIA",1,0,3,229,0,233,"2020"
"57850","291300 IBITIARA",0,2,2,132,0,136,"2020"
"57851","291310 IBITITA",1,2,4,207,1,215,"2020"
"57852","291320 IBOTIRAMA",3,2,1,397,1,404,"2020"
"57853","291330 ICHU",0,0,0,39,0,39,"2020"
"57854","291340 IGAPORA",0,1,4,127,2,134,"2020"
"57855","291345 IGRAPIUNA",3,2,4,169,2,180,"2020"
"57856","291350 IGUAI",3,4,6,350,1,364,"2020"
"57857","291360 ILHEUS",3,9,21,1523,725,2281,"2020"
"57858","291370 INHAMBUPE",3,5,4,390,3,405,"2020"
"57859","291380 IPECAETA",1,0,1,119,2,123,"2020"
"57860","291390 IPIAU",3,2,7,589,1,602,"2020"
"57861","291400 IPIRA",3,2,9,680,1,695,"2020"
"57862","291410 IPUPIARA",0,1,2,88,1,92,"2020"
"57863","291420 IRAJUBA",0,1,2,61,1,65,"2020"
"57864","291430 IRAMAIA",0,0,1,102,2,105,"2020"
"57865","291440 IRAQUARA",0,0,6,361,0,367,"2020"
"57866","291450 IRARA",0,3,8,280,5,296,"2020"
"57867","291460 IRECE",6,4,19,1228,2,1259,"2020"
"57868","291465 ITABELA",1,3,10,493,5,512,"2020"
"57869","291470 ITABERABA",3,2,4,837,2,848,"2020"
"57870","291480 ITABUNA",5,16,44,2258,10,2333,"2020"
"57871","291490 ITACARE",0,6,3,292,108,409,"2020"
"57872","291500 ITAETE",0,1,3,193,0,197,"2020"
"57873","291510 ITAGI",0,0,1,199,2,202,"2020"
"57874","291520 ITAGIBA",0,2,2,148,0,152,"2020"
"57875","291530 ITAGIMIRIM",0,0,0,53,1,54,"2020"
"57876","291535 ITAGUACU DA BAHIA",0,0,2,178,0,180,"2020"
"57877","291540 ITAJU DO COLONIA",2,0,4,65,3,74,"2020"
"57878","291550 ITAJUIPE",0,1,5,207,0,213,"2020"
"57879","291560 ITAMARAJU",6,2,25,942,10,985,"2020"
"57880","291570 ITAMARI",0,1,1,125,4,131,"2020"
"57881","291580 ITAMBE",2,4,11,246,4,267,"2020"
"57882","291590 ITANAGRA",1,0,0,93,0,94,"2020"
"57883","291600 ITANHEM",0,0,4,183,0,187,"2020"
"57884","291610 ITAPARICA",0,2,7,249,4,262,"2020"
"57885","291620 ITAPE",1,0,1,109,2,113,"2020"
"57886","291630 ITAPEBI",0,0,1,104,0,105,"2020"
"57887","291640 ITAPETINGA",0,5,19,925,10,959,"2020"
"57888","291650 ITAPICURU",1,0,4,307,10,322,"2020"
"57889","291660 ITAPITANGA",0,0,2,69,1,72,"2020"
"57890","291670 ITAQUARA",0,1,2,82,0,85,"2020"
"57891","291680 ITARANTIM",2,1,6,198,0,207,"2020"
"57892","291685 ITATIM",0,0,0,153,0,153,"2020"
"57893","291690 ITIRUCU",0,1,1,136,1,139,"2020"
"57894","291700 ITIUBA",4,6,13,486,2,511,"2020"
"57895","291710 ITORORO",3,2,6,183,9,203,"2020"
"57896","291720 ITUACU",0,1,10,191,1,203,"2020"
"57897","291730 ITUBERA",0,2,5,284,2,293,"2020"
"57898","291733 IUIU",0,1,5,124,1,131,"2020"
"57899","291735 JABORANDI",1,0,5,132,1,139,"2020"
"57900","291740 JACARACI",0,0,2,119,0,121,"2020"
"57901","291750 JACOBINA",4,3,15,1268,4,1294,"2020"
"57902","291760 JAGUAQUARA",1,2,12,663,1,679,"2020"
"57903","291770 JAGUARARI",3,2,10,399,35,449,"2020"
"57904","291780 JAGUARIPE",3,1,6,219,1,230,"2020"
"57905","291790 JANDAIRA",0,0,1,141,1,143,"2020"
"57906","291800 JEQUIE",1,11,28,2175,25,2240,"2020"
"57907","291810 JEREMOABO",1,2,14,467,8,492,"2020"
"57908","291820 JIQUIRICA",0,1,4,134,2,141,"2020"
"57909","291830 JITAUNA",0,0,2,180,2,184,"2020"
"57910","291835 JOAO DOURADO",2,4,14,383,1,404,"2020"
"57911","291840 JUAZEIRO",10,34,85,4075,59,4263,"2020"
"57912","291845 JUCURUCU",0,0,2,80,2,84,"2020"
"57913","291850 JUSSARA",0,0,7,179,2,188,"2020"
"57914","291855 JUSSARI",2,0,1,51,2,56,"2020"
"57915","291860 JUSSIAPE",0,0,0,55,3,58,"2020"
"57916","291870 LAFAIETE COUTINHO",0,0,1,54,1,56,"2020"
"57917","291875 LAGOA REAL",1,1,1,132,0,135,"2020"
"57918","291880 LAJE",0,3,6,254,4,267,"2020"
"57919","291890 LAJEDAO",0,0,0,33,0,33,"2020"
"57920","291900 LAJEDINHO",0,1,1,35,0,37,"2020"
"57921","291905 LAJEDO DO TABOCAL",0,0,4,62,0,66,"2020"
"57922","291910 LAMARAO",0,0,1,86,0,87,"2020"
"57923","291915 LAPAO",0,2,12,341,0,355,"2020"
"57924","291920 LAURO DE FREITAS",13,14,42,2906,38,3013,"2020"
"57925","291930 LENCOIS",0,3,1,118,15,137,"2020"
"57926","291940 LICINIO DE ALMEIDA",1,0,2,152,1,156,"2020"
"57927","291950 LIVRAMENTO DE NOSSA SENHORA",3,1,8,549,3,564,"2020"
"57928","291955 LUIS EDUARDO MAGALHAES",7,12,27,1989,0,2035,"2020"
"57929","291960 MACAJUBA",2,0,1,128,0,131,"2020"
"57930","291970 MACARANI",1,1,1,184,5,192,"2020"
"57931","291980 MACAUBAS",8,2,3,532,7,552,"2020"
"57932","291990 MACURURE",0,1,3,90,3,97,"2020"
"57933","291992 MADRE DE DEUS",1,2,4,247,0,254,"2020"
"57934","291995 MAETINGA",1,0,1,81,0,83,"2020"
"57935","292000 MAIQUINIQUE",0,1,2,107,2,112,"2020"
"57936","292010 MAIRI",0,0,1,209,0,210,"2020"
"57937","292020 MALHADA",1,0,2,168,3,174,"2020"
"57938","292030 MALHADA DE PEDRAS",0,0,0,104,0,104,"2020"
"57939","292040 MANOEL VITORINO",0,1,2,174,1,178,"2020"
"57940","292045 MANSIDAO",0,0,1,87,1,89,"2020"
"57941","292050 MARACAS",1,2,4,279,2,288,"2020"
"57942","292060 MARAGOGIPE",0,4,3,240,177,424,"2020"
"57943","292070 MARAU",0,1,2,230,58,291,"2020"
"57944","292080 MARCIONILIO SOUZA",0,0,1,108,0,109,"2020"
"57945","292090 MASCOTE",0,0,2,120,1,123,"2020"
"57946","292100 MATA DE SAO JOAO",12,5,10,724,5,756,"2020"
"57947","292105 MATINA",0,0,4,124,4,132,"2020"
"57948","292110 MEDEIROS NETO",0,3,9,273,0,285,"2020"
"57949","292120 MIGUEL CALMON",0,0,7,363,0,370,"2020"
"57950","292130 MILAGRES",0,1,1,128,0,130,"2020"
"57951","292140 MIRANGABA",0,0,6,175,1,182,"2020"
"57952","292145 MIRANTE",0,1,2,88,2,93,"2020"
"57953","292150 MONTE SANTO",0,2,15,616,7,640,"2020"
"57954","292160 MORPARA",0,1,4,98,0,103,"2020"
"57955","292170 MORRO DO CHAPEU",1,2,5,464,1,473,"2020"
"57956","292180 MORTUGABA",0,0,3,121,0,124,"2020"
"57957","292190 MUCUGE",1,1,1,94,32,129,"2020"
"57958","292200 MUCURI",1,1,10,629,0,641,"2020"
"57959","292205 MULUNGU DO MORRO",0,0,5,176,0,181,"2020"
"57960","292210 MUNDO NOVO",0,1,3,175,2,181,"2020"
"57961","292220 MUNIZ FERREIRA",1,0,2,68,0,71,"2020"
"57962","292225 MUQUEM DE SAO FRANCISCO",1,0,0,174,2,177,"2020"
"57963","292230 MURITIBA",0,0,7,243,57,307,"2020"
"57964","292240 MUTUIPE",2,2,7,241,0,252,"2020"
"57965","292250 NAZARE",1,2,5,273,2,283,"2020"
"57966","292260 NILO PECANHA",1,2,11,150,3,167,"2020"
"57967","292265 NORDESTINA",1,1,4,158,0,164,"2020"
"57968","292270 NOVA CANAA",1,0,3,150,0,154,"2020"
"57969","292273 NOVA FATIMA",0,0,0,67,1,68,"2020"
"57970","292275 NOVA IBIA",0,0,2,42,0,44,"2020"
"57971","292280 NOVA ITARANA",1,1,1,103,3,109,"2020"
"57972","292285 NOVA REDENCAO",2,1,0,75,17,95,"2020"
"57973","292290 NOVA SOURE",2,3,3,299,25,332,"2020"
"57974","292300 NOVA VICOSA",1,1,11,418,2,433,"2020"
"57975","292303 NOVO HORIZONTE",0,2,2,151,1,156,"2020"
"57976","292305 NOVO TRIUNFO",0,3,0,101,3,107,"2020"
"57977","292310 OLINDINA",0,2,6,261,13,282,"2020"
"57978","292320 OLIVEIRA DOS BREJINHOS",0,0,3,241,2,246,"2020"
"57979","292330 OURICANGAS",0,0,1,65,0,66,"2020"
"57980","292335 OUROLANDIA",0,2,4,241,0,247,"2020"
"57981","292340 PALMAS DE MONTE ALTO",0,2,7,220,8,237,"2020"
"57982","292350 PALMEIRAS",2,0,5,127,17,151,"2020"
"57983","292360 PARAMIRIM",1,0,2,236,0,239,"2020"
"57984","292370 PARATINGA",0,1,4,419,1,425,"2020"
"57985","292380 PARIPIRANGA",1,2,6,267,5,281,"2020"
"57986","292390 PAU BRASIL",1,1,3,145,3,153,"2020"
"57987","292400 PAULO AFONSO",4,7,30,1705,3,1749,"2020"
"57988","292405 PE DE SERRA",1,1,1,142,3,148,"2020"
"57989","292410 PEDRAO",1,0,2,71,2,76,"2020"
"57990","292420 PEDRO ALEXANDRE",0,0,2,183,5,190,"2020"
"57991","292430 PIATA",0,1,2,234,2,239,"2020"
"57992","292440 PILAO ARCADO",0,4,6,580,14,604,"2020"
"57993","292450 PINDAI",0,0,3,130,15,148,"2020"
"57994","292460 PINDOBACU",5,2,1,254,0,262,"2020"
"57995","292465 PINTADAS",0,0,1,71,0,72,"2020"
"57996","292467 PIRAI DO NORTE",2,1,0,91,1,95,"2020"
"57997","292470 PIRIPA",0,1,1,88,3,93,"2020"
"57998","292480 PIRITIBA",2,1,4,196,2,205,"2020"
"57999","292490 PLANALTINO",0,0,1,76,1,78,"2020"
"58000","292500 PLANALTO",0,0,9,287,0,296,"2020"
"58001","292510 POCOES",0,7,9,629,5,650,"2020"
"58002","292520 POJUCA",2,4,8,404,0,418,"2020"
"58003","292525 PONTO NOVO",2,1,3,250,1,257,"2020"
"58004","292530 PORTO SEGURO",4,7,32,2648,71,2762,"2020"
"58005","292540 POTIRAGUA",0,1,3,95,7,106,"2020"
"58006","292550 PRADO",2,2,13,499,5,521,"2020"
"58007","292560 PRESIDENTE DUTRA",0,0,3,146,0,149,"2020"
"58008","292570 PRESIDENTE JANIO QUADROS",0,2,3,115,2,122,"2020"
"58009","292575 PRESIDENTE TANCREDO NEVES",0,2,5,334,43,384,"2020"
"58010","292580 QUEIMADAS",1,1,0,331,0,333,"2020"
"58011","292590 QUIJINGUE",1,2,9,282,7,301,"2020"
"58012","292593 QUIXABEIRA",0,0,0,98,0,98,"2020"
"58013","292595 RAFAEL JAMBEIRO",1,0,5,204,3,213,"2020"
"58014","292600 REMANSO",1,4,5,634,3,647,"2020"
"58015","292610 RETIROLANDIA",1,1,2,170,1,175,"2020"
"58016","292620 RIACHAO DAS NEVES",2,2,6,287,2,299,"2020"
"58017","292630 RIACHAO DO JACUIPE",1,2,5,375,0,383,"2020"
"58018","292640 RIACHO DE SANTANA",1,1,4,329,4,339,"2020"
"58019","292650 RIBEIRA DO AMPARO",0,3,3,154,17,177,"2020"
"58020","292660 RIBEIRA DO POMBAL",1,2,9,560,159,731,"2020"
"58021","292665 RIBEIRAO DO LARGO",1,2,2,98,4,107,"2020"
"58022","292670 RIO DE CONTAS",1,0,1,135,0,137,"2020"
"58023","292680 RIO DO ANTONIO",0,3,0,125,2,130,"2020"
"58024","292690 RIO DO PIRES",0,0,1,84,0,85,"2020"
"58025","292700 RIO REAL",1,2,5,456,5,469,"2020"
"58026","292710 RODELAS",0,5,4,171,4,184,"2020"
"58027","292720 RUY BARBOSA",1,1,7,403,0,412,"2020"
"58028","292730 SALINAS DA MARGARIDA",1,1,5,183,1,191,"2020"
"58029","292740 SALVADOR",152,138,430,29168,261,30149,"2020"
"58030","292750 SANTA BARBARA",0,1,4,214,11,230,"2020"
"58031","292760 SANTA BRIGIDA",0,2,8,193,2,205,"2020"
"58032","292770 SANTA CRUZ CABRALIA",0,3,3,444,3,453,"2020"
"58033","292780 SANTA CRUZ DA VITORIA",0,0,0,57,1,58,"2020"
"58034","292790 SANTA INES",0,1,1,101,0,103,"2020"
"58035","292800 SANTALUZ",0,3,14,512,0,529,"2020"
"58036","292805 SANTA LUZIA",1,2,3,151,4,161,"2020"
"58037","292810 SANTA MARIA DA VITORIA",1,1,5,500,16,523,"2020"
"58038","292820 SANTANA",0,6,7,288,1,302,"2020"
"58039","292830 SANTANOPOLIS",0,1,1,52,1,55,"2020"
"58040","292840 SANTA RITA DE CASSIA",1,1,9,369,6,386,"2020"
"58041","292850 SANTA TERESINHA",0,0,1,147,0,148,"2020"
"58042","292860 SANTO AMARO",2,8,15,543,10,578,"2020"
"58043","292870 SANTO ANTONIO DE JESUS",3,7,25,1279,6,1320,"2020"
"58044","292880 SANTO ESTEVAO",1,0,11,608,18,638,"2020"
"58045","292890 SAO DESIDERIO",3,2,9,531,3,548,"2020"
"58046","292895 SAO DOMINGOS",0,1,0,69,0,70,"2020"
"58047","292900 SAO FELIX",0,1,1,26,127,155,"2020"
"58048","292905 SAO FELIX DO CORIBE",0,2,4,243,1,250,"2020"
"58049","292910 SAO FELIPE",2,0,2,206,2,212,"2020"
"58050","292920 SAO FRANCISCO DO CONDE",6,2,4,550,1,563,"2020"
"58051","292925 SAO GABRIEL",1,1,4,214,3,223,"2020"
"58052","292930 SAO GONCALO DOS CAMPOS",1,1,5,328,6,341,"2020"
"58053","292935 SAO JOSE DA VITORIA",1,0,1,79,1,82,"2020"
"58054","292937 SAO JOSE DO JACUIPE",2,1,2,123,0,128,"2020"
"58055","292940 SAO MIGUEL DAS MATAS",1,1,4,106,1,113,"2020"
"58056","292950 SAO SEBASTIAO DO PASSE",1,3,7,445,0,456,"2020"
"58057","292960 SAPEACU",0,0,0,210,0,210,"2020"
"58058","292970 SATIRO DIAS",1,0,5,165,1,172,"2020"
"58059","292975 SAUBARA",2,0,2,130,0,134,"2020"
"58060","292980 SAUDE",0,1,0,103,5,109,"2020"
"58061","292990 SEABRA",0,5,4,610,4,623,"2020"
"58062","293000 SEBASTIAO LARANJEIRAS",1,0,1,74,6,82,"2020"
"58063","293010 SENHOR DO BONFIM",11,3,13,979,4,1010,"2020"
"58064","293015 SERRA DO RAMALHO",2,0,11,542,10,565,"2020"
"58065","293020 SENTO SE",1,2,7,485,4,499,"2020"
"58066","293030 SERRA DOURADA",0,1,8,205,2,216,"2020"
"58067","293040 SERRA PRETA",0,0,1,84,3,88,"2020"
"58068","293050 SERRINHA",0,4,21,1118,2,1145,"2020"
"58069","293060 SERROLANDIA",0,2,1,152,0,155,"2020"
"58070","293070 SIMOES FILHO",7,6,22,1699,15,1749,"2020"
"58071","293075 SITIO DO MATO",2,2,4,181,1,190,"2020"
"58072","293076 SITIO DO QUINTO",0,0,1,132,4,137,"2020"
"58073","293077 SOBRADINHO",1,0,9,419,4,433,"2020"
"58074","293080 SOUTO SOARES",0,0,2,230,1,233,"2020"
"58075","293090 TABOCAS DO BREJO VELHO",1,2,3,127,2,135,"2020"
"58076","293100 TANHACU",1,0,5,247,0,253,"2020"
"58077","293105 TANQUE NOVO",0,0,4,190,4,198,"2020"
"58078","293110 TANQUINHO",0,0,0,73,1,74,"2020"
"58079","293120 TAPEROA",0,1,9,195,10,215,"2020"
"58080","293130 TAPIRAMUTA",1,1,7,233,1,243,"2020"
"58081","293135 TEIXEIRA DE FREITAS",8,6,28,2495,10,2547,"2020"
"58082","293140 TEODORO SAMPAIO",1,1,1,67,0,70,"2020"
"58083","293150 TEOFILANDIA",1,1,8,251,2,263,"2020"
"58084","293160 TEOLANDIA",0,3,4,170,1,178,"2020"
"58085","293170 TERRA NOVA",0,0,3,102,3,108,"2020"
"58086","293180 TREMEDAL",0,1,7,161,2,171,"2020"
"58087","293190 TUCANO",2,0,5,534,26,567,"2020"
"58088","293200 UAUA",0,0,8,327,2,337,"2020"
"58089","293210 UBAIRA",0,0,4,193,2,199,"2020"
"58090","293220 UBAITABA",1,1,2,246,5,255,"2020"
"58091","293230 UBATA",0,0,4,200,0,204,"2020"
"58092","293240 UIBAI",0,0,4,145,0,149,"2020"
"58093","293245 UMBURANAS",1,1,0,205,0,207,"2020"
"58094","293250 UNA",1,4,1,163,68,237,"2020"
"58095","293260 URANDI",0,3,3,154,3,163,"2020"
"58096","293270 URUCUCA",2,1,8,198,88,297,"2020"
"58097","293280 UTINGA",0,0,1,174,46,221,"2020"
"58098","293290 VALENCA",7,10,58,1296,0,1371,"2020"
"58099","293300 VALENTE",2,3,7,251,0,263,"2020"
"58100","293305 VARZEA DA ROCA",0,1,0,117,2,120,"2020"
"58101","293310 VARZEA DO POCO",0,0,3,84,1,88,"2020"
"58102","293315 VARZEA NOVA",0,2,3,165,4,174,"2020"
"58103","293317 VARZEDO",0,1,3,94,1,99,"2020"
"58104","293320 VERA CRUZ",4,3,8,535,2,552,"2020"
"58105","293325 VEREDA",0,0,2,68,0,70,"2020"
"58106","293330 VITORIA DA CONQUISTA",8,18,81,5022,45,5174,"2020"
"58107","293340 WAGNER",0,0,1,20,78,99,"2020"
"58108","293345 WANDERLEY",0,0,2,159,3,164,"2020"
"58109","293350 WENCESLAU GUIMARAES",0,1,8,286,1,296,"2020"
"58110","293360 XIQUE-XIQUE",2,4,21,804,25,856,"2020"
"58111","MUNICIPIO IGNORADO - MG",0,1,0,5,0,6,"2020"
"58112","310010 ABADIA DOS DOURADOS",0,0,1,60,0,61,"2020"
"58113","310020 ABAETE",1,2,2,244,0,249,"2020"
"58114","310030 ABRE CAMPO",0,0,0,153,5,158,"2020"
"58115","310040 ACAIACA",0,0,2,45,4,51,"2020"
"58116","310050 ACUCENA",0,0,0,94,0,94,"2020"
"58117","310060 AGUA BOA",0,0,2,165,3,170,"2020"
"58118","310070 AGUA COMPRIDA",0,0,0,25,0,25,"2020"
"58119","310080 AGUANIL",0,0,1,37,0,38,"2020"
"58120","310090 AGUAS FORMOSAS",0,0,5,252,1,258,"2020"
"58121","310100 AGUAS VERMELHAS",0,1,4,152,2,159,"2020"
"58122","310110 AIMORES",0,2,6,323,0,331,"2020"
"58123","310120 AIURUOCA",0,0,1,49,1,51,"2020"
"58124","310130 ALAGOA",0,0,0,25,0,25,"2020"
"58125","310140 ALBERTINA",0,0,0,20,0,20,"2020"
"58126","310150 ALEM PARAIBA",0,1,8,351,2,362,"2020"
"58127","310160 ALFENAS",2,3,17,965,3,990,"2020"
"58128","310163 ALFREDO VASCONCELOS",0,0,1,89,0,90,"2020"
"58129","310170 ALMENARA",12,5,18,503,3,541,"2020"
"58130","310180 ALPERCATA",0,1,1,88,4,94,"2020"
"58131","310190 ALPINOPOLIS",0,0,3,221,1,225,"2020"
"58132","310200 ALTEROSA",0,0,1,162,0,163,"2020"
"58133","310205 ALTO CAPARAO",0,0,1,75,1,77,"2020"
"58134","310210 ALTO RIO DOCE",0,0,1,95,1,97,"2020"
"58135","310220 ALVARENGA",0,1,1,52,2,56,"2020"
"58136","310230 ALVINOPOLIS",0,2,5,138,4,149,"2020"
"58137","310240 ALVORADA DE MINAS",0,1,2,59,0,62,"2020"
"58138","310250 AMPARO DO SERRA",0,0,1,47,0,48,"2020"
"58139","310260 ANDRADAS",2,3,6,453,9,473,"2020"
"58140","310270 CACHOEIRA DE PAJEU",0,0,2,74,1,77,"2020"
"58141","310280 ANDRELANDIA",0,0,3,112,0,115,"2020"
"58142","310285 ANGELANDIA",1,1,1,102,0,105,"2020"
"58143","310290 ANTONIO CARLOS",0,0,0,114,0,114,"2020"
"58144","310300 ANTONIO DIAS",1,2,2,109,0,114,"2020"
"58145","310310 ANTONIO PRADO DE MINAS",0,0,0,9,0,9,"2020"
"58146","310320 ARACAI",0,0,0,24,0,24,"2020"
"58147","310330 ARACITABA",0,0,1,16,0,17,"2020"
"58148","310340 ARACUAI",2,3,8,386,0,399,"2020"
"58149","310350 ARAGUARI",7,10,18,1288,7,1330,"2020"
"58150","310360 ARANTINA",0,0,0,29,1,30,"2020"
"58151","310370 ARAPONGA",0,1,2,99,1,103,"2020"
"58152","310375 ARAPORA",0,0,3,125,0,128,"2020"
"58153","310380 ARAPUA",0,0,1,15,0,16,"2020"
"58154","310390 ARAUJOS",1,1,1,100,0,103,"2020"
"58155","310400 ARAXA",4,4,12,1465,4,1489,"2020"
"58156","310410 ARCEBURGO",0,1,0,68,0,69,"2020"
"58157","310420 ARCOS",1,0,3,493,0,497,"2020"
"58158","310430 AREADO",0,1,2,142,2,147,"2020"
"58159","310440 ARGIRITA",0,0,1,33,0,34,"2020"
"58160","310445 ARICANDUVA",1,1,1,63,4,70,"2020"
"58161","310450 ARINOS",0,0,4,186,3,193,"2020"
"58162","310460 ASTOLFO DUTRA",0,0,4,123,0,127,"2020"
"58163","310470 ATALEIA",0,2,1,111,2,116,"2020"
"58164","310480 AUGUSTO DE LIMA",0,0,0,39,0,39,"2020"
"58165","310490 BAEPENDI",0,0,1,199,3,203,"2020"
"58166","310500 BALDIM",0,0,0,63,1,64,"2020"
"58167","310510 BAMBUI",1,0,1,258,0,260,"2020"
"58168","310520 BANDEIRA",1,1,1,48,0,51,"2020"
"58169","310530 BANDEIRA DO SUL",0,1,0,73,1,75,"2020"
"58170","310540 BARAO DE COCAIS",0,2,5,343,1,351,"2020"
"58171","310550 BARAO DE MONTE ALTO",0,0,1,34,2,37,"2020"
"58172","310560 BARBACENA",4,2,5,1394,2,1407,"2020"
"58173","310570 BARRA LONGA",0,1,0,52,1,54,"2020"
"58174","310590 BARROSO",1,1,3,187,22,214,"2020"
"58175","310600 BELA VISTA DE MINAS",1,0,1,95,1,98,"2020"
"58176","310610 BELMIRO BRAGA",0,0,0,26,1,27,"2020"
"58177","310620 BELO HORIZONTE",86,103,424,25548,120,26281,"2020"
"58178","310630 BELO ORIENTE",0,5,4,289,1,299,"2020"
"58179","310640 BELO VALE",0,0,2,101,1,104,"2020"
"58180","310650 BERILO",0,0,0,75,0,75,"2020"
"58181","310660 BERTOPOLIS",0,1,2,67,4,74,"2020"
"58182","310665 BERIZAL",0,1,0,55,0,56,"2020"
"58183","310670 BETIM",23,29,94,5514,37,5697,"2020"
"58184","310680 BIAS FORTES",0,0,0,38,0,38,"2020"
"58185","310690 BICAS",0,2,1,139,1,143,"2020"
"58186","310700 BIQUINHAS",0,0,0,20,0,20,"2020"
"58187","310710 BOA ESPERANCA",0,1,3,509,1,514,"2020"
"58188","310720 BOCAINA DE MINAS",0,0,0,33,2,35,"2020"
"58189","310730 BOCAIUVA",0,5,8,603,4,620,"2020"
"58190","310740 BOM DESPACHO",3,2,16,678,1,700,"2020"
"58191","310750 BOM JARDIM DE MINAS",0,0,2,55,0,57,"2020"
"58192","310760 BOM JESUS DA PENHA",0,0,1,39,0,40,"2020"
"58193","310770 BOM JESUS DO AMPARO",0,1,0,66,2,69,"2020"
"58194","310780 BOM JESUS DO GALHO",0,0,0,159,3,162,"2020"
"58195","310790 BOM REPOUSO",0,0,0,137,2,139,"2020"
"58196","310800 BOM SUCESSO",0,2,2,141,1,146,"2020"
"58197","310810 BONFIM",1,0,0,38,0,39,"2020"
"58198","310820 BONFINOPOLIS DE MINAS",0,0,2,58,0,60,"2020"
"58199","310825 BONITO DE MINAS",0,0,0,44,72,116,"2020"
"58200","310830 BORDA DA MATA",1,0,0,145,1,147,"2020"
"58201","310840 BOTELHOS",0,1,4,130,1,136,"2020"
"58202","310850 BOTUMIRIM",0,0,1,60,1,62,"2020"
"58203","310855 BRASILANDIA DE MINAS",0,0,1,234,1,236,"2020"
"58204","310860 BRASILIA DE MINAS",1,1,7,491,0,500,"2020"
"58205","310870 BRAS PIRES",0,0,1,28,2,31,"2020"
"58206","310880 BRAUNAS",0,0,0,52,2,54,"2020"
"58207","310890 BRAZOPOLIS",0,1,1,150,0,152,"2020"
"58208","310900 BRUMADINHO",4,1,8,424,2,439,"2020"
"58209","310910 BUENO BRANDAO",0,1,1,86,0,88,"2020"
"58210","310920 BUENOPOLIS",0,0,6,99,1,106,"2020"
"58211","310925 BUGRE",0,0,0,27,0,27,"2020"
"58212","310930 BURITIS",1,0,2,373,0,376,"2020"
"58213","310940 BURITIZEIRO",1,0,1,310,2,314,"2020"
"58214","310945 CABECEIRA GRANDE",0,0,3,62,1,66,"2020"
"58215","310950 CABO VERDE",0,0,3,127,0,130,"2020"
"58216","310960 CACHOEIRA DA PRATA",0,0,0,27,1,28,"2020"
"58217","310970 CACHOEIRA DE MINAS",0,1,0,131,0,132,"2020"
"58218","310980 CACHOEIRA DOURADA",0,0,0,11,0,11,"2020"
"58219","310990 CAETANOPOLIS",1,0,4,117,2,124,"2020"
"58220","311000 CAETE",3,1,4,442,7,457,"2020"
"58221","311010 CAIANA",0,1,1,59,0,61,"2020"
"58222","311020 CAJURI",0,1,2,56,0,59,"2020"
"58223","311030 CALDAS",1,0,1,107,1,110,"2020"
"58224","311040 CAMACHO",0,0,0,28,0,28,"2020"
"58225","311050 CAMANDUCAIA",0,0,1,266,2,269,"2020"
"58226","311060 CAMBUI",0,0,2,349,0,351,"2020"
"58227","311070 CAMBUQUIRA",1,0,1,140,0,142,"2020"
"58228","311080 CAMPANARIO",0,0,2,27,0,29,"2020"
"58229","311090 CAMPANHA",2,0,3,169,0,174,"2020"
"58230","311100 CAMPESTRE",0,1,1,210,0,212,"2020"
"58231","311110 CAMPINA VERDE",0,1,1,158,0,160,"2020"
"58232","311115 CAMPO AZUL",0,0,0,41,0,41,"2020"
"58233","311120 CAMPO BELO",0,3,5,563,0,571,"2020"
"58234","311130 CAMPO DO MEIO",0,0,2,139,0,141,"2020"
"58235","311140 CAMPO FLORIDO",2,0,1,125,0,128,"2020"
"58236","311150 CAMPOS ALTOS",3,0,1,165,0,169,"2020"
"58237","311160 CAMPOS GERAIS",1,3,6,294,0,304,"2020"
"58238","311170 CANAA",0,1,1,58,3,63,"2020"
"58239","311180 CANAPOLIS",0,0,1,118,5,124,"2020"
"58240","311190 CANA VERDE",0,0,0,40,1,41,"2020"
"58241","311200 CANDEIAS",0,0,0,150,0,150,"2020"
"58242","311205 CANTAGALO",0,0,0,39,0,39,"2020"
"58243","311210 CAPARAO",0,0,2,79,0,81,"2020"
"58244","311220 CAPELA NOVA",0,0,0,38,0,38,"2020"
"58245","311230 CAPELINHA",0,4,10,550,7,571,"2020"
"58246","311240 CAPETINGA",0,0,3,64,0,67,"2020"
"58247","311250 CAPIM BRANCO",0,1,0,95,2,98,"2020"
"58248","311260 CAPINOPOLIS",1,0,2,155,0,158,"2020"
"58249","311265 CAPITAO ANDRADE",0,0,0,52,0,52,"2020"
"58250","311270 CAPITAO ENEAS",1,1,2,206,4,214,"2020"
"58251","311280 CAPITOLIO",0,0,2,126,0,128,"2020"
"58252","311290 CAPUTIRA",0,0,2,100,0,102,"2020"
"58253","311300 CARAI",0,0,1,234,3,238,"2020"
"58254","311310 CARANAIBA",0,0,0,23,0,23,"2020"
"58255","311320 CARANDAI",0,1,3,284,2,290,"2020"
"58256","311330 CARANGOLA",0,0,4,367,0,371,"2020"
"58257","311340 CARATINGA",6,0,10,1150,9,1175,"2020"
"58258","311350 CARBONITA",0,0,0,85,0,85,"2020"
"58259","311360 CAREACU",0,0,1,58,1,60,"2020"
"58260","311370 CARLOS CHAGAS",1,3,0,202,2,208,"2020"
"58261","311380 CARMESIA",0,1,0,30,2,33,"2020"
"58262","311390 CARMO DA CACHOEIRA",0,0,3,131,1,135,"2020"
"58263","311400 CARMO DA MATA",0,0,1,105,0,106,"2020"
"58264","311410 CARMO DE MINAS",0,0,4,148,0,152,"2020"
"58265","311420 CARMO DO CAJURU",0,3,4,276,0,283,"2020"
"58266","311430 CARMO DO PARANAIBA",0,0,1,316,1,318,"2020"
"58267","311440 CARMO DO RIO CLARO",0,1,4,188,0,193,"2020"
"58268","311450 CARMOPOLIS DE MINAS",0,0,2,204,0,206,"2020"
"58269","311455 CARNEIRINHO",0,0,0,86,0,86,"2020"
"58270","311460 CARRANCAS",0,0,0,47,0,47,"2020"
"58271","311470 CARVALHOPOLIS",1,0,0,35,1,37,"2020"
"58272","311480 CARVALHOS",0,0,0,40,0,40,"2020"
"58273","311490 CASA GRANDE",0,0,1,20,0,21,"2020"
"58274","311500 CASCALHO RICO",0,0,0,30,0,30,"2020"
"58275","311510 CASSIA",2,1,9,208,0,220,"2020"
"58276","311520 CONCEICAO DA BARRA DE MINAS",0,0,0,28,0,28,"2020"
"58277","311530 CATAGUASES",4,0,14,650,2,670,"2020"
"58278","311535 CATAS ALTAS",1,0,0,58,0,59,"2020"
"58279","311540 CATAS ALTAS DA NORUEGA",0,2,1,35,0,38,"2020"
"58280","311545 CATUJI",1,1,1,104,0,107,"2020"
"58281","311547 CATUTI",0,0,0,16,32,48,"2020"
"58282","311550 CAXAMBU",0,1,2,226,10,239,"2020"
"58283","311560 CEDRO DO ABAETE",0,0,0,10,0,10,"2020"
"58284","311570 CENTRAL DE MINAS",0,0,0,80,0,80,"2020"
"58285","311580 CENTRALINA",0,0,3,93,2,98,"2020"
"58286","311590 CHACARA",0,0,3,34,0,37,"2020"
"58287","311600 CHALE",0,0,1,92,0,93,"2020"
"58288","311610 CHAPADA DO NORTE",0,0,0,88,0,88,"2020"
"58289","311615 CHAPADA GAUCHA",0,1,2,187,5,195,"2020"
"58290","311620 CHIADOR",0,0,0,29,0,29,"2020"
"58291","311630 CIPOTANEA",0,0,1,43,0,44,"2020"
"58292","311640 CLARAVAL",0,0,0,10,0,10,"2020"
"58293","311650 CLARO DOS POCOES",0,0,1,76,0,77,"2020"
"58294","311660 CLAUDIO",0,1,6,400,3,410,"2020"
"58295","311670 COIMBRA",0,0,0,67,0,67,"2020"
"58296","311680 COLUNA",0,1,2,99,0,102,"2020"
"58297","311690 COMENDADOR GOMES",1,0,0,22,0,23,"2020"
"58298","311700 COMERCINHO",0,1,1,51,1,54,"2020"
"58299","311710 CONCEICAO DA APARECIDA",0,0,3,121,0,124,"2020"
"58300","311720 CONCEICAO DAS PEDRAS",0,0,0,26,0,26,"2020"
"58301","311730 CONCEICAO DAS ALAGOAS",4,0,4,331,0,339,"2020"
"58302","311740 CONCEICAO DE IPANEMA",0,0,0,56,0,56,"2020"
"58303","311750 CONCEICAO DO MATO DENTRO",0,5,7,281,6,299,"2020"
"58304","311760 CONCEICAO DO PARA",0,0,2,58,0,60,"2020"
"58305","311770 CONCEICAO DO RIO VERDE",0,1,1,159,0,161,"2020"
"58306","311780 CONCEICAO DOS OUROS",2,0,2,111,1,116,"2020"
"58307","311783 CONEGO MARINHO",0,1,0,29,39,69,"2020"
"58308","311787 CONFINS",0,0,1,96,0,97,"2020"
"58309","311790 CONGONHAL",0,1,3,129,0,133,"2020"
"58310","311800 CONGONHAS",0,4,6,676,2,688,"2020"
"58311","311810 CONGONHAS DO NORTE",0,0,2,46,0,48,"2020"
"58312","311820 CONQUISTA",2,0,2,77,1,82,"2020"
"58313","311830 CONSELHEIRO LAFAIETE",5,8,26,1576,3,1618,"2020"
"58314","311840 CONSELHEIRO PENA",0,1,3,234,4,242,"2020"
"58315","311850 CONSOLACAO",0,0,0,12,0,12,"2020"
"58316","311860 CONTAGEM",33,36,108,7694,33,7904,"2020"
"58317","311870 COQUEIRAL",0,0,3,99,0,102,"2020"
"58318","311880 CORACAO DE JESUS",0,2,2,219,8,231,"2020"
"58319","311890 CORDISBURGO",0,0,1,56,0,57,"2020"
"58320","311900 CORDISLANDIA",0,0,0,40,0,40,"2020"
"58321","311910 CORINTO",1,2,12,277,1,293,"2020"
"58322","311920 COROACI",1,0,0,77,2,80,"2020"
"58323","311930 COROMANDEL",0,1,5,309,0,315,"2020"
"58324","311940 CORONEL FABRICIANO",3,3,12,1199,7,1224,"2020"
"58325","311950 CORONEL MURTA",1,1,0,86,4,92,"2020"
"58326","311960 CORONEL PACHECO",0,1,1,33,1,36,"2020"
"58327","311970 CORONEL XAVIER CHAVES",0,0,0,28,0,28,"2020"
"58328","311980 CORREGO DANTA",0,0,1,17,0,18,"2020"
"58329","311990 CORREGO DO BOM JESUS",0,0,0,38,0,38,"2020"
"58330","311995 CORREGO FUNDO",0,0,0,62,0,62,"2020"
"58331","312000 CORREGO NOVO",0,0,0,27,0,27,"2020"
"58332","312010 COUTO DE MAGALHAES DE MINAS",0,0,1,52,0,53,"2020"
"58333","312015 CRISOLITA",0,0,0,71,4,75,"2020"
"58334","312020 CRISTAIS",1,0,3,128,0,132,"2020"
"58335","312030 CRISTALIA",0,0,1,63,2,66,"2020"
"58336","312040 CRISTIANO OTONI",0,0,0,60,0,60,"2020"
"58337","312050 CRISTINA",0,0,1,102,0,103,"2020"
"58338","312060 CRUCILANDIA",0,0,0,45,0,45,"2020"
"58339","312070 CRUZEIRO DA FORTALEZA",0,0,0,53,0,53,"2020"
"58340","312080 CRUZILIA",1,0,2,188,0,191,"2020"
"58341","312083 CUPARAQUE",1,0,2,51,1,55,"2020"
"58342","312087 CURRAL DE DENTRO",0,0,0,104,11,115,"2020"
"58343","312090 CURVELO",6,9,36,895,2,948,"2020"
"58344","312100 DATAS",1,0,2,78,1,82,"2020"
"58345","312110 DELFIM MOREIRA",0,0,0,79,0,79,"2020"
"58346","312120 DELFINOPOLIS",0,1,2,95,1,99,"2020"
"58347","312125 DELTA",3,0,3,120,0,126,"2020"
"58348","312130 DESCOBERTO",0,0,0,51,0,51,"2020"
"58349","312140 DESTERRO DE ENTRE RIOS",0,0,1,71,0,72,"2020"
"58350","312150 DESTERRO DO MELO",0,0,0,28,0,28,"2020"
"58351","312160 DIAMANTINA",0,4,17,649,6,676,"2020"
"58352","312170 DIOGO DE VASCONCELOS",0,0,0,45,1,46,"2020"
"58353","312180 DIONISIO",0,0,0,51,0,51,"2020"
"58354","312190 DIVINESIA",0,1,0,40,0,41,"2020"
"58355","312200 DIVINO",1,0,1,287,0,289,"2020"
"58356","312210 DIVINO DAS LARANJEIRAS",0,0,0,39,1,40,"2020"
"58357","312220 DIVINOLANDIA DE MINAS",0,1,0,106,1,108,"2020"
"58358","312230 DIVINOPOLIS",6,13,44,2555,11,2629,"2020"
"58359","312235 DIVISA ALEGRE",0,0,1,74,1,76,"2020"
"58360","312240 DIVISA NOVA",0,0,0,71,1,72,"2020"
"58361","312245 DIVISOPOLIS",0,0,2,88,1,91,"2020"
"58362","312247 DOM BOSCO",0,0,0,33,1,34,"2020"
"58363","312250 DOM CAVATI",0,0,1,60,2,63,"2020"
"58364","312260 DOM JOAQUIM",0,0,1,48,2,51,"2020"
"58365","312270 DOM SILVERIO",0,0,1,47,0,48,"2020"
"58366","312280 DOM VICOSO",0,0,0,30,0,30,"2020"
"58367","312290 DONA EUSEBIA",2,0,2,70,1,75,"2020"
"58368","312300 DORES DE CAMPOS",1,0,1,104,8,114,"2020"
"58369","312310 DORES DE GUANHAES",0,0,1,49,1,51,"2020"
"58370","312320 DORES DO INDAIA",0,0,0,112,0,112,"2020"
"58371","312330 DORES DO TURVO",0,0,1,52,1,54,"2020"
"58372","312340 DORESOPOLIS",0,0,0,17,0,17,"2020"
"58373","312350 DOURADOQUARA",0,0,0,19,0,19,"2020"
"58374","312352 DURANDE",0,0,0,120,0,120,"2020"
"58375","312360 ELOI MENDES",0,0,3,323,0,326,"2020"
"58376","312370 ENGENHEIRO CALDAS",1,1,4,129,4,139,"2020"
"58377","312380 ENGENHEIRO NAVARRO",0,0,1,74,0,75,"2020"
"58378","312385 ENTRE FOLHAS",0,0,1,68,0,69,"2020"
"58379","312390 ENTRE RIOS DE MINAS",0,2,2,156,6,166,"2020"
"58380","312400 ERVALIA",0,1,0,214,4,219,"2020"
"58381","312410 ESMERALDAS",3,6,20,1028,8,1065,"2020"
"58382","312420 ESPERA FELIZ",1,0,3,315,0,319,"2020"
"58383","312430 ESPINOSA",0,2,5,324,28,359,"2020"
"58384","312440 ESPIRITO SANTO DO DOURADO",1,0,0,105,0,106,"2020"
"58385","312450 ESTIVA",1,0,0,126,0,127,"2020"
"58386","312460 ESTRELA DALVA",0,1,1,27,0,29,"2020"
"58387","312470 ESTRELA DO INDAIA",0,0,0,24,0,24,"2020"
"58388","312480 ESTRELA DO SUL",0,1,0,76,0,77,"2020"
"58389","312490 EUGENOPOLIS",0,1,2,115,2,120,"2020"
"58390","312500 EWBANK DA CAMARA",0,0,2,61,1,64,"2020"
"58391","312510 EXTREMA",1,2,7,696,0,706,"2020"
"58392","312520 FAMA",0,0,0,21,1,22,"2020"
"58393","312530 FARIA LEMOS",0,0,0,49,0,49,"2020"
"58394","312540 FELICIO DOS SANTOS",0,0,2,56,0,58,"2020"
"58395","312550 SAO GONCALO DO RIO PRETO",0,0,2,28,0,30,"2020"
"58396","312560 FELISBURGO",0,0,0,98,0,98,"2020"
"58397","312570 FELIXLANDIA",1,0,4,117,0,122,"2020"
"58398","312580 FERNANDES TOURINHO",0,0,2,27,1,30,"2020"
"58399","312590 FERROS",1,0,1,81,0,83,"2020"
"58400","312595 FERVEDOURO",0,0,2,139,0,141,"2020"
"58401","312600 FLORESTAL",0,0,1,88,0,89,"2020"
"58402","312610 FORMIGA",1,3,18,691,1,714,"2020"
"58403","312620 FORMOSO",0,0,3,101,3,107,"2020"
"58404","312630 FORTALEZA DE MINAS",0,0,1,34,0,35,"2020"
"58405","312640 FORTUNA DE MINAS",0,0,0,32,0,32,"2020"
"58406","312650 FRANCISCO BADARO",1,0,0,49,0,50,"2020"
"58407","312660 FRANCISCO DUMONT",0,0,0,50,0,50,"2020"
"58408","312670 FRANCISCO SA",0,0,1,236,1,238,"2020"
"58409","312675 FRANCISCOPOLIS",0,0,2,47,3,52,"2020"
"58410","312680 FREI GASPAR",0,0,1,87,2,90,"2020"
"58411","312690 FREI INOCENCIO",0,0,0,107,3,110,"2020"
"58412","312695 FREI LAGONEGRO",0,0,0,46,0,46,"2020"
"58413","312700 FRONTEIRA",0,0,2,124,0,126,"2020"
"58414","312705 FRONTEIRA DOS VALES",0,0,2,46,0,48,"2020"
"58415","312707 FRUTA DE LEITE",0,0,0,6,39,45,"2020"
"58416","312710 FRUTAL",2,0,8,671,1,682,"2020"
"58417","312720 FUNILANDIA",0,0,0,55,0,55,"2020"
"58418","312730 GALILEIA",1,0,5,84,6,96,"2020"
"58419","312733 GAMELEIRAS",0,0,2,13,50,65,"2020"
"58420","312735 GLAUCILANDIA",0,0,0,20,2,22,"2020"
"58421","312737 GOIABEIRA",0,1,1,43,0,45,"2020"
"58422","312738 GOIANA",0,0,1,29,0,30,"2020"
"58423","312740 GONCALVES",0,0,0,45,0,45,"2020"
"58424","312750 GONZAGA",0,1,1,67,2,71,"2020"
"58425","312760 GOUVEIA",0,1,4,119,0,124,"2020"
"58426","312770 GOVERNADOR VALADARES",12,6,35,3439,49,3541,"2020"
"58427","312780 GRAO MOGOL",0,0,4,119,30,153,"2020"
"58428","312790 GRUPIARA",0,0,0,8,0,8,"2020"
"58429","312800 GUANHAES",5,2,11,422,0,440,"2020"
"58430","312810 GUAPE",1,0,3,140,0,144,"2020"
"58431","312820 GUARACIABA",0,0,0,71,1,72,"2020"
"58432","312825 GUARACIAMA",0,0,1,56,1,58,"2020"
"58433","312830 GUARANESIA",0,1,0,225,0,226,"2020"
"58434","312840 GUARANI",1,2,0,77,1,81,"2020"
"58435","312850 GUARARA",0,0,0,37,0,37,"2020"
"58436","312860 GUARDA-MOR",0,0,0,57,1,58,"2020"
"58437","312870 GUAXUPE",3,3,6,502,0,514,"2020"
"58438","312880 GUIDOVAL",0,0,0,95,1,96,"2020"
"58439","312890 GUIMARANIA",0,0,1,109,0,110,"2020"
"58440","312900 GUIRICEMA",0,0,1,58,0,59,"2020"
"58441","312910 GURINHATA",0,0,0,33,0,33,"2020"
"58442","312920 HELIODORA",0,0,0,67,0,67,"2020"
"58443","312930 IAPU",0,0,0,106,1,107,"2020"
"58444","312940 IBERTIOGA",1,0,1,61,1,64,"2020"
"58445","312950 IBIA",2,1,1,283,2,289,"2020"
"58446","312960 IBIAI",0,1,2,89,1,93,"2020"
"58447","312965 IBIRACATU",0,0,1,56,1,58,"2020"
"58448","312970 IBIRACI",1,1,4,134,0,140,"2020"
"58449","312980 IBIRITE",9,8,30,2328,10,2385,"2020"
"58450","312990 IBITIURA DE MINAS",0,0,0,26,1,27,"2020"
"58451","313000 IBITURUNA",0,1,0,28,0,29,"2020"
"58452","313005 ICARAI DE MINAS",0,0,4,81,0,85,"2020"
"58453","313010 IGARAPE",2,1,9,569,3,584,"2020"
"58454","313020 IGARATINGA",0,0,2,128,0,130,"2020"
"58455","313030 IGUATAMA",0,0,2,71,0,73,"2020"
"58456","313040 IJACI",0,0,0,72,0,72,"2020"
"58457","313050 ILICINEA",0,1,1,146,1,149,"2020"
"58458","313055 IMBE DE MINAS",0,0,2,85,0,87,"2020"
"58459","313060 INCONFIDENTES",0,0,0,62,1,63,"2020"
"58460","313065 INDAIABIRA",0,1,0,83,0,84,"2020"
"58461","313070 INDIANOPOLIS",0,0,1,57,0,58,"2020"
"58462","313080 INGAI",0,0,1,32,0,33,"2020"
"58463","313090 INHAPIM",2,1,1,238,1,243,"2020"
"58464","313100 INHAUMA",0,0,0,57,0,57,"2020"
"58465","313110 INIMUTABA",1,1,5,75,0,82,"2020"
"58466","313115 IPABA",0,1,3,218,3,225,"2020"
"58467","313120 IPANEMA",1,1,1,192,1,196,"2020"
"58468","313130 IPATINGA",7,8,34,2700,13,2762,"2020"
"58469","313140 IPIACU",0,0,0,42,1,43,"2020"
"58470","313150 IPUIUNA",0,1,0,80,0,81,"2020"
"58471","313160 IRAI DE MINAS",0,1,2,106,0,109,"2020"
"58472","313170 ITABIRA",12,4,11,1301,5,1333,"2020"
"58473","313180 ITABIRINHA",0,1,1,142,0,144,"2020"
"58474","313190 ITABIRITO",1,1,12,735,1,750,"2020"
"58475","313200 ITACAMBIRA",0,0,1,31,1,33,"2020"
"58476","313210 ITACARAMBI",2,1,2,160,60,225,"2020"
"58477","313220 ITAGUARA",0,1,0,149,2,152,"2020"
"58478","313230 ITAIPE",1,0,1,156,2,160,"2020"
"58479","313240 ITAJUBA",2,0,2,1052,5,1061,"2020"
"58480","313250 ITAMARANDIBA",1,1,3,437,0,442,"2020"
"58481","313260 ITAMARATI DE MINAS",0,1,0,49,0,50,"2020"
"58482","313270 ITAMBACURI",1,1,9,284,6,301,"2020"
"58483","313280 ITAMBE DO MATO DENTRO",0,0,0,29,0,29,"2020"
"58484","313290 ITAMOGI",0,2,2,100,0,104,"2020"
"58485","313300 ITAMONTE",0,0,2,161,0,163,"2020"
"58486","313310 ITANHANDU",0,0,1,167,0,168,"2020"
"58487","313320 ITANHOMI",0,0,0,142,1,143,"2020"
"58488","313330 ITAOBIM",1,2,1,228,0,232,"2020"
"58489","313340 ITAPAGIPE",1,0,1,124,0,126,"2020"
"58490","313350 ITAPECERICA",1,0,3,184,1,189,"2020"
"58491","313360 ITAPEVA",0,2,1,137,0,140,"2020"
"58492","313370 ITATIAIUCU",0,1,1,141,0,143,"2020"
"58493","313375 ITAU DE MINAS",1,2,3,137,0,143,"2020"
"58494","313380 ITAUNA",1,3,5,1028,3,1040,"2020"
"58495","313390 ITAVERAVA",0,0,0,47,0,47,"2020"
"58496","313400 ITINGA",1,0,4,144,1,150,"2020"
"58497","313410 ITUETA",0,0,2,72,0,74,"2020"
"58498","313420 ITUIUTABA",3,3,7,1037,4,1054,"2020"
"58499","313430 ITUMIRIM",0,0,0,62,0,62,"2020"
"58500","313440 ITURAMA",1,0,1,473,1,476,"2020"
"58501","313450 ITUTINGA",1,0,0,58,0,59,"2020"
"58502","313460 JABOTICATUBAS",0,0,2,209,3,214,"2020"
"58503","313470 JACINTO",0,0,12,108,0,120,"2020"
"58504","313480 JACUI",0,0,0,86,1,87,"2020"
"58505","313490 JACUTINGA",0,1,0,287,0,288,"2020"
"58506","313500 JAGUARACU",0,0,1,40,0,41,"2020"
"58507","313505 JAIBA",0,1,9,531,39,580,"2020"
"58508","313507 JAMPRUCA",1,0,1,62,3,67,"2020"
"58509","313510 JANAUBA",1,1,15,1053,1,1071,"2020"
"58510","313520 JANUARIA",0,1,1,396,462,860,"2020"
"58511","313530 JAPARAIBA",0,0,0,46,0,46,"2020"
"58512","313535 JAPONVAR",0,1,2,95,0,98,"2020"
"58513","313540 JECEABA",0,0,0,77,0,77,"2020"
"58514","313545 JENIPAPO DE MINAS",0,0,1,79,0,80,"2020"
"58515","313550 JEQUERI",1,0,1,120,4,126,"2020"
"58516","313560 JEQUITAI",0,0,2,68,1,71,"2020"
"58517","313570 JEQUITIBA",1,0,0,55,0,56,"2020"
"58518","313580 JEQUITINHONHA",2,2,2,223,2,231,"2020"
"58519","313590 JESUANIA",1,0,0,38,0,39,"2020"
"58520","313600 JOAIMA",1,0,2,173,2,178,"2020"
"58521","313610 JOANESIA",0,0,0,36,1,37,"2020"
"58522","313620 JOAO MONLEVADE",0,3,14,842,3,862,"2020"
"58523","313630 JOAO PINHEIRO",0,3,8,665,3,679,"2020"
"58524","313640 JOAQUIM FELICIO",0,0,4,30,0,34,"2020"
"58525","313650 JORDANIA",2,1,4,103,0,110,"2020"
"58526","313652 JOSE GONCALVES DE MINAS",0,0,2,46,0,48,"2020"
"58527","313655 JOSE RAYDAN",0,1,0,49,0,50,"2020"
"58528","313657 JOSENOPOLIS",0,0,0,14,28,42,"2020"
"58529","313660 NOVA UNIAO",0,2,1,69,1,73,"2020"
"58530","313665 JUATUBA",2,1,5,407,2,417,"2020"
"58531","313670 JUIZ DE FORA",13,23,74,5913,20,6043,"2020"
"58532","313680 JURAMENTO",0,0,0,38,0,38,"2020"
"58533","313690 JURUAIA",0,1,5,158,1,165,"2020"
"58534","313695 JUVENILIA",1,0,0,22,43,66,"2020"
"58535","313700 LADAINHA",0,2,3,170,2,177,"2020"
"58536","313710 LAGAMAR",1,0,0,54,1,56,"2020"
"58537","313720 LAGOA DA PRATA",0,5,29,589,1,624,"2020"
"58538","313730 LAGOA DOS PATOS",1,1,0,43,0,45,"2020"
"58539","313740 LAGOA DOURADA",0,0,1,150,0,151,"2020"
"58540","313750 LAGOA FORMOSA",1,1,1,195,0,198,"2020"
"58541","313753 LAGOA GRANDE",0,0,0,89,0,89,"2020"
"58542","313760 LAGOA SANTA",3,2,9,763,11,788,"2020"
"58543","313770 LAJINHA",0,1,4,327,2,334,"2020"
"58544","313780 LAMBARI",0,0,1,213,0,214,"2020"
"58545","313790 LAMIM",0,0,1,23,0,24,"2020"
"58546","313800 LARANJAL",0,0,0,66,1,67,"2020"
"58547","313810 LASSANCE",0,0,0,68,2,70,"2020"
"58548","313820 LAVRAS",5,3,12,1351,3,1374,"2020"
"58549","313830 LEANDRO FERREIRA",0,0,1,19,0,20,"2020"
"58550","313835 LEME DO PRADO",0,0,0,33,0,33,"2020"
"58551","313840 LEOPOLDINA",1,6,11,563,0,581,"2020"
"58552","313850 LIBERDADE",0,1,1,44,0,46,"2020"
"58553","313860 LIMA DUARTE",1,0,4,165,1,171,"2020"
"58554","313862 LIMEIRA DO OESTE",0,0,0,89,0,89,"2020"
"58555","313865 LONTRA",0,0,0,99,3,102,"2020"
"58556","313867 LUISBURGO",0,0,1,112,0,113,"2020"
"58557","313868 LUISLANDIA",0,0,1,69,0,70,"2020"
"58558","313870 LUMINARIAS",0,0,1,47,0,48,"2020"
"58559","313880 LUZ",2,2,6,153,0,163,"2020"
"58560","313890 MACHACALIS",0,0,0,80,1,81,"2020"
"58561","313900 MACHADO",4,4,4,478,1,491,"2020"
"58562","313910 MADRE DE DEUS DE MINAS",0,0,1,44,0,45,"2020"
"58563","313920 MALACACHETA",0,0,3,218,3,224,"2020"
"58564","313925 MAMONAS",0,0,0,6,48,54,"2020"
"58565","313930 MANGA",5,0,1,42,237,285,"2020"
"58566","313940 MANHUACU",0,1,6,1217,2,1226,"2020"
"58567","313950 MANHUMIRIM",1,1,5,239,15,261,"2020"
"58568","313960 MANTENA",1,0,7,326,1,335,"2020"
"58569","313970 MARAVILHAS",0,0,0,56,0,56,"2020"
"58570","313980 MAR DE ESPANHA",0,1,1,153,2,157,"2020"
"58571","313990 MARIA DA FE",0,0,0,180,0,180,"2020"
"58572","314000 MARIANA",1,5,8,833,6,853,"2020"
"58573","314010 MARILAC",0,0,1,43,1,45,"2020"
"58574","314015 MARIO CAMPOS",0,3,6,186,2,197,"2020"
"58575","314020 MARIPA DE MINAS",0,0,1,29,0,30,"2020"
"58576","314030 MARLIERIA",0,0,0,34,0,34,"2020"
"58577","314040 MARMELOPOLIS",0,0,0,35,0,35,"2020"
"58578","314050 MARTINHO CAMPOS",1,1,0,120,0,122,"2020"
"58579","314053 MARTINS SOARES",0,0,3,124,3,130,"2020"
"58580","314055 MATA VERDE",5,2,2,81,0,90,"2020"
"58581","314060 MATERLANDIA",0,0,1,39,2,42,"2020"
"58582","314070 MATEUS LEME",2,4,7,426,2,441,"2020"
"58583","314080 MATIAS BARBOSA",1,0,0,141,1,143,"2020"
"58584","314085 MATIAS CARDOSO",0,1,1,112,21,135,"2020"
"58585","314090 MATIPO",0,0,1,173,0,174,"2020"
"58586","314100 MATO VERDE",1,0,2,45,100,148,"2020"
"58587","314110 MATOZINHOS",0,2,13,415,3,433,"2020"
"58588","314120 MATUTINA",1,0,0,40,0,41,"2020"
"58589","314130 MEDEIROS",0,0,0,34,0,34,"2020"
"58590","314140 MEDINA",0,2,3,228,0,233,"2020"
"58591","314150 MENDES PIMENTEL",0,0,0,49,0,49,"2020"
"58592","314160 MERCES",0,1,0,92,0,93,"2020"
"58593","314170 MESQUITA",0,0,0,51,1,52,"2020"
"58594","314180 MINAS NOVAS",3,0,1,283,2,289,"2020"
"58595","314190 MINDURI",0,0,1,37,0,38,"2020"
"58596","314200 MIRABELA",0,1,3,156,0,160,"2020"
"58597","314210 MIRADOURO",0,2,3,87,2,94,"2020"
"58598","314220 MIRAI",1,0,2,153,0,156,"2020"
"58599","314225 MIRAVANIA",0,0,0,13,38,51,"2020"
"58600","314230 MOEDA",0,0,0,53,0,53,"2020"
"58601","314240 MOEMA",0,1,4,84,0,89,"2020"
"58602","314250 MONJOLOS",0,0,1,21,0,22,"2020"
"58603","314260 MONSENHOR PAULO",0,0,0,79,0,79,"2020"
"58604","314270 MONTALVANIA",0,0,0,55,158,213,"2020"
"58605","314280 MONTE ALEGRE DE MINAS",0,1,1,164,22,188,"2020"
"58606","314290 MONTE AZUL",0,1,0,30,230,261,"2020"
"58607","314300 MONTE BELO",0,0,0,132,0,132,"2020"
"58608","314310 MONTE CARMELO",1,0,3,530,0,534,"2020"
"58609","314315 MONTE FORMOSO",0,2,1,68,0,71,"2020"
"58610","314320 MONTE SANTO DE MINAS",0,0,0,224,0,224,"2020"
"58611","314330 MONTES CLAROS",15,15,69,5846,33,5978,"2020"
"58612","314340 MONTE SIAO",0,0,1,165,8,174,"2020"
"58613","314345 MONTEZUMA",0,0,1,78,0,79,"2020"
"58614","314350 MORADA NOVA DE MINAS",0,0,1,66,0,67,"2020"
"58615","314360 MORRO DA GARCA",0,0,2,38,0,40,"2020"
"58616","314370 MORRO DO PILAR",0,1,0,28,0,29,"2020"
"58617","314380 MUNHOZ",1,1,0,76,1,79,"2020"
"58618","314390 MURIAE",10,11,12,1183,18,1234,"2020"
"58619","314400 MUTUM",0,0,5,334,7,346,"2020"
"58620","314410 MUZAMBINHO",0,1,4,246,0,251,"2020"
"58621","314420 NACIP RAYDAN",0,0,1,26,1,28,"2020"
"58622","314430 NANUQUE",1,2,20,415,1,439,"2020"
"58623","314435 NAQUE",0,0,1,127,1,129,"2020"
"58624","314437 NATALANDIA",1,0,1,35,1,38,"2020"
"58625","314440 NATERCIA",0,0,0,30,0,30,"2020"
"58626","314450 NAZARENO",0,0,1,83,0,84,"2020"
"58627","314460 NEPOMUCENO",1,1,1,260,1,264,"2020"
"58628","314465 NINHEIRA",0,0,1,77,6,84,"2020"
"58629","314467 NOVA BELEM",0,0,0,48,0,48,"2020"
"58630","314470 NOVA ERA",0,0,3,190,1,194,"2020"
"58631","314480 NOVA LIMA",3,5,33,1332,3,1376,"2020"
"58632","314490 NOVA MODICA",0,0,2,36,1,39,"2020"
"58633","314500 NOVA PONTE",0,1,1,177,0,179,"2020"
"58634","314505 NOVA PORTEIRINHA",0,0,3,85,0,88,"2020"
"58635","314510 NOVA RESENDE",1,0,6,194,0,201,"2020"
"58636","314520 NOVA SERRANA",6,8,30,1757,3,1804,"2020"
"58637","314530 NOVO CRUZEIRO",0,1,3,333,5,342,"2020"
"58638","314535 NOVO ORIENTE DE MINAS",0,0,0,115,7,122,"2020"
"58639","314537 NOVORIZONTE",1,0,0,21,26,48,"2020"
"58640","314540 OLARIA",0,0,1,20,0,21,"2020"
"58641","314545 OLHOS-D'AGUA",0,0,2,86,0,88,"2020"
"58642","314550 OLIMPIO NORONHA",0,0,0,24,0,24,"2020"
"58643","314560 OLIVEIRA",2,1,6,441,0,450,"2020"
"58644","314570 OLIVEIRA FORTES",0,0,0,20,1,21,"2020"
"58645","314580 ONCA DE PITANGUI",0,0,1,23,0,24,"2020"
"58646","314585 ORATORIOS",0,2,1,62,1,66,"2020"
"58647","314587 ORIZANIA",0,0,1,102,0,103,"2020"
"58648","314590 OURO BRANCO",1,1,1,466,2,471,"2020"
"58649","314600 OURO FINO",1,1,6,310,14,332,"2020"
"58650","314610 OURO PRETO",4,8,27,721,7,767,"2020"
"58651","314620 OURO VERDE DE MINAS",0,0,0,98,5,103,"2020"
"58652","314625 PADRE CARVALHO",0,0,0,11,45,56,"2020"
"58653","314630 PADRE PARAISO",2,1,5,262,1,271,"2020"
"58654","314640 PAINEIRAS",0,0,0,33,0,33,"2020"
"58655","314650 PAINS",0,1,1,103,0,105,"2020"
"58656","314655 PAI PEDRO",0,0,1,68,2,71,"2020"
"58657","314660 PAIVA",0,0,0,11,0,11,"2020"
"58658","314670 PALMA",0,0,0,46,1,47,"2020"
"58659","314675 PALMOPOLIS",2,0,1,95,0,98,"2020"
"58660","314690 PAPAGAIOS",0,0,1,179,5,185,"2020"
"58661","314700 PARACATU",2,4,18,1387,6,1417,"2020"
"58662","314710 PARA DE MINAS",3,4,10,1126,3,1146,"2020"
"58663","314720 PARAGUACU",0,2,1,264,1,268,"2020"
"58664","314730 PARAISOPOLIS",1,0,0,176,0,177,"2020"
"58665","314740 PARAOPEBA",0,1,5,274,0,280,"2020"
"58666","314750 PASSABEM",1,0,0,8,0,9,"2020"
"58667","314760 PASSA QUATRO",0,1,6,147,3,157,"2020"
"58668","314770 PASSA TEMPO",0,1,2,54,2,59,"2020"
"58669","314780 PASSA-VINTE",0,0,0,20,0,20,"2020"
"58670","314790 PASSOS",3,5,22,1420,0,1450,"2020"
"58671","314795 PATIS",0,0,2,56,0,58,"2020"
"58672","314800 PATOS DE MINAS",2,4,25,1794,3,1828,"2020"
"58673","314810 PATROCINIO",1,2,7,1253,0,1263,"2020"
"58674","314820 PATROCINIO DO MURIAE",0,1,0,49,0,50,"2020"
"58675","314830 PAULA CANDIDO",0,0,1,108,1,110,"2020"
"58676","314840 PAULISTAS",0,0,0,53,0,53,"2020"
"58677","314850 PAVAO",0,0,1,75,1,77,"2020"
"58678","314860 PECANHA",0,1,2,213,0,216,"2020"
"58679","314870 PEDRA AZUL",1,4,3,292,4,304,"2020"
"58680","314875 PEDRA BONITA",0,1,0,86,0,87,"2020"
"58681","314880 PEDRA DO ANTA",0,0,0,26,0,26,"2020"
"58682","314890 PEDRA DO INDAIA",0,0,3,27,0,30,"2020"
"58683","314900 PEDRA DOURADA",0,0,0,32,0,32,"2020"
"58684","314910 PEDRALVA",0,0,1,113,1,115,"2020"
"58685","314915 PEDRAS DE MARIA DA CRUZ",0,0,0,64,65,129,"2020"
"58686","314920 PEDRINOPOLIS",0,0,0,27,0,27,"2020"
"58687","314930 PEDRO LEOPOLDO",1,2,5,669,6,683,"2020"
"58688","314940 PEDRO TEIXEIRA",0,0,0,13,0,13,"2020"
"58689","314950 PEQUERI",0,0,0,33,0,33,"2020"
"58690","314960 PEQUI",0,0,0,36,1,37,"2020"
"58691","314970 PERDIGAO",0,1,13,163,1,178,"2020"
"58692","314980 PERDIZES",4,1,3,191,0,199,"2020"
"58693","314990 PERDOES",0,0,0,210,0,210,"2020"
"58694","314995 PERIQUITO",1,2,0,97,3,103,"2020"
"58695","315000 PESCADOR",0,0,1,46,0,47,"2020"
"58696","315010 PIAU",0,0,0,31,0,31,"2020"
"58697","315015 PIEDADE DE CARATINGA",2,2,1,142,0,147,"2020"
"58698","315020 PIEDADE DE PONTE NOVA",0,0,1,50,1,52,"2020"
"58699","315030 PIEDADE DO RIO GRANDE",0,0,0,44,0,44,"2020"
"58700","315040 PIEDADE DOS GERAIS",0,0,1,35,0,36,"2020"
"58701","315050 PIMENTA",0,0,0,60,1,61,"2020"
"58702","315053 PINGO-D'AGUA",0,0,1,67,0,68,"2020"
"58703","315057 PINTOPOLIS",0,0,0,73,1,74,"2020"
"58704","315060 PIRACEMA",1,0,2,50,1,54,"2020"
"58705","315070 PIRAJUBA",0,0,2,71,0,73,"2020"
"58706","315080 PIRANGA",1,0,1,144,0,146,"2020"
"58707","315090 PIRANGUCU",0,0,1,57,0,58,"2020"
"58708","315100 PIRANGUINHO",0,0,2,126,0,128,"2020"
"58709","315110 PIRAPETINGA",0,1,1,151,0,153,"2020"
"58710","315120 PIRAPORA",2,4,6,810,3,825,"2020"
"58711","315130 PIRAUBA",1,0,2,116,0,119,"2020"
"58712","315140 PITANGUI",0,0,11,323,4,338,"2020"
"58713","315150 PIUMHI",0,2,6,433,0,441,"2020"
"58714","315160 PLANURA",0,0,1,114,0,115,"2020"
"58715","315170 POCO FUNDO",0,1,1,172,0,174,"2020"
"58716","315180 POCOS DE CALDAS",6,8,27,1855,10,1906,"2020"
"58717","315190 POCRANE",0,0,1,87,0,88,"2020"
"58718","315200 POMPEU",2,2,10,396,2,412,"2020"
"58719","315210 PONTE NOVA",0,5,5,622,2,634,"2020"
"58720","315213 PONTO CHIQUE",0,1,0,45,3,49,"2020"
"58721","315217 PONTO DOS VOLANTES",0,0,7,125,0,132,"2020"
"58722","315220 PORTEIRINHA",1,2,10,466,0,479,"2020"
"58723","315230 PORTO FIRME",0,1,2,84,1,88,"2020"
"58724","315240 POTE",0,0,6,168,2,176,"2020"
"58725","315250 POUSO ALEGRE",2,5,17,1971,3,1998,"2020"
"58726","315260 POUSO ALTO",0,0,0,74,0,74,"2020"
"58727","315270 PRADOS",0,0,1,103,3,107,"2020"
"58728","315280 PRATA",0,0,2,317,0,319,"2020"
"58729","315290 PRATAPOLIS",0,3,2,74,0,79,"2020"
"58730","315300 PRATINHA",1,1,1,30,0,33,"2020"
"58731","315310 PRESIDENTE BERNARDES",0,0,3,35,1,39,"2020"
"58732","315320 PRESIDENTE JUSCELINO",0,0,0,25,0,25,"2020"
"58733","315330 PRESIDENTE KUBITSCHEK",0,0,2,39,0,41,"2020"
"58734","315340 PRESIDENTE OLEGARIO",0,0,4,149,0,153,"2020"
"58735","315350 ALTO JEQUITIBA",0,0,1,99,2,102,"2020"
"58736","315360 PRUDENTE DE MORAIS",2,1,0,147,3,153,"2020"
"58737","315370 QUARTEL GERAL",0,0,1,26,0,27,"2020"
"58738","315380 QUELUZITO",0,0,0,13,0,13,"2020"
"58739","315390 RAPOSOS",1,3,3,205,0,212,"2020"
"58740","315400 RAUL SOARES",0,2,2,238,0,242,"2020"
"58741","315410 RECREIO",0,1,1,74,0,76,"2020"
"58742","315415 REDUTO",0,0,1,115,2,118,"2020"
"58743","315420 RESENDE COSTA",1,1,0,120,0,122,"2020"
"58744","315430 RESPLENDOR",0,1,3,215,0,219,"2020"
"58745","315440 RESSAQUINHA",0,0,0,46,0,46,"2020"
"58746","315445 RIACHINHO",0,2,2,78,5,87,"2020"
"58747","315450 RIACHO DOS MACHADOS",0,0,2,119,1,122,"2020"
"58748","315460 RIBEIRAO DAS NEVES",11,28,73,4189,31,4332,"2020"
"58749","315470 RIBEIRAO VERMELHO",0,1,0,39,0,40,"2020"
"58750","315480 RIO ACIMA",0,0,1,129,1,131,"2020"
"58751","315490 RIO CASCA",0,0,1,160,1,162,"2020"
"58752","315500 RIO DOCE",0,0,0,24,0,24,"2020"
"58753","315510 RIO DO PRADO",1,1,3,50,0,55,"2020"
"58754","315520 RIO ESPERA",0,1,0,54,1,56,"2020"
"58755","315530 RIO MANSO",0,0,1,44,1,46,"2020"
"58756","315540 RIO NOVO",0,0,0,89,0,89,"2020"
"58757","315550 RIO PARANAIBA",0,0,3,218,0,221,"2020"
"58758","315560 RIO PARDO DE MINAS",1,1,6,384,2,394,"2020"
"58759","315570 RIO PIRACICABA",1,0,2,118,2,123,"2020"
"58760","315580 RIO POMBA",1,0,3,171,3,178,"2020"
"58761","315590 RIO PRETO",0,0,1,44,2,47,"2020"
"58762","315600 RIO VERMELHO",1,0,6,130,0,137,"2020"
"58763","315610 RITAPOLIS",0,0,0,51,0,51,"2020"
"58764","315620 ROCHEDO DE MINAS",0,0,1,32,1,34,"2020"
"58765","315630 RODEIRO",0,2,1,117,0,120,"2020"
"58766","315640 ROMARIA",0,0,0,43,0,43,"2020"
"58767","315645 ROSARIO DA LIMEIRA",0,0,0,45,3,48,"2020"
"58768","315650 RUBELITA",0,0,0,14,41,55,"2020"
"58769","315660 RUBIM",1,0,0,127,1,129,"2020"
"58770","315670 SABARA",2,7,33,1568,11,1621,"2020"
"58771","315680 SABINOPOLIS",0,1,5,162,0,168,"2020"
"58772","315690 SACRAMENTO",0,0,3,298,0,301,"2020"
"58773","315700 SALINAS",1,0,1,114,395,511,"2020"
"58774","315710 SALTO DA DIVISA",0,0,2,59,0,61,"2020"
"58775","315720 SANTA BARBARA",0,2,4,393,5,404,"2020"
"58776","315725 SANTA BARBARA DO LESTE",1,0,0,122,2,125,"2020"
"58777","315727 SANTA BARBARA DO MONTE VERDE",0,0,0,39,0,39,"2020"
"58778","315730 SANTA BARBARA DO TUGURIO",0,0,0,28,0,28,"2020"
"58779","315733 SANTA CRUZ DE MINAS",0,0,0,98,1,99,"2020"
"58780","315737 SANTA CRUZ DE SALINAS",0,0,1,18,32,51,"2020"
"58781","315740 SANTA CRUZ DO ESCALVADO",0,0,0,40,1,41,"2020"
"58782","315750 SANTA EFIGENIA DE MINAS",2,0,0,51,3,56,"2020"
"58783","315760 SANTA FE DE MINAS",0,0,0,42,0,42,"2020"
"58784","315765 SANTA HELENA DE MINAS",0,1,1,77,10,89,"2020"
"58785","315770 SANTA JULIANA",4,0,1,200,0,205,"2020"
"58786","315780 SANTA LUZIA",13,8,39,2881,14,2955,"2020"
"58787","315790 SANTA MARGARIDA",0,0,1,235,1,237,"2020"
"58788","315800 SANTA MARIA DE ITABIRA",0,0,2,115,0,117,"2020"
"58789","315810 SANTA MARIA DO SALTO",0,0,1,45,0,46,"2020"
"58790","315820 SANTA MARIA DO SUACUI",0,0,3,154,0,157,"2020"
"58791","315830 SANTANA DA VARGEM",0,0,1,74,0,75,"2020"
"58792","315840 SANTANA DE CATAGUASES",0,0,3,21,1,25,"2020"
"58793","315850 SANTANA DE PIRAPAMA",1,0,1,52,0,54,"2020"
"58794","315860 SANTANA DO DESERTO",0,0,1,26,0,27,"2020"
"58795","315870 SANTANA DO GARAMBEU",0,0,0,21,1,22,"2020"
"58796","315880 SANTANA DO JACARE",0,0,0,41,0,41,"2020"
"58797","315890 SANTANA DO MANHUACU",1,2,3,143,1,150,"2020"
"58798","315895 SANTANA DO PARAISO",0,2,7,694,3,706,"2020"
"58799","315900 SANTANA DO RIACHO",0,1,1,50,1,53,"2020"
"58800","315910 SANTANA DOS MONTES",0,0,0,31,0,31,"2020"
"58801","315920 SANTA RITA DE CALDAS",0,0,0,91,1,92,"2020"
"58802","315930 SANTA RITA DE JACUTINGA",0,1,1,40,0,42,"2020"
"58803","315935 SANTA RITA DE MINAS",0,0,0,108,0,108,"2020"
"58804","315940 SANTA RITA DE IBITIPOCA",0,0,1,28,0,29,"2020"
"58805","315950 SANTA RITA DO ITUETO",0,1,5,83,0,89,"2020"
"58806","315960 SANTA RITA DO SAPUCAI",1,1,3,460,7,472,"2020"
"58807","315970 SANTA ROSA DA SERRA",0,1,0,37,0,38,"2020"
"58808","315980 SANTA VITORIA",1,0,0,216,0,217,"2020"
"58809","315990 SANTO ANTONIO DO AMPARO",0,1,0,175,2,178,"2020"
"58810","316000 SANTO ANTONIO DO AVENTUREIRO",0,0,0,28,0,28,"2020"
"58811","316010 SANTO ANTONIO DO GRAMA",0,0,0,43,1,44,"2020"
"58812","316020 SANTO ANTONIO DO ITAMBE",0,0,0,38,1,39,"2020"
"58813","316030 SANTO ANTONIO DO JACINTO",3,1,7,105,3,119,"2020"
"58814","316040 SANTO ANTONIO DO MONTE",3,9,64,281,0,357,"2020"
"58815","316045 SANTO ANTONIO DO RETIRO",1,0,1,60,18,80,"2020"
"58816","316050 SANTO ANTONIO DO RIO ABAIXO",0,0,0,15,0,15,"2020"
"58817","316060 SANTO HIPOLITO",0,0,1,24,0,25,"2020"
"58818","316070 SANTOS DUMONT",1,3,6,428,2,440,"2020"
"58819","316080 SAO BENTO ABADE",1,0,2,76,1,80,"2020"
"58820","316090 SAO BRAS DO SUACUI",0,0,0,36,0,36,"2020"
"58821","316095 SAO DOMINGOS DAS DORES",0,0,0,97,0,97,"2020"
"58822","316100 SAO DOMINGOS DO PRATA",1,0,5,158,0,164,"2020"
"58823","316105 SAO FELIX DE MINAS",0,0,0,25,1,26,"2020"
"58824","316110 SAO FRANCISCO",1,3,8,687,9,708,"2020"
"58825","316120 SAO FRANCISCO DE PAULA",0,0,2,69,0,71,"2020"
"58826","316130 SAO FRANCISCO DE SALES",0,0,1,49,0,50,"2020"
"58827","316140 SAO FRANCISCO DO GLORIA",0,0,0,45,0,45,"2020"
"58828","316150 SAO GERALDO",0,0,0,99,0,99,"2020"
"58829","316160 SAO GERALDO DA PIEDADE",0,0,0,27,2,29,"2020"
"58830","316165 SAO GERALDO DO BAIXIO",0,1,0,34,1,36,"2020"
"58831","316170 SAO GONCALO DO ABAETE",1,0,0,60,0,61,"2020"
"58832","316180 SAO GONCALO DO PARA",1,0,1,114,1,117,"2020"
"58833","316190 SAO GONCALO DO RIO ABAIXO",2,1,1,140,3,147,"2020"
"58834","316200 SAO GONCALO DO SAPUCAI",1,0,2,322,1,326,"2020"
"58835","316210 SAO GOTARDO",1,1,0,606,0,608,"2020"
"58836","316220 SAO JOAO BATISTA DO GLORIA",0,0,1,95,0,96,"2020"
"58837","316225 SAO JOAO DA LAGOA",0,0,2,65,1,68,"2020"
"58838","316230 SAO JOAO DA MATA",0,0,0,24,0,24,"2020"
"58839","316240 SAO JOAO DA PONTE",2,1,2,263,5,273,"2020"
"58840","316245 SAO JOAO DAS MISSOES",0,0,5,93,176,274,"2020"
"58841","316250 SAO JOAO DEL REI",2,0,5,971,2,980,"2020"
"58842","316255 SAO JOAO DO MANHUACU",0,0,2,160,0,162,"2020"
"58843","316257 SAO JOAO DO MANTENINHA",0,0,0,62,0,62,"2020"
"58844","316260 SAO JOAO DO ORIENTE",1,0,3,73,2,79,"2020"
"58845","316265 SAO JOAO DO PACUI",0,1,1,42,0,44,"2020"
"58846","316270 SAO JOAO DO PARAISO",1,1,0,259,7,268,"2020"
"58847","316280 SAO JOAO EVANGELISTA",0,0,2,231,0,233,"2020"
"58848","316290 SAO JOAO NEPOMUCENO",0,0,1,310,0,311,"2020"
"58849","316292 SAO JOAQUIM DE BICAS",1,1,9,418,3,432,"2020"
"58850","316294 SAO JOSE DA BARRA",0,0,3,95,0,98,"2020"
"58851","316295 SAO JOSE DA LAPA",1,1,7,326,4,339,"2020"
"58852","316300 SAO JOSE DA SAFIRA",0,0,1,45,3,49,"2020"
"58853","316310 SAO JOSE DA VARGINHA",0,0,0,41,0,41,"2020"
"58854","316320 SAO JOSE DO ALEGRE",0,0,0,42,0,42,"2020"
"58855","316330 SAO JOSE DO DIVINO",0,0,0,34,0,34,"2020"
"58856","316340 SAO JOSE DO GOIABAL",0,0,1,51,4,56,"2020"
"58857","316350 SAO JOSE DO JACURI",0,0,0,62,0,62,"2020"
"58858","316360 SAO JOSE DO MANTIMENTO",0,0,0,43,0,43,"2020"
"58859","316370 SAO LOURENCO",1,0,7,473,1,482,"2020"
"58860","316380 SAO MIGUEL DO ANTA",1,0,1,68,0,70,"2020"
"58861","316390 SAO PEDRO DA UNIAO",0,1,0,44,0,45,"2020"
"58862","316400 SAO PEDRO DOS FERROS",1,0,0,60,0,61,"2020"
"58863","316410 SAO PEDRO DO SUACUI",0,1,2,50,0,53,"2020"
"58864","316420 SAO ROMAO",0,1,1,99,1,102,"2020"
"58865","316430 SAO ROQUE DE MINAS",1,1,0,76,0,78,"2020"
"58866","316440 SAO SEBASTIAO DA BELA VISTA",0,0,0,70,0,70,"2020"
"58867","316443 SAO SEBASTIAO DA VARGEM ALEGRE",0,0,1,28,0,29,"2020"
"58868","316447 SAO SEBASTIAO DO ANTA",0,0,1,87,1,89,"2020"
"58869","316450 SAO SEBASTIAO DO MARANHAO",0,0,0,93,0,93,"2020"
"58870","316460 SAO SEBASTIAO DO OESTE",0,0,3,126,1,130,"2020"
"58871","316470 SAO SEBASTIAO DO PARAISO",1,0,8,862,4,875,"2020"
"58872","316480 SAO SEBASTIAO DO RIO PRETO",0,1,0,11,0,12,"2020"
"58873","316490 SAO SEBASTIAO DO RIO VERDE",0,0,0,16,0,16,"2020"
"58874","316500 SAO TIAGO",0,0,1,137,1,139,"2020"
"58875","316510 SAO TOMAS DE AQUINO",1,1,0,86,0,88,"2020"
"58876","316520 SAO THOME DAS LETRAS",0,0,0,57,1,58,"2020"
"58877","316530 SAO VICENTE DE MINAS",0,0,0,78,0,78,"2020"
"58878","316540 SAPUCAI-MIRIM",0,0,3,73,0,76,"2020"
"58879","316550 SARDOA",0,1,3,64,4,72,"2020"
"58880","316553 SARZEDO",2,3,10,522,2,539,"2020"
"58881","316555 SETUBINHA",0,0,0,150,6,156,"2020"
"58882","316556 SEM-PEIXE",0,0,0,19,0,19,"2020"
"58883","316557 SENADOR AMARAL",0,0,0,120,0,120,"2020"
"58884","316560 SENADOR CORTES",0,0,0,27,0,27,"2020"
"58885","316570 SENADOR FIRMINO",0,0,1,72,1,74,"2020"
"58886","316580 SENADOR JOSE BENTO",0,0,0,15,0,15,"2020"
"58887","316590 SENADOR MODESTINO GONCALVES",0,0,1,30,0,31,"2020"
"58888","316600 SENHORA DE OLIVEIRA",0,0,0,48,1,49,"2020"
"58889","316610 SENHORA DO PORTO",0,0,1,49,1,51,"2020"
"58890","316620 SENHORA DOS REMEDIOS",0,1,0,98,0,99,"2020"
"58891","316630 SERICITA",0,1,0,92,0,93,"2020"
"58892","316640 SERITINGA",0,0,0,15,0,15,"2020"
"58893","316650 SERRA AZUL DE MINAS",0,0,2,42,1,45,"2020"
"58894","316660 SERRA DA SAUDADE",0,0,0,2,0,2,"2020"
"58895","316670 SERRA DOS AIMORES",0,0,4,85,0,89,"2020"
"58896","316680 SERRA DO SALITRE",2,1,4,184,1,192,"2020"
"58897","316690 SERRANIA",0,1,3,104,0,108,"2020"
"58898","316695 SERRANOPOLIS DE MINAS",0,0,1,41,0,42,"2020"
"58899","316700 SERRANOS",0,0,1,29,0,30,"2020"
"58900","316710 SERRO",0,0,7,262,4,273,"2020"
"58901","316720 SETE LAGOAS",7,9,41,2520,10,2587,"2020"
"58902","316730 SILVEIRANIA",0,0,1,28,0,29,"2020"
"58903","316740 SILVIANOPOLIS",0,0,0,42,1,43,"2020"
"58904","316750 SIMAO PEREIRA",0,0,0,25,0,25,"2020"
"58905","316760 SIMONESIA",0,0,1,337,0,338,"2020"
"58906","316770 SOBRALIA",0,0,1,36,1,38,"2020"
"58907","316780 SOLEDADE DE MINAS",0,0,1,55,1,57,"2020"
"58908","316790 TABULEIRO",0,0,0,42,0,42,"2020"
"58909","316800 TAIOBEIRAS",2,1,4,495,2,504,"2020"
"58910","316805 TAPARUBA",0,0,0,40,0,40,"2020"
"58911","316810 TAPIRA",0,0,0,43,0,43,"2020"
"58912","316820 TAPIRAI",0,0,2,13,0,15,"2020"
"58913","316830 TAQUARACU DE MINAS",1,1,0,39,1,42,"2020"
"58914","316840 TARUMIRIM",0,0,2,150,2,154,"2020"
"58915","316850 TEIXEIRAS",0,0,3,116,0,119,"2020"
"58916","316860 TEOFILO OTONI",3,6,12,1795,14,1830,"2020"
"58917","316870 TIMOTEO",0,2,12,878,2,894,"2020"
"58918","316880 TIRADENTES",0,0,0,89,1,90,"2020"
"58919","316890 TIROS",0,0,0,86,0,86,"2020"
"58920","316900 TOCANTINS",1,0,3,189,1,194,"2020"
"58921","316905 TOCOS DO MOJI",0,0,0,32,0,32,"2020"
"58922","316910 TOLEDO",0,1,2,85,0,88,"2020"
"58923","316920 TOMBOS",0,0,0,70,0,70,"2020"
"58924","316930 TRES CORACOES",2,1,8,1005,3,1019,"2020"
"58925","316935 TRES MARIAS",1,1,7,372,0,381,"2020"
"58926","316940 TRES PONTAS",1,2,21,694,1,719,"2020"
"58927","316950 TUMIRITINGA",0,1,3,78,5,87,"2020"
"58928","316960 TUPACIGUARA",1,1,3,192,6,203,"2020"
"58929","316970 TURMALINA",0,2,3,244,1,250,"2020"
"58930","316980 TURVOLANDIA",0,0,1,78,1,80,"2020"
"58931","316990 UBA",2,2,14,1273,9,1300,"2020"
"58932","317000 UBAI",1,1,1,113,3,119,"2020"
"58933","317005 UBAPORANGA",0,0,3,141,2,146,"2020"
"58934","317010 UBERABA",105,15,52,3678,11,3861,"2020"
"58935","317020 UBERLANDIA",28,24,71,8784,89,8996,"2020"
"58936","317030 UMBURATIBA",0,0,0,33,0,33,"2020"
"58937","317040 UNAI",7,2,6,1170,4,1189,"2020"
"58938","317043 UNIAO DE MINAS",0,0,0,30,0,30,"2020"
"58939","317047 URUANA DE MINAS",0,0,0,30,1,31,"2020"
"58940","317050 URUCANIA",0,0,0,151,0,151,"2020"
"58941","317052 URUCUIA",0,1,3,87,1,92,"2020"
"58942","317057 VARGEM ALEGRE",0,0,0,72,0,72,"2020"
"58943","317060 VARGEM BONITA",0,0,0,23,0,23,"2020"
"58944","317065 VARGEM GRANDE DO RIO PARDO",1,0,0,59,1,61,"2020"
"58945","317070 VARGINHA",6,3,13,1717,6,1745,"2020"
"58946","317075 VARJAO DE MINAS",0,1,2,90,0,93,"2020"
"58947","317080 VARZEA DA PALMA",1,3,4,438,4,450,"2020"
"58948","317090 VARZELANDIA",1,2,7,233,3,246,"2020"
"58949","317100 VAZANTE",1,0,1,239,0,241,"2020"
"58950","317103 VERDELANDIA",0,0,2,125,2,129,"2020"
"58951","317107 VEREDINHA",0,0,0,54,0,54,"2020"
"58952","317110 VERISSIMO",1,1,0,29,0,31,"2020"
"58953","317115 VERMELHO NOVO",1,0,0,52,1,54,"2020"
"58954","317120 VESPASIANO",4,14,27,1709,19,1773,"2020"
"58955","317130 VICOSA",0,7,15,862,7,891,"2020"
"58956","317140 VIEIRAS",0,0,1,32,0,33,"2020"
"58957","317150 MATHIAS LOBATO",0,0,1,24,1,26,"2020"
"58958","317160 VIRGEM DA LAPA",1,0,1,106,3,111,"2020"
"58959","317170 VIRGINIA",0,0,1,97,0,98,"2020"
"58960","317180 VIRGINOPOLIS",0,0,2,134,0,136,"2020"
"58961","317190 VIRGOLANDIA",0,0,1,48,0,49,"2020"
"58962","317200 VISCONDE DO RIO BRANCO",2,3,3,518,1,527,"2020"
"58963","317210 VOLTA GRANDE",0,1,1,52,0,54,"2020"
"58964","317220 WENCESLAU BRAZ",0,0,0,19,0,19,"2020"
"58965","MUNICIPIO IGNORADO - ES",0,0,0,0,1,1,"2020"
"58966","320010 AFONSO CLAUDIO",1,1,6,387,1,396,"2020"
"58967","320013 AGUIA BRANCA",0,2,5,122,0,129,"2020"
"58968","320016 AGUA DOCE DO NORTE",0,0,1,182,0,183,"2020"
"58969","320020 ALEGRE",0,1,7,367,0,375,"2020"
"58970","320030 ALFREDO CHAVES",0,1,0,125,0,126,"2020"
"58971","320035 ALTO RIO NOVO",0,0,1,88,1,90,"2020"
"58972","320040 ANCHIETA",0,1,9,407,1,418,"2020"
"58973","320050 APIACA",0,0,2,72,0,74,"2020"
"58974","320060 ARACRUZ",1,2,11,1436,3,1453,"2020"
"58975","320070 ATILIO VIVACQUA",1,0,0,151,0,152,"2020"
"58976","320080 BAIXO GUANDU",1,1,2,385,1,390,"2020"
"58977","320090 BARRA DE SAO FRANCISCO",0,3,4,628,2,637,"2020"
"58978","320100 BOA ESPERANCA",0,3,4,204,2,213,"2020"
"58979","320110 BOM JESUS DO NORTE",0,0,1,74,0,75,"2020"
"58980","320115 BREJETUBA",0,1,7,197,3,208,"2020"
"58981","320120 CACHOEIRO DE ITAPEMIRIM",3,5,25,2488,8,2529,"2020"
"58982","320130 CARIACICA",12,8,74,5267,54,5415,"2020"
"58983","320140 CASTELO",0,0,2,444,1,447,"2020"
"58984","320150 COLATINA",2,4,18,1567,3,1594,"2020"
"58985","320160 CONCEICAO DA BARRA",0,1,1,409,6,417,"2020"
"58986","320170 CONCEICAO DO CASTELO",0,2,2,172,0,176,"2020"
"58987","320180 DIVINO DE SAO LOURENCO",0,0,0,63,1,64,"2020"
"58988","320190 DOMINGOS MARTINS",1,1,14,453,2,471,"2020"
"58989","320200 DORES DO RIO PRETO",0,0,0,78,0,78,"2020"
"58990","320210 ECOPORANGA",0,4,2,298,0,304,"2020"
"58991","320220 FUNDAO",1,0,4,253,5,263,"2020"
"58992","320225 GOVERNADOR LINDENBERG",0,0,0,133,1,134,"2020"
"58993","320230 GUACUI",1,0,7,420,0,428,"2020"
"58994","320240 GUARAPARI",3,3,14,1767,7,1794,"2020"
"58995","320245 IBATIBA",1,1,5,379,5,391,"2020"
"58996","320250 IBIRACU",0,1,1,159,0,161,"2020"
"58997","320255 IBITIRAMA",0,1,2,141,0,144,"2020"
"58998","320260 ICONHA",0,0,2,132,0,134,"2020"
"58999","320265 IRUPI",0,2,2,178,6,188,"2020"
"59000","320270 ITAGUACU",0,0,4,146,2,152,"2020"
"59001","320280 ITAPEMIRIM",2,0,5,622,0,629,"2020"
"59002","320290 ITARANA",1,0,0,112,0,113,"2020"
"59003","320300 IUNA",1,0,4,321,5,331,"2020"
"59004","320305 JAGUARE",0,4,2,506,0,512,"2020"
"59005","320310 JERONIMO MONTEIRO",0,1,2,118,1,122,"2020"
"59006","320313 JOAO NEIVA",0,1,0,185,2,188,"2020"
"59007","320316 LARANJA DA TERRA",1,0,3,100,0,104,"2020"
"59008","320320 LINHARES",2,10,36,2517,1,2566,"2020"
"59009","320330 MANTENOPOLIS",0,2,2,177,0,181,"2020"
"59010","320332 MARATAIZES",0,2,7,578,1,588,"2020"
"59011","320334 MARECHAL FLORIANO",0,0,8,193,1,202,"2020"
"59012","320335 MARILANDIA",0,1,1,151,0,153,"2020"
"59013","320340 MIMOSO DO SUL",0,1,1,281,5,288,"2020"
"59014","320350 MONTANHA",0,2,1,275,0,278,"2020"
"59015","320360 MUCURICI",2,0,0,74,0,76,"2020"
"59016","320370 MUNIZ FREIRE",1,1,2,236,0,240,"2020"
"59017","320380 MUQUI",0,0,2,139,1,142,"2020"
"59018","320390 NOVA VENECIA",1,3,11,698,0,713,"2020"
"59019","320400 PANCAS",1,2,2,219,0,224,"2020"
"59020","320405 PEDRO CANARIO",1,2,1,300,1,305,"2020"
"59021","320410 PINHEIROS",0,2,6,342,12,362,"2020"
"59022","320420 PIUMA",1,0,6,332,1,340,"2020"
"59023","320425 PONTO BELO",0,0,1,81,0,82,"2020"
"59024","320430 PRESIDENTE KENNEDY",0,0,4,208,5,217,"2020"
"59025","320435 RIO BANANAL",0,1,7,268,2,278,"2020"
"59026","320440 RIO NOVO DO SUL",0,0,3,127,0,130,"2020"
"59027","320450 SANTA LEOPOLDINA",0,2,1,121,0,124,"2020"
"59028","320455 SANTA MARIA DE JETIBA",2,1,6,629,0,638,"2020"
"59029","320460 SANTA TERESA",0,0,1,303,0,304,"2020"
"59030","320465 SAO DOMINGOS DO NORTE",0,1,2,100,0,103,"2020"
"59031","320470 SAO GABRIEL DA PALHA",0,2,8,460,0,470,"2020"
"59032","320480 SAO JOSE DO CALCADO",1,0,2,113,1,117,"2020"
"59033","320490 SAO MATEUS",4,9,21,1876,7,1917,"2020"
"59034","320495 SAO ROQUE DO CANAA",0,0,0,108,0,108,"2020"
"59035","320500 SERRA",13,24,96,7377,57,7567,"2020"
"59036","320501 SOORETAMA",1,1,4,443,1,450,"2020"
"59037","320503 VARGEM ALTA",2,1,3,239,2,247,"2020"
"59038","320506 VENDA NOVA DO IMIGRANTE",0,2,3,327,0,332,"2020"
"59039","320510 VIANA",1,1,14,1024,12,1052,"2020"
"59040","320515 VILA PAVAO",0,1,0,101,1,103,"2020"
"59041","320517 VILA VALERIO",0,2,7,217,1,227,"2020"
"59042","320520 VILA VELHA",15,25,68,6128,33,6269,"2020"
"59043","320530 VITORIA",4,13,49,4076,29,4171,"2020"
"59044","MUNICIPIO IGNORADO - RJ",0,0,0,10,4,14,"2020"
"59045","330010 ANGRA DOS REIS",9,12,35,2263,24,2343,"2020"
"59046","330015 APERIBE",0,1,0,98,0,99,"2020"
"59047","330020 ARARUAMA",1,9,38,1596,23,1667,"2020"
"59048","330022 AREAL",0,0,3,147,1,151,"2020"
"59049","330023 ARMACAO DOS BUZIOS",3,7,7,620,4,641,"2020"
"59050","330025 ARRAIAL DO CABO",2,2,9,357,59,429,"2020"
"59051","330030 BARRA DO PIRAI",1,4,16,952,0,973,"2020"
"59052","330040 BARRA MANSA",3,11,42,2026,2,2084,"2020"
"59053","330045 BELFORD ROXO",19,35,102,6076,82,6314,"2020"
"59054","330050 BOM JARDIM",0,3,4,302,1,310,"2020"
"59055","330060 BOM JESUS DO ITABAPOANA",1,1,3,465,0,470,"2020"
"59056","330070 CABO FRIO",6,10,43,2536,17,2612,"2020"
"59057","330080 CACHOEIRAS DE MACACU",2,2,25,651,14,694,"2020"
"59058","330090 CAMBUCI",0,0,3,110,0,113,"2020"
"59059","330093 CARAPEBUS",1,1,1,147,0,150,"2020"
"59060","330095 COMENDADOR LEVY GASPARIAN",0,0,2,97,0,99,"2020"
"59061","330100 CAMPOS DOS GOYTACAZES",12,25,86,6674,52,6849,"2020"
"59062","330110 CANTAGALO",0,0,5,216,0,221,"2020"
"59063","330115 CARDOSO MOREIRA",1,0,3,117,1,122,"2020"
"59064","330120 CARMO",0,2,2,208,0,212,"2020"
"59065","330130 CASIMIRO DE ABREU",2,1,4,612,2,621,"2020"
"59066","330140 CONCEICAO DE MACABU",0,2,8,245,4,259,"2020"
"59067","330150 CORDEIRO",0,3,2,239,2,246,"2020"
"59068","330160 DUAS BARRAS",0,0,1,143,0,144,"2020"
"59069","330170 DUQUE DE CAXIAS",35,58,232,11269,112,11706,"2020"
"59070","330180 ENGENHEIRO PAULO DE FRONTIN",0,1,3,125,1,130,"2020"
"59071","330185 GUAPIMIRIM",0,1,13,655,6,675,"2020"
"59072","330187 IGUABA GRANDE",0,1,9,329,1,340,"2020"
"59073","330190 ITABORAI",3,12,45,2764,20,2844,"2020"
"59074","330200 ITAGUAI",1,10,27,1629,9,1676,"2020"
"59075","330205 ITALVA",0,0,3,173,1,177,"2020"
"59076","330210 ITAOCARA",1,2,5,256,2,266,"2020"
"59077","330220 ITAPERUNA",2,2,27,1025,5,1061,"2020"
"59078","330225 ITATIAIA",0,3,8,348,2,361,"2020"
"59079","330227 JAPERI",5,8,33,1250,16,1312,"2020"
"59080","330230 LAJE DO MURIAE",0,0,2,92,0,94,"2020"
"59081","330240 MACAE",6,12,45,3479,17,3559,"2020"
"59082","330245 MACUCO",1,1,1,96,0,99,"2020"
"59083","330250 MAGE",9,27,46,3365,4,3451,"2020"
"59084","330260 MANGARATIBA",1,0,7,443,3,454,"2020"
"59085","330270 MARICA",6,3,38,1704,266,2017,"2020"
"59086","330280 MENDES",0,0,3,182,0,185,"2020"
"59087","330285 MESQUITA",5,6,24,2124,23,2182,"2020"
"59088","330290 MIGUEL PEREIRA",2,1,14,331,5,353,"2020"
"59089","330300 MIRACEMA",0,0,1,339,1,341,"2020"
"59090","330310 NATIVIDADE",0,2,2,181,0,185,"2020"
"59091","330320 NILOPOLIS",3,12,20,1526,11,1572,"2020"
"59092","330330 NITEROI",15,26,83,5566,27,5717,"2020"
"59093","330340 NOVA FRIBURGO",2,6,19,2025,15,2067,"2020"
"59094","330350 NOVA IGUACU",23,46,264,10539,130,11002,"2020"
"59095","330360 PARACAMBI",0,2,3,465,2,472,"2020"
"59096","330370 PARAIBA DO SUL",2,2,5,466,1,476,"2020"
"59097","330380 PARATY",0,4,10,636,16,666,"2020"
"59098","330385 PATY DO ALFERES",1,0,8,335,2,346,"2020"
"59099","330390 PETROPOLIS",12,17,67,3248,41,3385,"2020"
"59100","330395 PINHEIRAL",0,3,6,310,2,321,"2020"
"59101","330400 PIRAI",1,0,6,342,1,350,"2020"
"59102","330410 PORCIUNCULA",0,0,4,219,0,223,"2020"
"59103","330411 PORTO REAL",1,1,1,262,1,266,"2020"
"59104","330412 QUATIS",0,0,4,158,0,162,"2020"
"59105","330414 QUEIMADOS",7,16,49,1955,24,2051,"2020"
"59106","330415 QUISSAMA",1,1,12,287,1,302,"2020"
"59107","330420 RESENDE",3,3,22,1571,0,1599,"2020"
"59108","330430 RIO BONITO",2,1,7,715,7,732,"2020"
"59109","330440 RIO CLARO",0,2,3,186,1,192,"2020"
"59110","330450 RIO DAS FLORES",0,3,2,112,1,118,"2020"
"59111","330452 RIO DAS OSTRAS",5,6,32,1829,17,1889,"2020"
"59112","330455 RIO DE JANEIRO",153,335,1317,70639,691,73135,"2020"
"59113","330460 SANTA MARIA MADALENA",0,0,1,78,0,79,"2020"
"59114","330470 SANTO ANTONIO DE PADUA",5,1,5,515,0,526,"2020"
"59115","330475 SAO FRANCISCO DE ITABAPOANA",0,0,11,566,7,584,"2020"
"59116","330480 SAO FIDELIS",2,0,7,365,53,427,"2020"
"59117","330490 SAO GONCALO",22,36,131,9681,27,9897,"2020"
"59118","330500 SAO JOAO DA BARRA",0,3,2,560,4,569,"2020"
"59119","330510 SAO JOAO DE MERITI",18,30,97,5266,70,5481,"2020"
"59120","330513 SAO JOSE DE UBA",0,0,1,96,0,97,"2020"
"59121","330515 SAO JOSE DO VALE DO RIO PRETO",0,1,2,286,2,291,"2020"
"59122","330520 SAO PEDRO DA ALDEIA",2,6,40,1614,13,1675,"2020"
"59123","330530 SAO SEBASTIAO DO ALTO",0,1,2,109,0,112,"2020"
"59124","330540 SAPUCAIA",1,1,1,160,1,164,"2020"
"59125","330550 SAQUAREMA",1,7,23,1132,7,1170,"2020"
"59126","330555 SEROPEDICA",3,4,18,1005,14,1044,"2020"
"59127","330560 SILVA JARDIM",0,0,4,260,0,264,"2020"
"59128","330570 SUMIDOURO",0,0,1,226,1,228,"2020"
"59129","330575 TANGUA",3,0,6,404,2,415,"2020"
"59130","330580 TERESOPOLIS",3,9,37,2111,28,2188,"2020"
"59131","330590 TRAJANO DE MORAES",0,1,0,114,0,115,"2020"
"59132","330600 TRES RIOS",4,3,9,1000,2,1018,"2020"
"59133","330610 VALENCA",2,6,29,739,7,783,"2020"
"59134","330615 VARRE-SAI",0,3,2,159,0,164,"2020"
"59135","330620 VASSOURAS",2,1,7,455,2,467,"2020"
"59136","330630 VOLTA REDONDA",6,18,58,2923,13,3018,"2020"
"59137","MUNICIPIO IGNORADO - SP",0,0,0,3,0,3,"2020"
"59138","350010 ADAMANTINA",0,1,7,375,0,383,"2020"
"59139","350020 ADOLFO",0,0,0,44,0,44,"2020"
"59140","350030 AGUAI",2,0,4,375,2,383,"2020"
"59141","350040 AGUAS DA PRATA",0,0,1,65,0,66,"2020"
"59142","350050 AGUAS DE LINDOIA",2,1,3,242,1,249,"2020"
"59143","350055 AGUAS DE SANTA BARBARA",0,0,0,72,0,72,"2020"
"59144","350060 AGUAS DE SAO PEDRO",0,0,0,35,0,35,"2020"
"59145","350070 AGUDOS",4,1,7,479,0,491,"2020"
"59146","350075 ALAMBARI",0,0,1,63,0,64,"2020"
"59147","350080 ALFREDO MARCONDES",0,0,1,39,0,40,"2020"
"59148","350090 ALTAIR",0,0,1,34,0,35,"2020"
"59149","350100 ALTINOPOLIS",1,1,1,161,0,164,"2020"
"59150","350110 ALTO ALEGRE",1,0,1,35,0,37,"2020"
"59151","350115 ALUMINIO",2,1,5,192,1,201,"2020"
"59152","350120 ALVARES FLORENCE",0,0,0,32,0,32,"2020"
"59153","350130 ALVARES MACHADO",2,0,4,313,0,319,"2020"
"59154","350140 ALVARO DE CARVALHO",0,0,0,32,1,33,"2020"
"59155","350150 ALVINLANDIA",0,0,0,36,0,36,"2020"
"59156","350160 AMERICANA",2,5,25,2387,6,2425,"2020"
"59157","350170 AMERICO BRASILIENSE",1,1,7,402,3,414,"2020"
"59158","350180 AMERICO DE CAMPOS",0,0,1,58,1,60,"2020"
"59159","350190 AMPARO",0,1,9,765,0,775,"2020"
"59160","350200 ANALANDIA",1,0,0,41,0,42,"2020"
"59161","350210 ANDRADINA",0,2,3,636,0,641,"2020"
"59162","350220 ANGATUBA",2,1,7,306,0,316,"2020"
"59163","350230 ANHEMBI",0,1,0,68,0,69,"2020"
"59164","350240 ANHUMAS",0,0,1,55,0,56,"2020"
"59165","350250 APARECIDA",0,2,3,343,4,352,"2020"
"59166","350260 APARECIDA D'OESTE",0,0,1,32,1,34,"2020"
"59167","350270 APIAI",0,1,9,351,2,363,"2020"
"59168","350275 ARACARIGUAMA",2,2,9,321,0,334,"2020"
"59169","350280 ARACATUBA",3,6,12,2177,1,2199,"2020"
"59170","350290 ARACOIABA DA SERRA",3,0,1,349,0,353,"2020"
"59171","350300 ARAMINA",0,0,2,71,0,73,"2020"
"59172","350310 ARANDU",0,1,0,82,0,83,"2020"
"59173","350315 ARAPEI",0,0,2,11,0,13,"2020"
"59174","350320 ARARAQUARA",7,12,26,2531,6,2582,"2020"
"59175","350330 ARARAS",5,4,12,1474,3,1498,"2020"
"59176","350335 ARCO-IRIS",1,1,0,20,0,22,"2020"
"59177","350340 AREALVA",0,1,0,108,1,110,"2020"
"59178","350350 AREIAS",0,0,0,35,0,35,"2020"
"59179","350360 AREIOPOLIS",1,0,5,123,0,129,"2020"
"59180","350370 ARIRANHA",0,0,0,60,0,60,"2020"
"59181","350380 ARTUR NOGUEIRA",0,3,5,579,0,587,"2020"
"59182","350390 ARUJA",6,11,29,1317,0,1363,"2020"
"59183","350395 ASPASIA",0,0,0,23,0,23,"2020"
"59184","350400 ASSIS",1,3,9,1071,0,1084,"2020"
"59185","350410 ATIBAIA",1,7,24,1930,2,1964,"2020"
"59186","350420 AURIFLAMA",0,0,1,157,0,158,"2020"
"59187","350430 AVAI",0,1,0,70,0,71,"2020"
"59188","350440 AVANHANDAVA",0,0,0,125,0,125,"2020"
"59189","350450 AVARE",5,8,14,1195,3,1225,"2020"
"59190","350460 BADY BASSITT",0,2,2,323,0,327,"2020"
"59191","350470 BALBINOS",0,0,0,11,0,11,"2020"
"59192","350480 BALSAMO",1,0,1,90,1,93,"2020"
"59193","350490 BANANAL",0,0,3,88,1,92,"2020"
"59194","350500 BARAO DE ANTONINA",1,0,0,46,0,47,"2020"
"59195","350510 BARBOSA",0,0,0,64,0,64,"2020"
"59196","350520 BARIRI",0,2,5,365,1,373,"2020"
"59197","350530 BARRA BONITA",0,0,1,289,1,291,"2020"
"59198","350535 BARRA DO CHAPEU",0,0,1,84,0,85,"2020"
"59199","350540 BARRA DO TURVO",0,0,4,85,0,89,"2020"
"59200","350550 BARRETOS",4,9,22,1402,4,1441,"2020"
"59201","350560 BARRINHA",1,0,4,444,0,449,"2020"
"59202","350570 BARUERI",19,13,46,5408,2,5488,"2020"
"59203","350580 BASTOS",0,2,4,250,0,256,"2020"
"59204","350590 BATATAIS",3,2,6,707,7,725,"2020"
"59205","350600 BAURU",9,21,55,4284,15,4384,"2020"
"59206","350610 BEBEDOURO",0,5,7,902,0,914,"2020"
"59207","350620 BENTO DE ABREU",0,0,0,32,0,32,"2020"
"59208","350630 BERNARDINO DE CAMPOS",0,0,3,94,0,97,"2020"
"59209","350635 BERTIOGA",2,6,14,932,1,955,"2020"
"59210","350640 BILAC",0,0,0,64,0,64,"2020"
"59211","350650 BIRIGUI",2,3,9,1250,4,1268,"2020"
"59212","350660 BIRITIBA-MIRIM",0,2,3,336,4,345,"2020"
"59213","350670 BOA ESPERANCA DO SUL",0,0,2,180,1,183,"2020"
"59214","350680 BOCAINA",1,0,0,125,0,126,"2020"
"59215","350690 BOFETE",0,0,2,97,0,99,"2020"
"59216","350700 BOITUVA",0,1,13,748,0,762,"2020"
"59217","350710 BOM JESUS DOS PERDOES",1,1,4,330,0,336,"2020"
"59218","350715 BOM SUCESSO DE ITARARE",0,0,4,59,1,64,"2020"
"59219","350720 BORA",0,1,0,14,0,15,"2020"
"59220","350730 BORACEIA",0,0,2,53,1,56,"2020"
"59221","350740 BORBOREMA",0,0,1,134,1,136,"2020"
"59222","350745 BOREBI",0,0,1,40,0,41,"2020"
"59223","350750 BOTUCATU",5,12,34,1585,10,1646,"2020"
"59224","350760 BRAGANCA PAULISTA",1,6,15,2134,5,2161,"2020"
"59225","350770 BRAUNA",0,0,1,59,0,60,"2020"
"59226","350775 BREJO ALEGRE",0,0,1,16,0,17,"2020"
"59227","350780 BRODOWSKI",1,1,2,287,3,294,"2020"
"59228","350790 BROTAS",0,2,2,291,0,295,"2020"
"59229","350800 BURI",0,3,9,299,0,311,"2020"
"59230","350810 BURITAMA",0,1,3,170,0,174,"2020"
"59231","350820 BURITIZAL",0,0,0,50,0,50,"2020"
"59232","350830 CABRALIA PAULISTA",0,0,0,46,0,46,"2020"
"59233","350840 CABREUVA",0,5,14,708,1,728,"2020"
"59234","350850 CACAPAVA",0,4,8,1121,2,1135,"2020"
"59235","350860 CACHOEIRA PAULISTA",1,0,6,418,11,436,"2020"
"59236","350870 CACONDE",0,1,2,212,0,215,"2020"
"59237","350880 CAFELANDIA",1,0,3,220,0,224,"2020"
"59238","350890 CAIABU",1,0,0,48,0,49,"2020"
"59239","350900 CAIEIRAS",6,5,12,1259,5,1287,"2020"
"59240","350910 CAIUA",0,0,0,31,0,31,"2020"
"59241","350920 CAJAMAR",3,5,13,1298,1,1320,"2020"
"59242","350925 CAJATI",1,4,8,416,1,430,"2020"
"59243","350930 CAJOBI",0,0,3,95,1,99,"2020"
"59244","350940 CAJURU",0,1,3,314,0,318,"2020"
"59245","350945 CAMPINA DO MONTE ALEGRE",0,0,3,77,0,80,"2020"
"59246","350950 CAMPINAS",39,51,163,13324,60,13637,"2020"
"59247","350960 CAMPO LIMPO PAULISTA",4,0,21,886,2,913,"2020"
"59248","350970 CAMPOS DO JORDAO",0,1,13,661,0,675,"2020"
"59249","350980 CAMPOS NOVOS PAULISTA",2,0,0,53,2,57,"2020"
"59250","350990 CANANEIA",0,2,2,167,2,173,"2020"
"59251","350995 CANAS",2,0,0,70,1,73,"2020"
"59252","351000 CANDIDO MOTA",0,0,3,328,1,332,"2020"
"59253","351010 CANDIDO RODRIGUES",0,0,0,22,0,22,"2020"
"59254","351015 CANITAR",0,0,1,89,0,90,"2020"
"59255","351020 CAPAO BONITO",1,0,2,577,0,580,"2020"
"59256","351030 CAPELA DO ALTO",0,1,6,283,0,290,"2020"
"59257","351040 CAPIVARI",1,2,2,684,3,692,"2020"
"59258","351050 CARAGUATATUBA",3,9,20,1736,6,1774,"2020"
"59259","351060 CARAPICUIBA",14,12,67,5539,39,5671,"2020"
"59260","351070 CARDOSO",1,0,0,94,0,95,"2020"
"59261","351080 CASA BRANCA",0,0,3,272,0,275,"2020"
"59262","351090 CASSIA DOS COQUEIROS",0,0,0,14,0,14,"2020"
"59263","351100 CASTILHO",0,1,3,187,1,192,"2020"
"59264","351110 CATANDUVA",0,6,22,1254,6,1288,"2020"
"59265","351120 CATIGUA",0,0,2,72,0,74,"2020"
"59266","351130 CEDRAL",1,0,1,117,0,119,"2020"
"59267","351140 CERQUEIRA CESAR",1,0,2,230,0,233,"2020"
"59268","351150 CERQUILHO",1,1,10,455,0,467,"2020"
"59269","351160 CESARIO LANGE",1,0,5,233,1,240,"2020"
"59270","351170 CHARQUEADA",0,1,2,178,0,181,"2020"
"59271","351190 CLEMENTINA",0,1,2,82,0,85,"2020"
"59272","351200 COLINA",0,2,3,184,2,191,"2020"
"59273","351210 COLOMBIA",0,0,1,66,0,67,"2020"
"59274","351220 CONCHAL",2,4,6,386,0,398,"2020"
"59275","351230 CONCHAS",0,4,6,155,0,165,"2020"
"59276","351240 CORDEIROPOLIS",1,1,3,291,1,297,"2020"
"59277","351250 COROADOS",0,0,1,58,0,59,"2020"
"59278","351260 CORONEL MACEDO",1,0,2,48,0,51,"2020"
"59279","351270 CORUMBATAI",0,0,0,57,0,57,"2020"
"59280","351280 COSMOPOLIS",2,1,11,626,0,640,"2020"
"59281","351290 COSMORAMA",0,0,3,95,0,98,"2020"
"59282","351300 COTIA",12,8,27,3917,14,3978,"2020"
"59283","351310 CRAVINHOS",1,0,9,385,1,396,"2020"
"59284","351320 CRISTAIS PAULISTA",0,1,1,102,0,104,"2020"
"59285","351330 CRUZALIA",0,0,0,22,0,22,"2020"
"59286","351340 CRUZEIRO",2,4,15,856,0,877,"2020"
"59287","351350 CUBATAO",3,11,24,1556,6,1600,"2020"
"59288","351360 CUNHA",1,1,2,227,0,231,"2020"
"59289","351370 DESCALVADO",1,1,4,344,0,350,"2020"
"59290","351380 DIADEMA",10,18,72,4687,18,4805,"2020"
"59291","351385 DIRCE REIS",0,0,0,25,0,25,"2020"
"59292","351390 DIVINOLANDIA",0,1,1,116,0,118,"2020"
"59293","351400 DOBRADA",0,0,1,102,0,103,"2020"
"59294","351410 DOIS CORREGOS",0,1,1,282,1,285,"2020"
"59295","351420 DOLCINOPOLIS",0,0,1,29,0,30,"2020"
"59296","351430 DOURADO",0,0,2,73,0,75,"2020"
"59297","351440 DRACENA",1,3,3,463,1,471,"2020"
"59298","351450 DUARTINA",0,1,2,123,0,126,"2020"
"59299","351460 DUMONT",0,0,3,107,1,111,"2020"
"59300","351470 ECHAPORA",1,0,2,82,0,85,"2020"
"59301","351480 ELDORADO",0,2,2,186,1,191,"2020"
"59302","351490 ELIAS FAUSTO",0,0,2,205,1,208,"2020"
"59303","351492 ELISIARIO",0,0,0,22,0,22,"2020"
"59304","351495 EMBAUBA",0,0,1,27,0,28,"2020"
"59305","351500 EMBU DAS ARTES",6,9,28,3536,9,3588,"2020"
"59306","351510 EMBU-GUACU",2,4,11,822,6,845,"2020"
"59307","351512 EMILIANOPOLIS",0,0,0,32,0,32,"2020"
"59308","351515 ENGENHEIRO COELHO",2,3,2,269,1,277,"2020"
"59309","351518 ESPIRITO SANTO DO PINHAL",0,3,6,425,0,434,"2020"
"59310","351519 ESPIRITO SANTO DO TURVO",0,0,0,54,0,54,"2020"
"59311","351520 ESTRELA D'OESTE",0,0,1,88,0,89,"2020"
"59312","351530 ESTRELA DO NORTE",0,0,1,28,0,29,"2020"
"59313","351535 EUCLIDES DA CUNHA PAULISTA",0,0,1,101,0,102,"2020"
"59314","351540 FARTURA",0,0,1,188,0,189,"2020"
"59315","351550 FERNANDOPOLIS",0,5,7,677,1,690,"2020"
"59316","351560 FERNANDO PRESTES",0,0,0,55,0,55,"2020"
"59317","351565 FERNAO",0,0,0,19,0,19,"2020"
"59318","351570 FERRAZ DE VASCONCELOS",3,4,40,2543,17,2607,"2020"
"59319","351580 FLORA RICA",0,0,0,14,0,14,"2020"
"59320","351590 FLOREAL",0,0,0,23,0,23,"2020"
"59321","351600 FLORIDA PAULISTA",0,0,2,113,0,115,"2020"
"59322","351610 FLORINIA",0,0,0,31,0,31,"2020"
"59323","351620 FRANCA",7,19,55,4352,13,4446,"2020"
"59324","351630 FRANCISCO MORATO",7,9,25,2551,12,2604,"2020"
"59325","351640 FRANCO DA ROCHA",5,8,14,1921,7,1955,"2020"
"59326","351650 GABRIEL MONTEIRO",0,0,1,29,0,30,"2020"
"59327","351660 GALIA",0,0,1,61,0,62,"2020"
"59328","351670 GARCA",1,4,5,474,0,484,"2020"
"59329","351680 GASTAO VIDIGAL",0,0,0,45,0,45,"2020"
"59330","351685 GAVIAO PEIXOTO",0,0,0,68,1,69,"2020"
"59331","351690 GENERAL SALGADO",2,0,3,80,0,85,"2020"
"59332","351700 GETULINA",0,0,1,86,0,87,"2020"
"59333","351710 GLICERIO",0,0,0,45,0,45,"2020"
"59334","351720 GUAICARA",0,0,0,144,0,144,"2020"
"59335","351730 GUAIMBE",0,0,2,72,1,75,"2020"
"59336","351740 GUAIRA",0,1,6,417,0,424,"2020"
"59337","351750 GUAPIACU",0,1,2,248,0,251,"2020"
"59338","351760 GUAPIARA",0,3,3,188,0,194,"2020"
"59339","351770 GUARA",1,0,3,191,0,195,"2020"
"59340","351780 GUARACAI",1,0,2,63,0,66,"2020"
"59341","351790 GUARACI",0,0,1,110,0,111,"2020"
"59342","351800 GUARANI D'OESTE",0,0,1,14,0,15,"2020"
"59343","351810 GUARANTA",1,0,1,50,0,52,"2020"
"59344","351820 GUARARAPES",0,3,2,335,0,340,"2020"
"59345","351830 GUARAREMA",2,0,4,425,1,432,"2020"
"59346","351840 GUARATINGUETA",3,10,24,1437,5,1479,"2020"
"59347","351850 GUAREI",1,0,3,139,1,144,"2020"
"59348","351860 GUARIBA",1,4,9,471,0,485,"2020"
"59349","351870 GUARUJA",10,21,67,3855,22,3975,"2020"
"59350","351880 GUARULHOS",45,80,250,18743,57,19175,"2020"
"59351","351885 GUATAPARA",0,0,2,82,1,85,"2020"
"59352","351890 GUZOLANDIA",0,0,0,55,0,55,"2020"
"59353","351900 HERCULANDIA",0,2,2,110,0,114,"2020"
"59354","351905 HOLAMBRA",0,2,2,207,2,213,"2020"
"59355","351907 HORTOLANDIA",5,10,25,2784,8,2832,"2020"
"59356","351910 IACANGA",0,0,0,121,0,121,"2020"
"59357","351920 IACRI",0,0,0,58,0,58,"2020"
"59358","351925 IARAS",0,0,1,76,1,78,"2020"
"59359","351930 IBATE",0,4,4,473,1,482,"2020"
"59360","351940 IBIRA",0,0,1,130,0,131,"2020"
"59361","351950 IBIRAREMA",1,0,2,67,0,70,"2020"
"59362","351960 IBITINGA",1,2,5,735,0,743,"2020"
"59363","351970 IBIUNA",2,3,10,975,2,992,"2020"
"59364","351980 ICEM",0,0,0,85,0,85,"2020"
"59365","351990 IEPE",0,0,0,81,0,81,"2020"
"59366","352000 IGARACU DO TIETE",1,0,0,260,2,263,"2020"
"59367","352010 IGARAPAVA",0,3,3,278,1,285,"2020"
"59368","352020 IGARATA",0,0,4,137,1,142,"2020"
"59369","352030 IGUAPE",2,2,4,316,1,325,"2020"
"59370","352040 ILHABELA",2,2,6,478,0,488,"2020"
"59371","352042 ILHA COMPRIDA",0,1,5,139,0,145,"2020"
"59372","352044 ILHA SOLTEIRA",1,0,2,222,0,225,"2020"
"59373","352050 INDAIATUBA",5,8,50,3048,2,3113,"2020"
"59374","352060 INDIANA",1,0,0,59,0,60,"2020"
"59375","352070 INDIAPORA",0,1,1,27,0,29,"2020"
"59376","352080 INUBIA PAULISTA",0,0,0,33,1,34,"2020"
"59377","352090 IPAUSSU",1,1,0,175,1,178,"2020"
"59378","352100 IPERO",0,1,3,346,1,351,"2020"
"59379","352110 IPEUNA",1,0,3,75,0,79,"2020"
"59380","352115 IPIGUA",0,0,1,85,0,86,"2020"
"59381","352120 IPORANGA",0,0,0,34,0,34,"2020"
"59382","352130 IPUA",0,0,1,159,0,160,"2020"
"59383","352140 IRACEMAPOLIS",0,0,1,258,0,259,"2020"
"59384","352150 IRAPUA",0,1,1,89,0,91,"2020"
"59385","352160 IRAPURU",0,0,1,53,0,54,"2020"
"59386","352170 ITABERA",2,1,3,228,1,235,"2020"
"59387","352180 ITAI",2,3,4,281,2,292,"2020"
"59388","352190 ITAJOBI",1,0,2,172,3,178,"2020"
"59389","352200 ITAJU",0,0,0,40,0,40,"2020"
"59390","352210 ITANHAEM",3,17,22,1356,5,1403,"2020"
"59391","352215 ITAOCA",0,0,0,34,0,34,"2020"
"59392","352220 ITAPECERICA DA SERRA",3,12,34,2342,10,2401,"2020"
"59393","352230 ITAPETININGA",6,4,30,2042,4,2086,"2020"
"59394","352240 ITAPEVA",2,14,51,1305,2,1374,"2020"
"59395","352250 ITAPEVI",5,8,47,3707,11,3778,"2020"
"59396","352260 ITAPIRA",0,2,4,694,1,701,"2020"
"59397","352265 ITAPIRAPUA PAULISTA",1,0,1,73,0,75,"2020"
"59398","352270 ITAPOLIS",0,3,8,404,0,415,"2020"
"59399","352280 ITAPORANGA",0,1,1,172,0,174,"2020"
"59400","352290 ITAPUI",0,1,1,191,1,194,"2020"
"59401","352300 ITAPURA",0,0,0,43,0,43,"2020"
"59402","352310 ITAQUAQUECETUBA",18,30,52,5460,29,5589,"2020"
"59403","352320 ITARARE",0,3,11,553,2,569,"2020"
"59404","352330 ITARIRI",0,1,4,154,2,161,"2020"
"59405","352340 ITATIBA",5,2,14,1321,6,1348,"2020"
"59406","352350 ITATINGA",0,2,5,229,1,237,"2020"
"59407","352360 ITIRAPINA",1,2,1,154,1,159,"2020"
"59408","352370 ITIRAPUA",0,1,1,69,0,71,"2020"
"59409","352380 ITOBI",1,0,1,93,0,95,"2020"
"59410","352390 ITU",3,5,26,2199,12,2245,"2020"
"59411","352400 ITUPEVA",3,5,9,822,3,842,"2020"
"59412","352410 ITUVERAVA",1,1,7,471,1,481,"2020"
"59413","352420 JABORANDI",0,0,3,56,0,59,"2020"
"59414","352430 JABOTICABAL",2,1,11,739,0,753,"2020"
"59415","352440 JACAREI",5,12,47,2700,10,2774,"2020"
"59416","352450 JACI",0,1,0,104,0,105,"2020"
"59417","352460 JACUPIRANGA",2,0,2,234,0,238,"2020"
"59418","352470 JAGUARIUNA",0,3,8,694,2,707,"2020"
"59419","352480 JALES",2,1,5,522,0,530,"2020"
"59420","352490 JAMBEIRO",0,0,0,64,1,65,"2020"
"59421","352500 JANDIRA",5,5,18,1449,6,1483,"2020"
"59422","352510 JARDINOPOLIS",2,3,10,531,0,546,"2020"
"59423","352520 JARINU",0,1,5,407,1,414,"2020"
"59424","352530 JAU",7,3,8,1469,8,1495,"2020"
"59425","352540 JERIQUARA",0,0,1,42,0,43,"2020"
"59426","352550 JOANOPOLIS",0,0,1,150,1,152,"2020"
"59427","352560 JOAO RAMALHO",0,0,0,54,0,54,"2020"
"59428","352570 JOSE BONIFACIO",2,1,3,418,0,424,"2020"
"59429","352580 JULIO MESQUITA",0,0,0,56,1,57,"2020"
"59430","352585 JUMIRIM",0,0,0,35,0,35,"2020"
"59431","352590 JUNDIAI",7,20,68,5691,8,5794,"2020"
"59432","352600 JUNQUEIROPOLIS",0,0,0,216,0,216,"2020"
"59433","352610 JUQUIA",1,0,3,234,0,238,"2020"
"59434","352620 JUQUITIBA",0,4,12,406,4,426,"2020"
"59435","352630 LAGOINHA",0,1,0,36,0,37,"2020"
"59436","352640 LARANJAL PAULISTA",2,2,6,360,0,370,"2020"
"59437","352650 LAVINIA",0,0,0,43,0,43,"2020"
"59438","352660 LAVRINHAS",0,0,4,103,0,107,"2020"
"59439","352670 LEME",3,2,8,1196,1,1210,"2020"
"59440","352680 LENCOIS PAULISTA",1,1,22,782,1,807,"2020"
"59441","352690 LIMEIRA",9,10,29,3287,8,3343,"2020"
"59442","352700 LINDOIA",0,0,1,70,1,72,"2020"
"59443","352710 LINS",3,4,8,853,0,868,"2020"
"59444","352720 LORENA",1,6,20,987,26,1040,"2020"
"59445","352725 LOURDES",0,0,0,21,0,21,"2020"
"59446","352730 LOUVEIRA",2,5,10,764,0,781,"2020"
"59447","352740 LUCELIA",0,2,1,189,0,192,"2020"
"59448","352750 LUCIANOPOLIS",0,0,1,27,0,28,"2020"
"59449","352760 LUIS ANTONIO",0,1,1,146,2,150,"2020"
"59450","352770 LUIZIANIA",0,0,0,53,0,53,"2020"
"59451","352780 LUPERCIO",0,0,0,48,0,48,"2020"
"59452","352790 LUTECIA",0,0,0,23,0,23,"2020"
"59453","352800 MACATUBA",1,0,1,198,0,200,"2020"
"59454","352810 MACAUBAL",0,0,2,64,0,66,"2020"
"59455","352820 MACEDONIA",0,0,0,36,0,36,"2020"
"59456","352830 MAGDA",0,0,0,20,0,20,"2020"
"59457","352840 MAIRINQUE",4,2,8,637,2,653,"2020"
"59458","352850 MAIRIPORA",2,4,8,1034,5,1053,"2020"
"59459","352860 MANDURI",0,0,0,92,0,92,"2020"
"59460","352870 MARABA PAULISTA",1,0,0,37,0,38,"2020"
"59461","352880 MARACAI",0,0,1,166,1,168,"2020"
"59462","352885 MARAPOAMA",1,0,3,33,0,37,"2020"
"59463","352890 MARIAPOLIS",0,0,0,32,0,32,"2020"
"59464","352900 MARILIA",9,8,54,2850,11,2932,"2020"
"59465","352910 MARINOPOLIS",0,0,0,15,0,15,"2020"
"59466","352920 MARTINOPOLIS",0,0,3,273,1,277,"2020"
"59467","352930 MATAO",0,2,10,860,0,872,"2020"
"59468","352940 MAUA",8,15,49,4811,26,4909,"2020"
"59469","352950 MENDONCA",0,0,0,73,0,73,"2020"
"59470","352960 MERIDIANO",0,1,0,45,0,46,"2020"
"59471","352965 MESOPOLIS",0,0,0,19,0,19,"2020"
"59472","352970 MIGUELOPOLIS",1,0,2,260,1,264,"2020"
"59473","352980 MINEIROS DO TIETE",0,0,1,118,0,119,"2020"
"59474","352990 MIRACATU",0,0,9,262,0,271,"2020"
"59475","353000 MIRA ESTRELA",0,0,0,24,0,24,"2020"
"59476","353010 MIRANDOPOLIS",0,1,4,225,0,230,"2020"
"59477","353020 MIRANTE DO PARANAPANEMA",2,0,1,160,0,163,"2020"
"59478","353030 MIRASSOL",3,1,1,757,0,762,"2020"
"59479","353040 MIRASSOLANDIA",0,0,4,45,0,49,"2020"
"59480","353050 MOCOCA",4,1,5,681,0,691,"2020"
"59481","353060 MOGI DAS CRUZES",7,14,39,5910,19,5989,"2020"
"59482","353070 MOGI GUACU",2,8,24,1762,4,1800,"2020"
"59483","353080 MOGI MIRIM",1,4,8,925,6,944,"2020"
"59484","353090 MOMBUCA",0,0,0,59,0,59,"2020"
"59485","353100 MONCOES",0,0,0,16,0,16,"2020"
"59486","353110 MONGAGUA",3,12,13,720,2,750,"2020"
"59487","353120 MONTE ALEGRE DO SUL",0,0,0,58,0,58,"2020"
"59488","353130 MONTE ALTO",1,3,2,460,1,467,"2020"
"59489","353140 MONTE APRAZIVEL",0,0,2,259,0,261,"2020"
"59490","353150 MONTE AZUL PAULISTA",3,0,2,195,0,200,"2020"
"59491","353160 MONTE CASTELO",0,0,1,37,0,38,"2020"
"59492","353170 MONTEIRO LOBATO",0,0,0,41,0,41,"2020"
"59493","353180 MONTE MOR",1,4,7,841,0,853,"2020"
"59494","353190 MORRO AGUDO",2,1,6,340,0,349,"2020"
"59495","353200 MORUNGABA",0,0,1,163,0,164,"2020"
"59496","353205 MOTUCA",0,1,0,38,0,39,"2020"
"59497","353210 MURUTINGA DO SUL",0,0,0,24,0,24,"2020"
"59498","353215 NANTES",1,0,0,38,0,39,"2020"
"59499","353220 NARANDIBA",0,0,1,72,0,73,"2020"
"59500","353230 NATIVIDADE DA SERRA",0,0,2,49,2,53,"2020"
"59501","353240 NAZARE PAULISTA",0,0,0,207,1,208,"2020"
"59502","353250 NEVES PAULISTA",0,0,0,87,0,87,"2020"
"59503","353260 NHANDEARA",0,1,0,92,0,93,"2020"
"59504","353270 NIPOA",0,0,0,60,0,60,"2020"
"59505","353280 NOVA ALIANCA",0,0,1,82,0,83,"2020"
"59506","353282 NOVA CAMPINA",2,2,2,113,3,122,"2020"
"59507","353284 NOVA CANAA PAULISTA",0,0,0,14,0,14,"2020"
"59508","353286 NOVA CASTILHO",0,0,0,9,0,9,"2020"
"59509","353290 NOVA EUROPA",1,0,3,129,0,133,"2020"
"59510","353300 NOVA GRANADA",1,1,3,242,0,247,"2020"
"59511","353310 NOVA GUATAPORANGA",0,0,0,29,0,29,"2020"
"59512","353320 NOVA INDEPENDENCIA",0,1,0,46,0,47,"2020"
"59513","353325 NOVAIS",0,0,2,54,1,57,"2020"
"59514","353330 NOVA LUZITANIA",0,0,0,19,0,19,"2020"
"59515","353340 NOVA ODESSA",1,2,5,610,3,621,"2020"
"59516","353350 NOVO HORIZONTE",1,0,3,425,0,429,"2020"
"59517","353360 NUPORANGA",0,0,2,84,0,86,"2020"
"59518","353370 OCAUCU",0,0,1,57,0,58,"2020"
"59519","353380 OLEO",0,0,0,23,0,23,"2020"
"59520","353390 OLIMPIA",1,4,10,631,0,646,"2020"
"59521","353400 ONDA VERDE",0,0,0,56,0,56,"2020"
"59522","353410 ORIENTE",1,0,1,68,0,70,"2020"
"59523","353420 ORINDIUVA",0,0,1,75,0,76,"2020"
"59524","353430 ORLANDIA",1,0,3,423,0,427,"2020"
"59525","353440 OSASCO",14,18,85,8768,26,8911,"2020"
"59526","353450 OSCAR BRESSANE",0,0,0,17,0,17,"2020"
"59527","353460 OSVALDO CRUZ",2,1,3,315,0,321,"2020"
"59528","353470 OURINHOS",2,5,15,1278,8,1308,"2020"
"59529","353475 OUROESTE",3,0,1,94,0,98,"2020"
"59530","353480 OURO VERDE",0,0,0,96,0,96,"2020"
"59531","353490 PACAEMBU",0,0,2,107,0,109,"2020"
"59532","353500 PALESTINA",1,0,1,133,0,135,"2020"
"59533","353510 PALMARES PAULISTA",0,0,0,138,0,138,"2020"
"59534","353520 PALMEIRA D'OESTE",0,0,2,92,0,94,"2020"
"59535","353530 PALMITAL",1,0,1,212,0,214,"2020"
"59536","353540 PANORAMA",0,0,3,174,0,177,"2020"
"59537","353550 PARAGUACU PAULISTA",1,2,10,510,1,524,"2020"
"59538","353560 PARAIBUNA",1,1,0,192,1,195,"2020"
"59539","353570 PARAISO",1,0,2,50,0,53,"2020"
"59540","353580 PARANAPANEMA",2,0,5,255,1,263,"2020"
"59541","353590 PARANAPUA",0,0,0,51,0,51,"2020"
"59542","353600 PARAPUA",0,0,1,95,1,97,"2020"
"59543","353610 PARDINHO",0,0,5,73,0,78,"2020"
"59544","353620 PARIQUERA-ACU",1,1,2,278,0,282,"2020"
"59545","353625 PARISI",0,0,0,29,0,29,"2020"
"59546","353630 PATROCINIO PAULISTA",2,1,5,167,3,178,"2020"
"59547","353640 PAULICEIA",1,0,0,99,0,100,"2020"
"59548","353650 PAULINIA",7,8,13,1393,3,1424,"2020"
"59549","353657 PAULISTANIA",0,0,0,27,1,28,"2020"
"59550","353660 PAULO DE FARIA",0,0,2,91,0,93,"2020"
"59551","353670 PEDERNEIRAS",0,0,2,496,5,503,"2020"
"59552","353680 PEDRA BELA",0,0,0,74,1,75,"2020"
"59553","353690 PEDRANOPOLIS",0,0,1,15,0,16,"2020"
"59554","353700 PEDREGULHO",0,1,1,187,1,190,"2020"
"59555","353710 PEDREIRA",1,2,6,429,0,438,"2020"
"59556","353715 PEDRINHAS PAULISTA",0,0,0,31,0,31,"2020"
"59557","353720 PEDRO DE TOLEDO",0,1,5,98,0,104,"2020"
"59558","353730 PENAPOLIS",0,5,3,712,0,720,"2020"
"59559","353740 PEREIRA BARRETO",1,2,2,238,0,243,"2020"
"59560","353750 PEREIRAS",2,0,0,89,1,92,"2020"
"59561","353760 PERUIBE",2,9,21,910,5,947,"2020"
"59562","353770 PIACATU",0,1,0,48,0,49,"2020"
"59563","353780 PIEDADE",0,2,9,650,1,662,"2020"
"59564","353790 PILAR DO SUL",0,0,1,376,0,377,"2020"
"59565","353800 PINDAMONHANGABA",2,10,39,2283,0,2334,"2020"
"59566","353810 PINDORAMA",0,0,1,145,0,146,"2020"
"59567","353820 PINHALZINHO",0,0,0,168,1,169,"2020"
"59568","353830 PIQUEROBI",0,0,1,29,0,30,"2020"
"59569","353850 PIQUETE",0,0,4,122,2,128,"2020"
"59570","353860 PIRACAIA",1,0,4,310,1,316,"2020"
"59571","353870 PIRACICABA",14,14,49,4822,8,4907,"2020"
"59572","353880 PIRAJU",2,1,4,353,0,360,"2020"
"59573","353890 PIRAJUI",1,0,3,208,0,212,"2020"
"59574","353900 PIRANGI",0,0,2,104,1,107,"2020"
"59575","353910 PIRAPORA DO BOM JESUS",0,0,2,175,5,182,"2020"
"59576","353920 PIRAPOZINHO",1,2,3,257,0,263,"2020"
"59577","353930 PIRASSUNUNGA",0,1,11,810,0,822,"2020"
"59578","353940 PIRATININGA",0,0,3,179,1,183,"2020"
"59579","353950 PITANGUEIRAS",3,0,3,418,0,424,"2020"
"59580","353960 PLANALTO",0,0,0,59,0,59,"2020"
"59581","353970 PLATINA",0,0,0,40,0,40,"2020"
"59582","353980 POA",4,5,11,1337,10,1367,"2020"
"59583","353990 POLONI",0,0,0,68,0,68,"2020"
"59584","354000 POMPEIA",0,0,2,219,0,221,"2020"
"59585","354010 PONGAI",0,0,0,35,0,35,"2020"
"59586","354020 PONTAL",1,2,3,519,1,526,"2020"
"59587","354025 PONTALINDA",0,0,0,57,0,57,"2020"
"59588","354030 PONTES GESTAL",0,0,1,23,0,24,"2020"
"59589","354040 POPULINA",0,2,0,39,0,41,"2020"
"59590","354050 PORANGABA",0,0,2,86,0,88,"2020"
"59591","354060 PORTO FELIZ",2,2,2,675,0,681,"2020"
"59592","354070 PORTO FERREIRA",1,1,4,524,0,530,"2020"
"59593","354075 POTIM",1,3,2,251,4,261,"2020"
"59594","354080 POTIRENDABA",1,0,2,209,0,212,"2020"
"59595","354085 PRACINHA",0,0,1,14,0,15,"2020"
"59596","354090 PRADOPOLIS",0,1,4,190,0,195,"2020"
"59597","354100 PRAIA GRANDE",11,40,77,4228,15,4371,"2020"
"59598","354105 PRATANIA",1,1,1,73,0,76,"2020"
"59599","354110 PRESIDENTE ALVES",0,0,1,44,0,45,"2020"
"59600","354120 PRESIDENTE BERNARDES",0,1,0,109,0,110,"2020"
"59601","354130 PRESIDENTE EPITACIO",2,3,2,445,0,452,"2020"
"59602","354140 PRESIDENTE PRUDENTE",5,4,25,2632,1,2667,"2020"
"59603","354150 PRESIDENTE VENCESLAU",1,1,3,359,0,364,"2020"
"59604","354160 PROMISSAO",1,2,1,391,0,395,"2020"
"59605","354165 QUADRA",0,0,1,32,0,33,"2020"
"59606","354170 QUATA",0,1,2,152,0,155,"2020"
"59607","354180 QUEIROZ",0,0,0,44,0,44,"2020"
"59608","354190 QUELUZ",0,1,2,105,0,108,"2020"
"59609","354200 QUINTANA",0,0,5,83,0,88,"2020"
"59610","354210 RAFARD",0,1,0,110,2,113,"2020"
"59611","354220 RANCHARIA",3,0,2,361,0,366,"2020"
"59612","354230 REDENCAO DA SERRA",0,0,2,42,1,45,"2020"
"59613","354240 REGENTE FEIJO",1,1,1,209,0,212,"2020"
"59614","354250 REGINOPOLIS",0,0,0,55,0,55,"2020"
"59615","354260 REGISTRO",3,1,5,750,1,760,"2020"
"59616","354270 RESTINGA",0,0,3,115,0,118,"2020"
"59617","354280 RIBEIRA",0,0,0,41,0,41,"2020"
"59618","354290 RIBEIRAO BONITO",0,0,2,129,0,131,"2020"
"59619","354300 RIBEIRAO BRANCO",1,1,14,271,1,288,"2020"
"59620","354310 RIBEIRAO CORRENTE",0,1,0,60,0,61,"2020"
"59621","354320 RIBEIRAO DO SUL",1,0,1,54,1,57,"2020"
"59622","354323 RIBEIRAO DOS INDIOS",0,0,1,14,0,15,"2020"
"59623","354325 RIBEIRAO GRANDE",0,0,0,86,0,86,"2020"
"59624","354330 RIBEIRAO PIRES",1,3,11,1241,5,1261,"2020"
"59625","354340 RIBEIRAO PRETO",13,31,123,7817,25,8009,"2020"
"59626","354350 RIVERSUL",0,0,2,73,1,76,"2020"
"59627","354360 RIFAINA",0,0,1,49,0,50,"2020"
"59628","354370 RINCAO",0,1,1,108,3,113,"2020"
"59629","354380 RINOPOLIS",1,0,1,99,0,101,"2020"
"59630","354390 RIO CLARO",1,5,31,2197,6,2240,"2020"
"59631","354400 RIO DAS PEDRAS",2,1,1,338,2,344,"2020"
"59632","354410 RIO GRANDE DA SERRA",0,3,7,514,7,531,"2020"
"59633","354420 RIOLANDIA",0,0,4,122,0,126,"2020"
"59634","354425 ROSANA",0,1,4,219,0,224,"2020"
"59635","354430 ROSEIRA",1,0,1,120,1,123,"2020"
"59636","354440 RUBIACEA",0,0,0,37,0,37,"2020"
"59637","354450 RUBINEIA",0,0,0,44,0,44,"2020"
"59638","354460 SABINO",0,0,0,50,0,50,"2020"
"59639","354470 SAGRES",1,0,0,29,0,30,"2020"
"59640","354480 SALES",0,0,1,56,1,58,"2020"
"59641","354490 SALES OLIVEIRA",1,0,1,125,0,127,"2020"
"59642","354500 SALESOPOLIS",0,1,2,196,3,202,"2020"
"59643","354510 SALMOURAO",0,0,0,51,0,51,"2020"
"59644","354515 SALTINHO",1,0,0,82,1,84,"2020"
"59645","354520 SALTO",5,8,26,1596,8,1643,"2020"
"59646","354530 SALTO DE PIRAPORA",0,2,7,485,0,494,"2020"
"59647","354540 SALTO GRANDE",0,0,3,110,1,114,"2020"
"59648","354550 SANDOVALINA",0,0,0,56,0,56,"2020"
"59649","354560 SANTA ADELIA",0,0,2,144,0,146,"2020"
"59650","354570 SANTA ALBERTINA",0,0,1,66,0,67,"2020"
"59651","354580 SANTA BARBARA D'OESTE",5,8,18,2092,3,2126,"2020"
"59652","354600 SANTA BRANCA",0,0,1,144,1,146,"2020"
"59653","354610 SANTA CLARA D'OESTE",0,0,1,29,0,30,"2020"
"59654","354620 SANTA CRUZ DA CONCEICAO",0,0,0,28,0,28,"2020"
"59655","354625 SANTA CRUZ DA ESPERANCA",0,0,0,25,0,25,"2020"
"59656","354630 SANTA CRUZ DAS PALMEIRAS",0,1,4,345,0,350,"2020"
"59657","354640 SANTA CRUZ DO RIO PARDO",5,2,5,593,1,606,"2020"
"59658","354650 SANTA ERNESTINA",0,0,0,73,0,73,"2020"
"59659","354660 SANTA FE DO SUL",2,1,3,394,0,400,"2020"
"59660","354670 SANTA GERTRUDES",1,0,2,317,0,320,"2020"
"59661","354680 SANTA ISABEL",0,4,18,628,1,651,"2020"
"59662","354690 SANTA LUCIA",0,0,0,75,0,75,"2020"
"59663","354700 SANTA MARIA DA SERRA",0,1,1,67,0,69,"2020"
"59664","354710 SANTA MERCEDES",1,0,0,29,0,30,"2020"
"59665","354720 SANTANA DA PONTE PENSA",0,0,1,6,0,7,"2020"
"59666","354730 SANTANA DE PARNAIBA",4,7,26,2360,3,2400,"2020"
"59667","354740 SANTA RITA D'OESTE",0,0,1,20,0,21,"2020"
"59668","354750 SANTA RITA DO PASSA QUATRO",2,1,2,233,0,238,"2020"
"59669","354760 SANTA ROSA DE VITERBO",0,2,4,205,0,211,"2020"
"59670","354765 SANTA SALETE",0,0,1,17,0,18,"2020"
"59671","354770 SANTO ANASTACIO",1,1,4,190,0,196,"2020"
"59672","354780 SANTO ANDRE",17,19,102,8458,2,8598,"2020"
"59673","354790 SANTO ANTONIO DA ALEGRIA",0,1,1,81,0,83,"2020"
"59674","354800 SANTO ANTONIO DE POSSE",1,0,8,263,0,272,"2020"
"59675","354805 SANTO ANTONIO DO ARACANGUA",0,0,3,73,0,76,"2020"
"59676","354810 SANTO ANTONIO DO JARDIM",0,0,0,58,0,58,"2020"
"59677","354820 SANTO ANTONIO DO PINHAL",0,0,1,68,0,69,"2020"
"59678","354830 SANTO EXPEDITO",0,0,1,37,0,38,"2020"
"59679","354840 SANTOPOLIS DO AGUAPEI",0,0,0,46,0,46,"2020"
"59680","354850 SANTOS",5,21,63,3980,15,4084,"2020"
"59681","354860 SAO BENTO DO SAPUCAI",0,0,4,101,0,105,"2020"
"59682","354870 SAO BERNARDO DO CAMPO",15,28,114,8966,35,9158,"2020"
"59683","354880 SAO CAETANO DO SUL",2,5,11,1507,0,1525,"2020"
"59684","354890 SAO CARLOS",1,25,43,2926,0,2995,"2020"
"59685","354900 SAO FRANCISCO",0,0,0,24,0,24,"2020"
"59686","354910 SAO JOAO DA BOA VISTA",1,5,8,977,0,991,"2020"
"59687","354920 SAO JOAO DAS DUAS PONTES",0,0,0,25,0,25,"2020"
"59688","354925 SAO JOAO DE IRACEMA",1,0,0,19,0,20,"2020"
"59689","354930 SAO JOAO DO PAU D'ALHO",0,0,2,14,0,16,"2020"
"59690","354940 SAO JOAQUIM DA BARRA",0,3,8,531,1,543,"2020"
"59691","354950 SAO JOSE DA BELA VISTA",0,0,3,79,1,83,"2020"
"59692","354960 SAO JOSE DO BARREIRO",0,1,2,39,1,43,"2020"
"59693","354970 SAO JOSE DO RIO PARDO",4,4,9,630,0,647,"2020"
"59694","354980 SAO JOSE DO RIO PRETO",9,13,41,5469,6,5538,"2020"
"59695","354990 SAO JOSE DOS CAMPOS",24,31,83,8517,27,8682,"2020"
"59696","354995 SAO LOURENCO DA SERRA",0,2,1,191,1,195,"2020"
"59697","355000 SAO LUIS DO PARAITINGA",0,1,3,102,0,106,"2020"
"59698","355010 SAO MANUEL",6,3,11,469,3,492,"2020"
"59699","355020 SAO MIGUEL ARCANJO",1,2,13,340,1,357,"2020"
"59700","355030 SAO PAULO",350,537,1687,143995,564,147133,"2020"
"59701","355040 SAO PEDRO",0,2,2,391,0,395,"2020"
"59702","355050 SAO PEDRO DO TURVO",1,0,1,74,2,78,"2020"
"59703","355060 SAO ROQUE",0,3,16,946,1,966,"2020"
"59704","355070 SAO SEBASTIAO",4,4,19,1150,1,1178,"2020"
"59705","355080 SAO SEBASTIAO DA GRAMA",0,0,0,76,0,76,"2020"
"59706","355090 SAO SIMAO",1,1,3,123,0,128,"2020"
"59707","355100 SAO VICENTE",7,32,112,3983,26,4160,"2020"
"59708","355110 SARAPUI",0,1,1,110,0,112,"2020"
"59709","355120 SARUTAIA",0,0,0,49,0,49,"2020"
"59710","355130 SEBASTIANOPOLIS DO SUL",0,0,0,35,0,35,"2020"
"59711","355140 SERRA AZUL",1,1,5,107,1,115,"2020"
"59712","355150 SERRANA",3,2,11,554,0,570,"2020"
"59713","355160 SERRA NEGRA",1,1,6,282,2,292,"2020"
"59714","355170 SERTAOZINHO",1,3,7,1554,0,1565,"2020"
"59715","355180 SETE BARRAS",0,1,2,193,1,197,"2020"
"59716","355190 SEVERINIA",2,0,1,184,0,187,"2020"
"59717","355200 SILVEIRAS",0,0,0,62,0,62,"2020"
"59718","355210 SOCORRO",1,1,2,389,2,395,"2020"
"59719","355220 SOROCABA",16,35,145,8749,18,8963,"2020"
"59720","355230 SUD MENNUCCI",0,0,1,100,0,101,"2020"
"59721","355240 SUMARE",7,15,45,3540,13,3620,"2020"
"59722","355250 SUZANO",24,17,58,4179,1,4279,"2020"
"59723","355255 SUZANAPOLIS",0,0,0,28,1,29,"2020"
"59724","355260 TABAPUA",0,1,0,98,0,99,"2020"
"59725","355270 TABATINGA",0,1,0,184,0,185,"2020"
"59726","355280 TABOAO DA SERRA",9,10,57,3723,12,3811,"2020"
"59727","355290 TACIBA",0,0,0,65,0,65,"2020"
"59728","355300 TAGUAI",0,0,3,200,0,203,"2020"
"59729","355310 TAIACU",0,0,0,60,0,60,"2020"
"59730","355320 TAIUVA",0,0,0,60,0,60,"2020"
"59731","355330 TAMBAU",1,0,0,244,0,245,"2020"
"59732","355340 TANABI",0,2,6,287,0,295,"2020"
"59733","355350 TAPIRAI",2,0,1,101,2,106,"2020"
"59734","355360 TAPIRATIBA",0,0,4,120,0,124,"2020"
"59735","355365 TAQUARAL",0,0,1,23,0,24,"2020"
"59736","355370 TAQUARITINGA",0,3,12,543,1,559,"2020"
"59737","355380 TAQUARITUBA",2,1,10,284,0,297,"2020"
"59738","355385 TAQUARIVAI",0,0,4,89,0,93,"2020"
"59739","355390 TARABAI",0,0,2,82,0,84,"2020"
"59740","355395 TARUMA",0,1,1,181,0,183,"2020"
"59741","355400 TATUI",6,2,24,1509,0,1541,"2020"
"59742","355410 TAUBATE",9,29,87,3422,17,3564,"2020"
"59743","355420 TEJUPA",1,0,0,59,0,60,"2020"
"59744","355430 TEODORO SAMPAIO",0,1,3,295,0,299,"2020"
"59745","355440 TERRA ROXA",0,0,1,62,14,77,"2020"
"59746","355450 TIETE",0,2,2,421,0,425,"2020"
"59747","355460 TIMBURI",0,0,0,17,1,18,"2020"
"59748","355465 TORRE DE PEDRA",0,0,0,24,0,24,"2020"
"59749","355470 TORRINHA",0,0,0,103,1,104,"2020"
"59750","355475 TRABIJU",0,0,1,17,0,18,"2020"
"59751","355480 TREMEMBE",0,3,9,473,1,486,"2020"
"59752","355490 TRES FRONTEIRAS",1,0,1,82,0,84,"2020"
"59753","355495 TUIUTI",0,0,0,66,0,66,"2020"
"59754","355500 TUPA",3,2,5,629,0,639,"2020"
"59755","355510 TUPI PAULISTA",0,1,3,135,0,139,"2020"
"59756","355520 TURIUBA",0,0,0,16,0,16,"2020"
"59757","355530 TURMALINA",0,0,1,19,0,20,"2020"
"59758","355535 UBARANA",0,1,0,84,1,86,"2020"
"59759","355540 UBATUBA",2,2,22,1309,8,1343,"2020"
"59760","355550 UBIRAJARA",0,1,2,64,0,67,"2020"
"59761","355560 UCHOA",0,0,1,105,0,106,"2020"
"59762","355570 UNIAO PAULISTA",0,0,0,21,0,21,"2020"
"59763","355580 URANIA",0,0,0,83,0,83,"2020"
"59764","355590 URU",0,0,0,13,0,13,"2020"
"59765","355600 URUPES",1,0,2,121,3,127,"2020"
"59766","355610 VALENTIM GENTIL",0,1,1,172,0,174,"2020"
"59767","355620 VALINHOS",2,6,11,1239,0,1258,"2020"
"59768","355630 VALPARAISO",0,1,2,285,0,288,"2020"
"59769","355635 VARGEM",0,1,0,108,0,109,"2020"
"59770","355640 VARGEM GRANDE DO SUL",1,2,6,484,2,495,"2020"
"59771","355645 VARGEM GRANDE PAULISTA",0,1,8,661,0,670,"2020"
"59772","355650 VARZEA PAULISTA",4,6,25,1182,4,1221,"2020"
"59773","355660 VERA CRUZ",2,0,1,106,3,112,"2020"
"59774","355670 VINHEDO",3,5,7,863,0,878,"2020"
"59775","355680 VIRADOURO",0,0,1,211,0,212,"2020"
"59776","355690 VISTA ALEGRE DO ALTO",0,0,0,94,0,94,"2020"
"59777","355695 VITORIA BRASIL",0,0,0,15,0,15,"2020"
"59778","355700 VOTORANTIM",4,9,26,1567,2,1608,"2020"
"59779","355710 VOTUPORANGA",3,3,6,1064,0,1076,"2020"
"59780","355715 ZACARIAS",0,0,1,26,0,27,"2020"
"59781","355720 CHAVANTES",0,2,2,131,0,135,"2020"
"59782","355730 ESTIVA GERBI",1,0,2,125,0,128,"2020"
"59783","MUNICIPIO IGNORADO - PR",0,0,0,1,1,2,"2020"
"59784","410010 ABATIA",1,0,1,87,0,89,"2020"
"59785","410020 ADRIANOPOLIS",0,0,0,80,0,80,"2020"
"59786","410030 AGUDOS DO SUL",0,0,5,128,1,134,"2020"
"59787","410040 ALMIRANTE TAMANDARE",4,2,26,1547,13,1592,"2020"
"59788","410045 ALTAMIRA DO PARANA",1,0,0,51,0,52,"2020"
"59789","410050 ALTONIA",0,0,1,224,0,225,"2020"
"59790","410060 ALTO PARANA",0,0,3,177,0,180,"2020"
"59791","410070 ALTO PIQUIRI",0,1,2,129,0,132,"2020"
"59792","410080 ALVORADA DO SUL",0,0,1,89,0,90,"2020"
"59793","410090 AMAPORA",0,0,0,64,0,64,"2020"
"59794","410100 AMPERE",1,1,9,262,3,276,"2020"
"59795","410105 ANAHY",0,1,0,37,0,38,"2020"
"59796","410110 ANDIRA",0,1,4,220,1,226,"2020"
"59797","410115 ANGULO",0,0,0,37,0,37,"2020"
"59798","410120 ANTONINA",0,0,1,208,0,209,"2020"
"59799","410130 ANTONIO OLINTO",0,0,0,74,1,75,"2020"
"59800","410140 APUCARANA",8,7,21,1559,5,1600,"2020"
"59801","410150 ARAPONGAS",3,6,13,1476,1,1499,"2020"
"59802","410160 ARAPOTI",1,0,4,357,0,362,"2020"
"59803","410165 ARAPUA",0,0,1,42,0,43,"2020"
"59804","410170 ARARUNA",0,0,1,184,0,185,"2020"
"59805","410180 ARAUCARIA",4,2,27,2151,4,2188,"2020"
"59806","410185 ARIRANHA DO IVAI",0,0,0,18,0,18,"2020"
"59807","410190 ASSAI",0,1,1,150,2,154,"2020"
"59808","410200 ASSIS CHATEAUBRIAND",1,2,7,425,1,436,"2020"
"59809","410210 ASTORGA",1,2,4,321,1,329,"2020"
"59810","410220 ATALAIA",0,0,0,37,0,37,"2020"
"59811","410230 BALSA NOVA",0,0,3,151,1,155,"2020"
"59812","410240 BANDEIRANTES",0,1,5,381,0,387,"2020"
"59813","410250 BARBOSA FERRAZ",0,0,0,125,0,125,"2020"
"59814","410260 BARRACAO",0,0,3,111,0,114,"2020"
"59815","410270 BARRA DO JACARE",0,0,0,31,0,31,"2020"
"59816","410275 BELA VISTA DA CAROBA",0,1,0,38,1,40,"2020"
"59817","410280 BELA VISTA DO PARAISO",1,0,4,150,0,155,"2020"
"59818","410290 BITURUNA",0,0,1,268,0,269,"2020"
"59819","410300 BOA ESPERANCA",0,0,0,52,0,52,"2020"
"59820","410302 BOA ESPERANCA DO IGUACU",0,0,1,29,0,30,"2020"
"59821","410304 BOA VENTURA DE SAO ROQUE",2,0,1,83,0,86,"2020"
"59822","410305 BOA VISTA DA APARECIDA",0,0,5,118,0,123,"2020"
"59823","410310 BOCAIUVA DO SUL",0,0,1,194,1,196,"2020"
"59824","410315 BOM JESUS DO SUL",0,0,0,58,0,58,"2020"
"59825","410320 BOM SUCESSO",0,0,1,78,0,79,"2020"
"59826","410322 BOM SUCESSO DO SUL",0,0,0,34,0,34,"2020"
"59827","410330 BORRAZOPOLIS",0,0,1,78,0,79,"2020"
"59828","410335 BRAGANEY",0,0,1,51,1,53,"2020"
"59829","410337 BRASILANDIA DO SUL",0,0,2,40,0,42,"2020"
"59830","410340 CAFEARA",0,0,0,32,0,32,"2020"
"59831","410345 CAFELANDIA",0,3,6,305,3,317,"2020"
"59832","410347 CAFEZAL DO SUL",0,0,1,64,0,65,"2020"
"59833","410350 CALIFORNIA",2,0,3,113,0,118,"2020"
"59834","410360 CAMBARA",2,1,3,273,0,279,"2020"
"59835","410370 CAMBE",4,7,15,1208,6,1240,"2020"
"59836","410380 CAMBIRA",0,0,1,114,0,115,"2020"
"59837","410390 CAMPINA DA LAGOA",1,0,3,192,0,196,"2020"
"59838","410395 CAMPINA DO SIMAO",0,0,1,50,0,51,"2020"
"59839","410400 CAMPINA GRANDE DO SUL",4,1,5,672,0,682,"2020"
"59840","410405 CAMPO BONITO",0,1,0,50,0,51,"2020"
"59841","410410 CAMPO DO TENENTE",0,1,5,105,0,111,"2020"
"59842","410420 CAMPO LARGO",6,10,41,1524,8,1589,"2020"
"59843","410425 CAMPO MAGRO",2,4,10,361,0,377,"2020"
"59844","410430 CAMPO MOURAO",3,16,18,1211,5,1253,"2020"
"59845","410440 CANDIDO DE ABREU",0,2,3,187,1,193,"2020"
"59846","410442 CANDOI",0,0,2,214,0,216,"2020"
"59847","410445 CANTAGALO",2,1,2,146,0,151,"2020"
"59848","410450 CAPANEMA",0,2,2,239,1,244,"2020"
"59849","410460 CAPITAO LEONIDAS MARQUES",0,1,4,187,0,192,"2020"
"59850","410465 CARAMBEI",1,4,5,335,1,346,"2020"
"59851","410470 CARLOPOLIS",0,0,0,202,0,202,"2020"
"59852","410480 CASCAVEL",8,25,87,4808,7,4935,"2020"
"59853","410490 CASTRO",4,6,14,1101,1,1126,"2020"
"59854","410500 CATANDUVAS",0,0,0,110,0,110,"2020"
"59855","410510 CENTENARIO DO SUL",0,1,3,116,0,120,"2020"
"59856","410520 CERRO AZUL",0,0,2,230,2,234,"2020"
"59857","410530 CEU AZUL",0,2,1,106,0,109,"2020"
"59858","410540 CHOPINZINHO",0,2,7,255,1,265,"2020"
"59859","410550 CIANORTE",2,3,6,1011,0,1022,"2020"
"59860","410560 CIDADE GAUCHA",0,0,0,144,1,145,"2020"
"59861","410570 CLEVELANDIA",1,1,1,255,0,258,"2020"
"59862","410580 COLOMBO",8,10,45,3223,4,3290,"2020"
"59863","410590 COLORADO",0,0,2,286,0,288,"2020"
"59864","410600 CONGONHINHAS",0,0,0,105,0,105,"2020"
"59865","410610 CONSELHEIRO MAIRINCK",0,0,1,31,0,32,"2020"
"59866","410620 CONTENDA",1,0,4,229,0,234,"2020"
"59867","410630 CORBELIA",0,1,2,219,0,222,"2020"
"59868","410640 CORNELIO PROCOPIO",3,1,1,445,2,452,"2020"
"59869","410645 CORONEL DOMINGOS SOARES",0,0,1,81,0,82,"2020"
"59870","410650 CORONEL VIVIDA",0,1,3,316,0,320,"2020"
"59871","410655 CORUMBATAI DO SUL",0,0,0,25,0,25,"2020"
"59872","410657 CRUZEIRO DO IGUACU",0,0,1,42,0,43,"2020"
"59873","410660 CRUZEIRO DO OESTE",0,1,4,281,0,286,"2020"
"59874","410670 CRUZEIRO DO SUL",0,0,0,44,0,44,"2020"
"59875","410680 CRUZ MACHADO",0,0,2,194,0,196,"2020"
"59876","410685 CRUZMALTINA",0,0,0,52,0,52,"2020"
"59877","410690 CURITIBA",43,79,331,19203,72,19728,"2020"
"59878","410700 CURIUVA",1,1,4,170,0,176,"2020"
"59879","410710 DIAMANTE DO NORTE",0,0,0,37,0,37,"2020"
"59880","410712 DIAMANTE DO SUL",2,0,1,36,0,39,"2020"
"59881","410715 DIAMANTE D'OESTE",0,0,0,48,1,49,"2020"
"59882","410720 DOIS VIZINHOS",0,3,10,631,0,644,"2020"
"59883","410725 DOURADINA",0,0,2,124,0,126,"2020"
"59884","410730 DOUTOR CAMARGO",1,0,1,58,0,60,"2020"
"59885","410740 ENEAS MARQUES",0,1,1,41,0,43,"2020"
"59886","410750 ENGENHEIRO BELTRAO",0,0,4,134,0,138,"2020"
"59887","410752 ESPERANCA NOVA",0,0,0,17,0,17,"2020"
"59888","410753 ENTRE RIOS DO OESTE",0,0,0,43,0,43,"2020"
"59889","410754 ESPIGAO ALTO DO IGUACU",0,1,0,58,0,59,"2020"
"59890","410755 FAROL",0,0,0,25,0,25,"2020"
"59891","410760 FAXINAL",1,1,5,189,4,200,"2020"
"59892","410765 FAZENDA RIO GRANDE",3,6,28,1971,9,2017,"2020"
"59893","410770 FENIX",0,1,3,50,0,54,"2020"
"59894","410773 FERNANDES PINHEIRO",0,0,1,90,0,91,"2020"
"59895","410775 FIGUEIRA",0,0,0,93,0,93,"2020"
"59896","410780 FLORAI",0,0,0,73,0,73,"2020"
"59897","410785 FLOR DA SERRA DO SUL",0,0,0,75,0,75,"2020"
"59898","410790 FLORESTA",0,0,1,125,0,126,"2020"
"59899","410800 FLORESTOPOLIS",0,1,1,146,0,148,"2020"
"59900","410810 FLORIDA",0,0,1,26,0,27,"2020"
"59901","410820 FORMOSA DO OESTE",0,0,4,72,0,76,"2020"
"59902","410830 FOZ DO IGUACU",5,5,54,4081,14,4159,"2020"
"59903","410832 FRANCISCO ALVES",1,2,2,112,0,117,"2020"
"59904","410840 FRANCISCO BELTRAO",2,4,25,1244,1,1276,"2020"
"59905","410845 FOZ DO JORDAO",0,0,0,89,0,89,"2020"
"59906","410850 GENERAL CARNEIRO",0,1,0,197,0,198,"2020"
"59907","410855 GODOY MOREIRA",0,0,0,24,0,24,"2020"
"59908","410860 GOIOERE",2,0,3,325,4,334,"2020"
"59909","410865 GOIOXIM",0,2,1,105,0,108,"2020"
"59910","410870 GRANDES RIOS",0,0,0,84,0,84,"2020"
"59911","410880 GUAIRA",0,2,10,430,7,449,"2020"
"59912","410890 GUAIRACA",0,1,1,76,0,78,"2020"
"59913","410895 GUAMIRANGA",0,1,0,70,0,71,"2020"
"59914","410900 GUAPIRAMA",0,0,1,49,0,50,"2020"
"59915","410910 GUAPOREMA",0,0,0,18,0,18,"2020"
"59916","410920 GUARACI",0,0,0,53,1,54,"2020"
"59917","410930 GUARANIACU",0,0,4,187,0,191,"2020"
"59918","410940 GUARAPUAVA",4,8,36,2883,1,2932,"2020"
"59919","410950 GUARAQUECABA",1,0,3,103,3,110,"2020"
"59920","410960 GUARATUBA",1,4,15,514,3,537,"2020"
"59921","410965 HONORIO SERPA",0,1,0,72,0,73,"2020"
"59922","410970 IBAITI",1,1,5,353,0,360,"2020"
"59923","410975 IBEMA",0,0,0,93,0,93,"2020"
"59924","410980 IBIPORA",4,1,11,608,0,624,"2020"
"59925","410990 ICARAIMA",0,1,1,105,0,107,"2020"
"59926","411000 IGUARACU",0,0,1,63,0,64,"2020"
"59927","411005 IGUATU",0,1,0,20,0,21,"2020"
"59928","411007 IMBAU",0,0,2,160,1,163,"2020"
"59929","411010 IMBITUVA",0,2,8,433,0,443,"2020"
"59930","411020 INACIO MARTINS",1,2,2,164,0,169,"2020"
"59931","411030 INAJA",0,0,0,33,0,33,"2020"
"59932","411040 INDIANOPOLIS",0,0,2,50,0,52,"2020"
"59933","411050 IPIRANGA",0,3,5,199,2,209,"2020"
"59934","411060 IPORA",0,0,2,209,0,211,"2020"
"59935","411065 IRACEMA DO OESTE",0,0,2,30,0,32,"2020"
"59936","411070 IRATI",2,1,12,731,0,746,"2020"
"59937","411080 IRETAMA",1,0,2,126,0,129,"2020"
"59938","411090 ITAGUAJE",0,1,0,57,0,58,"2020"
"59939","411095 ITAIPULANDIA",1,1,2,134,0,138,"2020"
"59940","411100 ITAMBARACA",0,0,0,58,0,58,"2020"
"59941","411110 ITAMBE",0,0,2,69,0,71,"2020"
"59942","411120 ITAPEJARA D'OESTE",0,1,0,158,0,159,"2020"
"59943","411125 ITAPERUCU",0,0,3,525,1,529,"2020"
"59944","411130 ITAUNA DO SUL",0,0,1,44,0,45,"2020"
"59945","411140 IVAI",3,4,1,188,1,197,"2020"
"59946","411150 IVAIPORA",0,1,8,337,1,347,"2020"
"59947","411155 IVATE",1,1,0,86,0,88,"2020"
"59948","411160 IVATUBA",0,0,1,33,0,34,"2020"
"59949","411170 JABOTI",0,0,0,73,0,73,"2020"
"59950","411180 JACAREZINHO",14,2,5,549,0,570,"2020"
"59951","411190 JAGUAPITA",0,1,2,167,0,170,"2020"
"59952","411200 JAGUARIAIVA",0,1,8,521,0,530,"2020"
"59953","411210 JANDAIA DO SUL",0,0,7,228,0,235,"2020"
"59954","411220 JANIOPOLIS",0,0,0,56,0,56,"2020"
"59955","411230 JAPIRA",1,1,0,53,0,55,"2020"
"59956","411240 JAPURA",0,0,0,92,0,92,"2020"
"59957","411250 JARDIM ALEGRE",0,1,0,131,3,135,"2020"
"59958","411260 JARDIM OLINDA",0,0,0,14,0,14,"2020"
"59959","411270 JATAIZINHO",2,1,1,152,3,159,"2020"
"59960","411275 JESUITAS",0,0,3,101,0,104,"2020"
"59961","411280 JOAQUIM TAVORA",0,1,3,168,0,172,"2020"
"59962","411290 JUNDIAI DO SUL",0,0,0,43,0,43,"2020"
"59963","411295 JURANDA",0,0,0,99,0,99,"2020"
"59964","411300 JUSSARA",0,0,0,69,0,69,"2020"
"59965","411310 KALORE",0,0,1,49,0,50,"2020"
"59966","411320 LAPA",0,2,14,523,0,539,"2020"
"59967","411325 LARANJAL",0,0,4,88,0,92,"2020"
"59968","411330 LARANJEIRAS DO SUL",3,2,8,478,0,491,"2020"
"59969","411340 LEOPOLIS",0,1,2,40,0,43,"2020"
"59970","411342 LIDIANOPOLIS",0,0,1,31,0,32,"2020"
"59971","411345 LINDOESTE",0,0,2,62,0,64,"2020"
"59972","411350 LOANDA",0,0,0,323,0,323,"2020"
"59973","411360 LOBATO",1,1,2,44,0,48,"2020"
"59974","411370 LONDRINA",18,24,73,6286,19,6420,"2020"
"59975","411373 LUIZIANA",0,1,0,90,1,92,"2020"
"59976","411375 LUNARDELLI",0,0,1,46,2,49,"2020"
"59977","411380 LUPIONOPOLIS",0,0,2,43,0,45,"2020"
"59978","411390 MALLET",1,0,1,133,0,135,"2020"
"59979","411400 MAMBORE",0,0,0,151,0,151,"2020"
"59980","411410 MANDAGUACU",2,1,4,416,0,423,"2020"
"59981","411420 MANDAGUARI",0,0,6,484,1,491,"2020"
"59982","411430 MANDIRITUBA",2,1,3,333,0,339,"2020"
"59983","411435 MANFRINOPOLIS",0,0,0,35,0,35,"2020"
"59984","411440 MANGUEIRINHA",0,1,4,234,1,240,"2020"
"59985","411450 MANOEL RIBAS",0,0,3,212,0,215,"2020"
"59986","411460 MARECHAL CANDIDO RONDON",0,2,13,729,0,744,"2020"
"59987","411470 MARIA HELENA",0,0,1,66,0,67,"2020"
"59988","411480 MARIALVA",0,2,8,541,0,551,"2020"
"59989","411490 MARILANDIA DO SUL",1,0,2,122,0,125,"2020"
"59990","411500 MARILENA",0,0,0,78,0,78,"2020"
"59991","411510 MARILUZ",0,1,1,144,0,146,"2020"
"59992","411520 MARINGA",8,12,60,4721,2,4803,"2020"
"59993","411530 MARIOPOLIS",0,1,0,83,0,84,"2020"
"59994","411535 MARIPA",0,0,1,75,0,76,"2020"
"59995","411540 MARMELEIRO",0,2,0,207,0,209,"2020"
"59996","411545 MARQUINHO",0,0,1,55,0,56,"2020"
"59997","411550 MARUMBI",0,0,0,46,1,47,"2020"
"59998","411560 MATELANDIA",1,0,4,287,0,292,"2020"
"59999","411570 MATINHOS",1,5,6,502,5,519,"2020"
"60000","411573 MATO RICO",0,0,1,36,0,37,"2020"
"60001","411575 MAUA DA SERRA",0,0,1,154,2,157,"2020"
"60002","411580 MEDIANEIRA",0,2,13,779,0,794,"2020"
"60003","411585 MERCEDES",0,0,0,62,0,62,"2020"
"60004","411590 MIRADOR",0,0,1,30,0,31,"2020"
"60005","411600 MIRASELVA",0,0,0,26,0,26,"2020"
"60006","411605 MISSAL",0,1,2,129,1,133,"2020"
"60007","411610 MOREIRA SALES",0,1,1,122,0,124,"2020"
"60008","411620 MORRETES",0,0,2,214,4,220,"2020"
"60009","411630 MUNHOZ DE MELO",0,0,0,49,0,49,"2020"
"60010","411640 NOSSA SENHORA DAS GRACAS",0,0,1,52,0,53,"2020"
"60011","411650 NOVA ALIANCA DO IVAI",0,0,0,14,0,14,"2020"
"60012","411660 NOVA AMERICA DA COLINA",0,0,0,35,0,35,"2020"
"60013","411670 NOVA AURORA",0,0,2,144,0,146,"2020"
"60014","411680 NOVA CANTU",0,0,1,92,0,93,"2020"
"60015","411690 NOVA ESPERANCA",1,0,5,279,0,285,"2020"
"60016","411695 NOVA ESPERANCA DO SUDOESTE",0,0,1,73,0,74,"2020"
"60017","411700 NOVA FATIMA",0,0,0,66,0,66,"2020"
"60018","411705 NOVA LARANJEIRAS",0,1,6,169,1,177,"2020"
"60019","411710 NOVA LONDRINA",0,0,0,149,0,149,"2020"
"60020","411720 NOVA OLIMPIA",0,1,0,66,0,67,"2020"
"60021","411721 NOVA SANTA BARBARA",1,0,0,48,0,49,"2020"
"60022","411722 NOVA SANTA ROSA",0,0,2,106,0,108,"2020"
"60023","411725 NOVA PRATA DO IGUACU",0,1,4,128,1,134,"2020"
"60024","411727 NOVA TEBAS",0,0,1,85,0,86,"2020"
"60025","411729 NOVO ITACOLOMI",1,0,2,38,1,42,"2020"
"60026","411730 ORTIGUEIRA",0,1,4,343,0,348,"2020"
"60027","411740 OURIZONA",0,0,0,34,0,34,"2020"
"60028","411745 OURO VERDE DO OESTE",0,0,0,74,0,74,"2020"
"60029","411750 PAICANDU",0,3,19,604,3,629,"2020"
"60030","411760 PALMAS",3,5,10,793,0,811,"2020"
"60031","411770 PALMEIRA",1,3,9,414,2,429,"2020"
"60032","411780 PALMITAL",0,1,2,191,0,194,"2020"
"60033","411790 PALOTINA",0,1,5,523,0,529,"2020"
"60034","411800 PARAISO DO NORTE",2,0,2,186,0,190,"2020"
"60035","411810 PARANACITY",0,1,2,115,0,118,"2020"
"60036","411820 PARANAGUA",3,7,17,2191,13,2231,"2020"
"60037","411830 PARANAPOEMA",0,0,0,25,0,25,"2020"
"60038","411840 PARANAVAI",1,0,5,1077,0,1083,"2020"
"60039","411845 PATO BRAGADO",0,0,2,82,0,84,"2020"
"60040","411850 PATO BRANCO",1,6,15,1323,1,1346,"2020"
"60041","411860 PAULA FREITAS",0,0,0,55,0,55,"2020"
"60042","411870 PAULO FRONTIN",0,1,0,65,0,66,"2020"
"60043","411880 PEABIRU",0,0,1,157,0,158,"2020"
"60044","411885 PEROBAL",0,0,3,83,0,86,"2020"
"60045","411890 PEROLA",0,0,2,151,0,153,"2020"
"60046","411900 PEROLA D'OESTE",0,0,0,62,0,62,"2020"
"60047","411910 PIEN",1,0,1,169,2,173,"2020"
"60048","411915 PINHAIS",4,13,40,1555,3,1615,"2020"
"60049","411920 PINHALAO",0,0,1,87,0,88,"2020"
"60050","411925 PINHAL DE SAO BENTO",0,0,1,27,0,28,"2020"
"60051","411930 PINHAO",4,2,6,464,0,476,"2020"
"60052","411940 PIRAI DO SUL",1,4,4,327,1,337,"2020"
"60053","411950 PIRAQUARA",3,9,30,1532,4,1578,"2020"
"60054","411960 PITANGA",0,1,5,464,0,470,"2020"
"60055","411965 PITANGUEIRAS",0,0,1,34,1,36,"2020"
"60056","411970 PLANALTINA DO PARANA",1,0,0,53,0,54,"2020"
"60057","411980 PLANALTO",1,3,2,137,0,143,"2020"
"60058","411990 PONTA GROSSA",13,25,90,4595,15,4738,"2020"
"60059","411995 PONTAL DO PARANA",0,1,3,327,2,333,"2020"
"60060","412000 PORECATU",0,1,1,124,0,126,"2020"
"60061","412010 PORTO AMAZONAS",0,1,0,44,0,45,"2020"
"60062","412015 PORTO BARREIRO",1,1,1,48,0,51,"2020"
"60063","412020 PORTO RICO",0,0,0,34,0,34,"2020"
"60064","412030 PORTO VITORIA",0,0,0,44,0,44,"2020"
"60065","412033 PRADO FERREIRA",0,0,0,57,0,57,"2020"
"60066","412035 PRANCHITA",1,1,0,64,0,66,"2020"
"60067","412040 PRESIDENTE CASTELO BRANCO",0,1,1,49,0,51,"2020"
"60068","412050 PRIMEIRO DE MAIO",0,0,3,92,0,95,"2020"
"60069","412060 PRUDENTOPOLIS",0,1,3,630,0,634,"2020"
"60070","412065 QUARTO CENTENARIO",0,0,1,53,0,54,"2020"
"60071","412070 QUATIGUA",0,0,0,93,0,93,"2020"
"60072","412080 QUATRO BARRAS",1,1,3,286,1,292,"2020"
"60073","412085 QUATRO PONTES",0,0,2,44,0,46,"2020"
"60074","412090 QUEDAS DO IGUACU",0,2,9,442,0,453,"2020"
"60075","412100 QUERENCIA DO NORTE",1,0,0,148,0,149,"2020"
"60076","412110 QUINTA DO SOL",0,0,0,57,0,57,"2020"
"60077","412120 QUITANDINHA",0,1,0,212,0,213,"2020"
"60078","412125 RAMILANDIA",0,0,1,58,0,59,"2020"
"60079","412130 RANCHO ALEGRE",0,1,0,39,0,40,"2020"
"60080","412135 RANCHO ALEGRE D'OESTE",0,0,0,35,0,35,"2020"
"60081","412140 REALEZA",0,0,2,205,0,207,"2020"
"60082","412150 REBOUCAS",1,0,2,183,0,186,"2020"
"60083","412160 RENASCENCA",0,0,2,76,0,78,"2020"
"60084","412170 RESERVA",0,1,5,339,2,347,"2020"
"60085","412175 RESERVA DO IGUACU",0,0,1,101,0,102,"2020"
"60086","412180 RIBEIRAO CLARO",0,1,1,160,0,162,"2020"
"60087","412190 RIBEIRAO DO PINHAL",1,0,0,164,0,165,"2020"
"60088","412200 RIO AZUL",1,1,1,163,0,166,"2020"
"60089","412210 RIO BOM",0,0,0,26,0,26,"2020"
"60090","412215 RIO BONITO DO IGUACU",0,1,5,228,2,236,"2020"
"60091","412217 RIO BRANCO DO IVAI",0,0,0,53,0,53,"2020"
"60092","412220 RIO BRANCO DO SUL",1,1,8,560,9,579,"2020"
"60093","412230 RIO NEGRO",0,2,5,329,0,336,"2020"
"60094","412240 ROLANDIA",0,3,18,958,2,981,"2020"
"60095","412250 RONCADOR",0,0,2,163,0,165,"2020"
"60096","412260 RONDON",0,0,2,113,0,115,"2020"
"60097","412265 ROSARIO DO IVAI",0,0,1,68,0,69,"2020"
"60098","412270 SABAUDIA",0,0,0,106,0,106,"2020"
"60099","412280 SALGADO FILHO",0,0,0,48,0,48,"2020"
"60100","412290 SALTO DO ITARARE",0,1,0,57,0,58,"2020"
"60101","412300 SALTO DO LONTRA",0,0,0,188,0,188,"2020"
"60102","412310 SANTA AMELIA",0,0,0,38,0,38,"2020"
"60103","412320 SANTA CECILIA DO PAVAO",1,0,0,33,0,34,"2020"
"60104","412330 SANTA CRUZ DE MONTE CASTELO",1,0,0,95,0,96,"2020"
"60105","412340 SANTA FE",1,0,1,122,0,124,"2020"
"60106","412350 SANTA HELENA",0,0,13,328,1,342,"2020"
"60107","412360 SANTA INES",0,0,0,22,0,22,"2020"
"60108","412370 SANTA ISABEL DO IVAI",2,0,1,98,0,101,"2020"
"60109","412380 SANTA IZABEL DO OESTE",0,1,0,163,0,164,"2020"
"60110","412382 SANTA LUCIA",0,0,3,39,0,42,"2020"
"60111","412385 SANTA MARIA DO OESTE",0,0,2,104,0,106,"2020"
"60112","412390 SANTA MARIANA",1,0,0,130,0,131,"2020"
"60113","412395 SANTA MONICA",0,0,1,38,0,39,"2020"
"60114","412400 SANTANA DO ITARARE",0,0,0,60,0,60,"2020"
"60115","412402 SANTA TEREZA DO OESTE",0,1,2,216,0,219,"2020"
"60116","412405 SANTA TEREZINHA DE ITAIPU",0,2,10,301,6,319,"2020"
"60117","412410 SANTO ANTONIO DA PLATINA",2,3,3,587,0,595,"2020"
"60118","412420 SANTO ANTONIO DO CAIUA",0,0,0,30,0,30,"2020"
"60119","412430 SANTO ANTONIO DO PARAISO",0,0,0,18,0,18,"2020"
"60120","412440 SANTO ANTONIO DO SUDOESTE",0,1,1,255,1,258,"2020"
"60121","412450 SANTO INACIO",0,0,0,90,0,90,"2020"
"60122","412460 SAO CARLOS DO IVAI",0,0,0,84,0,84,"2020"
"60123","412470 SAO JERONIMO DA SERRA",0,0,0,116,0,116,"2020"
"60124","412480 SAO JOAO",0,0,3,157,0,160,"2020"
"60125","412490 SAO JOAO DO CAIUA",1,0,0,72,0,73,"2020"
"60126","412500 SAO JOAO DO IVAI",1,1,0,112,0,114,"2020"
"60127","412510 SAO JOAO DO TRIUNFO",0,0,1,202,0,203,"2020"
"60128","412520 SAO JORGE D'OESTE",0,0,1,95,0,96,"2020"
"60129","412530 SAO JORGE DO IVAI",0,0,0,50,0,50,"2020"
"60130","412535 SAO JORGE DO PATROCINIO",0,0,3,85,0,88,"2020"
"60131","412540 SAO JOSE DA BOA VISTA",0,1,1,63,0,65,"2020"
"60132","412545 SAO JOSE DAS PALMEIRAS",0,0,1,55,0,56,"2020"
"60133","412550 SAO JOSE DOS PINHAIS",9,23,91,4433,14,4570,"2020"
"60134","412555 SAO MANOEL DO PARANA",0,0,0,22,0,22,"2020"
"60135","412560 SAO MATEUS DO SUL",1,3,6,577,3,590,"2020"
"60136","412570 SAO MIGUEL DO IGUACU",1,0,11,420,0,432,"2020"
"60137","412575 SAO PEDRO DO IGUACU",0,0,3,85,0,88,"2020"
"60138","412580 SAO PEDRO DO IVAI",1,2,2,97,0,102,"2020"
"60139","412590 SAO PEDRO DO PARANA",1,0,1,28,0,30,"2020"
"60140","412600 SAO SEBASTIAO DA AMOREIRA",0,0,0,82,0,82,"2020"
"60141","412610 SAO TOME",0,0,0,52,0,52,"2020"
"60142","412620 SAPOPEMA",0,0,0,90,0,90,"2020"
"60143","412625 SARANDI",1,7,29,1539,1,1577,"2020"
"60144","412627 SAUDADE DO IGUACU",0,1,3,80,0,84,"2020"
"60145","412630 SENGES",1,3,5,213,1,223,"2020"
"60146","412635 SERRANOPOLIS DO IGUACU",0,1,0,45,0,46,"2020"
"60147","412640 SERTANEJA",0,0,0,55,0,55,"2020"
"60148","412650 SERTANOPOLIS",2,1,1,159,0,163,"2020"
"60149","412660 SIQUEIRA CAMPOS",1,0,2,307,1,311,"2020"
"60150","412665 SULINA",0,1,0,38,0,39,"2020"
"60151","412667 TAMARANA",1,0,2,179,1,183,"2020"
"60152","412670 TAMBOARA",0,0,0,80,0,80,"2020"
"60153","412680 TAPEJARA",0,0,0,169,0,169,"2020"
"60154","412690 TAPIRA",0,0,1,57,1,59,"2020"
"60155","412700 TEIXEIRA SOARES",0,0,3,121,1,125,"2020"
"60156","412710 TELEMACO BORBA",3,9,10,1018,0,1040,"2020"
"60157","412720 TERRA BOA",1,2,4,234,1,242,"2020"
"60158","412730 TERRA RICA",0,0,1,179,0,180,"2020"
"60159","412740 TERRA ROXA",2,3,5,231,0,241,"2020"
"60160","412750 TIBAGI",0,3,3,281,0,287,"2020"
"60161","412760 TIJUCAS DO SUL",1,2,4,199,1,207,"2020"
"60162","412770 TOLEDO",6,4,26,1938,3,1977,"2020"
"60163","412780 TOMAZINA",0,1,0,78,0,79,"2020"
"60164","412785 TRES BARRAS DO PARANA",0,0,2,140,0,142,"2020"
"60165","412788 TUNAS DO PARANA",0,1,3,111,2,117,"2020"
"60166","412790 TUNEIRAS DO OESTE",1,1,0,88,0,90,"2020"
"60167","412795 TUPASSI",1,0,1,74,0,76,"2020"
"60168","412796 TURVO",1,0,2,198,0,201,"2020"
"60169","412800 UBIRATA",0,0,1,328,0,329,"2020"
"60170","412810 UMUARAMA",2,5,22,1543,2,1574,"2020"
"60171","412820 UNIAO DA VITORIA",1,0,5,775,1,782,"2020"
"60172","412830 UNIFLOR",0,0,0,29,0,29,"2020"
"60173","412840 URAI",0,1,2,106,0,109,"2020"
"60174","412850 WENCESLAU BRAZ",0,1,2,303,0,306,"2020"
"60175","412853 VENTANIA",0,1,2,117,0,120,"2020"
"60176","412855 VERA CRUZ DO OESTE",0,0,2,85,0,87,"2020"
"60177","412860 VERE",0,0,0,87,0,87,"2020"
"60178","412862 ALTO PARAISO",0,0,1,32,0,33,"2020"
"60179","412863 DOUTOR ULYSSES",1,0,3,70,0,74,"2020"
"60180","412865 VIRMOND",0,1,2,49,0,52,"2020"
"60181","412870 VITORINO",0,1,2,135,0,138,"2020"
"60182","412880 XAMBRE",0,2,1,71,0,74,"2020"
"60183","MUNICIPIO IGNORADO - SC",0,0,0,0,2,2,"2020"
"60184","420005 ABDON BATISTA",0,0,0,26,0,26,"2020"
"60185","420010 ABELARDO LUZ",1,1,4,304,0,310,"2020"
"60186","420020 AGROLANDIA",0,0,2,135,0,137,"2020"
"60187","420030 AGRONOMICA",0,0,2,75,0,77,"2020"
"60188","420040 AGUA DOCE",0,0,0,100,0,100,"2020"
"60189","420050 AGUAS DE CHAPECO",0,1,0,62,0,63,"2020"
"60190","420055 AGUAS FRIAS",0,0,0,34,0,34,"2020"
"60191","420060 AGUAS MORNAS",0,0,2,88,0,90,"2020"
"60192","420070 ALFREDO WAGNER",1,0,0,94,0,95,"2020"
"60193","420075 ALTO BELA VISTA",0,0,1,15,0,16,"2020"
"60194","420080 ANCHIETA",0,0,1,53,0,54,"2020"
"60195","420090 ANGELINA",0,0,0,51,0,51,"2020"
"60196","420100 ANITA GARIBALDI",0,0,5,87,2,94,"2020"
"60197","420110 ANITAPOLIS",0,0,0,34,1,35,"2020"
"60198","420120 ANTONIO CARLOS",0,0,3,132,0,135,"2020"
"60199","420125 APIUNA",0,1,0,114,0,115,"2020"
"60200","420127 ARABUTA",0,1,0,43,0,44,"2020"
"60201","420130 ARAQUARI",1,4,6,672,7,690,"2020"
"60202","420140 ARARANGUA",1,3,12,943,4,963,"2020"
"60203","420150 ARMAZEM",0,0,0,113,0,113,"2020"
"60204","420160 ARROIO TRINTA",0,0,0,38,0,38,"2020"
"60205","420165 ARVOREDO",0,0,2,29,0,31,"2020"
"60206","420170 ASCURRA",0,0,2,98,0,100,"2020"
"60207","420180 ATALANTA",0,0,0,46,0,46,"2020"
"60208","420190 AURORA",0,0,2,74,0,76,"2020"
"60209","420195 BALNEARIO ARROIO DO SILVA",0,0,1,164,3,168,"2020"
"60210","420200 BALNEARIO CAMBORIU",4,6,16,1648,3,1677,"2020"
"60211","420205 BALNEARIO BARRA DO SUL",2,1,3,150,0,156,"2020"
"60212","420207 BALNEARIO GAIVOTA",0,1,1,164,0,166,"2020"
"60213","420208 BANDEIRANTE",0,0,0,37,0,37,"2020"
"60214","420209 BARRA BONITA",0,0,0,12,0,12,"2020"
"60215","420210 BARRA VELHA",2,2,13,532,3,552,"2020"
"60216","420213 BELA VISTA DO TOLDO",0,0,2,58,0,60,"2020"
"60217","420215 BELMONTE",0,0,0,29,1,30,"2020"
"60218","420220 BENEDITO NOVO",0,1,4,109,0,114,"2020"
"60219","420230 BIGUACU",4,4,10,912,9,939,"2020"
"60220","420240 BLUMENAU",7,3,47,4263,4,4324,"2020"
"60221","420243 BOCAINA DO SUL",0,3,2,37,3,45,"2020"
"60222","420245 BOMBINHAS",0,0,7,313,0,320,"2020"
"60223","420250 BOM JARDIM DA SERRA",0,2,1,48,0,51,"2020"
"60224","420253 BOM JESUS",0,0,0,35,0,35,"2020"
"60225","420257 BOM JESUS DO OESTE",0,0,1,20,0,21,"2020"
"60226","420260 BOM RETIRO",1,3,3,100,0,107,"2020"
"60227","420270 BOTUVERA",0,1,2,55,0,58,"2020"
"60228","420280 BRACO DO NORTE",1,1,3,543,0,548,"2020"
"60229","420285 BRACO DO TROMBUDO",0,0,1,40,0,41,"2020"
"60230","420287 BRUNOPOLIS",0,0,0,33,0,33,"2020"
"60231","420290 BRUSQUE",8,10,22,2026,6,2072,"2020"
"60232","420300 CACADOR",1,3,9,1077,3,1093,"2020"
"60233","420310 CAIBI",0,1,0,70,0,71,"2020"
"60234","420315 CALMON",0,0,1,54,0,55,"2020"
"60235","420320 CAMBORIU",6,3,16,1482,7,1514,"2020"
"60236","420325 CAPAO ALTO",0,0,1,21,0,22,"2020"
"60237","420330 CAMPO ALEGRE",0,1,0,138,1,140,"2020"
"60238","420340 CAMPO BELO DO SUL",0,3,6,72,1,82,"2020"
"60239","420350 CAMPO ERE",0,0,1,143,0,144,"2020"
"60240","420360 CAMPOS NOVOS",1,1,3,500,0,505,"2020"
"60241","420370 CANELINHA",1,3,3,181,1,189,"2020"
"60242","420380 CANOINHAS",2,0,8,735,1,746,"2020"
"60243","420390 CAPINZAL",1,0,5,318,1,325,"2020"
"60244","420395 CAPIVARI DE BAIXO",0,0,3,298,0,301,"2020"
"60245","420400 CATANDUVAS",0,1,4,181,0,186,"2020"
"60246","420410 CAXAMBU DO SUL",0,0,0,58,0,58,"2020"
"60247","420415 CELSO RAMOS",0,0,0,29,0,29,"2020"
"60248","420417 CERRO NEGRO",0,2,4,34,0,40,"2020"
"60249","420419 CHAPADAO DO LAGEADO",0,0,0,34,0,34,"2020"
"60250","420420 CHAPECO",9,18,52,3717,5,3801,"2020"
"60251","420425 COCAL DO SUL",1,0,1,198,0,200,"2020"
"60252","420430 CONCORDIA",1,2,24,1130,1,1158,"2020"
"60253","420435 CORDILHEIRA ALTA",0,0,1,66,0,67,"2020"
"60254","420440 CORONEL FREITAS",0,1,5,118,0,124,"2020"
"60255","420445 CORONEL MARTINS",0,0,0,23,0,23,"2020"
"60256","420450 CORUPA",0,0,2,172,0,174,"2020"
"60257","420455 CORREIA PINTO",1,5,16,213,1,236,"2020"
"60258","420460 CRICIUMA",5,8,31,2664,10,2718,"2020"
"60259","420470 CUNHA PORA",0,0,1,144,0,145,"2020"
"60260","420475 CUNHATAI",1,0,0,17,0,18,"2020"
"60261","420480 CURITIBANOS",1,1,11,630,0,643,"2020"
"60262","420490 DESCANSO",1,0,1,83,0,85,"2020"
"60263","420500 DIONISIO CERQUEIRA",0,0,3,205,0,208,"2020"
"60264","420510 DONA EMMA",0,0,1,55,0,56,"2020"
"60265","420515 DOUTOR PEDRINHO",1,0,0,33,0,34,"2020"
"60266","420517 ENTRE RIOS",0,0,0,59,0,59,"2020"
"60267","420519 ERMO",0,0,0,22,0,22,"2020"
"60268","420520 ERVAL VELHO",0,0,1,46,0,47,"2020"
"60269","420530 FAXINAL DOS GUEDES",1,0,0,161,0,162,"2020"
"60270","420535 FLOR DO SERTAO",0,0,1,15,0,16,"2020"
"60271","420540 FLORIANOPOLIS",23,19,82,6024,23,6171,"2020"
"60272","420543 FORMOSA DO SUL",0,0,0,40,0,40,"2020"
"60273","420545 FORQUILHINHA",1,1,5,424,4,435,"2020"
"60274","420550 FRAIBURGO",2,0,6,521,0,529,"2020"
"60275","420555 FREI ROGERIO",0,0,0,26,0,26,"2020"
"60276","420560 GALVAO",0,1,2,43,0,46,"2020"
"60277","420570 GAROPABA",1,0,3,336,1,341,"2020"
"60278","420580 GARUVA",1,1,4,272,2,280,"2020"
"60279","420590 GASPAR",0,1,5,939,2,947,"2020"
"60280","420600 GOVERNADOR CELSO RAMOS",0,0,4,145,1,150,"2020"
"60281","420610 GRAO PARA",0,0,1,100,0,101,"2020"
"60282","420620 GRAVATAL",1,0,1,137,0,139,"2020"
"60283","420630 GUABIRUBA",2,0,5,344,3,354,"2020"
"60284","420640 GUARACIABA",0,1,1,123,0,125,"2020"
"60285","420650 GUARAMIRIM",1,3,15,608,0,627,"2020"
"60286","420660 GUARUJA DO SUL",0,0,0,50,0,50,"2020"
"60287","420665 GUATAMBU",0,0,0,96,0,96,"2020"
"60288","420670 HERVAL D'OESTE",0,3,0,281,1,285,"2020"
"60289","420675 IBIAM",0,0,0,26,0,26,"2020"
"60290","420680 IBICARE",0,0,2,38,0,40,"2020"
"60291","420690 IBIRAMA",0,2,6,237,0,245,"2020"
"60292","420700 ICARA",0,1,6,747,2,756,"2020"
"60293","420710 ILHOTA",1,1,2,176,2,182,"2020"
"60294","420720 IMARUI",0,1,0,117,1,119,"2020"
"60295","420730 IMBITUBA",1,1,9,602,0,613,"2020"
"60296","420740 IMBUIA",0,0,2,75,0,77,"2020"
"60297","420750 INDAIAL",3,2,12,898,1,916,"2020"
"60298","420757 IOMERE",0,0,1,27,0,28,"2020"
"60299","420760 IPIRA",0,0,2,51,0,53,"2020"
"60300","420765 IPORA DO OESTE",0,2,0,114,0,116,"2020"
"60301","420768 IPUACU",0,0,2,124,1,127,"2020"
"60302","420770 IPUMIRIM",0,0,4,99,0,103,"2020"
"60303","420775 IRACEMINHA",0,0,1,36,0,37,"2020"
"60304","420780 IRANI",0,0,2,118,0,120,"2020"
"60305","420785 IRATI",0,0,0,24,0,24,"2020"
"60306","420790 IRINEOPOLIS",0,0,1,125,0,126,"2020"
"60307","420800 ITA",0,2,0,71,1,74,"2020"
"60308","420810 ITAIOPOLIS",1,1,1,302,0,305,"2020"
"60309","420820 ITAJAI",4,13,44,3592,22,3675,"2020"
"60310","420830 ITAPEMA",2,2,11,964,1,980,"2020"
"60311","420840 ITAPIRANGA",0,3,4,220,0,227,"2020"
"60312","420845 ITAPOA",2,3,2,305,6,318,"2020"
"60313","420850 ITUPORANGA",0,1,12,367,2,382,"2020"
"60314","420860 JABORA",1,1,0,52,0,54,"2020"
"60315","420870 JACINTO MACHADO",0,1,1,117,0,119,"2020"
"60316","420880 JAGUARUNA",1,1,3,245,1,251,"2020"
"60317","420890 JARAGUA DO SUL",3,4,36,2365,9,2417,"2020"
"60318","420895 JARDINOPOLIS",0,0,0,19,0,19,"2020"
"60319","420900 JOACABA",1,1,4,361,1,368,"2020"
"60320","420910 JOINVILLE",15,45,172,7650,16,7898,"2020"
"60321","420915 JOSE BOITEUX",0,0,0,109,0,109,"2020"
"60322","420917 JUPIA",0,0,0,29,0,29,"2020"
"60323","420920 LACERDOPOLIS",0,0,0,21,0,21,"2020"
"60324","420930 LAGES",5,35,175,2062,7,2284,"2020"
"60325","420940 LAGUNA",2,0,2,429,0,433,"2020"
"60326","420945 LAJEADO GRANDE",0,0,0,19,0,19,"2020"
"60327","420950 LAURENTINO",0,1,1,77,0,79,"2020"
"60328","420960 LAURO MULLER",1,2,2,188,0,193,"2020"
"60329","420970 LEBON REGIS",0,0,2,182,1,185,"2020"
"60330","420980 LEOBERTO LEAL",0,0,1,47,0,48,"2020"
"60331","420985 LINDOIA DO SUL",0,0,2,41,0,43,"2020"
"60332","420990 LONTRAS",0,1,2,160,1,164,"2020"
"60333","421000 LUIZ ALVES",1,0,1,190,1,193,"2020"
"60334","421003 LUZERNA",0,0,2,49,0,51,"2020"
"60335","421005 MACIEIRA",0,0,0,20,0,20,"2020"
"60336","421010 MAFRA",2,2,9,701,1,715,"2020"
"60337","421020 MAJOR GERCINO",0,0,1,33,1,35,"2020"
"60338","421030 MAJOR VIEIRA",0,0,0,123,0,123,"2020"
"60339","421040 MARACAJA",0,1,1,108,1,111,"2020"
"60340","421050 MARAVILHA",0,1,8,373,0,382,"2020"
"60341","421055 MAREMA",0,0,0,16,0,16,"2020"
"60342","421060 MASSARANDUBA",1,0,1,195,2,199,"2020"
"60343","421070 MATOS COSTA",0,0,1,33,2,36,"2020"
"60344","421080 MELEIRO",0,0,1,82,1,84,"2020"
"60345","421085 MIRIM DOCE",0,0,0,29,0,29,"2020"
"60346","421090 MODELO",0,0,2,31,0,33,"2020"
"60347","421100 MONDAI",0,2,0,115,0,117,"2020"
"60348","421105 MONTE CARLO",0,0,1,130,0,131,"2020"
"60349","421110 MONTE CASTELO",0,1,1,104,0,106,"2020"
"60350","421120 MORRO DA FUMACA",0,1,4,208,1,214,"2020"
"60351","421125 MORRO GRANDE",0,0,1,35,0,36,"2020"
"60352","421130 NAVEGANTES",2,3,6,1489,4,1504,"2020"
"60353","421140 NOVA ERECHIM",0,0,0,64,0,64,"2020"
"60354","421145 NOVA ITABERABA",0,0,1,52,0,53,"2020"
"60355","421150 NOVA TRENTO",0,0,2,157,8,167,"2020"
"60356","421160 NOVA VENEZA",0,0,0,169,0,169,"2020"
"60357","421165 NOVO HORIZONTE",0,0,0,24,0,24,"2020"
"60358","421170 ORLEANS",0,2,8,322,0,332,"2020"
"60359","421175 OTACILIO COSTA",0,5,11,218,1,235,"2020"
"60360","421180 OURO",0,0,0,74,0,74,"2020"
"60361","421185 OURO VERDE",0,0,0,25,0,25,"2020"
"60362","421187 PAIAL",0,0,0,23,0,23,"2020"
"60363","421189 PAINEL",0,1,3,31,2,37,"2020"
"60364","421190 PALHOCA",8,14,46,2743,9,2820,"2020"
"60365","421200 PALMA SOLA",0,0,0,114,0,114,"2020"
"60366","421205 PALMEIRA",0,1,1,29,0,31,"2020"
"60367","421210 PALMITOS",1,0,1,145,0,147,"2020"
"60368","421220 PAPANDUVA",1,1,4,291,0,297,"2020"
"60369","421223 PARAISO",0,0,3,42,0,45,"2020"
"60370","421225 PASSO DE TORRES",0,0,2,77,0,79,"2020"
"60371","421227 PASSOS MAIA",0,0,0,63,0,63,"2020"
"60372","421230 PAULO LOPES",0,1,2,80,0,83,"2020"
"60373","421240 PEDRAS GRANDES",0,0,0,38,0,38,"2020"
"60374","421250 PENHA",0,0,4,409,0,413,"2020"
"60375","421260 PERITIBA",0,0,3,26,0,29,"2020"
"60376","421265 PESCARIA BRAVA",2,0,0,105,0,107,"2020"
"60377","421270 PETROLANDIA",0,1,3,72,0,76,"2020"
"60378","421280 BALNEARIO PICARRAS",1,3,2,321,3,330,"2020"
"60379","421290 PINHALZINHO",0,0,3,324,0,327,"2020"
"60380","421300 PINHEIRO PRETO",0,0,0,44,0,44,"2020"
"60381","421310 PIRATUBA",0,0,0,62,1,63,"2020"
"60382","421315 PLANALTO ALEGRE",0,0,2,33,0,35,"2020"
"60383","421320 POMERODE",1,2,10,433,0,446,"2020"
"60384","421330 PONTE ALTA",0,2,2,57,0,61,"2020"
"60385","421335 PONTE ALTA DO NORTE",0,0,0,59,0,59,"2020"
"60386","421340 PONTE SERRADA",1,1,1,162,0,165,"2020"
"60387","421350 PORTO BELO",0,2,3,320,2,327,"2020"
"60388","421360 PORTO UNIAO",2,2,9,368,0,381,"2020"
"60389","421370 POUSO REDONDO",1,1,5,257,0,264,"2020"
"60390","421380 PRAIA GRANDE",0,0,1,105,0,106,"2020"
"60391","421390 PRESIDENTE CASTELLO BRANCO",0,0,0,25,0,25,"2020"
"60392","421400 PRESIDENTE GETULIO",0,1,5,271,2,279,"2020"
"60393","421410 PRESIDENTE NEREU",1,0,0,23,0,24,"2020"
"60394","421415 PRINCESA",0,0,0,25,0,25,"2020"
"60395","421420 QUILOMBO",0,0,2,157,0,159,"2020"
"60396","421430 RANCHO QUEIMADO",0,0,0,43,1,44,"2020"
"60397","421440 RIO DAS ANTAS",0,0,0,73,0,73,"2020"
"60398","421450 RIO DO CAMPO",1,0,0,70,0,71,"2020"
"60399","421460 RIO DO OESTE",2,0,1,76,0,79,"2020"
"60400","421470 RIO DOS CEDROS",0,0,0,108,0,108,"2020"
"60401","421480 RIO DO SUL",1,2,7,880,2,892,"2020"
"60402","421490 RIO FORTUNA",0,0,0,78,0,78,"2020"
"60403","421500 RIO NEGRINHO",2,0,5,540,0,547,"2020"
"60404","421505 RIO RUFINO",0,0,1,24,0,25,"2020"
"60405","421507 RIQUEZA",0,0,0,45,0,45,"2020"
"60406","421510 RODEIO",2,0,4,128,0,134,"2020"
"60407","421520 ROMELANDIA",0,0,0,44,0,44,"2020"
"60408","421530 SALETE",0,1,1,77,0,79,"2020"
"60409","421535 SALTINHO",0,0,0,38,0,38,"2020"
"60410","421540 SALTO VELOSO",0,0,1,49,0,50,"2020"
"60411","421545 SANGAO",0,1,2,158,0,161,"2020"
"60412","421550 SANTA CECILIA",2,1,1,268,0,272,"2020"
"60413","421555 SANTA HELENA",0,0,0,30,0,30,"2020"
"60414","421560 SANTA ROSA DE LIMA",0,1,0,23,0,24,"2020"
"60415","421565 SANTA ROSA DO SUL",0,0,0,98,0,98,"2020"
"60416","421567 SANTA TEREZINHA",0,0,1,79,1,81,"2020"
"60417","421568 SANTA TEREZINHA DO PROGRESSO",0,0,3,22,0,25,"2020"
"60418","421569 SANTIAGO DO SUL",0,0,0,22,0,22,"2020"
"60419","421570 SANTO AMARO DA IMPERATRIZ",1,0,5,285,1,292,"2020"
"60420","421575 SAO BERNARDINO",0,0,0,34,0,34,"2020"
"60421","421580 SAO BENTO DO SUL",2,5,12,1053,0,1072,"2020"
"60422","421590 SAO BONIFACIO",0,1,1,33,0,35,"2020"
"60423","421600 SAO CARLOS",2,0,0,128,0,130,"2020"
"60424","421605 SAO CRISTOVAO DO SUL",0,0,0,73,0,73,"2020"
"60425","421610 SAO DOMINGOS",0,0,1,99,0,100,"2020"
"60426","421620 SAO FRANCISCO DO SUL",1,4,12,640,3,660,"2020"
"60427","421625 SAO JOAO DO OESTE",0,0,0,60,0,60,"2020"
"60428","421630 SAO JOAO BATISTA",2,4,10,458,0,474,"2020"
"60429","421635 SAO JOAO DO ITAPERIU",0,0,1,48,0,49,"2020"
"60430","421640 SAO JOAO DO SUL",0,0,1,110,0,111,"2020"
"60431","421650 SAO JOAQUIM",0,4,16,384,1,405,"2020"
"60432","421660 SAO JOSE",4,11,62,3120,12,3209,"2020"
"60433","421670 SAO JOSE DO CEDRO",0,0,4,161,0,165,"2020"
"60434","421680 SAO JOSE DO CERRITO",1,4,6,84,1,96,"2020"
"60435","421690 SAO LOURENCO DO OESTE",1,1,5,322,1,330,"2020"
"60436","421700 SAO LUDGERO",0,0,3,187,0,190,"2020"
"60437","421710 SAO MARTINHO",0,0,0,41,0,41,"2020"
"60438","421715 SAO MIGUEL DA BOA VISTA",0,0,0,15,0,15,"2020"
"60439","421720 SAO MIGUEL DO OESTE",0,0,4,518,0,522,"2020"
"60440","421725 SAO PEDRO DE ALCANTARA",0,0,1,31,0,32,"2020"
"60441","421730 SAUDADES",1,1,1,118,1,122,"2020"
"60442","421740 SCHROEDER",1,3,5,280,0,289,"2020"
"60443","421750 SEARA",0,1,7,258,0,266,"2020"
"60444","421755 SERRA ALTA",0,0,0,39,0,39,"2020"
"60445","421760 SIDEROPOLIS",1,2,5,151,1,160,"2020"
"60446","421770 SOMBRIO",1,1,7,411,1,421,"2020"
"60447","421775 SUL BRASIL",0,0,2,27,0,29,"2020"
"60448","421780 TAIO",1,1,2,292,1,297,"2020"
"60449","421790 TANGARA",1,1,1,98,0,101,"2020"
"60450","421795 TIGRINHOS",0,0,0,30,0,30,"2020"
"60451","421800 TIJUCAS",2,1,14,652,0,669,"2020"
"60452","421810 TIMBE DO SUL",0,0,0,63,0,63,"2020"
"60453","421820 TIMBO",0,0,3,461,1,465,"2020"
"60454","421825 TIMBO GRANDE",0,0,0,107,1,108,"2020"
"60455","421830 TRES BARRAS",0,2,2,292,0,296,"2020"
"60456","421835 TREVISO",0,0,0,34,0,34,"2020"
"60457","421840 TREZE DE MAIO",0,1,0,76,0,77,"2020"
"60458","421850 TREZE TILIAS",0,1,0,128,1,130,"2020"
"60459","421860 TROMBUDO CENTRAL",0,1,2,77,0,80,"2020"
"60460","421870 TUBARAO",3,2,11,1336,1,1353,"2020"
"60461","421875 TUNAPOLIS",2,0,0,55,0,57,"2020"
"60462","421880 TURVO",0,1,2,160,0,163,"2020"
"60463","421885 UNIAO DO OESTE",0,0,0,29,0,29,"2020"
"60464","421890 URUBICI",1,2,5,93,3,104,"2020"
"60465","421895 URUPEMA",0,1,0,30,0,31,"2020"
"60466","421900 URUSSANGA",0,1,2,183,1,187,"2020"
"60467","421910 VARGEAO",0,0,1,40,0,41,"2020"
"60468","421915 VARGEM",0,0,0,31,0,31,"2020"
"60469","421917 VARGEM BONITA",0,0,1,69,0,70,"2020"
"60470","421920 VIDAL RAMOS",0,0,2,58,0,60,"2020"
"60471","421930 VIDEIRA",1,1,5,808,0,815,"2020"
"60472","421935 VITOR MEIRELES",0,0,6,75,0,81,"2020"
"60473","421940 WITMARSUM",0,1,0,65,0,66,"2020"
"60474","421950 XANXERE",1,1,8,688,2,700,"2020"
"60475","421960 XAVANTINA",0,0,1,24,0,25,"2020"
"60476","421970 XAXIM",4,0,8,484,2,498,"2020"
"60477","421985 ZORTEA",0,0,0,44,0,44,"2020"
"60478","422000 BALNEARIO RINCAO",0,0,6,189,0,195,"2020"
"60479","430003 ACEGUA",0,1,1,50,0,52,"2020"
"60480","430005 AGUA SANTA",0,0,1,25,0,26,"2020"
"60481","430010 AGUDO",0,0,5,171,0,176,"2020"
"60482","430020 AJURICABA",1,0,0,59,0,60,"2020"
"60483","430030 ALECRIM",0,0,4,45,0,49,"2020"
"60484","430040 ALEGRETE",0,2,9,775,0,786,"2020"
"60485","430045 ALEGRIA",0,0,0,27,1,28,"2020"
"60486","430047 ALMIRANTE TAMANDARE DO SUL",0,0,2,14,0,16,"2020"
"60487","430050 ALPESTRE",1,0,0,74,0,75,"2020"
"60488","430055 ALTO ALEGRE",0,0,0,20,0,20,"2020"
"60489","430057 ALTO FELIZ",0,0,0,36,0,36,"2020"
"60490","430060 ALVORADA",4,14,48,2506,7,2579,"2020"
"60491","430063 AMARAL FERRADOR",0,0,0,50,0,50,"2020"
"60492","430064 AMETISTA DO SUL",0,1,1,98,0,100,"2020"
"60493","430066 ANDRE DA ROCHA",0,0,0,9,0,9,"2020"
"60494","430070 ANTA GORDA",0,0,0,61,0,61,"2020"
"60495","430080 ANTONIO PRADO",0,1,4,154,0,159,"2020"
"60496","430085 ARAMBARE",0,0,1,35,0,36,"2020"
"60497","430087 ARARICA",0,0,1,81,0,82,"2020"
"60498","430090 ARATIBA",0,0,0,48,0,48,"2020"
"60499","430100 ARROIO DO MEIO",1,3,4,289,0,297,"2020"
"60500","430105 ARROIO DO SAL",0,0,1,132,0,133,"2020"
"60501","430107 ARROIO DO PADRE",0,0,1,20,0,21,"2020"
"60502","430110 ARROIO DOS RATOS",0,3,4,177,0,184,"2020"
"60503","430120 ARROIO DO TIGRE",0,1,3,119,0,123,"2020"
"60504","430130 ARROIO GRANDE",0,0,4,162,1,167,"2020"
"60505","430140 ARVOREZINHA",0,0,1,127,1,129,"2020"
"60506","430150 AUGUSTO PESTANA",0,1,0,66,0,67,"2020"
"60507","430155 AUREA",0,0,0,29,0,29,"2020"
"60508","430160 BAGE",0,6,14,1478,6,1504,"2020"
"60509","430163 BALNEARIO PINHAL",0,1,1,157,2,161,"2020"
"60510","430165 BARAO",1,0,0,40,0,41,"2020"
"60511","430170 BARAO DE COTEGIPE",1,0,1,61,0,63,"2020"
"60512","430175 BARAO DO TRIUNFO",0,1,1,51,1,54,"2020"
"60513","430180 BARRACAO",0,0,1,37,0,38,"2020"
"60514","430185 BARRA DO GUARITA",0,0,0,45,0,45,"2020"
"60515","430187 BARRA DO QUARAI",0,0,0,16,19,35,"2020"
"60516","430190 BARRA DO RIBEIRO",0,0,4,114,9,127,"2020"
"60517","430192 BARRA DO RIO AZUL",0,0,0,9,0,9,"2020"
"60518","430195 BARRA FUNDA",0,0,0,30,0,30,"2020"
"60519","430200 BARROS CASSAL",0,1,2,122,0,125,"2020"
"60520","430205 BENJAMIN CONSTANT DO SUL",0,0,1,43,0,44,"2020"
"60521","430210 BENTO GONCALVES",0,8,20,1470,3,1501,"2020"
"60522","430215 BOA VISTA DAS MISSOES",0,0,1,20,0,21,"2020"
"60523","430220 BOA VISTA DO BURICA",1,0,0,88,0,89,"2020"
"60524","430222 BOA VISTA DO CADEADO",0,0,0,15,0,15,"2020"
"60525","430223 BOA VISTA DO INCRA",0,0,0,27,0,27,"2020"
"60526","430225 BOA VISTA DO SUL",0,0,0,23,0,23,"2020"
"60527","430230 BOM JESUS",0,2,3,159,1,165,"2020"
"60528","430235 BOM PRINCIPIO",0,0,2,147,0,149,"2020"
"60529","430237 BOM PROGRESSO",0,0,2,38,0,40,"2020"
"60530","430240 BOM RETIRO DO SUL",0,0,3,156,0,159,"2020"
"60531","430245 BOQUEIRAO DO LEAO",0,0,2,74,0,76,"2020"
"60532","430250 BOSSOROCA",0,0,1,61,0,62,"2020"
"60533","430258 BOZANO",0,0,0,23,0,23,"2020"
"60534","430260 BRAGA",0,0,0,40,0,40,"2020"
"60535","430265 BROCHIER",0,0,0,38,0,38,"2020"
"60536","430270 BUTIA",0,0,2,199,0,201,"2020"
"60537","430280 CACAPAVA DO SUL",1,0,10,362,4,377,"2020"
"60538","430290 CACEQUI",2,0,1,111,0,114,"2020"
"60539","430300 CACHOEIRA DO SUL",1,2,19,1017,1,1040,"2020"
"60540","430310 CACHOEIRINHA",3,7,30,1720,4,1764,"2020"
"60541","430320 CACIQUE DOBLE",0,0,0,50,0,50,"2020"
"60542","430330 CAIBATE",0,0,0,38,0,38,"2020"
"60543","430340 CAICARA",0,0,0,51,0,51,"2020"
"60544","430350 CAMAQUA",4,2,14,799,7,826,"2020"
"60545","430355 CAMARGO",0,0,0,42,0,42,"2020"
"60546","430360 CAMBARA DO SUL",0,0,1,68,0,69,"2020"
"60547","430367 CAMPESTRE DA SERRA",1,0,0,22,0,23,"2020"
"60548","430370 CAMPINA DAS MISSOES",0,0,2,65,1,68,"2020"
"60549","430380 CAMPINAS DO SUL",0,0,5,46,0,51,"2020"
"60550","430390 CAMPO BOM",0,1,6,821,0,828,"2020"
"60551","430400 CAMPO NOVO",0,1,1,68,0,70,"2020"
"60552","430410 CAMPOS BORGES",0,0,1,40,0,41,"2020"
"60553","430420 CANDELARIA",0,0,6,316,2,324,"2020"
"60554","430430 CANDIDO GODOI",0,0,0,54,0,54,"2020"
"60555","430435 CANDIOTA",0,0,2,120,0,122,"2020"
"60556","430440 CANELA",1,3,13,687,1,705,"2020"
"60557","430450 CANGUCU",0,3,13,531,2,549,"2020"
"60558","430460 CANOAS",19,16,97,4306,18,4456,"2020"
"60559","430461 CANUDOS DO VALE",0,0,1,11,0,12,"2020"
"60560","430462 CAPAO BONITO DO SUL",0,0,0,16,0,16,"2020"
"60561","430463 CAPAO DA CANOA",1,6,3,912,0,922,"2020"
"60562","430465 CAPAO DO CIPO",0,0,0,32,0,32,"2020"
"60563","430466 CAPAO DO LEAO",1,2,6,320,4,333,"2020"
"60564","430467 CAPIVARI DO SUL",0,0,0,46,0,46,"2020"
"60565","430468 CAPELA DE SANTANA",1,2,1,139,0,143,"2020"
"60566","430469 CAPITAO",0,0,2,35,0,37,"2020"
"60567","430470 CARAZINHO",2,4,16,762,1,785,"2020"
"60568","430471 CARAA",0,0,0,57,0,57,"2020"
"60569","430480 CARLOS BARBOSA",0,3,4,322,0,329,"2020"
"60570","430485 CARLOS GOMES",0,0,0,11,0,11,"2020"
"60571","430490 CASCA",2,0,0,77,0,79,"2020"
"60572","430495 CASEIROS",0,1,0,25,0,26,"2020"
"60573","430500 CATUIPE",1,0,2,96,0,99,"2020"
"60574","430510 CAXIAS DO SUL",10,20,111,5427,10,5578,"2020"
"60575","430511 CENTENARIO",0,1,1,29,0,31,"2020"
"60576","430512 CERRITO",0,0,1,38,0,39,"2020"
"60577","430513 CERRO BRANCO",0,0,1,25,0,26,"2020"
"60578","430515 CERRO GRANDE",0,0,1,31,0,32,"2020"
"60579","430517 CERRO GRANDE DO SUL",0,3,2,97,0,102,"2020"
"60580","430520 CERRO LARGO",0,0,0,136,0,136,"2020"
"60581","430530 CHAPADA",1,0,7,88,0,96,"2020"
"60582","430535 CHARQUEADAS",1,2,7,291,0,301,"2020"
"60583","430537 CHARRUA",0,0,0,31,0,31,"2020"
"60584","430540 CHIAPETTA",0,0,0,34,0,34,"2020"
"60585","430543 CHUI",0,0,0,41,0,41,"2020"
"60586","430544 CHUVISCA",0,0,4,50,0,54,"2020"
"60587","430545 CIDREIRA",0,0,3,200,0,203,"2020"
"60588","430550 CIRIACO",0,0,0,40,0,40,"2020"
"60589","430558 COLINAS",0,0,2,25,0,27,"2020"
"60590","430560 COLORADO",2,0,0,21,0,23,"2020"
"60591","430570 CONDOR",0,0,1,94,1,96,"2020"
"60592","430580 CONSTANTINA",0,0,1,117,0,118,"2020"
"60593","430583 COQUEIRO BAIXO",0,0,1,9,0,10,"2020"
"60594","430585 COQUEIROS DO SUL",0,0,0,19,0,19,"2020"
"60595","430587 CORONEL BARROS",0,0,0,30,0,30,"2020"
"60596","430590 CORONEL BICACO",0,0,0,86,0,86,"2020"
"60597","430593 CORONEL PILAR",0,0,0,12,0,12,"2020"
"60598","430595 COTIPORA",0,0,1,26,0,27,"2020"
"60599","430597 COXILHA",0,0,0,39,0,39,"2020"
"60600","430600 CRISSIUMAL",1,0,0,130,1,132,"2020"
"60601","430605 CRISTAL",0,1,1,76,1,79,"2020"
"60602","430607 CRISTAL DO SUL",0,0,0,39,0,39,"2020"
"60603","430610 CRUZ ALTA",3,1,7,769,1,781,"2020"
"60604","430613 CRUZALTENSE",0,0,2,15,0,17,"2020"
"60605","430620 CRUZEIRO DO SUL",0,1,1,129,0,131,"2020"
"60606","430630 DAVID CANABARRO",0,0,1,35,0,36,"2020"
"60607","430632 DERRUBADAS",0,0,2,30,0,32,"2020"
"60608","430635 DEZESSEIS DE NOVEMBRO",0,0,0,19,0,19,"2020"
"60609","430637 DILERMANDO DE AGUIAR",0,1,1,24,0,26,"2020"
"60610","430640 DOIS IRMAOS",0,1,7,395,1,404,"2020"
"60611","430642 DOIS IRMAOS DAS MISSOES",0,0,1,27,0,28,"2020"
"60612","430645 DOIS LAJEADOS",0,0,1,22,0,23,"2020"
"60613","430650 DOM FELICIANO",0,1,1,131,0,133,"2020"
"60614","430655 DOM PEDRO DE ALCANTARA",0,0,0,27,0,27,"2020"
"60615","430660 DOM PEDRITO",0,2,4,391,0,397,"2020"
"60616","430670 DONA FRANCISCA",0,0,0,27,0,27,"2020"
"60617","430673 DOUTOR MAURICIO CARDOSO",0,0,0,38,0,38,"2020"
"60618","430675 DOUTOR RICARDO",0,0,0,23,0,23,"2020"
"60619","430676 ELDORADO DO SUL",2,2,4,538,5,551,"2020"
"60620","430680 ENCANTADO",0,2,0,279,0,281,"2020"
"60621","430690 ENCRUZILHADA DO SUL",0,0,8,232,0,240,"2020"
"60622","430692 ENGENHO VELHO",0,0,1,29,0,30,"2020"
"60623","430693 ENTRE-IJUIS",0,0,1,118,1,120,"2020"
"60624","430695 ENTRE RIOS DO SUL",0,0,0,30,0,30,"2020"
"60625","430697 EREBANGO",0,0,0,51,0,51,"2020"
"60626","430700 ERECHIM",3,11,16,1277,3,1310,"2020"
"60627","430705 ERNESTINA",0,1,1,31,0,33,"2020"
"60628","430710 HERVAL",0,0,0,63,0,63,"2020"
"60629","430720 ERVAL GRANDE",0,0,0,52,0,52,"2020"
"60630","430730 ERVAL SECO",0,0,1,69,1,71,"2020"
"60631","430740 ESMERALDA",0,1,0,23,0,24,"2020"
"60632","430745 ESPERANCA DO SUL",0,0,1,38,0,39,"2020"
"60633","430750 ESPUMOSO",0,0,1,173,0,174,"2020"
"60634","430755 ESTACAO",2,0,1,65,0,68,"2020"
"60635","430760 ESTANCIA VELHA",0,2,6,513,0,521,"2020"
"60636","430770 ESTEIO",3,1,14,995,1,1014,"2020"
"60637","430780 ESTRELA",1,4,9,417,2,433,"2020"
"60638","430781 ESTRELA VELHA",0,0,0,37,0,37,"2020"
"60639","430783 EUGENIO DE CASTRO",0,0,0,30,1,31,"2020"
"60640","430786 FAGUNDES VARELA",0,0,0,23,0,23,"2020"
"60641","430790 FARROUPILHA",1,2,5,825,1,834,"2020"
"60642","430800 FAXINAL DO SOTURNO",1,0,1,60,0,62,"2020"
"60643","430805 FAXINALZINHO",0,0,1,20,0,21,"2020"
"60644","430807 FAZENDA VILANOVA",0,0,6,36,0,42,"2020"
"60645","430810 FELIZ",0,0,3,152,0,155,"2020"
"60646","430820 FLORES DA CUNHA",0,0,7,368,0,375,"2020"
"60647","430825 FLORIANO PEIXOTO",0,1,0,10,0,11,"2020"
"60648","430830 FONTOURA XAVIER",0,0,1,88,0,89,"2020"
"60649","430840 FORMIGUEIRO",0,0,3,71,0,74,"2020"
"60650","430843 FORQUETINHA",0,0,1,18,0,19,"2020"
"60651","430845 FORTALEZA DOS VALOS",0,0,1,47,0,48,"2020"
"60652","430850 FREDERICO WESTPHALEN",0,1,4,426,0,431,"2020"
"60653","430860 GARIBALDI",3,0,4,385,1,393,"2020"
"60654","430865 GARRUCHOS",0,0,0,16,0,16,"2020"
"60655","430870 GAURAMA",0,0,1,46,0,47,"2020"
"60656","430880 GENERAL CAMARA",0,0,0,80,0,80,"2020"
"60657","430885 GENTIL",0,0,0,28,0,28,"2020"
"60658","430890 GETULIO VARGAS",0,2,1,154,0,157,"2020"
"60659","430900 GIRUA",0,0,8,171,2,181,"2020"
"60660","430905 GLORINHA",0,0,2,73,1,76,"2020"
"60661","430910 GRAMADO",2,2,10,591,0,605,"2020"
"60662","430912 GRAMADO DOS LOUREIROS",0,0,1,36,0,37,"2020"
"60663","430915 GRAMADO XAVIER",0,1,1,37,0,39,"2020"
"60664","430920 GRAVATAI",4,18,30,3016,14,3082,"2020"
"60665","430925 GUABIJU",0,0,0,8,0,8,"2020"
"60666","430930 GUAIBA",3,5,22,1031,8,1069,"2020"
"60667","430940 GUAPORE",0,1,8,323,0,332,"2020"
"60668","430950 GUARANI DAS MISSOES",0,0,0,66,0,66,"2020"
"60669","430955 HARMONIA",0,0,0,50,0,50,"2020"
"60670","430957 HERVEIRAS",0,0,0,34,0,34,"2020"
"60671","430960 HORIZONTINA",0,0,1,223,0,224,"2020"
"60672","430965 HULHA NEGRA",1,0,0,54,0,55,"2020"
"60673","430970 HUMAITA",0,0,2,40,0,42,"2020"
"60674","430975 IBARAMA",0,0,0,37,0,37,"2020"
"60675","430980 IBIACA",0,0,0,49,0,49,"2020"
"60676","430990 IBIRAIARAS",0,0,1,67,0,68,"2020"
"60677","430995 IBIRAPUITA",0,0,1,36,0,37,"2020"
"60678","431000 IBIRUBA",0,1,2,253,0,256,"2020"
"60679","431010 IGREJINHA",0,0,2,539,0,541,"2020"
"60680","431020 IJUI",4,5,9,1060,1,1079,"2020"
"60681","431030 ILOPOLIS",0,0,0,45,0,45,"2020"
"60682","431033 IMBE",0,0,5,313,1,319,"2020"
"60683","431036 IMIGRANTE",0,1,1,23,0,25,"2020"
"60684","431040 INDEPENDENCIA",0,0,1,58,0,59,"2020"
"60685","431041 INHACORA",0,0,0,26,0,26,"2020"
"60686","431043 IPE",0,0,0,44,0,44,"2020"
"60687","431046 IPIRANGA DO SUL",0,0,1,11,0,12,"2020"
"60688","431050 IRAI",0,0,0,88,1,89,"2020"
"60689","431053 ITAARA",0,1,0,53,1,55,"2020"
"60690","431055 ITACURUBI",0,0,0,18,0,18,"2020"
"60691","431057 ITAPUCA",0,0,0,18,1,19,"2020"
"60692","431060 ITAQUI",0,3,7,475,1,486,"2020"
"60693","431065 ITATI",0,0,1,30,0,31,"2020"
"60694","431070 ITATIBA DO SUL",0,0,0,22,0,22,"2020"
"60695","431075 IVORA",0,0,0,8,0,8,"2020"
"60696","431080 IVOTI",0,0,3,227,0,230,"2020"
"60697","431085 JABOTICABA",0,0,0,39,0,39,"2020"
"60698","431087 JACUIZINHO",0,0,0,21,0,21,"2020"
"60699","431090 JACUTINGA",0,1,1,32,0,34,"2020"
"60700","431100 JAGUARAO",0,0,4,320,0,324,"2020"
"60701","431110 JAGUARI",0,0,1,84,0,85,"2020"
"60702","431112 JAQUIRANA",0,0,0,52,0,52,"2020"
"60703","431113 JARI",0,0,0,36,2,38,"2020"
"60704","431115 JOIA",0,0,0,69,0,69,"2020"
"60705","431120 JULIO DE CASTILHOS",0,4,2,205,0,211,"2020"
"60706","431123 LAGOA BONITA DO SUL",0,0,0,19,0,19,"2020"
"60707","431125 LAGOAO",0,1,0,54,0,55,"2020"
"60708","431127 LAGOA DOS TRES CANTOS",0,0,0,24,0,24,"2020"
"60709","431130 LAGOA VERMELHA",1,0,6,368,0,375,"2020"
"60710","431140 LAJEADO",1,4,18,1158,0,1181,"2020"
"60711","431142 LAJEADO DO BUGRE",0,0,0,30,0,30,"2020"
"60712","431150 LAVRAS DO SUL",0,1,0,69,2,72,"2020"
"60713","431160 LIBERATO SALZANO",0,1,1,52,0,54,"2020"
"60714","431162 LINDOLFO COLLOR",0,1,0,76,0,77,"2020"
"60715","431164 LINHA NOVA",0,0,1,5,0,6,"2020"
"60716","431170 MACHADINHO",0,0,0,58,0,58,"2020"
"60717","431171 MACAMBARA",0,0,0,61,0,61,"2020"
"60718","431173 MAMPITUBA",0,0,0,47,0,47,"2020"
"60719","431175 MANOEL VIANA",0,0,1,71,0,72,"2020"
"60720","431177 MAQUINE",0,0,1,84,1,86,"2020"
"60721","431179 MARATA",0,0,0,30,0,30,"2020"
"60722","431180 MARAU",0,3,9,551,2,565,"2020"
"60723","431190 MARCELINO RAMOS",0,0,0,42,0,42,"2020"
"60724","431198 MARIANA PIMENTEL",0,0,0,43,4,47,"2020"
"60725","431200 MARIANO MORO",0,0,0,17,0,17,"2020"
"60726","431205 MARQUES DE SOUZA",0,0,0,38,0,38,"2020"
"60727","431210 MATA",0,0,0,31,0,31,"2020"
"60728","431213 MATO CASTELHANO",0,0,0,41,0,41,"2020"
"60729","431215 MATO LEITAO",0,0,0,48,0,48,"2020"
"60730","431217 MATO QUEIMADO",0,0,0,21,0,21,"2020"
"60731","431220 MAXIMILIANO DE ALMEIDA",0,0,0,49,0,49,"2020"
"60732","431225 MINAS DO LEAO",0,1,0,83,0,84,"2020"
"60733","431230 MIRAGUAI",0,0,0,63,0,63,"2020"
"60734","431235 MONTAURI",0,0,0,11,0,11,"2020"
"60735","431237 MONTE ALEGRE DOS CAMPOS",0,0,0,33,0,33,"2020"
"60736","431238 MONTE BELO DO SUL",0,0,0,26,0,26,"2020"
"60737","431240 MONTENEGRO",3,4,20,801,0,828,"2020"
"60738","431242 MORMACO",0,0,0,19,0,19,"2020"
"60739","431244 MORRINHOS DO SUL",0,0,0,37,0,37,"2020"
"60740","431245 MORRO REDONDO",0,0,1,48,1,50,"2020"
"60741","431247 MORRO REUTER",0,0,1,63,0,64,"2020"
"60742","431250 MOSTARDAS",1,1,3,153,1,159,"2020"
"60743","431260 MUCUM",0,0,1,49,0,50,"2020"
"60744","431261 MUITOS CAPOES",0,0,1,37,0,38,"2020"
"60745","431262 MULITERNO",0,0,1,17,0,18,"2020"
"60746","431265 NAO-ME-TOQUE",0,1,1,240,0,242,"2020"
"60747","431267 NICOLAU VERGUEIRO",0,0,1,19,0,20,"2020"
"60748","431270 NONOAI",0,0,1,197,0,198,"2020"
"60749","431275 NOVA ALVORADA",0,0,0,35,0,35,"2020"
"60750","431280 NOVA ARACA",0,0,1,95,0,96,"2020"
"60751","431290 NOVA BASSANO",0,0,1,81,0,82,"2020"
"60752","431295 NOVA BOA VISTA",0,0,1,20,0,21,"2020"
"60753","431300 NOVA BRESCIA",0,0,0,19,0,19,"2020"
"60754","431301 NOVA CANDELARIA",0,1,1,33,0,35,"2020"
"60755","431303 NOVA ESPERANCA DO SUL",0,1,0,51,0,52,"2020"
"60756","431306 NOVA HARTZ",1,1,1,223,2,228,"2020"
"60757","431308 NOVA PADUA",0,1,0,17,0,18,"2020"
"60758","431310 NOVA PALMA",0,0,1,66,0,67,"2020"
"60759","431320 NOVA PETROPOLIS",1,1,3,245,0,250,"2020"
"60760","431330 NOVA PRATA",0,0,3,340,1,344,"2020"
"60761","431333 NOVA RAMADA",1,0,0,22,0,23,"2020"
"60762","431335 NOVA ROMA DO SUL",0,0,1,33,0,34,"2020"
"60763","431337 NOVA SANTA RITA",1,2,11,361,4,379,"2020"
"60764","431339 NOVO CABRAIS",0,1,0,51,0,52,"2020"
"60765","431340 NOVO HAMBURGO",10,8,48,2852,6,2924,"2020"
"60766","431342 NOVO MACHADO",0,0,0,27,0,27,"2020"
"60767","431344 NOVO TIRADENTES",0,0,0,17,0,17,"2020"
"60768","431346 NOVO XINGU",0,0,0,15,0,15,"2020"
"60769","431349 NOVO BARREIRO",0,0,0,47,0,47,"2020"
"60770","431350 OSORIO",1,2,5,620,0,628,"2020"
"60771","431360 PAIM FILHO",0,0,1,32,0,33,"2020"
"60772","431365 PALMARES DO SUL",0,1,0,137,1,139,"2020"
"60773","431370 PALMEIRA DAS MISSOES",1,0,7,466,1,475,"2020"
"60774","431380 PALMITINHO",0,0,0,85,0,85,"2020"
"60775","431390 PANAMBI",1,0,7,571,0,579,"2020"
"60776","431395 PANTANO GRANDE",0,1,1,106,0,108,"2020"
"60777","431400 PARAI",0,0,1,86,0,87,"2020"
"60778","431402 PARAISO DO SUL",0,0,2,62,1,65,"2020"
"60779","431403 PARECI NOVO",0,0,0,52,0,52,"2020"
"60780","431405 PAROBE",2,4,17,733,0,756,"2020"
"60781","431406 PASSA SETE",0,0,1,37,0,38,"2020"
"60782","431407 PASSO DO SOBRADO",0,0,0,57,0,57,"2020"
"60783","431410 PASSO FUNDO",8,8,55,2704,4,2779,"2020"
"60784","431413 PAULO BENTO",0,0,0,16,0,16,"2020"
"60785","431415 PAVERAMA",0,1,3,78,0,82,"2020"
"60786","431417 PEDRAS ALTAS",0,0,0,18,0,18,"2020"
"60787","431420 PEDRO OSORIO",1,0,1,77,0,79,"2020"
"60788","431430 PEJUCARA",0,0,1,44,0,45,"2020"
"60789","431440 PELOTAS",17,18,75,3633,5,3748,"2020"
"60790","431442 PICADA CAFE",0,0,1,38,0,39,"2020"
"60791","431445 PINHAL",0,0,0,45,0,45,"2020"
"60792","431446 PINHAL DA SERRA",0,0,0,20,0,20,"2020"
"60793","431447 PINHAL GRANDE",0,0,0,21,0,21,"2020"
"60794","431449 PINHEIRINHO DO VALE",0,0,2,49,0,51,"2020"
"60795","431450 PINHEIRO MACHADO",0,1,3,78,0,82,"2020"
"60796","431454 PINTO BANDEIRA",0,0,1,33,0,34,"2020"
"60797","431455 PIRAPO",0,0,0,13,0,13,"2020"
"60798","431460 PIRATINI",2,0,1,142,1,146,"2020"
"60799","431470 PLANALTO",0,0,2,126,0,128,"2020"
"60800","431475 POCO DAS ANTAS",0,0,0,20,0,20,"2020"
"60801","431477 PONTAO",0,0,0,26,0,26,"2020"
"60802","431478 PONTE PRETA",0,0,0,16,0,16,"2020"
"60803","431480 PORTAO",1,2,9,358,1,371,"2020"
"60804","431490 PORTO ALEGRE",68,83,341,15133,62,15687,"2020"
"60805","431500 PORTO LUCENA",0,0,0,36,1,37,"2020"
"60806","431505 PORTO MAUA",0,0,0,21,0,21,"2020"
"60807","431507 PORTO VERA CRUZ",0,0,0,13,0,13,"2020"
"60808","431510 PORTO XAVIER",0,0,2,125,0,127,"2020"
"60809","431513 POUSO NOVO",0,0,0,22,0,22,"2020"
"60810","431514 PRESIDENTE LUCENA",0,0,0,37,0,37,"2020"
"60811","431515 PROGRESSO",0,0,0,50,0,50,"2020"
"60812","431517 PROTASIO ALVES",0,0,0,13,0,13,"2020"
"60813","431520 PUTINGA",0,0,0,36,0,36,"2020"
"60814","431530 QUARAI",0,0,3,291,0,294,"2020"
"60815","431531 QUATRO IRMAOS",0,0,0,17,1,18,"2020"
"60816","431532 QUEVEDOS",0,0,0,17,0,17,"2020"
"60817","431535 QUINZE DE NOVEMBRO",0,0,0,41,0,41,"2020"
"60818","431540 REDENTORA",0,0,3,193,1,197,"2020"
"60819","431545 RELVADO",0,0,0,18,0,18,"2020"
"60820","431550 RESTINGA SECA",0,2,1,146,1,150,"2020"
"60821","431555 RIO DOS INDIOS",0,0,0,34,0,34,"2020"
"60822","431560 RIO GRANDE",9,8,66,2291,25,2399,"2020"
"60823","431570 RIO PARDO",0,1,3,376,1,381,"2020"
"60824","431575 RIOZINHO",0,0,0,48,0,48,"2020"
"60825","431580 ROCA SALES",1,0,2,109,0,112,"2020"
"60826","431590 RODEIO BONITO",0,0,2,109,0,111,"2020"
"60827","431595 ROLADOR",0,0,0,26,0,26,"2020"
"60828","431600 ROLANTE",0,1,3,266,1,271,"2020"
"60829","431610 RONDA ALTA",0,1,6,94,0,101,"2020"
"60830","431620 RONDINHA",0,0,1,63,0,64,"2020"
"60831","431630 ROQUE GONZALES",0,0,0,62,0,62,"2020"
"60832","431640 ROSARIO DO SUL",1,4,11,414,0,430,"2020"
"60833","431642 SAGRADA FAMILIA",0,0,0,27,0,27,"2020"
"60834","431643 SALDANHA MARINHO",0,0,0,27,0,27,"2020"
"60835","431645 SALTO DO JACUI",2,1,1,124,2,130,"2020"
"60836","431647 SALVADOR DAS MISSOES",0,0,0,28,0,28,"2020"
"60837","431650 SALVADOR DO SUL",0,0,2,73,0,75,"2020"
"60838","431660 SANANDUVA",0,1,2,161,0,164,"2020"
"60839","431670 SANTA BARBARA DO SUL",0,1,1,88,0,90,"2020"
"60840","431673 SANTA CECILIA DO SUL",0,0,0,15,0,15,"2020"
"60841","431675 SANTA CLARA DO SUL",0,0,1,76,0,77,"2020"
"60842","431680 SANTA CRUZ DO SUL",2,5,23,1451,1,1482,"2020"
"60843","431690 SANTA MARIA",9,21,57,3186,10,3283,"2020"
"60844","431695 SANTA MARIA DO HERVAL",0,1,1,46,0,48,"2020"
"60845","431697 SANTA MARGARIDA DO SUL",0,1,2,34,0,37,"2020"
"60846","431700 SANTANA DA BOA VISTA",0,0,2,49,1,52,"2020"
"60847","431710 SANT'ANA DO LIVRAMENTO",2,3,10,1017,14,1046,"2020"
"60848","431720 SANTA ROSA",2,0,19,964,4,989,"2020"
"60849","431725 SANTA TEREZA",0,0,0,9,0,9,"2020"
"60850","431730 SANTA VITORIA DO PALMAR",1,2,9,342,0,354,"2020"
"60851","431740 SANTIAGO",0,2,4,513,0,519,"2020"
"60852","431750 SANTO ANGELO",0,0,12,1008,4,1024,"2020"
"60853","431755 SANTO ANTONIO DO PALMA",0,1,0,25,0,26,"2020"
"60854","431760 SANTO ANTONIO DA PATRULHA",1,0,3,446,2,452,"2020"
"60855","431770 SANTO ANTONIO DAS MISSOES",0,0,0,108,0,108,"2020"
"60856","431775 SANTO ANTONIO DO PLANALTO",0,0,0,23,0,23,"2020"
"60857","431780 SANTO AUGUSTO",0,0,0,155,0,155,"2020"
"60858","431790 SANTO CRISTO",0,0,5,136,0,141,"2020"
"60859","431795 SANTO EXPEDITO DO SUL",0,0,0,24,0,24,"2020"
"60860","431800 SAO BORJA",0,0,2,723,1,726,"2020"
"60861","431805 SAO DOMINGOS DO SUL",0,0,0,25,0,25,"2020"
"60862","431810 SAO FRANCISCO DE ASSIS",1,2,4,133,1,141,"2020"
"60863","431820 SAO FRANCISCO DE PAULA",0,1,3,236,1,241,"2020"
"60864","431830 SAO GABRIEL",0,4,12,712,2,730,"2020"
"60865","431840 SAO JERONIMO",1,1,2,257,0,261,"2020"
"60866","431842 SAO JOAO DA URTIGA",0,0,2,46,0,48,"2020"
"60867","431843 SAO JOAO DO POLESINE",0,0,0,22,0,22,"2020"
"60868","431844 SAO JORGE",0,0,0,20,0,20,"2020"
"60869","431845 SAO JOSE DAS MISSOES",0,1,0,35,0,36,"2020"
"60870","431846 SAO JOSE DO HERVAL",0,0,0,18,0,18,"2020"
"60871","431848 SAO JOSE DO HORTENCIO",0,0,0,24,0,24,"2020"
"60872","431849 SAO JOSE DO INHACORA",0,0,0,20,0,20,"2020"
"60873","431850 SAO JOSE DO NORTE",1,1,12,287,3,304,"2020"
"60874","431860 SAO JOSE DO OURO",0,0,0,69,1,70,"2020"
"60875","431861 SAO JOSE DO SUL",0,0,0,16,0,16,"2020"
"60876","431862 SAO JOSE DOS AUSENTES",0,0,0,51,1,52,"2020"
"60877","431870 SAO LEOPOLDO",7,6,42,2712,3,2770,"2020"
"60878","431880 SAO LOURENCO DO SUL",0,3,4,418,0,425,"2020"
"60879","431890 SAO LUIZ GONZAGA",3,1,1,485,2,492,"2020"
"60880","431900 SAO MARCOS",0,0,4,213,1,218,"2020"
"60881","431910 SAO MARTINHO",0,0,1,64,0,65,"2020"
"60882","431912 SAO MARTINHO DA SERRA",1,0,0,20,0,21,"2020"
"60883","431915 SAO MIGUEL DAS MISSOES",1,0,3,77,1,82,"2020"
"60884","431920 SAO NICOLAU",0,0,1,55,0,56,"2020"
"60885","431930 SAO PAULO DAS MISSOES",0,0,2,44,0,46,"2020"
"60886","431935 SAO PEDRO DA SERRA",0,0,0,41,0,41,"2020"
"60887","431936 SAO PEDRO DAS MISSOES",0,0,1,12,0,13,"2020"
"60888","431937 SAO PEDRO DO BUTIA",0,0,2,23,0,25,"2020"
"60889","431940 SAO PEDRO DO SUL",0,2,4,168,0,174,"2020"
"60890","431950 SAO SEBASTIAO DO CAI",0,1,8,283,0,292,"2020"
"60891","431960 SAO SEPE",0,2,7,232,1,242,"2020"
"60892","431970 SAO VALENTIM",0,0,0,24,0,24,"2020"
"60893","431971 SAO VALENTIM DO SUL",0,0,0,23,0,23,"2020"
"60894","431973 SAO VALERIO DO SUL",0,1,0,43,0,44,"2020"
"60895","431975 SAO VENDELINO",0,0,1,25,0,26,"2020"
"60896","431980 SAO VICENTE DO SUL",0,0,4,74,0,78,"2020"
"60897","431990 SAPIRANGA",0,4,7,1133,0,1144,"2020"
"60898","432000 SAPUCAIA DO SUL",8,6,41,1572,2,1629,"2020"
"60899","432010 SARANDI",0,0,6,296,0,302,"2020"
"60900","432020 SEBERI",0,0,1,192,0,193,"2020"
"60901","432023 SEDE NOVA",0,0,0,31,0,31,"2020"
"60902","432026 SEGREDO",0,0,0,68,0,68,"2020"
"60903","432030 SELBACH",0,0,0,47,0,47,"2020"
"60904","432032 SENADOR SALGADO FILHO",0,0,0,26,0,26,"2020"
"60905","432035 SENTINELA DO SUL",0,0,0,48,1,49,"2020"
"60906","432040 SERAFINA CORREA",1,1,2,208,1,213,"2020"
"60907","432045 SERIO",0,0,0,22,0,22,"2020"
"60908","432050 SERTAO",0,0,0,61,0,61,"2020"
"60909","432055 SERTAO SANTANA",0,0,0,53,1,54,"2020"
"60910","432057 SETE DE SETEMBRO",0,0,0,12,0,12,"2020"
"60911","432060 SEVERIANO DE ALMEIDA",0,0,2,30,0,32,"2020"
"60912","432065 SILVEIRA MARTINS",0,0,1,20,0,21,"2020"
"60913","432067 SINIMBU",0,0,2,65,0,67,"2020"
"60914","432070 SOBRADINHO",0,3,2,203,0,208,"2020"
"60915","432080 SOLEDADE",1,1,5,366,0,373,"2020"
"60916","432085 TABAI",0,0,2,61,0,63,"2020"
"60917","432090 TAPEJARA",1,2,4,326,0,333,"2020"
"60918","432100 TAPERA",0,0,1,124,0,125,"2020"
"60919","432110 TAPES",3,2,1,159,1,166,"2020"
"60920","432120 TAQUARA",2,4,6,576,0,588,"2020"
"60921","432130 TAQUARI",1,0,1,271,0,273,"2020"
"60922","432132 TAQUARUCU DO SUL",0,0,1,38,0,39,"2020"
"60923","432135 TAVARES",0,1,0,54,1,56,"2020"
"60924","432140 TENENTE PORTELA",0,0,1,195,0,196,"2020"
"60925","432143 TERRA DE AREIA",0,0,3,127,0,130,"2020"
"60926","432145 TEUTONIA",0,1,4,400,2,407,"2020"
"60927","432146 TIO HUGO",0,0,0,46,0,46,"2020"
"60928","432147 TIRADENTES DO SUL",0,0,0,49,0,49,"2020"
"60929","432149 TOROPI",1,0,1,23,0,25,"2020"
"60930","432150 TORRES",5,3,10,544,0,562,"2020"
"60931","432160 TRAMANDAI",1,4,12,735,2,754,"2020"
"60932","432162 TRAVESSEIRO",0,1,0,15,0,16,"2020"
"60933","432163 TRES ARROIOS",0,0,1,16,0,17,"2020"
"60934","432166 TRES CACHOEIRAS",0,0,2,119,1,122,"2020"
"60935","432170 TRES COROAS",0,1,2,276,0,279,"2020"
"60936","432180 TRES DE MAIO",0,0,2,309,1,312,"2020"
"60937","432183 TRES FORQUILHAS",0,0,0,34,0,34,"2020"
"60938","432185 TRES PALMEIRAS",0,1,1,70,0,72,"2020"
"60939","432190 TRES PASSOS",0,3,7,288,0,298,"2020"
"60940","432195 TRINDADE DO SUL",0,0,2,77,0,79,"2020"
"60941","432200 TRIUNFO",0,1,3,293,1,298,"2020"
"60942","432210 TUCUNDUVA",0,0,2,53,0,55,"2020"
"60943","432215 TUNAS",0,0,0,52,1,53,"2020"
"60944","432218 TUPANCI DO SUL",0,0,0,15,0,15,"2020"
"60945","432220 TUPANCIRETA",0,1,2,226,0,229,"2020"
"60946","432225 TUPANDI",0,0,0,60,0,60,"2020"
"60947","432230 TUPARENDI",0,0,0,80,1,81,"2020"
"60948","432232 TURUCU",0,0,0,24,0,24,"2020"
"60949","432234 UBIRETAMA",0,0,0,13,0,13,"2020"
"60950","432235 UNIAO DA SERRA",0,0,1,8,0,9,"2020"
"60951","432237 UNISTALDA",0,0,0,16,0,16,"2020"
"60952","432240 URUGUAIANA",2,8,19,845,727,1601,"2020"
"60953","432250 VACARIA",3,3,9,990,2,1007,"2020"
"60954","432252 VALE VERDE",0,0,0,32,0,32,"2020"
"60955","432253 VALE DO SOL",0,0,1,85,0,86,"2020"
"60956","432254 VALE REAL",0,1,4,76,0,81,"2020"
"60957","432255 VANINI",0,0,2,18,0,20,"2020"
"60958","432260 VENANCIO AIRES",2,2,7,754,2,767,"2020"
"60959","432270 VERA CRUZ",0,0,7,265,0,272,"2020"
"60960","432280 VERANOPOLIS",1,1,2,239,1,244,"2020"
"60961","432285 VESPASIANO CORREA",0,0,1,12,0,13,"2020"
"60962","432290 VIADUTOS",0,0,0,35,1,36,"2020"
"60963","432300 VIAMAO",6,11,74,2456,26,2573,"2020"
"60964","432310 VICENTE DUTRA",0,0,0,45,0,45,"2020"
"60965","432320 VICTOR GRAEFF",0,0,0,27,0,27,"2020"
"60966","432330 VILA FLORES",0,0,2,35,0,37,"2020"
"60967","432335 VILA LANGARO",0,0,0,18,0,18,"2020"
"60968","432340 VILA MARIA",0,0,3,46,0,49,"2020"
"60969","432345 VILA NOVA DO SUL",0,0,1,24,1,26,"2020"
"60970","432350 VISTA ALEGRE",0,0,0,29,0,29,"2020"
"60971","432360 VISTA ALEGRE DO PRATA",0,0,0,9,0,9,"2020"
"60972","432370 VISTA GAUCHA",0,0,0,36,0,36,"2020"
"60973","432375 VITORIA DAS MISSOES",0,0,1,26,0,27,"2020"
"60974","432377 WESTFALIA",0,0,2,38,0,40,"2020"
"60975","432380 XANGRI-LA",0,0,0,233,2,235,"2020"
"60976","500020 AGUA CLARA",0,0,1,242,1,244,"2020"
"60977","500025 ALCINOPOLIS",0,0,1,41,0,42,"2020"
"60978","500060 AMAMBAI",1,3,8,613,1,626,"2020"
"60979","500070 ANASTACIO",1,0,4,363,2,370,"2020"
"60980","500080 ANAURILANDIA",0,1,0,54,0,55,"2020"
"60981","500085 ANGELICA",0,0,1,127,0,128,"2020"
"60982","500090 ANTONIO JOAO",0,0,7,164,3,174,"2020"
"60983","500100 APARECIDA DO TABOADO",0,0,3,381,0,384,"2020"
"60984","500110 AQUIDAUANA",2,1,3,727,5,738,"2020"
"60985","500124 ARAL MOREIRA",1,1,14,146,7,169,"2020"
"60986","500150 BANDEIRANTES",0,0,1,85,1,87,"2020"
"60987","500190 BATAGUASSU",3,1,2,455,0,461,"2020"
"60988","500200 BATAYPORA",3,0,0,142,1,146,"2020"
"60989","500210 BELA VISTA",0,2,2,386,1,391,"2020"
"60990","500215 BODOQUENA",0,1,0,113,0,114,"2020"
"60991","500220 BONITO",0,3,1,343,0,347,"2020"
"60992","500230 BRASILANDIA",0,0,2,161,0,163,"2020"
"60993","500240 CAARAPO",0,2,3,540,0,545,"2020"
"60994","500260 CAMAPUA",1,1,2,149,0,153,"2020"
"60995","500270 CAMPO GRANDE",22,18,97,12871,17,13025,"2020"
"60996","500280 CARACOL",0,0,1,56,1,58,"2020"
"60997","500290 CASSILANDIA",0,1,6,246,0,253,"2020"
"60998","500295 CHAPADAO DO SUL",0,2,9,509,2,522,"2020"
"60999","500310 CORGUINHO",0,0,0,39,0,39,"2020"
"61000","500315 CORONEL SAPUCAIA",1,2,7,343,25,378,"2020"
"61001","500320 CORUMBA",2,4,27,1713,3,1749,"2020"
"61002","500325 COSTA RICA",1,3,5,462,0,471,"2020"
"61003","500330 COXIM",0,3,2,468,0,473,"2020"
"61004","500345 DEODAPOLIS",0,1,1,153,0,155,"2020"
"61005","500348 DOIS IRMAOS DO BURITI",0,1,0,148,0,149,"2020"
"61006","500350 DOURADINA",0,0,2,65,2,69,"2020"
"61007","500370 DOURADOS",8,17,59,3685,16,3785,"2020"
"61008","500375 ELDORADO",0,0,0,176,0,176,"2020"
"61009","500380 FATIMA DO SUL",0,0,3,252,0,255,"2020"
"61010","500390 FIGUEIRAO",0,0,0,43,0,43,"2020"
"61011","500400 GLORIA DE DOURADOS",0,0,2,98,0,100,"2020"
"61012","500410 GUIA LOPES DA LAGUNA",0,0,1,115,0,116,"2020"
"61013","500430 IGUATEMI",1,0,1,208,2,212,"2020"
"61014","500440 INOCENCIA",0,0,0,98,0,98,"2020"
"61015","500450 ITAPORA",0,2,3,260,0,265,"2020"
"61016","500460 ITAQUIRAI",2,2,2,250,0,256,"2020"
"61017","500470 IVINHEMA",0,1,1,409,0,411,"2020"
"61018","500480 JAPORA",0,0,17,144,0,161,"2020"
"61019","500490 JARAGUARI",0,0,0,59,0,59,"2020"
"61020","500500 JARDIM",0,1,0,415,0,416,"2020"
"61021","500510 JATEI",0,1,1,46,0,48,"2020"
"61022","500515 JUTI",0,1,1,104,0,106,"2020"
"61023","500520 LADARIO",1,0,2,341,1,345,"2020"
"61024","500525 LAGUNA CARAPA",3,1,1,106,1,112,"2020"
"61025","500540 MARACAJU",0,2,3,709,0,714,"2020"
"61026","500560 MIRANDA",1,1,2,471,5,480,"2020"
"61027","500568 MUNDO NOVO",0,1,114,148,1,264,"2020"
"61028","500570 NAVIRAI",2,1,4,747,1,755,"2020"
"61029","500580 NIOAQUE",0,1,1,159,3,164,"2020"
"61030","500600 NOVA ALVORADA DO SUL",0,1,6,309,1,317,"2020"
"61031","500620 NOVA ANDRADINA",2,0,5,762,0,769,"2020"
"61032","500625 NOVO HORIZONTE DO SUL",0,0,0,72,0,72,"2020"
"61033","500627 PARAISO DAS AGUAS",0,0,0,65,0,65,"2020"
"61034","500630 PARANAIBA",0,1,2,512,0,515,"2020"
"61035","500635 PARANHOS",1,1,7,252,54,315,"2020"
"61036","500640 PEDRO GOMES",0,0,1,89,0,90,"2020"
"61037","500660 PONTA PORA",5,3,24,1582,2,1616,"2020"
"61038","500690 PORTO MURTINHO",0,0,0,219,0,219,"2020"
"61039","500710 RIBAS DO RIO PARDO",0,0,6,289,1,296,"2020"
"61040","500720 RIO BRILHANTE",0,2,5,626,0,633,"2020"
"61041","500730 RIO NEGRO",1,0,0,52,1,54,"2020"
"61042","500740 RIO VERDE DE MATO GROSSO",0,2,1,294,1,298,"2020"
"61043","500750 ROCHEDO",0,0,1,72,0,73,"2020"
"61044","500755 SANTA RITA DO PARDO",1,0,1,32,1,35,"2020"
"61045","500769 SAO GABRIEL DO OESTE",1,1,11,514,0,527,"2020"
"61046","500770 SETE QUEDAS",0,0,2,135,1,138,"2020"
"61047","500780 SELVIRIA",0,1,0,72,0,73,"2020"
"61048","500790 SIDROLANDIA",3,0,3,662,2,670,"2020"
"61049","500793 SONORA",1,1,2,210,1,215,"2020"
"61050","500795 TACURU",0,0,2,175,0,177,"2020"
"61051","500797 TAQUARUSSU",0,0,1,28,0,29,"2020"
"61052","500800 TERENOS",0,0,4,170,0,174,"2020"
"61053","500830 TRES LAGOAS",4,5,19,1811,0,1839,"2020"
"61054","500840 VICENTINA",0,0,0,80,0,80,"2020"
"61055","MUNICIPIO IGNORADO - MT",0,0,0,1,0,1,"2020"
"61056","510010 ACORIZAL",0,0,5,53,0,58,"2020"
"61057","510020 AGUA BOA",1,2,6,403,14,426,"2020"
"61058","510025 ALTA FLORESTA",1,2,6,885,0,894,"2020"
"61059","510030 ALTO ARAGUAIA",0,1,2,193,1,197,"2020"
"61060","510035 ALTO BOA VISTA",0,0,0,65,26,91,"2020"
"61061","510040 ALTO GARCAS",0,1,1,136,3,141,"2020"
"61062","510050 ALTO PARAGUAI",0,0,0,76,0,76,"2020"
"61063","510060 ALTO TAQUARI",0,0,7,139,0,146,"2020"
"61064","510080 APIACAS",0,0,2,120,0,122,"2020"
"61065","510100 ARAGUAIANA",0,0,1,42,0,43,"2020"
"61066","510120 ARAGUAINHA",0,0,0,8,0,8,"2020"
"61067","510125 ARAPUTANGA",0,0,1,254,0,255,"2020"
"61068","510130 ARENAPOLIS",0,1,3,100,0,104,"2020"
"61069","510140 ARIPUANA",0,1,0,387,1,389,"2020"
"61070","510160 BARAO DE MELGACO",0,0,1,55,0,56,"2020"
"61071","510170 BARRA DO BUGRES",0,4,6,441,2,453,"2020"
"61072","510180 BARRA DO GARCAS",2,2,16,1058,9,1087,"2020"
"61073","510185 BOM JESUS DO ARAGUAIA",0,0,2,90,0,92,"2020"
"61074","510190 BRASNORTE",0,0,11,318,13,342,"2020"
"61075","510250 CACERES",4,8,6,1492,7,1517,"2020"
"61076","510260 CAMPINAPOLIS",1,0,19,235,180,435,"2020"
"61077","510263 CAMPO NOVO DO PARECIS",0,6,24,759,1,790,"2020"
"61078","510267 CAMPO VERDE",1,1,10,772,0,784,"2020"
"61079","510268 CAMPOS DE JULIO",0,0,2,118,0,120,"2020"
"61080","510269 CANABRAVA DO NORTE",0,0,1,64,0,65,"2020"
"61081","510270 CANARANA",0,0,8,398,30,436,"2020"
"61082","510279 CARLINDA",0,0,0,129,0,129,"2020"
"61083","510285 CASTANHEIRA",0,0,1,109,0,110,"2020"
"61084","510300 CHAPADA DOS GUIMARAES",0,1,2,259,1,263,"2020"
"61085","510305 CLAUDIA",0,0,2,133,0,135,"2020"
"61086","510310 COCALINHO",0,0,1,68,0,69,"2020"
"61087","510320 COLIDER",1,3,11,478,0,493,"2020"
"61088","510325 COLNIZA",1,1,8,460,1,471,"2020"
"61089","510330 COMODORO",1,0,2,337,23,363,"2020"
"61090","510335 CONFRESA",0,4,8,604,5,621,"2020"
"61091","510336 CONQUISTA D'OESTE",0,0,1,61,1,63,"2020"
"61092","510337 COTRIGUACU",0,1,0,157,0,158,"2020"
"61093","510340 CUIABA",22,23,108,9670,5,9828,"2020"
"61094","510343 CURVELANDIA",0,0,0,67,0,67,"2020"
"61095","510345 DENISE",0,1,1,96,0,98,"2020"
"61096","510350 DIAMANTINO",1,0,1,386,0,388,"2020"
"61097","510360 DOM AQUINO",0,2,1,74,0,77,"2020"
"61098","510370 FELIZ NATAL",0,0,2,186,19,207,"2020"
"61099","510380 FIGUEIROPOLIS D'OESTE",0,0,0,44,0,44,"2020"
"61100","510385 GAUCHA DO NORTE",0,0,3,138,18,159,"2020"
"61101","510390 GENERAL CARNEIRO",0,1,2,120,4,127,"2020"
"61102","510395 GLORIA D'OESTE",0,0,1,26,0,27,"2020"
"61103","510410 GUARANTA DO NORTE",1,1,13,499,0,514,"2020"
"61104","510420 GUIRATINGA",0,0,1,96,0,97,"2020"
"61105","510450 INDIAVAI",0,0,0,20,0,20,"2020"
"61106","510452 IPIRANGA DO NORTE",0,1,0,126,0,127,"2020"
"61107","510454 ITANHANGA",0,0,1,102,1,104,"2020"
"61108","510455 ITAUBA",1,0,1,69,0,71,"2020"
"61109","510460 ITIQUIRA",2,1,2,163,0,168,"2020"
"61110","510480 JACIARA",1,1,4,426,2,434,"2020"
"61111","510490 JANGADA",0,0,0,105,0,105,"2020"
"61112","510500 JAURU",1,1,0,119,0,121,"2020"
"61113","510510 JUARA",0,0,6,534,3,543,"2020"
"61114","510515 JUINA",1,2,26,703,1,733,"2020"
"61115","510517 JURUENA",0,0,4,155,0,159,"2020"
"61116","510520 JUSCIMEIRA",0,0,1,141,0,142,"2020"
"61117","510523 LAMBARI D'OESTE",1,0,0,71,2,74,"2020"
"61118","510525 LUCAS DO RIO VERDE",3,3,19,1385,0,1410,"2020"
"61119","510530 LUCIARA",0,1,1,31,1,34,"2020"
"61120","510550 VILA BELA DA SANTISSIMA TRINDADE",0,0,2,233,10,245,"2020"
"61121","510558 MARCELANDIA",0,4,3,202,9,218,"2020"
"61122","510560 MATUPA",0,1,6,352,0,359,"2020"
"61123","510562 MIRASSOL D'OESTE",0,1,3,408,0,412,"2020"
"61124","510590 NOBRES",0,0,5,252,0,257,"2020"
"61125","510600 NORTELANDIA",0,1,1,70,0,72,"2020"
"61126","510610 NOSSA SENHORA DO LIVRAMENTO",0,0,0,126,0,126,"2020"
"61127","510615 NOVA BANDEIRANTES",0,1,1,170,0,172,"2020"
"61128","510617 NOVA NAZARE",1,1,0,56,44,102,"2020"
"61129","510618 NOVA LACERDA",0,0,2,93,1,96,"2020"
"61130","510619 NOVA SANTA HELENA",0,1,2,54,0,57,"2020"
"61131","510620 NOVA BRASILANDIA",0,0,0,38,0,38,"2020"
"61132","510621 NOVA CANAA DO NORTE",0,0,7,177,0,184,"2020"
"61133","510622 NOVA MUTUM",1,0,7,981,0,989,"2020"
"61134","510623 NOVA OLIMPIA",0,1,7,251,0,259,"2020"
"61135","510624 NOVA UBIRATA",0,0,1,161,0,162,"2020"
"61136","510625 NOVA XAVANTINA",0,1,0,321,1,323,"2020"
"61137","510626 NOVO MUNDO",0,0,3,101,0,104,"2020"
"61138","510627 NOVO HORIZONTE DO NORTE",0,0,0,33,0,33,"2020"
"61139","510628 NOVO SAO JOAQUIM",0,0,0,104,0,104,"2020"
"61140","510629 PARANAITA",0,0,2,186,0,188,"2020"
"61141","510630 PARANATINGA",2,0,4,366,17,389,"2020"
"61142","510631 NOVO SANTO ANTONIO",0,0,0,28,0,28,"2020"
"61143","510637 PEDRA PRETA",2,0,4,229,2,237,"2020"
"61144","510642 PEIXOTO DE AZEVEDO",1,5,13,591,0,610,"2020"
"61145","510645 PLANALTO DA SERRA",0,0,0,36,0,36,"2020"
"61146","510650 POCONE",1,2,9,481,1,494,"2020"
"61147","510665 PONTAL DO ARAGUAIA",1,0,2,78,0,81,"2020"
"61148","510670 PONTE BRANCA",0,0,0,16,0,16,"2020"
"61149","510675 PONTES E LACERDA",5,0,5,846,3,859,"2020"
"61150","510677 PORTO ALEGRE DO NORTE",0,1,2,163,0,166,"2020"
"61151","510680 PORTO DOS GAUCHOS",0,0,2,82,0,84,"2020"
"61152","510682 PORTO ESPERIDIAO",0,1,0,148,4,153,"2020"
"61153","510685 PORTO ESTRELA",0,0,0,38,0,38,"2020"
"61154","510700 POXOREO",0,2,1,253,2,258,"2020"
"61155","510704 PRIMAVERA DO LESTE",2,1,7,1392,3,1405,"2020"
"61156","510706 QUERENCIA",1,0,2,458,24,485,"2020"
"61157","510710 SAO JOSE DOS QUATRO MARCOS",0,0,2,210,0,212,"2020"
"61158","510715 RESERVA DO CABACAL",0,0,0,17,0,17,"2020"
"61159","510718 RIBEIRAO CASCALHEIRA",1,0,0,138,32,171,"2020"
"61160","510719 RIBEIRAOZINHO",0,0,1,41,0,42,"2020"
"61161","510720 RIO BRANCO",0,0,0,70,0,70,"2020"
"61162","510724 SANTA CARMEM",0,0,2,77,0,79,"2020"
"61163","510726 SANTO AFONSO",0,0,0,27,0,27,"2020"
"61164","510729 SAO JOSE DO POVO",0,0,0,21,2,23,"2020"
"61165","510730 SAO JOSE DO RIO CLARO",1,2,1,250,0,254,"2020"
"61166","510735 SAO JOSE DO XINGU",1,0,2,119,3,125,"2020"
"61167","510740 SAO PEDRO DA CIPA",0,0,0,56,0,56,"2020"
"61168","510757 RONDOLANDIA",0,0,0,35,0,35,"2020"
"61169","510760 RONDONOPOLIS",9,15,42,3743,19,3828,"2020"
"61170","510770 ROSARIO OESTE",0,1,1,162,0,164,"2020"
"61171","510774 SANTA CRUZ DO XINGU",0,0,0,34,0,34,"2020"
"61172","510775 SALTO DO CEU",0,1,0,56,0,57,"2020"
"61173","510776 SANTA RITA DO TRIVELATO",0,0,2,41,0,43,"2020"
"61174","510777 SANTA TEREZINHA",0,0,2,114,4,120,"2020"
"61175","510779 SANTO ANTONIO DO LESTE",0,0,0,50,10,60,"2020"
"61176","510780 SANTO ANTONIO DO LEVERGER",0,2,2,218,0,222,"2020"
"61177","510785 SAO FELIX DO ARAGUAIA",0,0,3,147,7,157,"2020"
"61178","510787 SAPEZAL",2,1,10,573,3,589,"2020"
"61179","510788 SERRA NOVA DOURADA",0,0,0,17,1,18,"2020"
"61180","510790 SINOP",0,14,31,3088,3,3136,"2020"
"61181","510792 SORRISO",2,3,30,1921,3,1959,"2020"
"61182","510794 TABAPORA",0,0,0,132,0,132,"2020"
"61183","510795 TANGARA DA SERRA",2,4,29,1636,2,1673,"2020"
"61184","510800 TAPURAH",1,0,0,223,1,225,"2020"
"61185","510805 TERRA NOVA DO NORTE",0,1,7,149,0,157,"2020"
"61186","510810 TESOURO",0,0,0,26,1,27,"2020"
"61187","510820 TORIXOREU",0,0,1,38,0,39,"2020"
"61188","510830 UNIAO DO SUL",0,0,1,47,1,49,"2020"
"61189","510835 VALE DE SAO DOMINGOS",0,1,0,30,0,31,"2020"
"61190","510840 VARZEA GRANDE",8,18,62,4628,17,4733,"2020"
"61191","510850 VERA",0,1,5,156,1,163,"2020"
"61192","510860 VILA RICA",2,0,3,307,1,313,"2020"
"61193","510880 NOVA GUARITA",0,1,4,67,0,72,"2020"
"61194","510885 NOVA MARILANDIA",0,0,0,33,0,33,"2020"
"61195","510890 NOVA MARINGA",0,0,1,68,0,69,"2020"
"61196","510895 NOVA MONTE VERDE",0,0,1,102,0,103,"2020"
"61197","MUNICIPIO IGNORADO - GO",1,0,0,0,0,1,"2020"
"61198","520005 ABADIA DE GOIAS",3,0,5,244,2,254,"2020"
"61199","520010 ABADIANIA",1,1,5,177,3,187,"2020"
"61200","520013 ACREUNA",1,1,87,161,3,253,"2020"
"61201","520015 ADELANDIA",0,0,0,17,0,17,"2020"
"61202","520017 AGUA FRIA DE GOIAS",0,0,0,64,1,65,"2020"
"61203","520020 AGUA LIMPA",0,0,1,10,0,11,"2020"
"61204","520025 AGUAS LINDAS DE GOIAS",3,21,62,2717,122,2925,"2020"
"61205","520030 ALEXANIA",0,0,2,409,1,412,"2020"
"61206","520050 ALOANDIA",0,0,1,28,0,29,"2020"
"61207","520055 ALTO HORIZONTE",0,0,3,119,0,122,"2020"
"61208","520060 ALTO PARAISO DE GOIAS",1,0,1,131,6,139,"2020"
"61209","520080 ALVORADA DO NORTE",1,0,3,138,0,142,"2020"
"61210","520082 AMARALINA",0,0,1,19,0,20,"2020"
"61211","520085 AMERICANO DO BRASIL",0,0,0,96,0,96,"2020"
"61212","520090 AMORINOPOLIS",0,1,0,33,0,34,"2020"
"61213","520110 ANAPOLIS",16,12,108,5481,10,5627,"2020"
"61214","520120 ANHANGUERA",0,0,0,8,0,8,"2020"
"61215","520130 ANICUNS",1,0,1,189,0,191,"2020"
"61216","520140 APARECIDA DE GOIANIA",28,19,83,7110,41,7281,"2020"
"61217","520145 APARECIDA DO RIO DOCE",0,0,0,31,0,31,"2020"
"61218","520150 APORE",0,1,1,49,0,51,"2020"
"61219","520160 ARACU",0,0,0,24,1,25,"2020"
"61220","520170 ARAGARCAS",0,0,3,196,0,199,"2020"
"61221","520180 ARAGOIANIA",0,0,0,136,2,138,"2020"
"61222","520215 ARAGUAPAZ",0,0,0,51,0,51,"2020"
"61223","520235 ARENOPOLIS",0,0,1,35,1,37,"2020"
"61224","520250 ARUANA",1,0,0,95,1,97,"2020"
"61225","520260 AURILANDIA",0,0,0,31,0,31,"2020"
"61226","520280 AVELINOPOLIS",0,0,0,23,0,23,"2020"
"61227","520310 BALIZA",0,0,0,33,0,33,"2020"
"61228","520320 BARRO ALTO",0,0,6,156,0,162,"2020"
"61229","520330 BELA VISTA DE GOIAS",3,1,4,466,0,474,"2020"
"61230","520340 BOM JARDIM DE GOIAS",1,0,1,90,0,92,"2020"
"61231","520350 BOM JESUS DE GOIAS",1,0,6,310,0,317,"2020"
"61232","520355 BONFINOPOLIS",1,1,0,108,0,110,"2020"
"61233","520357 BONOPOLIS",0,0,1,39,0,40,"2020"
"61234","520360 BRAZABRANTES",0,0,0,48,0,48,"2020"
"61235","520380 BRITANIA",0,0,1,79,1,81,"2020"
"61236","520390 BURITI ALEGRE",0,1,0,120,1,122,"2020"
"61237","520393 BURITI DE GOIAS",0,0,0,29,0,29,"2020"
"61238","520396 BURITINOPOLIS",0,0,1,44,0,45,"2020"
"61239","520400 CABECEIRAS",0,0,2,98,0,100,"2020"
"61240","520410 CACHOEIRA ALTA",1,0,1,152,0,154,"2020"
"61241","520420 CACHOEIRA DE GOIAS",0,0,0,20,0,20,"2020"
"61242","520425 CACHOEIRA DOURADA",0,0,0,91,1,92,"2020"
"61243","520430 CACU",1,0,3,157,0,161,"2020"
"61244","520440 CAIAPONIA",0,0,8,166,0,174,"2020"
"61245","520450 CALDAS NOVAS",3,4,15,1262,2,1286,"2020"
"61246","520455 CALDAZINHA",0,0,0,45,0,45,"2020"
"61247","520460 CAMPESTRE DE GOIAS",0,2,0,43,0,45,"2020"
"61248","520465 CAMPINACU",0,0,0,40,0,40,"2020"
"61249","520470 CAMPINORTE",0,1,4,126,0,131,"2020"
"61250","520480 CAMPO ALEGRE DE GOIAS",0,0,1,73,0,74,"2020"
"61251","520485 CAMPO LIMPO DE GOIAS",1,0,2,129,0,132,"2020"
"61252","520490 CAMPOS BELOS",1,0,8,269,0,278,"2020"
"61253","520495 CAMPOS VERDES",0,1,1,51,0,53,"2020"
"61254","520500 CARMO DO RIO VERDE",1,0,2,94,1,98,"2020"
"61255","520505 CASTELANDIA",0,0,0,35,0,35,"2020"
"61256","520510 CATALAO",4,3,18,1435,0,1460,"2020"
"61257","520520 CATURAI",0,1,2,55,0,58,"2020"
"61258","520530 CAVALCANTE",0,0,1,137,5,143,"2020"
"61259","520540 CERES",1,1,2,244,0,248,"2020"
"61260","520545 CEZARINA",0,1,1,92,0,94,"2020"
"61261","520547 CHAPADAO DO CEU",1,0,7,228,0,236,"2020"
"61262","520549 CIDADE OCIDENTAL",1,6,19,1139,15,1180,"2020"
"61263","520551 COCALZINHO DE GOIAS",0,0,5,194,57,256,"2020"
"61264","520552 COLINAS DO SUL",0,0,0,36,0,36,"2020"
"61265","520570 CORREGO DO OURO",0,0,0,25,0,25,"2020"
"61266","520580 CORUMBA DE GOIAS",0,0,2,95,1,98,"2020"
"61267","520590 CORUMBAIBA",0,0,2,93,0,95,"2020"
"61268","520620 CRISTALINA",3,3,11,946,17,980,"2020"
"61269","520630 CRISTIANOPOLIS",0,0,1,38,0,39,"2020"
"61270","520640 CRIXAS",0,2,1,215,0,218,"2020"
"61271","520650 CROMINIA",0,0,0,42,0,42,"2020"
"61272","520660 CUMARI",0,0,0,24,0,24,"2020"
"61273","520670 DAMIANOPOLIS",0,0,1,54,0,55,"2020"
"61274","520680 DAMOLANDIA",0,0,2,28,0,30,"2020"
"61275","520690 DAVINOPOLIS",0,0,0,14,0,14,"2020"
"61276","520710 DIORAMA",0,0,0,28,0,28,"2020"
"61277","520725 DOVERLANDIA",1,0,3,64,0,68,"2020"
"61278","520735 EDEALINA",0,0,0,36,0,36,"2020"
"61279","520740 EDEIA",1,0,0,166,0,167,"2020"
"61280","520750 ESTRELA DO NORTE",0,0,1,31,0,32,"2020"
"61281","520753 FAINA",0,1,1,62,0,64,"2020"
"61282","520760 FAZENDA NOVA",0,0,0,59,0,59,"2020"
"61283","520780 FIRMINOPOLIS",0,0,0,96,1,97,"2020"
"61284","520790 FLORES DE GOIAS",1,0,1,97,2,101,"2020"
"61285","520800 FORMOSA",1,4,32,1648,13,1698,"2020"
"61286","520810 FORMOSO",0,0,0,67,0,67,"2020"
"61287","520815 GAMELEIRA DE GOIAS",0,0,2,44,0,46,"2020"
"61288","520830 DIVINOPOLIS DE GOIAS",0,0,1,56,0,57,"2020"
"61289","520840 GOIANAPOLIS",0,2,3,182,1,188,"2020"
"61290","520850 GOIANDIRA",0,0,0,35,0,35,"2020"
"61291","520860 GOIANESIA",1,2,18,1012,0,1033,"2020"
"61292","520870 GOIANIA",69,43,209,18937,64,19322,"2020"
"61293","520880 GOIANIRA",1,3,11,961,0,976,"2020"
"61294","520890 GOIAS",0,1,2,212,3,218,"2020"
"61295","520910 GOIATUBA",1,2,3,427,1,434,"2020"
"61296","520915 GOUVELANDIA",0,0,0,46,0,46,"2020"
"61297","520920 GUAPO",0,0,4,207,1,212,"2020"
"61298","520929 GUARAITA",0,0,0,25,0,25,"2020"
"61299","520940 GUARANI DE GOIAS",0,1,1,46,0,48,"2020"
"61300","520945 GUARINOS",0,0,0,12,0,12,"2020"
"61301","520960 HEITORAI",0,1,0,36,0,37,"2020"
"61302","520970 HIDROLANDIA",2,3,4,321,0,330,"2020"
"61303","520980 HIDROLINA",0,0,0,24,0,24,"2020"
"61304","520990 IACIARA",1,1,3,169,1,175,"2020"
"61305","520993 INACIOLANDIA",0,1,1,65,0,67,"2020"
"61306","520995 INDIARA",1,0,2,193,0,196,"2020"
"61307","521000 INHUMAS",1,7,6,616,1,631,"2020"
"61308","521010 IPAMERI",0,2,2,304,1,309,"2020"
"61309","521015 IPIRANGA DE GOIAS",0,0,0,27,0,27,"2020"
"61310","521020 IPORA",4,2,1,478,1,486,"2020"
"61311","521030 ISRAELANDIA",0,0,0,18,0,18,"2020"
"61312","521040 ITABERAI",3,1,10,567,1,582,"2020"
"61313","521056 ITAGUARI",0,0,0,50,0,50,"2020"
"61314","521060 ITAGUARU",0,1,0,52,0,53,"2020"
"61315","521080 ITAJA",0,0,0,54,0,54,"2020"
"61316","521090 ITAPACI",2,0,6,294,0,302,"2020"
"61317","521100 ITAPIRAPUA",0,0,0,78,1,79,"2020"
"61318","521120 ITAPURANGA",0,0,1,305,1,307,"2020"
"61319","521130 ITARUMA",1,0,0,88,0,89,"2020"
"61320","521140 ITAUCU",0,1,1,82,0,84,"2020"
"61321","521150 ITUMBIARA",3,4,15,1322,3,1347,"2020"
"61322","521160 IVOLANDIA",0,0,1,20,0,21,"2020"
"61323","521170 JANDAIA",0,0,0,63,0,63,"2020"
"61324","521180 JARAGUA",1,1,4,518,0,524,"2020"
"61325","521190 JATAI",3,6,19,1387,2,1417,"2020"
"61326","521200 JAUPACI",0,0,0,36,0,36,"2020"
"61327","521205 JESUPOLIS",0,0,0,18,1,19,"2020"
"61328","521210 JOVIANIA",0,0,0,102,0,102,"2020"
"61329","521220 JUSSARA",0,1,2,233,0,236,"2020"
"61330","521225 LAGOA SANTA",0,0,0,11,0,11,"2020"
"61331","521230 LEOPOLDO DE BULHOES",1,1,0,90,0,92,"2020"
"61332","521250 LUZIANIA",6,10,64,2740,55,2875,"2020"
"61333","521260 MAIRIPOTABA",0,0,1,27,0,28,"2020"
"61334","521270 MAMBAI",0,0,3,120,1,124,"2020"
"61335","521280 MARA ROSA",0,1,1,125,0,127,"2020"
"61336","521290 MARZAGAO",0,1,1,38,1,41,"2020"
"61337","521295 MATRINCHA",1,0,1,60,0,62,"2020"
"61338","521300 MAURILANDIA",1,1,1,161,1,165,"2020"
"61339","521305 MIMOSO DE GOIAS",0,0,1,11,6,18,"2020"
"61340","521308 MINACU",0,2,2,366,0,370,"2020"
"61341","521310 MINEIROS",5,1,9,1056,0,1071,"2020"
"61342","521340 MOIPORA",0,0,0,16,0,16,"2020"
"61343","521350 MONTE ALEGRE DE GOIAS",2,1,1,86,1,91,"2020"
"61344","521370 MONTES CLAROS DE GOIAS",0,0,1,87,0,88,"2020"
"61345","521375 MONTIVIDIU",1,1,1,150,0,153,"2020"
"61346","521377 MONTIVIDIU DO NORTE",0,0,0,52,0,52,"2020"
"61347","521380 MORRINHOS",1,5,3,610,0,619,"2020"
"61348","521385 MORRO AGUDO DE GOIAS",0,0,0,32,0,32,"2020"
"61349","521390 MOSSAMEDES",0,0,0,48,0,48,"2020"
"61350","521400 MOZARLANDIA",0,1,2,242,0,245,"2020"
"61351","521405 MUNDO NOVO",0,0,0,67,0,67,"2020"
"61352","521410 MUTUNOPOLIS",0,0,2,49,0,51,"2020"
"61353","521440 NAZARIO",0,0,0,94,0,94,"2020"
"61354","521450 NEROPOLIS",3,4,8,451,0,466,"2020"
"61355","521460 NIQUELANDIA",1,4,11,417,0,433,"2020"
"61356","521470 NOVA AMERICA",0,0,1,34,0,35,"2020"
"61357","521480 NOVA AURORA",0,0,0,7,0,7,"2020"
"61358","521483 NOVA CRIXAS",1,0,1,156,0,158,"2020"
"61359","521486 NOVA GLORIA",0,0,0,74,0,74,"2020"
"61360","521487 NOVA IGUACU DE GOIAS",0,0,1,31,0,32,"2020"
"61361","521490 NOVA ROMA",1,0,2,28,0,31,"2020"
"61362","521500 NOVA VENEZA",0,0,1,96,0,97,"2020"
"61363","521520 NOVO BRASIL",0,0,0,30,0,30,"2020"
"61364","521523 NOVO GAMA",2,4,26,1357,10,1399,"2020"
"61365","521525 NOVO PLANALTO",0,0,0,43,0,43,"2020"
"61366","521530 ORIZONA",0,2,4,212,0,218,"2020"
"61367","521540 OURO VERDE DE GOIAS",1,0,2,44,0,47,"2020"
"61368","521550 OUVIDOR",0,0,0,92,0,92,"2020"
"61369","521560 PADRE BERNARDO",0,0,4,168,237,409,"2020"
"61370","521565 PALESTINA DE GOIAS",0,0,0,33,0,33,"2020"
"61371","521570 PALMEIRAS DE GOIAS",0,2,6,472,0,480,"2020"
"61372","521580 PALMELO",0,0,0,20,0,20,"2020"
"61373","521590 PALMINOPOLIS",1,0,1,61,0,63,"2020"
"61374","521600 PANAMA",0,0,0,30,0,30,"2020"
"61375","521630 PARANAIGUARA",0,0,0,83,0,83,"2020"
"61376","521640 PARAUNA",2,1,9,151,0,163,"2020"
"61377","521645 PEROLANDIA",0,0,0,46,0,46,"2020"
"61378","521680 PETROLINA DE GOIAS",0,0,1,77,0,78,"2020"
"61379","521690 PILAR DE GOIAS",0,1,0,39,0,40,"2020"
"61380","521710 PIRACANJUBA",0,0,5,231,0,236,"2020"
"61381","521720 PIRANHAS",0,1,7,119,0,127,"2020"
"61382","521730 PIRENOPOLIS",0,1,4,268,4,277,"2020"
"61383","521740 PIRES DO RIO",1,1,4,323,2,331,"2020"
"61384","521760 PLANALTINA",4,8,21,1379,11,1423,"2020"
"61385","521770 PONTALINA",0,0,1,181,0,182,"2020"
"61386","521800 PORANGATU",0,5,12,511,1,529,"2020"
"61387","521805 PORTEIRAO",0,0,0,41,0,41,"2020"
"61388","521810 PORTELANDIA",0,1,0,36,0,37,"2020"
"61389","521830 POSSE",1,2,8,519,0,530,"2020"
"61390","521839 PROFESSOR JAMIL",0,0,0,24,0,24,"2020"
"61391","521850 QUIRINOPOLIS",1,0,3,658,1,663,"2020"
"61392","521860 RIALMA",1,0,2,176,0,179,"2020"
"61393","521870 RIANAPOLIS",0,0,0,48,0,48,"2020"
"61394","521878 RIO QUENTE",1,0,1,44,0,46,"2020"
"61395","521880 RIO VERDE",6,7,41,3270,6,3330,"2020"
"61396","521890 RUBIATABA",1,1,4,230,1,237,"2020"
"61397","521900 SANCLERLANDIA",0,0,1,89,0,90,"2020"
"61398","521910 SANTA BARBARA DE GOIAS",0,0,3,65,0,68,"2020"
"61399","521920 SANTA CRUZ DE GOIAS",0,0,0,30,0,30,"2020"
"61400","521925 SANTA FE DE GOIAS",0,1,0,53,0,54,"2020"
"61401","521930 SANTA HELENA DE GOIAS",0,3,3,499,1,506,"2020"
"61402","521935 SANTA ISABEL",0,0,0,35,0,35,"2020"
"61403","521940 SANTA RITA DO ARAGUAIA",0,0,0,91,0,91,"2020"
"61404","521945 SANTA RITA DO NOVO DESTINO",0,0,0,17,0,17,"2020"
"61405","521950 SANTA ROSA DE GOIAS",0,0,0,38,0,38,"2020"
"61406","521960 SANTA TEREZA DE GOIAS",0,0,0,52,0,52,"2020"
"61407","521970 SANTA TEREZINHA DE GOIAS",0,0,3,117,0,120,"2020"
"61408","521971 SANTO ANTONIO DA BARRA",0,0,1,46,0,47,"2020"
"61409","521973 SANTO ANTONIO DE GOIAS",1,0,0,83,0,84,"2020"
"61410","521975 SANTO ANTONIO DO DESCOBERTO",1,5,10,927,11,954,"2020"
"61411","521980 SAO DOMINGOS",1,0,3,119,0,123,"2020"
"61412","521990 SAO FRANCISCO DE GOIAS",0,0,2,59,0,61,"2020"
"61413","522000 SAO JOAO D'ALIANCA",0,1,2,177,2,182,"2020"
"61414","522005 SAO JOAO DA PARAUNA",0,1,1,24,0,26,"2020"
"61415","522010 SAO LUIS DE MONTES BELOS",0,1,5,418,1,425,"2020"
"61416","522015 SAO LUIZ DO NORTE",0,0,2,50,0,52,"2020"
"61417","522020 SAO MIGUEL DO ARAGUAIA",1,1,2,298,0,302,"2020"
"61418","522026 SAO MIGUEL DO PASSA QUATRO",0,0,0,31,0,31,"2020"
"61419","522028 SAO PATRICIO",0,0,1,17,0,18,"2020"
"61420","522040 SAO SIMAO",0,0,1,198,0,199,"2020"
"61421","522045 SENADOR CANEDO",9,6,29,2250,5,2299,"2020"
"61422","522050 SERRANOPOLIS",0,0,1,102,2,105,"2020"
"61423","522060 SILVANIA",0,0,1,231,0,232,"2020"
"61424","522068 SIMOLANDIA",0,0,3,73,0,76,"2020"
"61425","522070 SITIO D'ABADIA",0,0,1,24,0,25,"2020"
"61426","522100 TAQUARAL DE GOIAS",0,0,2,47,0,49,"2020"
"61427","522108 TERESINA DE GOIAS",0,0,1,37,0,38,"2020"
"61428","522119 TEREZOPOLIS DE GOIAS",1,1,2,81,2,87,"2020"
"61429","522130 TRES RANCHOS",0,0,0,18,0,18,"2020"
"61430","522140 TRINDADE",3,5,19,1991,6,2024,"2020"
"61431","522145 TROMBAS",0,0,1,23,0,24,"2020"
"61432","522150 TURVANIA",0,1,1,52,0,54,"2020"
"61433","522155 TURVELANDIA",0,0,1,69,0,70,"2020"
"61434","522157 UIRAPURU",0,1,0,30,0,31,"2020"
"61435","522160 URUACU",0,4,20,506,0,530,"2020"
"61436","522170 URUANA",0,1,0,134,0,135,"2020"
"61437","522180 URUTAI",0,0,0,24,0,24,"2020"
"61438","522185 VALPARAISO DE GOIAS",4,10,62,2385,17,2478,"2020"
"61439","522190 VARJAO",1,0,0,28,0,29,"2020"
"61440","522200 VIANOPOLIS",1,0,4,167,0,172,"2020"
"61441","522205 VICENTINOPOLIS",0,0,0,139,0,139,"2020"
"61442","522220 VILA BOA",0,0,0,47,4,51,"2020"
"61443","522230 VILA PROPICIO",0,1,0,52,0,53,"2020"
"61444","530010 BRASILIA",130,121,595,37707,808,39361,"2020"
"61445","TOTAL",7527,10526,38385,2582578,38085,2677101,"2021"
"61446","MUNICIPIO IGNORADO - RO",0,0,1,3,0,4,"2021"
"61447","110001 ALTA FLORESTA D'OESTE",0,2,2,352,1,357,"2021"
"61448","110002 ARIQUEMES",4,8,63,1469,1,1545,"2021"
"61449","110003 CABIXI",0,0,0,68,0,68,"2021"
"61450","110004 CACOAL",3,7,15,1338,3,1366,"2021"
"61451","110005 CEREJEIRAS",0,2,0,245,4,251,"2021"
"61452","110006 COLORADO DO OESTE",1,0,1,225,4,231,"2021"
"61453","110007 CORUMBIARA",0,0,1,113,4,118,"2021"
"61454","110008 COSTA MARQUES",0,2,4,184,5,195,"2021"
"61455","110009 ESPIGAO D'OESTE",1,1,10,473,0,485,"2021"
"61456","110010 GUAJARA-MIRIM",0,1,3,806,24,834,"2021"
"61457","110011 JARU",1,1,12,905,1,920,"2021"
"61458","110012 JI-PARANA",2,7,37,1918,8,1972,"2021"
"61459","110013 MACHADINHO D'OESTE",1,5,20,439,3,468,"2021"
"61460","110014 NOVA BRASILANDIA D'OESTE",0,3,5,225,0,233,"2021"
"61461","110015 OURO PRETO DO OESTE",0,2,14,521,1,538,"2021"
"61462","110018 PIMENTA BUENO",2,1,4,565,1,573,"2021"
"61463","110020 PORTO VELHO",10,28,76,7526,63,7703,"2021"
"61464","110025 PRESIDENTE MEDICI",1,1,7,245,0,254,"2021"
"61465","110026 RIO CRESPO",0,0,1,47,0,48,"2021"
"61466","110028 ROLIM DE MOURA",1,0,8,807,0,816,"2021"
"61467","110029 SANTA LUZIA D'OESTE",0,0,0,78,0,78,"2021"
"61468","110030 VILHENA",4,3,9,1601,6,1623,"2021"
"61469","110032 SAO MIGUEL DO GUAPORE",0,1,6,337,0,344,"2021"
"61470","110033 NOVA MAMORE",0,0,5,458,6,469,"2021"
"61471","110034 ALVORADA D'OESTE",0,0,3,196,1,200,"2021"
"61472","110037 ALTO ALEGRE DOS PARECIS",0,0,2,140,1,143,"2021"
"61473","110040 ALTO PARAISO",1,2,12,209,0,224,"2021"
"61474","110045 BURITIS",1,1,3,537,0,542,"2021"
"61475","110050 NOVO HORIZONTE DO OESTE",0,0,5,79,0,84,"2021"
"61476","110060 CACAULANDIA",0,0,0,60,0,60,"2021"
"61477","110070 CAMPO NOVO DE RONDONIA",0,0,1,132,0,133,"2021"
"61478","110080 CANDEIAS DO JAMARI",2,1,8,339,3,353,"2021"
"61479","110090 CASTANHEIRAS",1,0,0,36,0,37,"2021"
"61480","110092 CHUPINGUAIA",0,0,0,151,1,152,"2021"
"61481","110094 CUJUBIM",0,4,14,224,1,243,"2021"
"61482","110100 GOVERNADOR JORGE TEIXEIRA",0,0,1,102,2,105,"2021"
"61483","110110 ITAPUA DO OESTE",0,0,0,117,3,120,"2021"
"61484","110120 MINISTRO ANDREAZZA",0,0,2,63,0,65,"2021"
"61485","110130 MIRANTE DA SERRA",0,1,5,147,0,153,"2021"
"61486","110140 MONTE NEGRO",0,0,9,166,0,175,"2021"
"61487","110143 NOVA UNIAO",0,0,1,84,0,85,"2021"
"61488","110145 PARECIS",0,0,0,40,0,40,"2021"
"61489","110146 PIMENTEIRAS DO OESTE",0,1,1,40,0,42,"2021"
"61490","110147 PRIMAVERA DE RONDONIA",0,0,0,40,0,40,"2021"
"61491","110148 SAO FELIPE D'OESTE",0,0,0,45,0,45,"2021"
"61492","110149 SAO FRANCISCO DO GUAPORE",0,2,6,275,1,284,"2021"
"61493","110150 SERINGUEIRAS",0,1,4,175,0,180,"2021"
"61494","110155 TEIXEIROPOLIS",0,0,0,50,0,50,"2021"
"61495","110160 THEOBROMA",0,0,1,82,0,83,"2021"
"61496","110170 URUPA",0,2,2,156,1,161,"2021"
"61497","110175 VALE DO ANARI",0,1,2,71,1,75,"2021"
"61498","110180 VALE DO PARAISO",0,0,2,70,0,72,"2021"
"61499","MUNICIPIO IGNORADO - AC",0,0,0,1,0,1,"2021"
"61500","120001 ACRELANDIA",0,1,2,243,5,251,"2021"
"61501","120005 ASSIS BRASIL",0,0,4,220,47,271,"2021"
"61502","120010 BRASILEIA",1,3,7,509,5,525,"2021"
"61503","120013 BUJARI",1,0,1,243,6,251,"2021"
"61504","120017 CAPIXABA",0,3,2,207,3,215,"2021"
"61505","120020 CRUZEIRO DO SUL",1,4,27,1740,22,1794,"2021"
"61506","120025 EPITACIOLANDIA",0,0,1,295,8,304,"2021"
"61507","120030 FEIJO",4,3,12,688,182,889,"2021"
"61508","120032 JORDAO",1,1,3,169,122,296,"2021"
"61509","120033 MANCIO LIMA",0,0,4,368,7,379,"2021"
"61510","120034 MANOEL URBANO",1,2,2,241,30,276,"2021"
"61511","120035 MARECHAL THAUMATURGO",2,1,9,332,99,443,"2021"
"61512","120038 PLACIDO DE CASTRO",1,3,4,266,8,282,"2021"
"61513","120039 PORTO WALTER",0,1,10,302,25,338,"2021"
"61514","120040 RIO BRANCO",7,21,66,5442,130,5666,"2021"
"61515","120042 RODRIGUES ALVES",1,1,7,317,9,335,"2021"
"61516","120043 SANTA ROSA DO PURUS",1,1,4,104,68,178,"2021"
"61517","120045 SENADOR GUIOMARD",1,1,5,376,9,392,"2021"
"61518","120050 SENA MADUREIRA",0,6,10,726,17,759,"2021"
"61519","120060 TARAUACA",7,9,11,1064,83,1174,"2021"
"61520","120070 XAPURI",0,5,5,310,6,326,"2021"
"61521","120080 PORTO ACRE",0,2,2,341,9,354,"2021"
"61522","MUNICIPIO IGNORADO - AM",0,0,2,21,3,26,"2021"
"61523","130002 ALVARAES",1,4,8,432,0,445,"2021"
"61524","130006 AMATURA",0,0,3,193,89,285,"2021"
"61525","130008 ANAMA",0,0,2,178,0,180,"2021"
"61526","130010 ANORI",0,4,6,228,24,262,"2021"
"61527","130014 APUI",1,0,1,288,0,290,"2021"
"61528","130020 ATALAIA DO NORTE",0,1,1,230,39,271,"2021"
"61529","130030 AUTAZES",3,1,9,844,93,950,"2021"
"61530","130040 BARCELOS",0,2,2,329,174,507,"2021"
"61531","130050 BARREIRINHA",0,4,10,775,150,939,"2021"
"61532","130060 BENJAMIN CONSTANT",2,3,4,1043,3,1055,"2021"
"61533","130063 BERURI",1,2,9,465,112,589,"2021"
"61534","130068 BOA VISTA DO RAMOS",0,3,3,291,0,297,"2021"
"61535","130070 BOCA DO ACRE",1,3,20,742,6,772,"2021"
"61536","130080 BORBA",2,4,18,830,32,886,"2021"
"61537","130083 CAAPIRANGA",1,4,12,178,10,205,"2021"
"61538","130090 CANUTAMA",0,0,1,196,1,198,"2021"
"61539","130100 CARAUARI",3,7,35,501,138,684,"2021"
"61540","130110 CAREIRO",1,1,2,603,12,619,"2021"
"61541","130115 CAREIRO DA VARZEA",0,0,0,195,23,218,"2021"
"61542","130120 COARI",1,1,9,1611,0,1622,"2021"
"61543","130130 CODAJAS",2,1,3,488,2,496,"2021"
"61544","130140 EIRUNEPE",0,5,17,595,111,728,"2021"
"61545","130150 ENVIRA",0,2,3,332,28,365,"2021"
"61546","130160 FONTE BOA",0,2,10,666,0,678,"2021"
"61547","130165 GUAJARA",1,1,6,323,9,340,"2021"
"61548","130170 HUMAITA",2,2,9,1110,4,1127,"2021"
"61549","130180 IPIXUNA",1,2,1,335,67,406,"2021"
"61550","130185 IRANDUBA",3,8,9,896,23,939,"2021"
"61551","130190 ITACOATIARA",2,4,12,1961,66,2045,"2021"
"61552","130195 ITAMARATI",1,0,0,223,74,298,"2021"
"61553","130200 ITAPIRANGA",0,0,3,204,1,208,"2021"
"61554","130210 JAPURA",0,0,1,171,4,176,"2021"
"61555","130220 JURUA",0,0,3,205,0,208,"2021"
"61556","130230 JUTAI",0,1,1,552,126,680,"2021"
"61557","130240 LABREA",2,4,28,818,29,881,"2021"
"61558","130250 MANACAPURU",8,1,13,2241,2,2265,"2021"
"61559","130255 MANAQUIRI",1,0,3,250,2,256,"2021"
"61560","130260 MANAUS",86,112,232,36264,347,37041,"2021"
"61561","130270 MANICORE",3,10,29,867,101,1010,"2021"
"61562","130280 MARAA",2,2,4,415,26,449,"2021"
"61563","130290 MAUES",2,14,25,1168,306,1515,"2021"
"61564","130300 NHAMUNDA",3,0,5,303,37,348,"2021"
"61565","130310 NOVA OLINDA DO NORTE",1,1,6,583,49,640,"2021"
"61566","130320 NOVO AIRAO",0,4,1,294,7,306,"2021"
"61567","130330 NOVO ARIPUANA",2,5,10,405,18,440,"2021"
"61568","130340 PARINTINS",3,6,49,1896,85,2039,"2021"
"61569","130350 PAUINI",0,0,12,351,63,426,"2021"
"61570","130353 PRESIDENTE FIGUEIREDO",1,1,11,589,3,605,"2021"
"61571","130356 RIO PRETO DA EVA",0,2,2,408,6,418,"2021"
"61572","130360 SANTA ISABEL DO RIO NEGRO",0,0,2,174,192,368,"2021"
"61573","130370 SANTO ANTONIO DO ICA",1,3,5,643,174,826,"2021"
"61574","130380 SAO GABRIEL DA CACHOEIRA",2,3,2,500,1081,1588,"2021"
"61575","130390 SAO PAULO DE OLIVENCA",1,6,11,444,531,993,"2021"
"61576","130395 SAO SEBASTIAO DO UATUMA",0,2,7,195,0,204,"2021"
"61577","130400 SILVES",0,2,1,203,4,210,"2021"
"61578","130406 TABATINGA",2,0,7,1203,600,1812,"2021"
"61579","130410 TAPAUA",0,0,3,416,49,468,"2021"
"61580","130420 TEFE",11,9,8,1821,22,1871,"2021"
"61581","130423 TONANTINS",1,0,8,439,2,450,"2021"
"61582","130426 UARINI",3,2,9,363,10,387,"2021"
"61583","130430 URUCARA",0,1,1,262,1,265,"2021"
"61584","130440 URUCURITUBA",0,0,0,359,20,379,"2021"
"61585","140002 AMAJARI",6,0,2,231,196,435,"2021"
"61586","140005 ALTO ALEGRE",3,1,6,249,509,768,"2021"
"61587","140010 BOA VISTA",130,18,91,7829,40,8108,"2021"
"61588","140015 BONFIM",13,1,5,336,78,433,"2021"
"61589","140017 CANTA",18,2,7,347,44,418,"2021"
"61590","140020 CARACARAI",5,0,3,346,70,424,"2021"
"61591","140023 CAROEBE",1,1,1,202,5,210,"2021"
"61592","140028 IRACEMA",1,0,3,107,31,142,"2021"
"61593","140030 MUCAJAI",13,1,4,322,29,369,"2021"
"61594","140040 NORMANDIA",11,0,1,366,99,477,"2021"
"61595","140045 PACARAIMA",12,0,7,528,62,609,"2021"
"61596","140047 RORAINOPOLIS",4,1,7,543,6,561,"2021"
"61597","140050 SAO JOAO DA BALIZA",0,0,3,137,1,141,"2021"
"61598","140060 SAO LUIZ",0,0,3,96,3,102,"2021"
"61599","140070 UIRAMUTA",6,0,1,395,302,704,"2021"
"61600","MUNICIPIO IGNORADO - PA",0,0,0,1,0,1,"2021"
"61601","150010 ABAETETUBA",9,12,33,2704,10,2768,"2021"
"61602","150013 ABEL FIGUEIREDO",2,0,2,127,1,132,"2021"
"61603","150020 ACARA",2,3,6,930,18,959,"2021"
"61604","150030 AFUA",2,6,9,1012,34,1063,"2021"
"61605","150034 AGUA AZUL DO NORTE",1,1,3,204,0,209,"2021"
"61606","150040 ALENQUER",6,7,17,1068,33,1131,"2021"
"61607","150050 ALMEIRIM",5,5,10,762,10,792,"2021"
"61608","150060 ALTAMIRA",5,6,22,2125,49,2207,"2021"
"61609","150070 ANAJAS",4,2,29,691,135,861,"2021"
"61610","150080 ANANINDEUA",9,13,74,6734,26,6856,"2021"
"61611","150085 ANAPU",1,5,6,635,2,649,"2021"
"61612","150090 AUGUSTO CORREA",1,7,12,849,31,900,"2021"
"61613","150095 AURORA DO PARA",0,0,12,401,1,414,"2021"
"61614","150100 AVEIRO",0,1,5,158,20,184,"2021"
"61615","150110 BAGRE",1,5,14,386,170,576,"2021"
"61616","150120 BAIAO",0,0,8,545,37,590,"2021"
"61617","150125 BANNACH",0,0,0,53,0,53,"2021"
"61618","150130 BARCARENA",5,8,21,2229,7,2270,"2021"
"61619","150140 BELEM",37,52,168,16479,80,16816,"2021"
"61620","150145 BELTERRA",0,0,12,270,9,291,"2021"
"61621","150150 BENEVIDES",2,2,5,922,11,942,"2021"
"61622","150157 BOM JESUS DO TOCANTINS",1,4,2,276,1,284,"2021"
"61623","150160 BONITO",0,0,0,190,4,194,"2021"
"61624","150170 BRAGANCA",3,5,23,2077,47,2155,"2021"
"61625","150172 BRASIL NOVO",0,2,1,334,0,337,"2021"
"61626","150175 BREJO GRANDE DO ARAGUAIA",0,3,0,108,1,112,"2021"
"61627","150178 BREU BRANCO",3,3,10,713,4,733,"2021"
"61628","150180 BREVES",4,18,56,2741,11,2830,"2021"
"61629","150190 BUJARU",3,1,4,384,21,413,"2021"
"61630","150195 CACHOEIRA DO PIRIA",0,0,3,305,36,344,"2021"
"61631","150200 CACHOEIRA DO ARARI",0,2,4,304,1,311,"2021"
"61632","150210 CAMETA",13,40,211,2192,64,2520,"2021"
"61633","150215 CANAA DOS CARAJAS",1,13,33,1384,3,1434,"2021"
"61634","150220 CAPANEMA",4,1,10,1038,5,1058,"2021"
"61635","150230 CAPITAO POCO",2,7,9,837,7,862,"2021"
"61636","150240 CASTANHAL",3,7,30,3235,0,3275,"2021"
"61637","150250 CHAVES",2,1,2,365,38,408,"2021"
"61638","150260 COLARES",0,0,0,136,5,141,"2021"
"61639","150270 CONCEICAO DO ARAGUAIA",2,0,9,732,2,745,"2021"
"61640","150275 CONCORDIA DO PARA",0,2,3,518,3,526,"2021"
"61641","150276 CUMARU DO NORTE",1,0,1,209,1,212,"2021"
"61642","150277 CURIONOPOLIS",0,3,6,369,0,378,"2021"
"61643","150280 CURRALINHO",1,5,17,620,85,728,"2021"
"61644","150285 CURUA",1,0,1,158,55,215,"2021"
"61645","150290 CURUCA",1,2,7,498,9,517,"2021"
"61646","150293 DOM ELISEU",0,1,11,667,1,680,"2021"
"61647","150295 ELDORADO DOS CARAJAS",3,2,12,460,0,477,"2021"
"61648","150300 FARO",0,3,2,122,6,133,"2021"
"61649","150304 FLORESTA DO ARAGUAIA",0,2,4,317,1,324,"2021"
"61650","150307 GARRAFAO DO NORTE",1,1,5,384,4,395,"2021"
"61651","150309 GOIANESIA DO PARA",1,0,5,568,2,576,"2021"
"61652","150310 GURUPA",3,3,10,707,45,768,"2021"
"61653","150320 IGARAPE-ACU",0,2,3,526,0,531,"2021"
"61654","150330 IGARAPE-MIRI",3,4,18,1055,54,1134,"2021"
"61655","150340 INHANGAPI",0,0,0,177,1,178,"2021"
"61656","150345 IPIXUNA DO PARA",0,3,4,625,4,636,"2021"
"61657","150350 IRITUIA",0,2,4,430,14,450,"2021"
"61658","150360 ITAITUBA",5,20,60,2488,26,2599,"2021"
"61659","150370 ITUPIRANGA",4,2,5,767,4,782,"2021"
"61660","150375 JACAREACANGA",0,4,3,350,316,673,"2021"
"61661","150380 JACUNDA",2,4,9,670,1,686,"2021"
"61662","150390 JURUTI",7,7,18,1045,51,1128,"2021"
"61663","150400 LIMOEIRO DO AJURU",4,2,31,400,34,471,"2021"
"61664","150405 MAE DO RIO",0,1,12,531,3,547,"2021"
"61665","150410 MAGALHAES BARATA",0,1,2,92,2,97,"2021"
"61666","150420 MARABA",29,15,37,4558,31,4670,"2021"
"61667","150430 MARACANA",1,0,3,390,0,394,"2021"
"61668","150440 MARAPANIM",1,1,4,302,4,312,"2021"
"61669","150442 MARITUBA",3,5,24,1653,12,1697,"2021"
"61670","150445 MEDICILANDIA",1,1,4,448,7,461,"2021"
"61671","150450 MELGACO",6,8,17,478,129,638,"2021"
"61672","150460 MOCAJUBA",2,0,11,504,7,524,"2021"
"61673","150470 MOJU",3,8,17,1286,19,1333,"2021"
"61674","150475 MOJUI DOS CAMPOS",0,2,4,274,6,286,"2021"
"61675","150480 MONTE ALEGRE",2,1,11,1111,3,1128,"2021"
"61676","150490 MUANA",1,7,21,655,2,686,"2021"
"61677","150495 NOVA ESPERANCA DO PIRIA",2,1,8,327,0,338,"2021"
"61678","150497 NOVA IPIXUNA",0,0,2,188,2,192,"2021"
"61679","150500 NOVA TIMBOTEUA",0,0,2,142,0,144,"2021"
"61680","150503 NOVO PROGRESSO",3,8,9,695,2,717,"2021"
"61681","150506 NOVO REPARTIMENTO",6,5,12,1254,3,1280,"2021"
"61682","150510 OBIDOS",3,4,11,938,86,1042,"2021"
"61683","150520 OEIRAS DO PARA",2,12,28,677,41,760,"2021"
"61684","150530 ORIXIMINA",11,9,23,1482,42,1567,"2021"
"61685","150540 OUREM",0,1,4,287,3,295,"2021"
"61686","150543 OURILANDIA DO NORTE",4,6,10,624,3,647,"2021"
"61687","150548 PACAJA",2,0,9,744,0,755,"2021"
"61688","150549 PALESTINA DO PARA",1,0,0,105,0,106,"2021"
"61689","150550 PARAGOMINAS",4,3,15,1863,5,1890,"2021"
"61690","150553 PARAUAPEBAS",7,15,62,5001,2,5087,"2021"
"61691","150555 PAU D'ARCO",0,3,3,113,0,119,"2021"
"61692","150560 PEIXE-BOI",0,0,0,87,1,88,"2021"
"61693","150563 PICARRA",1,0,1,179,3,184,"2021"
"61694","150565 PLACAS",0,1,5,305,1,312,"2021"
"61695","150570 PONTA DE PEDRAS",2,0,4,310,17,333,"2021"
"61696","150580 PORTEL",4,9,16,1340,304,1673,"2021"
"61697","150590 PORTO DE MOZ",6,4,7,742,2,761,"2021"
"61698","150600 PRAINHA",1,2,12,691,68,774,"2021"
"61699","150610 PRIMAVERA",0,2,1,168,0,171,"2021"
"61700","150611 QUATIPURU",0,0,2,144,0,146,"2021"
"61701","150613 REDENCAO",1,9,19,1660,2,1691,"2021"
"61702","150616 RIO MARIA",9,1,5,308,0,323,"2021"
"61703","150618 RONDON DO PARA",1,2,6,583,4,596,"2021"
"61704","150619 RUROPOLIS",3,1,2,463,3,472,"2021"
"61705","150620 SALINOPOLIS",0,0,2,737,0,739,"2021"
"61706","150630 SALVATERRA",0,3,8,323,0,334,"2021"
"61707","150635 SANTA BARBARA DO PARA",0,2,6,315,5,328,"2021"
"61708","150640 SANTA CRUZ DO ARARI",0,0,0,70,2,72,"2021"
"61709","150650 SANTA IZABEL DO PARA",1,7,13,910,2,933,"2021"
"61710","150655 SANTA LUZIA DO PARA",2,2,9,278,3,294,"2021"
"61711","150658 SANTA MARIA DAS BARREIRAS",2,3,5,189,1,200,"2021"
"61712","150660 SANTA MARIA DO PARA",0,2,3,351,4,360,"2021"
"61713","150670 SANTANA DO ARAGUAIA",2,3,22,649,0,676,"2021"
"61714","150680 SANTAREM",21,48,132,6249,414,6864,"2021"
"61715","150690 SANTAREM NOVO",1,1,0,99,0,101,"2021"
"61716","150700 SANTO ANTONIO DO TAUA",1,2,3,413,9,428,"2021"
"61717","150710 SAO CAETANO DE ODIVELAS",0,0,3,202,1,206,"2021"
"61718","150715 SAO DOMINGOS DO ARAGUAIA",0,1,3,376,2,382,"2021"
"61719","150720 SAO DOMINGOS DO CAPIM",1,2,13,455,8,479,"2021"
"61720","150730 SAO FELIX DO XINGU",4,3,48,1050,15,1120,"2021"
"61721","150740 SAO FRANCISCO DO PARA",0,1,2,244,1,248,"2021"
"61722","150745 SAO GERALDO DO ARAGUAIA",1,2,2,457,2,464,"2021"
"61723","150746 SAO JOAO DA PONTA",0,0,2,79,1,82,"2021"
"61724","150747 SAO JOAO DE PIRABAS",2,1,0,290,3,296,"2021"
"61725","150750 SAO JOAO DO ARAGUAIA",2,1,1,217,1,222,"2021"
"61726","150760 SAO MIGUEL DO GUAMA",4,1,10,865,2,882,"2021"
"61727","150770 SAO SEBASTIAO DA BOA VISTA",1,2,12,547,10,572,"2021"
"61728","150775 SAPUCAIA",0,0,2,75,0,77,"2021"
"61729","150780 SENADOR JOSE PORFIRIO",1,0,2,289,4,296,"2021"
"61730","150790 SOURE",0,0,1,410,0,411,"2021"
"61731","150795 TAILANDIA",2,6,14,1497,0,1519,"2021"
"61732","150796 TERRA ALTA",0,0,2,175,1,178,"2021"
"61733","150797 TERRA SANTA",2,2,8,287,2,301,"2021"
"61734","150800 TOME-ACU",2,6,24,1469,4,1505,"2021"
"61735","150803 TRACUATEUA",0,2,8,445,2,457,"2021"
"61736","150805 TRAIRAO",0,0,10,250,0,260,"2021"
"61737","150808 TUCUMA",1,3,10,727,1,742,"2021"
"61738","150810 TUCURUI",10,7,28,1603,16,1664,"2021"
"61739","150812 ULIANOPOLIS",1,2,5,380,0,388,"2021"
"61740","150815 URUARA",9,2,3,780,3,797,"2021"
"61741","150820 VIGIA",1,7,6,590,2,606,"2021"
"61742","150830 VISEU",4,5,11,925,146,1091,"2021"
"61743","150835 VITORIA DO XINGU",0,0,4,332,0,336,"2021"
"61744","150840 XINGUARA",4,4,11,946,1,966,"2021"
"61745","160005 SERRA DO NAVIO",0,0,1,90,3,94,"2021"
"61746","160010 AMAPA",1,0,2,151,6,160,"2021"
"61747","160015 PEDRA BRANCA DO AMAPARI",0,0,7,311,18,336,"2021"
"61748","160020 CALCOENE",4,0,2,199,4,209,"2021"
"61749","160021 CUTIAS",0,0,1,109,7,117,"2021"
"61750","160023 FERREIRA GOMES",1,0,5,144,4,154,"2021"
"61751","160025 ITAUBAL",0,0,3,125,28,156,"2021"
"61752","160027 LARANJAL DO JARI",4,2,20,660,2,688,"2021"
"61753","160030 MACAPA",27,27,80,8359,96,8589,"2021"
"61754","160040 MAZAGAO",0,1,4,522,48,575,"2021"
"61755","160050 OIAPOQUE",3,4,23,499,80,609,"2021"
"61756","160053 PORTO GRANDE",2,1,4,380,6,393,"2021"
"61757","160055 PRACUUBA",0,0,0,77,34,111,"2021"
"61758","160060 SANTANA",7,4,39,2124,26,2200,"2021"
"61759","160070 TARTARUGALZINHO",2,0,5,260,76,343,"2021"
"61760","160080 VITORIA DO JARI",1,1,2,255,0,259,"2021"
"61761","170025 ABREULANDIA",0,0,1,29,0,30,"2021"
"61762","170030 AGUIARNOPOLIS",0,1,2,86,2,91,"2021"
"61763","170035 ALIANCA DO TOCANTINS",0,0,0,66,1,67,"2021"
"61764","170040 ALMAS",0,0,3,120,0,123,"2021"
"61765","170070 ALVORADA",0,0,0,133,0,133,"2021"
"61766","170100 ANANAS",0,0,4,150,2,156,"2021"
"61767","170105 ANGICO",0,0,0,32,1,33,"2021"
"61768","170110 APARECIDA DO RIO NEGRO",1,1,1,69,0,72,"2021"
"61769","170130 ARAGOMINAS",0,0,1,63,0,64,"2021"
"61770","170190 ARAGUACEMA",1,0,0,92,0,93,"2021"
"61771","170200 ARAGUACU",0,0,0,93,1,94,"2021"
"61772","170210 ARAGUAINA",11,6,45,2964,24,3050,"2021"
"61773","170215 ARAGUANA",0,0,1,62,1,64,"2021"
"61774","170220 ARAGUATINS",0,2,5,393,59,459,"2021"
"61775","170230 ARAPOEMA",0,0,0,91,1,92,"2021"
"61776","170240 ARRAIAS",0,0,2,132,3,137,"2021"
"61777","170255 AUGUSTINOPOLIS",0,0,3,259,38,300,"2021"
"61778","170270 AURORA DO TOCANTINS",0,0,0,29,0,29,"2021"
"61779","170290 AXIXA DO TOCANTINS",0,1,1,176,20,198,"2021"
"61780","170300 BABACULANDIA",0,1,3,85,3,92,"2021"
"61781","170305 BANDEIRANTES DO TOCANTINS",0,1,2,54,0,57,"2021"
"61782","170307 BARRA DO OURO",0,0,2,86,6,94,"2021"
"61783","170310 BARROLANDIA",0,0,1,60,0,61,"2021"
"61784","170320 BERNARDO SAYAO",1,0,0,50,0,51,"2021"
"61785","170330 BOM JESUS DO TOCANTINS",0,0,3,69,1,73,"2021"
"61786","170360 BRASILANDIA DO TOCANTINS",1,0,0,28,1,30,"2021"
"61787","170370 BREJINHO DE NAZARE",0,0,0,60,0,60,"2021"
"61788","170380 BURITI DO TOCANTINS",0,0,0,123,23,146,"2021"
"61789","170382 CACHOEIRINHA",0,0,0,33,0,33,"2021"
"61790","170384 CAMPOS LINDOS",0,1,0,150,19,170,"2021"
"61791","170386 CARIRI DO TOCANTINS",0,0,1,53,0,54,"2021"
"61792","170388 CARMOLANDIA",0,1,1,34,0,36,"2021"
"61793","170389 CARRASCO BONITO",0,0,2,40,13,55,"2021"
"61794","170390 CASEARA",0,1,0,83,1,85,"2021"
"61795","170410 CENTENARIO",0,0,0,24,1,25,"2021"
"61796","170460 CHAPADA DE AREIA",0,0,0,13,0,13,"2021"
"61797","170510 CHAPADA DA NATIVIDADE",0,0,1,48,1,50,"2021"
"61798","170550 COLINAS DO TOCANTINS",3,0,6,577,5,591,"2021"
"61799","170555 COMBINADO",0,0,4,50,0,54,"2021"
"61800","170560 CONCEICAO DO TOCANTINS",0,1,2,54,1,58,"2021"
"61801","170600 COUTO MAGALHAES",0,1,2,76,0,79,"2021"
"61802","170610 CRISTALANDIA",0,1,1,74,0,76,"2021"
"61803","170625 CRIXAS DO TOCANTINS",0,0,0,17,0,17,"2021"
"61804","170650 DARCINOPOLIS",2,0,1,104,4,111,"2021"
"61805","170700 DIANOPOLIS",4,0,3,290,2,299,"2021"
"61806","170710 DIVINOPOLIS DO TOCANTINS",0,0,0,104,1,105,"2021"
"61807","170720 DOIS IRMAOS DO TOCANTINS",0,0,2,63,1,66,"2021"
"61808","170730 DUERE",0,0,0,57,0,57,"2021"
"61809","170740 ESPERANTINA",0,1,3,119,16,139,"2021"
"61810","170755 FATIMA",0,1,1,46,1,49,"2021"
"61811","170765 FIGUEIROPOLIS",1,2,0,58,0,61,"2021"
"61812","170770 FILADELFIA",0,0,2,90,2,94,"2021"
"61813","170820 FORMOSO DO ARAGUAIA",0,1,1,295,1,298,"2021"
"61814","170825 FORTALEZA DO TABOCAO",0,0,0,57,0,57,"2021"
"61815","170830 GOIANORTE",0,0,2,59,0,61,"2021"
"61816","170900 GOIATINS",0,3,1,198,6,208,"2021"
"61817","170930 GUARAI",1,1,3,359,0,364,"2021"
"61818","170950 GURUPI",3,4,14,1240,2,1263,"2021"
"61819","170980 IPUEIRAS",1,0,0,24,0,25,"2021"
"61820","171050 ITACAJA",0,0,2,123,2,127,"2021"
"61821","171070 ITAGUATINS",0,0,1,58,7,66,"2021"
"61822","171090 ITAPIRATINS",0,0,0,54,1,55,"2021"
"61823","171110 ITAPORA DO TOCANTINS",0,0,0,38,0,38,"2021"
"61824","171150 JAU DO TOCANTINS",0,0,0,29,0,29,"2021"
"61825","171180 JUARINA",1,0,0,35,1,37,"2021"
"61826","171190 LAGOA DA CONFUSAO",0,1,3,283,2,289,"2021"
"61827","171195 LAGOA DO TOCANTINS",0,0,2,59,2,63,"2021"
"61828","171200 LAJEADO",0,0,0,58,0,58,"2021"
"61829","171215 LAVANDEIRA",1,0,0,17,0,18,"2021"
"61830","171240 LIZARDA",0,1,0,51,1,53,"2021"
"61831","171245 LUZINOPOLIS",0,0,0,44,1,45,"2021"
"61832","171250 MARIANOPOLIS DO TOCANTINS",0,1,0,64,0,65,"2021"
"61833","171270 MATEIROS",0,2,1,36,1,40,"2021"
"61834","171280 MAURILANDIA DO TOCANTINS",1,0,3,29,3,36,"2021"
"61835","171320 MIRACEMA DO TOCANTINS",1,2,3,288,1,295,"2021"
"61836","171330 MIRANORTE",1,0,2,172,0,175,"2021"
"61837","171360 MONTE DO CARMO",0,0,1,85,0,86,"2021"
"61838","171370 MONTE SANTO DO TOCANTINS",0,0,0,28,0,28,"2021"
"61839","171380 PALMEIRAS DO TOCANTINS",0,1,0,69,2,72,"2021"
"61840","171395 MURICILANDIA",0,0,0,52,3,55,"2021"
"61841","171420 NATIVIDADE",0,0,1,101,1,103,"2021"
"61842","171430 NAZARE",0,0,1,61,0,62,"2021"
"61843","171488 NOVA OLINDA",0,0,2,159,1,162,"2021"
"61844","171500 NOVA ROSALANDIA",0,0,0,48,0,48,"2021"
"61845","171510 NOVO ACORDO",0,0,0,61,1,62,"2021"
"61846","171515 NOVO ALEGRE",0,0,0,23,0,23,"2021"
"61847","171525 NOVO JARDIM",0,0,0,43,0,43,"2021"
"61848","171550 OLIVEIRA DE FATIMA",0,0,0,16,0,16,"2021"
"61849","171570 PALMEIRANTE",0,0,0,48,2,50,"2021"
"61850","171575 PALMEIROPOLIS",0,0,1,84,0,85,"2021"
"61851","171610 PARAISO DO TOCANTINS",3,1,4,787,0,795,"2021"
"61852","171620 PARANA",0,0,3,158,1,162,"2021"
"61853","171630 PAU D'ARCO",0,0,3,62,1,66,"2021"
"61854","171650 PEDRO AFONSO",2,1,3,214,0,220,"2021"
"61855","171660 PEIXE",0,0,1,129,0,130,"2021"
"61856","171665 PEQUIZEIRO",0,1,1,66,0,68,"2021"
"61857","171670 COLMEIA",0,0,1,123,0,124,"2021"
"61858","171700 PINDORAMA DO TOCANTINS",0,0,0,44,0,44,"2021"
"61859","171720 PIRAQUE",2,0,0,34,1,37,"2021"
"61860","171750 PIUM",0,0,0,81,1,82,"2021"
"61861","171780 PONTE ALTA DO BOM JESUS",0,0,0,34,0,34,"2021"
"61862","171790 PONTE ALTA DO TOCANTINS",0,0,3,116,0,119,"2021"
"61863","171800 PORTO ALEGRE DO TOCANTINS",0,0,0,47,1,48,"2021"
"61864","171820 PORTO NACIONAL",4,5,22,1080,4,1115,"2021"
"61865","171830 PRAIA NORTE",0,0,3,88,8,99,"2021"
"61866","171840 PRESIDENTE KENNEDY",0,0,0,43,1,44,"2021"
"61867","171845 PUGMIL",0,0,1,30,0,31,"2021"
"61868","171850 RECURSOLANDIA",0,0,0,60,0,60,"2021"
"61869","171855 RIACHINHO",1,1,0,62,2,66,"2021"
"61870","171865 RIO DA CONCEICAO",0,0,0,31,0,31,"2021"
"61871","171870 RIO DOS BOIS",0,0,1,39,0,40,"2021"
"61872","171875 RIO SONO",1,0,1,64,1,67,"2021"
"61873","171880 SAMPAIO",0,0,0,85,3,88,"2021"
"61874","171884 SANDOLANDIA",0,0,1,42,1,44,"2021"
"61875","171886 SANTA FE DO ARAGUAIA",0,0,1,112,1,114,"2021"
"61876","171888 SANTA MARIA DO TOCANTINS",0,0,0,38,1,39,"2021"
"61877","171889 SANTA RITA DO TOCANTINS",0,0,0,30,0,30,"2021"
"61878","171890 SANTA ROSA DO TOCANTINS",0,1,0,87,1,89,"2021"
"61879","171900 SANTA TEREZA DO TOCANTINS",0,0,0,51,2,53,"2021"
"61880","172000 SANTA TEREZINHA DO TOCANTINS",0,0,0,27,1,28,"2021"
"61881","172010 SAO BENTO DO TOCANTINS",0,0,1,74,4,79,"2021"
"61882","172015 SAO FELIX DO TOCANTINS",0,0,0,20,1,21,"2021"
"61883","172020 SAO MIGUEL DO TOCANTINS",0,0,2,153,0,155,"2021"
"61884","172025 SAO SALVADOR DO TOCANTINS",0,0,0,26,0,26,"2021"
"61885","172030 SAO SEBASTIAO DO TOCANTINS",0,0,0,53,3,56,"2021"
"61886","172049 SAO VALERIO",0,0,0,40,0,40,"2021"
"61887","172065 SILVANOPOLIS",0,0,0,63,0,63,"2021"
"61888","172080 SITIO NOVO DO TOCANTINS",0,1,1,128,5,135,"2021"
"61889","172085 SUCUPIRA",0,0,0,19,0,19,"2021"
"61890","172090 TAGUATINGA",1,1,2,168,1,173,"2021"
"61891","172093 TAIPAS DO TOCANTINS",0,0,0,33,0,33,"2021"
"61892","172097 TALISMA",1,0,0,32,0,33,"2021"
"61893","172100 PALMAS",16,10,47,4848,20,4941,"2021"
"61894","172110 TOCANTINIA",2,0,1,182,4,189,"2021"
"61895","172120 TOCANTINOPOLIS",1,0,11,432,1,445,"2021"
"61896","172125 TUPIRAMA",0,0,0,34,0,34,"2021"
"61897","172130 TUPIRATINS",0,0,1,32,0,33,"2021"
"61898","172208 WANDERLANDIA",0,1,1,142,1,145,"2021"
"61899","172210 XAMBIOA",0,0,5,168,1,174,"2021"
"61900","MUNICIPIO IGNORADO - MA",0,0,0,3,0,3,"2021"
"61901","210005 ACAILANDIA",1,11,50,1882,1,1945,"2021"
"61902","210010 AFONSO CUNHA",0,4,4,107,1,116,"2021"
"61903","210015 AGUA DOCE DO MARANHAO",1,2,0,176,4,183,"2021"
"61904","210020 ALCANTARA",2,1,5,173,39,220,"2021"
"61905","210030 ALDEIAS ALTAS",0,3,27,395,3,428,"2021"
"61906","210040 ALTAMIRA DO MARANHAO",2,0,1,68,0,71,"2021"
"61907","210043 ALTO ALEGRE DO MARANHAO",0,4,9,417,4,434,"2021"
"61908","210047 ALTO ALEGRE DO PINDARE",0,2,5,491,2,500,"2021"
"61909","210050 ALTO PARNAIBA",1,2,8,170,1,182,"2021"
"61910","210055 AMAPA DO MARANHAO",0,1,3,119,2,125,"2021"
"61911","210060 AMARANTE DO MARANHAO",2,5,7,768,43,825,"2021"
"61912","210070 ANAJATUBA",2,0,5,297,4,308,"2021"
"61913","210080 ANAPURUS",2,4,2,291,4,303,"2021"
"61914","210083 APICUM-ACU",0,0,2,191,71,264,"2021"
"61915","210087 ARAGUANA",0,3,2,139,6,150,"2021"
"61916","210090 ARAIOSES",1,6,20,501,13,541,"2021"
"61917","210095 ARAME",3,5,5,575,5,593,"2021"
"61918","210100 ARARI",2,2,13,401,3,421,"2021"
"61919","210110 AXIXA",0,1,0,106,7,114,"2021"
"61920","210120 BACABAL",7,4,35,1705,1,1752,"2021"
"61921","210125 BACABEIRA",1,1,5,221,0,228,"2021"
"61922","210130 BACURI",0,0,2,68,168,238,"2021"
"61923","210135 BACURITUBA",0,0,1,72,2,75,"2021"
"61924","210140 BALSAS",8,2,21,1912,7,1950,"2021"
"61925","210150 BARAO DE GRAJAU",2,1,5,297,1,306,"2021"
"61926","210160 BARRA DO CORDA",3,5,8,404,1079,1499,"2021"
"61927","210170 BARREIRINHAS",2,4,8,1246,21,1281,"2021"
"61928","210173 BELAGUA",1,1,3,51,162,218,"2021"
"61929","210177 BELA VISTA DO MARANHAO",0,0,1,195,0,196,"2021"
"61930","210180 BENEDITO LEITE",0,1,1,57,4,63,"2021"
"61931","210190 BEQUIMAO",1,0,2,78,153,234,"2021"
"61932","210193 BERNARDO DO MEARIM",0,0,0,59,0,59,"2021"
"61933","210197 BOA VISTA DO GURUPI",0,0,0,131,7,138,"2021"
"61934","210200 BOM JARDIM",1,2,6,545,25,579,"2021"
"61935","210203 BOM JESUS DAS SELVAS",0,3,12,514,4,533,"2021"
"61936","210207 BOM LUGAR",0,0,6,136,0,142,"2021"
"61937","210210 BREJO",1,0,2,523,6,532,"2021"
"61938","210215 BREJO DE AREIA",0,0,0,169,0,169,"2021"
"61939","210220 BURITI",4,4,18,478,2,506,"2021"
"61940","210230 BURITI BRAVO",7,4,10,340,4,365,"2021"
"61941","210232 BURITICUPU",1,6,19,1092,7,1125,"2021"
"61942","210235 BURITIRANA",0,0,4,194,5,203,"2021"
"61943","210237 CACHOEIRA GRANDE",1,1,2,54,3,61,"2021"
"61944","210240 CAJAPIO",3,0,7,112,18,140,"2021"
"61945","210250 CAJARI",0,0,2,198,87,287,"2021"
"61946","210255 CAMPESTRE DO MARANHAO",0,0,2,178,0,180,"2021"
"61947","210260 CANDIDO MENDES",2,0,8,303,30,343,"2021"
"61948","210270 CANTANHEDE",1,3,4,266,2,276,"2021"
"61949","210275 CAPINZAL DO NORTE",1,6,5,156,2,170,"2021"
"61950","210280 CAROLINA",0,0,2,347,3,352,"2021"
"61951","210290 CARUTAPERA",2,2,19,417,12,452,"2021"
"61952","210300 CAXIAS",2,10,121,2417,26,2576,"2021"
"61953","210310 CEDRAL",0,0,0,117,10,127,"2021"
"61954","210312 CENTRAL DO MARANHAO",0,0,0,99,42,141,"2021"
"61955","210315 CENTRO DO GUILHERME",1,5,3,223,5,237,"2021"
"61956","210317 CENTRO NOVO DO MARANHAO",0,2,8,307,19,336,"2021"
"61957","210320 CHAPADINHA",5,15,25,1451,8,1504,"2021"
"61958","210325 CIDELANDIA",0,0,2,128,33,163,"2021"
"61959","210330 CODO",7,13,52,1794,23,1889,"2021"
"61960","210340 COELHO NETO",2,3,17,680,0,702,"2021"
"61961","210350 COLINAS",0,1,10,662,2,675,"2021"
"61962","210355 CONCEICAO DO LAGO-ACU",2,3,8,207,7,227,"2021"
"61963","210360 COROATA",5,6,17,1001,16,1045,"2021"
"61964","210370 CURURUPU",3,1,2,205,267,478,"2021"
"61965","210375 DAVINOPOLIS",0,0,4,202,2,208,"2021"
"61966","210380 DOM PEDRO",2,0,3,298,5,308,"2021"
"61967","210390 DUQUE BACELAR",1,3,3,177,1,185,"2021"
"61968","210400 ESPERANTINOPOLIS",3,1,0,285,7,296,"2021"
"61969","210405 ESTREITO",1,2,8,267,206,484,"2021"
"61970","210407 FEIRA NOVA DO MARANHAO",1,1,2,118,1,123,"2021"
"61971","210408 FERNANDO FALCAO",0,0,2,56,251,309,"2021"
"61972","210409 FORMOSA DA SERRA NEGRA",0,0,1,224,28,253,"2021"
"61973","210410 FORTALEZA DOS NOGUEIRAS",1,1,1,182,22,207,"2021"
"61974","210420 FORTUNA",0,1,2,253,5,261,"2021"
"61975","210430 GODOFREDO VIANA",0,1,4,136,3,144,"2021"
"61976","210440 GONCALVES DIAS",0,2,3,233,3,241,"2021"
"61977","210450 GOVERNADOR ARCHER",0,1,3,151,1,156,"2021"
"61978","210455 GOVERNADOR EDISON LOBAO",0,0,5,295,5,305,"2021"
"61979","210460 GOVERNADOR EUGENIO BARROS",1,0,6,226,1,234,"2021"
"61980","210462 GOVERNADOR LUIZ ROCHA",0,0,1,121,1,123,"2021"
"61981","210465 GOVERNADOR NEWTON BELLO",0,0,2,120,2,124,"2021"
"61982","210467 GOVERNADOR NUNES FREIRE",0,3,1,490,0,494,"2021"
"61983","210470 GRACA ARANHA",0,0,2,47,0,49,"2021"
"61984","210480 GRAJAU",0,4,24,1502,7,1537,"2021"
"61985","210490 GUIMARAES",0,0,1,123,11,135,"2021"
"61986","210500 HUMBERTO DE CAMPOS",0,1,7,373,90,471,"2021"
"61987","210510 ICATU",3,0,7,357,29,396,"2021"
"61988","210515 IGARAPE DO MEIO",0,1,3,273,3,280,"2021"
"61989","210520 IGARAPE GRANDE",1,0,1,189,1,192,"2021"
"61990","210530 IMPERATRIZ",5,11,78,4567,25,4686,"2021"
"61991","210535 ITAIPAVA DO GRAJAU",0,0,5,255,15,275,"2021"
"61992","210540 ITAPECURU MIRIM",0,1,12,1125,3,1141,"2021"
"61993","210542 ITINGA DO MARANHAO",1,2,10,299,2,314,"2021"
"61994","210545 JATOBA",1,1,3,126,0,131,"2021"
"61995","210547 JENIPAPO DOS VIEIRAS",1,1,2,114,306,424,"2021"
"61996","210550 JOAO LISBOA",2,2,9,428,1,442,"2021"
"61997","210560 JOSELANDIA",1,1,1,240,0,243,"2021"
"61998","210565 JUNCO DO MARANHAO",1,0,1,75,3,80,"2021"
"61999","210570 LAGO DA PEDRA",0,3,6,773,2,784,"2021"
"62000","210580 LAGO DO JUNCO",0,1,1,136,2,140,"2021"
"62001","210590 LAGO VERDE",2,1,7,219,1,230,"2021"
"62002","210592 LAGOA DO MATO",0,1,1,145,0,147,"2021"
"62003","210594 LAGO DOS RODRIGUES",0,0,1,99,0,100,"2021"
"62004","210596 LAGOA GRANDE DO MARANHAO",0,3,5,220,4,232,"2021"
"62005","210598 LAJEADO NOVO",0,1,2,115,0,118,"2021"
"62006","210600 LIMA CAMPOS",0,1,3,178,3,185,"2021"
"62007","210610 LORETO",1,0,1,139,6,147,"2021"
"62008","210620 LUIS DOMINGUES",0,2,2,80,27,111,"2021"
"62009","210630 MAGALHAES DE ALMEIDA",1,2,2,158,0,163,"2021"
"62010","210632 MARACACUME",1,2,6,352,6,367,"2021"
"62011","210635 MARAJA DO SENA",0,1,1,93,4,99,"2021"
"62012","210637 MARANHAOZINHO",1,1,2,166,6,176,"2021"
"62013","210640 MATA ROMA",1,1,4,270,3,279,"2021"
"62014","210650 MATINHA",0,0,0,58,305,363,"2021"
"62015","210660 MATOES",1,15,11,450,2,479,"2021"
"62016","210663 MATOES DO NORTE",0,0,1,119,0,120,"2021"
"62017","210667 MILAGRES DO MARANHAO",0,0,6,85,0,91,"2021"
"62018","210670 MIRADOR",1,0,10,311,6,328,"2021"
"62019","210675 MIRANDA DO NORTE",3,1,0,315,3,322,"2021"
"62020","210680 MIRINZAL",0,0,1,108,127,236,"2021"
"62021","210690 MONCAO",3,1,5,449,3,461,"2021"
"62022","210700 MONTES ALTOS",0,0,3,160,3,166,"2021"
"62023","210710 MORROS",0,2,3,130,6,141,"2021"
"62024","210720 NINA RODRIGUES",2,1,7,210,3,223,"2021"
"62025","210725 NOVA COLINAS",0,1,0,94,0,95,"2021"
"62026","210730 NOVA IORQUE",0,0,0,37,2,39,"2021"
"62027","210735 NOVA OLINDA DO MARANHAO",1,1,7,282,7,298,"2021"
"62028","210740 OLHO D'AGUA DAS CUNHAS",1,1,1,228,0,231,"2021"
"62029","210745 OLINDA NOVA DO MARANHAO",2,0,3,25,194,224,"2021"
"62030","210750 PACO DO LUMIAR",16,6,32,1579,25,1658,"2021"
"62031","210760 PALMEIRANDIA",0,1,2,250,38,291,"2021"
"62032","210770 PARAIBANO",0,2,7,292,2,303,"2021"
"62033","210780 PARNARAMA",2,2,6,424,12,446,"2021"
"62034","210790 PASSAGEM FRANCA",2,1,5,306,0,314,"2021"
"62035","210800 PASTOS BONS",0,1,5,171,109,286,"2021"
"62036","210805 PAULINO NEVES",2,1,2,321,16,342,"2021"
"62037","210810 PAULO RAMOS",0,0,5,315,1,321,"2021"
"62038","210820 PEDREIRAS",1,1,4,509,0,515,"2021"
"62039","210825 PEDRO DO ROSARIO",0,4,13,353,27,397,"2021"
"62040","210830 PENALVA",0,3,8,636,33,680,"2021"
"62041","210840 PERI MIRIM",0,0,3,107,8,118,"2021"
"62042","210845 PERITORO",0,2,9,327,5,343,"2021"
"62043","210850 PINDARE-MIRIM",1,2,7,494,4,508,"2021"
"62044","210860 PINHEIRO",1,9,24,1389,48,1471,"2021"
"62045","210870 PIO XII",0,3,1,333,0,337,"2021"
"62046","210880 PIRAPEMAS",1,1,6,238,5,251,"2021"
"62047","210890 POCAO DE PEDRAS",0,1,2,216,0,219,"2021"
"62048","210900 PORTO FRANCO",1,0,3,402,2,408,"2021"
"62049","210905 PORTO RICO DO MARANHAO",0,0,0,40,15,55,"2021"
"62050","210910 PRESIDENTE DUTRA",1,5,10,736,2,754,"2021"
"62051","210920 PRESIDENTE JUSCELINO",1,3,5,146,12,167,"2021"
"62052","210923 PRESIDENTE MEDICI",0,0,3,101,2,106,"2021"
"62053","210927 PRESIDENTE SARNEY",0,5,7,310,12,334,"2021"
"62054","210930 PRESIDENTE VARGAS",0,1,2,187,12,202,"2021"
"62055","210940 PRIMEIRA CRUZ",0,4,2,167,33,206,"2021"
"62056","210945 RAPOSA",3,1,8,499,2,513,"2021"
"62057","210950 RIACHAO",0,0,2,360,2,364,"2021"
"62058","210955 RIBAMAR FIQUENE",0,0,0,93,3,96,"2021"
"62059","210960 ROSARIO",1,3,3,517,9,533,"2021"
"62060","210970 SAMBAIBA",1,2,0,80,3,86,"2021"
"62061","210975 SANTA FILOMENA DO MARANHAO",0,1,1,65,0,67,"2021"
"62062","210980 SANTA HELENA",4,2,4,434,43,487,"2021"
"62063","210990 SANTA INES",4,7,27,1452,3,1493,"2021"
"62064","211000 SANTA LUZIA",2,4,12,985,0,1003,"2021"
"62065","211003 SANTA LUZIA DO PARUA",2,4,9,344,4,363,"2021"
"62066","211010 SANTA QUITERIA DO MARANHAO",3,6,11,446,5,471,"2021"
"62067","211020 SANTA RITA",1,3,26,509,1,540,"2021"
"62068","211023 SANTANA DO MARANHAO",0,1,2,163,0,166,"2021"
"62069","211027 SANTO AMARO DO MARANHAO",0,1,4,124,2,131,"2021"
"62070","211030 SANTO ANTONIO DOS LOPES",3,2,20,231,2,258,"2021"
"62071","211040 SAO BENEDITO DO RIO PRETO",0,4,5,299,74,382,"2021"
"62072","211050 SAO BENTO",2,2,1,443,8,456,"2021"
"62073","211060 SAO BERNARDO",2,1,7,394,0,404,"2021"
"62074","211065 SAO DOMINGOS DO AZEITAO",1,0,1,65,28,95,"2021"
"62075","211070 SAO DOMINGOS DO MARANHAO",0,0,8,611,2,621,"2021"
"62076","211080 SAO FELIX DE BALSAS",1,0,1,28,34,64,"2021"
"62077","211085 SAO FRANCISCO DO BREJAO",0,0,2,105,1,108,"2021"
"62078","211090 SAO FRANCISCO DO MARANHAO",0,1,2,105,23,131,"2021"
"62079","211100 SAO JOAO BATISTA",0,0,4,224,27,255,"2021"
"62080","211102 SAO JOAO DO CARU",1,1,2,237,4,245,"2021"
"62081","211105 SAO JOAO DO PARAISO",0,1,1,149,3,154,"2021"
"62082","211107 SAO JOAO DO SOTER",0,1,16,249,1,267,"2021"
"62083","211110 SAO JOAO DOS PATOS",1,4,10,361,1,377,"2021"
"62084","211120 SAO JOSE DE RIBAMAR",22,31,67,3257,63,3440,"2021"
"62085","211125 SAO JOSE DOS BASILIOS",0,1,2,96,1,100,"2021"
"62086","211130 SAO LUIS",121,58,218,14622,145,15164,"2021"
"62087","211140 SAO LUIS GONZAGA DO MARANHAO",1,4,2,260,1,268,"2021"
"62088","211150 SAO MATEUS DO MARANHAO",1,5,13,566,2,587,"2021"
"62089","211153 SAO PEDRO DA AGUA BRANCA",0,2,3,124,3,132,"2021"
"62090","211157 SAO PEDRO DOS CRENTES",0,1,1,95,1,98,"2021"
"62091","211160 SAO RAIMUNDO DAS MANGABEIRAS",2,0,4,256,30,292,"2021"
"62092","211163 SAO RAIMUNDO DO DOCA BEZERRA",0,0,1,43,30,74,"2021"
"62093","211167 SAO ROBERTO",0,0,0,56,14,70,"2021"
"62094","211170 SAO VICENTE FERRER",1,0,1,273,9,284,"2021"
"62095","211172 SATUBINHA",0,1,4,130,0,135,"2021"
"62096","211174 SENADOR ALEXANDRE COSTA",3,1,6,166,4,180,"2021"
"62097","211176 SENADOR LA ROCQUE",0,0,3,252,2,257,"2021"
"62098","211178 SERRANO DO MARANHAO",0,0,0,67,92,159,"2021"
"62099","211180 SITIO NOVO",2,1,4,275,3,285,"2021"
"62100","211190 SUCUPIRA DO NORTE",0,0,3,176,0,179,"2021"
"62101","211195 SUCUPIRA DO RIACHAO",1,0,0,38,0,39,"2021"
"62102","211200 TASSO FRAGOSO",1,2,2,125,2,132,"2021"
"62103","211210 TIMBIRAS",1,1,2,491,0,495,"2021"
"62104","211220 TIMON",8,5,31,2911,5,2960,"2021"
"62105","211223 TRIZIDELA DO VALE",1,2,4,333,4,344,"2021"
"62106","211227 TUFILANDIA",0,0,0,77,0,77,"2021"
"62107","211230 TUNTUM",2,3,3,465,24,497,"2021"
"62108","211240 TURIACU",0,1,0,44,601,646,"2021"
"62109","211245 TURILANDIA",1,0,5,265,69,340,"2021"
"62110","211250 TUTOIA",3,6,6,984,28,1027,"2021"
"62111","211260 URBANO SANTOS",0,1,5,128,517,651,"2021"
"62112","211270 VARGEM GRANDE",6,2,14,798,18,838,"2021"
"62113","211280 VIANA",4,2,17,915,62,1000,"2021"
"62114","211285 VILA NOVA DOS MARTIRIOS",0,1,5,156,2,164,"2021"
"62115","211290 VITORIA DO MEARIM",2,1,10,511,1,525,"2021"
"62116","211300 VITORINO FREIRE",1,1,2,467,0,471,"2021"
"62117","211400 ZE DOCA",3,2,14,749,3,771,"2021"
"62118","MUNICIPIO IGNORADO - PI",0,0,0,3,0,3,"2021"
"62119","220005 ACAUA",0,0,0,40,46,86,"2021"
"62120","220010 AGRICOLANDIA",1,0,0,67,0,68,"2021"
"62121","220020 AGUA BRANCA",0,2,9,235,3,249,"2021"
"62122","220025 ALAGOINHA DO PIAUI",0,0,2,74,1,77,"2021"
"62123","220027 ALEGRETE DO PIAUI",0,0,1,60,0,61,"2021"
"62124","220030 ALTO LONGA",1,0,2,116,0,119,"2021"
"62125","220040 ALTOS",1,1,4,619,9,634,"2021"
"62126","220045 ALVORADA DO GURGUEIA",0,0,0,69,10,79,"2021"
"62127","220050 AMARANTE",2,3,3,250,3,261,"2021"
"62128","220060 ANGICAL DO PIAUI",0,0,1,84,3,88,"2021"
"62129","220070 ANISIO DE ABREU",0,1,2,136,16,155,"2021"
"62130","220080 ANTONIO ALMEIDA",0,1,1,59,0,61,"2021"
"62131","220090 AROAZES",0,1,0,41,0,42,"2021"
"62132","220095 AROEIRAS DO ITAIM",0,0,0,33,0,33,"2021"
"62133","220100 ARRAIAL",0,0,3,64,0,67,"2021"
"62134","220105 ASSUNCAO DO PIAUI",3,0,1,118,4,126,"2021"
"62135","220110 AVELINO LOPES",0,0,2,135,45,182,"2021"
"62136","220115 BAIXA GRANDE DO RIBEIRO",1,0,1,213,105,320,"2021"
"62137","220117 BARRA D'ALCANTARA",0,1,1,39,0,41,"2021"
"62138","220120 BARRAS",3,5,6,711,1,726,"2021"
"62139","220130 BARREIRAS DO PIAUI",1,0,0,14,35,50,"2021"
"62140","220140 BARRO DURO",0,1,0,91,2,94,"2021"
"62141","220150 BATALHA",0,2,5,336,1,344,"2021"
"62142","220155 BELA VISTA DO PIAUI",0,0,2,61,0,63,"2021"
"62143","220157 BELEM DO PIAUI",0,0,0,34,0,34,"2021"
"62144","220160 BENEDITINOS",1,0,0,123,1,125,"2021"
"62145","220170 BERTOLINIA",0,0,1,65,0,66,"2021"
"62146","220173 BETANIA DO PIAUI",1,0,2,64,61,128,"2021"
"62147","220177 BOA HORA",0,0,2,76,0,78,"2021"
"62148","220180 BOCAINA",0,0,0,37,0,37,"2021"
"62149","220190 BOM JESUS",1,0,5,487,23,516,"2021"
"62150","220191 BOM PRINCIPIO DO PIAUI",0,1,4,79,3,87,"2021"
"62151","220192 BONFIM DO PIAUI",0,1,1,70,8,80,"2021"
"62152","220194 BOQUEIRAO DO PIAUI",0,0,1,92,0,93,"2021"
"62153","220196 BRASILEIRA",0,0,1,65,0,66,"2021"
"62154","220198 BREJO DO PIAUI",0,0,0,48,2,50,"2021"
"62155","220200 BURITI DOS LOPES",1,2,3,306,0,312,"2021"
"62156","220202 BURITI DOS MONTES",0,0,1,66,4,71,"2021"
"62157","220205 CABECEIRAS DO PIAUI",0,0,0,95,2,97,"2021"
"62158","220207 CAJAZEIRAS DO PIAUI",0,0,2,37,1,40,"2021"
"62159","220208 CAJUEIRO DA PRAIA",0,1,0,130,0,131,"2021"
"62160","220209 CALDEIRAO GRANDE DO PIAUI",0,1,4,75,0,80,"2021"
"62161","220210 CAMPINAS DO PIAUI",0,0,1,56,0,57,"2021"
"62162","220211 CAMPO ALEGRE DO FIDALGO",0,3,0,67,0,70,"2021"
"62163","220213 CAMPO GRANDE DO PIAUI",0,0,0,87,0,87,"2021"
"62164","220217 CAMPO LARGO DO PIAUI",1,0,1,88,0,90,"2021"
"62165","220220 CAMPO MAIOR",2,4,11,544,10,571,"2021"
"62166","220225 CANAVIEIRA",0,0,0,50,0,50,"2021"
"62167","220230 CANTO DO BURITI",2,3,2,273,14,294,"2021"
"62168","220240 CAPITAO DE CAMPOS",0,2,0,151,0,153,"2021"
"62169","220245 CAPITAO GERVASIO OLIVEIRA",0,0,0,48,3,51,"2021"
"62170","220250 CARACOL",0,6,1,120,46,173,"2021"
"62171","220253 CARAUBAS DO PIAUI",0,1,2,73,1,77,"2021"
"62172","220255 CARIDADE DO PIAUI",2,0,0,71,1,74,"2021"
"62173","220260 CASTELO DO PIAUI",0,0,1,235,19,255,"2021"
"62174","220265 CAXINGO",0,0,1,89,1,91,"2021"
"62175","220270 COCAL",0,2,9,403,3,417,"2021"
"62176","220271 COCAL DE TELHA",0,0,0,56,1,57,"2021"
"62177","220272 COCAL DOS ALVES",0,1,1,83,1,86,"2021"
"62178","220273 COIVARAS",0,0,1,45,0,46,"2021"
"62179","220275 COLONIA DO GURGUEIA",0,0,4,74,2,80,"2021"
"62180","220277 COLONIA DO PIAUI",0,0,1,93,0,94,"2021"
"62181","220280 CONCEICAO DO CANINDE",0,0,3,58,3,64,"2021"
"62182","220285 CORONEL JOSE DIAS",1,0,1,35,3,40,"2021"
"62183","220290 CORRENTE",2,1,1,138,372,514,"2021"
"62184","220300 CRISTALANDIA DO PIAUI",0,0,0,69,39,108,"2021"
"62185","220310 CRISTINO CASTRO",0,3,2,169,7,181,"2021"
"62186","220320 CURIMATA",0,0,3,72,117,192,"2021"
"62187","220323 CURRAIS",0,1,1,90,0,92,"2021"
"62188","220325 CURRALINHOS",0,0,0,59,0,59,"2021"
"62189","220327 CURRAL NOVO DO PIAUI",0,0,0,51,48,99,"2021"
"62190","220330 DEMERVAL LOBAO",0,0,1,237,3,241,"2021"
"62191","220335 DIRCEU ARCOVERDE",1,2,0,84,18,105,"2021"
"62192","220340 DOM EXPEDITO LOPES",0,0,1,72,1,74,"2021"
"62193","220342 DOMINGOS MOURAO",0,0,1,56,0,57,"2021"
"62194","220345 DOM INOCENCIO",0,8,2,71,22,103,"2021"
"62195","220350 ELESBAO VELOSO",1,0,2,136,1,140,"2021"
"62196","220360 ELISEU MARTINS",1,0,0,51,0,52,"2021"
"62197","220370 ESPERANTINA",4,2,13,598,2,619,"2021"
"62198","220375 FARTURA DO PIAUI",0,0,0,59,13,72,"2021"
"62199","220380 FLORES DO PIAUI",0,0,2,48,0,50,"2021"
"62200","220385 FLORESTA DO PIAUI",0,0,0,25,0,25,"2021"
"62201","220390 FLORIANO",0,1,18,911,0,930,"2021"
"62202","220400 FRANCINOPOLIS",0,1,0,65,0,66,"2021"
"62203","220410 FRANCISCO AYRES",0,0,0,61,0,61,"2021"
"62204","220415 FRANCISCO MACEDO",0,0,1,30,0,31,"2021"
"62205","220420 FRANCISCO SANTOS",1,0,0,71,0,72,"2021"
"62206","220430 FRONTEIRAS",0,0,1,95,0,96,"2021"
"62207","220435 GEMINIANO",0,0,1,90,0,91,"2021"
"62208","220440 GILBUES",0,0,2,136,41,179,"2021"
"62209","220450 GUADALUPE",0,0,6,151,0,157,"2021"
"62210","220455 GUARIBAS",0,3,0,70,17,90,"2021"
"62211","220460 HUGO NAPOLEAO",0,0,1,48,0,49,"2021"
"62212","220465 ILHA GRANDE",1,1,2,156,0,160,"2021"
"62213","220470 INHUMA",0,0,0,167,0,167,"2021"
"62214","220480 IPIRANGA DO PIAUI",1,0,0,105,0,106,"2021"
"62215","220490 ISAIAS COELHO",0,0,0,116,1,117,"2021"
"62216","220500 ITAINOPOLIS",0,0,0,103,0,103,"2021"
"62217","220510 ITAUEIRA",0,0,3,114,0,117,"2021"
"62218","220515 JACOBINA DO PIAUI",0,0,0,29,40,69,"2021"
"62219","220520 JAICOS",2,2,7,240,2,253,"2021"
"62220","220525 JARDIM DO MULATO",0,0,0,53,1,54,"2021"
"62221","220527 JATOBA DO PIAUI",0,1,1,39,0,41,"2021"
"62222","220530 JERUMENHA",1,0,2,62,0,65,"2021"
"62223","220535 JOAO COSTA",0,0,1,32,0,33,"2021"
"62224","220540 JOAQUIM PIRES",0,0,3,192,1,196,"2021"
"62225","220545 JOCA MARQUES",1,0,0,60,0,61,"2021"
"62226","220550 JOSE DE FREITAS",1,3,11,544,4,563,"2021"
"62227","220551 JUAZEIRO DO PIAUI",0,1,1,61,1,64,"2021"
"62228","220552 JULIO BORGES",0,0,2,32,56,90,"2021"
"62229","220553 JUREMA",0,0,0,56,9,65,"2021"
"62230","220554 LAGOINHA DO PIAUI",0,0,2,23,0,25,"2021"
"62231","220555 LAGOA ALEGRE",0,0,3,97,1,101,"2021"
"62232","220556 LAGOA DO BARRO DO PIAUI",0,9,1,56,11,77,"2021"
"62233","220557 LAGOA DE SAO FRANCISCO",0,0,1,79,1,81,"2021"
"62234","220558 LAGOA DO PIAUI",0,0,1,67,0,68,"2021"
"62235","220559 LAGOA DO SITIO",0,0,1,51,1,53,"2021"
"62236","220560 LANDRI SALES",0,0,1,52,0,53,"2021"
"62237","220570 LUIS CORREIA",1,3,7,416,3,430,"2021"
"62238","220580 LUZILANDIA",1,3,7,324,6,341,"2021"
"62239","220585 MADEIRO",1,0,2,93,1,97,"2021"
"62240","220590 MANOEL EMIDIO",0,1,2,74,2,79,"2021"
"62241","220595 MARCOLANDIA",0,1,1,113,0,115,"2021"
"62242","220600 MARCOS PARENTE",0,0,0,63,0,63,"2021"
"62243","220605 MASSAPE DO PIAUI",0,2,0,51,1,54,"2021"
"62244","220610 MATIAS OLIMPIO",0,0,4,163,7,174,"2021"
"62245","220620 MIGUEL ALVES",3,3,6,465,11,488,"2021"
"62246","220630 MIGUEL LEAO",0,0,0,12,0,12,"2021"
"62247","220635 MILTON BRANDAO",0,1,2,70,2,75,"2021"
"62248","220640 MONSENHOR GIL",0,0,3,110,4,117,"2021"
"62249","220650 MONSENHOR HIPOLITO",0,0,0,84,0,84,"2021"
"62250","220660 MONTE ALEGRE DO PIAUI",1,3,1,145,57,207,"2021"
"62251","220665 MORRO CABECA NO TEMPO",0,0,1,40,35,76,"2021"
"62252","220667 MORRO DO CHAPEU DO PIAUI",0,0,2,94,0,96,"2021"
"62253","220669 MURICI DOS PORTELAS",0,0,2,105,1,108,"2021"
"62254","220670 NAZARE DO PIAUI",1,1,2,101,0,105,"2021"
"62255","220672 NAZARIA",0,0,5,138,5,148,"2021"
"62256","220675 NOSSA SENHORA DE NAZARE",0,0,1,54,0,55,"2021"
"62257","220680 NOSSA SENHORA DOS REMEDIOS",1,1,5,127,2,136,"2021"
"62258","220690 NOVO ORIENTE DO PIAUI",0,1,0,49,0,50,"2021"
"62259","220695 NOVO SANTO ANTONIO",0,0,1,32,1,34,"2021"
"62260","220700 OEIRAS",1,2,9,469,0,481,"2021"
"62261","220710 OLHO D'AGUA DO PIAUI",0,0,2,35,1,38,"2021"
"62262","220720 PADRE MARCOS",0,0,3,85,2,90,"2021"
"62263","220730 PAES LANDIM",0,0,1,61,0,62,"2021"
"62264","220735 PAJEU DO PIAUI",0,2,0,26,3,31,"2021"
"62265","220740 PALMEIRA DO PIAUI",0,0,2,75,10,87,"2021"
"62266","220750 PALMEIRAIS",3,2,1,146,45,197,"2021"
"62267","220755 PAQUETA",0,0,0,28,0,28,"2021"
"62268","220760 PARNAGUA",0,0,1,42,116,159,"2021"
"62269","220770 PARNAIBA",5,4,27,2288,2,2326,"2021"
"62270","220775 PASSAGEM FRANCA DO PIAUI",0,1,0,49,0,50,"2021"
"62271","220777 PATOS DO PIAUI",0,1,1,43,17,62,"2021"
"62272","220779 PAU D'ARCO DO PIAUI",0,0,0,45,0,45,"2021"
"62273","220780 PAULISTANA",0,0,2,198,167,367,"2021"
"62274","220785 PAVUSSU",0,0,1,43,1,45,"2021"
"62275","220790 PEDRO II",0,1,18,516,5,540,"2021"
"62276","220793 PEDRO LAURENTINO",0,0,0,35,0,35,"2021"
"62277","220795 NOVA SANTA RITA",0,0,1,53,1,55,"2021"
"62278","220800 PICOS",0,0,8,1083,3,1094,"2021"
"62279","220810 PIMENTEIRAS",0,0,0,115,0,115,"2021"
"62280","220820 PIO IX",1,0,3,222,1,227,"2021"
"62281","220830 PIRACURUCA",1,1,0,356,0,358,"2021"
"62282","220840 PIRIPIRI",4,6,11,870,6,897,"2021"
"62283","220850 PORTO",0,0,7,232,0,239,"2021"
"62284","220855 PORTO ALEGRE DO PIAUI",1,0,1,42,0,44,"2021"
"62285","220860 PRATA DO PIAUI",0,0,0,31,2,33,"2021"
"62286","220865 QUEIMADA NOVA",0,1,1,64,43,109,"2021"
"62287","220870 REDENCAO DO GURGUEIA",0,0,2,173,6,181,"2021"
"62288","220880 REGENERACAO",1,0,5,242,5,253,"2021"
"62289","220885 RIACHO FRIO",1,0,0,13,47,61,"2021"
"62290","220887 RIBEIRA DO PIAUI",0,1,1,47,1,50,"2021"
"62291","220890 RIBEIRO GONCALVES",0,0,0,18,82,100,"2021"
"62292","220900 RIO GRANDE DO PIAUI",0,0,0,59,1,60,"2021"
"62293","220910 SANTA CRUZ DO PIAUI",0,0,0,67,0,67,"2021"
"62294","220915 SANTA CRUZ DOS MILAGRES",0,0,1,32,0,33,"2021"
"62295","220920 SANTA FILOMENA",0,0,1,92,2,95,"2021"
"62296","220930 SANTA LUZ",0,0,2,61,2,65,"2021"
"62297","220935 SANTANA DO PIAUI",0,0,0,47,0,47,"2021"
"62298","220937 SANTA ROSA DO PIAUI",1,0,0,62,0,63,"2021"
"62299","220940 SANTO ANTONIO DE LISBOA",0,1,1,72,1,75,"2021"
"62300","220945 SANTO ANTONIO DOS MILAGRES",0,0,0,22,0,22,"2021"
"62301","220950 SANTO INACIO DO PIAUI",0,0,0,32,1,33,"2021"
"62302","220955 SAO BRAZ DO PIAUI",0,0,1,56,4,61,"2021"
"62303","220960 SAO FELIX DO PIAUI",0,0,0,29,1,30,"2021"
"62304","220965 SAO FRANCISCO DE ASSIS DO PIAUI",0,2,2,63,7,74,"2021"
"62305","220970 SAO FRANCISCO DO PIAUI",0,0,1,65,1,67,"2021"
"62306","220975 SAO GONCALO DO GURGUEIA",0,0,0,20,38,58,"2021"
"62307","220980 SAO GONCALO DO PIAUI",0,0,0,60,3,63,"2021"
"62308","220985 SAO JOAO DA CANABRAVA",0,1,0,46,0,47,"2021"
"62309","220987 SAO JOAO DA FRONTEIRA",0,0,0,72,0,72,"2021"
"62310","220990 SAO JOAO DA SERRA",1,0,1,57,5,64,"2021"
"62311","220995 SAO JOAO DA VARJOTA",0,0,0,65,0,65,"2021"
"62312","220997 SAO JOAO DO ARRAIAL",1,0,2,150,0,153,"2021"
"62313","221000 SAO JOAO DO PIAUI",1,0,2,355,3,361,"2021"
"62314","221005 SAO JOSE DO DIVINO",0,0,0,71,0,71,"2021"
"62315","221010 SAO JOSE DO PEIXE",0,0,0,39,0,39,"2021"
"62316","221020 SAO JOSE DO PIAUI",0,1,0,81,0,82,"2021"
"62317","221030 SAO JULIAO",0,1,0,73,0,74,"2021"
"62318","221035 SAO LOURENCO DO PIAUI",1,0,1,42,1,45,"2021"
"62319","221037 SAO LUIS DO PIAUI",0,0,1,25,1,27,"2021"
"62320","221038 SAO MIGUEL DA BAIXA GRANDE",1,0,0,20,0,21,"2021"
"62321","221039 SAO MIGUEL DO FIDALGO",0,0,0,42,0,42,"2021"
"62322","221040 SAO MIGUEL DO TAPUIO",2,0,3,184,5,194,"2021"
"62323","221050 SAO PEDRO DO PIAUI",0,0,7,186,0,193,"2021"
"62324","221060 SAO RAIMUNDO NONATO",8,1,5,519,75,608,"2021"
"62325","221062 SEBASTIAO BARROS",0,0,0,6,36,42,"2021"
"62326","221063 SEBASTIAO LEAL",0,0,1,58,0,59,"2021"
"62327","221065 SIGEFREDO PACHECO",0,1,0,111,3,115,"2021"
"62328","221070 SIMOES",1,1,2,190,2,196,"2021"
"62329","221080 SIMPLICIO MENDES",0,0,3,171,1,175,"2021"
"62330","221090 SOCORRO DO PIAUI",1,1,1,44,1,48,"2021"
"62331","221093 SUSSUAPARA",0,0,0,80,0,80,"2021"
"62332","221095 TAMBORIL DO PIAUI",0,0,1,32,8,41,"2021"
"62333","221097 TANQUE DO PIAUI",0,0,1,38,0,39,"2021"
"62334","221100 TERESINA",37,31,115,12100,92,12375,"2021"
"62335","221110 UNIAO",0,4,8,681,7,700,"2021"
"62336","221120 URUCUI",0,2,7,427,4,440,"2021"
"62337","221130 VALENCA DO PIAUI",0,0,2,269,1,272,"2021"
"62338","221135 VARZEA BRANCA",0,0,2,76,9,87,"2021"
"62339","221140 VARZEA GRANDE",0,0,1,44,1,46,"2021"
"62340","221150 VERA MENDES",0,0,0,38,0,38,"2021"
"62341","221160 VILA NOVA DO PIAUI",0,0,0,28,0,28,"2021"
"62342","221170 WALL FERRAZ",0,0,0,38,1,39,"2021"
"62343","MUNICIPIO IGNORADO - CE",0,0,0,1,0,1,"2021"
"62344","230010 ABAIARA",0,0,2,143,2,147,"2021"
"62345","230015 ACARAPE",1,0,2,185,1,189,"2021"
"62346","230020 ACARAU",4,2,6,957,1,970,"2021"
"62347","230030 ACOPIARA",1,4,12,535,0,552,"2021"
"62348","230040 AIUABA",0,1,5,156,1,163,"2021"
"62349","230050 ALCANTARAS",2,2,2,146,1,153,"2021"
"62350","230060 ALTANEIRA",1,0,1,109,0,111,"2021"
"62351","230070 ALTO SANTO",1,3,3,181,0,188,"2021"
"62352","230075 AMONTADA",3,5,24,726,14,772,"2021"
"62353","230080 ANTONINA DO NORTE",0,0,1,79,0,80,"2021"
"62354","230090 APUIARES",0,1,3,163,2,169,"2021"
"62355","230100 AQUIRAZ",3,7,12,1125,4,1151,"2021"
"62356","230110 ARACATI",1,4,12,920,4,941,"2021"
"62357","230120 ARACOIABA",0,0,8,332,1,341,"2021"
"62358","230125 ARARENDA",0,0,1,130,1,132,"2021"
"62359","230130 ARARIPE",2,3,7,334,0,346,"2021"
"62360","230140 ARATUBA",0,1,2,149,0,152,"2021"
"62361","230150 ARNEIROZ",0,0,4,84,0,88,"2021"
"62362","230160 ASSARE",1,1,10,270,0,282,"2021"
"62363","230170 AURORA",1,3,5,293,0,302,"2021"
"62364","230180 BAIXIO",1,0,0,54,0,55,"2021"
"62365","230185 BANABUIU",0,1,7,217,1,226,"2021"
"62366","230190 BARBALHA",0,5,20,1165,3,1193,"2021"
"62367","230195 BARREIRA",0,2,1,297,0,300,"2021"
"62368","230200 BARRO",0,4,2,229,1,236,"2021"
"62369","230205 BARROQUINHA",0,0,4,221,0,225,"2021"
"62370","230210 BATURITE",1,2,8,476,3,490,"2021"
"62371","230220 BEBERIBE",2,1,12,628,0,643,"2021"
"62372","230230 BELA CRUZ",1,0,2,395,1,399,"2021"
"62373","230240 BOA VIAGEM",2,4,13,631,2,652,"2021"
"62374","230250 BREJO SANTO",0,3,12,650,1,666,"2021"
"62375","230260 CAMOCIM",1,4,12,941,0,958,"2021"
"62376","230270 CAMPOS SALES",2,2,11,352,0,367,"2021"
"62377","230280 CANINDE",1,4,19,1046,8,1078,"2021"
"62378","230290 CAPISTRANO",1,0,1,217,1,220,"2021"
"62379","230300 CARIDADE",0,2,3,232,2,239,"2021"
"62380","230310 CARIRE",1,1,4,229,1,236,"2021"
"62381","230320 CARIRIACU",2,2,5,366,0,375,"2021"
"62382","230330 CARIUS",0,1,4,151,0,156,"2021"
"62383","230340 CARNAUBAL",0,2,2,271,1,276,"2021"
"62384","230350 CASCAVEL",2,1,28,903,4,938,"2021"
"62385","230360 CATARINA",0,0,5,122,1,128,"2021"
"62386","230365 CATUNDA",0,1,3,81,0,85,"2021"
"62387","230370 CAUCAIA",14,17,80,4837,31,4979,"2021"
"62388","230380 CEDRO",0,3,5,245,1,254,"2021"
"62389","230390 CHAVAL",0,1,5,167,0,173,"2021"
"62390","230393 CHORO",1,1,5,161,2,170,"2021"
"62391","230395 CHOROZINHO",0,0,6,255,0,261,"2021"
"62392","230400 COREAU",0,3,5,295,0,303,"2021"
"62393","230410 CRATEUS",5,7,24,910,5,951,"2021"
"62394","230420 CRATO",9,7,43,2021,3,2083,"2021"
"62395","230423 CROATA",1,4,2,256,0,263,"2021"
"62396","230425 CRUZ",1,2,8,446,2,459,"2021"
"62397","230426 DEPUTADO IRAPUAN PINHEIRO",0,1,0,85,0,86,"2021"
"62398","230427 ERERE",1,0,1,25,0,27,"2021"
"62399","230428 EUSEBIO",7,2,21,1185,6,1221,"2021"
"62400","230430 FARIAS BRITO",1,2,7,231,0,241,"2021"
"62401","230435 FORQUILHA",1,1,3,259,1,265,"2021"
"62402","230440 FORTALEZA",77,128,465,30860,214,31744,"2021"
"62403","230445 FORTIM",0,3,1,209,0,213,"2021"
"62404","230450 FRECHEIRINHA",0,1,7,226,1,235,"2021"
"62405","230460 GENERAL SAMPAIO",0,1,2,83,2,88,"2021"
"62406","230465 GRACA",1,3,5,190,0,199,"2021"
"62407","230470 GRANJA",1,4,12,763,2,782,"2021"
"62408","230480 GRANJEIRO",0,1,0,73,0,74,"2021"
"62409","230490 GROAIRAS",0,0,3,119,0,122,"2021"
"62410","230495 GUAIUBA",0,0,4,289,3,296,"2021"
"62411","230500 GUARACIABA DO NORTE",3,7,9,650,8,677,"2021"
"62412","230510 GUARAMIRANGA",1,0,1,84,0,86,"2021"
"62413","230520 HIDROLANDIA",0,1,6,233,0,240,"2021"
"62414","230523 HORIZONTE",4,4,21,1061,6,1096,"2021"
"62415","230526 IBARETAMA",0,1,2,163,3,169,"2021"
"62416","230530 IBIAPINA",0,2,6,367,3,378,"2021"
"62417","230533 IBICUITINGA",0,0,3,115,1,119,"2021"
"62418","230535 ICAPUI",0,1,3,200,0,204,"2021"
"62419","230540 ICO",2,2,12,675,10,701,"2021"
"62420","230550 IGUATU",5,6,47,1357,14,1429,"2021"
"62421","230560 INDEPENDENCIA",1,2,15,288,1,307,"2021"
"62422","230565 IPAPORANGA",1,0,3,134,1,139,"2021"
"62423","230570 IPAUMIRIM",1,0,2,114,1,118,"2021"
"62424","230580 IPU",1,3,8,635,0,647,"2021"
"62425","230590 IPUEIRAS",3,1,12,453,2,471,"2021"
"62426","230600 IRACEMA",0,1,2,139,0,142,"2021"
"62427","230610 IRAUCUBA",1,4,12,381,0,398,"2021"
"62428","230620 ITAICABA",0,0,0,79,2,81,"2021"
"62429","230625 ITAITINGA",0,5,7,740,2,754,"2021"
"62430","230630 ITAPAGE",2,7,8,608,5,630,"2021"
"62431","230640 ITAPIPOCA",2,4,52,2037,20,2115,"2021"
"62432","230650 ITAPIUNA",0,1,7,216,1,225,"2021"
"62433","230655 ITAREMA",6,3,9,686,4,708,"2021"
"62434","230660 ITATIRA",1,1,2,265,2,271,"2021"
"62435","230670 JAGUARETAMA",1,1,7,216,1,226,"2021"
"62436","230680 JAGUARIBARA",1,0,1,113,1,116,"2021"
"62437","230690 JAGUARIBE",1,2,5,406,1,415,"2021"
"62438","230700 JAGUARUANA",0,4,7,358,0,369,"2021"
"62439","230710 JARDIM",0,2,7,376,7,392,"2021"
"62440","230720 JATI",0,1,2,85,0,88,"2021"
"62441","230725 JIJOCA DE JERICOACOARA",2,2,7,366,0,377,"2021"
"62442","230730 JUAZEIRO DO NORTE",14,16,94,3784,6,3914,"2021"
"62443","230740 JUCAS",2,2,8,310,1,323,"2021"
"62444","230750 LAVRAS DA MANGABEIRA",0,1,7,330,0,338,"2021"
"62445","230760 LIMOEIRO DO NORTE",1,1,4,699,0,705,"2021"
"62446","230763 MADALENA",1,0,4,172,1,178,"2021"
"62447","230765 MARACANAU",14,13,35,4062,25,4149,"2021"
"62448","230770 MARANGUAPE",3,3,20,1186,7,1219,"2021"
"62449","230780 MARCO",2,3,3,505,0,513,"2021"
"62450","230790 MARTINOPOLE",0,0,3,184,0,187,"2021"
"62451","230800 MASSAPE",1,4,14,520,0,539,"2021"
"62452","230810 MAURITI",4,6,10,682,1,703,"2021"
"62453","230820 MERUOCA",1,1,3,196,0,201,"2021"
"62454","230830 MILAGRES",0,3,6,341,0,350,"2021"
"62455","230835 MILHA",1,0,2,147,0,150,"2021"
"62456","230837 MIRAIMA",0,1,4,163,2,170,"2021"
"62457","230840 MISSAO VELHA",2,1,9,598,2,612,"2021"
"62458","230850 MOMBACA",1,7,15,436,2,461,"2021"
"62459","230860 MONSENHOR TABOSA",2,0,5,204,4,215,"2021"
"62460","230870 MORADA NOVA",2,4,17,700,6,729,"2021"
"62461","230880 MORAUJO",0,1,1,99,0,101,"2021"
"62462","230890 MORRINHOS",1,0,3,323,1,328,"2021"
"62463","230900 MUCAMBO",1,0,3,154,0,158,"2021"
"62464","230910 MULUNGU",1,0,3,147,0,151,"2021"
"62465","230920 NOVA OLINDA",0,1,6,231,1,239,"2021"
"62466","230930 NOVA RUSSAS",1,2,4,383,2,392,"2021"
"62467","230940 NOVO ORIENTE",0,2,4,350,1,357,"2021"
"62468","230945 OCARA",0,0,6,266,0,272,"2021"
"62469","230950 OROS",0,0,1,209,1,211,"2021"
"62470","230960 PACAJUS",2,4,21,924,2,953,"2021"
"62471","230970 PACATUBA",4,3,18,998,6,1029,"2021"
"62472","230980 PACOTI",0,0,3,128,0,131,"2021"
"62473","230990 PACUJA",0,0,1,71,0,72,"2021"
"62474","231000 PALHANO",0,2,3,100,0,105,"2021"
"62475","231010 PALMACIA",1,0,1,104,1,107,"2021"
"62476","231020 PARACURU",4,2,6,542,3,557,"2021"
"62477","231025 PARAIPABA",1,4,9,411,1,426,"2021"
"62478","231030 PARAMBU",0,1,8,447,0,456,"2021"
"62479","231040 PARAMOTI",0,0,1,99,0,100,"2021"
"62480","231050 PEDRA BRANCA",0,4,10,474,0,488,"2021"
"62481","231060 PENAFORTE",1,0,1,173,0,175,"2021"
"62482","231070 PENTECOSTE",6,1,5,452,3,467,"2021"
"62483","231080 PEREIRO",3,0,2,205,0,210,"2021"
"62484","231085 PINDORETAMA",0,0,3,313,2,318,"2021"
"62485","231090 PIQUET CARNEIRO",0,1,3,152,0,156,"2021"
"62486","231095 PIRES FERREIRA",1,0,4,109,0,114,"2021"
"62487","231100 PORANGA",1,1,2,144,1,149,"2021"
"62488","231110 PORTEIRAS",0,2,4,261,0,267,"2021"
"62489","231120 POTENGI",2,2,3,130,2,139,"2021"
"62490","231123 POTIRETAMA",0,0,0,68,1,69,"2021"
"62491","231126 QUITERIANOPOLIS",1,3,4,224,4,236,"2021"
"62492","231130 QUIXADA",3,2,13,1210,6,1234,"2021"
"62493","231135 QUIXELO",0,1,2,171,1,175,"2021"
"62494","231140 QUIXERAMOBIM",4,9,40,1141,3,1197,"2021"
"62495","231150 QUIXERE",1,2,0,245,1,249,"2021"
"62496","231160 REDENCAO",0,2,3,394,0,399,"2021"
"62497","231170 RERIUTABA",1,1,5,245,2,254,"2021"
"62498","231180 RUSSAS",3,4,18,898,2,925,"2021"
"62499","231190 SABOEIRO",0,2,6,183,0,191,"2021"
"62500","231195 SALITRE",2,1,5,336,0,344,"2021"
"62501","231200 SANTANA DO ACARAU",3,4,5,377,3,392,"2021"
"62502","231210 SANTANA DO CARIRI",0,0,5,244,2,251,"2021"
"62503","231220 SANTA QUITERIA",1,2,7,489,0,499,"2021"
"62504","231230 SAO BENEDITO",2,2,16,713,0,733,"2021"
"62505","231240 SAO GONCALO DO AMARANTE",1,7,11,798,6,823,"2021"
"62506","231250 SAO JOAO DO JAGUARIBE",0,0,0,50,0,50,"2021"
"62507","231260 SAO LUIS DO CURU",0,0,3,146,3,152,"2021"
"62508","231270 SENADOR POMPEU",1,1,6,276,2,286,"2021"
"62509","231280 SENADOR SA",1,1,1,100,0,103,"2021"
"62510","231290 SOBRAL",5,5,49,2867,8,2934,"2021"
"62511","231300 SOLONOPOLE",0,2,4,209,0,215,"2021"
"62512","231310 TABULEIRO DO NORTE",0,0,5,344,0,349,"2021"
"62513","231320 TAMBORIL",0,0,7,331,0,338,"2021"
"62514","231325 TARRAFAS",0,0,1,80,0,81,"2021"
"62515","231330 TAUA",1,3,10,754,4,772,"2021"
"62516","231335 TEJUCUOCA",0,1,6,200,2,209,"2021"
"62517","231340 TIANGUA",1,9,28,1456,1,1495,"2021"
"62518","231350 TRAIRI",2,2,20,790,8,822,"2021"
"62519","231355 TURURU",0,0,2,259,6,267,"2021"
"62520","231360 UBAJARA",1,4,8,468,0,481,"2021"
"62521","231370 UMARI",0,1,1,68,0,70,"2021"
"62522","231375 UMIRIM",1,1,8,220,4,234,"2021"
"62523","231380 URUBURETAMA",2,1,7,318,2,330,"2021"
"62524","231390 URUOCA",4,0,5,163,0,172,"2021"
"62525","231395 VARJOTA",0,0,7,248,3,258,"2021"
"62526","231400 VARZEA ALEGRE",0,2,6,445,1,454,"2021"
"62527","231410 VICOSA DO CEARA",3,2,12,974,0,991,"2021"
"62528","240010 ACARI",1,2,2,116,0,121,"2021"
"62529","240020 ACU",3,1,9,683,1,697,"2021"
"62530","240030 AFONSO BEZERRA",1,0,1,114,0,116,"2021"
"62531","240040 AGUA NOVA",0,0,1,37,0,38,"2021"
"62532","240050 ALEXANDRIA",0,1,1,148,0,150,"2021"
"62533","240060 ALMINO AFONSO",0,0,0,52,0,52,"2021"
"62534","240070 ALTO DO RODRIGUES",0,0,4,144,0,148,"2021"
"62535","240080 ANGICOS",1,0,4,119,0,124,"2021"
"62536","240090 ANTONIO MARTINS",0,0,1,71,0,72,"2021"
"62537","240100 APODI",0,1,7,404,0,412,"2021"
"62538","240110 AREIA BRANCA",1,1,4,304,3,313,"2021"
"62539","240120 ARES",2,1,1,174,2,180,"2021"
"62540","240130 AUGUSTO SEVERO",0,2,0,78,1,81,"2021"
"62541","240140 BAIA FORMOSA",1,1,2,111,2,117,"2021"
"62542","240145 BARAUNA",3,1,2,347,0,353,"2021"
"62543","240150 BARCELONA",0,1,0,52,5,58,"2021"
"62544","240160 BENTO FERNANDES",0,0,1,48,0,49,"2021"
"62545","240165 BODO",0,0,1,36,0,37,"2021"
"62546","240170 BOM JESUS",0,3,3,117,2,125,"2021"
"62547","240180 BREJINHO",1,1,3,170,1,176,"2021"
"62548","240185 CAICARA DO NORTE",0,1,1,70,0,72,"2021"
"62549","240190 CAICARA DO RIO DO VENTO",0,0,0,49,3,52,"2021"
"62550","240200 CAICO",5,6,23,666,4,704,"2021"
"62551","240210 CAMPO REDONDO",0,0,3,123,1,127,"2021"
"62552","240220 CANGUARETAMA",1,1,9,474,9,494,"2021"
"62553","240230 CARAUBAS",0,2,4,182,2,190,"2021"
"62554","240240 CARNAUBA DOS DANTAS",1,0,2,89,0,92,"2021"
"62555","240250 CARNAUBAIS",0,0,0,94,0,94,"2021"
"62556","240260 CEARA-MIRIM",7,4,12,1129,5,1157,"2021"
"62557","240270 CERRO CORA",0,2,4,137,0,143,"2021"
"62558","240280 CORONEL EZEQUIEL",0,1,3,78,2,84,"2021"
"62559","240290 CORONEL JOAO PESSOA",2,0,2,55,0,59,"2021"
"62560","240300 CRUZETA",0,0,3,85,0,88,"2021"
"62561","240310 CURRAIS NOVOS",4,0,10,451,3,468,"2021"
"62562","240320 DOUTOR SEVERIANO",1,0,1,91,0,93,"2021"
"62563","240325 PARNAMIRIM",9,12,28,3432,14,3495,"2021"
"62564","240330 ENCANTO",0,0,2,92,0,94,"2021"
"62565","240340 EQUADOR",0,0,0,68,1,69,"2021"
"62566","240350 ESPIRITO SANTO",0,1,2,106,4,113,"2021"
"62567","240360 EXTREMOZ",3,0,9,620,8,640,"2021"
"62568","240370 FELIPE GUERRA",0,0,1,54,0,55,"2021"
"62569","240375 FERNANDO PEDROZA",1,0,2,38,0,41,"2021"
"62570","240380 FLORANIA",1,0,2,86,0,89,"2021"
"62571","240390 FRANCISCO DANTAS",1,0,0,31,0,32,"2021"
"62572","240400 FRUTUOSO GOMES",1,1,0,54,0,56,"2021"
"62573","240410 GALINHOS",0,0,0,41,0,41,"2021"
"62574","240420 GOIANINHA",2,3,9,479,0,493,"2021"
"62575","240430 GOVERNADOR DIX-SEPT ROSADO",1,1,4,138,0,144,"2021"
"62576","240440 GROSSOS",1,0,1,89,0,91,"2021"
"62577","240450 GUAMARE",1,2,9,261,1,274,"2021"
"62578","240460 IELMO MARINHO",1,1,1,129,0,132,"2021"
"62579","240470 IPANGUACU",0,0,4,195,2,201,"2021"
"62580","240480 IPUEIRA",0,0,0,16,0,16,"2021"
"62581","240485 ITAJA",2,1,1,99,1,104,"2021"
"62582","240490 ITAU",0,0,0,72,0,72,"2021"
"62583","240500 JACANA",0,0,2,95,3,100,"2021"
"62584","240510 JANDAIRA",1,0,2,92,0,95,"2021"
"62585","240520 JANDUIS",1,0,1,46,1,49,"2021"
"62586","240530 JANUARIO CICCO",0,0,8,120,3,131,"2021"
"62587","240540 JAPI",0,1,2,82,1,86,"2021"
"62588","240550 JARDIM DE ANGICOS",1,0,1,32,0,34,"2021"
"62589","240560 JARDIM DE PIRANHAS",0,2,1,137,0,140,"2021"
"62590","240570 JARDIM DO SERIDO",0,0,5,100,1,106,"2021"
"62591","240580 JOAO CAMARA",4,6,8,500,1,519,"2021"
"62592","240590 JOAO DIAS",1,0,1,18,0,20,"2021"
"62593","240600 JOSE DA PENHA",1,0,0,77,0,78,"2021"
"62594","240610 JUCURUTU",1,1,6,203,4,215,"2021"
"62595","240615 JUNDIA",0,0,1,38,1,40,"2021"
"62596","240620 LAGOA D'ANTA",0,0,4,71,2,77,"2021"
"62597","240630 LAGOA DE PEDRAS",3,0,0,97,1,101,"2021"
"62598","240640 LAGOA DE VELHOS",0,0,3,29,0,32,"2021"
"62599","240650 LAGOA NOVA",0,0,3,188,3,194,"2021"
"62600","240660 LAGOA SALGADA",0,1,1,137,3,142,"2021"
"62601","240670 LAJES",0,0,2,113,2,117,"2021"
"62602","240680 LAJES PINTADAS",0,0,1,66,0,67,"2021"
"62603","240690 LUCRECIA",0,0,2,35,0,37,"2021"
"62604","240700 LUIS GOMES",0,2,1,106,0,109,"2021"
"62605","240710 MACAIBA",3,5,11,979,8,1006,"2021"
"62606","240720 MACAU",0,4,7,285,2,298,"2021"
"62607","240725 MAJOR SALES",0,1,1,45,0,47,"2021"
"62608","240730 MARCELINO VIEIRA",0,0,0,115,0,115,"2021"
"62609","240740 MARTINS",0,0,0,94,0,94,"2021"
"62610","240750 MAXARANGUAPE",1,1,1,127,1,131,"2021"
"62611","240760 MESSIAS TARGINO",0,0,0,56,0,56,"2021"
"62612","240770 MONTANHAS",0,0,2,199,1,202,"2021"
"62613","240780 MONTE ALEGRE",1,3,4,263,0,271,"2021"
"62614","240790 MONTE DAS GAMELEIRAS",0,1,2,35,3,41,"2021"
"62615","240800 MOSSORO",17,8,42,3447,3,3517,"2021"
"62616","240810 NATAL",22,45,145,9964,46,10222,"2021"
"62617","240820 NISIA FLORESTA",1,2,7,391,0,401,"2021"
"62618","240830 NOVA CRUZ",3,4,4,465,1,477,"2021"
"62619","240840 OLHO-D'AGUA DO BORGES",0,0,0,34,0,34,"2021"
"62620","240850 OURO BRANCO",0,0,1,60,0,61,"2021"
"62621","240860 PARANA",0,0,0,53,0,53,"2021"
"62622","240870 PARAU",0,0,0,43,1,44,"2021"
"62623","240880 PARAZINHO",0,1,0,118,1,120,"2021"
"62624","240890 PARELHAS",0,0,5,244,2,251,"2021"
"62625","240895 RIO DO FOGO",0,1,1,154,2,158,"2021"
"62626","240910 PASSA E FICA",2,1,2,154,1,160,"2021"
"62627","240920 PASSAGEM",0,1,0,40,0,41,"2021"
"62628","240930 PATU",0,0,2,105,0,107,"2021"
"62629","240933 SANTA MARIA",0,1,3,73,1,78,"2021"
"62630","240940 PAU DOS FERROS",1,4,5,415,0,425,"2021"
"62631","240950 PEDRA GRANDE",0,0,0,57,0,57,"2021"
"62632","240960 PEDRA PRETA",0,0,0,29,1,30,"2021"
"62633","240970 PEDRO AVELINO",0,0,2,59,0,61,"2021"
"62634","240980 PEDRO VELHO",0,2,7,188,0,197,"2021"
"62635","240990 PENDENCIAS",2,0,1,129,1,133,"2021"
"62636","241000 PILOES",0,0,0,20,0,20,"2021"
"62637","241010 POCO BRANCO",2,4,3,141,1,151,"2021"
"62638","241020 PORTALEGRE",0,0,2,72,0,74,"2021"
"62639","241025 PORTO DO MANGUE",0,0,1,77,0,78,"2021"
"62640","241030 SERRA CAIADA",0,0,3,150,2,155,"2021"
"62641","241040 PUREZA",1,2,2,130,2,137,"2021"
"62642","241050 RAFAEL FERNANDES",0,0,0,60,0,60,"2021"
"62643","241060 RAFAEL GODEIRO",0,0,0,22,0,22,"2021"
"62644","241070 RIACHO DA CRUZ",0,0,0,23,0,23,"2021"
"62645","241080 RIACHO DE SANTANA",0,0,0,37,0,37,"2021"
"62646","241090 RIACHUELO",1,0,2,93,2,98,"2021"
"62647","241100 RODOLFO FERNANDES",0,0,2,54,0,56,"2021"
"62648","241105 TIBAU",0,0,1,80,0,81,"2021"
"62649","241110 RUY BARBOSA",0,0,1,43,1,45,"2021"
"62650","241120 SANTA CRUZ",1,4,16,481,2,504,"2021"
"62651","241140 SANTANA DO MATOS",0,1,4,109,2,116,"2021"
"62652","241142 SANTANA DO SERIDO",0,0,1,28,0,29,"2021"
"62653","241150 SANTO ANTONIO",0,5,5,312,3,325,"2021"
"62654","241160 SAO BENTO DO NORTE",0,2,2,61,0,65,"2021"
"62655","241170 SAO BENTO DO TRAIRI",0,0,2,66,0,68,"2021"
"62656","241180 SAO FERNANDO",0,1,0,30,0,31,"2021"
"62657","241190 SAO FRANCISCO DO OESTE",0,0,1,54,0,55,"2021"
"62658","241200 SAO GONCALO DO AMARANTE",5,7,25,1475,8,1520,"2021"
"62659","241210 SAO JOAO DO SABUGI",0,0,1,64,0,65,"2021"
"62660","241220 SAO JOSE DE MIPIBU",0,8,10,701,2,721,"2021"
"62661","241230 SAO JOSE DO CAMPESTRE",0,1,3,127,2,133,"2021"
"62662","241240 SAO JOSE DO SERIDO",0,0,0,56,0,56,"2021"
"62663","241250 SAO MIGUEL",0,3,3,277,3,286,"2021"
"62664","241255 SAO MIGUEL DO GOSTOSO",0,0,2,145,1,148,"2021"
"62665","241260 SAO PAULO DO POTENGI",0,2,7,197,4,210,"2021"
"62666","241270 SAO PEDRO",1,0,2,73,1,77,"2021"
"62667","241280 SAO RAFAEL",0,0,0,74,1,75,"2021"
"62668","241290 SAO TOME",0,0,4,96,2,102,"2021"
"62669","241300 SAO VICENTE",0,2,2,62,0,66,"2021"
"62670","241310 SENADOR ELOI DE SOUZA",0,1,2,92,2,97,"2021"
"62671","241320 SENADOR GEORGINO AVELINO",0,0,4,70,0,74,"2021"
"62672","241330 SERRA DE SAO BENTO",0,0,4,60,1,65,"2021"
"62673","241335 SERRA DO MEL",0,1,4,195,0,200,"2021"
"62674","241340 SERRA NEGRA DO NORTE",0,1,2,68,2,73,"2021"
"62675","241350 SERRINHA",0,0,2,81,1,84,"2021"
"62676","241355 SERRINHA DOS PINTOS",0,0,3,42,0,45,"2021"
"62677","241360 SEVERIANO MELO",0,0,1,67,0,68,"2021"
"62678","241370 SITIO NOVO",0,0,3,50,1,54,"2021"
"62679","241380 TABOLEIRO GRANDE",0,0,1,26,0,27,"2021"
"62680","241390 TAIPU",0,1,1,127,2,131,"2021"
"62681","241400 TANGARA",0,1,8,189,1,199,"2021"
"62682","241410 TENENTE ANANIAS",0,0,0,140,0,140,"2021"
"62683","241415 TENENTE LAURENTINO CRUZ",0,0,0,81,1,82,"2021"
"62684","241420 TIBAU DO SUL",0,2,5,232,5,244,"2021"
"62685","241430 TIMBAUBA DOS BATISTAS",0,0,0,18,0,18,"2021"
"62686","241440 TOUROS",1,3,5,485,2,496,"2021"
"62687","241445 TRIUNFO POTIGUAR",0,0,1,56,1,58,"2021"
"62688","241450 UMARIZAL",2,0,0,99,0,101,"2021"
"62689","241460 UPANEMA",0,0,4,128,0,132,"2021"
"62690","241470 VARZEA",0,1,2,64,0,67,"2021"
"62691","241475 VENHA-VER",1,0,1,44,0,46,"2021"
"62692","241480 VERA CRUZ",2,2,2,191,2,199,"2021"
"62693","241490 VICOSA",0,0,0,20,0,20,"2021"
"62694","241500 VILA FLOR",0,0,1,55,0,56,"2021"
"62695","MUNICIPIO IGNORADO - PB",0,0,0,3,2,5,"2021"
"62696","250010 AGUA BRANCA",1,0,4,125,2,132,"2021"
"62697","250020 AGUIAR",0,0,1,60,2,63,"2021"
"62698","250030 ALAGOA GRANDE",1,0,6,408,3,418,"2021"
"62699","250040 ALAGOA NOVA",2,4,6,282,15,309,"2021"
"62700","250050 ALAGOINHA",0,2,1,226,1,230,"2021"
"62701","250053 ALCANTIL",0,0,2,93,1,96,"2021"
"62702","250057 ALGODAO DE JANDAIRA",0,0,0,57,1,58,"2021"
"62703","250060 ALHANDRA",0,5,4,366,4,379,"2021"
"62704","250070 SAO JOAO DO RIO DO PEIXE",0,1,2,183,2,188,"2021"
"62705","250073 AMPARO",0,0,0,27,1,28,"2021"
"62706","250077 APARECIDA",2,0,0,90,0,92,"2021"
"62707","250080 ARACAGI",0,0,1,221,4,226,"2021"
"62708","250090 ARARA",0,0,1,134,1,136,"2021"
"62709","250100 ARARUNA",1,1,1,238,4,245,"2021"
"62710","250110 AREIA",1,1,5,272,6,285,"2021"
"62711","250115 AREIA DE BARAUNAS",0,0,0,33,1,34,"2021"
"62712","250120 AREIAL",0,1,3,106,3,113,"2021"
"62713","250130 AROEIRAS",2,4,6,221,2,235,"2021"
"62714","250135 ASSUNCAO",0,0,0,57,3,60,"2021"
"62715","250140 BAIA DA TRAICAO",1,4,1,174,0,180,"2021"
"62716","250150 BANANEIRAS",3,3,4,300,1,311,"2021"
"62717","250153 BARAUNA",1,3,0,59,0,63,"2021"
"62718","250157 BARRA DE SANTANA",2,1,1,89,1,94,"2021"
"62719","250160 BARRA DE SANTA ROSA",0,0,1,157,1,159,"2021"
"62720","250170 BARRA DE SAO MIGUEL",0,0,1,96,0,97,"2021"
"62721","250180 BAYEUX",3,5,18,1287,7,1320,"2021"
"62722","250190 BELEM",0,1,1,210,2,214,"2021"
"62723","250200 BELEM DO BREJO DO CRUZ",1,0,0,60,0,61,"2021"
"62724","250205 BERNARDINO BATISTA",0,0,3,68,0,71,"2021"
"62725","250210 BOA VENTURA",0,1,1,68,0,70,"2021"
"62726","250215 BOA VISTA",0,0,1,78,2,81,"2021"
"62727","250220 BOM JESUS",0,0,1,30,1,32,"2021"
"62728","250230 BOM SUCESSO",0,0,0,51,2,53,"2021"
"62729","250240 BONITO DE SANTA FE",0,0,7,140,1,148,"2021"
"62730","250250 BOQUEIRAO",0,0,2,262,1,265,"2021"
"62731","250260 IGARACY",0,0,1,62,1,64,"2021"
"62732","250270 BORBOREMA",2,0,0,60,0,62,"2021"
"62733","250280 BREJO DO CRUZ",1,2,5,190,0,198,"2021"
"62734","250290 BREJO DOS SANTOS",2,0,1,70,0,73,"2021"
"62735","250300 CAAPORA",1,3,12,373,2,391,"2021"
"62736","250310 CABACEIRAS",0,0,0,53,0,53,"2021"
"62737","250320 CABEDELO",5,6,14,942,0,967,"2021"
"62738","250330 CACHOEIRA DOS INDIOS",1,0,3,133,2,139,"2021"
"62739","250340 CACIMBA DE AREIA",1,0,1,42,0,44,"2021"
"62740","250350 CACIMBA DE DENTRO",0,1,4,222,1,228,"2021"
"62741","250355 CACIMBAS",6,1,5,148,5,165,"2021"
"62742","250360 CAICARA",1,1,1,74,1,78,"2021"
"62743","250370 CAJAZEIRAS",1,4,13,865,5,888,"2021"
"62744","250375 CAJAZEIRINHAS",1,0,0,44,0,45,"2021"
"62745","250380 CALDAS BRANDAO",0,0,0,75,0,75,"2021"
"62746","250390 CAMALAU",0,1,4,90,0,95,"2021"
"62747","250400 CAMPINA GRANDE",16,18,74,5746,96,5950,"2021"
"62748","250403 CAPIM",0,1,3,128,0,132,"2021"
"62749","250407 CARAUBAS",0,0,0,74,1,75,"2021"
"62750","250410 CARRAPATEIRA",0,0,1,29,0,30,"2021"
"62751","250415 CASSERENGUE",1,0,3,77,1,82,"2021"
"62752","250420 CATINGUEIRA",3,1,1,59,0,64,"2021"
"62753","250430 CATOLE DO ROCHA",2,0,9,354,1,366,"2021"
"62754","250435 CATURITE",0,0,0,82,1,83,"2021"
"62755","250440 CONCEICAO",0,0,3,242,1,246,"2021"
"62756","250450 CONDADO",2,0,0,86,1,89,"2021"
"62757","250460 CONDE",2,2,8,508,5,525,"2021"
"62758","250470 CONGO",0,0,0,114,1,115,"2021"
"62759","250480 COREMAS",1,1,6,175,3,186,"2021"
"62760","250485 COXIXOLA",0,0,0,25,0,25,"2021"
"62761","250490 CRUZ DO ESPIRITO SANTO",2,2,6,299,0,309,"2021"
"62762","250500 CUBATI",0,0,0,112,3,115,"2021"
"62763","250510 CUITE",0,2,4,233,0,239,"2021"
"62764","250520 CUITEGI",1,0,0,104,0,105,"2021"
"62765","250523 CUITE DE MAMANGUAPE",0,1,0,114,0,115,"2021"
"62766","250527 CURRAL DE CIMA",0,0,1,80,1,82,"2021"
"62767","250530 CURRAL VELHO",0,0,1,31,1,33,"2021"
"62768","250535 DAMIAO",0,0,0,68,2,70,"2021"
"62769","250540 DESTERRO",4,1,3,127,10,145,"2021"
"62770","250550 VISTA SERRANA",1,0,1,46,2,50,"2021"
"62771","250560 DIAMANTE",1,2,3,77,0,83,"2021"
"62772","250570 DONA INES",1,0,3,133,2,139,"2021"
"62773","250580 DUAS ESTRADAS",0,0,2,51,0,53,"2021"
"62774","250590 EMAS",0,0,1,37,2,40,"2021"
"62775","250600 ESPERANCA",0,4,3,435,5,447,"2021"
"62776","250610 FAGUNDES",1,0,4,150,2,157,"2021"
"62777","250620 FREI MARTINHO",0,0,0,23,1,24,"2021"
"62778","250625 GADO BRAVO",0,2,1,134,2,139,"2021"
"62779","250630 GUARABIRA",1,5,8,769,1,784,"2021"
"62780","250640 GURINHEM",0,1,0,197,0,198,"2021"
"62781","250650 GURJAO",0,0,1,51,1,53,"2021"
"62782","250660 IBIARA",0,0,1,76,0,77,"2021"
"62783","250670 IMACULADA",0,0,2,137,2,141,"2021"
"62784","250680 INGA",0,1,3,233,5,242,"2021"
"62785","250690 ITABAIANA",0,0,1,365,0,366,"2021"
"62786","250700 ITAPORANGA",1,1,7,315,3,327,"2021"
"62787","250710 ITAPOROROCA",0,0,5,270,0,275,"2021"
"62788","250720 ITATUBA",0,1,2,167,1,171,"2021"
"62789","250730 JACARAU",0,3,4,224,1,232,"2021"
"62790","250740 JERICO",0,1,1,81,0,83,"2021"
"62791","250750 JOAO PESSOA",33,54,152,10847,40,11126,"2021"
"62792","250760 JUAREZ TAVORA",0,0,4,119,3,126,"2021"
"62793","250770 JUAZEIRINHO",0,3,5,281,11,300,"2021"
"62794","250780 JUNCO DO SERIDO",1,0,2,105,3,111,"2021"
"62795","250790 JURIPIRANGA",0,0,3,201,0,204,"2021"
"62796","250800 JURU",1,2,3,109,1,116,"2021"
"62797","250810 LAGOA",0,0,0,53,0,53,"2021"
"62798","250820 LAGOA DE DENTRO",0,0,2,125,6,133,"2021"
"62799","250830 LAGOA SECA",1,1,4,383,7,396,"2021"
"62800","250840 LASTRO",0,0,0,45,0,45,"2021"
"62801","250850 LIVRAMENTO",1,0,3,84,0,88,"2021"
"62802","250855 LOGRADOURO",0,0,0,32,0,32,"2021"
"62803","250860 LUCENA",0,0,5,218,1,224,"2021"
"62804","250870 MAE D'AGUA",1,0,5,34,0,40,"2021"
"62805","250880 MALTA",0,0,5,84,1,90,"2021"
"62806","250890 MAMANGUAPE",2,2,23,815,1,843,"2021"
"62807","250900 MANAIRA",2,0,0,163,1,166,"2021"
"62808","250905 MARCACAO",3,1,3,169,0,176,"2021"
"62809","250910 MARI",1,1,5,273,1,281,"2021"
"62810","250915 MARIZOPOLIS",1,0,0,76,0,77,"2021"
"62811","250920 MASSARANDUBA",1,1,4,144,3,153,"2021"
"62812","250930 MATARACA",0,1,1,177,0,179,"2021"
"62813","250933 MATINHAS",0,1,3,73,5,82,"2021"
"62814","250937 MATO GROSSO",0,0,0,28,0,28,"2021"
"62815","250939 MATUREIA",2,0,4,121,5,132,"2021"
"62816","250940 MOGEIRO",0,1,1,198,0,200,"2021"
"62817","250950 MONTADAS",1,1,1,98,6,107,"2021"
"62818","250960 MONTE HOREBE",0,0,1,62,0,63,"2021"
"62819","250970 MONTEIRO",1,1,1,482,1,486,"2021"
"62820","250980 MULUNGU",0,0,1,107,1,109,"2021"
"62821","250990 NATUBA",0,2,0,85,0,87,"2021"
"62822","251000 NAZAREZINHO",0,1,0,96,0,97,"2021"
"62823","251010 NOVA FLORESTA",0,0,2,99,1,102,"2021"
"62824","251020 NOVA OLINDA",0,0,0,77,1,78,"2021"
"62825","251030 NOVA PALMEIRA",1,1,0,35,0,37,"2021"
"62826","251040 OLHO D'AGUA",0,0,1,83,2,86,"2021"
"62827","251050 OLIVEDOS",0,0,1,42,1,44,"2021"
"62828","251060 OURO VELHO",0,0,1,37,0,38,"2021"
"62829","251065 PARARI",0,0,0,14,0,14,"2021"
"62830","251070 PASSAGEM",0,0,1,24,0,25,"2021"
"62831","251080 PATOS",8,10,25,1335,25,1403,"2021"
"62832","251090 PAULISTA",0,0,1,154,1,156,"2021"
"62833","251100 PEDRA BRANCA",0,1,0,62,0,63,"2021"
"62834","251110 PEDRA LAVRADA",0,0,1,74,0,75,"2021"
"62835","251120 PEDRAS DE FOGO",0,2,3,441,1,447,"2021"
"62836","251130 PIANCO",1,2,2,164,1,170,"2021"
"62837","251140 PICUI",1,1,6,236,3,247,"2021"
"62838","251150 PILAR",1,0,3,204,1,209,"2021"
"62839","251160 PILOES",0,1,2,123,2,128,"2021"
"62840","251170 PILOEZINHOS",0,0,1,95,1,97,"2021"
"62841","251180 PIRPIRITUBA",0,0,2,121,4,127,"2021"
"62842","251190 PITIMBU",1,0,8,281,4,294,"2021"
"62843","251200 POCINHOS",0,1,2,224,5,232,"2021"
"62844","251203 POCO DANTAS",0,0,1,50,0,51,"2021"
"62845","251207 POCO DE JOSE DE MOURA",0,0,0,42,2,44,"2021"
"62846","251210 POMBAL",2,1,5,327,1,336,"2021"
"62847","251220 PRATA",0,0,0,47,1,48,"2021"
"62848","251230 PRINCESA ISABEL",4,3,5,286,3,301,"2021"
"62849","251240 PUXINANA",1,0,3,215,10,229,"2021"
"62850","251250 QUEIMADAS",2,4,11,654,6,677,"2021"
"62851","251260 QUIXABA",0,0,1,18,0,19,"2021"
"62852","251270 REMIGIO",0,0,0,243,8,251,"2021"
"62853","251272 PEDRO REGIS",0,0,1,70,0,71,"2021"
"62854","251274 RIACHAO",0,0,0,37,0,37,"2021"
"62855","251275 RIACHAO DO BACAMARTE",0,0,0,77,0,77,"2021"
"62856","251276 RIACHAO DO POCO",0,1,2,74,0,77,"2021"
"62857","251278 RIACHO DE SANTO ANTONIO",0,0,0,38,0,38,"2021"
"62858","251280 RIACHO DOS CAVALOS",0,0,1,93,0,94,"2021"
"62859","251290 RIO TINTO",0,3,9,403,1,416,"2021"
"62860","251300 SALGADINHO",1,0,0,42,0,43,"2021"
"62861","251310 SALGADO DE SAO FELIX",0,1,3,147,0,151,"2021"
"62862","251315 SANTA CECILIA",1,0,8,116,2,127,"2021"
"62863","251320 SANTA CRUZ",0,0,2,62,0,64,"2021"
"62864","251330 SANTA HELENA",1,1,3,64,0,69,"2021"
"62865","251335 SANTA INES",0,0,1,36,0,37,"2021"
"62866","251340 SANTA LUZIA",1,0,7,188,2,198,"2021"
"62867","251350 SANTANA DE MANGUEIRA",0,0,0,49,1,50,"2021"
"62868","251360 SANTANA DOS GARROTES",0,0,0,71,1,72,"2021"
"62869","251365 JOCA CLAUDINO",0,0,0,18,0,18,"2021"
"62870","251370 SANTA RITA",8,11,26,2229,1,2275,"2021"
"62871","251380 SANTA TERESINHA",1,1,2,31,1,36,"2021"
"62872","251385 SANTO ANDRE",0,0,1,26,1,28,"2021"
"62873","251390 SAO BENTO",2,2,6,418,1,429,"2021"
"62874","251392 SAO BENTINHO",0,1,0,53,0,54,"2021"
"62875","251394 SAO DOMINGOS DO CARIRI",0,0,0,32,0,32,"2021"
"62876","251396 SAO DOMINGOS",0,0,0,28,0,28,"2021"
"62877","251398 SAO FRANCISCO",0,1,0,37,0,38,"2021"
"62878","251400 SAO JOAO DO CARIRI",0,0,0,54,0,54,"2021"
"62879","251410 SAO JOAO DO TIGRE",0,0,0,53,0,53,"2021"
"62880","251420 SAO JOSE DA LAGOA TAPADA",0,0,0,71,0,71,"2021"
"62881","251430 SAO JOSE DE CAIANA",0,0,2,91,0,93,"2021"
"62882","251440 SAO JOSE DE ESPINHARAS",2,0,1,53,0,56,"2021"
"62883","251445 SAO JOSE DOS RAMOS",0,0,0,72,0,72,"2021"
"62884","251450 SAO JOSE DE PIRANHAS",0,3,7,227,4,241,"2021"
"62885","251455 SAO JOSE DE PRINCESA",0,0,0,52,1,53,"2021"
"62886","251460 SAO JOSE DO BONFIM",2,0,0,48,0,50,"2021"
"62887","251465 SAO JOSE DO BREJO DO CRUZ",0,0,1,22,0,23,"2021"
"62888","251470 SAO JOSE DO SABUGI",0,0,0,45,1,46,"2021"
"62889","251480 SAO JOSE DOS CORDEIROS",0,0,1,47,1,49,"2021"
"62890","251490 SAO MAMEDE",2,2,2,81,0,87,"2021"
"62891","251500 SAO MIGUEL DE TAIPU",0,0,2,130,0,132,"2021"
"62892","251510 SAO SEBASTIAO DE LAGOA DE ROCA",0,0,2,132,5,139,"2021"
"62893","251520 SAO SEBASTIAO DO UMBUZEIRO",1,0,0,36,0,37,"2021"
"62894","251530 SAPE",0,5,9,606,4,624,"2021"
"62895","251540 SAO VICENTE DO SERIDO",0,0,3,154,3,160,"2021"
"62896","251550 SERRA BRANCA",0,1,2,142,2,147,"2021"
"62897","251560 SERRA DA RAIZ",0,0,0,34,0,34,"2021"
"62898","251570 SERRA GRANDE",1,0,2,50,1,54,"2021"
"62899","251580 SERRA REDONDA",0,2,1,98,0,101,"2021"
"62900","251590 SERRARIA",1,0,2,69,1,73,"2021"
"62901","251593 SERTAOZINHO",1,0,0,77,0,78,"2021"
"62902","251597 SOBRADO",0,1,1,119,0,121,"2021"
"62903","251600 SOLANEA",1,1,2,361,4,369,"2021"
"62904","251610 SOLEDADE",1,0,6,189,4,200,"2021"
"62905","251615 SOSSEGO",0,0,2,53,2,57,"2021"
"62906","251620 SOUSA",6,6,6,975,2,995,"2021"
"62907","251630 SUME",1,0,3,217,2,223,"2021"
"62908","251640 TACIMA",1,1,1,103,2,108,"2021"
"62909","251650 TAPEROA",1,1,3,191,2,198,"2021"
"62910","251660 TAVARES",1,1,1,167,4,174,"2021"
"62911","251670 TEIXEIRA",3,0,2,220,5,230,"2021"
"62912","251675 TENORIO",0,0,0,41,2,43,"2021"
"62913","251680 TRIUNFO",0,2,0,102,1,105,"2021"
"62914","251690 UIRAUNA",1,0,5,161,1,168,"2021"
"62915","251700 UMBUZEIRO",0,0,7,111,2,120,"2021"
"62916","251710 VARZEA",0,0,1,27,1,29,"2021"
"62917","251720 VIEIROPOLIS",0,0,0,36,0,36,"2021"
"62918","251740 ZABELE",0,0,1,30,0,31,"2021"
"62919","MUNICIPIO IGNORADO - PE",0,0,0,19,0,19,"2021"
"62920","260005 ABREU E LIMA",3,6,9,1244,11,1273,"2021"
"62921","260010 AFOGADOS DA INGAZEIRA",1,3,11,560,0,575,"2021"
"62922","260020 AFRANIO",0,0,2,231,8,241,"2021"
"62923","260030 AGRESTINA",1,1,6,363,0,371,"2021"
"62924","260040 AGUA PRETA",1,1,3,401,2,408,"2021"
"62925","260050 AGUAS BELAS",3,3,12,682,2,702,"2021"
"62926","260060 ALAGOINHA",1,2,2,176,1,182,"2021"
"62927","260070 ALIANCA",2,1,2,511,2,518,"2021"
"62928","260080 ALTINHO",0,1,4,234,1,240,"2021"
"62929","260090 AMARAJI",2,1,3,262,0,268,"2021"
"62930","260100 ANGELIM",0,1,0,148,1,150,"2021"
"62931","260105 ARACOIABA",1,2,3,319,2,327,"2021"
"62932","260110 ARARIPINA",6,7,31,1566,6,1616,"2021"
"62933","260120 ARCOVERDE",3,4,5,1113,10,1135,"2021"
"62934","260130 BARRA DE GUABIRABA",0,0,3,155,0,158,"2021"
"62935","260140 BARREIROS",3,5,7,654,9,678,"2021"
"62936","260150 BELEM DE MARIA",1,1,1,132,1,136,"2021"
"62937","260160 BELEM DE SAO FRANCISCO",0,3,11,265,0,279,"2021"
"62938","260170 BELO JARDIM",1,5,14,1094,5,1119,"2021"
"62939","260180 BETANIA",0,1,6,171,0,178,"2021"
"62940","260190 BEZERROS",6,3,9,688,5,711,"2021"
"62941","260200 BODOCO",1,4,7,509,7,528,"2021"
"62942","260210 BOM CONSELHO",2,1,8,435,2,448,"2021"
"62943","260220 BOM JARDIM",0,1,8,423,3,435,"2021"
"62944","260230 BONITO",4,0,8,629,8,649,"2021"
"62945","260240 BREJAO",0,0,2,172,3,177,"2021"
"62946","260250 BREJINHO",1,0,2,91,0,94,"2021"
"62947","260260 BREJO DA MADRE DE DEUS",4,1,9,723,6,743,"2021"
"62948","260270 BUENOS AIRES",2,0,1,173,3,179,"2021"
"62949","260280 BUIQUE",1,8,4,836,1,850,"2021"
"62950","260290 CABO DE SANTO AGOSTINHO",9,15,33,2832,16,2905,"2021"
"62951","260300 CABROBO",1,1,14,506,1,523,"2021"
"62952","260310 CACHOEIRINHA",0,1,2,333,0,336,"2021"
"62953","260320 CAETES",1,2,7,436,1,447,"2021"
"62954","260330 CALCADO",0,1,5,115,4,125,"2021"
"62955","260340 CALUMBI",1,1,3,92,0,97,"2021"
"62956","260345 CAMARAGIBE",5,10,26,2000,7,2048,"2021"
"62957","260350 CAMOCIM DE SAO FELIX",1,0,3,206,1,211,"2021"
"62958","260360 CAMUTANGA",2,1,1,87,0,91,"2021"
"62959","260370 CANHOTINHO",1,2,5,340,2,350,"2021"
"62960","260380 CAPOEIRAS",0,1,5,258,5,269,"2021"
"62961","260390 CARNAIBA",1,0,5,244,0,250,"2021"
"62962","260392 CARNAUBEIRA DA PENHA",2,1,4,256,9,272,"2021"
"62963","260400 CARPINA",5,4,14,1023,6,1052,"2021"
"62964","260410 CARUARU",9,12,54,5443,36,5554,"2021"
"62965","260415 CASINHAS",0,0,3,152,1,156,"2021"
"62966","260420 CATENDE",2,3,4,439,6,454,"2021"
"62967","260430 CEDRO",2,1,2,150,0,155,"2021"
"62968","260440 CHA DE ALEGRIA",0,2,1,168,0,171,"2021"
"62969","260450 CHA GRANDE",0,0,2,313,2,317,"2021"
"62970","260460 CONDADO",1,1,1,335,1,339,"2021"
"62971","260470 CORRENTES",2,0,3,174,1,180,"2021"
"62972","260480 CORTES",0,1,2,157,0,160,"2021"
"62973","260490 CUMARU",0,1,4,134,1,140,"2021"
"62974","260500 CUPIRA",0,0,8,343,5,356,"2021"
"62975","260510 CUSTODIA",3,3,9,531,4,550,"2021"
"62976","260515 DORMENTES",0,2,6,187,30,225,"2021"
"62977","260520 ESCADA",1,1,7,761,7,777,"2021"
"62978","260530 EXU",0,4,9,401,2,416,"2021"
"62979","260540 FEIRA NOVA",0,1,3,296,1,301,"2021"
"62980","260545 FERNANDO DE NORONHA",0,0,0,26,0,26,"2021"
"62981","260550 FERREIROS",0,0,2,133,3,138,"2021"
"62982","260560 FLORES",0,2,4,266,0,272,"2021"
"62983","260570 FLORESTA",3,1,6,481,1,492,"2021"
"62984","260580 FREI MIGUELINHO",1,0,3,133,0,137,"2021"
"62985","260590 GAMELEIRA",2,0,6,287,0,295,"2021"
"62986","260600 GARANHUNS",7,5,16,2096,11,2135,"2021"
"62987","260610 GLORIA DO GOITA",1,1,4,357,1,364,"2021"
"62988","260620 GOIANA",6,2,14,1062,10,1094,"2021"
"62989","260630 GRANITO",1,2,2,118,2,125,"2021"
"62990","260640 GRAVATA",1,6,7,1021,4,1039,"2021"
"62991","260650 IATI",0,0,6,313,2,321,"2021"
"62992","260660 IBIMIRIM",4,4,3,404,3,418,"2021"
"62993","260670 IBIRAJUBA",1,0,1,105,2,109,"2021"
"62994","260680 IGARASSU",10,6,22,1474,20,1532,"2021"
"62995","260690 IGUARACY",0,0,1,135,0,136,"2021"
"62996","260700 INAJA",1,0,5,347,7,360,"2021"
"62997","260710 INGAZEIRA",0,0,0,62,0,62,"2021"
"62998","260720 IPOJUCA",5,9,26,1772,4,1816,"2021"
"62999","260730 IPUBI",5,3,9,561,0,578,"2021"
"63000","260740 ITACURUBA",0,0,1,77,0,78,"2021"
"63001","260750 ITAIBA",0,0,6,407,2,415,"2021"
"63002","260760 ILHA DE ITAMARACA",0,2,3,307,3,315,"2021"
"63003","260765 ITAMBE",1,3,5,436,2,447,"2021"
"63004","260770 ITAPETIM",2,1,1,179,0,183,"2021"
"63005","260775 ITAPISSUMA",0,1,5,382,4,392,"2021"
"63006","260780 ITAQUITINGA",1,1,3,185,5,195,"2021"
"63007","260790 JABOATAO DOS GUARARAPES",26,32,94,8462,46,8660,"2021"
"63008","260795 JAQUEIRA",0,0,1,144,3,148,"2021"
"63009","260800 JATAUBA",0,1,2,215,1,219,"2021"
"63010","260805 JATOBA",0,1,3,209,4,217,"2021"
"63011","260810 JOAO ALFREDO",2,2,4,335,0,343,"2021"
"63012","260820 JOAQUIM NABUCO",0,0,1,225,2,228,"2021"
"63013","260825 JUCATI",0,1,0,185,0,186,"2021"
"63014","260830 JUPI",0,0,3,301,2,306,"2021"
"63015","260840 JUREMA",2,1,2,183,1,189,"2021"
"63016","260845 LAGOA DO CARRO",0,1,4,231,0,236,"2021"
"63017","260850 LAGOA DE ITAENGA",3,0,5,322,1,331,"2021"
"63018","260860 LAGOA DO OURO",0,0,2,145,0,147,"2021"
"63019","260870 LAGOA DOS GATOS",0,1,1,174,0,176,"2021"
"63020","260875 LAGOA GRANDE",3,3,5,363,3,377,"2021"
"63021","260880 LAJEDO",4,0,14,647,4,669,"2021"
"63022","260890 LIMOEIRO",4,4,8,740,1,757,"2021"
"63023","260900 MACAPARANA",1,3,5,330,2,341,"2021"
"63024","260910 MACHADOS",0,0,5,199,3,207,"2021"
"63025","260915 MANARI",1,2,1,248,0,252,"2021"
"63026","260920 MARAIAL",0,1,4,149,0,154,"2021"
"63027","260930 MIRANDIBA",1,2,8,265,4,280,"2021"
"63028","260940 MORENO",5,1,7,742,5,760,"2021"
"63029","260950 NAZARE DA MATA",0,0,7,399,0,406,"2021"
"63030","260960 OLINDA",16,18,69,4586,35,4724,"2021"
"63031","260970 OROBO",0,2,0,291,0,293,"2021"
"63032","260980 OROCO",1,2,4,250,0,257,"2021"
"63033","260990 OURICURI",5,2,21,1018,3,1049,"2021"
"63034","261000 PALMARES",2,6,6,819,8,841,"2021"
"63035","261010 PALMEIRINA",1,0,0,90,2,93,"2021"
"63036","261020 PANELAS",0,1,5,361,2,369,"2021"
"63037","261030 PARANATAMA",0,0,2,198,0,200,"2021"
"63038","261040 PARNAMIRIM",1,3,3,255,1,263,"2021"
"63039","261050 PASSIRA",0,2,4,352,1,359,"2021"
"63040","261060 PAUDALHO",3,2,10,802,1,818,"2021"
"63041","261070 PAULISTA",6,15,41,3540,23,3625,"2021"
"63042","261080 PEDRA",0,2,4,356,3,365,"2021"
"63043","261090 PESQUEIRA",7,3,10,878,4,902,"2021"
"63044","261100 PETROLANDIA",6,1,2,656,2,667,"2021"
"63045","261110 PETROLINA",25,36,105,6066,67,6299,"2021"
"63046","261120 POCAO",0,1,1,151,7,160,"2021"
"63047","261130 POMBOS",0,1,3,362,3,369,"2021"
"63048","261140 PRIMAVERA",0,1,4,158,1,164,"2021"
"63049","261150 QUIPAPA",0,0,2,201,2,205,"2021"
"63050","261153 QUIXABA",0,0,0,95,0,95,"2021"
"63051","261160 RECIFE",43,63,187,17740,113,18146,"2021"
"63052","261170 RIACHO DAS ALMAS",0,0,6,277,2,285,"2021"
"63053","261180 RIBEIRAO",0,2,3,451,3,459,"2021"
"63054","261190 RIO FORMOSO",0,1,3,335,8,347,"2021"
"63055","261200 SAIRE",0,0,3,113,1,117,"2021"
"63056","261210 SALGADINHO",0,0,0,66,0,66,"2021"
"63057","261220 SALGUEIRO",4,4,30,942,2,982,"2021"
"63058","261230 SALOA",0,2,3,184,0,189,"2021"
"63059","261240 SANHARO",1,0,6,284,3,294,"2021"
"63060","261245 SANTA CRUZ",0,0,1,208,2,211,"2021"
"63061","261247 SANTA CRUZ DA BAIXA VERDE",0,1,4,147,1,153,"2021"
"63062","261250 SANTA CRUZ DO CAPIBARIBE",0,1,9,1298,5,1313,"2021"
"63063","261255 SANTA FILOMENA",0,1,8,196,0,205,"2021"
"63064","261260 SANTA MARIA DA BOA VISTA",3,7,11,622,5,648,"2021"
"63065","261270 SANTA MARIA DO CAMBUCA",2,0,2,184,2,190,"2021"
"63066","261280 SANTA TEREZINHA",1,1,1,118,1,122,"2021"
"63067","261290 SAO BENEDITO DO SUL",0,3,0,147,1,151,"2021"
"63068","261300 SAO BENTO DO UNA",1,4,13,733,4,755,"2021"
"63069","261310 SAO CAITANO",2,2,9,514,2,529,"2021"
"63070","261320 SAO JOAO",1,2,6,319,1,329,"2021"
"63071","261330 SAO JOAQUIM DO MONTE",1,2,0,256,3,262,"2021"
"63072","261340 SAO JOSE DA COROA GRANDE",0,1,6,292,2,301,"2021"
"63073","261350 SAO JOSE DO BELMONTE",4,2,5,484,0,495,"2021"
"63074","261360 SAO JOSE DO EGITO",2,3,5,408,1,419,"2021"
"63075","261370 SAO LOURENCO DA MATA",7,7,19,1448,8,1489,"2021"
"63076","261380 SAO VICENTE FERRER",0,0,12,259,1,272,"2021"
"63077","261390 SERRA TALHADA",5,7,28,1443,2,1485,"2021"
"63078","261400 SERRITA",1,1,7,268,2,279,"2021"
"63079","261410 SERTANIA",2,1,4,392,2,401,"2021"
"63080","261420 SIRINHAEM",4,2,11,514,4,535,"2021"
"63081","261430 MOREILANDIA",1,0,6,137,0,144,"2021"
"63082","261440 SOLIDAO",0,0,0,76,0,76,"2021"
"63083","261450 SURUBIM",4,2,12,802,6,826,"2021"
"63084","261460 TABIRA",3,2,3,344,1,353,"2021"
"63085","261470 TACAIMBO",0,0,0,180,0,180,"2021"
"63086","261480 TACARATU",1,2,7,319,1,330,"2021"
"63087","261485 TAMANDARE",1,1,5,394,4,405,"2021"
"63088","261500 TAQUARITINGA DO NORTE",0,1,4,384,1,390,"2021"
"63089","261510 TEREZINHA",0,0,1,98,0,99,"2021"
"63090","261520 TERRA NOVA",0,1,4,128,0,133,"2021"
"63091","261530 TIMBAUBA",0,3,7,639,2,651,"2021"
"63092","261540 TORITAMA",2,1,5,633,3,644,"2021"
"63093","261550 TRACUNHAEM",1,1,3,195,0,200,"2021"
"63094","261560 TRINDADE",2,3,13,555,0,573,"2021"
"63095","261570 TRIUNFO",1,0,5,172,1,179,"2021"
"63096","261580 TUPANATINGA",3,1,7,350,2,363,"2021"
"63097","261590 TUPARETAMA",0,1,2,108,1,112,"2021"
"63098","261600 VENTUROSA",3,0,5,273,3,284,"2021"
"63099","261610 VERDEJANTE",0,2,2,125,0,129,"2021"
"63100","261618 VERTENTE DO LERIO",1,0,2,96,1,100,"2021"
"63101","261620 VERTENTES",1,1,1,307,1,311,"2021"
"63102","261630 VICENCIA",2,3,6,345,0,356,"2021"
"63103","261640 VITORIA DE SANTO ANTAO",2,2,14,1887,10,1915,"2021"
"63104","261650 XEXEU",1,2,1,222,9,235,"2021"
"63105","270010 AGUA BRANCA",2,2,0,302,5,311,"2021"
"63106","270020 ANADIA",0,0,0,208,2,210,"2021"
"63107","270030 ARAPIRACA",6,20,47,3686,12,3771,"2021"
"63108","270040 ATALAIA",3,5,14,590,11,623,"2021"
"63109","270050 BARRA DE SANTO ANTONIO",1,2,3,244,10,260,"2021"
"63110","270060 BARRA DE SAO MIGUEL",1,0,0,145,1,147,"2021"
"63111","270070 BATALHA",0,1,7,289,0,297,"2021"
"63112","270080 BELEM",0,0,2,62,0,64,"2021"
"63113","270090 BELO MONTE",0,0,2,101,1,104,"2021"
"63114","270100 BOCA DA MATA",0,4,5,297,0,306,"2021"
"63115","270110 BRANQUINHA",0,0,1,182,1,184,"2021"
"63116","270120 CACIMBINHAS",2,0,0,158,0,160,"2021"
"63117","270130 CAJUEIRO",1,1,4,257,5,268,"2021"
"63118","270135 CAMPESTRE",0,0,1,105,1,107,"2021"
"63119","270140 CAMPO ALEGRE",0,4,2,482,3,491,"2021"
"63120","270150 CAMPO GRANDE",0,0,1,150,0,151,"2021"
"63121","270160 CANAPI",2,3,3,302,12,322,"2021"
"63122","270170 CAPELA",0,1,4,189,5,199,"2021"
"63123","270180 CARNEIROS",0,0,1,139,1,141,"2021"
"63124","270190 CHA PRETA",0,1,1,79,1,82,"2021"
"63125","270200 COITE DO NOIA",0,0,5,146,0,151,"2021"
"63126","270210 COLONIA LEOPOLDINA",0,1,1,275,1,278,"2021"
"63127","270220 COQUEIRO SECO",0,0,0,91,2,93,"2021"
"63128","270230 CORURIPE",10,3,5,863,4,885,"2021"
"63129","270235 CRAIBAS",0,0,2,405,6,413,"2021"
"63130","270240 DELMIRO GOUVEIA",2,1,8,730,6,747,"2021"
"63131","270250 DOIS RIACHOS",0,0,1,149,2,152,"2021"
"63132","270255 ESTRELA DE ALAGOAS",2,1,8,281,1,293,"2021"
"63133","270260 FEIRA GRANDE",1,2,5,322,1,331,"2021"
"63134","270270 FELIZ DESERTO",0,0,0,61,1,62,"2021"
"63135","270280 FLEXEIRAS",0,0,4,151,4,159,"2021"
"63136","270290 GIRAU DO PONCIANO",0,0,11,550,4,565,"2021"
"63137","270300 IBATEGUARA",1,2,2,242,0,247,"2021"
"63138","270310 IGACI",0,2,5,334,0,341,"2021"
"63139","270320 IGREJA NOVA",0,2,5,311,4,322,"2021"
"63140","270330 INHAPI",0,0,2,247,17,266,"2021"
"63141","270340 JACARE DOS HOMENS",0,1,1,95,0,97,"2021"
"63142","270350 JACUIPE",0,2,1,48,2,53,"2021"
"63143","270360 JAPARATINGA",0,0,3,169,0,172,"2021"
"63144","270370 JARAMATAIA",0,0,0,85,0,85,"2021"
"63145","270375 JEQUIA DA PRAIA",2,2,1,167,3,175,"2021"
"63146","270380 JOAQUIM GOMES",1,1,1,338,2,343,"2021"
"63147","270390 JUNDIA",0,1,0,70,0,71,"2021"
"63148","270400 JUNQUEIRO",1,1,2,330,2,336,"2021"
"63149","270410 LAGOA DA CANOA",0,0,5,318,3,326,"2021"
"63150","270420 LIMOEIRO DE ANADIA",0,1,3,371,4,379,"2021"
"63151","270430 MACEIO",25,57,175,13200,147,13604,"2021"
"63152","270440 MAJOR ISIDORO",0,3,1,265,3,272,"2021"
"63153","270450 MARAGOGI",0,6,7,611,4,628,"2021"
"63154","270460 MARAVILHA",1,0,1,145,2,149,"2021"
"63155","270470 MARECHAL DEODORO",4,5,10,899,5,923,"2021"
"63156","270480 MARIBONDO",1,0,2,176,1,180,"2021"
"63157","270490 MAR VERMELHO",0,1,1,30,0,32,"2021"
"63158","270500 MATA GRANDE",0,1,4,318,4,327,"2021"
"63159","270510 MATRIZ DE CAMARAGIBE",1,0,5,356,7,369,"2021"
"63160","270520 MESSIAS",1,0,5,237,3,246,"2021"
"63161","270530 MINADOR DO NEGRAO",0,0,2,76,0,78,"2021"
"63162","270540 MONTEIROPOLIS",1,0,4,130,0,135,"2021"
"63163","270550 MURICI",1,2,7,433,3,446,"2021"
"63164","270560 NOVO LINO",0,1,1,142,0,144,"2021"
"63165","270570 OLHO D'AGUA DAS FLORES",1,3,3,373,0,380,"2021"
"63166","270580 OLHO D'AGUA DO CASADO",0,0,1,136,0,137,"2021"
"63167","270590 OLHO D'AGUA GRANDE",1,0,0,58,2,61,"2021"
"63168","270600 OLIVENCA",0,0,0,158,0,158,"2021"
"63169","270610 OURO BRANCO",0,2,3,201,0,206,"2021"
"63170","270620 PALESTINA",0,0,0,89,0,89,"2021"
"63171","270630 PALMEIRA DOS INDIOS",2,2,16,1110,1,1131,"2021"
"63172","270640 PAO DE ACUCAR",2,2,4,403,1,412,"2021"
"63173","270642 PARICONHA",0,0,2,153,1,156,"2021"
"63174","270644 PARIPUEIRA",1,1,3,206,6,217,"2021"
"63175","270650 PASSO DE CAMARAGIBE",2,0,1,193,2,198,"2021"
"63176","270660 PAULO JACINTO",1,0,2,94,1,98,"2021"
"63177","270670 PENEDO",1,2,14,907,5,929,"2021"
"63178","270680 PIACABUCU",0,2,3,277,2,284,"2021"
"63179","270690 PILAR",1,2,7,552,2,564,"2021"
"63180","270700 PINDOBA",2,0,2,25,0,29,"2021"
"63181","270710 PIRANHAS",1,0,5,414,4,424,"2021"
"63182","270720 POCO DAS TRINCHEIRAS",0,0,5,200,0,205,"2021"
"63183","270730 PORTO CALVO",0,1,5,379,2,387,"2021"
"63184","270740 PORTO DE PEDRAS",0,0,3,143,1,147,"2021"
"63185","270750 PORTO REAL DO COLEGIO",0,1,6,284,5,296,"2021"
"63186","270760 QUEBRANGULO",0,0,2,183,0,185,"2021"
"63187","270770 RIO LARGO",6,4,25,1300,24,1359,"2021"
"63188","270780 ROTEIRO",0,0,2,126,0,128,"2021"
"63189","270790 SANTA LUZIA DO NORTE",1,0,2,107,2,112,"2021"
"63190","270800 SANTANA DO IPANEMA",1,3,12,769,1,786,"2021"
"63191","270810 SANTANA DO MUNDAU",0,0,4,184,0,188,"2021"
"63192","270820 SAO BRAS",0,1,2,88,6,97,"2021"
"63193","270830 SAO JOSE DA LAJE",0,0,1,396,0,397,"2021"
"63194","270840 SAO JOSE DA TAPERA",1,1,5,560,1,568,"2021"
"63195","270850 SAO LUIS DO QUITUNDE",2,2,3,438,3,448,"2021"
"63196","270860 SAO MIGUEL DOS CAMPOS",1,0,9,812,1,823,"2021"
"63197","270870 SAO MIGUEL DOS MILAGRES",1,0,1,141,0,143,"2021"
"63198","270880 SAO SEBASTIAO",2,2,8,470,1,483,"2021"
"63199","270890 SATUBA",0,0,7,313,7,327,"2021"
"63200","270895 SENADOR RUI PALMEIRA",1,2,1,190,2,196,"2021"
"63201","270900 TANQUE D'ARCA",1,0,1,91,1,94,"2021"
"63202","270910 TAQUARANA",0,0,5,275,3,283,"2021"
"63203","270915 TEOTONIO VILELA",2,2,9,602,3,618,"2021"
"63204","270920 TRAIPU",1,1,7,331,3,343,"2021"
"63205","270930 UNIAO DOS PALMARES",1,5,7,1232,5,1250,"2021"
"63206","270940 VICOSA",0,2,8,381,8,399,"2021"
"63207","280010 AMPARO DE SAO FRANCISCO",0,0,1,34,1,36,"2021"
"63208","280020 AQUIDABA",1,1,6,232,12,252,"2021"
"63209","280030 ARACAJU",29,29,108,7687,64,7917,"2021"
"63210","280040 ARAUA",1,1,2,126,4,134,"2021"
"63211","280050 AREIA BRANCA",0,0,2,238,7,247,"2021"
"63212","280060 BARRA DOS COQUEIROS",3,2,3,552,10,570,"2021"
"63213","280067 BOQUIM",0,1,2,311,2,316,"2021"
"63214","280070 BREJO GRANDE",0,0,4,141,9,154,"2021"
"63215","280100 CAMPO DO BRITO",1,3,3,202,5,214,"2021"
"63216","280110 CANHOBA",1,0,1,61,1,64,"2021"
"63217","280120 CANINDE DE SAO FRANCISCO",0,2,7,471,29,509,"2021"
"63218","280130 CAPELA",2,1,13,518,37,571,"2021"
"63219","280140 CARIRA",0,1,5,271,11,288,"2021"
"63220","280150 CARMOPOLIS",0,0,4,196,9,209,"2021"
"63221","280160 CEDRO DE SAO JOAO",0,0,0,58,2,60,"2021"
"63222","280170 CRISTINAPOLIS",0,0,7,250,1,258,"2021"
"63223","280190 CUMBE",0,0,0,30,4,34,"2021"
"63224","280200 DIVINA PASTORA",0,3,0,76,3,82,"2021"
"63225","280210 ESTANCIA",6,4,11,1023,11,1055,"2021"
"63226","280220 FEIRA NOVA",0,0,1,88,12,101,"2021"
"63227","280230 FREI PAULO",0,0,4,228,3,235,"2021"
"63228","280240 GARARU",0,0,2,114,14,130,"2021"
"63229","280250 GENERAL MAYNARD",2,1,2,38,2,45,"2021"
"63230","280260 GRACHO CARDOSO",0,0,1,76,4,81,"2021"
"63231","280270 ILHA DAS FLORES",1,0,2,143,3,149,"2021"
"63232","280280 INDIAROBA",0,2,2,250,6,260,"2021"
"63233","280290 ITABAIANA",5,3,6,1399,12,1425,"2021"
"63234","280300 ITABAIANINHA",1,3,12,543,9,568,"2021"
"63235","280310 ITABI",0,0,1,51,4,56,"2021"
"63236","280320 ITAPORANGA D'AJUDA",0,3,9,510,36,558,"2021"
"63237","280330 JAPARATUBA",1,1,4,204,14,224,"2021"
"63238","280340 JAPOATA",1,2,0,205,12,220,"2021"
"63239","280350 LAGARTO",8,6,15,1392,6,1427,"2021"
"63240","280360 LARANJEIRAS",1,3,5,344,18,371,"2021"
"63241","280370 MACAMBIRA",0,1,0,76,2,79,"2021"
"63242","280380 MALHADA DOS BOIS",0,1,1,50,4,56,"2021"
"63243","280390 MALHADOR",1,1,1,166,4,173,"2021"
"63244","280400 MARUIM",0,1,7,216,5,229,"2021"
"63245","280410 MOITA BONITA",0,0,3,133,1,137,"2021"
"63246","280420 MONTE ALEGRE DE SERGIPE",0,2,3,230,19,254,"2021"
"63247","280430 MURIBECA",0,0,2,109,5,116,"2021"
"63248","280440 NEOPOLIS",1,0,2,233,9,245,"2021"
"63249","280445 NOSSA SENHORA APARECIDA",0,2,2,114,3,121,"2021"
"63250","280450 NOSSA SENHORA DA GLORIA",2,1,6,586,53,648,"2021"
"63251","280460 NOSSA SENHORA DAS DORES",2,1,5,305,16,329,"2021"
"63252","280470 NOSSA SENHORA DE LOURDES",1,0,1,71,4,77,"2021"
"63253","280480 NOSSA SENHORA DO SOCORRO",3,12,41,2700,43,2799,"2021"
"63254","280490 PACATUBA",0,3,2,224,9,238,"2021"
"63255","280500 PEDRA MOLE",0,0,0,44,0,44,"2021"
"63256","280510 PEDRINHAS",0,0,1,110,2,113,"2021"
"63257","280520 PINHAO",0,0,0,75,5,80,"2021"
"63258","280530 PIRAMBU",0,2,3,121,3,129,"2021"
"63259","280540 POCO REDONDO",4,2,11,465,30,512,"2021"
"63260","280550 POCO VERDE",0,1,3,255,7,266,"2021"
"63261","280560 PORTO DA FOLHA",0,2,6,368,23,399,"2021"
"63262","280570 PROPRIA",0,0,5,381,17,403,"2021"
"63263","280580 RIACHAO DO DANTAS",0,2,2,235,4,243,"2021"
"63264","280590 RIACHUELO",0,2,2,137,3,144,"2021"
"63265","280600 RIBEIROPOLIS",0,1,2,165,4,172,"2021"
"63266","280610 ROSARIO DO CATETE",0,2,5,140,4,151,"2021"
"63267","280620 SALGADO",1,2,5,238,4,250,"2021"
"63268","280630 SANTA LUZIA DO ITANHY",1,5,3,221,4,234,"2021"
"63269","280640 SANTANA DO SAO FRANCISCO",0,1,2,99,4,106,"2021"
"63270","280650 SANTA ROSA DE LIMA",0,0,0,64,1,65,"2021"
"63271","280660 SANTO AMARO DAS BROTAS",1,0,3,143,3,150,"2021"
"63272","280670 SAO CRISTOVAO",3,5,27,1165,24,1224,"2021"
"63273","280680 SAO DOMINGOS",0,0,1,124,1,126,"2021"
"63274","280690 SAO FRANCISCO",0,1,1,37,8,47,"2021"
"63275","280700 SAO MIGUEL DO ALEIXO",0,0,0,41,0,41,"2021"
"63276","280710 SIMAO DIAS",4,1,10,566,10,591,"2021"
"63277","280720 SIRIRI",1,0,2,91,2,96,"2021"
"63278","280730 TELHA",1,1,1,44,2,49,"2021"
"63279","280740 TOBIAS BARRETO",1,3,9,645,16,674,"2021"
"63280","280750 TOMAR DO GERU",0,1,4,160,2,167,"2021"
"63281","280760 UMBAUBA",2,1,4,400,2,409,"2021"
"63282","MUNICIPIO IGNORADO - BA",0,0,0,4,0,4,"2021"
"63283","290010 ABAIRA",0,0,1,48,0,49,"2021"
"63284","290020 ABARE",1,2,10,298,0,311,"2021"
"63285","290030 ACAJUTIBA",1,2,3,165,1,172,"2021"
"63286","290035 ADUSTINA",0,0,1,170,10,181,"2021"
"63287","290040 AGUA FRIA",1,1,2,123,3,130,"2021"
"63288","290050 ERICO CARDOSO",0,0,1,120,2,123,"2021"
"63289","290060 AIQUARA",0,0,0,37,1,38,"2021"
"63290","290070 ALAGOINHAS",2,11,22,1962,19,2016,"2021"
"63291","290080 ALCOBACA",0,0,10,359,4,373,"2021"
"63292","290090 ALMADINA",0,0,2,49,2,53,"2021"
"63293","290100 AMARGOSA",0,2,5,423,1,431,"2021"
"63294","290110 AMELIA RODRIGUES",0,2,4,142,3,151,"2021"
"63295","290115 AMERICA DOURADA",0,2,1,201,1,205,"2021"
"63296","290120 ANAGE",0,1,4,215,5,225,"2021"
"63297","290130 ANDARAI",1,2,3,159,5,170,"2021"
"63298","290135 ANDORINHA",1,0,3,171,1,176,"2021"
"63299","290140 ANGICAL",1,2,5,182,1,191,"2021"
"63300","290150 ANGUERA",0,0,0,46,3,49,"2021"
"63301","290160 ANTAS",0,1,3,157,1,162,"2021"
"63302","290170 ANTONIO CARDOSO",1,0,1,109,0,111,"2021"
"63303","290180 ANTONIO GONCALVES",0,2,4,124,3,133,"2021"
"63304","290190 APORA",1,2,6,182,0,191,"2021"
"63305","290195 APUAREMA",1,1,0,110,1,113,"2021"
"63306","290200 ARACATU",2,1,5,163,1,172,"2021"
"63307","290205 ARACAS",0,0,1,138,1,140,"2021"
"63308","290210 ARACI",2,4,8,614,6,634,"2021"
"63309","290220 ARAMARI",0,1,1,121,1,124,"2021"
"63310","290225 ARATACA",1,0,3,92,3,99,"2021"
"63311","290230 ARATUIPE",1,1,2,122,1,127,"2021"
"63312","290240 AURELINO LEAL",1,3,1,163,22,190,"2021"
"63313","290250 BAIANOPOLIS",0,0,2,135,0,137,"2021"
"63314","290260 BAIXA GRANDE",0,2,5,180,1,188,"2021"
"63315","290265 BANZAE",0,0,3,121,29,153,"2021"
"63316","290270 BARRA",0,0,16,879,5,900,"2021"
"63317","290280 BARRA DA ESTIVA",0,1,4,364,1,370,"2021"
"63318","290290 BARRA DO CHOCA",0,1,9,465,5,480,"2021"
"63319","290300 BARRA DO MENDES",1,0,8,169,0,178,"2021"
"63320","290310 BARRA DO ROCHA",0,0,1,73,0,74,"2021"
"63321","290320 BARREIRAS",8,10,42,2437,7,2504,"2021"
"63322","290323 BARRO ALTO",1,1,4,135,0,141,"2021"
"63323","290327 BARROCAS",3,1,11,189,0,204,"2021"
"63324","290330 BARRO PRETO",0,2,1,69,0,72,"2021"
"63325","290340 BELMONTE",0,1,5,272,4,282,"2021"
"63326","290350 BELO CAMPO",1,1,1,216,1,220,"2021"
"63327","290360 BIRITINGA",0,3,13,178,2,196,"2021"
"63328","290370 BOA NOVA",0,0,2,154,1,157,"2021"
"63329","290380 BOA VISTA DO TUPIM",2,1,6,212,1,222,"2021"
"63330","290390 BOM JESUS DA LAPA",5,6,9,1072,7,1099,"2021"
"63331","290395 BOM JESUS DA SERRA",1,2,4,110,3,120,"2021"
"63332","290400 BONINAL",0,0,1,162,10,173,"2021"
"63333","290405 BONITO",0,1,7,206,2,216,"2021"
"63334","290410 BOQUIRA",0,1,1,257,1,260,"2021"
"63335","290420 BOTUPORA",1,0,4,127,0,132,"2021"
"63336","290430 BREJOES",0,0,3,153,0,156,"2021"
"63337","290440 BREJOLANDIA",0,0,1,94,1,96,"2021"
"63338","290450 BROTAS DE MACAUBAS",0,2,0,129,3,134,"2021"
"63339","290460 BRUMADO",0,9,19,836,1,865,"2021"
"63340","290470 BUERAREMA",2,0,5,217,7,231,"2021"
"63341","290475 BURITIRAMA",2,1,9,316,1,329,"2021"
"63342","290480 CAATIBA",0,1,2,58,1,62,"2021"
"63343","290485 CABACEIRAS DO PARAGUACU",2,1,6,225,21,255,"2021"
"63344","290490 CACHOEIRA",0,2,3,161,154,320,"2021"
"63345","290500 CACULE",1,0,5,306,0,312,"2021"
"63346","290510 CAEM",0,2,4,133,4,143,"2021"
"63347","290515 CAETANOS",0,1,2,108,1,112,"2021"
"63348","290520 CAETITE",3,3,17,482,114,619,"2021"
"63349","290530 CAFARNAUM",2,1,11,262,0,276,"2021"
"63350","290540 CAIRU",2,1,8,243,0,254,"2021"
"63351","290550 CALDEIRAO GRANDE",1,1,1,174,0,177,"2021"
"63352","290560 CAMACAN",1,4,9,369,2,385,"2021"
"63353","290570 CAMACARI",18,12,75,3756,46,3907,"2021"
"63354","290580 CAMAMU",4,0,8,535,7,554,"2021"
"63355","290590 CAMPO ALEGRE DE LOURDES",2,0,5,499,6,512,"2021"
"63356","290600 CAMPO FORMOSO",2,5,9,1053,42,1111,"2021"
"63357","290610 CANAPOLIS",0,0,4,131,0,135,"2021"
"63358","290620 CANARANA",2,0,7,329,1,339,"2021"
"63359","290630 CANAVIEIRAS",3,4,15,437,19,478,"2021"
"63360","290640 CANDEAL",0,1,0,66,0,67,"2021"
"63361","290650 CANDEIAS",8,2,18,878,16,922,"2021"
"63362","290660 CANDIBA",0,4,2,134,0,140,"2021"
"63363","290670 CANDIDO SALES",1,1,7,281,2,292,"2021"
"63364","290680 CANSANCAO",2,1,8,455,6,472,"2021"
"63365","290682 CANUDOS",0,2,7,205,2,216,"2021"
"63366","290685 CAPELA DO ALTO ALEGRE",0,0,0,123,0,123,"2021"
"63367","290687 CAPIM GROSSO",1,2,2,408,2,415,"2021"
"63368","290689 CARAIBAS",1,1,3,90,2,97,"2021"
"63369","290690 CARAVELAS",0,2,5,266,6,279,"2021"
"63370","290700 CARDEAL DA SILVA",1,1,1,122,2,127,"2021"
"63371","290710 CARINHANHA",1,3,10,437,1,452,"2021"
"63372","290720 CASA NOVA",3,6,9,1013,11,1042,"2021"
"63373","290730 CASTRO ALVES",2,1,6,330,1,340,"2021"
"63374","290740 CATOLANDIA",1,0,2,49,0,52,"2021"
"63375","290750 CATU",1,4,6,485,0,496,"2021"
"63376","290755 CATURAMA",0,0,1,75,0,76,"2021"
"63377","290760 CENTRAL",0,2,3,229,0,234,"2021"
"63378","290770 CHORROCHO",0,2,9,154,1,166,"2021"
"63379","290780 CICERO DANTAS",3,0,6,309,14,332,"2021"
"63380","290790 CIPO",2,0,3,248,19,272,"2021"
"63381","290800 COARACI",0,2,10,212,1,225,"2021"
"63382","290810 COCOS",0,1,4,185,29,219,"2021"
"63383","290820 CONCEICAO DA FEIRA",1,1,0,102,78,182,"2021"
"63384","290830 CONCEICAO DO ALMEIDA",0,2,4,172,4,182,"2021"
"63385","290840 CONCEICAO DO COITE",1,3,14,974,3,995,"2021"
"63386","290850 CONCEICAO DO JACUIPE",1,0,4,279,5,289,"2021"
"63387","290860 CONDE",1,2,7,333,4,347,"2021"
"63388","290870 CONDEUBA",1,0,3,162,1,167,"2021"
"63389","290880 CONTENDAS DO SINCORA",1,0,1,36,0,38,"2021"
"63390","290890 CORACAO DE MARIA",0,1,3,208,2,214,"2021"
"63391","290900 CORDEIROS",0,0,0,65,2,67,"2021"
"63392","290910 CORIBE",0,1,1,133,2,137,"2021"
"63393","290920 CORONEL JOAO SA",0,0,0,156,10,166,"2021"
"63394","290930 CORRENTINA",1,0,2,91,367,461,"2021"
"63395","290940 COTEGIPE",1,3,5,178,2,189,"2021"
"63396","290950 CRAVOLANDIA",1,0,1,54,0,56,"2021"
"63397","290960 CRISOPOLIS",2,4,5,235,4,250,"2021"
"63398","290970 CRISTOPOLIS",1,4,1,146,2,154,"2021"
"63399","290980 CRUZ DAS ALMAS",3,7,10,667,3,690,"2021"
"63400","290990 CURACA",1,0,9,529,8,547,"2021"
"63401","291000 DARIO MEIRA",1,0,2,140,1,144,"2021"
"63402","291005 DIAS D'AVILA",3,5,12,920,2,942,"2021"
"63403","291010 DOM BASILIO",0,0,3,137,0,140,"2021"
"63404","291020 DOM MACEDO COSTA",0,0,2,35,0,37,"2021"
"63405","291030 ELISIO MEDRADO",0,1,3,71,1,76,"2021"
"63406","291040 ENCRUZILHADA",2,1,14,226,3,246,"2021"
"63407","291050 ENTRE RIOS",3,2,5,476,3,489,"2021"
"63408","291060 ESPLANADA",1,5,10,404,3,423,"2021"
"63409","291070 EUCLIDES DA CUNHA",0,3,12,726,6,747,"2021"
"63410","291072 EUNAPOLIS",3,4,22,1619,9,1657,"2021"
"63411","291075 FATIMA",0,2,3,196,2,203,"2021"
"63412","291077 FEIRA DA MATA",0,1,1,55,7,64,"2021"
"63413","291080 FEIRA DE SANTANA",29,44,168,9078,64,9383,"2021"
"63414","291085 FILADELFIA",1,1,4,231,3,240,"2021"
"63415","291090 FIRMINO ALVES",1,1,1,46,0,49,"2021"
"63416","291100 FLORESTA AZUL",0,0,3,74,3,80,"2021"
"63417","291110 FORMOSA DO RIO PRETO",0,5,12,423,12,452,"2021"
"63418","291120 GANDU",0,2,2,424,1,429,"2021"
"63419","291125 GAVIAO",0,1,2,38,0,41,"2021"
"63420","291130 GENTIO DO OURO",1,0,4,121,1,127,"2021"
"63421","291140 GLORIA",0,1,7,239,0,247,"2021"
"63422","291150 GONGOGI",0,0,1,64,4,69,"2021"
"63423","291160 GOVERNADOR MANGABEIRA",1,2,4,219,35,261,"2021"
"63424","291165 GUAJERU",0,0,1,47,1,49,"2021"
"63425","291170 GUANAMBI",4,4,22,1150,18,1198,"2021"
"63426","291180 GUARATINGA",0,2,3,195,2,202,"2021"
"63427","291185 HELIOPOLIS",0,0,1,111,11,123,"2021"
"63428","291190 IACU",1,0,7,333,1,342,"2021"
"63429","291200 IBIASSUCE",0,0,0,100,0,100,"2021"
"63430","291210 IBICARAI",1,2,4,211,7,225,"2021"
"63431","291220 IBICOARA",1,0,8,278,0,287,"2021"
"63432","291230 IBICUI",0,1,2,120,1,124,"2021"
"63433","291240 IBIPEBA",1,1,1,201,1,205,"2021"
"63434","291250 IBIPITANGA",0,0,1,133,1,135,"2021"
"63435","291260 IBIQUERA",0,1,1,49,0,51,"2021"
"63436","291270 IBIRAPITANGA",3,1,8,290,3,305,"2021"
"63437","291280 IBIRAPUA",0,2,1,106,0,109,"2021"
"63438","291290 IBIRATAIA",0,2,6,299,0,307,"2021"
"63439","291300 IBITIARA",0,1,1,142,0,144,"2021"
"63440","291310 IBITITA",1,2,6,201,2,212,"2021"
"63441","291320 IBOTIRAMA",1,2,2,376,0,381,"2021"
"63442","291330 ICHU",0,0,1,53,0,54,"2021"
"63443","291340 IGAPORA",0,0,3,130,3,136,"2021"
"63444","291345 IGRAPIUNA",1,1,5,154,1,162,"2021"
"63445","291350 IGUAI",1,3,3,319,0,326,"2021"
"63446","291360 ILHEUS",5,7,43,1776,311,2142,"2021"
"63447","291370 INHAMBUPE",0,2,6,405,6,419,"2021"
"63448","291380 IPECAETA",0,0,5,119,4,128,"2021"
"63449","291390 IPIAU",1,2,10,600,2,615,"2021"
"63450","291400 IPIRA",3,4,6,635,2,650,"2021"
"63451","291410 IPUPIARA",0,1,0,90,0,91,"2021"
"63452","291420 IRAJUBA",1,0,1,63,0,65,"2021"
"63453","291430 IRAMAIA",0,2,0,90,1,93,"2021"
"63454","291440 IRAQUARA",1,1,2,381,0,385,"2021"
"63455","291450 IRARA",4,4,4,235,5,252,"2021"
"63456","291460 IRECE",11,3,23,1295,4,1336,"2021"
"63457","291465 ITABELA",1,4,8,505,1,519,"2021"
"63458","291470 ITABERABA",2,0,8,833,1,844,"2021"
"63459","291480 ITABUNA",10,17,34,2279,8,2348,"2021"
"63460","291490 ITACARE",0,5,6,377,50,438,"2021"
"63461","291500 ITAETE",0,1,7,193,0,201,"2021"
"63462","291510 ITAGI",0,0,0,160,1,161,"2021"
"63463","291520 ITAGIBA",1,3,3,187,0,194,"2021"
"63464","291530 ITAGIMIRIM",0,2,0,54,5,61,"2021"
"63465","291535 ITAGUACU DA BAHIA",0,1,2,174,0,177,"2021"
"63466","291540 ITAJU DO COLONIA",1,1,4,63,5,74,"2021"
"63467","291550 ITAJUIPE",1,3,4,185,4,197,"2021"
"63468","291560 ITAMARAJU",3,3,16,916,7,945,"2021"
"63469","291570 ITAMARI",3,1,3,135,4,146,"2021"
"63470","291580 ITAMBE",4,3,9,268,0,284,"2021"
"63471","291590 ITANAGRA",0,0,1,87,0,88,"2021"
"63472","291600 ITANHEM",0,2,2,173,1,178,"2021"
"63473","291610 ITAPARICA",1,1,3,291,0,296,"2021"
"63474","291620 ITAPE",2,1,1,111,1,116,"2021"
"63475","291630 ITAPEBI",1,1,3,116,1,122,"2021"
"63476","291640 ITAPETINGA",2,7,13,982,3,1007,"2021"
"63477","291650 ITAPICURU",1,4,7,338,11,361,"2021"
"63478","291660 ITAPITANGA",0,0,2,69,0,71,"2021"
"63479","291670 ITAQUARA",0,0,1,84,2,87,"2021"
"63480","291680 ITARANTIM",1,0,1,191,1,194,"2021"
"63481","291685 ITATIM",0,1,2,172,1,176,"2021"
"63482","291690 ITIRUCU",0,1,0,126,1,128,"2021"
"63483","291700 ITIUBA",1,4,10,423,3,441,"2021"
"63484","291710 ITORORO",0,2,4,204,2,212,"2021"
"63485","291720 ITUACU",0,3,7,210,3,223,"2021"
"63486","291730 ITUBERA",1,3,10,276,1,291,"2021"
"63487","291733 IUIU",1,2,7,130,1,141,"2021"
"63488","291735 JABORANDI",0,0,1,147,0,148,"2021"
"63489","291740 JACARACI",1,1,4,119,0,125,"2021"
"63490","291750 JACOBINA",4,2,23,1278,3,1310,"2021"
"63491","291760 JAGUAQUARA",2,2,7,635,0,646,"2021"
"63492","291770 JAGUARARI",4,2,6,427,3,442,"2021"
"63493","291780 JAGUARIPE",1,1,5,192,0,199,"2021"
"63494","291790 JANDAIRA",0,1,1,124,3,129,"2021"
"63495","291800 JEQUIE",8,5,21,2105,18,2157,"2021"
"63496","291810 JEREMOABO",1,4,11,477,3,496,"2021"
"63497","291820 JIQUIRICA",1,0,4,153,0,158,"2021"
"63498","291830 JITAUNA",0,0,2,172,4,178,"2021"
"63499","291835 JOAO DOURADO",0,3,7,336,0,346,"2021"
"63500","291840 JUAZEIRO",11,20,48,3873,62,4014,"2021"
"63501","291845 JUCURUCU",0,1,2,97,4,104,"2021"
"63502","291850 JUSSARA",1,1,5,201,0,208,"2021"
"63503","291855 JUSSARI",1,1,0,49,0,51,"2021"
"63504","291860 JUSSIAPE",0,1,3,61,0,65,"2021"
"63505","291870 LAFAIETE COUTINHO",0,0,0,43,0,43,"2021"
"63506","291875 LAGOA REAL",0,0,0,137,0,137,"2021"
"63507","291880 LAJE",1,2,8,243,0,254,"2021"
"63508","291890 LAJEDAO",0,0,3,44,0,47,"2021"
"63509","291900 LAJEDINHO",0,1,0,53,1,55,"2021"
"63510","291905 LAJEDO DO TABOCAL",0,0,1,68,1,70,"2021"
"63511","291910 LAMARAO",2,2,2,104,0,110,"2021"
"63512","291915 LAPAO",0,4,9,412,0,425,"2021"
"63513","291920 LAURO DE FREITAS",9,15,48,2765,33,2870,"2021"
"63514","291930 LENCOIS",0,0,3,126,3,132,"2021"
"63515","291940 LICINIO DE ALMEIDA",0,0,0,118,0,118,"2021"
"63516","291950 LIVRAMENTO DE NOSSA SENHORA",0,3,2,475,1,481,"2021"
"63517","291955 LUIS EDUARDO MAGALHAES",11,16,32,1964,3,2026,"2021"
"63518","291960 MACAJUBA",0,1,4,118,1,124,"2021"
"63519","291970 MACARANI",1,3,3,170,1,178,"2021"
"63520","291980 MACAUBAS",1,0,4,521,5,531,"2021"
"63521","291990 MACURURE",0,2,2,82,2,88,"2021"
"63522","291992 MADRE DE DEUS",4,1,2,194,2,203,"2021"
"63523","291995 MAETINGA",0,1,0,78,0,79,"2021"
"63524","292000 MAIQUINIQUE",1,3,5,106,1,116,"2021"
"63525","292010 MAIRI",0,0,1,178,0,179,"2021"
"63526","292020 MALHADA",2,0,4,227,18,251,"2021"
"63527","292030 MALHADA DE PEDRAS",0,1,1,87,0,89,"2021"
"63528","292040 MANOEL VITORINO",1,1,3,168,4,177,"2021"
"63529","292045 MANSIDAO",0,0,0,78,1,79,"2021"
"63530","292050 MARACAS",4,1,4,306,1,316,"2021"
"63531","292060 MARAGOGIPE",6,1,9,272,142,430,"2021"
"63532","292070 MARAU",0,2,4,245,32,283,"2021"
"63533","292080 MARCIONILIO SOUZA",1,1,0,86,0,88,"2021"
"63534","292090 MASCOTE",2,0,4,115,4,125,"2021"
"63535","292100 MATA DE SAO JOAO",1,4,9,698,5,717,"2021"
"63536","292105 MATINA",1,0,3,135,2,141,"2021"
"63537","292110 MEDEIROS NETO",0,2,4,313,2,321,"2021"
"63538","292120 MIGUEL CALMON",1,2,4,321,1,329,"2021"
"63539","292130 MILAGRES",1,0,1,144,0,146,"2021"
"63540","292140 MIRANGABA",1,2,2,186,1,192,"2021"
"63541","292145 MIRANTE",0,0,0,89,1,90,"2021"
"63542","292150 MONTE SANTO",4,3,10,636,3,656,"2021"
"63543","292160 MORPARA",0,0,1,100,0,101,"2021"
"63544","292170 MORRO DO CHAPEU",3,3,3,439,1,449,"2021"
"63545","292180 MORTUGABA",0,0,3,105,0,108,"2021"
"63546","292190 MUCUGE",1,1,1,149,7,159,"2021"
"63547","292200 MUCURI",0,0,9,610,0,619,"2021"
"63548","292205 MULUNGU DO MORRO",3,4,3,191,0,201,"2021"
"63549","292210 MUNDO NOVO",1,1,2,152,0,156,"2021"
"63550","292220 MUNIZ FERREIRA",1,0,3,67,0,71,"2021"
"63551","292225 MUQUEM DE SAO FRANCISCO",0,0,1,174,0,175,"2021"
"63552","292230 MURITIBA",3,1,10,233,78,325,"2021"
"63553","292240 MUTUIPE",2,0,6,254,2,264,"2021"
"63554","292250 NAZARE",1,2,8,265,1,277,"2021"
"63555","292260 NILO PECANHA",0,0,6,161,1,168,"2021"
"63556","292265 NORDESTINA",0,3,0,162,1,166,"2021"
"63557","292270 NOVA CANAA",1,3,3,146,0,153,"2021"
"63558","292273 NOVA FATIMA",0,0,1,79,0,80,"2021"
"63559","292275 NOVA IBIA",0,1,0,48,1,50,"2021"
"63560","292280 NOVA ITARANA",0,0,3,107,2,112,"2021"
"63561","292285 NOVA REDENCAO",0,1,3,66,0,70,"2021"
"63562","292290 NOVA SOURE",0,3,3,293,24,323,"2021"
"63563","292300 NOVA VICOSA",2,2,12,496,2,514,"2021"
"63564","292303 NOVO HORIZONTE",0,0,4,130,0,134,"2021"
"63565","292305 NOVO TRIUNFO",1,0,2,90,4,97,"2021"
"63566","292310 OLINDINA",0,0,5,271,8,284,"2021"
"63567","292320 OLIVEIRA DOS BREJINHOS",1,1,7,277,6,292,"2021"
"63568","292330 OURICANGAS",0,4,0,92,1,97,"2021"
"63569","292335 OUROLANDIA",4,3,5,239,1,252,"2021"
"63570","292340 PALMAS DE MONTE ALTO",1,2,5,227,0,235,"2021"
"63571","292350 PALMEIRAS",0,0,2,143,19,164,"2021"
"63572","292360 PARAMIRIM",4,4,1,245,0,254,"2021"
"63573","292370 PARATINGA",1,3,4,373,1,382,"2021"
"63574","292380 PARIPIRANGA",3,0,2,239,8,252,"2021"
"63575","292390 PAU BRASIL",0,3,2,129,2,136,"2021"
"63576","292400 PAULO AFONSO",1,7,45,1614,3,1670,"2021"
"63577","292405 PE DE SERRA",1,1,6,131,1,140,"2021"
"63578","292410 PEDRAO",0,0,0,56,1,57,"2021"
"63579","292420 PEDRO ALEXANDRE",2,1,5,194,4,206,"2021"
"63580","292430 PIATA",1,1,5,244,1,252,"2021"
"63581","292440 PILAO ARCADO",0,2,9,551,7,569,"2021"
"63582","292450 PINDAI",1,3,1,181,1,187,"2021"
"63583","292460 PINDOBACU",3,2,8,237,2,252,"2021"
"63584","292465 PINTADAS",1,0,0,86,1,88,"2021"
"63585","292467 PIRAI DO NORTE",1,1,1,79,2,84,"2021"
"63586","292470 PIRIPA",1,1,2,89,1,94,"2021"
"63587","292480 PIRITIBA",3,2,6,219,1,231,"2021"
"63588","292490 PLANALTINO",1,0,1,72,1,75,"2021"
"63589","292500 PLANALTO",0,3,2,252,5,262,"2021"
"63590","292510 POCOES",6,3,10,580,1,600,"2021"
"63591","292520 POJUCA",2,5,9,433,0,449,"2021"
"63592","292525 PONTO NOVO",1,3,5,277,3,289,"2021"
"63593","292530 PORTO SEGURO",8,8,41,2660,60,2777,"2021"
"63594","292540 POTIRAGUA",0,2,3,104,1,110,"2021"
"63595","292550 PRADO",2,2,8,538,13,563,"2021"
"63596","292560 PRESIDENTE DUTRA",0,1,2,135,0,138,"2021"
"63597","292570 PRESIDENTE JANIO QUADROS",0,0,5,128,0,133,"2021"
"63598","292575 PRESIDENTE TANCREDO NEVES",6,3,7,346,44,406,"2021"
"63599","292580 QUEIMADAS",0,2,4,322,0,328,"2021"
"63600","292590 QUIJINGUE",1,3,5,318,5,332,"2021"
"63601","292593 QUIXABEIRA",0,0,1,90,1,92,"2021"
"63602","292595 RAFAEL JAMBEIRO",1,0,4,213,4,222,"2021"
"63603","292600 REMANSO",2,2,7,578,10,599,"2021"
"63604","292610 RETIROLANDIA",1,0,6,160,1,168,"2021"
"63605","292620 RIACHAO DAS NEVES",0,1,6,258,6,271,"2021"
"63606","292630 RIACHAO DO JACUIPE",0,0,5,384,1,390,"2021"
"63607","292640 RIACHO DE SANTANA",0,1,0,311,3,315,"2021"
"63608","292650 RIBEIRA DO AMPARO",2,2,2,154,27,187,"2021"
"63609","292660 RIBEIRA DO POMBAL",0,1,3,546,191,741,"2021"
"63610","292665 RIBEIRAO DO LARGO",0,0,4,86,1,91,"2021"
"63611","292670 RIO DE CONTAS",1,0,2,137,1,141,"2021"
"63612","292680 RIO DO ANTONIO",0,0,2,110,1,113,"2021"
"63613","292690 RIO DO PIRES",0,1,0,93,0,94,"2021"
"63614","292700 RIO REAL",1,0,5,499,4,509,"2021"
"63615","292710 RODELAS",2,2,4,156,2,166,"2021"
"63616","292720 RUY BARBOSA",2,2,8,380,1,393,"2021"
"63617","292730 SALINAS DA MARGARIDA",0,0,4,167,1,172,"2021"
"63618","292740 SALVADOR",170,109,406,27655,258,28598,"2021"
"63619","292750 SANTA BARBARA",0,0,8,208,3,219,"2021"
"63620","292760 SANTA BRIGIDA",3,0,7,184,0,194,"2021"
"63621","292770 SANTA CRUZ CABRALIA",0,1,5,451,4,461,"2021"
"63622","292780 SANTA CRUZ DA VITORIA",0,0,0,56,2,58,"2021"
"63623","292790 SANTA INES",2,0,0,103,1,106,"2021"
"63624","292800 SANTALUZ",2,1,11,504,2,520,"2021"
"63625","292805 SANTA LUZIA",1,1,2,156,3,163,"2021"
"63626","292810 SANTA MARIA DA VITORIA",1,2,7,463,17,490,"2021"
"63627","292820 SANTANA",0,0,8,287,1,296,"2021"
"63628","292830 SANTANOPOLIS",0,1,0,55,2,58,"2021"
"63629","292840 SANTA RITA DE CASSIA",2,3,9,361,6,381,"2021"
"63630","292850 SANTA TERESINHA",0,0,2,120,0,122,"2021"
"63631","292860 SANTO AMARO",3,5,8,603,9,628,"2021"
"63632","292870 SANTO ANTONIO DE JESUS",4,4,42,1291,2,1343,"2021"
"63633","292880 SANTO ESTEVAO",0,2,10,587,4,603,"2021"
"63634","292890 SAO DESIDERIO",3,5,11,628,3,650,"2021"
"63635","292895 SAO DOMINGOS",0,0,0,86,0,86,"2021"
"63636","292900 SAO FELIX",0,1,1,27,109,138,"2021"
"63637","292905 SAO FELIX DO CORIBE",0,1,1,198,3,203,"2021"
"63638","292910 SAO FELIPE",2,2,0,214,7,225,"2021"
"63639","292920 SAO FRANCISCO DO CONDE",0,1,4,454,0,459,"2021"
"63640","292925 SAO GABRIEL",3,1,5,232,0,241,"2021"
"63641","292930 SAO GONCALO DOS CAMPOS",2,1,9,326,2,340,"2021"
"63642","292935 SAO JOSE DA VITORIA",0,1,1,69,0,71,"2021"
"63643","292937 SAO JOSE DO JACUIPE",0,0,3,146,0,149,"2021"
"63644","292940 SAO MIGUEL DAS MATAS",1,1,3,114,2,121,"2021"
"63645","292950 SAO SEBASTIAO DO PASSE",1,3,2,405,7,418,"2021"
"63646","292960 SAPEACU",2,2,4,211,1,220,"2021"
"63647","292970 SATIRO DIAS",5,0,3,194,6,208,"2021"
"63648","292975 SAUBARA",0,0,2,108,0,110,"2021"
"63649","292980 SAUDE",0,2,3,101,0,106,"2021"
"63650","292990 SEABRA",1,1,6,616,5,629,"2021"
"63651","293000 SEBASTIAO LARANJEIRAS",0,0,2,80,4,86,"2021"
"63652","293010 SENHOR DO BONFIM",8,5,15,969,4,1001,"2021"
"63653","293015 SERRA DO RAMALHO",2,4,7,570,10,593,"2021"
"63654","293020 SENTO SE",3,3,13,498,4,521,"2021"
"63655","293030 SERRA DOURADA",0,0,5,233,2,240,"2021"
"63656","293040 SERRA PRETA",0,0,1,102,5,108,"2021"
"63657","293050 SERRINHA",0,3,47,1055,2,1107,"2021"
"63658","293060 SERROLANDIA",0,1,5,142,0,148,"2021"
"63659","293070 SIMOES FILHO",4,4,29,1687,22,1746,"2021"
"63660","293075 SITIO DO MATO",0,1,2,209,2,214,"2021"
"63661","293076 SITIO DO QUINTO",0,0,1,123,3,127,"2021"
"63662","293077 SOBRADINHO",2,0,9,373,3,387,"2021"
"63663","293080 SOUTO SOARES",0,3,5,206,2,216,"2021"
"63664","293090 TABOCAS DO BREJO VELHO",0,0,3,122,0,125,"2021"
"63665","293100 TANHACU",0,0,4,217,0,221,"2021"
"63666","293105 TANQUE NOVO",0,2,5,189,5,201,"2021"
"63667","293110 TANQUINHO",1,0,1,65,2,69,"2021"
"63668","293120 TAPEROA",2,3,4,257,2,268,"2021"
"63669","293130 TAPIRAMUTA",0,3,2,189,0,194,"2021"
"63670","293135 TEIXEIRA DE FREITAS",5,14,51,2398,9,2477,"2021"
"63671","293140 TEODORO SAMPAIO",1,2,0,51,2,56,"2021"
"63672","293150 TEOFILANDIA",2,3,9,248,7,269,"2021"
"63673","293160 TEOLANDIA",0,2,5,158,1,166,"2021"
"63674","293170 TERRA NOVA",0,1,2,88,2,93,"2021"
"63675","293180 TREMEDAL",0,1,5,170,2,178,"2021"
"63676","293190 TUCANO",2,3,9,562,23,599,"2021"
"63677","293200 UAUA",1,2,1,259,4,267,"2021"
"63678","293210 UBAIRA",2,3,3,200,2,210,"2021"
"63679","293220 UBAITABA",3,0,7,201,9,220,"2021"
"63680","293230 UBATA",0,0,4,194,0,198,"2021"
"63681","293240 UIBAI",0,0,0,124,0,124,"2021"
"63682","293245 UMBURANAS",0,2,2,171,0,175,"2021"
"63683","293250 UNA",1,2,9,196,27,235,"2021"
"63684","293260 URANDI",0,0,10,169,0,179,"2021"
"63685","293270 URUCUCA",0,3,5,261,53,322,"2021"
"63686","293280 UTINGA",1,2,6,213,7,229,"2021"
"63687","293290 VALENCA",4,10,36,1227,2,1279,"2021"
"63688","293300 VALENTE",0,3,11,234,3,251,"2021"
"63689","293305 VARZEA DA ROCA",0,0,0,116,1,117,"2021"
"63690","293310 VARZEA DO POCO",1,1,4,82,1,89,"2021"
"63691","293315 VARZEA NOVA",1,3,3,181,0,188,"2021"
"63692","293317 VARZEDO",2,0,3,114,0,119,"2021"
"63693","293320 VERA CRUZ",1,4,6,520,5,536,"2021"
"63694","293325 VEREDA",0,1,2,88,0,91,"2021"
"63695","293330 VITORIA DA CONQUISTA",19,19,100,5056,48,5242,"2021"
"63696","293340 WAGNER",0,0,1,71,19,91,"2021"
"63697","293345 WANDERLEY",0,1,4,169,1,175,"2021"
"63698","293350 WENCESLAU GUIMARAES",1,2,8,339,8,358,"2021"
"63699","293360 XIQUE-XIQUE",4,6,16,855,20,901,"2021"
"63700","MUNICIPIO IGNORADO - MG",0,0,0,2,0,2,"2021"
"63701","310010 ABADIA DOS DOURADOS",0,0,1,46,0,47,"2021"
"63702","310020 ABAETE",1,2,2,195,0,200,"2021"
"63703","310030 ABRE CAMPO",0,0,2,150,20,172,"2021"
"63704","310040 ACAIACA",0,0,0,46,0,46,"2021"
"63705","310050 ACUCENA",0,0,2,67,1,70,"2021"
"63706","310060 AGUA BOA",1,0,8,131,2,142,"2021"
"63707","310070 AGUA COMPRIDA",1,0,0,19,0,20,"2021"
"63708","310080 AGUANIL",0,0,0,40,0,40,"2021"
"63709","310090 AGUAS FORMOSAS",1,2,1,286,4,294,"2021"
"63710","310100 AGUAS VERMELHAS",0,1,2,161,1,165,"2021"
"63711","310110 AIMORES",2,1,4,317,0,324,"2021"
"63712","310120 AIURUOCA",0,0,0,62,0,62,"2021"
"63713","310130 ALAGOA",0,0,0,24,0,24,"2021"
"63714","310140 ALBERTINA",0,0,0,28,0,28,"2021"
"63715","310150 ALEM PARAIBA",1,2,4,333,0,340,"2021"
"63716","310160 ALFENAS",5,4,12,929,4,954,"2021"
"63717","310163 ALFREDO VASCONCELOS",0,0,1,85,0,86,"2021"
"63718","310170 ALMENARA",8,2,16,543,1,570,"2021"
"63719","310180 ALPERCATA",0,0,3,78,0,81,"2021"
"63720","310190 ALPINOPOLIS",1,1,2,214,0,218,"2021"
"63721","310200 ALTEROSA",0,1,4,141,0,146,"2021"
"63722","310205 ALTO CAPARAO",0,1,0,73,9,83,"2021"
"63723","310210 ALTO RIO DOCE",0,0,2,91,1,94,"2021"
"63724","310220 ALVARENGA",0,0,0,50,0,50,"2021"
"63725","310230 ALVINOPOLIS",0,0,2,130,1,133,"2021"
"63726","310240 ALVORADA DE MINAS",0,0,0,53,0,53,"2021"
"63727","310250 AMPARO DO SERRA",0,0,0,44,0,44,"2021"
"63728","310260 ANDRADAS",0,1,2,458,4,465,"2021"
"63729","310270 CACHOEIRA DE PAJEU",0,0,4,78,3,85,"2021"
"63730","310280 ANDRELANDIA",0,0,6,109,0,115,"2021"
"63731","310285 ANGELANDIA",0,0,2,123,1,126,"2021"
"63732","310290 ANTONIO CARLOS",0,0,2,108,0,110,"2021"
"63733","310300 ANTONIO DIAS",0,1,2,85,1,89,"2021"
"63734","310310 ANTONIO PRADO DE MINAS",0,0,0,9,0,9,"2021"
"63735","310320 ARACAI",0,0,0,10,0,10,"2021"
"63736","310330 ARACITABA",1,0,0,16,0,17,"2021"
"63737","310340 ARACUAI",0,4,6,412,3,425,"2021"
"63738","310350 ARAGUARI",5,5,10,1228,7,1255,"2021"
"63739","310360 ARANTINA",0,0,1,32,1,34,"2021"
"63740","310370 ARAPONGA",0,0,2,108,7,117,"2021"
"63741","310375 ARAPORA",0,1,2,125,0,128,"2021"
"63742","310380 ARAPUA",0,0,0,20,1,21,"2021"
"63743","310390 ARAUJOS",0,1,2,108,1,112,"2021"
"63744","310400 ARAXA",8,7,17,1406,2,1440,"2021"
"63745","310410 ARCEBURGO",0,0,1,53,0,54,"2021"
"63746","310420 ARCOS",0,3,6,470,1,480,"2021"
"63747","310430 AREADO",0,1,0,136,0,137,"2021"
"63748","310440 ARGIRITA",0,0,0,26,0,26,"2021"
"63749","310445 ARICANDUVA",0,0,2,59,2,63,"2021"
"63750","310450 ARINOS",1,4,1,190,1,197,"2021"
"63751","310460 ASTOLFO DUTRA",0,3,2,95,0,100,"2021"
"63752","310470 ATALEIA",0,1,4,134,4,143,"2021"
"63753","310480 AUGUSTO DE LIMA",0,0,0,43,1,44,"2021"
"63754","310490 BAEPENDI",1,0,2,174,0,177,"2021"
"63755","310500 BALDIM",0,0,1,68,1,70,"2021"
"63756","310510 BAMBUI",0,2,7,222,0,231,"2021"
"63757","310520 BANDEIRA",0,0,6,39,0,45,"2021"
"63758","310530 BANDEIRA DO SUL",1,0,2,68,0,71,"2021"
"63759","310540 BARAO DE COCAIS",4,0,3,364,3,374,"2021"
"63760","310550 BARAO DE MONTE ALTO",0,0,0,48,0,48,"2021"
"63761","310560 BARBACENA",1,3,7,1331,4,1346,"2021"
"63762","310570 BARRA LONGA",0,1,0,52,2,55,"2021"
"63763","310590 BARROSO",0,3,2,234,0,239,"2021"
"63764","310600 BELA VISTA DE MINAS",0,0,3,106,2,111,"2021"
"63765","310610 BELMIRO BRAGA",0,0,0,29,1,30,"2021"
"63766","310620 BELO HORIZONTE",70,105,420,24338,95,25028,"2021"
"63767","310630 BELO ORIENTE",1,0,2,322,4,329,"2021"
"63768","310640 BELO VALE",0,0,2,94,0,96,"2021"
"63769","310650 BERILO",0,2,1,76,0,79,"2021"
"63770","310660 BERTOPOLIS",0,0,2,68,16,86,"2021"
"63771","310665 BERIZAL",0,0,0,56,1,57,"2021"
"63772","310670 BETIM",15,26,132,5367,52,5592,"2021"
"63773","310680 BIAS FORTES",0,0,0,19,0,19,"2021"
"63774","310690 BICAS",1,0,1,139,1,142,"2021"
"63775","310700 BIQUINHAS",0,0,0,21,0,21,"2021"
"63776","310710 BOA ESPERANCA",3,2,3,460,0,468,"2021"
"63777","310720 BOCAINA DE MINAS",0,2,0,23,0,25,"2021"
"63778","310730 BOCAIUVA",2,1,16,610,5,634,"2021"
"63779","310740 BOM DESPACHO",6,3,15,627,0,651,"2021"
"63780","310750 BOM JARDIM DE MINAS",0,1,1,51,1,54,"2021"
"63781","310760 BOM JESUS DA PENHA",2,0,0,48,0,50,"2021"
"63782","310770 BOM JESUS DO AMPARO",1,0,1,69,1,72,"2021"
"63783","310780 BOM JESUS DO GALHO",0,0,1,167,1,169,"2021"
"63784","310790 BOM REPOUSO",0,0,0,161,0,161,"2021"
"63785","310800 BOM SUCESSO",0,0,1,144,1,146,"2021"
"63786","310810 BONFIM",0,0,4,37,0,41,"2021"
"63787","310820 BONFINOPOLIS DE MINAS",0,0,0,45,1,46,"2021"
"63788","310825 BONITO DE MINAS",0,0,2,75,57,134,"2021"
"63789","310830 BORDA DA MATA",1,1,1,147,0,150,"2021"
"63790","310840 BOTELHOS",0,0,2,127,0,129,"2021"
"63791","310850 BOTUMIRIM",0,0,0,59,2,61,"2021"
"63792","310855 BRASILANDIA DE MINAS",2,0,1,240,1,244,"2021"
"63793","310860 BRASILIA DE MINAS",1,4,4,482,3,494,"2021"
"63794","310870 BRAS PIRES",0,1,1,34,0,36,"2021"
"63795","310880 BRAUNAS",0,0,0,57,1,58,"2021"
"63796","310890 BRAZOPOLIS",0,0,1,143,0,144,"2021"
"63797","310900 BRUMADINHO",0,3,12,490,3,508,"2021"
"63798","310910 BUENO BRANDAO",0,0,0,88,0,88,"2021"
"63799","310920 BUENOPOLIS",0,1,1,93,0,95,"2021"
"63800","310925 BUGRE",0,0,0,36,1,37,"2021"
"63801","310930 BURITIS",0,2,7,352,1,362,"2021"
"63802","310940 BURITIZEIRO",0,1,1,305,4,311,"2021"
"63803","310945 CABECEIRA GRANDE",0,1,1,55,0,57,"2021"
"63804","310950 CABO VERDE",0,0,0,111,1,112,"2021"
"63805","310960 CACHOEIRA DA PRATA",1,0,0,31,0,32,"2021"
"63806","310970 CACHOEIRA DE MINAS",0,0,0,116,1,117,"2021"
"63807","310980 CACHOEIRA DOURADA",0,0,0,14,0,14,"2021"
"63808","310990 CAETANOPOLIS",0,1,0,109,1,111,"2021"
"63809","311000 CAETE",1,1,3,397,3,405,"2021"
"63810","311010 CAIANA",0,0,1,52,0,53,"2021"
"63811","311020 CAJURI",0,0,0,48,1,49,"2021"
"63812","311030 CALDAS",0,0,5,84,0,89,"2021"
"63813","311040 CAMACHO",0,0,0,41,0,41,"2021"
"63814","311050 CAMANDUCAIA",1,0,5,256,3,265,"2021"
"63815","311060 CAMBUI",0,1,3,290,1,295,"2021"
"63816","311070 CAMBUQUIRA",2,0,3,147,0,152,"2021"
"63817","311080 CAMPANARIO",0,0,0,27,0,27,"2021"
"63818","311090 CAMPANHA",0,0,3,173,1,177,"2021"
"63819","311100 CAMPESTRE",1,1,1,227,2,232,"2021"
"63820","311110 CAMPINA VERDE",1,0,2,145,0,148,"2021"
"63821","311115 CAMPO AZUL",0,0,0,31,0,31,"2021"
"63822","311120 CAMPO BELO",0,2,6,574,1,583,"2021"
"63823","311130 CAMPO DO MEIO",1,0,2,115,1,119,"2021"
"63824","311140 CAMPO FLORIDO",3,0,1,95,0,99,"2021"
"63825","311150 CAMPOS ALTOS",0,1,2,167,0,170,"2021"
"63826","311160 CAMPOS GERAIS",1,1,5,262,6,275,"2021"
"63827","311170 CANAA",0,0,1,38,0,39,"2021"
"63828","311180 CANAPOLIS",0,0,0,117,2,119,"2021"
"63829","311190 CANA VERDE",0,0,1,45,0,46,"2021"
"63830","311200 CANDEIAS",1,1,0,107,1,110,"2021"
"63831","311205 CANTAGALO",0,0,0,54,0,54,"2021"
"63832","311210 CAPARAO",0,0,0,86,0,86,"2021"
"63833","311220 CAPELA NOVA",0,0,0,47,0,47,"2021"
"63834","311230 CAPELINHA",2,1,10,571,5,589,"2021"
"63835","311240 CAPETINGA",0,0,0,76,0,76,"2021"
"63836","311250 CAPIM BRANCO",0,0,1,103,1,105,"2021"
"63837","311260 CAPINOPOLIS",0,2,1,160,1,164,"2021"
"63838","311265 CAPITAO ANDRADE",0,0,0,48,2,50,"2021"
"63839","311270 CAPITAO ENEAS",1,0,4,202,3,210,"2021"
"63840","311280 CAPITOLIO",0,0,5,126,0,131,"2021"
"63841","311290 CAPUTIRA",0,1,1,128,0,130,"2021"
"63842","311300 CARAI",1,1,2,250,1,255,"2021"
"63843","311310 CARANAIBA",0,0,0,30,0,30,"2021"
"63844","311320 CARANDAI",0,1,3,248,3,255,"2021"
"63845","311330 CARANGOLA",0,0,3,414,0,417,"2021"
"63846","311340 CARATINGA",3,0,5,1123,6,1137,"2021"
"63847","311350 CARBONITA",2,1,1,86,1,91,"2021"
"63848","311360 CAREACU",0,0,1,66,0,67,"2021"
"63849","311370 CARLOS CHAGAS",0,1,2,225,2,230,"2021"
"63850","311380 CARMESIA",0,0,0,34,0,34,"2021"
"63851","311390 CARMO DA CACHOEIRA",0,1,2,122,0,125,"2021"
"63852","311400 CARMO DA MATA",1,0,2,87,0,90,"2021"
"63853","311410 CARMO DE MINAS",0,0,6,130,0,136,"2021"
"63854","311420 CARMO DO CAJURU",1,0,6,265,0,272,"2021"
"63855","311430 CARMO DO PARANAIBA",0,1,1,275,1,278,"2021"
"63856","311440 CARMO DO RIO CLARO",0,0,2,213,0,215,"2021"
"63857","311450 CARMOPOLIS DE MINAS",2,0,0,214,0,216,"2021"
"63858","311455 CARNEIRINHO",0,0,2,80,0,82,"2021"
"63859","311460 CARRANCAS",0,0,0,56,0,56,"2021"
"63860","311470 CARVALHOPOLIS",0,0,0,25,0,25,"2021"
"63861","311480 CARVALHOS",0,1,0,41,0,42,"2021"
"63862","311490 CASA GRANDE",0,0,0,22,0,22,"2021"
"63863","311500 CASCALHO RICO",0,0,0,35,0,35,"2021"
"63864","311510 CASSIA",0,2,11,199,0,212,"2021"
"63865","311520 CONCEICAO DA BARRA DE MINAS",0,0,0,30,0,30,"2021"
"63866","311530 CATAGUASES",1,2,7,638,3,651,"2021"
"63867","311535 CATAS ALTAS",0,1,1,66,1,69,"2021"
"63868","311540 CATAS ALTAS DA NORUEGA",0,0,0,34,1,35,"2021"
"63869","311545 CATUJI",0,1,1,121,0,123,"2021"
"63870","311547 CATUTI",0,0,1,19,28,48,"2021"
"63871","311550 CAXAMBU",1,0,1,191,18,211,"2021"
"63872","311560 CEDRO DO ABAETE",0,0,0,6,0,6,"2021"
"63873","311570 CENTRAL DE MINAS",1,0,0,78,1,80,"2021"
"63874","311580 CENTRALINA",0,0,0,107,2,109,"2021"
"63875","311590 CHACARA",0,0,2,30,0,32,"2021"
"63876","311600 CHALE",0,1,2,75,0,78,"2021"
"63877","311610 CHAPADA DO NORTE",0,0,0,94,0,94,"2021"
"63878","311615 CHAPADA GAUCHA",0,1,0,201,5,207,"2021"
"63879","311620 CHIADOR",0,0,0,29,0,29,"2021"
"63880","311630 CIPOTANEA",1,0,1,41,0,43,"2021"
"63881","311640 CLARAVAL",0,0,0,13,0,13,"2021"
"63882","311650 CLARO DOS POCOES",0,0,0,62,0,62,"2021"
"63883","311660 CLAUDIO",0,3,7,352,3,365,"2021"
"63884","311670 COIMBRA",0,0,1,60,0,61,"2021"
"63885","311680 COLUNA",0,0,3,111,1,115,"2021"
"63886","311690 COMENDADOR GOMES",0,0,0,27,0,27,"2021"
"63887","311700 COMERCINHO",0,1,1,44,1,47,"2021"
"63888","311710 CONCEICAO DA APARECIDA",2,0,0,108,0,110,"2021"
"63889","311720 CONCEICAO DAS PEDRAS",0,0,0,26,0,26,"2021"
"63890","311730 CONCEICAO DAS ALAGOAS",3,1,2,345,0,351,"2021"
"63891","311740 CONCEICAO DE IPANEMA",0,0,0,50,0,50,"2021"
"63892","311750 CONCEICAO DO MATO DENTRO",1,2,5,269,8,285,"2021"
"63893","311760 CONCEICAO DO PARA",0,0,1,62,0,63,"2021"
"63894","311770 CONCEICAO DO RIO VERDE",0,2,0,143,1,146,"2021"
"63895","311780 CONCEICAO DOS OUROS",0,0,2,102,0,104,"2021"
"63896","311783 CONEGO MARINHO",0,0,2,50,25,77,"2021"
"63897","311787 CONFINS",0,0,1,87,1,89,"2021"
"63898","311790 CONGONHAL",0,0,1,123,0,124,"2021"
"63899","311800 CONGONHAS",0,4,9,701,1,715,"2021"
"63900","311810 CONGONHAS DO NORTE",0,0,1,64,0,65,"2021"
"63901","311820 CONQUISTA",0,1,1,53,0,55,"2021"
"63902","311830 CONSELHEIRO LAFAIETE",5,4,21,1526,4,1560,"2021"
"63903","311840 CONSELHEIRO PENA",1,1,4,226,1,233,"2021"
"63904","311850 CONSOLACAO",0,0,0,18,0,18,"2021"
"63905","311860 CONTAGEM",24,40,113,7350,37,7564,"2021"
"63906","311870 COQUEIRAL",0,1,2,83,1,87,"2021"
"63907","311880 CORACAO DE JESUS",0,0,2,255,2,259,"2021"
"63908","311890 CORDISBURGO",0,0,0,71,0,71,"2021"
"63909","311900 CORDISLANDIA",0,0,1,39,0,40,"2021"
"63910","311910 CORINTO",0,1,4,276,2,283,"2021"
"63911","311920 COROACI",0,0,0,84,2,86,"2021"
"63912","311930 COROMANDEL",0,1,3,291,0,295,"2021"
"63913","311940 CORONEL FABRICIANO",3,4,15,1189,7,1218,"2021"
"63914","311950 CORONEL MURTA",0,0,1,92,5,98,"2021"
"63915","311960 CORONEL PACHECO",0,0,1,22,0,23,"2021"
"63916","311970 CORONEL XAVIER CHAVES",0,0,0,36,0,36,"2021"
"63917","311980 CORREGO DANTA",0,0,0,21,0,21,"2021"
"63918","311990 CORREGO DO BOM JESUS",0,0,0,23,0,23,"2021"
"63919","311995 CORREGO FUNDO",0,0,0,46,0,46,"2021"
"63920","312000 CORREGO NOVO",0,0,0,30,0,30,"2021"
"63921","312010 COUTO DE MAGALHAES DE MINAS",0,0,0,50,0,50,"2021"
"63922","312015 CRISOLITA",0,0,3,93,2,98,"2021"
"63923","312020 CRISTAIS",0,1,1,120,0,122,"2021"
"63924","312030 CRISTALIA",0,0,1,92,0,93,"2021"
"63925","312040 CRISTIANO OTONI",0,1,1,56,1,59,"2021"
"63926","312050 CRISTINA",0,0,0,109,1,110,"2021"
"63927","312060 CRUCILANDIA",0,0,0,43,0,43,"2021"
"63928","312070 CRUZEIRO DA FORTALEZA",0,0,1,46,0,47,"2021"
"63929","312080 CRUZILIA",0,1,0,194,0,195,"2021"
"63930","312083 CUPARAQUE",2,0,0,75,2,79,"2021"
"63931","312087 CURRAL DE DENTRO",0,0,3,90,4,97,"2021"
"63932","312090 CURVELO",2,6,9,938,2,957,"2021"
"63933","312100 DATAS",0,0,1,61,1,63,"2021"
"63934","312110 DELFIM MOREIRA",1,0,0,82,1,84,"2021"
"63935","312120 DELFINOPOLIS",2,0,6,90,0,98,"2021"
"63936","312125 DELTA",1,0,2,138,0,141,"2021"
"63937","312130 DESCOBERTO",0,0,1,47,0,48,"2021"
"63938","312140 DESTERRO DE ENTRE RIOS",0,1,1,71,1,74,"2021"
"63939","312150 DESTERRO DO MELO",0,0,0,25,0,25,"2021"
"63940","312160 DIAMANTINA",0,5,12,628,4,649,"2021"
"63941","312170 DIOGO DE VASCONCELOS",0,0,0,37,1,38,"2021"
"63942","312180 DIONISIO",0,0,0,39,1,40,"2021"
"63943","312190 DIVINESIA",0,0,0,51,1,52,"2021"
"63944","312200 DIVINO",2,0,0,265,1,268,"2021"
"63945","312210 DIVINO DAS LARANJEIRAS",0,0,0,54,1,55,"2021"
"63946","312220 DIVINOLANDIA DE MINAS",1,2,1,88,1,93,"2021"
"63947","312230 DIVINOPOLIS",9,10,54,2511,17,2601,"2021"
"63948","312235 DIVISA ALEGRE",0,0,2,62,0,64,"2021"
"63949","312240 DIVISA NOVA",0,0,3,71,0,74,"2021"
"63950","312245 DIVISOPOLIS",0,0,3,76,2,81,"2021"
"63951","312247 DOM BOSCO",0,0,0,57,0,57,"2021"
"63952","312250 DOM CAVATI",0,1,2,56,1,60,"2021"
"63953","312260 DOM JOAQUIM",0,0,1,63,1,65,"2021"
"63954","312270 DOM SILVERIO",0,0,1,39,0,40,"2021"
"63955","312280 DOM VICOSO",0,0,0,25,0,25,"2021"
"63956","312290 DONA EUSEBIA",0,0,1,66,0,67,"2021"
"63957","312300 DORES DE CAMPOS",0,1,1,104,1,107,"2021"
"63958","312310 DORES DE GUANHAES",0,0,1,65,0,66,"2021"
"63959","312320 DORES DO INDAIA",0,0,1,107,0,108,"2021"
"63960","312330 DORES DO TURVO",0,0,1,36,0,37,"2021"
"63961","312340 DORESOPOLIS",0,0,0,12,0,12,"2021"
"63962","312350 DOURADOQUARA",0,0,0,14,0,14,"2021"
"63963","312352 DURANDE",0,0,5,145,0,150,"2021"
"63964","312360 ELOI MENDES",1,1,1,315,1,319,"2021"
"63965","312370 ENGENHEIRO CALDAS",0,0,1,125,2,128,"2021"
"63966","312380 ENGENHEIRO NAVARRO",0,0,1,81,2,84,"2021"
"63967","312385 ENTRE FOLHAS",0,0,0,76,0,76,"2021"
"63968","312390 ENTRE RIOS DE MINAS",0,0,0,183,0,183,"2021"
"63969","312400 ERVALIA",0,2,2,240,3,247,"2021"
"63970","312410 ESMERALDAS",5,6,15,968,12,1006,"2021"
"63971","312420 ESPERA FELIZ",0,0,0,328,0,328,"2021"
"63972","312430 ESPINOSA",1,3,7,336,31,378,"2021"
"63973","312440 ESPIRITO SANTO DO DOURADO",0,0,1,104,0,105,"2021"
"63974","312450 ESTIVA",0,0,0,109,1,110,"2021"
"63975","312460 ESTRELA DALVA",0,0,0,21,0,21,"2021"
"63976","312470 ESTRELA DO INDAIA",1,0,0,17,0,18,"2021"
"63977","312480 ESTRELA DO SUL",0,0,1,82,0,83,"2021"
"63978","312490 EUGENOPOLIS",0,0,1,96,0,97,"2021"
"63979","312500 EWBANK DA CAMARA",0,1,0,55,1,57,"2021"
"63980","312510 EXTREMA",2,1,2,767,2,774,"2021"
"63981","312520 FAMA",0,0,0,19,0,19,"2021"
"63982","312530 FARIA LEMOS",0,0,0,33,0,33,"2021"
"63983","312540 FELICIO DOS SANTOS",0,1,2,63,2,68,"2021"
"63984","312550 SAO GONCALO DO RIO PRETO",0,1,0,15,1,17,"2021"
"63985","312560 FELISBURGO",0,2,2,76,1,81,"2021"
"63986","312570 FELIXLANDIA",0,1,1,130,0,132,"2021"
"63987","312580 FERNANDES TOURINHO",0,0,0,22,0,22,"2021"
"63988","312590 FERROS",0,0,2,75,2,79,"2021"
"63989","312595 FERVEDOURO",1,0,1,135,0,137,"2021"
"63990","312600 FLORESTAL",1,0,0,72,0,73,"2021"
"63991","312610 FORMIGA",2,5,20,639,1,667,"2021"
"63992","312620 FORMOSO",0,1,1,94,1,97,"2021"
"63993","312630 FORTALEZA DE MINAS",0,1,2,28,0,31,"2021"
"63994","312640 FORTUNA DE MINAS",1,0,0,44,0,45,"2021"
"63995","312650 FRANCISCO BADARO",0,0,3,59,0,62,"2021"
"63996","312660 FRANCISCO DUMONT",0,1,1,43,0,45,"2021"
"63997","312670 FRANCISCO SA",0,0,3,235,1,239,"2021"
"63998","312675 FRANCISCOPOLIS",0,0,0,53,0,53,"2021"
"63999","312680 FREI GASPAR",0,1,1,83,2,87,"2021"
"64000","312690 FREI INOCENCIO",0,1,1,95,6,103,"2021"
"64001","312695 FREI LAGONEGRO",0,0,1,35,0,36,"2021"
"64002","312700 FRONTEIRA",0,0,0,118,0,118,"2021"
"64003","312705 FRONTEIRA DOS VALES",0,0,2,54,0,56,"2021"
"64004","312707 FRUTA DE LEITE",0,0,0,6,48,54,"2021"
"64005","312710 FRUTAL",2,2,4,681,0,689,"2021"
"64006","312720 FUNILANDIA",0,0,0,43,0,43,"2021"
"64007","312730 GALILEIA",0,1,7,75,0,83,"2021"
"64008","312733 GAMELEIRAS",0,0,0,6,48,54,"2021"
"64009","312735 GLAUCILANDIA",0,1,1,24,1,27,"2021"
"64010","312737 GOIABEIRA",0,1,2,36,0,39,"2021"
"64011","312738 GOIANA",0,0,1,19,0,20,"2021"
"64012","312740 GONCALVES",0,0,0,45,0,45,"2021"
"64013","312750 GONZAGA",0,0,1,63,1,65,"2021"
"64014","312760 GOUVEIA",0,2,2,137,0,141,"2021"
"64015","312770 GOVERNADOR VALADARES",13,16,39,3380,29,3477,"2021"
"64016","312780 GRAO MOGOL",0,1,2,129,16,148,"2021"
"64017","312790 GRUPIARA",0,0,0,16,0,16,"2021"
"64018","312800 GUANHAES",0,2,6,407,1,416,"2021"
"64019","312810 GUAPE",1,0,1,114,0,116,"2021"
"64020","312820 GUARACIABA",1,0,1,63,0,65,"2021"
"64021","312825 GUARACIAMA",0,0,0,45,0,45,"2021"
"64022","312830 GUARANESIA",0,1,4,241,4,250,"2021"
"64023","312840 GUARANI",0,0,0,75,3,78,"2021"
"64024","312850 GUARARA",0,1,2,42,0,45,"2021"
"64025","312860 GUARDA-MOR",1,0,3,68,0,72,"2021"
"64026","312870 GUAXUPE",0,4,16,507,2,529,"2021"
"64027","312880 GUIDOVAL",0,0,1,90,1,92,"2021"
"64028","312890 GUIMARANIA",0,0,0,114,0,114,"2021"
"64029","312900 GUIRICEMA",0,0,0,67,0,67,"2021"
"64030","312910 GURINHATA",0,0,0,25,0,25,"2021"
"64031","312920 HELIODORA",0,0,0,65,2,67,"2021"
"64032","312930 IAPU",0,1,0,133,2,136,"2021"
"64033","312940 IBERTIOGA",0,0,1,53,0,54,"2021"
"64034","312950 IBIA",1,1,2,240,1,245,"2021"
"64035","312960 IBIAI",1,0,4,91,0,96,"2021"
"64036","312965 IBIRACATU",0,0,0,61,1,62,"2021"
"64037","312970 IBIRACI",2,0,2,125,0,129,"2021"
"64038","312980 IBIRITE",12,9,36,2240,14,2311,"2021"
"64039","312990 IBITIURA DE MINAS",0,0,0,32,0,32,"2021"
"64040","313000 IBITURUNA",0,1,0,16,0,17,"2021"
"64041","313005 ICARAI DE MINAS",0,0,3,117,0,120,"2021"
"64042","313010 IGARAPE",1,3,16,601,8,629,"2021"
"64043","313020 IGARATINGA",1,1,6,146,0,154,"2021"
"64044","313030 IGUATAMA",0,0,0,62,0,62,"2021"
"64045","313040 IJACI",0,1,1,75,0,77,"2021"
"64046","313050 ILICINEA",0,0,1,135,1,137,"2021"
"64047","313055 IMBE DE MINAS",0,0,0,84,0,84,"2021"
"64048","313060 INCONFIDENTES",0,2,1,72,2,77,"2021"
"64049","313065 INDAIABIRA",0,0,2,63,0,65,"2021"
"64050","313070 INDIANOPOLIS",0,0,3,53,0,56,"2021"
"64051","313080 INGAI",0,0,0,22,0,22,"2021"
"64052","313090 INHAPIM",1,0,0,254,0,255,"2021"
"64053","313100 INHAUMA",0,0,2,70,0,72,"2021"
"64054","313110 INIMUTABA",0,0,2,63,0,65,"2021"
"64055","313115 IPABA",0,1,1,243,2,247,"2021"
"64056","313120 IPANEMA",0,0,4,224,0,228,"2021"
"64057","313130 IPATINGA",11,8,29,2842,10,2900,"2021"
"64058","313140 IPIACU",0,0,3,39,0,42,"2021"
"64059","313150 IPUIUNA",0,0,0,96,0,96,"2021"
"64060","313160 IRAI DE MINAS",1,0,0,81,0,82,"2021"
"64061","313170 ITABIRA",12,2,6,1254,5,1279,"2021"
"64062","313180 ITABIRINHA",0,1,1,155,3,160,"2021"
"64063","313190 ITABIRITO",1,4,25,713,0,743,"2021"
"64064","313200 ITACAMBIRA",0,0,0,39,1,40,"2021"
"64065","313210 ITACARAMBI",1,1,4,212,41,259,"2021"
"64066","313220 ITAGUARA",0,1,0,168,1,170,"2021"
"64067","313230 ITAIPE",0,0,1,205,1,207,"2021"
"64068","313240 ITAJUBA",4,4,10,1070,1,1089,"2021"
"64069","313250 ITAMARANDIBA",3,2,5,435,2,447,"2021"
"64070","313260 ITAMARATI DE MINAS",0,0,0,37,1,38,"2021"
"64071","313270 ITAMBACURI",3,4,5,295,1,308,"2021"
"64072","313280 ITAMBE DO MATO DENTRO",0,0,0,19,0,19,"2021"
"64073","313290 ITAMOGI",0,1,0,105,0,106,"2021"
"64074","313300 ITAMONTE",0,1,4,178,0,183,"2021"
"64075","313310 ITANHANDU",0,0,0,178,0,178,"2021"
"64076","313320 ITANHOMI",0,0,1,143,0,144,"2021"
"64077","313330 ITAOBIM",0,3,3,243,0,249,"2021"
"64078","313340 ITAPAGIPE",1,0,0,93,0,94,"2021"
"64079","313350 ITAPECERICA",0,1,7,169,2,179,"2021"
"64080","313360 ITAPEVA",2,0,0,124,0,126,"2021"
"64081","313370 ITATIAIUCU",0,0,0,126,0,126,"2021"
"64082","313375 ITAU DE MINAS",0,0,2,149,0,151,"2021"
"64083","313380 ITAUNA",0,1,10,1010,2,1023,"2021"
"64084","313390 ITAVERAVA",0,0,1,48,0,49,"2021"
"64085","313400 ITINGA",1,0,4,135,1,141,"2021"
"64086","313410 ITUETA",0,0,1,83,0,84,"2021"
"64087","313420 ITUIUTABA",9,1,7,1012,5,1034,"2021"
"64088","313430 ITUMIRIM",0,0,0,68,0,68,"2021"
"64089","313440 ITURAMA",0,1,6,489,1,497,"2021"
"64090","313450 ITUTINGA",2,0,0,49,0,51,"2021"
"64091","313460 JABOTICATUBAS",6,1,1,199,3,210,"2021"
"64092","313470 JACINTO",0,2,7,116,0,125,"2021"
"64093","313480 JACUI",0,1,0,82,1,84,"2021"
"64094","313490 JACUTINGA",0,0,2,296,0,298,"2021"
"64095","313500 JAGUARACU",0,0,1,22,0,23,"2021"
"64096","313505 JAIBA",2,0,6,510,62,580,"2021"
"64097","313507 JAMPRUCA",0,0,2,50,2,54,"2021"
"64098","313510 JANAUBA",3,3,11,1016,11,1044,"2021"
"64099","313520 JANUARIA",0,1,10,637,312,960,"2021"
"64100","313530 JAPARAIBA",0,0,2,58,0,60,"2021"
"64101","313535 JAPONVAR",0,0,0,92,0,92,"2021"
"64102","313540 JECEABA",0,0,0,54,0,54,"2021"
"64103","313545 JENIPAPO DE MINAS",0,0,1,60,0,61,"2021"
"64104","313550 JEQUERI",0,0,0,121,6,127,"2021"
"64105","313560 JEQUITAI",0,1,1,60,3,65,"2021"
"64106","313570 JEQUITIBA",0,0,1,58,0,59,"2021"
"64107","313580 JEQUITINHONHA",0,1,6,247,1,255,"2021"
"64108","313590 JESUANIA",0,1,1,52,1,55,"2021"
"64109","313600 JOAIMA",0,0,1,197,1,199,"2021"
"64110","313610 JOANESIA",0,0,0,34,0,34,"2021"
"64111","313620 JOAO MONLEVADE",1,1,14,865,5,886,"2021"
"64112","313630 JOAO PINHEIRO",0,7,10,677,0,694,"2021"
"64113","313640 JOAQUIM FELICIO",0,0,2,37,1,40,"2021"
"64114","313650 JORDANIA",2,0,2,99,0,103,"2021"
"64115","313652 JOSE GONCALVES DE MINAS",0,0,0,33,0,33,"2021"
"64116","313655 JOSE RAYDAN",0,0,0,58,0,58,"2021"
"64117","313657 JOSENOPOLIS",0,0,0,32,22,54,"2021"
"64118","313660 NOVA UNIAO",0,1,1,68,3,73,"2021"
"64119","313665 JUATUBA",0,2,5,348,2,357,"2021"
"64120","313670 JUIZ DE FORA",11,21,81,5508,32,5653,"2021"
"64121","313680 JURAMENTO",0,1,0,41,1,43,"2021"
"64122","313690 JURUAIA",1,0,5,111,1,118,"2021"
"64123","313695 JUVENILIA",0,0,1,20,58,79,"2021"
"64124","313700 LADAINHA",0,1,4,155,3,163,"2021"
"64125","313710 LAGAMAR",0,0,1,51,0,52,"2021"
"64126","313720 LAGOA DA PRATA",1,4,30,588,0,623,"2021"
"64127","313730 LAGOA DOS PATOS",0,0,1,41,1,43,"2021"
"64128","313740 LAGOA DOURADA",0,0,1,142,0,143,"2021"
"64129","313750 LAGOA FORMOSA",0,1,3,188,3,195,"2021"
"64130","313753 LAGOA GRANDE",0,0,1,88,2,91,"2021"
"64131","313760 LAGOA SANTA",2,5,16,790,4,817,"2021"
"64132","313770 LAJINHA",1,1,2,305,1,310,"2021"
"64133","313780 LAMBARI",0,0,1,222,0,223,"2021"
"64134","313790 LAMIM",0,0,1,20,0,21,"2021"
"64135","313800 LARANJAL",0,0,1,42,0,43,"2021"
"64136","313810 LASSANCE",0,0,3,93,1,97,"2021"
"64137","313820 LAVRAS",4,6,11,1281,7,1309,"2021"
"64138","313830 LEANDRO FERREIRA",0,0,0,34,0,34,"2021"
"64139","313835 LEME DO PRADO",1,2,1,48,0,52,"2021"
"64140","313840 LEOPOLDINA",1,3,9,514,0,527,"2021"
"64141","313850 LIBERDADE",0,0,0,40,0,40,"2021"
"64142","313860 LIMA DUARTE",0,0,2,167,0,169,"2021"
"64143","313862 LIMEIRA DO OESTE",0,0,0,95,0,95,"2021"
"64144","313865 LONTRA",0,0,1,100,0,101,"2021"
"64145","313867 LUISBURGO",0,1,0,111,0,112,"2021"
"64146","313868 LUISLANDIA",0,0,0,77,1,78,"2021"
"64147","313870 LUMINARIAS",0,0,0,48,0,48,"2021"
"64148","313880 LUZ",0,1,7,194,0,202,"2021"
"64149","313890 MACHACALIS",0,1,1,73,0,75,"2021"
"64150","313900 MACHADO",2,1,3,395,0,401,"2021"
"64151","313910 MADRE DE DEUS DE MINAS",0,0,0,61,0,61,"2021"
"64152","313920 MALACACHETA",0,0,1,193,2,196,"2021"
"64153","313925 MAMONAS",0,0,0,3,43,46,"2021"
"64154","313930 MANGA",0,1,2,39,262,304,"2021"
"64155","313940 MANHUACU",1,4,24,1326,1,1356,"2021"
"64156","313950 MANHUMIRIM",0,1,4,243,7,255,"2021"
"64157","313960 MANTENA",1,0,1,353,0,355,"2021"
"64158","313970 MARAVILHAS",1,1,1,75,1,79,"2021"
"64159","313980 MAR DE ESPANHA",0,0,1,150,2,153,"2021"
"64160","313990 MARIA DA FE",0,0,0,149,0,149,"2021"
"64161","314000 MARIANA",3,3,15,838,5,864,"2021"
"64162","314010 MARILAC",0,0,1,51,2,54,"2021"
"64163","314015 MARIO CAMPOS",0,0,4,201,3,208,"2021"
"64164","314020 MARIPA DE MINAS",0,0,1,36,0,37,"2021"
"64165","314030 MARLIERIA",1,0,0,44,1,46,"2021"
"64166","314040 MARMELOPOLIS",0,0,0,28,0,28,"2021"
"64167","314050 MARTINHO CAMPOS",1,0,0,132,0,133,"2021"
"64168","314053 MARTINS SOARES",0,0,0,160,1,161,"2021"
"64169","314055 MATA VERDE",2,0,3,93,0,98,"2021"
"64170","314060 MATERLANDIA",0,1,0,53,0,54,"2021"
"64171","314070 MATEUS LEME",1,0,11,445,1,458,"2021"
"64172","314080 MATIAS BARBOSA",0,0,5,129,1,135,"2021"
"64173","314085 MATIAS CARDOSO",0,1,3,108,30,142,"2021"
"64174","314090 MATIPO",0,0,4,252,7,263,"2021"
"64175","314100 MATO VERDE",1,1,1,39,107,149,"2021"
"64176","314110 MATOZINHOS",0,1,5,433,4,443,"2021"
"64177","314120 MATUTINA",0,0,0,27,1,28,"2021"
"64178","314130 MEDEIROS",0,0,1,40,0,41,"2021"
"64179","314140 MEDINA",0,1,3,282,1,287,"2021"
"64180","314150 MENDES PIMENTEL",0,0,1,57,1,59,"2021"
"64181","314160 MERCES",0,0,3,85,1,89,"2021"
"64182","314170 MESQUITA",1,1,1,48,1,52,"2021"
"64183","314180 MINAS NOVAS",2,4,3,268,1,278,"2021"
"64184","314190 MINDURI",0,1,0,35,0,36,"2021"
"64185","314200 MIRABELA",0,1,1,148,0,150,"2021"
"64186","314210 MIRADOURO",0,0,1,79,0,80,"2021"
"64187","314220 MIRAI",0,0,3,138,0,141,"2021"
"64188","314225 MIRAVANIA",1,0,0,7,42,50,"2021"
"64189","314230 MOEDA",1,0,0,72,0,73,"2021"
"64190","314240 MOEMA",0,0,3,97,0,100,"2021"
"64191","314250 MONJOLOS",0,0,0,17,0,17,"2021"
"64192","314260 MONSENHOR PAULO",0,0,0,88,0,88,"2021"
"64193","314270 MONTALVANIA",2,0,1,56,137,196,"2021"
"64194","314280 MONTE ALEGRE DE MINAS",0,1,0,199,29,229,"2021"
"64195","314290 MONTE AZUL",1,0,2,22,175,200,"2021"
"64196","314300 MONTE BELO",0,0,0,115,0,115,"2021"
"64197","314310 MONTE CARMELO",3,0,3,497,1,504,"2021"
"64198","314315 MONTE FORMOSO",0,1,0,63,0,64,"2021"
"64199","314320 MONTE SANTO DE MINAS",0,0,1,233,0,234,"2021"
"64200","314330 MONTES CLAROS",13,17,81,5702,37,5850,"2021"
"64201","314340 MONTE SIAO",0,0,1,159,3,163,"2021"
"64202","314345 MONTEZUMA",0,0,0,102,0,102,"2021"
"64203","314350 MORADA NOVA DE MINAS",0,0,2,103,0,105,"2021"
"64204","314360 MORRO DA GARCA",1,0,0,23,0,24,"2021"
"64205","314370 MORRO DO PILAR",0,0,1,24,0,25,"2021"
"64206","314380 MUNHOZ",0,0,0,67,1,68,"2021"
"64207","314390 MURIAE",2,7,30,1250,4,1293,"2021"
"64208","314400 MUTUM",0,0,5,319,0,324,"2021"
"64209","314410 MUZAMBINHO",0,0,2,238,1,241,"2021"
"64210","314420 NACIP RAYDAN",0,0,0,17,1,18,"2021"
"64211","314430 NANUQUE",1,3,16,440,3,463,"2021"
"64212","314435 NAQUE",0,1,2,119,1,123,"2021"
"64213","314437 NATALANDIA",0,0,2,39,0,41,"2021"
"64214","314440 NATERCIA",0,0,0,34,0,34,"2021"
"64215","314450 NAZARENO",0,2,0,69,0,71,"2021"
"64216","314460 NEPOMUCENO",1,0,3,235,1,240,"2021"
"64217","314465 NINHEIRA",0,0,0,114,6,120,"2021"
"64218","314467 NOVA BELEM",0,1,2,37,0,40,"2021"
"64219","314470 NOVA ERA",1,0,2,193,1,197,"2021"
"64220","314480 NOVA LIMA",1,2,24,1302,5,1334,"2021"
"64221","314490 NOVA MODICA",0,0,2,41,0,43,"2021"
"64222","314500 NOVA PONTE",0,1,2,166,2,171,"2021"
"64223","314505 NOVA PORTEIRINHA",0,0,4,105,0,109,"2021"
"64224","314510 NOVA RESENDE",1,0,0,230,0,231,"2021"
"64225","314520 NOVA SERRANA",5,10,30,1663,4,1712,"2021"
"64226","314530 NOVO CRUZEIRO",0,2,4,358,4,368,"2021"
"64227","314535 NOVO ORIENTE DE MINAS",0,1,3,133,4,141,"2021"
"64228","314537 NOVORIZONTE",0,1,0,22,44,67,"2021"
"64229","314540 OLARIA",0,0,0,23,0,23,"2021"
"64230","314545 OLHOS-D'AGUA",0,1,1,52,2,56,"2021"
"64231","314550 OLIMPIO NORONHA",0,0,0,32,0,32,"2021"
"64232","314560 OLIVEIRA",3,1,7,368,0,379,"2021"
"64233","314570 OLIVEIRA FORTES",0,0,0,18,0,18,"2021"
"64234","314580 ONCA DE PITANGUI",0,0,1,19,0,20,"2021"
"64235","314585 ORATORIOS",0,0,1,53,0,54,"2021"
"64236","314587 ORIZANIA",0,0,2,117,0,119,"2021"
"64237","314590 OURO BRANCO",1,2,5,470,0,478,"2021"
"64238","314600 OURO FINO",0,1,2,315,16,334,"2021"
"64239","314610 OURO PRETO",4,4,31,752,18,809,"2021"
"64240","314620 OURO VERDE DE MINAS",0,0,5,91,5,101,"2021"
"64241","314625 PADRE CARVALHO",0,0,0,8,56,64,"2021"
"64242","314630 PADRE PARAISO",1,4,2,231,2,240,"2021"
"64243","314640 PAINEIRAS",0,0,0,21,0,21,"2021"
"64244","314650 PAINS",0,0,1,90,0,91,"2021"
"64245","314655 PAI PEDRO",0,0,2,64,5,71,"2021"
"64246","314660 PAIVA",0,0,0,13,1,14,"2021"
"64247","314670 PALMA",0,0,0,63,0,63,"2021"
"64248","314675 PALMOPOLIS",0,0,2,61,0,63,"2021"
"64249","314690 PAPAGAIOS",0,0,4,168,2,174,"2021"
"64250","314700 PARACATU",2,3,13,1279,4,1301,"2021"
"64251","314710 PARA DE MINAS",4,3,17,1119,5,1148,"2021"
"64252","314720 PARAGUACU",0,1,3,242,2,248,"2021"
"64253","314730 PARAISOPOLIS",1,0,1,206,0,208,"2021"
"64254","314740 PARAOPEBA",1,2,3,289,2,297,"2021"
"64255","314750 PASSABEM",0,0,0,12,0,12,"2021"
"64256","314760 PASSA QUATRO",0,0,3,160,1,164,"2021"
"64257","314770 PASSA TEMPO",0,0,0,45,0,45,"2021"
"64258","314780 PASSA-VINTE",0,0,2,15,0,17,"2021"
"64259","314790 PASSOS",0,5,19,1312,1,1337,"2021"
"64260","314795 PATIS",0,0,2,44,0,46,"2021"
"64261","314800 PATOS DE MINAS",2,3,14,1688,5,1712,"2021"
"64262","314810 PATROCINIO",2,4,12,1138,1,1157,"2021"
"64263","314820 PATROCINIO DO MURIAE",0,0,0,58,0,58,"2021"
"64264","314830 PAULA CANDIDO",0,0,0,75,2,77,"2021"
"64265","314840 PAULISTAS",0,0,0,44,1,45,"2021"
"64266","314850 PAVAO",1,0,0,81,1,83,"2021"
"64267","314860 PECANHA",2,1,1,220,0,224,"2021"
"64268","314870 PEDRA AZUL",0,1,5,260,4,270,"2021"
"64269","314875 PEDRA BONITA",0,1,1,105,2,109,"2021"
"64270","314880 PEDRA DO ANTA",0,1,1,30,0,32,"2021"
"64271","314890 PEDRA DO INDAIA",0,0,0,30,1,31,"2021"
"64272","314900 PEDRA DOURADA",0,0,0,33,0,33,"2021"
"64273","314910 PEDRALVA",0,0,0,101,1,102,"2021"
"64274","314915 PEDRAS DE MARIA DA CRUZ",0,1,1,64,41,107,"2021"
"64275","314920 PEDRINOPOLIS",0,0,0,22,0,22,"2021"
"64276","314930 PEDRO LEOPOLDO",6,2,13,686,6,713,"2021"
"64277","314940 PEDRO TEIXEIRA",0,0,0,15,0,15,"2021"
"64278","314950 PEQUERI",0,1,0,26,0,27,"2021"
"64279","314960 PEQUI",0,0,0,41,0,41,"2021"
"64280","314970 PERDIGAO",1,0,5,166,1,173,"2021"
"64281","314980 PERDIZES",2,1,1,213,2,219,"2021"
"64282","314990 PERDOES",2,0,1,187,0,190,"2021"
"64283","314995 PERIQUITO",1,0,1,93,1,96,"2021"
"64284","315000 PESCADOR",0,1,1,37,0,39,"2021"
"64285","315010 PIAU",0,0,0,20,0,20,"2021"
"64286","315015 PIEDADE DE CARATINGA",0,0,0,166,1,167,"2021"
"64287","315020 PIEDADE DE PONTE NOVA",0,0,0,50,1,51,"2021"
"64288","315030 PIEDADE DO RIO GRANDE",0,0,0,43,1,44,"2021"
"64289","315040 PIEDADE DOS GERAIS",0,0,0,46,2,48,"2021"
"64290","315050 PIMENTA",0,1,1,73,0,75,"2021"
"64291","315053 PINGO-D'AGUA",0,0,0,54,0,54,"2021"
"64292","315057 PINTOPOLIS",0,0,1,91,5,97,"2021"
"64293","315060 PIRACEMA",0,0,0,58,0,58,"2021"
"64294","315070 PIRAJUBA",0,1,2,77,0,80,"2021"
"64295","315080 PIRANGA",0,0,5,138,0,143,"2021"
"64296","315090 PIRANGUCU",0,0,1,55,0,56,"2021"
"64297","315100 PIRANGUINHO",0,1,0,118,0,119,"2021"
"64298","315110 PIRAPETINGA",0,1,0,139,0,140,"2021"
"64299","315120 PIRAPORA",2,2,8,702,7,721,"2021"
"64300","315130 PIRAUBA",0,0,1,114,1,116,"2021"
"64301","315140 PITANGUI",0,1,4,305,8,318,"2021"
"64302","315150 PIUMHI",0,1,3,375,1,380,"2021"
"64303","315160 PLANURA",0,0,1,124,0,125,"2021"
"64304","315170 POCO FUNDO",2,1,0,135,1,139,"2021"
"64305","315180 POCOS DE CALDAS",4,8,34,1717,2,1765,"2021"
"64306","315190 POCRANE",1,0,2,101,2,106,"2021"
"64307","315200 POMPEU",0,2,5,406,1,414,"2021"
"64308","315210 PONTE NOVA",2,3,6,698,3,712,"2021"
"64309","315213 PONTO CHIQUE",0,0,4,61,1,66,"2021"
"64310","315217 PONTO DOS VOLANTES",0,2,1,145,0,148,"2021"
"64311","315220 PORTEIRINHA",1,0,6,446,1,454,"2021"
"64312","315230 PORTO FIRME",0,0,1,92,0,93,"2021"
"64313","315240 POTE",0,0,3,173,3,179,"2021"
"64314","315250 POUSO ALEGRE",6,2,13,1928,10,1959,"2021"
"64315","315260 POUSO ALTO",0,0,1,57,0,58,"2021"
"64316","315270 PRADOS",0,0,0,84,1,85,"2021"
"64317","315280 PRATA",0,2,4,352,0,358,"2021"
"64318","315290 PRATAPOLIS",1,0,6,77,0,84,"2021"
"64319","315300 PRATINHA",0,0,1,45,0,46,"2021"
"64320","315310 PRESIDENTE BERNARDES",0,0,1,33,0,34,"2021"
"64321","315320 PRESIDENTE JUSCELINO",0,0,0,35,1,36,"2021"
"64322","315330 PRESIDENTE KUBITSCHEK",0,0,0,36,0,36,"2021"
"64323","315340 PRESIDENTE OLEGARIO",1,1,1,185,1,189,"2021"
"64324","315350 ALTO JEQUITIBA",0,2,1,106,3,112,"2021"
"64325","315360 PRUDENTE DE MORAIS",0,0,2,150,1,153,"2021"
"64326","315370 QUARTEL GERAL",0,1,0,25,0,26,"2021"
"64327","315380 QUELUZITO",0,0,0,16,0,16,"2021"
"64328","315390 RAPOSOS",0,1,2,180,0,183,"2021"
"64329","315400 RAUL SOARES",0,1,2,231,0,234,"2021"
"64330","315410 RECREIO",0,0,1,77,0,78,"2021"
"64331","315415 REDUTO",0,1,4,108,1,114,"2021"
"64332","315420 RESENDE COSTA",0,1,0,114,0,115,"2021"
"64333","315430 RESPLENDOR",3,0,5,210,1,219,"2021"
"64334","315440 RESSAQUINHA",0,0,0,40,2,42,"2021"
"64335","315445 RIACHINHO",1,0,0,79,2,82,"2021"
"64336","315450 RIACHO DOS MACHADOS",1,0,3,112,1,117,"2021"
"64337","315460 RIBEIRAO DAS NEVES",13,21,73,4155,32,4294,"2021"
"64338","315470 RIBEIRAO VERMELHO",0,0,0,37,0,37,"2021"
"64339","315480 RIO ACIMA",0,0,1,112,0,113,"2021"
"64340","315490 RIO CASCA",0,0,1,111,4,116,"2021"
"64341","315500 RIO DOCE",1,0,0,27,0,28,"2021"
"64342","315510 RIO DO PRADO",0,0,1,41,0,42,"2021"
"64343","315520 RIO ESPERA",0,0,1,39,1,41,"2021"
"64344","315530 RIO MANSO",0,0,1,39,0,40,"2021"
"64345","315540 RIO NOVO",0,0,1,82,2,85,"2021"
"64346","315550 RIO PARANAIBA",1,0,5,165,1,172,"2021"
"64347","315560 RIO PARDO DE MINAS",3,0,4,375,1,383,"2021"
"64348","315570 RIO PIRACICABA",0,1,0,120,0,121,"2021"
"64349","315580 RIO POMBA",0,0,2,198,0,200,"2021"
"64350","315590 RIO PRETO",0,0,1,52,1,54,"2021"
"64351","315600 RIO VERMELHO",0,0,6,96,0,102,"2021"
"64352","315610 RITAPOLIS",0,0,0,29,0,29,"2021"
"64353","315620 ROCHEDO DE MINAS",0,0,0,18,0,18,"2021"
"64354","315630 RODEIRO",0,0,3,108,2,113,"2021"
"64355","315640 ROMARIA",0,0,0,37,0,37,"2021"
"64356","315645 ROSARIO DA LIMEIRA",0,0,1,48,0,49,"2021"
"64357","315650 RUBELITA",0,0,1,9,43,53,"2021"
"64358","315660 RUBIM",1,0,2,73,0,76,"2021"
"64359","315670 SABARA",2,5,30,1470,11,1518,"2021"
"64360","315680 SABINOPOLIS",0,0,4,164,5,173,"2021"
"64361","315690 SACRAMENTO",1,1,3,296,2,303,"2021"
"64362","315700 SALINAS",1,1,3,121,370,496,"2021"
"64363","315710 SALTO DA DIVISA",0,1,3,60,0,64,"2021"
"64364","315720 SANTA BARBARA",2,2,0,366,6,376,"2021"
"64365","315725 SANTA BARBARA DO LESTE",0,0,1,94,0,95,"2021"
"64366","315727 SANTA BARBARA DO MONTE VERDE",0,0,0,23,0,23,"2021"
"64367","315730 SANTA BARBARA DO TUGURIO",0,0,2,29,0,31,"2021"
"64368","315733 SANTA CRUZ DE MINAS",0,0,0,88,0,88,"2021"
"64369","315737 SANTA CRUZ DE SALINAS",0,0,0,6,39,45,"2021"
"64370","315740 SANTA CRUZ DO ESCALVADO",0,0,0,43,2,45,"2021"
"64371","315750 SANTA EFIGENIA DE MINAS",0,0,0,54,3,57,"2021"
"64372","315760 SANTA FE DE MINAS",0,0,0,40,2,42,"2021"
"64373","315765 SANTA HELENA DE MINAS",0,0,4,91,10,105,"2021"
"64374","315770 SANTA JULIANA",2,1,6,210,1,220,"2021"
"64375","315780 SANTA LUZIA",17,11,44,2721,26,2819,"2021"
"64376","315790 SANTA MARGARIDA",0,1,3,261,0,265,"2021"
"64377","315800 SANTA MARIA DE ITABIRA",3,0,4,129,0,136,"2021"
"64378","315810 SANTA MARIA DO SALTO",0,0,2,50,0,52,"2021"
"64379","315820 SANTA MARIA DO SUACUI",0,1,0,170,1,172,"2021"
"64380","315830 SANTANA DA VARGEM",0,0,0,67,0,67,"2021"
"64381","315840 SANTANA DE CATAGUASES",0,0,1,27,0,28,"2021"
"64382","315850 SANTANA DE PIRAPAMA",0,0,0,61,1,62,"2021"
"64383","315860 SANTANA DO DESERTO",0,1,0,35,0,36,"2021"
"64384","315870 SANTANA DO GARAMBEU",0,0,0,16,0,16,"2021"
"64385","315880 SANTANA DO JACARE",0,0,0,53,0,53,"2021"
"64386","315890 SANTANA DO MANHUACU",0,0,2,153,0,155,"2021"
"64387","315895 SANTANA DO PARAISO",4,5,10,735,3,757,"2021"
"64388","315900 SANTANA DO RIACHO",0,0,0,65,0,65,"2021"
"64389","315910 SANTANA DOS MONTES",0,0,0,27,0,27,"2021"
"64390","315920 SANTA RITA DE CALDAS",0,0,1,49,0,50,"2021"
"64391","315930 SANTA RITA DE JACUTINGA",0,0,0,47,0,47,"2021"
"64392","315935 SANTA RITA DE MINAS",0,0,2,102,1,105,"2021"
"64393","315940 SANTA RITA DE IBITIPOCA",0,1,0,34,0,35,"2021"
"64394","315950 SANTA RITA DO ITUETO",0,0,0,93,0,93,"2021"
"64395","315960 SANTA RITA DO SAPUCAI",0,0,10,463,5,478,"2021"
"64396","315970 SANTA ROSA DA SERRA",0,0,0,48,0,48,"2021"
"64397","315980 SANTA VITORIA",0,1,1,245,0,247,"2021"
"64398","315990 SANTO ANTONIO DO AMPARO",0,0,0,171,5,176,"2021"
"64399","316000 SANTO ANTONIO DO AVENTUREIRO",0,0,0,38,1,39,"2021"
"64400","316010 SANTO ANTONIO DO GRAMA",0,0,0,43,2,45,"2021"
"64401","316020 SANTO ANTONIO DO ITAMBE",1,0,0,43,0,44,"2021"
"64402","316030 SANTO ANTONIO DO JACINTO",2,1,8,99,1,111,"2021"
"64403","316040 SANTO ANTONIO DO MONTE",0,3,88,279,0,370,"2021"
"64404","316045 SANTO ANTONIO DO RETIRO",0,0,0,64,15,79,"2021"
"64405","316050 SANTO ANTONIO DO RIO ABAIXO",0,0,0,19,1,20,"2021"
"64406","316060 SANTO HIPOLITO",1,0,0,22,0,23,"2021"
"64407","316070 SANTOS DUMONT",1,2,7,409,6,425,"2021"
"64408","316080 SAO BENTO ABADE",0,0,0,73,0,73,"2021"
"64409","316090 SAO BRAS DO SUACUI",0,0,2,36,0,38,"2021"
"64410","316095 SAO DOMINGOS DAS DORES",0,0,0,86,0,86,"2021"
"64411","316100 SAO DOMINGOS DO PRATA",0,0,2,162,1,165,"2021"
"64412","316105 SAO FELIX DE MINAS",0,0,1,37,0,38,"2021"
"64413","316110 SAO FRANCISCO",0,5,10,731,5,751,"2021"
"64414","316120 SAO FRANCISCO DE PAULA",0,0,0,54,0,54,"2021"
"64415","316130 SAO FRANCISCO DE SALES",0,0,0,47,0,47,"2021"
"64416","316140 SAO FRANCISCO DO GLORIA",0,0,0,43,0,43,"2021"
"64417","316150 SAO GERALDO",1,0,1,108,1,111,"2021"
"64418","316160 SAO GERALDO DA PIEDADE",0,1,0,37,1,39,"2021"
"64419","316165 SAO GERALDO DO BAIXIO",0,0,0,36,0,36,"2021"
"64420","316170 SAO GONCALO DO ABAETE",1,0,0,60,0,61,"2021"
"64421","316180 SAO GONCALO DO PARA",0,1,1,145,1,148,"2021"
"64422","316190 SAO GONCALO DO RIO ABAIXO",1,3,2,124,3,133,"2021"
"64423","316200 SAO GONCALO DO SAPUCAI",0,0,6,312,0,318,"2021"
"64424","316210 SAO GOTARDO",3,2,2,699,1,707,"2021"
"64425","316220 SAO JOAO BATISTA DO GLORIA",1,0,3,85,0,89,"2021"
"64426","316225 SAO JOAO DA LAGOA",0,0,0,60,0,60,"2021"
"64427","316230 SAO JOAO DA MATA",0,0,1,32,0,33,"2021"
"64428","316240 SAO JOAO DA PONTE",1,2,8,267,0,278,"2021"
"64429","316245 SAO JOAO DAS MISSOES",4,0,0,100,165,269,"2021"
"64430","316250 SAO JOAO DEL REI",0,2,6,896,2,906,"2021"
"64431","316255 SAO JOAO DO MANHUACU",1,0,0,161,0,162,"2021"
"64432","316257 SAO JOAO DO MANTENINHA",1,0,4,62,0,67,"2021"
"64433","316260 SAO JOAO DO ORIENTE",0,2,0,80,1,83,"2021"
"64434","316265 SAO JOAO DO PACUI",0,0,0,32,0,32,"2021"
"64435","316270 SAO JOAO DO PARAISO",1,0,1,232,13,247,"2021"
"64436","316280 SAO JOAO EVANGELISTA",0,1,1,197,4,203,"2021"
"64437","316290 SAO JOAO NEPOMUCENO",0,1,5,272,2,280,"2021"
"64438","316292 SAO JOAQUIM DE BICAS",1,3,11,417,4,436,"2021"
"64439","316294 SAO JOSE DA BARRA",0,0,1,91,0,92,"2021"
"64440","316295 SAO JOSE DA LAPA",2,3,3,319,4,331,"2021"
"64441","316300 SAO JOSE DA SAFIRA",0,0,1,70,4,75,"2021"
"64442","316310 SAO JOSE DA VARGINHA",0,0,0,36,0,36,"2021"
"64443","316320 SAO JOSE DO ALEGRE",0,0,0,61,0,61,"2021"
"64444","316330 SAO JOSE DO DIVINO",0,0,1,42,0,43,"2021"
"64445","316340 SAO JOSE DO GOIABAL",0,0,0,49,1,50,"2021"
"64446","316350 SAO JOSE DO JACURI",0,0,0,94,0,94,"2021"
"64447","316360 SAO JOSE DO MANTIMENTO",0,0,1,36,0,37,"2021"
"64448","316370 SAO LOURENCO",0,1,10,509,1,521,"2021"
"64449","316380 SAO MIGUEL DO ANTA",0,1,0,56,2,59,"2021"
"64450","316390 SAO PEDRO DA UNIAO",0,0,0,51,0,51,"2021"
"64451","316400 SAO PEDRO DOS FERROS",0,1,0,64,0,65,"2021"
"64452","316410 SAO PEDRO DO SUACUI",0,0,0,40,0,40,"2021"
"64453","316420 SAO ROMAO",0,0,1,92,0,93,"2021"
"64454","316430 SAO ROQUE DE MINAS",1,0,2,86,0,89,"2021"
"64455","316440 SAO SEBASTIAO DA BELA VISTA",0,0,2,89,0,91,"2021"
"64456","316443 SAO SEBASTIAO DA VARGEM ALEGRE",0,0,0,30,0,30,"2021"
"64457","316447 SAO SEBASTIAO DO ANTA",2,0,0,94,0,96,"2021"
"64458","316450 SAO SEBASTIAO DO MARANHAO",0,1,3,98,0,102,"2021"
"64459","316460 SAO SEBASTIAO DO OESTE",2,1,0,146,2,151,"2021"
"64460","316470 SAO SEBASTIAO DO PARAISO",1,0,7,787,2,797,"2021"
"64461","316480 SAO SEBASTIAO DO RIO PRETO",0,0,0,16,0,16,"2021"
"64462","316490 SAO SEBASTIAO DO RIO VERDE",0,0,1,20,0,21,"2021"
"64463","316500 SAO TIAGO",2,0,0,111,1,114,"2021"
"64464","316510 SAO TOMAS DE AQUINO",0,0,1,83,0,84,"2021"
"64465","316520 SAO THOME DAS LETRAS",0,0,0,61,0,61,"2021"
"64466","316530 SAO VICENTE DE MINAS",0,0,1,83,0,84,"2021"
"64467","316540 SAPUCAI-MIRIM",0,0,2,71,0,73,"2021"
"64468","316550 SARDOA",0,0,2,73,2,77,"2021"
"64469","316553 SARZEDO",2,2,10,464,2,480,"2021"
"64470","316555 SETUBINHA",0,2,1,142,6,151,"2021"
"64471","316556 SEM-PEIXE",0,0,0,16,1,17,"2021"
"64472","316557 SENADOR AMARAL",0,1,1,121,1,124,"2021"
"64473","316560 SENADOR CORTES",0,0,1,24,2,27,"2021"
"64474","316570 SENADOR FIRMINO",0,0,0,68,0,68,"2021"
"64475","316580 SENADOR JOSE BENTO",0,0,0,18,1,19,"2021"
"64476","316590 SENADOR MODESTINO GONCALVES",0,0,1,29,0,30,"2021"
"64477","316600 SENHORA DE OLIVEIRA",0,0,0,44,0,44,"2021"
"64478","316610 SENHORA DO PORTO",0,0,0,25,0,25,"2021"
"64479","316620 SENHORA DOS REMEDIOS",0,1,1,97,1,100,"2021"
"64480","316630 SERICITA",0,0,0,117,3,120,"2021"
"64481","316640 SERITINGA",0,0,1,18,0,19,"2021"
"64482","316650 SERRA AZUL DE MINAS",2,1,1,52,2,58,"2021"
"64483","316660 SERRA DA SAUDADE",0,0,0,5,0,5,"2021"
"64484","316670 SERRA DOS AIMORES",1,1,4,100,0,106,"2021"
"64485","316680 SERRA DO SALITRE",1,1,2,181,2,187,"2021"
"64486","316690 SERRANIA",0,0,0,86,0,86,"2021"
"64487","316695 SERRANOPOLIS DE MINAS",0,0,1,36,0,37,"2021"
"64488","316700 SERRANOS",0,0,0,26,0,26,"2021"
"64489","316710 SERRO",0,1,3,238,3,245,"2021"
"64490","316720 SETE LAGOAS",11,8,17,2581,8,2625,"2021"
"64491","316730 SILVEIRANIA",0,0,0,31,0,31,"2021"
"64492","316740 SILVIANOPOLIS",0,0,0,45,0,45,"2021"
"64493","316750 SIMAO PEREIRA",0,1,3,28,0,32,"2021"
"64494","316760 SIMONESIA",1,1,4,276,1,283,"2021"
"64495","316770 SOBRALIA",0,0,1,60,2,63,"2021"
"64496","316780 SOLEDADE DE MINAS",0,1,3,52,1,57,"2021"
"64497","316790 TABULEIRO",0,0,0,37,0,37,"2021"
"64498","316800 TAIOBEIRAS",0,0,2,464,1,467,"2021"
"64499","316805 TAPARUBA",0,0,0,43,1,44,"2021"
"64500","316810 TAPIRA",0,0,1,55,0,56,"2021"
"64501","316820 TAPIRAI",0,0,0,11,0,11,"2021"
"64502","316830 TAQUARACU DE MINAS",0,0,1,29,0,30,"2021"
"64503","316840 TARUMIRIM",0,1,2,146,3,152,"2021"
"64504","316850 TEIXEIRAS",1,0,1,105,0,107,"2021"
"64505","316860 TEOFILO OTONI",4,7,26,1762,17,1816,"2021"
"64506","316870 TIMOTEO",4,3,6,842,9,864,"2021"
"64507","316880 TIRADENTES",0,0,1,85,0,86,"2021"
"64508","316890 TIROS",0,0,0,96,1,97,"2021"
"64509","316900 TOCANTINS",0,0,0,141,2,143,"2021"
"64510","316905 TOCOS DO MOJI",0,0,0,28,0,28,"2021"
"64511","316910 TOLEDO",0,0,0,69,0,69,"2021"
"64512","316920 TOMBOS",0,0,0,83,0,83,"2021"
"64513","316930 TRES CORACOES",3,3,10,921,0,937,"2021"
"64514","316935 TRES MARIAS",1,1,2,351,0,355,"2021"
"64515","316940 TRES PONTAS",0,4,13,698,2,717,"2021"
"64516","316950 TUMIRITINGA",1,0,2,67,2,72,"2021"
"64517","316960 TUPACIGUARA",0,0,2,222,5,229,"2021"
"64518","316970 TURMALINA",1,0,1,237,1,240,"2021"
"64519","316980 TURVOLANDIA",0,0,0,68,0,68,"2021"
"64520","316990 UBA",2,5,16,1185,7,1215,"2021"
"64521","317000 UBAI",1,0,0,174,1,176,"2021"
"64522","317005 UBAPORANGA",0,0,0,139,0,139,"2021"
"64523","317010 UBERABA",59,14,50,3663,3,3789,"2021"
"64524","317020 UBERLANDIA",32,22,85,8362,58,8559,"2021"
"64525","317030 UMBURATIBA",0,1,3,36,0,40,"2021"
"64526","317040 UNAI",1,3,14,1169,5,1192,"2021"
"64527","317043 UNIAO DE MINAS",0,0,0,30,1,31,"2021"
"64528","317047 URUANA DE MINAS",0,0,0,32,0,32,"2021"
"64529","317050 URUCANIA",0,1,0,140,1,142,"2021"
"64530","317052 URUCUIA",0,0,5,101,0,106,"2021"
"64531","317057 VARGEM ALEGRE",0,1,0,70,0,71,"2021"
"64532","317060 VARGEM BONITA",0,0,0,27,0,27,"2021"
"64533","317065 VARGEM GRANDE DO RIO PARDO",0,0,0,55,0,55,"2021"
"64534","317070 VARGINHA",1,4,24,1659,5,1693,"2021"
"64535","317075 VARJAO DE MINAS",0,0,0,99,0,99,"2021"
"64536","317080 VARZEA DA PALMA",1,1,5,425,6,438,"2021"
"64537","317090 VARZELANDIA",3,2,5,263,4,277,"2021"
"64538","317100 VAZANTE",2,2,1,230,0,235,"2021"
"64539","317103 VERDELANDIA",0,0,3,116,2,121,"2021"
"64540","317107 VEREDINHA",0,0,0,69,0,69,"2021"
"64541","317110 VERISSIMO",0,1,0,36,0,37,"2021"
"64542","317115 VERMELHO NOVO",0,0,0,47,1,48,"2021"
"64543","317120 VESPASIANO",4,10,22,1637,12,1685,"2021"
"64544","317130 VICOSA",1,2,13,904,6,926,"2021"
"64545","317140 VIEIRAS",0,0,1,27,1,29,"2021"
"64546","317150 MATHIAS LOBATO",1,1,0,41,1,44,"2021"
"64547","317160 VIRGEM DA LAPA",0,0,0,117,5,122,"2021"
"64548","317170 VIRGINIA",0,0,1,93,0,94,"2021"
"64549","317180 VIRGINOPOLIS",0,0,0,129,0,129,"2021"
"64550","317190 VIRGOLANDIA",0,0,0,53,0,53,"2021"
"64551","317200 VISCONDE DO RIO BRANCO",0,2,1,465,1,469,"2021"
"64552","317210 VOLTA GRANDE",0,0,0,40,0,40,"2021"
"64553","317220 WENCESLAU BRAZ",0,0,1,26,0,27,"2021"
"64554","MUNICIPIO IGNORADO - ES",0,0,0,1,0,1,"2021"
"64555","320010 AFONSO CLAUDIO",2,7,8,403,1,421,"2021"
"64556","320013 AGUIA BRANCA",0,1,0,118,1,120,"2021"
"64557","320016 AGUA DOCE DO NORTE",1,0,3,154,2,160,"2021"
"64558","320020 ALEGRE",0,1,5,341,0,347,"2021"
"64559","320030 ALFREDO CHAVES",0,1,6,132,0,139,"2021"
"64560","320035 ALTO RIO NOVO",0,1,1,98,1,101,"2021"
"64561","320040 ANCHIETA",1,0,6,380,2,389,"2021"
"64562","320050 APIACA",1,0,1,73,0,75,"2021"
"64563","320060 ARACRUZ",2,2,13,1432,2,1451,"2021"
"64564","320070 ATILIO VIVACQUA",0,1,2,141,1,145,"2021"
"64565","320080 BAIXO GUANDU",0,2,11,366,1,380,"2021"
"64566","320090 BARRA DE SAO FRANCISCO",4,2,5,623,1,635,"2021"
"64567","320100 BOA ESPERANCA",0,2,5,159,0,166,"2021"
"64568","320110 BOM JESUS DO NORTE",0,1,1,107,0,109,"2021"
"64569","320115 BREJETUBA",1,1,2,196,4,204,"2021"
"64570","320120 CACHOEIRO DE ITAPEMIRIM",0,7,37,2502,4,2550,"2021"
"64571","320130 CARIACICA",12,6,71,5112,62,5263,"2021"
"64572","320140 CASTELO",1,0,6,400,0,407,"2021"
"64573","320150 COLATINA",4,7,20,1460,0,1491,"2021"
"64574","320160 CONCEICAO DA BARRA",1,0,3,379,7,390,"2021"
"64575","320170 CONCEICAO DO CASTELO",1,0,5,171,1,178,"2021"
"64576","320180 DIVINO DE SAO LOURENCO",0,1,2,56,0,59,"2021"
"64577","320190 DOMINGOS MARTINS",0,1,5,437,1,444,"2021"
"64578","320200 DORES DO RIO PRETO",0,0,2,84,0,86,"2021"
"64579","320210 ECOPORANGA",1,0,3,263,1,268,"2021"
"64580","320220 FUNDAO",0,1,0,270,0,271,"2021"
"64581","320225 GOVERNADOR LINDENBERG",0,1,0,126,1,128,"2021"
"64582","320230 GUACUI",2,1,6,421,1,431,"2021"
"64583","320240 GUARAPARI",1,7,24,1774,14,1820,"2021"
"64584","320245 IBATIBA",0,0,7,353,8,368,"2021"
"64585","320250 IBIRACU",1,1,1,144,0,147,"2021"
"64586","320255 IBITIRAMA",0,0,2,128,0,130,"2021"
"64587","320260 ICONHA",0,0,1,117,0,118,"2021"
"64588","320265 IRUPI",2,0,1,176,0,179,"2021"
"64589","320270 ITAGUACU",0,0,3,137,2,142,"2021"
"64590","320280 ITAPEMIRIM",1,1,7,543,4,556,"2021"
"64591","320290 ITARANA",0,1,2,100,1,104,"2021"
"64592","320300 IUNA",1,2,4,437,2,446,"2021"
"64593","320305 JAGUARE",0,3,7,447,0,457,"2021"
"64594","320310 JERONIMO MONTEIRO",0,0,4,146,0,150,"2021"
"64595","320313 JOAO NEIVA",0,1,3,166,0,170,"2021"
"64596","320316 LARANJA DA TERRA",0,0,2,92,2,96,"2021"
"64597","320320 LINHARES",8,10,23,2571,0,2612,"2021"
"64598","320330 MANTENOPOLIS",0,0,1,173,0,174,"2021"
"64599","320332 MARATAIZES",1,1,9,528,0,539,"2021"
"64600","320334 MARECHAL FLORIANO",0,4,3,240,2,249,"2021"
"64601","320335 MARILANDIA",1,1,2,141,1,146,"2021"
"64602","320340 MIMOSO DO SUL",0,0,2,304,1,307,"2021"
"64603","320350 MONTANHA",2,2,6,242,2,254,"2021"
"64604","320360 MUCURICI",0,0,2,83,2,87,"2021"
"64605","320370 MUNIZ FREIRE",0,0,2,196,1,199,"2021"
"64606","320380 MUQUI",0,1,3,174,1,179,"2021"
"64607","320390 NOVA VENECIA",2,3,16,634,0,655,"2021"
"64608","320400 PANCAS",1,2,3,215,4,225,"2021"
"64609","320405 PEDRO CANARIO",1,3,3,383,5,395,"2021"
"64610","320410 PINHEIROS",1,0,3,331,10,345,"2021"
"64611","320420 PIUMA",0,1,3,309,0,313,"2021"
"64612","320425 PONTO BELO",0,2,4,88,0,94,"2021"
"64613","320430 PRESIDENTE KENNEDY",0,0,6,196,1,203,"2021"
"64614","320435 RIO BANANAL",2,0,3,284,0,289,"2021"
"64615","320440 RIO NOVO DO SUL",0,0,0,116,0,116,"2021"
"64616","320450 SANTA LEOPOLDINA",0,0,4,113,0,117,"2021"
"64617","320455 SANTA MARIA DE JETIBA",1,1,7,704,2,715,"2021"
"64618","320460 SANTA TERESA",1,1,3,306,2,313,"2021"
"64619","320465 SAO DOMINGOS DO NORTE",0,1,0,104,0,105,"2021"
"64620","320470 SAO GABRIEL DA PALHA",2,2,7,378,1,390,"2021"
"64621","320480 SAO JOSE DO CALCADO",0,1,1,134,0,136,"2021"
"64622","320490 SAO MATEUS",2,3,21,1826,6,1858,"2021"
"64623","320495 SAO ROQUE DO CANAA",1,2,1,110,0,114,"2021"
"64624","320500 SERRA",9,18,101,7244,55,7427,"2021"
"64625","320501 SOORETAMA",3,2,6,444,0,455,"2021"
"64626","320503 VARGEM ALTA",0,0,3,241,2,246,"2021"
"64627","320506 VENDA NOVA DO IMIGRANTE",2,1,5,329,1,338,"2021"
"64628","320510 VIANA",1,3,12,980,12,1008,"2021"
"64629","320515 VILA PAVAO",1,0,0,101,2,104,"2021"
"64630","320517 VILA VALERIO",1,1,0,207,2,211,"2021"
"64631","320520 VILA VELHA",7,14,62,5810,41,5934,"2021"
"64632","320530 VITORIA",6,8,44,3863,28,3949,"2021"
"64633","MUNICIPIO IGNORADO - RJ",0,0,0,10,2,12,"2021"
"64634","330010 ANGRA DOS REIS",3,7,50,2062,24,2146,"2021"
"64635","330015 APERIBE",0,0,3,123,0,126,"2021"
"64636","330020 ARARUAMA",2,14,42,1580,19,1657,"2021"
"64637","330022 AREAL",1,0,2,132,0,135,"2021"
"64638","330023 ARMACAO DOS BUZIOS",3,5,16,636,5,665,"2021"
"64639","330025 ARRAIAL DO CABO",3,2,5,390,4,404,"2021"
"64640","330030 BARRA DO PIRAI",8,3,23,992,1,1027,"2021"
"64641","330040 BARRA MANSA",2,8,32,1794,2,1838,"2021"
"64642","330045 BELFORD ROXO",15,24,122,5911,92,6164,"2021"
"64643","330050 BOM JARDIM",4,2,4,305,0,315,"2021"
"64644","330060 BOM JESUS DO ITABAPOANA",2,2,0,486,2,492,"2021"
"64645","330070 CABO FRIO",10,10,49,2464,21,2554,"2021"
"64646","330080 CACHOEIRAS DE MACACU",2,5,10,623,4,644,"2021"
"64647","330090 CAMBUCI",2,1,4,122,0,129,"2021"
"64648","330093 CARAPEBUS",2,0,1,120,0,123,"2021"
"64649","330095 COMENDADOR LEVY GASPARIAN",0,2,1,110,0,113,"2021"
"64650","330100 CAMPOS DOS GOYTACAZES",19,31,94,6585,47,6776,"2021"
"64651","330110 CANTAGALO",1,1,1,209,0,212,"2021"
"64652","330115 CARDOSO MOREIRA",0,1,3,126,3,133,"2021"
"64653","330120 CARMO",0,1,0,194,1,196,"2021"
"64654","330130 CASIMIRO DE ABREU",1,1,3,547,1,553,"2021"
"64655","330140 CONCEICAO DE MACABU",2,2,6,247,0,257,"2021"
"64656","330150 CORDEIRO",2,0,4,220,0,226,"2021"
"64657","330160 DUAS BARRAS",0,0,1,60,5,66,"2021"
"64658","330170 DUQUE DE CAXIAS",28,47,210,10881,149,11315,"2021"
"64659","330180 ENGENHEIRO PAULO DE FRONTIN",1,0,3,109,1,114,"2021"
"64660","330185 GUAPIMIRIM",0,6,6,660,7,679,"2021"
"64661","330187 IGUABA GRANDE",0,0,2,305,5,312,"2021"
"64662","330190 ITABORAI",8,5,40,2634,15,2702,"2021"
"64663","330200 ITAGUAI",2,7,13,1543,11,1576,"2021"
"64664","330205 ITALVA",0,2,1,180,0,183,"2021"
"64665","330210 ITAOCARA",0,2,4,218,1,225,"2021"
"64666","330220 ITAPERUNA",3,6,35,1063,1,1108,"2021"
"64667","330225 ITATIAIA",0,2,5,335,0,342,"2021"
"64668","330227 JAPERI",4,8,25,1203,22,1262,"2021"
"64669","330230 LAJE DO MURIAE",1,0,2,90,0,93,"2021"
"64670","330240 MACAE",8,16,50,3312,24,3410,"2021"
"64671","330245 MACUCO",0,0,2,77,0,79,"2021"
"64672","330250 MAGE",7,18,63,3165,10,3263,"2021"
"64673","330260 MANGARATIBA",2,2,2,475,1,482,"2021"
"64674","330270 MARICA",13,6,30,1915,67,2031,"2021"
"64675","330280 MENDES",1,2,6,158,0,167,"2021"
"64676","330285 MESQUITA",5,12,31,1961,28,2037,"2021"
"64677","330290 MIGUEL PEREIRA",0,2,11,271,1,285,"2021"
"64678","330300 MIRACEMA",0,2,2,333,0,337,"2021"
"64679","330310 NATIVIDADE",0,0,2,167,0,169,"2021"
"64680","330320 NILOPOLIS",2,11,24,1376,15,1428,"2021"
"64681","330330 NITEROI",11,18,71,5243,20,5363,"2021"
"64682","330340 NOVA FRIBURGO",2,5,26,1897,15,1945,"2021"
"64683","330350 NOVA IGUACU",26,51,212,10119,122,10530,"2021"
"64684","330360 PARACAMBI",2,1,5,507,5,520,"2021"
"64685","330370 PARAIBA DO SUL",1,3,7,483,2,496,"2021"
"64686","330380 PARATY",6,0,7,547,5,565,"2021"
"64687","330385 PATY DO ALFERES",0,4,9,345,1,359,"2021"
"64688","330390 PETROPOLIS",7,15,50,3179,41,3292,"2021"
"64689","330395 PINHEIRAL",0,2,4,292,2,300,"2021"
"64690","330400 PIRAI",2,1,6,312,0,321,"2021"
"64691","330410 PORCIUNCULA",2,1,3,189,2,197,"2021"
"64692","330411 PORTO REAL",1,1,2,260,1,265,"2021"
"64693","330412 QUATIS",0,0,1,136,1,138,"2021"
"64694","330414 QUEIMADOS",4,12,43,1937,14,2010,"2021"
"64695","330415 QUISSAMA",1,1,8,301,2,313,"2021"
"64696","330420 RESENDE",1,1,18,1574,0,1594,"2021"
"64697","330430 RIO BONITO",1,3,13,658,6,681,"2021"
"64698","330440 RIO CLARO",0,2,3,186,2,193,"2021"
"64699","330450 RIO DAS FLORES",0,3,1,105,2,111,"2021"
"64700","330452 RIO DAS OSTRAS",5,14,32,1788,12,1851,"2021"
"64701","330455 RIO DE JANEIRO",168,309,1267,66427,703,68874,"2021"
"64702","330460 SANTA MARIA MADALENA",0,0,0,90,1,91,"2021"
"64703","330470 SANTO ANTONIO DE PADUA",3,3,7,443,3,459,"2021"
"64704","330475 SAO FRANCISCO DE ITABAPOANA",2,2,12,598,6,620,"2021"
"64705","330480 SAO FIDELIS",0,2,2,346,73,423,"2021"
"64706","330490 SAO GONCALO",31,31,105,9191,35,9393,"2021"
"64707","330500 SAO JOAO DA BARRA",0,0,7,531,6,544,"2021"
"64708","330510 SAO JOAO DE MERITI",12,26,89,4877,78,5082,"2021"
"64709","330513 SAO JOSE DE UBA",0,0,2,110,0,112,"2021"
"64710","330515 SAO JOSE DO VALE DO RIO PRETO",0,4,5,265,1,275,"2021"
"64711","330520 SAO PEDRO DA ALDEIA",1,7,38,1604,9,1659,"2021"
"64712","330530 SAO SEBASTIAO DO ALTO",0,1,0,82,0,83,"2021"
"64713","330540 SAPUCAIA",0,0,2,180,1,183,"2021"
"64714","330550 SAQUAREMA",4,6,20,1088,2,1120,"2021"
"64715","330555 SEROPEDICA",3,3,16,1013,13,1048,"2021"
"64716","330560 SILVA JARDIM",0,1,4,235,2,242,"2021"
"64717","330570 SUMIDOURO",0,1,0,222,2,225,"2021"
"64718","330575 TANGUA",1,2,5,386,4,398,"2021"
"64719","330580 TERESOPOLIS",0,9,36,1952,16,2013,"2021"
"64720","330590 TRAJANO DE MORAES",0,0,1,97,3,101,"2021"
"64721","330600 TRES RIOS",1,5,5,990,1,1002,"2021"
"64722","330610 VALENCA",2,12,30,686,14,744,"2021"
"64723","330615 VARRE-SAI",0,2,2,127,0,131,"2021"
"64724","330620 VASSOURAS",3,3,11,470,0,487,"2021"
"64725","330630 VOLTA REDONDA",11,13,53,2858,16,2951,"2021"
"64726","MUNICIPIO IGNORADO - SP",0,0,0,2,4,6,"2021"
"64727","350010 ADAMANTINA",2,1,4,343,0,350,"2021"
"64728","350020 ADOLFO",0,0,0,44,0,44,"2021"
"64729","350030 AGUAI",1,0,4,359,3,367,"2021"
"64730","350040 AGUAS DA PRATA",0,0,0,61,1,62,"2021"
"64731","350050 AGUAS DE LINDOIA",0,1,2,221,0,224,"2021"
"64732","350055 AGUAS DE SANTA BARBARA",0,0,1,71,0,72,"2021"
"64733","350060 AGUAS DE SAO PEDRO",0,0,0,28,0,28,"2021"
"64734","350070 AGUDOS",5,2,7,474,0,488,"2021"
"64735","350075 ALAMBARI",0,0,3,67,0,70,"2021"
"64736","350080 ALFREDO MARCONDES",1,0,1,47,0,49,"2021"
"64737","350090 ALTAIR",0,0,2,35,0,37,"2021"
"64738","350100 ALTINOPOLIS",2,2,4,174,0,182,"2021"
"64739","350110 ALTO ALEGRE",0,0,0,32,0,32,"2021"
"64740","350115 ALUMINIO",0,0,4,217,1,222,"2021"
"64741","350120 ALVARES FLORENCE",0,0,0,29,0,29,"2021"
"64742","350130 ALVARES MACHADO",0,0,0,301,1,302,"2021"
"64743","350140 ALVARO DE CARVALHO",0,0,0,29,0,29,"2021"
"64744","350150 ALVINLANDIA",2,1,0,30,0,33,"2021"
"64745","350160 AMERICANA",4,5,31,2352,10,2402,"2021"
"64746","350170 AMERICO BRASILIENSE",3,3,4,400,0,410,"2021"
"64747","350180 AMERICO DE CAMPOS",0,0,1,51,0,52,"2021"
"64748","350190 AMPARO",1,0,7,766,1,775,"2021"
"64749","350200 ANALANDIA",0,0,1,39,0,40,"2021"
"64750","350210 ANDRADINA",1,3,2,640,4,650,"2021"
"64751","350220 ANGATUBA",2,0,6,328,0,336,"2021"
"64752","350230 ANHEMBI",1,0,0,68,0,69,"2021"
"64753","350240 ANHUMAS",0,0,1,37,0,38,"2021"
"64754","350250 APARECIDA",0,0,3,342,7,352,"2021"
"64755","350260 APARECIDA D'OESTE",1,0,1,38,0,40,"2021"
"64756","350270 APIAI",2,1,4,292,1,300,"2021"
"64757","350275 ARACARIGUAMA",0,2,4,309,1,316,"2021"
"64758","350280 ARACATUBA",7,0,21,2079,2,2109,"2021"
"64759","350290 ARACOIABA DA SERRA",1,1,4,348,0,354,"2021"
"64760","350300 ARAMINA",0,1,2,53,0,56,"2021"
"64761","350310 ARANDU",0,0,0,85,0,85,"2021"
"64762","350315 ARAPEI",0,0,0,19,0,19,"2021"
"64763","350320 ARARAQUARA",12,14,25,2553,2,2606,"2021"
"64764","350330 ARARAS",10,6,14,1391,2,1423,"2021"
"64765","350335 ARCO-IRIS",0,0,0,18,0,18,"2021"
"64766","350340 AREALVA",0,0,0,86,0,86,"2021"
"64767","350350 AREIAS",0,1,0,54,0,55,"2021"
"64768","350360 AREIOPOLIS",1,0,3,112,0,116,"2021"
"64769","350370 ARIRANHA",0,1,1,88,0,90,"2021"
"64770","350380 ARTUR NOGUEIRA",1,1,6,615,0,623,"2021"
"64771","350390 ARUJA",3,5,24,1306,1,1339,"2021"
"64772","350395 ASPASIA",0,0,0,20,0,20,"2021"
"64773","350400 ASSIS",1,5,8,1013,1,1028,"2021"
"64774","350410 ATIBAIA",2,8,26,1964,5,2005,"2021"
"64775","350420 AURIFLAMA",0,1,1,126,0,128,"2021"
"64776","350430 AVAI",0,0,1,63,0,64,"2021"
"64777","350440 AVANHANDAVA",0,1,0,129,0,130,"2021"
"64778","350450 AVARE",2,5,22,1107,0,1136,"2021"
"64779","350460 BADY BASSITT",0,1,7,347,0,355,"2021"
"64780","350470 BALBINOS",0,0,1,13,0,14,"2021"
"64781","350480 BALSAMO",1,1,3,77,0,82,"2021"
"64782","350490 BANANAL",0,0,3,86,0,89,"2021"
"64783","350500 BARAO DE ANTONINA",0,1,0,48,0,49,"2021"
"64784","350510 BARBOSA",0,0,0,72,0,72,"2021"
"64785","350520 BARIRI",0,3,4,349,3,359,"2021"
"64786","350530 BARRA BONITA",1,2,0,324,2,329,"2021"
"64787","350535 BARRA DO CHAPEU",0,0,0,77,1,78,"2021"
"64788","350540 BARRA DO TURVO",0,2,2,77,1,82,"2021"
"64789","350550 BARRETOS",2,4,20,1374,4,1404,"2021"
"64790","350560 BARRINHA",0,0,12,368,0,380,"2021"
"64791","350570 BARUERI",12,16,52,5133,3,5216,"2021"
"64792","350580 BASTOS",2,2,3,258,1,266,"2021"
"64793","350590 BATATAIS",3,3,8,647,12,673,"2021"
"64794","350600 BAURU",6,12,54,4191,19,4282,"2021"
"64795","350610 BEBEDOURO",4,1,11,766,0,782,"2021"
"64796","350620 BENTO DE ABREU",0,0,1,26,0,27,"2021"
"64797","350630 BERNARDINO DE CAMPOS",1,0,0,104,0,105,"2021"
"64798","350635 BERTIOGA",7,3,11,958,1,980,"2021"
"64799","350640 BILAC",0,0,0,46,0,46,"2021"
"64800","350650 BIRIGUI",1,4,8,1258,2,1273,"2021"
"64801","350660 BIRITIBA-MIRIM",0,0,1,353,6,360,"2021"
"64802","350670 BOA ESPERANCA DO SUL",0,0,4,166,1,171,"2021"
"64803","350680 BOCAINA",0,0,0,114,1,115,"2021"
"64804","350690 BOFETE",0,2,1,106,0,109,"2021"
"64805","350700 BOITUVA",2,3,11,735,2,753,"2021"
"64806","350710 BOM JESUS DOS PERDOES",0,0,0,282,1,283,"2021"
"64807","350715 BOM SUCESSO DE ITARARE",0,0,1,62,1,64,"2021"
"64808","350720 BORA",0,0,0,6,0,6,"2021"
"64809","350730 BORACEIA",0,1,1,67,0,69,"2021"
"64810","350740 BORBOREMA",0,0,4,111,0,115,"2021"
"64811","350745 BOREBI",1,0,0,33,0,34,"2021"
"64812","350750 BOTUCATU",12,11,43,1534,6,1606,"2021"
"64813","350760 BRAGANCA PAULISTA",3,3,19,2071,3,2099,"2021"
"64814","350770 BRAUNA",0,0,0,71,0,71,"2021"
"64815","350775 BREJO ALEGRE",0,0,0,26,0,26,"2021"
"64816","350780 BRODOWSKI",2,3,2,298,1,306,"2021"
"64817","350790 BROTAS",3,1,3,281,2,290,"2021"
"64818","350800 BURI",0,2,7,260,0,269,"2021"
"64819","350810 BURITAMA",0,0,2,152,0,154,"2021"
"64820","350820 BURITIZAL",0,0,0,38,0,38,"2021"
"64821","350830 CABRALIA PAULISTA",1,0,2,37,0,40,"2021"
"64822","350840 CABREUVA",0,2,12,727,1,742,"2021"
"64823","350850 CACAPAVA",3,4,17,1064,8,1096,"2021"
"64824","350860 CACHOEIRA PAULISTA",1,2,7,325,7,342,"2021"
"64825","350870 CACONDE",1,0,2,180,0,183,"2021"
"64826","350880 CAFELANDIA",0,0,1,194,0,195,"2021"
"64827","350890 CAIABU",0,1,0,45,0,46,"2021"
"64828","350900 CAIEIRAS",4,4,14,1230,4,1256,"2021"
"64829","350910 CAIUA",0,0,0,34,0,34,"2021"
"64830","350920 CAJAMAR",4,6,15,1259,3,1287,"2021"
"64831","350925 CAJATI",0,3,4,414,0,421,"2021"
"64832","350930 CAJOBI",0,0,1,86,0,87,"2021"
"64833","350940 CAJURU",1,4,2,307,1,315,"2021"
"64834","350945 CAMPINA DO MONTE ALEGRE",0,0,0,63,0,63,"2021"
"64835","350950 CAMPINAS",65,42,102,12583,47,12839,"2021"
"64836","350960 CAMPO LIMPO PAULISTA",2,4,19,856,2,883,"2021"
"64837","350970 CAMPOS DO JORDAO",0,1,7,615,0,623,"2021"
"64838","350980 CAMPOS NOVOS PAULISTA",0,0,0,59,0,59,"2021"
"64839","350990 CANANEIA",0,0,1,165,2,168,"2021"
"64840","350995 CANAS",0,1,1,76,2,80,"2021"
"64841","351000 CANDIDO MOTA",0,1,5,326,0,332,"2021"
"64842","351010 CANDIDO RODRIGUES",0,0,0,21,0,21,"2021"
"64843","351015 CANITAR",0,1,0,87,1,89,"2021"
"64844","351020 CAPAO BONITO",0,0,7,624,0,631,"2021"
"64845","351030 CAPELA DO ALTO",0,1,2,286,0,289,"2021"
"64846","351040 CAPIVARI",1,3,4,599,1,608,"2021"
"64847","351050 CARAGUATATUBA",7,4,17,1565,3,1596,"2021"
"64848","351060 CARAPICUIBA",19,21,60,5481,30,5611,"2021"
"64849","351070 CARDOSO",0,0,1,87,0,88,"2021"
"64850","351080 CASA BRANCA",0,0,6,236,0,242,"2021"
"64851","351090 CASSIA DOS COQUEIROS",0,0,0,13,0,13,"2021"
"64852","351100 CASTILHO",1,0,3,207,1,212,"2021"
"64853","351110 CATANDUVA",0,5,12,1143,4,1164,"2021"
"64854","351120 CATIGUA",0,0,1,74,0,75,"2021"
"64855","351130 CEDRAL",0,0,1,138,0,139,"2021"
"64856","351140 CERQUEIRA CESAR",1,1,5,235,0,242,"2021"
"64857","351150 CERQUILHO",0,1,7,443,0,451,"2021"
"64858","351160 CESARIO LANGE",1,1,3,221,0,226,"2021"
"64859","351170 CHARQUEADA",0,0,0,186,0,186,"2021"
"64860","351190 CLEMENTINA",1,1,1,78,0,81,"2021"
"64861","351200 COLINA",0,1,4,230,0,235,"2021"
"64862","351210 COLOMBIA",0,1,0,86,0,87,"2021"
"64863","351220 CONCHAL",0,1,10,373,1,385,"2021"
"64864","351230 CONCHAS",1,0,2,188,1,192,"2021"
"64865","351240 CORDEIROPOLIS",1,1,5,244,0,251,"2021"
"64866","351250 COROADOS",0,0,0,38,0,38,"2021"
"64867","351260 CORONEL MACEDO",0,0,1,43,0,44,"2021"
"64868","351270 CORUMBATAI",0,0,0,38,0,38,"2021"
"64869","351280 COSMOPOLIS",3,7,7,646,2,665,"2021"
"64870","351290 COSMORAMA",0,1,1,76,0,78,"2021"
"64871","351300 COTIA",6,10,31,3747,15,3809,"2021"
"64872","351310 CRAVINHOS",0,2,10,359,0,371,"2021"
"64873","351320 CRISTAIS PAULISTA",0,0,1,116,3,120,"2021"
"64874","351330 CRUZALIA",0,0,2,20,0,22,"2021"
"64875","351340 CRUZEIRO",1,8,11,849,2,871,"2021"
"64876","351350 CUBATAO",3,8,17,1364,7,1399,"2021"
"64877","351360 CUNHA",0,2,5,217,2,226,"2021"
"64878","351370 DESCALVADO",0,0,2,323,0,325,"2021"
"64879","351380 DIADEMA",10,19,43,4397,13,4482,"2021"
"64880","351385 DIRCE REIS",0,0,0,15,0,15,"2021"
"64881","351390 DIVINOLANDIA",0,0,0,112,0,112,"2021"
"64882","351400 DOBRADA",0,1,0,91,1,93,"2021"
"64883","351410 DOIS CORREGOS",0,2,0,271,0,273,"2021"
"64884","351420 DOLCINOPOLIS",0,1,0,28,1,30,"2021"
"64885","351430 DOURADO",0,1,2,78,0,81,"2021"
"64886","351440 DRACENA",5,1,2,411,0,419,"2021"
"64887","351450 DUARTINA",0,0,1,140,0,141,"2021"
"64888","351460 DUMONT",1,0,1,109,0,111,"2021"
"64889","351470 ECHAPORA",0,0,0,66,0,66,"2021"
"64890","351480 ELDORADO",0,0,1,202,0,203,"2021"
"64891","351490 ELIAS FAUSTO",0,0,2,182,1,185,"2021"
"64892","351492 ELISIARIO",0,0,0,29,0,29,"2021"
"64893","351495 EMBAUBA",0,0,0,23,0,23,"2021"
"64894","351500 EMBU DAS ARTES",7,13,42,3518,12,3592,"2021"
"64895","351510 EMBU-GUACU",3,6,7,768,3,787,"2021"
"64896","351512 EMILIANOPOLIS",0,0,0,19,1,20,"2021"
"64897","351515 ENGENHEIRO COELHO",1,0,1,269,1,272,"2021"
"64898","351518 ESPIRITO SANTO DO PINHAL",3,1,12,381,0,397,"2021"
"64899","351519 ESPIRITO SANTO DO TURVO",1,1,2,57,0,61,"2021"
"64900","351520 ESTRELA D'OESTE",0,0,1,98,0,99,"2021"
"64901","351530 ESTRELA DO NORTE",0,0,0,17,0,17,"2021"
"64902","351535 EUCLIDES DA CUNHA PAULISTA",0,0,1,79,0,80,"2021"
"64903","351540 FARTURA",1,0,3,210,0,214,"2021"
"64904","351550 FERNANDOPOLIS",2,2,6,724,0,734,"2021"
"64905","351560 FERNANDO PRESTES",0,0,0,56,0,56,"2021"
"64906","351565 FERNAO",0,1,0,18,0,19,"2021"
"64907","351570 FERRAZ DE VASCONCELOS",3,8,39,2365,15,2430,"2021"
"64908","351580 FLORA RICA",0,0,0,12,0,12,"2021"
"64909","351590 FLOREAL",0,0,0,17,0,17,"2021"
"64910","351600 FLORIDA PAULISTA",1,0,6,83,0,90,"2021"
"64911","351610 FLORINIA",0,0,1,21,0,22,"2021"
"64912","351620 FRANCA",7,11,40,4150,11,4219,"2021"
"64913","351630 FRANCISCO MORATO",6,7,24,2633,14,2684,"2021"
"64914","351640 FRANCO DA ROCHA",2,10,27,1986,10,2035,"2021"
"64915","351650 GABRIEL MONTEIRO",0,0,0,24,0,24,"2021"
"64916","351660 GALIA",0,2,4,48,0,54,"2021"
"64917","351670 GARCA",2,1,11,474,2,490,"2021"
"64918","351680 GASTAO VIDIGAL",0,0,0,31,0,31,"2021"
"64919","351685 GAVIAO PEIXOTO",1,0,2,58,0,61,"2021"
"64920","351690 GENERAL SALGADO",0,1,0,93,0,94,"2021"
"64921","351700 GETULINA",3,0,0,84,0,87,"2021"
"64922","351710 GLICERIO",0,0,0,52,0,52,"2021"
"64923","351720 GUAICARA",0,1,2,119,0,122,"2021"
"64924","351730 GUAIMBE",1,1,2,57,0,61,"2021"
"64925","351740 GUAIRA",1,1,8,412,3,425,"2021"
"64926","351750 GUAPIACU",0,1,1,253,0,255,"2021"
"64927","351760 GUAPIARA",1,1,1,206,0,209,"2021"
"64928","351770 GUARA",1,1,2,187,0,191,"2021"
"64929","351780 GUARACAI",1,0,1,67,0,69,"2021"
"64930","351790 GUARACI",0,0,3,102,0,105,"2021"
"64931","351800 GUARANI D'OESTE",0,0,0,17,0,17,"2021"
"64932","351810 GUARANTA",1,0,0,69,0,70,"2021"
"64933","351820 GUARARAPES",0,4,6,306,1,317,"2021"
"64934","351830 GUARAREMA",0,1,2,389,0,392,"2021"
"64935","351840 GUARATINGUETA",2,5,11,1358,4,1380,"2021"
"64936","351850 GUAREI",3,0,3,119,0,125,"2021"
"64937","351860 GUARIBA",0,3,6,402,0,411,"2021"
"64938","351870 GUARUJA",6,22,98,3666,12,3804,"2021"
"64939","351880 GUARULHOS",38,73,220,17883,65,18279,"2021"
"64940","351885 GUATAPARA",0,0,1,77,2,80,"2021"
"64941","351890 GUZOLANDIA",0,0,0,49,0,49,"2021"
"64942","351900 HERCULANDIA",0,0,1,120,0,121,"2021"
"64943","351905 HOLAMBRA",0,1,2,201,2,206,"2021"
"64944","351907 HORTOLANDIA",9,6,17,2705,5,2742,"2021"
"64945","351910 IACANGA",0,0,0,124,0,124,"2021"
"64946","351920 IACRI",0,0,0,49,0,49,"2021"
"64947","351925 IARAS",0,0,0,63,0,63,"2021"
"64948","351930 IBATE",1,1,2,468,0,472,"2021"
"64949","351940 IBIRA",1,0,2,117,1,121,"2021"
"64950","351950 IBIRAREMA",0,0,0,72,2,74,"2021"
"64951","351960 IBITINGA",1,5,9,704,1,720,"2021"
"64952","351970 IBIUNA",2,1,8,970,1,982,"2021"
"64953","351980 ICEM",0,0,0,80,0,80,"2021"
"64954","351990 IEPE",1,0,0,96,0,97,"2021"
"64955","352000 IGARACU DO TIETE",0,0,1,229,1,231,"2021"
"64956","352010 IGARAPAVA",0,0,1,284,0,285,"2021"
"64957","352020 IGARATA",0,1,1,136,0,138,"2021"
"64958","352030 IGUAPE",1,0,6,291,0,298,"2021"
"64959","352040 ILHABELA",2,0,6,449,2,459,"2021"
"64960","352042 ILHA COMPRIDA",0,0,1,112,0,113,"2021"
"64961","352044 ILHA SOLTEIRA",0,0,1,248,1,250,"2021"
"64962","352050 INDAIATUBA",4,9,68,3022,2,3105,"2021"
"64963","352060 INDIANA",0,0,2,52,0,54,"2021"
"64964","352070 INDIAPORA",1,0,0,34,0,35,"2021"
"64965","352080 INUBIA PAULISTA",0,0,0,36,0,36,"2021"
"64966","352090 IPAUSSU",2,1,2,147,2,154,"2021"
"64967","352100 IPERO",0,4,5,334,1,344,"2021"
"64968","352110 IPEUNA",0,0,0,83,0,83,"2021"
"64969","352115 IPIGUA",0,0,2,66,0,68,"2021"
"64970","352120 IPORANGA",0,0,1,59,0,60,"2021"
"64971","352130 IPUA",0,0,3,175,0,178,"2021"
"64972","352140 IRACEMAPOLIS",0,1,5,228,0,234,"2021"
"64973","352150 IRAPUA",1,0,1,68,0,70,"2021"
"64974","352160 IRAPURU",1,0,2,55,0,58,"2021"
"64975","352170 ITABERA",0,1,3,218,1,223,"2021"
"64976","352180 ITAI",0,3,7,268,0,278,"2021"
"64977","352190 ITAJOBI",0,0,2,193,0,195,"2021"
"64978","352200 ITAJU",0,0,0,43,1,44,"2021"
"64979","352210 ITANHAEM",6,7,25,1245,2,1285,"2021"
"64980","352215 ITAOCA",1,1,0,44,0,46,"2021"
"64981","352220 ITAPECERICA DA SERRA",10,16,24,2188,14,2252,"2021"
"64982","352230 ITAPETININGA",1,7,30,1854,0,1892,"2021"
"64983","352240 ITAPEVA",5,13,37,1243,6,1304,"2021"
"64984","352250 ITAPEVI",10,12,42,3552,18,3634,"2021"
"64985","352260 ITAPIRA",1,2,3,701,2,709,"2021"
"64986","352265 ITAPIRAPUA PAULISTA",0,0,0,56,1,57,"2021"
"64987","352270 ITAPOLIS",0,4,8,397,0,409,"2021"
"64988","352280 ITAPORANGA",0,1,1,149,0,151,"2021"
"64989","352290 ITAPUI",0,1,0,216,1,218,"2021"
"64990","352300 ITAPURA",0,0,0,33,0,33,"2021"
"64991","352310 ITAQUAQUECETUBA",10,21,57,4952,36,5076,"2021"
"64992","352320 ITARARE",2,4,9,546,2,563,"2021"
"64993","352330 ITARIRI",1,1,3,155,1,161,"2021"
"64994","352340 ITATIBA",4,3,13,1305,1,1326,"2021"
"64995","352350 ITATINGA",1,0,8,246,0,255,"2021"
"64996","352360 ITIRAPINA",0,0,4,158,0,162,"2021"
"64997","352370 ITIRAPUA",2,4,0,80,1,87,"2021"
"64998","352380 ITOBI",0,0,0,81,0,81,"2021"
"64999","352390 ITU",4,4,23,2089,11,2131,"2021"
"65000","352400 ITUPEVA",1,3,10,832,0,846,"2021"
"65001","352410 ITUVERAVA",0,1,11,374,0,386,"2021"
"65002","352420 JABORANDI",0,0,1,55,1,57,"2021"
"65003","352430 JABOTICABAL",1,4,12,711,0,728,"2021"
"65004","352440 JACAREI",8,9,38,2516,16,2587,"2021"
"65005","352450 JACI",0,0,0,84,0,84,"2021"
"65006","352460 JACUPIRANGA",0,1,3,220,1,225,"2021"
"65007","352470 JAGUARIUNA",6,1,3,717,1,728,"2021"
"65008","352480 JALES",0,1,8,465,1,475,"2021"
"65009","352490 JAMBEIRO",0,0,0,71,0,71,"2021"
"65010","352500 JANDIRA",3,7,27,1407,12,1456,"2021"
"65011","352510 JARDINOPOLIS",1,1,17,514,2,535,"2021"
"65012","352520 JARINU",2,4,7,436,2,451,"2021"
"65013","352530 JAU",2,4,11,1385,7,1409,"2021"
"65014","352540 JERIQUARA",0,0,0,58,0,58,"2021"
"65015","352550 JOANOPOLIS",0,1,1,122,0,124,"2021"
"65016","352560 JOAO RAMALHO",0,0,0,52,0,52,"2021"
"65017","352570 JOSE BONIFACIO",2,2,3,442,0,449,"2021"
"65018","352580 JULIO MESQUITA",0,0,2,58,0,60,"2021"
"65019","352585 JUMIRIM",0,0,0,43,0,43,"2021"
"65020","352590 JUNDIAI",7,19,46,5448,13,5533,"2021"
"65021","352600 JUNQUEIROPOLIS",1,2,0,195,1,199,"2021"
"65022","352610 JUQUIA",2,2,4,209,0,217,"2021"
"65023","352620 JUQUITIBA",2,1,1,343,3,350,"2021"
"65024","352630 LAGOINHA",0,0,0,47,0,47,"2021"
"65025","352640 LARANJAL PAULISTA",3,0,2,349,0,354,"2021"
"65026","352650 LAVINIA",1,0,3,28,0,32,"2021"
"65027","352660 LAVRINHAS",0,0,3,90,1,94,"2021"
"65028","352670 LEME",2,2,8,1001,6,1019,"2021"
"65029","352680 LENCOIS PAULISTA",5,1,22,808,1,837,"2021"
"65030","352690 LIMEIRA",7,5,42,3137,7,3198,"2021"
"65031","352700 LINDOIA",0,0,0,85,0,85,"2021"
"65032","352710 LINS",3,4,5,802,0,814,"2021"
"65033","352720 LORENA",4,4,10,1071,12,1101,"2021"
"65034","352725 LOURDES",0,1,0,15,0,16,"2021"
"65035","352730 LOUVEIRA",1,3,13,722,1,740,"2021"
"65036","352740 LUCELIA",0,0,2,177,0,179,"2021"
"65037","352750 LUCIANOPOLIS",2,0,0,26,0,28,"2021"
"65038","352760 LUIS ANTONIO",0,1,2,164,3,170,"2021"
"65039","352770 LUIZIANIA",0,1,0,71,0,72,"2021"
"65040","352780 LUPERCIO",0,0,0,44,0,44,"2021"
"65041","352790 LUTECIA",1,0,0,37,0,38,"2021"
"65042","352800 MACATUBA",2,0,2,193,6,203,"2021"
"65043","352810 MACAUBAL",0,1,3,59,0,63,"2021"
"65044","352820 MACEDONIA",0,0,2,39,0,41,"2021"
"65045","352830 MAGDA",0,0,0,18,0,18,"2021"
"65046","352840 MAIRINQUE",6,2,15,589,1,613,"2021"
"65047","352850 MAIRIPORA",5,9,12,981,9,1016,"2021"
"65048","352860 MANDURI",0,4,1,98,0,103,"2021"
"65049","352870 MARABA PAULISTA",0,0,2,33,0,35,"2021"
"65050","352880 MARACAI",1,0,1,139,1,142,"2021"
"65051","352885 MARAPOAMA",0,0,1,30,0,31,"2021"
"65052","352890 MARIAPOLIS",0,0,0,37,0,37,"2021"
"65053","352900 MARILIA",6,11,37,2728,4,2786,"2021"
"65054","352910 MARINOPOLIS",1,1,0,13,0,15,"2021"
"65055","352920 MARTINOPOLIS",1,1,2,270,1,275,"2021"
"65056","352930 MATAO",1,3,5,784,1,794,"2021"
"65057","352940 MAUA",7,13,50,4475,17,4562,"2021"
"65058","352950 MENDONCA",0,0,0,57,0,57,"2021"
"65059","352960 MERIDIANO",1,0,0,38,0,39,"2021"
"65060","352965 MESOPOLIS",0,0,0,23,0,23,"2021"
"65061","352970 MIGUELOPOLIS",0,0,4,212,0,216,"2021"
"65062","352980 MINEIROS DO TIETE",0,0,2,111,0,113,"2021"
"65063","352990 MIRACATU",1,2,4,271,1,279,"2021"
"65064","353000 MIRA ESTRELA",1,0,0,28,0,29,"2021"
"65065","353010 MIRANDOPOLIS",1,0,1,239,1,242,"2021"
"65066","353020 MIRANTE DO PARANAPANEMA",2,0,5,160,0,167,"2021"
"65067","353030 MIRASSOL",2,1,1,699,0,703,"2021"
"65068","353040 MIRASSOLANDIA",0,0,0,65,0,65,"2021"
"65069","353050 MOCOCA",0,1,5,686,3,695,"2021"
"65070","353060 MOGI DAS CRUZES",9,14,36,5565,38,5662,"2021"
"65071","353070 MOGI GUACU",2,7,24,1657,6,1696,"2021"
"65072","353080 MOGI MIRIM",0,3,11,921,6,941,"2021"
"65073","353090 MOMBUCA",0,0,1,52,0,53,"2021"
"65074","353100 MONCOES",0,0,0,15,0,15,"2021"
"65075","353110 MONGAGUA",0,13,14,718,2,747,"2021"
"65076","353120 MONTE ALEGRE DO SUL",0,0,0,65,0,65,"2021"
"65077","353130 MONTE ALTO",0,3,0,451,0,454,"2021"
"65078","353140 MONTE APRAZIVEL",0,0,1,189,0,190,"2021"
"65079","353150 MONTE AZUL PAULISTA",0,0,2,214,0,216,"2021"
"65080","353160 MONTE CASTELO",0,0,1,42,1,44,"2021"
"65081","353170 MONTEIRO LOBATO",0,0,0,39,1,40,"2021"
"65082","353180 MONTE MOR",4,2,4,868,2,880,"2021"
"65083","353190 MORRO AGUDO",2,0,1,297,0,300,"2021"
"65084","353200 MORUNGABA",0,0,1,147,0,148,"2021"
"65085","353205 MOTUCA",0,0,0,36,0,36,"2021"
"65086","353210 MURUTINGA DO SUL",0,0,1,25,0,26,"2021"
"65087","353215 NANTES",0,0,0,31,0,31,"2021"
"65088","353220 NARANDIBA",0,0,0,90,1,91,"2021"
"65089","353230 NATIVIDADE DA SERRA",0,0,2,54,0,56,"2021"
"65090","353240 NAZARE PAULISTA",0,3,2,227,0,232,"2021"
"65091","353250 NEVES PAULISTA",1,0,0,83,0,84,"2021"
"65092","353260 NHANDEARA",0,1,2,71,0,74,"2021"
"65093","353270 NIPOA",0,0,0,59,0,59,"2021"
"65094","353280 NOVA ALIANCA",0,0,1,85,0,86,"2021"
"65095","353282 NOVA CAMPINA",0,1,0,115,0,116,"2021"
"65096","353284 NOVA CANAA PAULISTA",0,0,0,12,0,12,"2021"
"65097","353286 NOVA CASTILHO",0,0,0,5,0,5,"2021"
"65098","353290 NOVA EUROPA",0,0,1,112,0,113,"2021"
"65099","353300 NOVA GRANADA",0,0,5,229,1,235,"2021"
"65100","353310 NOVA GUATAPORANGA",0,0,0,22,0,22,"2021"
"65101","353320 NOVA INDEPENDENCIA",0,0,0,49,0,49,"2021"
"65102","353325 NOVAIS",0,1,0,55,1,57,"2021"
"65103","353330 NOVA LUZITANIA",0,0,3,20,0,23,"2021"
"65104","353340 NOVA ODESSA",1,1,9,670,0,681,"2021"
"65105","353350 NOVO HORIZONTE",2,0,5,398,0,405,"2021"
"65106","353360 NUPORANGA",0,0,0,87,0,87,"2021"
"65107","353370 OCAUCU",0,0,1,57,0,58,"2021"
"65108","353380 OLEO",0,0,0,25,1,26,"2021"
"65109","353390 OLIMPIA",0,6,11,615,4,636,"2021"
"65110","353400 ONDA VERDE",1,0,1,63,0,65,"2021"
"65111","353410 ORIENTE",0,0,2,60,0,62,"2021"
"65112","353420 ORINDIUVA",0,1,1,72,0,74,"2021"
"65113","353430 ORLANDIA",2,2,4,428,0,436,"2021"
"65114","353440 OSASCO",19,24,100,8222,16,8381,"2021"
"65115","353450 OSCAR BRESSANE",0,0,0,16,0,16,"2021"
"65116","353460 OSVALDO CRUZ",1,0,2,303,0,306,"2021"
"65117","353470 OURINHOS",1,4,12,1153,4,1174,"2021"
"65118","353475 OUROESTE",1,1,0,80,0,82,"2021"
"65119","353480 OURO VERDE",2,0,3,95,0,100,"2021"
"65120","353490 PACAEMBU",1,0,1,93,0,95,"2021"
"65121","353500 PALESTINA",0,0,1,133,0,134,"2021"
"65122","353510 PALMARES PAULISTA",0,1,2,115,0,118,"2021"
"65123","353520 PALMEIRA D'OESTE",1,0,0,79,0,80,"2021"
"65124","353530 PALMITAL",0,2,0,209,0,211,"2021"
"65125","353540 PANORAMA",1,0,3,177,0,181,"2021"
"65126","353550 PARAGUACU PAULISTA",2,4,1,467,1,475,"2021"
"65127","353560 PARAIBUNA",0,4,0,202,0,206,"2021"
"65128","353570 PARAISO",0,0,0,53,2,55,"2021"
"65129","353580 PARANAPANEMA",1,2,2,263,0,268,"2021"
"65130","353590 PARANAPUA",1,0,0,55,0,56,"2021"
"65131","353600 PARAPUA",0,0,3,99,0,102,"2021"
"65132","353610 PARDINHO",1,1,2,77,0,81,"2021"
"65133","353620 PARIQUERA-ACU",0,1,7,255,1,264,"2021"
"65134","353625 PARISI",0,0,0,29,0,29,"2021"
"65135","353630 PATROCINIO PAULISTA",1,0,4,213,2,220,"2021"
"65136","353640 PAULICEIA",1,1,1,115,0,118,"2021"
"65137","353650 PAULINIA",4,3,17,1296,6,1326,"2021"
"65138","353657 PAULISTANIA",0,0,0,23,0,23,"2021"
"65139","353660 PAULO DE FARIA",0,0,0,67,0,67,"2021"
"65140","353670 PEDERNEIRAS",1,3,4,523,2,533,"2021"
"65141","353680 PEDRA BELA",0,0,0,77,0,77,"2021"
"65142","353690 PEDRANOPOLIS",0,1,0,24,0,25,"2021"
"65143","353700 PEDREGULHO",0,1,1,189,1,192,"2021"
"65144","353710 PEDREIRA",5,4,3,440,1,453,"2021"
"65145","353715 PEDRINHAS PAULISTA",0,0,0,20,0,20,"2021"
"65146","353720 PEDRO DE TOLEDO",0,2,2,98,0,102,"2021"
"65147","353730 PENAPOLIS",2,2,5,670,0,679,"2021"
"65148","353740 PEREIRA BARRETO",0,1,2,253,1,257,"2021"
"65149","353750 PEREIRAS",0,2,3,85,0,90,"2021"
"65150","353760 PERUIBE",0,6,10,875,6,897,"2021"
"65151","353770 PIACATU",0,0,1,45,1,47,"2021"
"65152","353780 PIEDADE",1,2,5,632,0,640,"2021"
"65153","353790 PILAR DO SUL",0,1,3,391,0,395,"2021"
"65154","353800 PINDAMONHANGABA",2,8,23,2178,2,2213,"2021"
"65155","353810 PINDORAMA",3,0,4,131,2,140,"2021"
"65156","353820 PINHALZINHO",1,1,2,153,0,157,"2021"
"65157","353830 PIQUEROBI",0,1,0,32,0,33,"2021"
"65158","353850 PIQUETE",0,0,1,116,1,118,"2021"
"65159","353860 PIRACAIA",0,1,2,292,2,297,"2021"
"65160","353870 PIRACICABA",10,9,42,4650,17,4728,"2021"
"65161","353880 PIRAJU",1,1,2,323,1,328,"2021"
"65162","353890 PIRAJUI",0,3,3,170,2,178,"2021"
"65163","353900 PIRANGI",0,0,1,102,0,103,"2021"
"65164","353910 PIRAPORA DO BOM JESUS",0,1,2,228,3,234,"2021"
"65165","353920 PIRAPOZINHO",0,1,6,256,0,263,"2021"
"65166","353930 PIRASSUNUNGA",1,3,9,772,0,785,"2021"
"65167","353940 PIRATININGA",1,0,6,135,1,143,"2021"
"65168","353950 PITANGUEIRAS",0,0,4,437,0,441,"2021"
"65169","353960 PLANALTO",0,0,0,62,0,62,"2021"
"65170","353970 PLATINA",0,0,0,26,0,26,"2021"
"65171","353980 POA",3,7,14,1219,8,1251,"2021"
"65172","353990 POLONI",0,0,0,64,0,64,"2021"
"65173","354000 POMPEIA",1,2,0,198,0,201,"2021"
"65174","354010 PONGAI",0,0,0,20,0,20,"2021"
"65175","354020 PONTAL",3,0,6,464,0,473,"2021"
"65176","354025 PONTALINDA",0,0,1,51,0,52,"2021"
"65177","354030 PONTES GESTAL",0,0,0,29,0,29,"2021"
"65178","354040 POPULINA",0,0,0,34,0,34,"2021"
"65179","354050 PORANGABA",0,0,3,87,0,90,"2021"
"65180","354060 PORTO FELIZ",1,3,9,618,0,631,"2021"
"65181","354070 PORTO FERREIRA",2,0,2,563,2,569,"2021"
"65182","354075 POTIM",1,0,4,233,3,241,"2021"
"65183","354080 POTIRENDABA",0,2,2,201,0,205,"2021"
"65184","354085 PRACINHA",0,0,0,13,0,13,"2021"
"65185","354090 PRADOPOLIS",2,0,2,165,1,170,"2021"
"65186","354100 PRAIA GRANDE",12,29,101,4055,18,4215,"2021"
"65187","354105 PRATANIA",0,1,1,85,0,87,"2021"
"65188","354110 PRESIDENTE ALVES",1,0,0,41,0,42,"2021"
"65189","354120 PRESIDENTE BERNARDES",0,0,0,109,0,109,"2021"
"65190","354130 PRESIDENTE EPITACIO",1,0,1,438,2,442,"2021"
"65191","354140 PRESIDENTE PRUDENTE",6,7,17,2469,6,2505,"2021"
"65192","354150 PRESIDENTE VENCESLAU",1,0,2,329,0,332,"2021"
"65193","354160 PROMISSAO",1,1,1,344,1,348,"2021"
"65194","354165 QUADRA",0,0,0,46,1,47,"2021"
"65195","354170 QUATA",0,2,1,139,0,142,"2021"
"65196","354180 QUEIROZ",0,0,0,62,0,62,"2021"
"65197","354190 QUELUZ",0,0,1,120,1,122,"2021"
"65198","354200 QUINTANA",0,1,1,91,0,93,"2021"
"65199","354210 RAFARD",0,0,2,115,0,117,"2021"
"65200","354220 RANCHARIA",1,0,1,311,0,313,"2021"
"65201","354230 REDENCAO DA SERRA",0,0,3,40,2,45,"2021"
"65202","354240 REGENTE FEIJO",0,0,2,185,0,187,"2021"
"65203","354250 REGINOPOLIS",0,1,3,51,0,55,"2021"
"65204","354260 REGISTRO",0,5,12,765,1,783,"2021"
"65205","354270 RESTINGA",0,1,0,99,0,100,"2021"
"65206","354280 RIBEIRA",0,0,1,44,0,45,"2021"
"65207","354290 RIBEIRAO BONITO",1,0,0,115,2,118,"2021"
"65208","354300 RIBEIRAO BRANCO",1,0,10,255,0,266,"2021"
"65209","354310 RIBEIRAO CORRENTE",1,0,2,46,0,49,"2021"
"65210","354320 RIBEIRAO DO SUL",0,0,0,52,0,52,"2021"
"65211","354323 RIBEIRAO DOS INDIOS",0,0,1,15,0,16,"2021"
"65212","354325 RIBEIRAO GRANDE",0,2,1,89,0,92,"2021"
"65213","354330 RIBEIRAO PIRES",2,3,7,1082,5,1099,"2021"
"65214","354340 RIBEIRAO PRETO",17,31,110,7563,29,7750,"2021"
"65215","354350 RIVERSUL",0,1,2,48,1,52,"2021"
"65216","354360 RIFAINA",0,1,1,40,0,42,"2021"
"65217","354370 RINCAO",1,1,2,103,1,108,"2021"
"65218","354380 RINOPOLIS",1,0,1,74,0,76,"2021"
"65219","354390 RIO CLARO",8,8,34,2224,3,2277,"2021"
"65220","354400 RIO DAS PEDRAS",3,1,2,360,2,368,"2021"
"65221","354410 RIO GRANDE DA SERRA",2,1,5,480,1,489,"2021"
"65222","354420 RIOLANDIA",3,0,1,121,0,125,"2021"
"65223","354425 ROSANA",0,0,2,191,0,193,"2021"
"65224","354430 ROSEIRA",1,1,3,99,0,104,"2021"
"65225","354440 RUBIACEA",0,0,0,27,0,27,"2021"
"65226","354450 RUBINEIA",0,0,1,35,0,36,"2021"
"65227","354460 SABINO",1,0,1,44,0,46,"2021"
"65228","354470 SAGRES",0,0,1,28,0,29,"2021"
"65229","354480 SALES",0,0,1,31,1,33,"2021"
"65230","354490 SALES OLIVEIRA",0,0,1,101,2,104,"2021"
"65231","354500 SALESOPOLIS",0,0,2,206,3,211,"2021"
"65232","354510 SALMOURAO",0,1,0,50,0,51,"2021"
"65233","354515 SALTINHO",0,0,0,77,0,77,"2021"
"65234","354520 SALTO",5,6,23,1567,6,1607,"2021"
"65235","354530 SALTO DE PIRAPORA",1,1,6,447,0,455,"2021"
"65236","354540 SALTO GRANDE",0,0,0,119,0,119,"2021"
"65237","354550 SANDOVALINA",0,0,2,44,0,46,"2021"
"65238","354560 SANTA ADELIA",0,0,2,152,0,154,"2021"
"65239","354570 SANTA ALBERTINA",0,0,0,70,0,70,"2021"
"65240","354580 SANTA BARBARA D'OESTE",0,10,13,1972,9,2004,"2021"
"65241","354600 SANTA BRANCA",1,0,1,136,1,139,"2021"
"65242","354610 SANTA CLARA D'OESTE",0,0,0,32,0,32,"2021"
"65243","354620 SANTA CRUZ DA CONCEICAO",0,0,0,30,0,30,"2021"
"65244","354625 SANTA CRUZ DA ESPERANCA",0,0,0,23,0,23,"2021"
"65245","354630 SANTA CRUZ DAS PALMEIRAS",1,1,5,336,0,343,"2021"
"65246","354640 SANTA CRUZ DO RIO PARDO",1,2,0,502,0,505,"2021"
"65247","354650 SANTA ERNESTINA",0,1,0,70,0,71,"2021"
"65248","354660 SANTA FE DO SUL",3,2,6,426,0,437,"2021"
"65249","354670 SANTA GERTRUDES",1,0,7,292,1,301,"2021"
"65250","354680 SANTA ISABEL",4,4,18,629,1,656,"2021"
"65251","354690 SANTA LUCIA",0,0,0,67,0,67,"2021"
"65252","354700 SANTA MARIA DA SERRA",0,0,0,69,0,69,"2021"
"65253","354710 SANTA MERCEDES",0,0,1,31,0,32,"2021"
"65254","354720 SANTANA DA PONTE PENSA",0,0,0,21,0,21,"2021"
"65255","354730 SANTANA DE PARNAIBA",7,2,20,2256,2,2287,"2021"
"65256","354740 SANTA RITA D'OESTE",0,0,1,25,0,26,"2021"
"65257","354750 SANTA RITA DO PASSA QUATRO",1,0,6,211,0,218,"2021"
"65258","354760 SANTA ROSA DE VITERBO",1,1,0,196,1,199,"2021"
"65259","354765 SANTA SALETE",0,0,0,18,0,18,"2021"
"65260","354770 SANTO ANASTACIO",1,0,6,183,0,190,"2021"
"65261","354780 SANTO ANDRE",14,19,98,7846,15,7992,"2021"
"65262","354790 SANTO ANTONIO DA ALEGRIA",0,3,3,76,2,84,"2021"
"65263","354800 SANTO ANTONIO DE POSSE",1,2,1,266,0,270,"2021"
"65264","354805 SANTO ANTONIO DO ARACANGUA",0,0,1,93,0,94,"2021"
"65265","354810 SANTO ANTONIO DO JARDIM",0,0,1,56,0,57,"2021"
"65266","354820 SANTO ANTONIO DO PINHAL",0,0,2,86,0,88,"2021"
"65267","354830 SANTO EXPEDITO",0,0,0,40,0,40,"2021"
"65268","354840 SANTOPOLIS DO AGUAPEI",0,0,0,43,0,43,"2021"
"65269","354850 SANTOS",7,17,83,3761,16,3884,"2021"
"65270","354860 SAO BENTO DO SAPUCAI",0,0,5,121,1,127,"2021"
"65271","354870 SAO BERNARDO DO CAMPO",15,19,119,8392,31,8576,"2021"
"65272","354880 SAO CAETANO DO SUL",1,5,5,1386,0,1397,"2021"
"65273","354890 SAO CARLOS",5,19,31,2777,5,2837,"2021"
"65274","354900 SAO FRANCISCO",0,0,0,19,0,19,"2021"
"65275","354910 SAO JOAO DA BOA VISTA",3,4,11,906,1,925,"2021"
"65276","354920 SAO JOAO DAS DUAS PONTES",0,0,0,13,0,13,"2021"
"65277","354925 SAO JOAO DE IRACEMA",0,0,0,20,0,20,"2021"
"65278","354930 SAO JOAO DO PAU D'ALHO",0,0,0,13,0,13,"2021"
"65279","354940 SAO JOAQUIM DA BARRA",1,4,7,487,0,499,"2021"
"65280","354950 SAO JOSE DA BELA VISTA",0,0,0,83,0,83,"2021"
"65281","354960 SAO JOSE DO BARREIRO",0,0,0,41,1,42,"2021"
"65282","354970 SAO JOSE DO RIO PARDO",2,1,6,533,0,542,"2021"
"65283","354980 SAO JOSE DO RIO PRETO",7,7,44,5141,7,5206,"2021"
"65284","354990 SAO JOSE DOS CAMPOS",21,34,83,8358,49,8545,"2021"
"65285","354995 SAO LOURENCO DA SERRA",1,0,3,170,1,175,"2021"
"65286","355000 SAO LUIS DO PARAITINGA",1,0,4,97,1,103,"2021"
"65287","355010 SAO MANUEL",2,1,10,423,0,436,"2021"
"65288","355020 SAO MIGUEL ARCANJO",2,3,2,347,0,354,"2021"
"65289","355030 SAO PAULO",353,525,1683,133538,633,136732,"2021"
"65290","355040 SAO PEDRO",0,0,6,390,0,396,"2021"
"65291","355050 SAO PEDRO DO TURVO",0,4,0,81,0,85,"2021"
"65292","355060 SAO ROQUE",7,1,9,875,5,897,"2021"
"65293","355070 SAO SEBASTIAO",1,6,19,1165,2,1193,"2021"
"65294","355080 SAO SEBASTIAO DA GRAMA",1,0,2,70,0,73,"2021"
"65295","355090 SAO SIMAO",0,0,0,117,0,117,"2021"
"65296","355100 SAO VICENTE",8,28,109,3703,32,3880,"2021"
"65297","355110 SARAPUI",0,0,1,105,0,106,"2021"
"65298","355120 SARUTAIA",0,0,0,45,0,45,"2021"
"65299","355130 SEBASTIANOPOLIS DO SUL",0,0,0,32,0,32,"2021"
"65300","355140 SERRA AZUL",0,0,2,107,0,109,"2021"
"65301","355150 SERRANA",4,3,8,509,3,527,"2021"
"65302","355160 SERRA NEGRA",0,1,4,290,0,295,"2021"
"65303","355170 SERTAOZINHO",9,2,9,1464,2,1486,"2021"
"65304","355180 SETE BARRAS",1,1,6,197,1,206,"2021"
"65305","355190 SEVERINIA",0,0,2,165,2,169,"2021"
"65306","355200 SILVEIRAS",0,0,1,68,0,69,"2021"
"65307","355210 SOCORRO",0,1,0,374,1,376,"2021"
"65308","355220 SOROCABA",18,40,137,8448,34,8677,"2021"
"65309","355230 SUD MENNUCCI",0,0,2,83,3,88,"2021"
"65310","355240 SUMARE",11,12,38,3324,11,3396,"2021"
"65311","355250 SUZANO",19,12,52,4101,4,4188,"2021"
"65312","355255 SUZANAPOLIS",0,0,1,46,0,47,"2021"
"65313","355260 TABAPUA",0,1,1,98,0,100,"2021"
"65314","355270 TABATINGA",0,0,1,181,0,182,"2021"
"65315","355280 TABOAO DA SERRA",3,12,34,3479,18,3546,"2021"
"65316","355290 TACIBA",1,0,1,81,0,83,"2021"
"65317","355300 TAGUAI",0,2,2,184,0,188,"2021"
"65318","355310 TAIACU",1,0,0,64,0,65,"2021"
"65319","355320 TAIUVA",0,0,1,44,0,45,"2021"
"65320","355330 TAMBAU",0,2,2,250,0,254,"2021"
"65321","355340 TANABI",2,0,1,260,2,265,"2021"
"65322","355350 TAPIRAI",1,0,0,97,1,99,"2021"
"65323","355360 TAPIRATIBA",0,0,5,91,0,96,"2021"
"65324","355365 TAQUARAL",1,0,0,19,0,20,"2021"
"65325","355370 TAQUARITINGA",1,2,8,538,1,550,"2021"
"65326","355380 TAQUARITUBA",0,1,3,283,0,287,"2021"
"65327","355385 TAQUARIVAI",0,0,3,90,1,94,"2021"
"65328","355390 TARABAI",0,0,0,66,0,66,"2021"
"65329","355395 TARUMA",1,1,0,170,0,172,"2021"
"65330","355400 TATUI",8,6,16,1483,0,1513,"2021"
"65331","355410 TAUBATE",8,16,70,3398,22,3514,"2021"
"65332","355420 TEJUPA",0,0,0,55,0,55,"2021"
"65333","355430 TEODORO SAMPAIO",0,1,5,291,0,297,"2021"
"65334","355440 TERRA ROXA",0,0,1,72,1,74,"2021"
"65335","355450 TIETE",2,1,3,438,0,444,"2021"
"65336","355460 TIMBURI",0,0,1,15,0,16,"2021"
"65337","355465 TORRE DE PEDRA",0,0,1,27,0,28,"2021"
"65338","355470 TORRINHA",0,0,0,87,0,87,"2021"
"65339","355475 TRABIJU",0,2,0,19,0,21,"2021"
"65340","355480 TREMEMBE",1,3,10,406,2,422,"2021"
"65341","355490 TRES FRONTEIRAS",1,0,1,65,0,67,"2021"
"65342","355495 TUIUTI",0,0,1,64,0,65,"2021"
"65343","355500 TUPA",2,2,8,658,0,670,"2021"
"65344","355510 TUPI PAULISTA",0,2,1,121,0,124,"2021"
"65345","355520 TURIUBA",0,0,0,13,0,13,"2021"
"65346","355530 TURMALINA",0,0,0,13,0,13,"2021"
"65347","355535 UBARANA",0,0,1,57,0,58,"2021"
"65348","355540 UBATUBA",1,6,18,1257,8,1290,"2021"
"65349","355550 UBIRAJARA",1,0,3,71,1,76,"2021"
"65350","355560 UCHOA",2,0,1,101,0,104,"2021"
"65351","355570 UNIAO PAULISTA",0,0,0,24,0,24,"2021"
"65352","355580 URANIA",0,0,0,78,0,78,"2021"
"65353","355590 URU",0,0,1,13,0,14,"2021"
"65354","355600 URUPES",1,1,0,134,0,136,"2021"
"65355","355610 VALENTIM GENTIL",0,1,2,151,0,154,"2021"
"65356","355620 VALINHOS",1,2,14,1228,2,1247,"2021"
"65357","355630 VALPARAISO",0,0,4,265,0,269,"2021"
"65358","355635 VARGEM",0,0,0,113,0,113,"2021"
"65359","355640 VARGEM GRANDE DO SUL",2,2,4,507,2,517,"2021"
"65360","355645 VARGEM GRANDE PAULISTA",5,0,10,696,4,715,"2021"
"65361","355650 VARZEA PAULISTA",1,3,19,1212,6,1241,"2021"
"65362","355660 VERA CRUZ",0,1,3,75,0,79,"2021"
"65363","355670 VINHEDO",1,5,7,810,1,824,"2021"
"65364","355680 VIRADOURO",2,0,3,200,1,206,"2021"
"65365","355690 VISTA ALEGRE DO ALTO",0,0,0,104,0,104,"2021"
"65366","355695 VITORIA BRASIL",1,0,0,17,0,18,"2021"
"65367","355700 VOTORANTIM",3,5,35,1486,0,1529,"2021"
"65368","355710 VOTUPORANGA",0,3,12,1092,1,1108,"2021"
"65369","355715 ZACARIAS",0,0,0,25,0,25,"2021"
"65370","355720 CHAVANTES",2,0,0,147,0,149,"2021"
"65371","355730 ESTIVA GERBI",0,0,1,126,0,127,"2021"
"65372","MUNICIPIO IGNORADO - PR",0,0,0,1,0,1,"2021"
"65373","410010 ABATIA",0,0,0,78,1,79,"2021"
"65374","410020 ADRIANOPOLIS",0,1,2,72,1,76,"2021"
"65375","410030 AGUDOS DO SUL",0,0,1,145,2,148,"2021"
"65376","410040 ALMIRANTE TAMANDARE",4,6,27,1542,5,1584,"2021"
"65377","410045 ALTAMIRA DO PARANA",0,0,1,59,0,60,"2021"
"65378","410050 ALTONIA",0,1,3,222,0,226,"2021"
"65379","410060 ALTO PARANA",1,2,0,151,0,154,"2021"
"65380","410070 ALTO PIQUIRI",0,0,1,114,0,115,"2021"
"65381","410080 ALVORADA DO SUL",0,0,0,100,0,100,"2021"
"65382","410090 AMAPORA",0,1,1,60,0,62,"2021"
"65383","410100 AMPERE",1,2,5,270,0,278,"2021"
"65384","410105 ANAHY",0,0,1,32,0,33,"2021"
"65385","410110 ANDIRA",0,0,5,200,0,205,"2021"
"65386","410115 ANGULO",0,0,1,42,0,43,"2021"
"65387","410120 ANTONINA",2,1,2,230,5,240,"2021"
"65388","410130 ANTONIO OLINTO",1,0,3,64,1,69,"2021"
"65389","410140 APUCARANA",5,10,17,1484,2,1518,"2021"
"65390","410150 ARAPONGAS",10,9,15,1423,0,1457,"2021"
"65391","410160 ARAPOTI",0,2,4,337,0,343,"2021"
"65392","410165 ARAPUA",0,0,0,47,0,47,"2021"
"65393","410170 ARARUNA",0,2,4,172,0,178,"2021"
"65394","410180 ARAUCARIA",3,5,32,1988,6,2034,"2021"
"65395","410185 ARIRANHA DO IVAI",0,0,2,22,0,24,"2021"
"65396","410190 ASSAI",0,0,1,129,1,131,"2021"
"65397","410200 ASSIS CHATEAUBRIAND",0,1,8,434,0,443,"2021"
"65398","410210 ASTORGA",1,2,5,286,1,295,"2021"
"65399","410220 ATALAIA",0,2,0,32,1,35,"2021"
"65400","410230 BALSA NOVA",1,0,4,156,1,162,"2021"
"65401","410240 BANDEIRANTES",0,3,5,374,0,382,"2021"
"65402","410250 BARBOSA FERRAZ",0,0,1,109,0,110,"2021"
"65403","410260 BARRACAO",0,0,0,119,0,119,"2021"
"65404","410270 BARRA DO JACARE",0,0,0,27,0,27,"2021"
"65405","410275 BELA VISTA DA CAROBA",1,0,1,32,0,34,"2021"
"65406","410280 BELA VISTA DO PARAISO",1,0,0,167,2,170,"2021"
"65407","410290 BITURUNA",1,1,2,270,0,274,"2021"
"65408","410300 BOA ESPERANCA",0,0,1,61,0,62,"2021"
"65409","410302 BOA ESPERANCA DO IGUACU",0,0,0,17,0,17,"2021"
"65410","410304 BOA VENTURA DE SAO ROQUE",0,0,0,72,0,72,"2021"
"65411","410305 BOA VISTA DA APARECIDA",1,1,0,107,0,109,"2021"
"65412","410310 BOCAIUVA DO SUL",0,1,2,186,0,189,"2021"
"65413","410315 BOM JESUS DO SUL",0,0,0,41,1,42,"2021"
"65414","410320 BOM SUCESSO",0,0,0,96,0,96,"2021"
"65415","410322 BOM SUCESSO DO SUL",1,0,0,39,0,40,"2021"
"65416","410330 BORRAZOPOLIS",1,0,0,66,0,67,"2021"
"65417","410335 BRAGANEY",0,0,3,48,0,51,"2021"
"65418","410337 BRASILANDIA DO SUL",0,1,0,46,0,47,"2021"
"65419","410340 CAFEARA",0,0,0,17,0,17,"2021"
"65420","410345 CAFELANDIA",0,2,18,304,0,324,"2021"
"65421","410347 CAFEZAL DO SUL",0,0,1,59,1,61,"2021"
"65422","410350 CALIFORNIA",1,2,3,109,1,116,"2021"
"65423","410360 CAMBARA",1,0,0,283,2,286,"2021"
"65424","410370 CAMBE",2,10,17,1201,4,1234,"2021"
"65425","410380 CAMBIRA",0,0,0,104,1,105,"2021"
"65426","410390 CAMPINA DA LAGOA",1,1,1,211,0,214,"2021"
"65427","410395 CAMPINA DO SIMAO",1,0,0,64,0,65,"2021"
"65428","410400 CAMPINA GRANDE DO SUL",1,3,7,637,0,648,"2021"
"65429","410405 CAMPO BONITO",0,0,0,40,0,40,"2021"
"65430","410410 CAMPO DO TENENTE",0,1,1,110,0,112,"2021"
"65431","410420 CAMPO LARGO",5,5,27,1467,12,1516,"2021"
"65432","410425 CAMPO MAGRO",0,1,4,378,3,386,"2021"
"65433","410430 CAMPO MOURAO",2,2,13,1262,2,1281,"2021"
"65434","410440 CANDIDO DE ABREU",0,2,2,192,0,196,"2021"
"65435","410442 CANDOI",0,0,4,218,0,222,"2021"
"65436","410445 CANTAGALO",0,1,2,174,1,178,"2021"
"65437","410450 CAPANEMA",0,1,3,240,1,245,"2021"
"65438","410460 CAPITAO LEONIDAS MARQUES",0,0,4,187,2,193,"2021"
"65439","410465 CARAMBEI",0,2,5,327,3,337,"2021"
"65440","410470 CARLOPOLIS",0,0,2,195,2,199,"2021"
"65441","410480 CASCAVEL",15,21,142,4726,1,4905,"2021"
"65442","410490 CASTRO",3,3,22,1112,4,1144,"2021"
"65443","410500 CATANDUVAS",1,0,2,133,0,136,"2021"
"65444","410510 CENTENARIO DO SUL",0,0,0,83,1,84,"2021"
"65445","410520 CERRO AZUL",1,1,0,206,2,210,"2021"
"65446","410530 CEU AZUL",1,0,3,122,0,126,"2021"
"65447","410540 CHOPINZINHO",0,0,9,303,1,313,"2021"
"65448","410550 CIANORTE",2,1,5,1001,0,1009,"2021"
"65449","410560 CIDADE GAUCHA",0,1,0,163,0,164,"2021"
"65450","410570 CLEVELANDIA",0,1,5,253,0,259,"2021"
"65451","410580 COLOMBO",14,11,45,2982,12,3064,"2021"
"65452","410590 COLORADO",2,2,1,279,0,284,"2021"
"65453","410600 CONGONHINHAS",0,0,1,99,1,101,"2021"
"65454","410610 CONSELHEIRO MAIRINCK",0,0,0,46,0,46,"2021"
"65455","410620 CONTENDA",1,2,5,200,1,209,"2021"
"65456","410630 CORBELIA",1,0,7,242,0,250,"2021"
"65457","410640 CORNELIO PROCOPIO",3,2,4,452,0,461,"2021"
"65458","410645 CORONEL DOMINGOS SOARES",0,0,0,116,0,116,"2021"
"65459","410650 CORONEL VIVIDA",1,2,2,337,0,342,"2021"
"65460","410655 CORUMBATAI DO SUL",0,0,0,41,0,41,"2021"
"65461","410657 CRUZEIRO DO IGUACU",0,0,1,45,1,47,"2021"
"65462","410660 CRUZEIRO DO OESTE",0,2,7,279,0,288,"2021"
"65463","410670 CRUZEIRO DO SUL",0,0,1,56,0,57,"2021"
"65464","410680 CRUZ MACHADO",0,0,3,196,2,201,"2021"
"65465","410685 CRUZMALTINA",0,0,2,40,0,42,"2021"
"65466","410690 CURITIBA",38,97,246,18120,74,18575,"2021"
"65467","410700 CURIUVA",0,0,2,162,1,165,"2021"
"65468","410710 DIAMANTE DO NORTE",0,0,0,46,0,46,"2021"
"65469","410712 DIAMANTE DO SUL",1,0,4,45,1,51,"2021"
"65470","410715 DIAMANTE D'OESTE",0,0,3,50,0,53,"2021"
"65471","410720 DOIS VIZINHOS",0,0,2,609,1,612,"2021"
"65472","410725 DOURADINA",0,0,1,118,0,119,"2021"
"65473","410730 DOUTOR CAMARGO",0,0,0,71,0,71,"2021"
"65474","410740 ENEAS MARQUES",0,0,2,69,0,71,"2021"
"65475","410750 ENGENHEIRO BELTRAO",0,1,2,137,0,140,"2021"
"65476","410752 ESPERANCA NOVA",0,0,0,26,0,26,"2021"
"65477","410753 ENTRE RIOS DO OESTE",0,0,2,53,0,55,"2021"
"65478","410754 ESPIGAO ALTO DO IGUACU",0,0,1,61,0,62,"2021"
"65479","410755 FAROL",0,0,0,31,0,31,"2021"
"65480","410760 FAXINAL",0,2,2,212,0,216,"2021"
"65481","410765 FAZENDA RIO GRANDE",2,9,33,1969,9,2022,"2021"
"65482","410770 FENIX",0,0,0,41,0,41,"2021"
"65483","410773 FERNANDES PINHEIRO",0,0,1,70,0,71,"2021"
"65484","410775 FIGUEIRA",0,0,0,98,0,98,"2021"
"65485","410780 FLORAI",0,0,0,40,0,40,"2021"
"65486","410785 FLOR DA SERRA DO SUL",0,1,2,68,0,71,"2021"
"65487","410790 FLORESTA",0,0,0,115,0,115,"2021"
"65488","410800 FLORESTOPOLIS",0,0,0,131,0,131,"2021"
"65489","410810 FLORIDA",1,1,0,30,0,32,"2021"
"65490","410820 FORMOSA DO OESTE",0,0,3,98,0,101,"2021"
"65491","410830 FOZ DO IGUACU",6,13,56,3840,21,3936,"2021"
"65492","410832 FRANCISCO ALVES",1,0,3,120,0,124,"2021"
"65493","410840 FRANCISCO BELTRAO",1,9,26,1247,0,1283,"2021"
"65494","410845 FOZ DO JORDAO",1,1,1,72,0,75,"2021"
"65495","410850 GENERAL CARNEIRO",0,0,1,175,1,177,"2021"
"65496","410855 GODOY MOREIRA",0,0,0,21,1,22,"2021"
"65497","410860 GOIOERE",0,0,1,319,0,320,"2021"
"65498","410865 GOIOXIM",0,0,1,86,0,87,"2021"
"65499","410870 GRANDES RIOS",0,1,2,57,0,60,"2021"
"65500","410880 GUAIRA",1,1,8,458,3,471,"2021"
"65501","410890 GUAIRACA",0,0,0,94,0,94,"2021"
"65502","410895 GUAMIRANGA",0,0,1,96,1,98,"2021"
"65503","410900 GUAPIRAMA",0,1,2,54,0,57,"2021"
"65504","410910 GUAPOREMA",0,0,1,22,0,23,"2021"
"65505","410920 GUARACI",0,1,1,35,1,38,"2021"
"65506","410930 GUARANIACU",0,1,5,157,0,163,"2021"
"65507","410940 GUARAPUAVA",6,1,26,2689,1,2723,"2021"
"65508","410950 GUARAQUECABA",0,0,2,94,2,98,"2021"
"65509","410960 GUARATUBA",3,3,15,497,1,519,"2021"
"65510","410965 HONORIO SERPA",0,0,1,59,0,60,"2021"
"65511","410970 IBAITI",1,0,7,355,1,364,"2021"
"65512","410975 IBEMA",0,1,1,76,1,79,"2021"
"65513","410980 IBIPORA",3,2,6,565,0,576,"2021"
"65514","410990 ICARAIMA",0,0,0,90,0,90,"2021"
"65515","411000 IGUARACU",0,1,2,56,0,59,"2021"
"65516","411005 IGUATU",0,0,1,18,0,19,"2021"
"65517","411007 IMBAU",1,1,0,182,1,185,"2021"
"65518","411010 IMBITUVA",2,2,5,489,0,498,"2021"
"65519","411020 INACIO MARTINS",1,3,3,164,0,171,"2021"
"65520","411030 INAJA",0,0,0,22,0,22,"2021"
"65521","411040 INDIANOPOLIS",0,0,1,57,0,58,"2021"
"65522","411050 IPIRANGA",2,0,4,174,0,180,"2021"
"65523","411060 IPORA",1,0,4,211,0,216,"2021"
"65524","411065 IRACEMA DO OESTE",0,0,2,20,0,22,"2021"
"65525","411070 IRATI",4,4,9,682,1,700,"2021"
"65526","411080 IRETAMA",1,0,1,120,0,122,"2021"
"65527","411090 ITAGUAJE",0,0,2,62,0,64,"2021"
"65528","411095 ITAIPULANDIA",0,0,1,165,1,167,"2021"
"65529","411100 ITAMBARACA",0,1,0,57,1,59,"2021"
"65530","411110 ITAMBE",0,1,3,60,0,64,"2021"
"65531","411120 ITAPEJARA D'OESTE",0,1,1,140,0,142,"2021"
"65532","411125 ITAPERUCU",0,1,9,467,2,479,"2021"
"65533","411130 ITAUNA DO SUL",0,1,0,41,0,42,"2021"
"65534","411140 IVAI",0,0,3,188,0,191,"2021"
"65535","411150 IVAIPORA",0,1,10,329,0,340,"2021"
"65536","411155 IVATE",0,0,2,72,0,74,"2021"
"65537","411160 IVATUBA",0,0,2,21,1,24,"2021"
"65538","411170 JABOTI",0,0,0,55,1,56,"2021"
"65539","411180 JACAREZINHO",5,0,3,572,0,580,"2021"
"65540","411190 JAGUAPITA",0,1,1,178,0,180,"2021"
"65541","411200 JAGUARIAIVA",0,2,7,471,1,481,"2021"
"65542","411210 JANDAIA DO SUL",0,0,4,248,0,252,"2021"
"65543","411220 JANIOPOLIS",0,0,0,67,0,67,"2021"
"65544","411230 JAPIRA",0,1,0,74,0,75,"2021"
"65545","411240 JAPURA",0,0,0,75,0,75,"2021"
"65546","411250 JARDIM ALEGRE",2,2,2,127,1,134,"2021"
"65547","411260 JARDIM OLINDA",0,0,0,17,0,17,"2021"
"65548","411270 JATAIZINHO",0,1,3,152,0,156,"2021"
"65549","411275 JESUITAS",0,0,1,81,0,82,"2021"
"65550","411280 JOAQUIM TAVORA",1,0,4,168,0,173,"2021"
"65551","411290 JUNDIAI DO SUL",0,0,0,44,0,44,"2021"
"65552","411295 JURANDA",0,2,0,111,0,113,"2021"
"65553","411300 JUSSARA",0,0,0,73,0,73,"2021"
"65554","411310 KALORE",0,0,1,44,0,45,"2021"
"65555","411320 LAPA",0,0,16,533,0,549,"2021"
"65556","411325 LARANJAL",0,1,1,84,0,86,"2021"
"65557","411330 LARANJEIRAS DO SUL",0,3,6,438,2,449,"2021"
"65558","411340 LEOPOLIS",0,0,0,33,0,33,"2021"
"65559","411342 LIDIANOPOLIS",0,0,0,44,0,44,"2021"
"65560","411345 LINDOESTE",0,1,1,60,0,62,"2021"
"65561","411350 LOANDA",0,0,0,304,0,304,"2021"
"65562","411360 LOBATO",0,0,0,49,0,49,"2021"
"65563","411370 LONDRINA",17,26,79,6107,24,6253,"2021"
"65564","411373 LUIZIANA",0,0,2,89,0,91,"2021"
"65565","411375 LUNARDELLI",0,0,0,38,0,38,"2021"
"65566","411380 LUPIONOPOLIS",1,0,2,55,0,58,"2021"
"65567","411390 MALLET",0,1,4,145,0,150,"2021"
"65568","411400 MAMBORE",0,1,0,179,0,180,"2021"
"65569","411410 MANDAGUACU",3,1,6,406,0,416,"2021"
"65570","411420 MANDAGUARI",0,2,5,439,0,446,"2021"
"65571","411430 MANDIRITUBA",0,1,7,339,2,349,"2021"
"65572","411435 MANFRINOPOLIS",0,0,0,27,0,27,"2021"
"65573","411440 MANGUEIRINHA",1,0,5,299,2,307,"2021"
"65574","411450 MANOEL RIBAS",0,0,5,167,0,172,"2021"
"65575","411460 MARECHAL CANDIDO RONDON",2,2,10,748,3,765,"2021"
"65576","411470 MARIA HELENA",0,1,0,66,0,67,"2021"
"65577","411480 MARIALVA",2,0,6,502,1,511,"2021"
"65578","411490 MARILANDIA DO SUL",1,0,0,86,0,87,"2021"
"65579","411500 MARILENA",1,0,2,81,0,84,"2021"
"65580","411510 MARILUZ",0,1,3,110,0,114,"2021"
"65581","411520 MARINGA",12,18,68,4364,4,4466,"2021"
"65582","411530 MARIOPOLIS",0,0,0,85,0,85,"2021"
"65583","411535 MARIPA",0,0,3,62,0,65,"2021"
"65584","411540 MARMELEIRO",0,1,4,212,0,217,"2021"
"65585","411545 MARQUINHO",0,0,2,55,0,57,"2021"
"65586","411550 MARUMBI",0,0,0,53,0,53,"2021"
"65587","411560 MATELANDIA",2,3,5,273,0,283,"2021"
"65588","411570 MATINHOS",1,4,9,480,2,496,"2021"
"65589","411573 MATO RICO",0,1,0,46,0,47,"2021"
"65590","411575 MAUA DA SERRA",0,1,2,173,1,177,"2021"
"65591","411580 MEDIANEIRA",3,5,14,747,1,770,"2021"
"65592","411585 MERCEDES",1,0,0,50,0,51,"2021"
"65593","411590 MIRADOR",0,0,0,33,0,33,"2021"
"65594","411600 MIRASELVA",0,0,0,16,0,16,"2021"
"65595","411605 MISSAL",1,0,0,117,2,120,"2021"
"65596","411610 MOREIRA SALES",0,1,1,118,0,120,"2021"
"65597","411620 MORRETES",0,2,4,193,1,200,"2021"
"65598","411630 MUNHOZ DE MELO",0,0,3,47,0,50,"2021"
"65599","411640 NOSSA SENHORA DAS GRACAS",0,0,1,43,0,44,"2021"
"65600","411650 NOVA ALIANCA DO IVAI",0,0,1,22,0,23,"2021"
"65601","411660 NOVA AMERICA DA COLINA",0,0,0,37,0,37,"2021"
"65602","411670 NOVA AURORA",0,0,1,128,0,129,"2021"
"65603","411680 NOVA CANTU",0,0,0,89,0,89,"2021"
"65604","411690 NOVA ESPERANCA",1,1,12,267,1,282,"2021"
"65605","411695 NOVA ESPERANCA DO SUDOESTE",0,0,0,53,0,53,"2021"
"65606","411700 NOVA FATIMA",0,0,1,77,0,78,"2021"
"65607","411705 NOVA LARANJEIRAS",0,0,2,161,2,165,"2021"
"65608","411710 NOVA LONDRINA",0,0,0,141,1,142,"2021"
"65609","411720 NOVA OLIMPIA",0,0,0,68,0,68,"2021"
"65610","411721 NOVA SANTA BARBARA",1,0,0,55,0,56,"2021"
"65611","411722 NOVA SANTA ROSA",0,0,1,106,0,107,"2021"
"65612","411725 NOVA PRATA DO IGUACU",0,1,0,119,0,120,"2021"
"65613","411727 NOVA TEBAS",0,2,0,89,1,92,"2021"
"65614","411729 NOVO ITACOLOMI",0,0,1,34,0,35,"2021"
"65615","411730 ORTIGUEIRA",0,2,5,354,0,361,"2021"
"65616","411740 OURIZONA",0,0,1,31,0,32,"2021"
"65617","411745 OURO VERDE DO OESTE",1,0,2,84,2,89,"2021"
"65618","411750 PAICANDU",3,3,12,597,0,615,"2021"
"65619","411760 PALMAS",1,2,5,819,0,827,"2021"
"65620","411770 PALMEIRA",0,2,10,439,3,454,"2021"
"65621","411780 PALMITAL",0,0,2,184,0,186,"2021"
"65622","411790 PALOTINA",1,3,3,491,0,498,"2021"
"65623","411800 PARAISO DO NORTE",0,0,2,177,0,179,"2021"
"65624","411810 PARANACITY",0,0,2,124,0,126,"2021"
"65625","411820 PARANAGUA",1,13,16,2102,11,2143,"2021"
"65626","411830 PARANAPOEMA",0,0,0,27,0,27,"2021"
"65627","411840 PARANAVAI",0,5,4,1127,1,1137,"2021"
"65628","411845 PATO BRAGADO",0,0,1,80,1,82,"2021"
"65629","411850 PATO BRANCO",4,3,14,1236,0,1257,"2021"
"65630","411860 PAULA FREITAS",0,1,0,72,0,73,"2021"
"65631","411870 PAULO FRONTIN",0,0,1,60,0,61,"2021"
"65632","411880 PEABIRU",0,1,2,139,0,142,"2021"
"65633","411885 PEROBAL",0,1,1,97,0,99,"2021"
"65634","411890 PEROLA",1,0,3,146,0,150,"2021"
"65635","411900 PEROLA D'OESTE",0,0,0,73,0,73,"2021"
"65636","411910 PIEN",0,0,5,177,0,182,"2021"
"65637","411915 PINHAIS",5,2,16,1490,4,1517,"2021"
"65638","411920 PINHALAO",1,0,2,106,0,109,"2021"
"65639","411925 PINHAL DE SAO BENTO",0,0,0,32,0,32,"2021"
"65640","411930 PINHAO",0,2,5,501,0,508,"2021"
"65641","411940 PIRAI DO SUL",1,1,5,279,1,287,"2021"
"65642","411950 PIRAQUARA",3,7,14,1398,7,1429,"2021"
"65643","411960 PITANGA",0,2,2,480,0,484,"2021"
"65644","411965 PITANGUEIRAS",0,0,0,34,0,34,"2021"
"65645","411970 PLANALTINA DO PARANA",0,0,0,49,0,49,"2021"
"65646","411980 PLANALTO",1,0,0,114,0,115,"2021"
"65647","411990 PONTA GROSSA",13,37,117,4558,2,4727,"2021"
"65648","411995 PONTAL DO PARANA",3,3,4,305,1,316,"2021"
"65649","412000 PORECATU",0,0,4,94,0,98,"2021"
"65650","412010 PORTO AMAZONAS",0,0,1,37,0,38,"2021"
"65651","412015 PORTO BARREIRO",0,0,2,29,0,31,"2021"
"65652","412020 PORTO RICO",0,0,0,39,0,39,"2021"
"65653","412030 PORTO VITORIA",0,0,2,40,0,42,"2021"
"65654","412033 PRADO FERREIRA",0,1,0,48,0,49,"2021"
"65655","412035 PRANCHITA",0,0,1,76,0,77,"2021"
"65656","412040 PRESIDENTE CASTELO BRANCO",0,0,1,45,0,46,"2021"
"65657","412050 PRIMEIRO DE MAIO",0,0,0,96,0,96,"2021"
"65658","412060 PRUDENTOPOLIS",0,1,3,634,0,638,"2021"
"65659","412065 QUARTO CENTENARIO",0,0,0,45,0,45,"2021"
"65660","412070 QUATIGUA",0,0,0,99,0,99,"2021"
"65661","412080 QUATRO BARRAS",2,1,7,283,0,293,"2021"
"65662","412085 QUATRO PONTES",0,0,1,48,0,49,"2021"
"65663","412090 QUEDAS DO IGUACU",1,4,12,436,0,453,"2021"
"65664","412100 QUERENCIA DO NORTE",0,0,0,162,0,162,"2021"
"65665","412110 QUINTA DO SOL",0,0,0,66,0,66,"2021"
"65666","412120 QUITANDINHA",0,0,2,222,1,225,"2021"
"65667","412125 RAMILANDIA",0,0,3,58,0,61,"2021"
"65668","412130 RANCHO ALEGRE",0,0,0,27,0,27,"2021"
"65669","412135 RANCHO ALEGRE D'OESTE",0,0,1,24,0,25,"2021"
"65670","412140 REALEZA",1,0,4,231,0,236,"2021"
"65671","412150 REBOUCAS",1,0,2,175,0,178,"2021"
"65672","412160 RENASCENCA",0,1,1,103,0,105,"2021"
"65673","412170 RESERVA",0,6,7,375,2,390,"2021"
"65674","412175 RESERVA DO IGUACU",0,0,0,117,0,117,"2021"
"65675","412180 RIBEIRAO CLARO",0,0,1,134,0,135,"2021"
"65676","412190 RIBEIRAO DO PINHAL",2,0,2,152,0,156,"2021"
"65677","412200 RIO AZUL",0,0,0,192,1,193,"2021"
"65678","412210 RIO BOM",0,0,0,26,0,26,"2021"
"65679","412215 RIO BONITO DO IGUACU",0,1,4,218,2,225,"2021"
"65680","412217 RIO BRANCO DO IVAI",0,0,2,42,0,44,"2021"
"65681","412220 RIO BRANCO DO SUL",1,5,3,530,3,542,"2021"
"65682","412230 RIO NEGRO",0,0,5,340,0,345,"2021"
"65683","412240 ROLANDIA",4,5,8,811,2,830,"2021"
"65684","412250 RONCADOR",0,0,1,148,0,149,"2021"
"65685","412260 RONDON",0,3,0,110,0,113,"2021"
"65686","412265 ROSARIO DO IVAI",0,0,0,53,1,54,"2021"
"65687","412270 SABAUDIA",2,0,1,125,0,128,"2021"
"65688","412280 SALGADO FILHO",0,0,1,56,0,57,"2021"
"65689","412290 SALTO DO ITARARE",0,0,0,59,0,59,"2021"
"65690","412300 SALTO DO LONTRA",0,0,3,184,0,187,"2021"
"65691","412310 SANTA AMELIA",0,0,0,50,0,50,"2021"
"65692","412320 SANTA CECILIA DO PAVAO",1,0,0,45,0,46,"2021"
"65693","412330 SANTA CRUZ DE MONTE CASTELO",0,1,1,107,0,109,"2021"
"65694","412340 SANTA FE",1,1,3,134,0,139,"2021"
"65695","412350 SANTA HELENA",0,1,1,308,3,313,"2021"
"65696","412360 SANTA INES",0,0,0,23,0,23,"2021"
"65697","412370 SANTA ISABEL DO IVAI",1,0,1,85,1,88,"2021"
"65698","412380 SANTA IZABEL DO OESTE",1,0,4,164,1,170,"2021"
"65699","412382 SANTA LUCIA",0,0,1,55,0,56,"2021"
"65700","412385 SANTA MARIA DO OESTE",2,0,4,145,0,151,"2021"
"65701","412390 SANTA MARIANA",0,0,3,134,1,138,"2021"
"65702","412395 SANTA MONICA",0,0,1,37,0,38,"2021"
"65703","412400 SANTANA DO ITARARE",0,0,0,50,0,50,"2021"
"65704","412402 SANTA TEREZA DO OESTE",1,2,2,175,0,180,"2021"
"65705","412405 SANTA TEREZINHA DE ITAIPU",3,2,5,323,9,342,"2021"
"65706","412410 SANTO ANTONIO DA PLATINA",2,0,5,573,0,580,"2021"
"65707","412420 SANTO ANTONIO DO CAIUA",0,0,1,24,0,25,"2021"
"65708","412430 SANTO ANTONIO DO PARAISO",0,0,0,17,0,17,"2021"
"65709","412440 SANTO ANTONIO DO SUDOESTE",0,0,0,243,1,244,"2021"
"65710","412450 SANTO INACIO",0,1,2,98,0,101,"2021"
"65711","412460 SAO CARLOS DO IVAI",0,0,1,78,0,79,"2021"
"65712","412470 SAO JERONIMO DA SERRA",0,0,4,147,1,152,"2021"
"65713","412480 SAO JOAO",0,2,2,130,0,134,"2021"
"65714","412490 SAO JOAO DO CAIUA",0,1,3,88,0,92,"2021"
"65715","412500 SAO JOAO DO IVAI",0,0,2,115,0,117,"2021"
"65716","412510 SAO JOAO DO TRIUNFO",0,3,6,164,0,173,"2021"
"65717","412520 SAO JORGE D'OESTE",1,0,5,112,1,119,"2021"
"65718","412530 SAO JORGE DO IVAI",0,1,0,44,0,45,"2021"
"65719","412535 SAO JORGE DO PATROCINIO",0,0,1,93,0,94,"2021"
"65720","412540 SAO JOSE DA BOA VISTA",0,0,1,59,0,60,"2021"
"65721","412545 SAO JOSE DAS PALMEIRAS",0,0,1,36,0,37,"2021"
"65722","412550 SAO JOSE DOS PINHAIS",7,16,127,4153,12,4315,"2021"
"65723","412555 SAO MANOEL DO PARANA",0,0,1,27,0,28,"2021"
"65724","412560 SAO MATEUS DO SUL",1,0,8,578,3,590,"2021"
"65725","412570 SAO MIGUEL DO IGUACU",0,0,4,388,2,394,"2021"
"65726","412575 SAO PEDRO DO IGUACU",1,0,2,65,0,68,"2021"
"65727","412580 SAO PEDRO DO IVAI",0,0,2,115,0,117,"2021"
"65728","412590 SAO PEDRO DO PARANA",0,0,0,34,0,34,"2021"
"65729","412600 SAO SEBASTIAO DA AMOREIRA",0,1,2,64,0,67,"2021"
"65730","412610 SAO TOME",2,1,0,58,0,61,"2021"
"65731","412620 SAPOPEMA",0,0,2,95,0,97,"2021"
"65732","412625 SARANDI",2,4,19,1502,2,1529,"2021"
"65733","412627 SAUDADE DO IGUACU",1,0,2,86,0,89,"2021"
"65734","412630 SENGES",0,1,2,224,0,227,"2021"
"65735","412635 SERRANOPOLIS DO IGUACU",1,0,0,53,0,54,"2021"
"65736","412640 SERTANEJA",0,0,0,48,0,48,"2021"
"65737","412650 SERTANOPOLIS",0,1,0,167,0,168,"2021"
"65738","412660 SIQUEIRA CAMPOS",0,2,3,285,2,292,"2021"
"65739","412665 SULINA",0,0,0,39,0,39,"2021"
"65740","412667 TAMARANA",0,0,4,142,1,147,"2021"
"65741","412670 TAMBOARA",0,0,0,60,1,61,"2021"
"65742","412680 TAPEJARA",0,0,1,165,0,166,"2021"
"65743","412690 TAPIRA",0,0,1,60,0,61,"2021"
"65744","412700 TEIXEIRA SOARES",1,0,1,97,0,99,"2021"
"65745","412710 TELEMACO BORBA",1,5,11,1004,5,1026,"2021"
"65746","412720 TERRA BOA",0,0,2,236,0,238,"2021"
"65747","412730 TERRA RICA",0,1,0,185,0,186,"2021"
"65748","412740 TERRA ROXA",0,3,5,230,2,240,"2021"
"65749","412750 TIBAGI",0,1,2,295,0,298,"2021"
"65750","412760 TIJUCAS DO SUL",0,0,4,207,2,213,"2021"
"65751","412770 TOLEDO",4,10,37,1905,3,1959,"2021"
"65752","412780 TOMAZINA",1,0,2,80,0,83,"2021"
"65753","412785 TRES BARRAS DO PARANA",1,0,4,130,0,135,"2021"
"65754","412788 TUNAS DO PARANA",1,0,1,96,0,98,"2021"
"65755","412790 TUNEIRAS DO OESTE",0,0,0,119,0,119,"2021"
"65756","412795 TUPASSI",0,0,1,71,0,72,"2021"
"65757","412796 TURVO",0,1,1,211,0,213,"2021"
"65758","412800 UBIRATA",0,0,2,295,0,297,"2021"
"65759","412810 UMUARAMA",3,7,25,1478,2,1515,"2021"
"65760","412820 UNIAO DA VITORIA",0,0,13,752,1,766,"2021"
"65761","412830 UNIFLOR",0,0,0,25,1,26,"2021"
"65762","412840 URAI",0,0,1,96,0,97,"2021"
"65763","412850 WENCESLAU BRAZ",0,1,4,236,1,242,"2021"
"65764","412853 VENTANIA",0,3,2,112,0,117,"2021"
"65765","412855 VERA CRUZ DO OESTE",0,0,3,82,0,85,"2021"
"65766","412860 VERE",0,0,1,83,0,84,"2021"
"65767","412862 ALTO PARAISO",0,0,0,41,0,41,"2021"
"65768","412863 DOUTOR ULYSSES",2,1,1,68,0,72,"2021"
"65769","412865 VIRMOND",0,1,0,33,1,35,"2021"
"65770","412870 VITORINO",0,0,0,114,0,114,"2021"
"65771","412880 XAMBRE",0,0,1,71,0,72,"2021"
"65772","MUNICIPIO IGNORADO - SC",0,0,0,1,0,1,"2021"
"65773","420005 ABDON BATISTA",0,0,0,21,0,21,"2021"
"65774","420010 ABELARDO LUZ",3,1,2,303,0,309,"2021"
"65775","420020 AGROLANDIA",0,2,6,128,0,136,"2021"
"65776","420030 AGRONOMICA",0,0,1,79,0,80,"2021"
"65777","420040 AGUA DOCE",0,0,1,80,0,81,"2021"
"65778","420050 AGUAS DE CHAPECO",2,2,0,85,1,90,"2021"
"65779","420055 AGUAS FRIAS",0,0,0,38,0,38,"2021"
"65780","420060 AGUAS MORNAS",0,0,2,81,0,83,"2021"
"65781","420070 ALFREDO WAGNER",0,0,2,97,0,99,"2021"
"65782","420075 ALTO BELA VISTA",0,0,1,17,0,18,"2021"
"65783","420080 ANCHIETA",0,0,2,71,0,73,"2021"
"65784","420090 ANGELINA",0,0,1,56,0,57,"2021"
"65785","420100 ANITA GARIBALDI",0,1,4,98,1,104,"2021"
"65786","420110 ANITAPOLIS",0,0,0,50,0,50,"2021"
"65787","420120 ANTONIO CARLOS",0,0,3,143,1,147,"2021"
"65788","420125 APIUNA",0,1,5,101,0,107,"2021"
"65789","420127 ARABUTA",0,0,2,41,0,43,"2021"
"65790","420130 ARAQUARI",4,4,15,615,9,647,"2021"
"65791","420140 ARARANGUA",1,3,14,920,0,938,"2021"
"65792","420150 ARMAZEM",0,0,1,117,0,118,"2021"
"65793","420160 ARROIO TRINTA",0,0,0,36,0,36,"2021"
"65794","420165 ARVOREDO",0,0,2,26,0,28,"2021"
"65795","420170 ASCURRA",1,0,2,129,0,132,"2021"
"65796","420180 ATALANTA",0,0,4,38,0,42,"2021"
"65797","420190 AURORA",0,0,3,93,0,96,"2021"
"65798","420195 BALNEARIO ARROIO DO SILVA",1,0,6,175,0,182,"2021"
"65799","420200 BALNEARIO CAMBORIU",1,5,16,1612,6,1640,"2021"
"65800","420205 BALNEARIO BARRA DO SUL",1,0,5,161,1,168,"2021"
"65801","420207 BALNEARIO GAIVOTA",0,1,0,178,2,181,"2021"
"65802","420208 BANDEIRANTE",0,0,0,25,0,25,"2021"
"65803","420209 BARRA BONITA",0,0,0,19,0,19,"2021"
"65804","420210 BARRA VELHA",3,0,10,531,4,548,"2021"
"65805","420213 BELA VISTA DO TOLDO",0,0,1,63,0,64,"2021"
"65806","420215 BELMONTE",0,0,0,40,0,40,"2021"
"65807","420220 BENEDITO NOVO",0,0,1,97,1,99,"2021"
"65808","420230 BIGUACU",1,2,13,925,4,945,"2021"
"65809","420240 BLUMENAU",6,8,43,4163,5,4225,"2021"
"65810","420243 BOCAINA DO SUL",0,0,5,39,2,46,"2021"
"65811","420245 BOMBINHAS",0,3,5,302,6,316,"2021"
"65812","420250 BOM JARDIM DA SERRA",0,0,1,31,0,32,"2021"
"65813","420253 BOM JESUS",0,0,0,31,0,31,"2021"
"65814","420257 BOM JESUS DO OESTE",0,0,0,32,0,32,"2021"
"65815","420260 BOM RETIRO",0,2,7,114,1,124,"2021"
"65816","420270 BOTUVERA",0,0,0,78,1,79,"2021"
"65817","420280 BRACO DO NORTE",1,0,6,565,0,572,"2021"
"65818","420285 BRACO DO TROMBUDO",0,0,1,46,0,47,"2021"
"65819","420287 BRUNOPOLIS",0,1,0,29,0,30,"2021"
"65820","420290 BRUSQUE",5,5,11,2028,8,2057,"2021"
"65821","420300 CACADOR",6,3,14,1050,3,1076,"2021"
"65822","420310 CAIBI",0,0,1,67,0,68,"2021"
"65823","420315 CALMON",0,1,1,60,0,62,"2021"
"65824","420320 CAMBORIU",2,2,25,1450,10,1489,"2021"
"65825","420325 CAPAO ALTO",0,1,0,32,0,33,"2021"
"65826","420330 CAMPO ALEGRE",0,0,1,125,0,126,"2021"
"65827","420340 CAMPO BELO DO SUL",0,1,2,83,0,86,"2021"
"65828","420350 CAMPO ERE",1,1,3,148,0,153,"2021"
"65829","420360 CAMPOS NOVOS",2,2,4,516,1,525,"2021"
"65830","420370 CANELINHA",1,0,0,147,5,153,"2021"
"65831","420380 CANOINHAS",1,2,11,760,3,777,"2021"
"65832","420390 CAPINZAL",1,0,4,330,2,337,"2021"
"65833","420395 CAPIVARI DE BAIXO",0,1,1,277,0,279,"2021"
"65834","420400 CATANDUVAS",1,0,1,173,0,175,"2021"
"65835","420410 CAXAMBU DO SUL",0,0,1,53,0,54,"2021"
"65836","420415 CELSO RAMOS",1,0,0,26,0,27,"2021"
"65837","420417 CERRO NEGRO",0,0,1,49,0,50,"2021"
"65838","420419 CHAPADAO DO LAGEADO",0,0,2,29,0,31,"2021"
"65839","420420 CHAPECO",13,20,59,3586,1,3679,"2021"
"65840","420425 COCAL DO SUL",2,0,6,211,1,220,"2021"
"65841","420430 CONCORDIA",3,3,20,1062,1,1089,"2021"
"65842","420435 CORDILHEIRA ALTA",1,1,2,44,0,48,"2021"
"65843","420440 CORONEL FREITAS",0,1,1,118,0,120,"2021"
"65844","420445 CORONEL MARTINS",0,0,1,21,0,22,"2021"
"65845","420450 CORUPA",0,0,4,159,0,163,"2021"
"65846","420455 CORREIA PINTO",1,0,19,180,0,200,"2021"
"65847","420460 CRICIUMA",5,9,53,2678,13,2758,"2021"
"65848","420470 CUNHA PORA",0,0,4,136,0,140,"2021"
"65849","420475 CUNHATAI",0,0,0,18,0,18,"2021"
"65850","420480 CURITIBANOS",0,2,13,575,2,592,"2021"
"65851","420490 DESCANSO",0,0,0,84,0,84,"2021"
"65852","420500 DIONISIO CERQUEIRA",0,1,2,189,1,193,"2021"
"65853","420510 DONA EMMA",1,0,1,44,2,48,"2021"
"65854","420515 DOUTOR PEDRINHO",0,0,0,32,0,32,"2021"
"65855","420517 ENTRE RIOS",0,2,0,54,2,58,"2021"
"65856","420519 ERMO",0,0,1,33,0,34,"2021"
"65857","420520 ERVAL VELHO",0,0,1,45,0,46,"2021"
"65858","420530 FAXINAL DOS GUEDES",0,1,0,162,0,163,"2021"
"65859","420535 FLOR DO SERTAO",0,1,1,17,0,19,"2021"
"65860","420540 FLORIANOPOLIS",12,20,101,5733,36,5902,"2021"
"65861","420543 FORMOSA DO SUL",1,1,2,35,0,39,"2021"
"65862","420545 FORQUILHINHA",1,0,15,415,5,436,"2021"
"65863","420550 FRAIBURGO",1,2,6,503,1,513,"2021"
"65864","420555 FREI ROGERIO",0,0,2,23,0,25,"2021"
"65865","420560 GALVAO",0,0,0,33,1,34,"2021"
"65866","420570 GAROPABA",1,2,4,338,2,347,"2021"
"65867","420580 GARUVA",1,1,11,286,2,301,"2021"
"65868","420590 GASPAR",3,6,7,875,2,893,"2021"
"65869","420600 GOVERNADOR CELSO RAMOS",0,1,2,160,2,165,"2021"
"65870","420610 GRAO PARA",0,0,2,90,0,92,"2021"
"65871","420620 GRAVATAL",1,1,0,132,0,134,"2021"
"65872","420630 GUABIRUBA",2,0,3,297,2,304,"2021"
"65873","420640 GUARACIABA",0,0,2,102,0,104,"2021"
"65874","420650 GUARAMIRIM",0,4,9,651,0,664,"2021"
"65875","420660 GUARUJA DO SUL",0,0,0,49,0,49,"2021"
"65876","420665 GUATAMBU",0,1,3,119,0,123,"2021"
"65877","420670 HERVAL D'OESTE",0,0,3,272,2,277,"2021"
"65878","420675 IBIAM",0,0,0,12,0,12,"2021"
"65879","420680 IBICARE",0,0,1,32,0,33,"2021"
"65880","420690 IBIRAMA",1,0,12,229,0,242,"2021"
"65881","420700 ICARA",0,4,8,680,0,692,"2021"
"65882","420710 ILHOTA",0,0,2,199,3,204,"2021"
"65883","420720 IMARUI",1,1,1,88,0,91,"2021"
"65884","420730 IMBITUBA",2,0,9,589,0,600,"2021"
"65885","420740 IMBUIA",0,1,3,65,0,69,"2021"
"65886","420750 INDAIAL",4,1,14,936,0,955,"2021"
"65887","420757 IOMERE",0,0,0,21,0,21,"2021"
"65888","420760 IPIRA",0,0,0,48,0,48,"2021"
"65889","420765 IPORA DO OESTE",0,0,2,125,0,127,"2021"
"65890","420768 IPUACU",0,0,3,140,0,143,"2021"
"65891","420770 IPUMIRIM",1,1,0,101,0,103,"2021"
"65892","420775 IRACEMINHA",1,0,3,43,0,47,"2021"
"65893","420780 IRANI",0,0,3,121,0,124,"2021"
"65894","420785 IRATI",0,0,0,15,0,15,"2021"
"65895","420790 IRINEOPOLIS",0,0,2,143,1,146,"2021"
"65896","420800 ITA",0,2,3,75,1,81,"2021"
"65897","420810 ITAIOPOLIS",1,0,2,316,1,320,"2021"
"65898","420820 ITAJAI",7,9,37,3534,15,3602,"2021"
"65899","420830 ITAPEMA",2,5,17,1021,9,1054,"2021"
"65900","420840 ITAPIRANGA",0,2,0,251,0,253,"2021"
"65901","420845 ITAPOA",3,1,9,337,7,357,"2021"
"65902","420850 ITUPORANGA",0,4,16,382,0,402,"2021"
"65903","420860 JABORA",0,0,0,55,0,55,"2021"
"65904","420870 JACINTO MACHADO",0,1,1,139,0,141,"2021"
"65905","420880 JAGUARUNA",1,1,4,288,1,295,"2021"
"65906","420890 JARAGUA DO SUL",1,7,42,2259,2,2311,"2021"
"65907","420895 JARDINOPOLIS",0,1,0,17,0,18,"2021"
"65908","420900 JOACABA",2,2,4,377,1,386,"2021"
"65909","420910 JOINVILLE",14,32,169,7155,18,7388,"2021"
"65910","420915 JOSE BOITEUX",0,0,3,112,1,116,"2021"
"65911","420917 JUPIA",0,0,3,46,0,49,"2021"
"65912","420920 LACERDOPOLIS",0,0,0,22,0,22,"2021"
"65913","420930 LAGES",8,19,132,1958,14,2131,"2021"
"65914","420940 LAGUNA",2,1,1,449,0,453,"2021"
"65915","420945 LAJEADO GRANDE",0,0,0,20,0,20,"2021"
"65916","420950 LAURENTINO",0,0,2,91,1,94,"2021"
"65917","420960 LAURO MULLER",1,0,5,176,0,182,"2021"
"65918","420970 LEBON REGIS",0,1,1,166,1,169,"2021"
"65919","420980 LEOBERTO LEAL",0,0,2,47,0,49,"2021"
"65920","420985 LINDOIA DO SUL",0,0,1,56,0,57,"2021"
"65921","420990 LONTRAS",0,2,3,142,0,147,"2021"
"65922","421000 LUIZ ALVES",1,1,2,186,0,190,"2021"
"65923","421003 LUZERNA",0,0,0,70,0,70,"2021"
"65924","421005 MACIEIRA",0,0,0,20,0,20,"2021"
"65925","421010 MAFRA",0,2,10,723,2,737,"2021"
"65926","421020 MAJOR GERCINO",0,0,1,37,1,39,"2021"
"65927","421030 MAJOR VIEIRA",0,1,2,68,0,71,"2021"
"65928","421040 MARACAJA",0,0,2,93,0,95,"2021"
"65929","421050 MARAVILHA",1,1,15,394,0,411,"2021"
"65930","421055 MAREMA",0,0,0,24,0,24,"2021"
"65931","421060 MASSARANDUBA",0,0,5,234,0,239,"2021"
"65932","421070 MATOS COSTA",0,0,0,22,0,22,"2021"
"65933","421080 MELEIRO",1,0,1,70,0,72,"2021"
"65934","421085 MIRIM DOCE",0,0,0,21,0,21,"2021"
"65935","421090 MODELO",0,1,0,54,0,55,"2021"
"65936","421100 MONDAI",1,0,1,123,0,125,"2021"
"65937","421105 MONTE CARLO",0,0,1,134,0,135,"2021"
"65938","421110 MONTE CASTELO",1,0,1,108,0,110,"2021"
"65939","421120 MORRO DA FUMACA",0,4,9,233,0,246,"2021"
"65940","421125 MORRO GRANDE",0,1,0,34,0,35,"2021"
"65941","421130 NAVEGANTES",3,4,11,1398,4,1420,"2021"
"65942","421140 NOVA ERECHIM",0,0,2,66,0,68,"2021"
"65943","421145 NOVA ITABERABA",0,0,0,42,0,42,"2021"
"65944","421150 NOVA TRENTO",1,0,1,123,9,134,"2021"
"65945","421160 NOVA VENEZA",0,1,3,140,0,144,"2021"
"65946","421165 NOVO HORIZONTE",0,0,0,24,0,24,"2021"
"65947","421170 ORLEANS",1,0,7,291,1,300,"2021"
"65948","421175 OTACILIO COSTA",1,3,16,214,2,236,"2021"
"65949","421180 OURO",0,0,0,69,0,69,"2021"
"65950","421185 OURO VERDE",0,0,0,18,0,18,"2021"
"65951","421187 PAIAL",0,0,1,26,0,27,"2021"
"65952","421189 PAINEL",0,0,5,19,1,25,"2021"
"65953","421190 PALHOCA",9,8,58,2758,18,2851,"2021"
"65954","421200 PALMA SOLA",0,0,0,112,0,112,"2021"
"65955","421205 PALMEIRA",0,0,2,34,0,36,"2021"
"65956","421210 PALMITOS",1,0,4,152,1,158,"2021"
"65957","421220 PAPANDUVA",0,1,5,274,0,280,"2021"
"65958","421223 PARAISO",0,0,1,62,1,64,"2021"
"65959","421225 PASSO DE TORRES",0,0,3,102,1,106,"2021"
"65960","421227 PASSOS MAIA",0,0,0,59,0,59,"2021"
"65961","421230 PAULO LOPES",0,0,2,105,0,107,"2021"
"65962","421240 PEDRAS GRANDES",0,0,0,30,0,30,"2021"
"65963","421250 PENHA",1,4,3,406,1,415,"2021"
"65964","421260 PERITIBA",0,0,0,33,0,33,"2021"
"65965","421265 PESCARIA BRAVA",0,0,1,90,0,91,"2021"
"65966","421270 PETROLANDIA",0,0,1,74,0,75,"2021"
"65967","421280 BALNEARIO PICARRAS",0,0,4,348,2,354,"2021"
"65968","421290 PINHALZINHO",0,0,4,308,0,312,"2021"
"65969","421300 PINHEIRO PRETO",0,0,1,45,0,46,"2021"
"65970","421310 PIRATUBA",0,0,2,67,0,69,"2021"
"65971","421315 PLANALTO ALEGRE",0,0,1,36,0,37,"2021"
"65972","421320 POMERODE",0,1,6,377,0,384,"2021"
"65973","421330 PONTE ALTA",0,0,3,56,0,59,"2021"
"65974","421335 PONTE ALTA DO NORTE",0,0,1,55,0,56,"2021"
"65975","421340 PONTE SERRADA",1,1,2,159,0,163,"2021"
"65976","421350 PORTO BELO",0,0,5,321,3,329,"2021"
"65977","421360 PORTO UNIAO",0,0,4,355,0,359,"2021"
"65978","421370 POUSO REDONDO",2,0,3,232,1,238,"2021"
"65979","421380 PRAIA GRANDE",0,0,0,97,0,97,"2021"
"65980","421390 PRESIDENTE CASTELLO BRANCO",0,0,1,20,0,21,"2021"
"65981","421400 PRESIDENTE GETULIO",0,1,10,263,2,276,"2021"
"65982","421410 PRESIDENTE NEREU",0,0,0,23,0,23,"2021"
"65983","421415 PRINCESA",0,0,0,33,0,33,"2021"
"65984","421420 QUILOMBO",0,2,0,157,0,159,"2021"
"65985","421430 RANCHO QUEIMADO",0,0,1,32,0,33,"2021"
"65986","421440 RIO DAS ANTAS",0,0,1,73,0,74,"2021"
"65987","421450 RIO DO CAMPO",0,0,0,84,0,84,"2021"
"65988","421460 RIO DO OESTE",0,0,1,76,0,77,"2021"
"65989","421470 RIO DOS CEDROS",0,0,1,115,0,116,"2021"
"65990","421480 RIO DO SUL",1,2,24,866,2,895,"2021"
"65991","421490 RIO FORTUNA",0,0,1,73,0,74,"2021"
"65992","421500 RIO NEGRINHO",0,1,4,528,0,533,"2021"
"65993","421505 RIO RUFINO",0,0,1,22,0,23,"2021"
"65994","421507 RIQUEZA",1,1,3,43,0,48,"2021"
"65995","421510 RODEIO",0,0,0,145,0,145,"2021"
"65996","421520 ROMELANDIA",0,0,0,47,0,47,"2021"
"65997","421530 SALETE",1,0,2,85,0,88,"2021"
"65998","421535 SALTINHO",1,0,0,43,0,44,"2021"
"65999","421540 SALTO VELOSO",0,1,2,60,0,63,"2021"
"66000","421545 SANGAO",0,0,2,179,0,181,"2021"
"66001","421550 SANTA CECILIA",0,2,0,250,0,252,"2021"
"66002","421555 SANTA HELENA",1,0,0,25,0,26,"2021"
"66003","421560 SANTA ROSA DE LIMA",1,0,1,24,0,26,"2021"
"66004","421565 SANTA ROSA DO SUL",0,0,1,119,0,120,"2021"
"66005","421567 SANTA TEREZINHA",0,0,0,95,1,96,"2021"
"66006","421568 SANTA TEREZINHA DO PROGRESSO",0,0,1,31,0,32,"2021"
"66007","421569 SANTIAGO DO SUL",0,0,0,22,0,22,"2021"
"66008","421570 SANTO AMARO DA IMPERATRIZ",1,1,14,314,6,336,"2021"
"66009","421575 SAO BERNARDINO",0,0,0,40,0,40,"2021"
"66010","421580 SAO BENTO DO SUL",3,3,19,1002,2,1029,"2021"
"66011","421590 SAO BONIFACIO",0,0,0,26,0,26,"2021"
"66012","421600 SAO CARLOS",0,0,3,122,0,125,"2021"
"66013","421605 SAO CRISTOVAO DO SUL",0,0,0,81,0,81,"2021"
"66014","421610 SAO DOMINGOS",0,0,2,127,1,130,"2021"
"66015","421620 SAO FRANCISCO DO SUL",1,2,10,599,9,621,"2021"
"66016","421625 SAO JOAO DO OESTE",1,0,0,71,0,72,"2021"
"66017","421630 SAO JOAO BATISTA",0,1,8,456,0,465,"2021"
"66018","421635 SAO JOAO DO ITAPERIU",0,0,1,60,0,61,"2021"
"66019","421640 SAO JOAO DO SUL",0,0,2,86,1,89,"2021"
"66020","421650 SAO JOAQUIM",1,4,11,338,1,355,"2021"
"66021","421660 SAO JOSE",2,7,49,3116,11,3185,"2021"
"66022","421670 SAO JOSE DO CEDRO",1,2,2,153,0,158,"2021"
"66023","421680 SAO JOSE DO CERRITO",1,0,6,73,0,80,"2021"
"66024","421690 SAO LOURENCO DO OESTE",1,1,3,350,0,355,"2021"
"66025","421700 SAO LUDGERO",1,2,2,182,0,187,"2021"
"66026","421710 SAO MARTINHO",0,0,0,54,0,54,"2021"
"66027","421715 SAO MIGUEL DA BOA VISTA",1,0,1,19,0,21,"2021"
"66028","421720 SAO MIGUEL DO OESTE",1,4,9,495,0,509,"2021"
"66029","421725 SAO PEDRO DE ALCANTARA",0,0,0,36,0,36,"2021"
"66030","421730 SAUDADES",1,0,1,101,0,103,"2021"
"66031","421740 SCHROEDER",0,1,5,256,0,262,"2021"
"66032","421750 SEARA",0,0,2,247,0,249,"2021"
"66033","421755 SERRA ALTA",0,0,0,43,0,43,"2021"
"66034","421760 SIDEROPOLIS",0,0,2,137,1,140,"2021"
"66035","421770 SOMBRIO",2,1,8,367,0,378,"2021"
"66036","421775 SUL BRASIL",0,0,2,37,0,39,"2021"
"66037","421780 TAIO",1,1,1,261,2,266,"2021"
"66038","421790 TANGARA",0,0,1,80,1,82,"2021"
"66039","421795 TIGRINHOS",0,0,3,22,0,25,"2021"
"66040","421800 TIJUCAS",0,0,13,681,3,697,"2021"
"66041","421810 TIMBE DO SUL",0,0,0,58,0,58,"2021"
"66042","421820 TIMBO",2,0,5,465,0,472,"2021"
"66043","421825 TIMBO GRANDE",0,1,0,119,0,120,"2021"
"66044","421830 TRES BARRAS",0,4,6,325,2,337,"2021"
"66045","421835 TREVISO",0,0,3,43,0,46,"2021"
"66046","421840 TREZE DE MAIO",0,1,1,91,1,94,"2021"
"66047","421850 TREZE TILIAS",0,2,1,131,1,135,"2021"
"66048","421860 TROMBUDO CENTRAL",0,1,3,74,1,79,"2021"
"66049","421870 TUBARAO",0,5,12,1329,6,1352,"2021"
"66050","421875 TUNAPOLIS",0,0,1,60,0,61,"2021"
"66051","421880 TURVO",2,0,1,165,0,168,"2021"
"66052","421885 UNIAO DO OESTE",0,1,0,32,0,33,"2021"
"66053","421890 URUBICI",2,2,7,126,1,138,"2021"
"66054","421895 URUPEMA",0,2,2,34,0,38,"2021"
"66055","421900 URUSSANGA",0,0,5,197,1,203,"2021"
"66056","421910 VARGEAO",0,0,0,46,0,46,"2021"
"66057","421915 VARGEM",0,0,0,33,0,33,"2021"
"66058","421917 VARGEM BONITA",0,0,0,62,0,62,"2021"
"66059","421920 VIDAL RAMOS",0,0,1,67,0,68,"2021"
"66060","421930 VIDEIRA",1,0,7,802,0,810,"2021"
"66061","421935 VITOR MEIRELES",0,0,3,82,0,85,"2021"
"66062","421940 WITMARSUM",0,1,3,46,2,52,"2021"
"66063","421950 XANXERE",1,2,9,653,0,665,"2021"
"66064","421960 XAVANTINA",0,0,0,26,0,26,"2021"
"66065","421970 XAXIM",0,0,8,439,0,447,"2021"
"66066","421985 ZORTEA",0,0,2,60,0,62,"2021"
"66067","422000 BALNEARIO RINCAO",1,0,5,219,1,226,"2021"
"66068","430003 ACEGUA",0,0,0,55,0,55,"2021"
"66069","430005 AGUA SANTA",0,0,2,50,0,52,"2021"
"66070","430010 AGUDO",1,1,3,130,1,136,"2021"
"66071","430020 AJURICABA",0,0,2,50,0,52,"2021"
"66072","430030 ALECRIM",0,0,0,56,0,56,"2021"
"66073","430040 ALEGRETE",1,4,17,807,1,830,"2021"
"66074","430045 ALEGRIA",1,0,0,20,0,21,"2021"
"66075","430047 ALMIRANTE TAMANDARE DO SUL",0,0,0,16,0,16,"2021"
"66076","430050 ALPESTRE",0,0,1,55,0,56,"2021"
"66077","430055 ALTO ALEGRE",0,0,0,19,0,19,"2021"
"66078","430057 ALTO FELIZ",0,0,0,19,0,19,"2021"
"66079","430060 ALVORADA",4,12,30,2407,3,2456,"2021"
"66080","430063 AMARAL FERRADOR",0,1,1,44,1,47,"2021"
"66081","430064 AMETISTA DO SUL",0,0,1,92,0,93,"2021"
"66082","430066 ANDRE DA ROCHA",0,0,0,12,0,12,"2021"
"66083","430070 ANTA GORDA",0,0,1,41,0,42,"2021"
"66084","430080 ANTONIO PRADO",0,0,2,134,0,136,"2021"
"66085","430085 ARAMBARE",0,0,0,39,0,39,"2021"
"66086","430087 ARARICA",1,0,1,106,0,108,"2021"
"66087","430090 ARATIBA",0,0,1,55,0,56,"2021"
"66088","430100 ARROIO DO MEIO",0,0,6,285,1,292,"2021"
"66089","430105 ARROIO DO SAL",1,0,3,119,0,123,"2021"
"66090","430107 ARROIO DO PADRE",0,0,1,27,0,28,"2021"
"66091","430110 ARROIO DOS RATOS",0,0,3,144,1,148,"2021"
"66092","430120 ARROIO DO TIGRE",1,1,2,126,0,130,"2021"
"66093","430130 ARROIO GRANDE",0,1,5,166,0,172,"2021"
"66094","430140 ARVOREZINHA",0,1,2,127,0,130,"2021"
"66095","430150 AUGUSTO PESTANA",0,1,0,69,0,70,"2021"
"66096","430155 AUREA",0,0,0,32,0,32,"2021"
"66097","430160 BAGE",1,4,12,1405,8,1430,"2021"
"66098","430163 BALNEARIO PINHAL",0,2,1,126,1,130,"2021"
"66099","430165 BARAO",0,0,0,57,0,57,"2021"
"66100","430170 BARAO DE COTEGIPE",0,0,0,80,0,80,"2021"
"66101","430175 BARAO DO TRIUNFO",1,1,0,50,0,52,"2021"
"66102","430180 BARRACAO",0,0,1,61,0,62,"2021"
"66103","430185 BARRA DO GUARITA",0,0,0,46,0,46,"2021"
"66104","430187 BARRA DO QUARAI",0,0,1,38,3,42,"2021"
"66105","430190 BARRA DO RIBEIRO",0,1,3,134,8,146,"2021"
"66106","430192 BARRA DO RIO AZUL",0,0,0,7,0,7,"2021"
"66107","430195 BARRA FUNDA",0,0,1,26,0,27,"2021"
"66108","430200 BARROS CASSAL",0,0,3,110,0,113,"2021"
"66109","430205 BENJAMIN CONSTANT DO SUL",0,0,0,36,1,37,"2021"
"66110","430210 BENTO GONCALVES",2,3,21,1539,1,1566,"2021"
"66111","430215 BOA VISTA DAS MISSOES",0,0,1,26,0,27,"2021"
"66112","430220 BOA VISTA DO BURICA",0,0,1,66,0,67,"2021"
"66113","430222 BOA VISTA DO CADEADO",0,0,0,17,0,17,"2021"
"66114","430223 BOA VISTA DO INCRA",0,0,0,29,0,29,"2021"
"66115","430225 BOA VISTA DO SUL",0,0,0,23,0,23,"2021"
"66116","430230 BOM JESUS",3,0,0,167,0,170,"2021"
"66117","430235 BOM PRINCIPIO",1,0,5,165,0,171,"2021"
"66118","430237 BOM PROGRESSO",0,0,1,22,0,23,"2021"
"66119","430240 BOM RETIRO DO SUL",0,0,2,137,0,139,"2021"
"66120","430245 BOQUEIRAO DO LEAO",0,0,2,81,0,83,"2021"
"66121","430250 BOSSOROCA",0,1,1,52,0,54,"2021"
"66122","430258 BOZANO",0,0,0,19,0,19,"2021"
"66123","430260 BRAGA",0,0,0,43,0,43,"2021"
"66124","430265 BROCHIER",0,0,1,65,0,66,"2021"
"66125","430270 BUTIA",0,2,6,185,0,193,"2021"
"66126","430280 CACAPAVA DO SUL",3,1,8,373,3,388,"2021"
"66127","430290 CACEQUI",0,0,2,120,0,122,"2021"
"66128","430300 CACHOEIRA DO SUL",3,5,15,899,6,928,"2021"
"66129","430310 CACHOEIRINHA",1,5,18,1590,4,1618,"2021"
"66130","430320 CACIQUE DOBLE",0,0,0,54,0,54,"2021"
"66131","430330 CAIBATE",0,0,0,48,0,48,"2021"
"66132","430340 CAICARA",0,0,1,37,0,38,"2021"
"66133","430350 CAMAQUA",4,2,5,704,7,722,"2021"
"66134","430355 CAMARGO",0,0,0,34,0,34,"2021"
"66135","430360 CAMBARA DO SUL",0,1,0,65,0,66,"2021"
"66136","430367 CAMPESTRE DA SERRA",0,0,0,26,1,27,"2021"
"66137","430370 CAMPINA DAS MISSOES",0,0,1,53,0,54,"2021"
"66138","430380 CAMPINAS DO SUL",0,0,0,53,0,53,"2021"
"66139","430390 CAMPO BOM",1,2,6,754,0,763,"2021"
"66140","430400 CAMPO NOVO",0,0,0,64,0,64,"2021"
"66141","430410 CAMPOS BORGES",0,0,2,43,0,45,"2021"
"66142","430420 CANDELARIA",1,1,0,303,0,305,"2021"
"66143","430430 CANDIDO GODOI",0,0,3,58,0,61,"2021"
"66144","430435 CANDIOTA",1,2,2,124,0,129,"2021"
"66145","430440 CANELA",0,2,11,614,4,631,"2021"
"66146","430450 CANGUCU",1,0,20,504,2,527,"2021"
"66147","430460 CANOAS",10,22,90,4130,20,4272,"2021"
"66148","430461 CANUDOS DO VALE",0,0,0,17,0,17,"2021"
"66149","430462 CAPAO BONITO DO SUL",0,0,0,14,0,14,"2021"
"66150","430463 CAPAO DA CANOA",2,2,7,861,1,873,"2021"
"66151","430465 CAPAO DO CIPO",0,0,1,30,0,31,"2021"
"66152","430466 CAPAO DO LEAO",1,2,6,285,0,294,"2021"
"66153","430467 CAPIVARI DO SUL",0,0,1,50,0,51,"2021"
"66154","430468 CAPELA DE SANTANA",0,1,4,119,0,124,"2021"
"66155","430469 CAPITAO",0,0,0,42,0,42,"2021"
"66156","430470 CARAZINHO",1,1,4,783,0,789,"2021"
"66157","430471 CARAA",0,0,0,57,0,57,"2021"
"66158","430480 CARLOS BARBOSA",0,0,8,327,3,338,"2021"
"66159","430485 CARLOS GOMES",0,0,0,11,0,11,"2021"
"66160","430490 CASCA",0,0,0,84,0,84,"2021"
"66161","430495 CASEIROS",0,0,0,20,0,20,"2021"
"66162","430500 CATUIPE",0,0,3,82,0,85,"2021"
"66163","430510 CAXIAS DO SUL",12,35,112,5061,9,5229,"2021"
"66164","430511 CENTENARIO",0,0,0,27,0,27,"2021"
"66165","430512 CERRITO",0,0,1,47,0,48,"2021"
"66166","430513 CERRO BRANCO",0,0,0,24,1,25,"2021"
"66167","430515 CERRO GRANDE",0,2,0,31,0,33,"2021"
"66168","430517 CERRO GRANDE DO SUL",1,1,2,93,1,98,"2021"
"66169","430520 CERRO LARGO",0,2,2,134,0,138,"2021"
"66170","430530 CHAPADA",0,1,2,81,1,85,"2021"
"66171","430535 CHARQUEADAS",0,0,2,313,2,317,"2021"
"66172","430537 CHARRUA",0,0,0,29,0,29,"2021"
"66173","430540 CHIAPETTA",0,0,0,31,0,31,"2021"
"66174","430543 CHUI",0,1,1,22,0,24,"2021"
"66175","430544 CHUVISCA",0,0,1,51,0,52,"2021"
"66176","430545 CIDREIRA",0,1,4,181,3,189,"2021"
"66177","430550 CIRIACO",0,0,0,42,0,42,"2021"
"66178","430558 COLINAS",0,0,0,19,0,19,"2021"
"66179","430560 COLORADO",0,0,0,28,0,28,"2021"
"66180","430570 CONDOR",0,0,0,79,0,79,"2021"
"66181","430580 CONSTANTINA",0,0,2,109,0,111,"2021"
"66182","430583 COQUEIRO BAIXO",0,0,0,10,0,10,"2021"
"66183","430585 COQUEIROS DO SUL",1,0,0,31,0,32,"2021"
"66184","430587 CORONEL BARROS",0,0,0,23,0,23,"2021"
"66185","430590 CORONEL BICACO",0,0,0,72,0,72,"2021"
"66186","430593 CORONEL PILAR",0,1,0,9,1,11,"2021"
"66187","430595 COTIPORA",1,0,0,23,0,24,"2021"
"66188","430597 COXILHA",0,0,0,32,0,32,"2021"
"66189","430600 CRISSIUMAL",2,0,1,123,0,126,"2021"
"66190","430605 CRISTAL",0,0,0,86,0,86,"2021"
"66191","430607 CRISTAL DO SUL",0,0,1,24,0,25,"2021"
"66192","430610 CRUZ ALTA",0,3,7,781,0,791,"2021"
"66193","430613 CRUZALTENSE",0,0,0,15,1,16,"2021"
"66194","430620 CRUZEIRO DO SUL",0,0,1,115,2,118,"2021"
"66195","430630 DAVID CANABARRO",0,0,0,34,0,34,"2021"
"66196","430632 DERRUBADAS",0,0,0,32,0,32,"2021"
"66197","430635 DEZESSEIS DE NOVEMBRO",0,0,1,24,1,26,"2021"
"66198","430637 DILERMANDO DE AGUIAR",0,0,0,27,1,28,"2021"
"66199","430640 DOIS IRMAOS",0,1,5,320,0,326,"2021"
"66200","430642 DOIS IRMAOS DAS MISSOES",0,0,0,28,0,28,"2021"
"66201","430645 DOIS LAJEADOS",0,0,0,22,0,22,"2021"
"66202","430650 DOM FELICIANO",0,2,0,126,0,128,"2021"
"66203","430655 DOM PEDRO DE ALCANTARA",0,0,0,27,0,27,"2021"
"66204","430660 DOM PEDRITO",2,0,3,361,0,366,"2021"
"66205","430670 DONA FRANCISCA",0,0,1,25,0,26,"2021"
"66206","430673 DOUTOR MAURICIO CARDOSO",0,0,1,36,0,37,"2021"
"66207","430675 DOUTOR RICARDO",0,0,1,9,0,10,"2021"
"66208","430676 ELDORADO DO SUL",0,2,8,527,7,544,"2021"
"66209","430680 ENCANTADO",0,0,3,245,1,249,"2021"
"66210","430690 ENCRUZILHADA DO SUL",1,2,9,237,0,249,"2021"
"66211","430692 ENGENHO VELHO",0,1,0,17,0,18,"2021"
"66212","430693 ENTRE-IJUIS",0,1,1,93,0,95,"2021"
"66213","430695 ENTRE RIOS DO SUL",0,0,0,21,0,21,"2021"
"66214","430697 EREBANGO",0,0,0,29,0,29,"2021"
"66215","430700 ERECHIM",1,3,22,1265,2,1293,"2021"
"66216","430705 ERNESTINA",1,1,0,25,0,27,"2021"
"66217","430710 HERVAL",0,2,4,68,0,74,"2021"
"66218","430720 ERVAL GRANDE",0,0,1,57,2,60,"2021"
"66219","430730 ERVAL SECO",0,2,5,88,0,95,"2021"
"66220","430740 ESMERALDA",0,0,0,37,1,38,"2021"
"66221","430745 ESPERANCA DO SUL",0,0,0,28,0,28,"2021"
"66222","430750 ESPUMOSO",0,0,2,172,0,174,"2021"
"66223","430755 ESTACAO",0,0,0,46,0,46,"2021"
"66224","430760 ESTANCIA VELHA",2,0,12,507,1,522,"2021"
"66225","430770 ESTEIO",6,4,7,873,3,893,"2021"
"66226","430780 ESTRELA",0,3,13,392,0,408,"2021"
"66227","430781 ESTRELA VELHA",0,0,0,30,0,30,"2021"
"66228","430783 EUGENIO DE CASTRO",0,0,1,23,0,24,"2021"
"66229","430786 FAGUNDES VARELA",0,0,0,14,0,14,"2021"
"66230","430790 FARROUPILHA",1,4,21,752,0,778,"2021"
"66231","430800 FAXINAL DO SOTURNO",0,1,0,69,0,70,"2021"
"66232","430805 FAXINALZINHO",0,0,0,30,0,30,"2021"
"66233","430807 FAZENDA VILANOVA",0,0,0,54,0,54,"2021"
"66234","430810 FELIZ",0,1,0,148,0,149,"2021"
"66235","430820 FLORES DA CUNHA",2,1,5,383,0,391,"2021"
"66236","430825 FLORIANO PEIXOTO",0,0,0,10,0,10,"2021"
"66237","430830 FONTOURA XAVIER",0,0,1,101,1,103,"2021"
"66238","430840 FORMIGUEIRO",0,0,0,73,0,73,"2021"
"66239","430843 FORQUETINHA",0,0,0,16,0,16,"2021"
"66240","430845 FORTALEZA DOS VALOS",0,0,0,52,0,52,"2021"
"66241","430850 FREDERICO WESTPHALEN",0,2,4,449,1,456,"2021"
"66242","430860 GARIBALDI",1,1,5,382,0,389,"2021"
"66243","430865 GARRUCHOS",0,0,0,30,0,30,"2021"
"66244","430870 GAURAMA",0,1,0,49,0,50,"2021"
"66245","430880 GENERAL CAMARA",0,0,0,70,0,70,"2021"
"66246","430885 GENTIL",0,0,0,22,0,22,"2021"
"66247","430890 GETULIO VARGAS",2,0,5,198,0,205,"2021"
"66248","430900 GIRUA",2,0,5,153,0,160,"2021"
"66249","430905 GLORINHA",0,1,2,84,0,87,"2021"
"66250","430910 GRAMADO",0,1,8,486,0,495,"2021"
"66251","430912 GRAMADO DOS LOUREIROS",0,0,0,28,0,28,"2021"
"66252","430915 GRAMADO XAVIER",0,0,0,47,0,47,"2021"
"66253","430920 GRAVATAI",11,12,34,2967,10,3034,"2021"
"66254","430925 GUABIJU",0,0,0,7,0,7,"2021"
"66255","430930 GUAIBA",3,3,17,1022,6,1051,"2021"
"66256","430940 GUAPORE",0,3,6,298,0,307,"2021"
"66257","430950 GUARANI DAS MISSOES",0,1,0,67,0,68,"2021"
"66258","430955 HARMONIA",1,2,3,56,0,62,"2021"
"66259","430957 HERVEIRAS",0,0,1,22,0,23,"2021"
"66260","430960 HORIZONTINA",0,0,1,206,0,207,"2021"
"66261","430965 HULHA NEGRA",0,0,1,66,0,67,"2021"
"66262","430970 HUMAITA",0,0,1,36,0,37,"2021"
"66263","430975 IBARAMA",0,0,0,38,0,38,"2021"
"66264","430980 IBIACA",0,1,2,45,0,48,"2021"
"66265","430990 IBIRAIARAS",0,0,3,60,0,63,"2021"
"66266","430995 IBIRAPUITA",0,1,0,46,0,47,"2021"
"66267","431000 IBIRUBA",0,1,4,245,0,250,"2021"
"66268","431010 IGREJINHA",0,1,0,486,0,487,"2021"
"66269","431020 IJUI",0,1,18,974,0,993,"2021"
"66270","431030 ILOPOLIS",0,0,1,38,0,39,"2021"
"66271","431033 IMBE",1,0,7,267,2,277,"2021"
"66272","431036 IMIGRANTE",0,0,2,20,0,22,"2021"
"66273","431040 INDEPENDENCIA",0,0,2,59,0,61,"2021"
"66274","431041 INHACORA",0,0,1,24,0,25,"2021"
"66275","431043 IPE",0,1,0,51,0,52,"2021"
"66276","431046 IPIRANGA DO SUL",0,0,0,16,0,16,"2021"
"66277","431050 IRAI",1,2,0,87,1,91,"2021"
"66278","431053 ITAARA",0,0,0,54,0,54,"2021"
"66279","431055 ITACURUBI",0,0,0,26,0,26,"2021"
"66280","431057 ITAPUCA",0,0,0,23,0,23,"2021"
"66281","431060 ITAQUI",0,0,11,460,2,473,"2021"
"66282","431065 ITATI",0,0,2,39,0,41,"2021"
"66283","431070 ITATIBA DO SUL",0,0,0,27,1,28,"2021"
"66284","431075 IVORA",0,0,0,13,0,13,"2021"
"66285","431080 IVOTI",1,0,2,189,0,192,"2021"
"66286","431085 JABOTICABA",0,0,1,45,0,46,"2021"
"66287","431087 JACUIZINHO",0,0,1,23,0,24,"2021"
"66288","431090 JACUTINGA",0,0,1,29,0,30,"2021"
"66289","431100 JAGUARAO",1,0,3,303,0,307,"2021"
"66290","431110 JAGUARI",0,1,3,80,3,87,"2021"
"66291","431112 JAQUIRANA",0,0,0,55,0,55,"2021"
"66292","431113 JARI",0,1,1,24,0,26,"2021"
"66293","431115 JOIA",0,1,0,56,0,57,"2021"
"66294","431120 JULIO DE CASTILHOS",0,3,4,203,1,211,"2021"
"66295","431123 LAGOA BONITA DO SUL",0,0,0,22,0,22,"2021"
"66296","431125 LAGOAO",0,0,0,63,0,63,"2021"
"66297","431127 LAGOA DOS TRES CANTOS",0,0,0,13,0,13,"2021"
"66298","431130 LAGOA VERMELHA",1,1,6,356,0,364,"2021"
"66299","431140 LAJEADO",3,2,16,1179,0,1200,"2021"
"66300","431142 LAJEADO DO BUGRE",0,0,0,26,0,26,"2021"
"66301","431150 LAVRAS DO SUL",0,0,1,58,1,60,"2021"
"66302","431160 LIBERATO SALZANO",1,1,1,62,0,65,"2021"
"66303","431162 LINDOLFO COLLOR",0,0,0,74,1,75,"2021"
"66304","431164 LINHA NOVA",0,0,0,10,0,10,"2021"
"66305","431170 MACHADINHO",0,0,1,57,0,58,"2021"
"66306","431171 MACAMBARA",0,0,0,56,0,56,"2021"
"66307","431173 MAMPITUBA",0,0,0,51,0,51,"2021"
"66308","431175 MANOEL VIANA",0,0,0,59,0,59,"2021"
"66309","431177 MAQUINE",0,0,1,81,5,87,"2021"
"66310","431179 MARATA",0,0,0,31,0,31,"2021"
"66311","431180 MARAU",1,4,5,553,0,563,"2021"
"66312","431190 MARCELINO RAMOS",0,0,0,38,0,38,"2021"
"66313","431198 MARIANA PIMENTEL",0,1,2,32,7,42,"2021"
"66314","431200 MARIANO MORO",0,0,0,12,0,12,"2021"
"66315","431205 MARQUES DE SOUZA",0,0,0,38,0,38,"2021"
"66316","431210 MATA",0,0,0,34,0,34,"2021"
"66317","431213 MATO CASTELHANO",0,0,3,42,0,45,"2021"
"66318","431215 MATO LEITAO",0,0,1,47,0,48,"2021"
"66319","431217 MATO QUEIMADO",0,0,0,16,0,16,"2021"
"66320","431220 MAXIMILIANO DE ALMEIDA",0,0,0,31,0,31,"2021"
"66321","431225 MINAS DO LEAO",0,1,1,76,0,78,"2021"
"66322","431230 MIRAGUAI",0,0,3,53,0,56,"2021"
"66323","431235 MONTAURI",1,0,0,13,0,14,"2021"
"66324","431237 MONTE ALEGRE DOS CAMPOS",1,0,1,37,0,39,"2021"
"66325","431238 MONTE BELO DO SUL",0,0,0,19,0,19,"2021"
"66326","431240 MONTENEGRO",2,3,17,789,1,812,"2021"
"66327","431242 MORMACO",0,0,0,33,0,33,"2021"
"66328","431244 MORRINHOS DO SUL",0,0,1,35,0,36,"2021"
"66329","431245 MORRO REDONDO",0,0,0,41,0,41,"2021"
"66330","431247 MORRO REUTER",0,0,0,53,0,53,"2021"
"66331","431250 MOSTARDAS",1,0,3,152,0,156,"2021"
"66332","431260 MUCUM",0,0,0,30,0,30,"2021"
"66333","431261 MUITOS CAPOES",0,0,0,28,0,28,"2021"
"66334","431262 MULITERNO",0,0,1,25,0,26,"2021"
"66335","431265 NAO-ME-TOQUE",0,1,1,224,1,227,"2021"
"66336","431267 NICOLAU VERGUEIRO",0,0,1,27,0,28,"2021"
"66337","431270 NONOAI",0,1,1,194,0,196,"2021"
"66338","431275 NOVA ALVORADA",1,0,2,44,0,47,"2021"
"66339","431280 NOVA ARACA",1,0,2,75,0,78,"2021"
"66340","431290 NOVA BASSANO",0,1,2,78,0,81,"2021"
"66341","431295 NOVA BOA VISTA",0,0,0,19,0,19,"2021"
"66342","431300 NOVA BRESCIA",0,0,0,24,0,24,"2021"
"66343","431301 NOVA CANDELARIA",0,1,0,28,0,29,"2021"
"66344","431303 NOVA ESPERANCA DO SUL",0,0,0,44,0,44,"2021"
"66345","431306 NOVA HARTZ",0,2,5,239,0,246,"2021"
"66346","431308 NOVA PADUA",0,0,0,17,0,17,"2021"
"66347","431310 NOVA PALMA",0,0,0,46,0,46,"2021"
"66348","431320 NOVA PETROPOLIS",2,1,7,229,0,239,"2021"
"66349","431330 NOVA PRATA",0,0,3,273,0,276,"2021"
"66350","431333 NOVA RAMADA",0,0,0,26,0,26,"2021"
"66351","431335 NOVA ROMA DO SUL",0,1,1,25,0,27,"2021"
"66352","431337 NOVA SANTA RITA",2,1,8,401,0,412,"2021"
"66353","431339 NOVO CABRAIS",0,1,0,34,0,35,"2021"
"66354","431340 NOVO HAMBURGO",4,9,45,2664,4,2726,"2021"
"66355","431342 NOVO MACHADO",0,0,1,30,0,31,"2021"
"66356","431344 NOVO TIRADENTES",0,0,1,22,0,23,"2021"
"66357","431346 NOVO XINGU",0,0,0,15,0,15,"2021"
"66358","431349 NOVO BARREIRO",1,0,1,37,0,39,"2021"
"66359","431350 OSORIO",2,3,5,543,0,553,"2021"
"66360","431360 PAIM FILHO",0,0,0,30,0,30,"2021"
"66361","431365 PALMARES DO SUL",0,0,0,125,0,125,"2021"
"66362","431370 PALMEIRA DAS MISSOES",1,2,13,472,1,489,"2021"
"66363","431380 PALMITINHO",0,0,0,89,0,89,"2021"
"66364","431390 PANAMBI",1,3,10,518,0,532,"2021"
"66365","431395 PANTANO GRANDE",0,0,0,95,0,95,"2021"
"66366","431400 PARAI",0,0,2,68,0,70,"2021"
"66367","431402 PARAISO DO SUL",0,1,3,67,0,71,"2021"
"66368","431403 PARECI NOVO",0,0,1,71,0,72,"2021"
"66369","431405 PAROBE",0,0,15,710,1,726,"2021"
"66370","431406 PASSA SETE",0,0,0,39,0,39,"2021"
"66371","431407 PASSO DO SOBRADO",0,1,1,60,0,62,"2021"
"66372","431410 PASSO FUNDO",6,8,63,2682,7,2766,"2021"
"66373","431413 PAULO BENTO",0,0,0,13,0,13,"2021"
"66374","431415 PAVERAMA",0,0,1,76,0,77,"2021"
"66375","431417 PEDRAS ALTAS",1,0,2,19,1,23,"2021"
"66376","431420 PEDRO OSORIO",0,0,2,69,1,72,"2021"
"66377","431430 PEJUCARA",1,0,2,39,0,42,"2021"
"66378","431440 PELOTAS",9,22,109,3465,10,3615,"2021"
"66379","431442 PICADA CAFE",0,1,1,42,0,44,"2021"
"66380","431445 PINHAL",0,0,1,46,0,47,"2021"
"66381","431446 PINHAL DA SERRA",0,0,0,21,0,21,"2021"
"66382","431447 PINHAL GRANDE",0,0,3,27,0,30,"2021"
"66383","431449 PINHEIRINHO DO VALE",0,0,0,58,0,58,"2021"
"66384","431450 PINHEIRO MACHADO",0,2,1,67,0,70,"2021"
"66385","431454 PINTO BANDEIRA",0,0,0,20,0,20,"2021"
"66386","431455 PIRAPO",0,0,0,16,0,16,"2021"
"66387","431460 PIRATINI",1,0,4,150,9,164,"2021"
"66388","431470 PLANALTO",1,0,3,123,0,127,"2021"
"66389","431475 POCO DAS ANTAS",0,0,0,18,0,18,"2021"
"66390","431477 PONTAO",0,0,1,41,0,42,"2021"
"66391","431478 PONTE PRETA",0,0,0,11,0,11,"2021"
"66392","431480 PORTAO",1,1,7,366,1,376,"2021"
"66393","431490 PORTO ALEGRE",58,81,299,13647,68,14153,"2021"
"66394","431500 PORTO LUCENA",0,0,1,34,0,35,"2021"
"66395","431505 PORTO MAUA",0,0,0,24,0,24,"2021"
"66396","431507 PORTO VERA CRUZ",0,0,0,11,0,11,"2021"
"66397","431510 PORTO XAVIER",0,0,1,100,0,101,"2021"
"66398","431513 POUSO NOVO",0,0,0,18,0,18,"2021"
"66399","431514 PRESIDENTE LUCENA",0,1,1,18,1,21,"2021"
"66400","431515 PROGRESSO",0,0,1,56,0,57,"2021"
"66401","431517 PROTASIO ALVES",0,0,0,13,0,13,"2021"
"66402","431520 PUTINGA",0,0,1,20,0,21,"2021"
"66403","431530 QUARAI",0,0,2,273,0,275,"2021"
"66404","431531 QUATRO IRMAOS",1,0,0,14,0,15,"2021"
"66405","431532 QUEVEDOS",0,0,0,24,0,24,"2021"
"66406","431535 QUINZE DE NOVEMBRO",0,0,1,41,0,42,"2021"
"66407","431540 REDENTORA",0,3,5,182,1,191,"2021"
"66408","431545 RELVADO",0,0,0,19,0,19,"2021"
"66409","431550 RESTINGA SECA",2,0,3,150,0,155,"2021"
"66410","431555 RIO DOS INDIOS",0,0,0,24,1,25,"2021"
"66411","431560 RIO GRANDE",6,15,58,2208,12,2299,"2021"
"66412","431570 RIO PARDO",3,2,8,340,0,353,"2021"
"66413","431575 RIOZINHO",0,0,2,44,0,46,"2021"
"66414","431580 ROCA SALES",0,1,2,89,0,92,"2021"
"66415","431590 RODEIO BONITO",0,0,1,91,0,92,"2021"
"66416","431595 ROLADOR",0,0,0,24,0,24,"2021"
"66417","431600 ROLANTE",0,0,2,239,0,241,"2021"
"66418","431610 RONDA ALTA",0,3,2,114,0,119,"2021"
"66419","431620 RONDINHA",0,0,0,30,0,30,"2021"
"66420","431630 ROQUE GONZALES",1,0,0,58,0,59,"2021"
"66421","431640 ROSARIO DO SUL",1,4,5,446,0,456,"2021"
"66422","431642 SAGRADA FAMILIA",1,0,0,26,0,27,"2021"
"66423","431643 SALDANHA MARINHO",0,0,0,18,0,18,"2021"
"66424","431645 SALTO DO JACUI",0,1,1,99,0,101,"2021"
"66425","431647 SALVADOR DAS MISSOES",0,0,1,23,0,24,"2021"
"66426","431650 SALVADOR DO SUL",0,0,0,86,0,86,"2021"
"66427","431660 SANANDUVA",0,0,1,176,0,177,"2021"
"66428","431670 SANTA BARBARA DO SUL",0,1,0,76,0,77,"2021"
"66429","431673 SANTA CECILIA DO SUL",0,0,0,20,0,20,"2021"
"66430","431675 SANTA CLARA DO SUL",0,0,1,53,0,54,"2021"
"66431","431680 SANTA CRUZ DO SUL",4,8,28,1421,0,1461,"2021"
"66432","431690 SANTA MARIA",9,18,58,2992,7,3084,"2021"
"66433","431695 SANTA MARIA DO HERVAL",0,1,1,50,0,52,"2021"
"66434","431697 SANTA MARGARIDA DO SUL",0,0,0,15,0,15,"2021"
"66435","431700 SANTANA DA BOA VISTA",1,0,1,54,0,56,"2021"
"66436","431710 SANT'ANA DO LIVRAMENTO",2,0,6,974,4,986,"2021"
"66437","431720 SANTA ROSA",0,3,22,961,3,989,"2021"
"66438","431725 SANTA TEREZA",0,0,0,7,0,7,"2021"
"66439","431730 SANTA VITORIA DO PALMAR",0,2,10,315,0,327,"2021"
"66440","431740 SANTIAGO",2,2,2,476,1,483,"2021"
"66441","431750 SANTO ANGELO",1,1,3,961,2,968,"2021"
"66442","431755 SANTO ANTONIO DO PALMA",0,0,0,10,0,10,"2021"
"66443","431760 SANTO ANTONIO DA PATRULHA",0,1,2,461,0,464,"2021"
"66444","431770 SANTO ANTONIO DAS MISSOES",0,0,0,108,0,108,"2021"
"66445","431775 SANTO ANTONIO DO PLANALTO",0,0,2,21,0,23,"2021"
"66446","431780 SANTO AUGUSTO",2,0,2,195,0,199,"2021"
"66447","431790 SANTO CRISTO",0,0,2,147,0,149,"2021"
"66448","431795 SANTO EXPEDITO DO SUL",0,0,0,28,0,28,"2021"
"66449","431800 SAO BORJA",0,1,9,696,0,706,"2021"
"66450","431805 SAO DOMINGOS DO SUL",0,0,2,28,0,30,"2021"
"66451","431810 SAO FRANCISCO DE ASSIS",1,0,2,126,2,131,"2021"
"66452","431820 SAO FRANCISCO DE PAULA",2,2,2,251,3,260,"2021"
"66453","431830 SAO GABRIEL",3,2,9,660,0,674,"2021"
"66454","431840 SAO JERONIMO",1,0,2,206,0,209,"2021"
"66455","431842 SAO JOAO DA URTIGA",0,1,0,27,0,28,"2021"
"66456","431843 SAO JOAO DO POLESINE",0,1,0,25,0,26,"2021"
"66457","431844 SAO JORGE",0,0,0,19,0,19,"2021"
"66458","431845 SAO JOSE DAS MISSOES",0,0,0,25,0,25,"2021"
"66459","431846 SAO JOSE DO HERVAL",0,0,0,24,0,24,"2021"
"66460","431848 SAO JOSE DO HORTENCIO",0,0,0,39,1,40,"2021"
"66461","431849 SAO JOSE DO INHACORA",0,0,0,14,0,14,"2021"
"66462","431850 SAO JOSE DO NORTE",0,3,5,253,3,264,"2021"
"66463","431860 SAO JOSE DO OURO",0,0,0,58,0,58,"2021"
"66464","431861 SAO JOSE DO SUL",0,0,1,34,1,36,"2021"
"66465","431862 SAO JOSE DOS AUSENTES",0,0,0,71,0,71,"2021"
"66466","431870 SAO LEOPOLDO",5,12,47,2611,16,2691,"2021"
"66467","431880 SAO LOURENCO DO SUL",1,3,5,351,0,360,"2021"
"66468","431890 SAO LUIZ GONZAGA",1,0,1,475,1,478,"2021"
"66469","431900 SAO MARCOS",0,0,6,208,1,215,"2021"
"66470","431910 SAO MARTINHO",0,0,1,64,0,65,"2021"
"66471","431912 SAO MARTINHO DA SERRA",0,0,1,21,1,23,"2021"
"66472","431915 SAO MIGUEL DAS MISSOES",1,0,1,67,1,70,"2021"
"66473","431920 SAO NICOLAU",0,0,0,58,0,58,"2021"
"66474","431930 SAO PAULO DAS MISSOES",0,0,2,55,0,57,"2021"
"66475","431935 SAO PEDRO DA SERRA",0,0,2,33,0,35,"2021"
"66476","431936 SAO PEDRO DAS MISSOES",0,0,0,17,1,18,"2021"
"66477","431937 SAO PEDRO DO BUTIA",0,0,0,25,0,25,"2021"
"66478","431940 SAO PEDRO DO SUL",0,0,4,127,0,131,"2021"
"66479","431950 SAO SEBASTIAO DO CAI",1,2,3,272,0,278,"2021"
"66480","431960 SAO SEPE",1,3,4,223,2,233,"2021"
"66481","431970 SAO VALENTIM",0,0,1,24,1,26,"2021"
"66482","431971 SAO VALENTIM DO SUL",0,0,0,14,0,14,"2021"
"66483","431973 SAO VALERIO DO SUL",1,0,0,36,2,39,"2021"
"66484","431975 SAO VENDELINO",0,0,0,25,0,25,"2021"
"66485","431980 SAO VICENTE DO SUL",0,0,2,59,0,61,"2021"
"66486","431990 SAPIRANGA",3,5,19,1038,1,1066,"2021"
"66487","432000 SAPUCAIA DO SUL",1,3,34,1432,1,1471,"2021"
"66488","432010 SARANDI",1,2,1,302,1,307,"2021"
"66489","432020 SEBERI",0,1,3,182,0,186,"2021"
"66490","432023 SEDE NOVA",0,1,1,20,0,22,"2021"
"66491","432026 SEGREDO",0,0,1,89,0,90,"2021"
"66492","432030 SELBACH",0,0,0,49,0,49,"2021"
"66493","432032 SENADOR SALGADO FILHO",0,0,1,19,0,20,"2021"
"66494","432035 SENTINELA DO SUL",0,0,0,41,0,41,"2021"
"66495","432040 SERAFINA CORREA",1,0,1,193,0,195,"2021"
"66496","432045 SERIO",0,0,0,19,0,19,"2021"
"66497","432050 SERTAO",0,1,0,59,0,60,"2021"
"66498","432055 SERTAO SANTANA",0,1,0,48,0,49,"2021"
"66499","432057 SETE DE SETEMBRO",0,0,0,24,0,24,"2021"
"66500","432060 SEVERIANO DE ALMEIDA",0,0,1,23,1,25,"2021"
"66501","432065 SILVEIRA MARTINS",0,0,0,17,0,17,"2021"
"66502","432067 SINIMBU",0,0,4,64,1,69,"2021"
"66503","432070 SOBRADINHO",1,0,0,178,0,179,"2021"
"66504","432080 SOLEDADE",1,2,4,371,2,380,"2021"
"66505","432085 TABAI",0,0,0,55,0,55,"2021"
"66506","432090 TAPEJARA",1,1,4,353,0,359,"2021"
"66507","432100 TAPERA",0,1,3,116,0,120,"2021"
"66508","432110 TAPES",0,1,1,144,0,146,"2021"
"66509","432120 TAQUARA",4,0,9,562,0,575,"2021"
"66510","432130 TAQUARI",2,0,3,246,0,251,"2021"
"66511","432132 TAQUARUCU DO SUL",0,0,1,35,0,36,"2021"
"66512","432135 TAVARES",0,0,0,44,0,44,"2021"
"66513","432140 TENENTE PORTELA",1,0,4,224,0,229,"2021"
"66514","432143 TERRA DE AREIA",2,2,3,135,1,143,"2021"
"66515","432145 TEUTONIA",0,0,3,440,0,443,"2021"
"66516","432146 TIO HUGO",1,1,1,33,0,36,"2021"
"66517","432147 TIRADENTES DO SUL",0,1,1,50,0,52,"2021"
"66518","432149 TOROPI",0,0,1,14,0,15,"2021"
"66519","432150 TORRES",1,3,6,550,4,564,"2021"
"66520","432160 TRAMANDAI",1,0,10,690,3,704,"2021"
"66521","432162 TRAVESSEIRO",0,1,0,14,0,15,"2021"
"66522","432163 TRES ARROIOS",0,0,0,13,0,13,"2021"
"66523","432166 TRES CACHOEIRAS",0,0,0,121,0,121,"2021"
"66524","432170 TRES COROAS",2,0,2,239,0,243,"2021"
"66525","432180 TRES DE MAIO",1,0,2,352,0,355,"2021"
"66526","432183 TRES FORQUILHAS",0,0,0,38,0,38,"2021"
"66527","432185 TRES PALMEIRAS",0,0,0,68,0,68,"2021"
"66528","432190 TRES PASSOS",1,2,6,281,0,290,"2021"
"66529","432195 TRINDADE DO SUL",0,0,1,83,1,85,"2021"
"66530","432200 TRIUNFO",1,3,5,305,0,314,"2021"
"66531","432210 TUCUNDUVA",0,0,0,43,0,43,"2021"
"66532","432215 TUNAS",0,0,0,34,0,34,"2021"
"66533","432218 TUPANCI DO SUL",0,0,0,12,0,12,"2021"
"66534","432220 TUPANCIRETA",0,1,3,228,0,232,"2021"
"66535","432225 TUPANDI",0,2,2,53,0,57,"2021"
"66536","432230 TUPARENDI",0,0,1,75,0,76,"2021"
"66537","432232 TURUCU",0,0,0,27,0,27,"2021"
"66538","432234 UBIRETAMA",0,0,0,19,0,19,"2021"
"66539","432235 UNIAO DA SERRA",0,0,0,7,0,7,"2021"
"66540","432237 UNISTALDA",0,0,1,23,0,24,"2021"
"66541","432240 URUGUAIANA",2,4,30,1327,209,1572,"2021"
"66542","432250 VACARIA",1,1,9,889,5,905,"2021"
"66543","432252 VALE VERDE",0,0,1,34,0,35,"2021"
"66544","432253 VALE DO SOL",0,0,0,102,0,102,"2021"
"66545","432254 VALE REAL",0,1,0,61,0,62,"2021"
"66546","432255 VANINI",0,0,1,14,0,15,"2021"
"66547","432260 VENANCIO AIRES",2,0,11,634,1,648,"2021"
"66548","432270 VERA CRUZ",0,1,8,274,1,284,"2021"
"66549","432280 VERANOPOLIS",0,0,1,226,0,227,"2021"
"66550","432285 VESPASIANO CORREA",1,0,0,12,0,13,"2021"
"66551","432290 VIADUTOS",0,1,2,35,0,38,"2021"
"66552","432300 VIAMAO",9,10,30,2262,19,2330,"2021"
"66553","432310 VICENTE DUTRA",0,0,0,68,0,68,"2021"
"66554","432320 VICTOR GRAEFF",0,0,0,19,0,19,"2021"
"66555","432330 VILA FLORES",0,0,1,27,0,28,"2021"
"66556","432335 VILA LANGARO",0,0,0,15,0,15,"2021"
"66557","432340 VILA MARIA",0,1,0,36,0,37,"2021"
"66558","432345 VILA NOVA DO SUL",0,0,1,32,0,33,"2021"
"66559","432350 VISTA ALEGRE",0,0,0,28,0,28,"2021"
"66560","432360 VISTA ALEGRE DO PRATA",0,0,0,12,0,12,"2021"
"66561","432370 VISTA GAUCHA",1,0,0,33,0,34,"2021"
"66562","432375 VITORIA DAS MISSOES",0,0,2,27,0,29,"2021"
"66563","432377 WESTFALIA",0,0,0,24,0,24,"2021"
"66564","432380 XANGRI-LA",1,1,2,240,0,244,"2021"
"66565","500020 AGUA CLARA",0,0,2,254,1,257,"2021"
"66566","500025 ALCINOPOLIS",0,0,1,44,0,45,"2021"
"66567","500060 AMAMBAI",3,4,12,610,0,629,"2021"
"66568","500070 ANASTACIO",2,0,6,404,2,414,"2021"
"66569","500080 ANAURILANDIA",0,2,1,75,1,79,"2021"
"66570","500085 ANGELICA",0,0,1,158,0,159,"2021"
"66571","500090 ANTONIO JOAO",0,0,5,133,1,139,"2021"
"66572","500100 APARECIDA DO TABOADO",0,1,0,400,0,401,"2021"
"66573","500110 AQUIDAUANA",2,0,8,711,2,723,"2021"
"66574","500124 ARAL MOREIRA",1,1,10,143,7,162,"2021"
"66575","500150 BANDEIRANTES",0,0,0,84,0,84,"2021"
"66576","500190 BATAGUASSU",2,1,3,373,0,379,"2021"
"66577","500200 BATAYPORA",0,0,0,133,0,133,"2021"
"66578","500210 BELA VISTA",0,0,3,411,1,415,"2021"
"66579","500215 BODOQUENA",0,0,2,126,0,128,"2021"
"66580","500220 BONITO",0,0,3,403,0,406,"2021"
"66581","500230 BRASILANDIA",0,0,2,139,0,141,"2021"
"66582","500240 CAARAPO",2,3,2,500,1,508,"2021"
"66583","500260 CAMAPUA",1,2,2,153,1,159,"2021"
"66584","500270 CAMPO GRANDE",23,39,118,12524,45,12749,"2021"
"66585","500280 CARACOL",0,1,1,92,0,94,"2021"
"66586","500290 CASSILANDIA",0,1,8,264,0,273,"2021"
"66587","500295 CHAPADAO DO SUL",3,3,5,511,1,523,"2021"
"66588","500310 CORGUINHO",0,0,1,17,0,18,"2021"
"66589","500315 CORONEL SAPUCAIA",0,0,5,335,22,362,"2021"
"66590","500320 CORUMBA",5,11,9,1832,10,1867,"2021"
"66591","500325 COSTA RICA",0,0,7,427,0,434,"2021"
"66592","500330 COXIM",0,6,3,453,0,462,"2021"
"66593","500345 DEODAPOLIS",0,0,1,168,0,169,"2021"
"66594","500348 DOIS IRMAOS DO BURITI",0,1,0,125,0,126,"2021"
"66595","500350 DOURADINA",0,0,2,71,1,74,"2021"
"66596","500370 DOURADOS",11,15,47,3922,26,4021,"2021"
"66597","500375 ELDORADO",0,0,1,209,0,210,"2021"
"66598","500380 FATIMA DO SUL",0,1,3,299,0,303,"2021"
"66599","500390 FIGUEIRAO",1,0,0,45,0,46,"2021"
"66600","500400 GLORIA DE DOURADOS",0,0,1,119,0,120,"2021"
"66601","500410 GUIA LOPES DA LAGUNA",0,1,2,133,0,136,"2021"
"66602","500430 IGUATEMI",0,0,3,232,0,235,"2021"
"66603","500440 INOCENCIA",0,0,2,96,0,98,"2021"
"66604","500450 ITAPORA",0,0,1,250,0,251,"2021"
"66605","500460 ITAQUIRAI",0,0,2,260,0,262,"2021"
"66606","500470 IVINHEMA",2,0,0,391,0,393,"2021"
"66607","500480 JAPORA",1,0,28,137,1,167,"2021"
"66608","500490 JARAGUARI",0,0,0,54,0,54,"2021"
"66609","500500 JARDIM",0,1,2,449,2,454,"2021"
"66610","500510 JATEI",0,0,0,58,0,58,"2021"
"66611","500515 JUTI",0,1,1,95,0,97,"2021"
"66612","500520 LADARIO",0,0,3,401,3,407,"2021"
"66613","500525 LAGUNA CARAPA",0,0,3,108,0,111,"2021"
"66614","500540 MARACAJU",0,4,3,708,0,715,"2021"
"66615","500560 MIRANDA",1,1,6,470,5,483,"2021"
"66616","500568 MUNDO NOVO",0,1,154,134,0,289,"2021"
"66617","500570 NAVIRAI",1,3,2,783,4,793,"2021"
"66618","500580 NIOAQUE",0,1,1,169,3,174,"2021"
"66619","500600 NOVA ALVORADA DO SUL",0,0,5,367,0,372,"2021"
"66620","500620 NOVA ANDRADINA",1,0,1,706,1,709,"2021"
"66621","500625 NOVO HORIZONTE DO SUL",0,0,1,70,0,71,"2021"
"66622","500627 PARAISO DAS AGUAS",0,0,0,62,0,62,"2021"
"66623","500630 PARANAIBA",1,1,2,489,0,493,"2021"
"66624","500635 PARANHOS",1,1,3,331,28,364,"2021"
"66625","500640 PEDRO GOMES",0,0,1,102,0,103,"2021"
"66626","500660 PONTA PORA",6,2,17,1792,2,1819,"2021"
"66627","500690 PORTO MURTINHO",0,2,1,229,1,233,"2021"
"66628","500710 RIBAS DO RIO PARDO",0,1,1,332,0,334,"2021"
"66629","500720 RIO BRILHANTE",1,0,6,602,3,612,"2021"
"66630","500730 RIO NEGRO",0,0,0,52,1,53,"2021"
"66631","500740 RIO VERDE DE MATO GROSSO",0,1,2,272,0,275,"2021"
"66632","500750 ROCHEDO",1,0,3,67,0,71,"2021"
"66633","500755 SANTA RITA DO PARDO",0,0,2,66,0,68,"2021"
"66634","500769 SAO GABRIEL DO OESTE",2,1,9,480,1,493,"2021"
"66635","500770 SETE QUEDAS",0,3,0,129,1,133,"2021"
"66636","500780 SELVIRIA",1,0,0,71,0,72,"2021"
"66637","500790 SIDROLANDIA",1,1,6,739,3,750,"2021"
"66638","500793 SONORA",1,1,1,240,0,243,"2021"
"66639","500795 TACURU",1,1,2,183,1,188,"2021"
"66640","500797 TAQUARUSSU",0,0,1,43,0,44,"2021"
"66641","500800 TERENOS",0,0,1,197,1,199,"2021"
"66642","500830 TRES LAGOAS",3,6,14,1911,0,1934,"2021"
"66643","500840 VICENTINA",0,2,0,86,1,89,"2021"
"66644","MUNICIPIO IGNORADO - MT",0,0,0,1,0,1,"2021"
"66645","510010 ACORIZAL",0,0,0,44,0,44,"2021"
"66646","510020 AGUA BOA",2,1,5,432,10,450,"2021"
"66647","510025 ALTA FLORESTA",3,4,8,898,0,913,"2021"
"66648","510030 ALTO ARAGUAIA",1,1,2,178,0,182,"2021"
"66649","510035 ALTO BOA VISTA",1,0,0,58,37,96,"2021"
"66650","510040 ALTO GARCAS",1,3,2,142,0,148,"2021"
"66651","510050 ALTO PARAGUAI",0,0,2,92,0,94,"2021"
"66652","510060 ALTO TAQUARI",0,0,0,150,1,151,"2021"
"66653","510080 APIACAS",0,1,3,125,1,130,"2021"
"66654","510100 ARAGUAIANA",0,0,1,46,0,47,"2021"
"66655","510120 ARAGUAINHA",0,0,0,5,0,5,"2021"
"66656","510125 ARAPUTANGA",1,0,4,248,1,254,"2021"
"66657","510130 ARENAPOLIS",0,0,3,186,0,189,"2021"
"66658","510140 ARIPUANA",2,1,4,396,0,403,"2021"
"66659","510160 BARAO DE MELGACO",0,1,0,57,0,58,"2021"
"66660","510170 BARRA DO BUGRES",0,2,5,443,0,450,"2021"
"66661","510180 BARRA DO GARCAS",2,1,8,1106,27,1144,"2021"
"66662","510185 BOM JESUS DO ARAGUAIA",0,1,1,113,3,118,"2021"
"66663","510190 BRASNORTE",0,2,4,296,5,307,"2021"
"66664","510250 CACERES",10,4,8,1456,6,1484,"2021"
"66665","510260 CAMPINAPOLIS",2,0,8,284,196,490,"2021"
"66666","510263 CAMPO NOVO DO PARECIS",1,6,11,802,1,821,"2021"
"66667","510267 CAMPO VERDE",1,3,8,813,0,825,"2021"
"66668","510268 CAMPOS DE JULIO",0,1,4,128,1,134,"2021"
"66669","510269 CANABRAVA DO NORTE",0,0,2,64,0,66,"2021"
"66670","510270 CANARANA",0,1,0,425,44,470,"2021"
"66671","510279 CARLINDA",0,0,1,141,0,142,"2021"
"66672","510285 CASTANHEIRA",0,0,3,107,0,110,"2021"
"66673","510300 CHAPADA DOS GUIMARAES",0,1,0,270,1,272,"2021"
"66674","510305 CLAUDIA",0,1,1,136,0,138,"2021"
"66675","510310 COCALINHO",0,1,0,69,2,72,"2021"
"66676","510320 COLIDER",4,4,12,436,0,456,"2021"
"66677","510325 COLNIZA",1,1,6,514,0,522,"2021"
"66678","510330 COMODORO",0,0,1,304,18,323,"2021"
"66679","510335 CONFRESA",3,1,8,674,3,689,"2021"
"66680","510336 CONQUISTA D'OESTE",1,0,0,48,0,49,"2021"
"66681","510337 COTRIGUACU",0,0,1,152,0,153,"2021"
"66682","510340 CUIABA",33,36,118,9304,10,9501,"2021"
"66683","510343 CURVELANDIA",1,0,0,54,2,57,"2021"
"66684","510345 DENISE",0,0,2,101,0,103,"2021"
"66685","510350 DIAMANTINO",2,0,2,360,0,364,"2021"
"66686","510360 DOM AQUINO",1,0,0,68,1,70,"2021"
"66687","510370 FELIZ NATAL",0,0,6,223,3,232,"2021"
"66688","510380 FIGUEIROPOLIS D'OESTE",0,0,1,31,0,32,"2021"
"66689","510385 GAUCHA DO NORTE",0,0,2,154,14,170,"2021"
"66690","510390 GENERAL CARNEIRO",0,0,0,139,1,140,"2021"
"66691","510395 GLORIA D'OESTE",0,0,0,28,0,28,"2021"
"66692","510410 GUARANTA DO NORTE",3,3,17,551,3,577,"2021"
"66693","510420 GUIRATINGA",1,0,0,82,0,83,"2021"
"66694","510450 INDIAVAI",0,0,0,24,0,24,"2021"
"66695","510452 IPIRANGA DO NORTE",0,1,2,121,1,125,"2021"
"66696","510454 ITANHANGA",0,0,4,112,0,116,"2021"
"66697","510455 ITAUBA",0,0,1,88,0,89,"2021"
"66698","510460 ITIQUIRA",1,1,5,138,2,147,"2021"
"66699","510480 JACIARA",0,1,5,420,2,428,"2021"
"66700","510490 JANGADA",0,0,2,93,0,95,"2021"
"66701","510500 JAURU",0,0,5,124,0,129,"2021"
"66702","510510 JUARA",2,2,1,648,1,654,"2021"
"66703","510515 JUINA",2,2,6,646,0,656,"2021"
"66704","510517 JURUENA",0,1,3,166,0,170,"2021"
"66705","510520 JUSCIMEIRA",0,1,0,102,1,104,"2021"
"66706","510523 LAMBARI D'OESTE",1,1,0,77,2,81,"2021"
"66707","510525 LUCAS DO RIO VERDE",0,5,22,1461,1,1489,"2021"
"66708","510530 LUCIARA",0,0,1,31,2,34,"2021"
"66709","510550 VILA BELA DA SANTISSIMA TRINDADE",0,2,2,244,6,254,"2021"
"66710","510558 MARCELANDIA",0,2,2,175,10,189,"2021"
"66711","510560 MATUPA",1,1,2,380,1,385,"2021"
"66712","510562 MIRASSOL D'OESTE",1,1,6,395,1,404,"2021"
"66713","510590 NOBRES",0,2,3,238,1,244,"2021"
"66714","510600 NORTELANDIA",0,0,0,65,0,65,"2021"
"66715","510610 NOSSA SENHORA DO LIVRAMENTO",1,3,2,111,0,117,"2021"
"66716","510615 NOVA BANDEIRANTES",0,1,3,180,0,184,"2021"
"66717","510617 NOVA NAZARE",0,1,3,53,45,102,"2021"
"66718","510618 NOVA LACERDA",0,0,0,96,0,96,"2021"
"66719","510619 NOVA SANTA HELENA",0,1,1,80,0,82,"2021"
"66720","510620 NOVA BRASILANDIA",0,0,0,46,0,46,"2021"
"66721","510621 NOVA CANAA DO NORTE",0,1,3,170,0,174,"2021"
"66722","510622 NOVA MUTUM",3,3,9,918,0,933,"2021"
"66723","510623 NOVA OLIMPIA",0,0,4,250,0,254,"2021"
"66724","510624 NOVA UBIRATA",0,0,1,195,0,196,"2021"
"66725","510625 NOVA XAVANTINA",1,0,2,308,0,311,"2021"
"66726","510626 NOVO MUNDO",0,0,1,119,0,120,"2021"
"66727","510627 NOVO HORIZONTE DO NORTE",1,0,0,38,0,39,"2021"
"66728","510628 NOVO SAO JOAQUIM",0,0,2,88,0,90,"2021"
"66729","510629 PARANAITA",0,0,0,185,0,185,"2021"
"66730","510630 PARANATINGA",0,3,9,370,21,403,"2021"
"66731","510631 NOVO SANTO ANTONIO",1,0,1,39,0,41,"2021"
"66732","510637 PEDRA PRETA",0,0,2,238,1,241,"2021"
"66733","510642 PEIXOTO DE AZEVEDO",0,2,12,636,3,653,"2021"
"66734","510645 PLANALTO DA SERRA",0,0,0,39,1,40,"2021"
"66735","510650 POCONE",1,1,3,498,0,503,"2021"
"66736","510665 PONTAL DO ARAGUAIA",0,0,0,78,0,78,"2021"
"66737","510670 PONTE BRANCA",0,0,0,14,0,14,"2021"
"66738","510675 PONTES E LACERDA",4,1,12,839,4,860,"2021"
"66739","510677 PORTO ALEGRE DO NORTE",1,0,3,168,0,172,"2021"
"66740","510680 PORTO DOS GAUCHOS",0,0,1,90,0,91,"2021"
"66741","510682 PORTO ESPERIDIAO",1,1,2,151,2,157,"2021"
"66742","510685 PORTO ESTRELA",1,0,0,40,0,41,"2021"
"66743","510700 POXOREO",0,0,0,209,2,211,"2021"
"66744","510704 PRIMAVERA DO LESTE",0,4,10,1430,0,1444,"2021"
"66745","510706 QUERENCIA",0,1,6,490,13,510,"2021"
"66746","510710 SAO JOSE DOS QUATRO MARCOS",1,0,3,211,0,215,"2021"
"66747","510715 RESERVA DO CABACAL",0,0,0,23,0,23,"2021"
"66748","510718 RIBEIRAO CASCALHEIRA",0,0,0,132,26,158,"2021"
"66749","510719 RIBEIRAOZINHO",0,1,1,25,0,27,"2021"
"66750","510720 RIO BRANCO",0,0,1,66,0,67,"2021"
"66751","510724 SANTA CARMEM",0,0,2,88,0,90,"2021"
"66752","510726 SANTO AFONSO",0,0,0,31,0,31,"2021"
"66753","510729 SAO JOSE DO POVO",0,0,0,13,0,13,"2021"
"66754","510730 SAO JOSE DO RIO CLARO",0,2,3,242,1,248,"2021"
"66755","510735 SAO JOSE DO XINGU",0,1,3,122,2,128,"2021"
"66756","510740 SAO PEDRO DA CIPA",0,0,0,56,0,56,"2021"
"66757","510757 RONDOLANDIA",0,0,0,35,0,35,"2021"
"66758","510760 RONDONOPOLIS",19,10,31,3836,21,3917,"2021"
"66759","510770 ROSARIO OESTE",0,0,2,184,0,186,"2021"
"66760","510774 SANTA CRUZ DO XINGU",0,0,0,36,0,36,"2021"
"66761","510775 SALTO DO CEU",1,0,2,39,1,43,"2021"
"66762","510776 SANTA RITA DO TRIVELATO",1,0,1,47,0,49,"2021"
"66763","510777 SANTA TEREZINHA",0,0,2,110,0,112,"2021"
"66764","510779 SANTO ANTONIO DO LESTE",1,1,1,63,18,84,"2021"
"66765","510780 SANTO ANTONIO DO LEVERGER",0,0,1,229,3,233,"2021"
"66766","510785 SAO FELIX DO ARAGUAIA",0,2,2,134,13,151,"2021"
"66767","510787 SAPEZAL",2,2,9,556,5,574,"2021"
"66768","510788 SERRA NOVA DOURADA",0,0,0,19,0,19,"2021"
"66769","510790 SINOP",7,14,29,3296,5,3351,"2021"
"66770","510792 SORRISO",2,4,23,2067,0,2096,"2021"
"66771","510794 TABAPORA",0,0,4,148,0,152,"2021"
"66772","510795 TANGARA DA SERRA",8,5,35,1698,3,1749,"2021"
"66773","510800 TAPURAH",0,3,3,211,0,217,"2021"
"66774","510805 TERRA NOVA DO NORTE",0,2,2,163,1,168,"2021"
"66775","510810 TESOURO",0,0,1,22,0,23,"2021"
"66776","510820 TORIXOREU",0,0,2,47,1,50,"2021"
"66777","510830 UNIAO DO SUL",0,0,1,40,0,41,"2021"
"66778","510835 VALE DE SAO DOMINGOS",0,0,0,35,0,35,"2021"
"66779","510840 VARZEA GRANDE",11,25,78,4541,31,4686,"2021"
"66780","510850 VERA",1,1,2,164,0,168,"2021"
"66781","510860 VILA RICA",0,0,3,269,0,272,"2021"
"66782","510880 NOVA GUARITA",1,1,1,64,1,68,"2021"
"66783","510885 NOVA MARILANDIA",0,0,1,49,0,50,"2021"
"66784","510890 NOVA MARINGA",1,1,2,74,0,78,"2021"
"66785","510895 NOVA MONTE VERDE",0,0,0,115,0,115,"2021"
"66786","MUNICIPIO IGNORADO - GO",0,0,0,2,0,2,"2021"
"66787","520005 ABADIA DE GOIAS",1,1,1,209,1,213,"2021"
"66788","520010 ABADIANIA",1,3,3,172,3,182,"2021"
"66789","520013 ACREUNA",0,1,58,180,0,239,"2021"
"66790","520015 ADELANDIA",0,0,0,24,0,24,"2021"
"66791","520017 AGUA FRIA DE GOIAS",1,0,0,48,0,49,"2021"
"66792","520020 AGUA LIMPA",0,0,1,16,0,17,"2021"
"66793","520025 AGUAS LINDAS DE GOIAS",6,21,56,2986,25,3094,"2021"
"66794","520030 ALEXANIA",1,0,6,387,4,398,"2021"
"66795","520050 ALOANDIA",0,0,0,17,0,17,"2021"
"66796","520055 ALTO HORIZONTE",0,0,1,114,0,115,"2021"
"66797","520060 ALTO PARAISO DE GOIAS",1,0,1,130,9,141,"2021"
"66798","520080 ALVORADA DO NORTE",1,1,5,124,0,131,"2021"
"66799","520082 AMARALINA",0,0,0,20,0,20,"2021"
"66800","520085 AMERICANO DO BRASIL",0,0,0,82,0,82,"2021"
"66801","520090 AMORINOPOLIS",0,0,0,25,0,25,"2021"
"66802","520110 ANAPOLIS",16,24,101,5508,22,5671,"2021"
"66803","520120 ANHANGUERA",0,0,0,7,0,7,"2021"
"66804","520130 ANICUNS",2,0,1,205,0,208,"2021"
"66805","520140 APARECIDA DE GOIANIA",24,23,84,7044,43,7218,"2021"
"66806","520145 APARECIDA DO RIO DOCE",0,0,0,20,0,20,"2021"
"66807","520150 APORE",0,0,0,69,0,69,"2021"
"66808","520160 ARACU",0,0,1,22,0,23,"2021"
"66809","520170 ARAGARCAS",4,1,3,213,0,221,"2021"
"66810","520180 ARAGOIANIA",1,2,1,151,0,155,"2021"
"66811","520215 ARAGUAPAZ",0,0,2,36,0,38,"2021"
"66812","520235 ARENOPOLIS",0,0,0,30,0,30,"2021"
"66813","520250 ARUANA",0,0,2,97,0,99,"2021"
"66814","520260 AURILANDIA",0,0,0,33,0,33,"2021"
"66815","520280 AVELINOPOLIS",0,0,0,23,0,23,"2021"
"66816","520310 BALIZA",0,0,0,30,0,30,"2021"
"66817","520320 BARRO ALTO",1,0,11,129,1,142,"2021"
"66818","520330 BELA VISTA DE GOIAS",0,2,3,414,1,420,"2021"
"66819","520340 BOM JARDIM DE GOIAS",1,1,2,116,0,120,"2021"
"66820","520350 BOM JESUS DE GOIAS",1,1,3,333,2,340,"2021"
"66821","520355 BONFINOPOLIS",1,0,0,121,1,123,"2021"
"66822","520357 BONOPOLIS",0,0,0,42,0,42,"2021"
"66823","520360 BRAZABRANTES",0,0,1,39,0,40,"2021"
"66824","520380 BRITANIA",1,0,0,85,0,86,"2021"
"66825","520390 BURITI ALEGRE",0,0,0,113,0,113,"2021"
"66826","520393 BURITI DE GOIAS",0,0,0,33,0,33,"2021"
"66827","520396 BURITINOPOLIS",0,0,0,52,0,52,"2021"
"66828","520400 CABECEIRAS",0,0,3,85,0,88,"2021"
"66829","520410 CACHOEIRA ALTA",0,0,0,111,0,111,"2021"
"66830","520420 CACHOEIRA DE GOIAS",0,0,0,19,0,19,"2021"
"66831","520425 CACHOEIRA DOURADA",1,0,1,64,0,66,"2021"
"66832","520430 CACU",0,0,1,161,0,162,"2021"
"66833","520440 CAIAPONIA",0,0,3,202,0,205,"2021"
"66834","520450 CALDAS NOVAS",2,4,14,1239,1,1260,"2021"
"66835","520455 CALDAZINHA",0,0,0,34,0,34,"2021"
"66836","520460 CAMPESTRE DE GOIAS",0,0,0,45,0,45,"2021"
"66837","520465 CAMPINACU",0,0,0,37,0,37,"2021"
"66838","520470 CAMPINORTE",1,0,0,139,0,140,"2021"
"66839","520480 CAMPO ALEGRE DE GOIAS",0,1,0,85,2,88,"2021"
"66840","520485 CAMPO LIMPO DE GOIAS",0,0,2,117,1,120,"2021"
"66841","520490 CAMPOS BELOS",0,1,12,287,0,300,"2021"
"66842","520495 CAMPOS VERDES",0,0,1,48,0,49,"2021"
"66843","520500 CARMO DO RIO VERDE",0,0,0,89,0,89,"2021"
"66844","520505 CASTELANDIA",1,0,0,27,0,28,"2021"
"66845","520510 CATALAO",7,3,13,1376,1,1400,"2021"
"66846","520520 CATURAI",0,1,0,41,0,42,"2021"
"66847","520530 CAVALCANTE",4,0,1,122,9,136,"2021"
"66848","520540 CERES",0,1,1,283,0,285,"2021"
"66849","520545 CEZARINA",2,0,0,79,0,81,"2021"
"66850","520547 CHAPADAO DO CEU",0,1,3,210,0,214,"2021"
"66851","520549 CIDADE OCIDENTAL",3,1,24,1120,8,1156,"2021"
"66852","520551 COCALZINHO DE GOIAS",0,1,5,266,5,277,"2021"
"66853","520552 COLINAS DO SUL",0,0,2,59,0,61,"2021"
"66854","520570 CORREGO DO OURO",0,0,1,23,0,24,"2021"
"66855","520580 CORUMBA DE GOIAS",0,1,1,96,1,99,"2021"
"66856","520590 CORUMBAIBA",0,0,2,100,0,102,"2021"
"66857","520620 CRISTALINA",7,6,11,890,14,928,"2021"
"66858","520630 CRISTIANOPOLIS",0,0,0,50,0,50,"2021"
"66859","520640 CRIXAS",0,0,1,195,0,196,"2021"
"66860","520650 CROMINIA",0,1,0,38,1,40,"2021"
"66861","520660 CUMARI",0,0,2,27,0,29,"2021"
"66862","520670 DAMIANOPOLIS",1,0,0,59,0,60,"2021"
"66863","520680 DAMOLANDIA",0,0,0,19,0,19,"2021"
"66864","520690 DAVINOPOLIS",0,0,0,18,0,18,"2021"
"66865","520710 DIORAMA",0,0,0,15,0,15,"2021"
"66866","520725 DOVERLANDIA",1,1,0,70,0,72,"2021"
"66867","520735 EDEALINA",0,1,1,44,0,46,"2021"
"66868","520740 EDEIA",0,0,1,136,0,137,"2021"
"66869","520750 ESTRELA DO NORTE",0,0,0,31,0,31,"2021"
"66870","520753 FAINA",0,0,0,54,1,55,"2021"
"66871","520760 FAZENDA NOVA",1,0,0,40,0,41,"2021"
"66872","520780 FIRMINOPOLIS",0,0,0,94,0,94,"2021"
"66873","520790 FLORES DE GOIAS",0,1,1,89,2,93,"2021"
"66874","520800 FORMOSA",1,5,25,1640,8,1679,"2021"
"66875","520810 FORMOSO",0,0,1,50,1,52,"2021"
"66876","520815 GAMELEIRA DE GOIAS",0,0,2,29,0,31,"2021"
"66877","520830 DIVINOPOLIS DE GOIAS",0,0,0,63,0,63,"2021"
"66878","520840 GOIANAPOLIS",0,0,7,177,1,185,"2021"
"66879","520850 GOIANDIRA",0,0,0,42,0,42,"2021"
"66880","520860 GOIANESIA",2,3,50,948,0,1003,"2021"
"66881","520870 GOIANIA",68,54,208,18325,43,18698,"2021"
"66882","520880 GOIANIRA",4,3,9,908,2,926,"2021"
"66883","520890 GOIAS",0,0,1,211,1,213,"2021"
"66884","520910 GOIATUBA",2,0,4,413,0,419,"2021"
"66885","520915 GOUVELANDIA",0,0,0,45,0,45,"2021"
"66886","520920 GUAPO",0,0,6,206,1,213,"2021"
"66887","520929 GUARAITA",0,0,0,12,0,12,"2021"
"66888","520940 GUARANI DE GOIAS",0,0,1,42,0,43,"2021"
"66889","520945 GUARINOS",0,0,0,21,1,22,"2021"
"66890","520960 HEITORAI",0,0,1,33,0,34,"2021"
"66891","520970 HIDROLANDIA",1,2,2,314,0,319,"2021"
"66892","520980 HIDROLINA",1,0,2,36,0,39,"2021"
"66893","520990 IACIARA",0,1,0,177,0,178,"2021"
"66894","520993 INACIOLANDIA",2,0,1,52,0,55,"2021"
"66895","520995 INDIARA",1,2,2,194,1,200,"2021"
"66896","521000 INHUMAS",3,5,5,587,0,600,"2021"
"66897","521010 IPAMERI",0,1,1,300,1,303,"2021"
"66898","521015 IPIRANGA DE GOIAS",0,0,0,29,0,29,"2021"
"66899","521020 IPORA",0,1,2,400,0,403,"2021"
"66900","521030 ISRAELANDIA",0,0,0,27,0,27,"2021"
"66901","521040 ITABERAI",2,3,4,553,0,562,"2021"
"66902","521056 ITAGUARI",0,0,0,50,0,50,"2021"
"66903","521060 ITAGUARU",0,0,0,41,0,41,"2021"
"66904","521080 ITAJA",1,1,0,66,0,68,"2021"
"66905","521090 ITAPACI",0,1,3,278,0,282,"2021"
"66906","521100 ITAPIRAPUA",0,0,0,73,2,75,"2021"
"66907","521120 ITAPURANGA",1,0,4,306,1,312,"2021"
"66908","521130 ITARUMA",0,0,1,64,0,65,"2021"
"66909","521140 ITAUCU",0,1,1,80,0,82,"2021"
"66910","521150 ITUMBIARA",3,5,18,1231,6,1263,"2021"
"66911","521160 IVOLANDIA",0,0,0,21,0,21,"2021"
"66912","521170 JANDAIA",0,0,0,61,0,61,"2021"
"66913","521180 JARAGUA",0,1,4,519,1,525,"2021"
"66914","521190 JATAI",4,4,17,1416,0,1441,"2021"
"66915","521200 JAUPACI",0,0,2,45,0,47,"2021"
"66916","521205 JESUPOLIS",0,0,1,21,0,22,"2021"
"66917","521210 JOVIANIA",0,1,0,83,0,84,"2021"
"66918","521220 JUSSARA",0,0,2,203,0,205,"2021"
"66919","521225 LAGOA SANTA",0,0,1,20,0,21,"2021"
"66920","521230 LEOPOLDO DE BULHOES",0,0,2,79,1,82,"2021"
"66921","521250 LUZIANIA",7,6,42,2836,28,2919,"2021"
"66922","521260 MAIRIPOTABA",0,0,0,16,0,16,"2021"
"66923","521270 MAMBAI",1,1,9,151,0,162,"2021"
"66924","521280 MARA ROSA",1,1,1,128,1,132,"2021"
"66925","521290 MARZAGAO",0,0,2,34,0,36,"2021"
"66926","521295 MATRINCHA",0,0,2,47,0,49,"2021"
"66927","521300 MAURILANDIA",0,0,1,140,0,141,"2021"
"66928","521305 MIMOSO DE GOIAS",0,0,0,27,0,27,"2021"
"66929","521308 MINACU",2,1,6,381,0,390,"2021"
"66930","521310 MINEIROS",0,7,10,1009,0,1026,"2021"
"66931","521340 MOIPORA",0,0,0,6,0,6,"2021"
"66932","521350 MONTE ALEGRE DE GOIAS",1,1,3,92,0,97,"2021"
"66933","521370 MONTES CLAROS DE GOIAS",0,0,2,96,0,98,"2021"
"66934","521375 MONTIVIDIU",0,0,2,163,0,165,"2021"
"66935","521377 MONTIVIDIU DO NORTE",1,0,1,44,1,47,"2021"
"66936","521380 MORRINHOS",3,2,3,624,0,632,"2021"
"66937","521385 MORRO AGUDO DE GOIAS",0,0,0,35,0,35,"2021"
"66938","521390 MOSSAMEDES",0,0,0,49,0,49,"2021"
"66939","521400 MOZARLANDIA",0,1,0,244,0,245,"2021"
"66940","521405 MUNDO NOVO",0,0,1,92,0,93,"2021"
"66941","521410 MUTUNOPOLIS",0,0,1,51,0,52,"2021"
"66942","521440 NAZARIO",1,0,1,80,0,82,"2021"
"66943","521450 NEROPOLIS",0,1,3,463,0,467,"2021"
"66944","521460 NIQUELANDIA",1,1,5,407,0,414,"2021"
"66945","521470 NOVA AMERICA",0,0,0,19,0,19,"2021"
"66946","521480 NOVA AURORA",0,0,0,17,0,17,"2021"
"66947","521483 NOVA CRIXAS",1,0,1,163,0,165,"2021"
"66948","521486 NOVA GLORIA",0,0,0,71,1,72,"2021"
"66949","521487 NOVA IGUACU DE GOIAS",0,0,1,34,0,35,"2021"
"66950","521490 NOVA ROMA",0,1,1,34,0,36,"2021"
"66951","521500 NOVA VENEZA",0,0,1,86,1,88,"2021"
"66952","521520 NOVO BRASIL",0,0,0,41,0,41,"2021"
"66953","521523 NOVO GAMA",4,2,31,1367,10,1414,"2021"
"66954","521525 NOVO PLANALTO",0,0,0,47,0,47,"2021"
"66955","521530 ORIZONA",1,1,0,209,1,212,"2021"
"66956","521540 OURO VERDE DE GOIAS",0,0,1,52,0,53,"2021"
"66957","521550 OUVIDOR",0,1,3,74,0,78,"2021"
"66958","521560 PADRE BERNARDO",1,1,10,380,4,396,"2021"
"66959","521565 PALESTINA DE GOIAS",0,0,1,43,0,44,"2021"
"66960","521570 PALMEIRAS DE GOIAS",1,0,8,427,1,437,"2021"
"66961","521580 PALMELO",0,0,1,9,0,10,"2021"
"66962","521590 PALMINOPOLIS",0,0,1,44,0,45,"2021"
"66963","521600 PANAMA",1,0,0,31,0,32,"2021"
"66964","521630 PARANAIGUARA",0,0,0,82,0,82,"2021"
"66965","521640 PARAUNA",0,1,4,135,0,140,"2021"
"66966","521645 PEROLANDIA",0,0,0,44,0,44,"2021"
"66967","521680 PETROLINA DE GOIAS",0,0,1,69,0,70,"2021"
"66968","521690 PILAR DE GOIAS",0,0,0,30,0,30,"2021"
"66969","521710 PIRACANJUBA",0,0,5,228,1,234,"2021"
"66970","521720 PIRANHAS",0,0,5,137,0,142,"2021"
"66971","521730 PIRENOPOLIS",1,1,4,264,1,271,"2021"
"66972","521740 PIRES DO RIO",1,0,4,363,0,368,"2021"
"66973","521760 PLANALTINA",5,6,19,1426,9,1465,"2021"
"66974","521770 PONTALINA",0,2,5,188,1,196,"2021"
"66975","521800 PORANGATU",1,4,9,539,1,554,"2021"
"66976","521805 PORTEIRAO",0,0,1,63,0,64,"2021"
"66977","521810 PORTELANDIA",0,0,1,31,0,32,"2021"
"66978","521830 POSSE",0,4,9,543,3,559,"2021"
"66979","521839 PROFESSOR JAMIL",0,0,0,30,0,30,"2021"
"66980","521850 QUIRINOPOLIS",1,2,3,615,0,621,"2021"
"66981","521860 RIALMA",0,1,0,161,0,162,"2021"
"66982","521870 RIANAPOLIS",0,0,1,43,0,44,"2021"
"66983","521878 RIO QUENTE",0,0,0,32,0,32,"2021"
"66984","521880 RIO VERDE",9,11,41,3215,8,3284,"2021"
"66985","521890 RUBIATABA",1,0,0,207,1,209,"2021"
"66986","521900 SANCLERLANDIA",0,0,1,82,0,83,"2021"
"66987","521910 SANTA BARBARA DE GOIAS",0,0,2,70,0,72,"2021"
"66988","521920 SANTA CRUZ DE GOIAS",0,0,0,18,0,18,"2021"
"66989","521925 SANTA FE DE GOIAS",0,0,0,61,0,61,"2021"
"66990","521930 SANTA HELENA DE GOIAS",2,2,5,461,0,470,"2021"
"66991","521935 SANTA ISABEL",0,0,0,34,0,34,"2021"
"66992","521940 SANTA RITA DO ARAGUAIA",0,0,0,61,0,61,"2021"
"66993","521945 SANTA RITA DO NOVO DESTINO",0,0,1,28,0,29,"2021"
"66994","521950 SANTA ROSA DE GOIAS",0,0,0,36,0,36,"2021"
"66995","521960 SANTA TEREZA DE GOIAS",0,0,0,35,0,35,"2021"
"66996","521970 SANTA TEREZINHA DE GOIAS",0,0,0,104,0,104,"2021"
"66997","521971 SANTO ANTONIO DA BARRA",0,0,3,49,0,52,"2021"
"66998","521973 SANTO ANTONIO DE GOIAS",0,0,1,71,0,72,"2021"
"66999","521975 SANTO ANTONIO DO DESCOBERTO",2,3,20,870,6,901,"2021"
"67000","521980 SAO DOMINGOS",0,1,0,121,0,122,"2021"
"67001","521990 SAO FRANCISCO DE GOIAS",0,0,1,52,2,55,"2021"
"67002","522000 SAO JOAO D'ALIANCA",0,0,3,168,3,174,"2021"
"67003","522005 SAO JOAO DA PARAUNA",0,0,0,17,0,17,"2021"
"67004","522010 SAO LUIS DE MONTES BELOS",1,0,5,403,0,409,"2021"
"67005","522015 SAO LUIZ DO NORTE",1,0,1,88,0,90,"2021"
"67006","522020 SAO MIGUEL DO ARAGUAIA",2,2,4,271,1,280,"2021"
"67007","522026 SAO MIGUEL DO PASSA QUATRO",0,0,0,39,0,39,"2021"
"67008","522028 SAO PATRICIO",0,0,0,30,0,30,"2021"
"67009","522040 SAO SIMAO",4,0,2,198,0,204,"2021"
"67010","522045 SENADOR CANEDO",4,11,18,2199,4,2236,"2021"
"67011","522050 SERRANOPOLIS",0,3,0,76,0,79,"2021"
"67012","522060 SILVANIA",0,0,1,194,0,195,"2021"
"67013","522068 SIMOLANDIA",0,0,2,87,0,89,"2021"
"67014","522070 SITIO D'ABADIA",1,0,0,26,0,27,"2021"
"67015","522100 TAQUARAL DE GOIAS",0,0,1,41,0,42,"2021"
"67016","522108 TERESINA DE GOIAS",0,0,0,37,0,37,"2021"
"67017","522119 TEREZOPOLIS DE GOIAS",0,0,1,88,0,89,"2021"
"67018","522130 TRES RANCHOS",0,0,0,19,0,19,"2021"
"67019","522140 TRINDADE",7,3,17,1801,4,1832,"2021"
"67020","522145 TROMBAS",0,1,1,43,0,45,"2021"
"67021","522150 TURVANIA",0,0,0,56,1,57,"2021"
"67022","522155 TURVELANDIA",0,0,0,61,0,61,"2021"
"67023","522157 UIRAPURU",0,0,0,20,0,20,"2021"
"67024","522160 URUACU",2,0,15,510,2,529,"2021"
"67025","522170 URUANA",1,0,1,158,0,160,"2021"
"67026","522180 URUTAI",0,0,1,26,0,27,"2021"
"67027","522185 VALPARAISO DE GOIAS",11,5,51,2274,17,2358,"2021"
"67028","522190 VARJAO",0,0,0,27,1,28,"2021"
"67029","522200 VIANOPOLIS",0,1,2,204,0,207,"2021"
"67030","522205 VICENTINOPOLIS",0,0,0,98,1,99,"2021"
"67031","522220 VILA BOA",0,0,2,60,2,64,"2021"
"67032","522230 VILA PROPICIO",0,0,5,65,0,70,"2021"
"67033","530010 BRASILIA",134,146,595,36995,165,38035,"2021"
"67034","TOTAL",7171,9880,37143,2476782,30946,2561922,"2022"
"67035","MUNICIPIO IGNORADO - RO",0,0,0,2,0,2,"2022"
"67036","110001 ALTA FLORESTA D'OESTE",1,1,6,354,6,368,"2022"
"67037","110002 ARIQUEMES",2,18,60,1425,0,1505,"2022"
"67038","110003 CABIXI",0,0,2,60,2,64,"2022"
"67039","110004 CACOAL",3,1,12,1335,2,1353,"2022"
"67040","110005 CEREJEIRAS",0,0,1,270,1,272,"2022"
"67041","110006 COLORADO DO OESTE",0,0,7,197,1,205,"2022"
"67042","110007 CORUMBIARA",0,0,2,99,2,103,"2022"
"67043","110008 COSTA MARQUES",0,0,6,210,2,218,"2022"
"67044","110009 ESPIGAO D'OESTE",1,4,11,445,1,462,"2022"
"67045","110010 GUAJARA-MIRIM",1,2,11,722,12,748,"2022"
"67046","110011 JARU",2,3,6,878,1,890,"2022"
"67047","110012 JI-PARANA",3,10,41,1951,5,2010,"2022"
"67048","110013 MACHADINHO D'OESTE",1,7,10,478,2,498,"2022"
"67049","110014 NOVA BRASILANDIA D'OESTE",0,1,8,226,1,236,"2022"
"67050","110015 OURO PRETO DO OESTE",1,1,12,516,2,532,"2022"
"67051","110018 PIMENTA BUENO",3,3,13,567,1,587,"2022"
"67052","110020 PORTO VELHO",13,17,72,7188,64,7354,"2022"
"67053","110025 PRESIDENTE MEDICI",0,1,3,290,0,294,"2022"
"67054","110026 RIO CRESPO",0,0,1,34,0,35,"2022"
"67055","110028 ROLIM DE MOURA",0,1,16,814,4,835,"2022"
"67056","110029 SANTA LUZIA D'OESTE",0,0,0,73,0,73,"2022"
"67057","110030 VILHENA",4,1,12,1508,2,1527,"2022"
"67058","110032 SAO MIGUEL DO GUAPORE",0,3,10,374,1,388,"2022"
"67059","110033 NOVA MAMORE",0,4,12,444,4,464,"2022"
"67060","110034 ALVORADA D'OESTE",0,0,1,182,0,183,"2022"
"67061","110037 ALTO ALEGRE DOS PARECIS",0,0,1,148,1,150,"2022"
"67062","110040 ALTO PARAISO",0,1,6,196,1,204,"2022"
"67063","110045 BURITIS",1,1,4,510,1,517,"2022"
"67064","110050 NOVO HORIZONTE DO OESTE",0,0,1,101,0,102,"2022"
"67065","110060 CACAULANDIA",0,0,1,63,0,64,"2022"
"67066","110070 CAMPO NOVO DE RONDONIA",0,1,2,133,1,137,"2022"
"67067","110080 CANDEIAS DO JAMARI",0,0,4,328,2,334,"2022"
"67068","110090 CASTANHEIRAS",0,0,0,29,0,29,"2022"
"67069","110092 CHUPINGUAIA",0,0,3,159,0,162,"2022"
"67070","110094 CUJUBIM",0,2,3,201,2,208,"2022"
"67071","110100 GOVERNADOR JORGE TEIXEIRA",0,0,0,86,0,86,"2022"
"67072","110110 ITAPUA DO OESTE",2,0,1,104,0,107,"2022"
"67073","110120 MINISTRO ANDREAZZA",0,0,0,73,0,73,"2022"
"67074","110130 MIRANTE DA SERRA",0,0,2,128,0,130,"2022"
"67075","110140 MONTE NEGRO",1,3,5,157,0,166,"2022"
"67076","110143 NOVA UNIAO",0,1,0,102,0,103,"2022"
"67077","110145 PARECIS",0,0,0,45,0,45,"2022"
"67078","110146 PIMENTEIRAS DO OESTE",0,0,0,35,0,35,"2022"
"67079","110147 PRIMAVERA DE RONDONIA",1,0,2,37,0,40,"2022"
"67080","110148 SAO FELIPE D'OESTE",0,0,1,59,0,60,"2022"
"67081","110149 SAO FRANCISCO DO GUAPORE",1,1,6,275,3,286,"2022"
"67082","110150 SERINGUEIRAS",0,2,7,178,0,187,"2022"
"67083","110155 TEIXEIROPOLIS",0,0,2,51,0,53,"2022"
"67084","110160 THEOBROMA",0,1,1,87,2,91,"2022"
"67085","110170 URUPA",0,0,1,159,1,161,"2022"
"67086","110175 VALE DO ANARI",0,1,2,78,0,81,"2022"
"67087","110180 VALE DO PARAISO",0,1,4,79,0,84,"2022"
"67088","120001 ACRELANDIA",0,0,1,203,1,205,"2022"
"67089","120005 ASSIS BRASIL",0,0,3,184,48,235,"2022"
"67090","120010 BRASILEIA",2,1,3,531,5,542,"2022"
"67091","120013 BUJARI",1,0,1,221,7,230,"2022"
"67092","120017 CAPIXABA",1,0,2,176,3,182,"2022"
"67093","120020 CRUZEIRO DO SUL",0,7,35,1528,5,1575,"2022"
"67094","120025 EPITACIOLANDIA",0,0,2,273,3,278,"2022"
"67095","120030 FEIJO",1,1,5,706,96,809,"2022"
"67096","120032 JORDAO",0,0,3,133,94,230,"2022"
"67097","120033 MANCIO LIMA",0,2,7,316,5,330,"2022"
"67098","120034 MANOEL URBANO",0,0,0,200,42,242,"2022"
"67099","120035 MARECHAL THAUMATURGO",0,2,0,288,78,368,"2022"
"67100","120038 PLACIDO DE CASTRO",0,0,3,250,3,256,"2022"
"67101","120039 PORTO WALTER",2,1,4,245,14,266,"2022"
"67102","120040 RIO BRANCO",7,19,36,5159,132,5353,"2022"
"67103","120042 RODRIGUES ALVES",0,2,4,307,8,321,"2022"
"67104","120043 SANTA ROSA DO PURUS",1,0,4,120,91,216,"2022"
"67105","120045 SENADOR GUIOMARD",0,1,5,328,10,344,"2022"
"67106","120050 SENA MADUREIRA",2,2,7,734,18,763,"2022"
"67107","120060 TARAUACA",2,2,10,987,87,1088,"2022"
"67108","120070 XAPURI",1,3,1,299,10,314,"2022"
"67109","120080 PORTO ACRE",3,0,3,323,7,336,"2022"
"67110","MUNICIPIO IGNORADO - AM",0,0,0,4,0,4,"2022"
"67111","130002 ALVARAES",1,3,7,319,0,330,"2022"
"67112","130006 AMATURA",0,2,5,189,63,259,"2022"
"67113","130008 ANAMA",0,0,1,179,0,180,"2022"
"67114","130010 ANORI",0,1,3,228,6,238,"2022"
"67115","130014 APUI",1,1,3,266,0,271,"2022"
"67116","130020 ATALAIA DO NORTE",0,0,2,213,159,374,"2022"
"67117","130030 AUTAZES",1,6,16,785,48,856,"2022"
"67118","130040 BARCELOS",1,0,5,330,54,390,"2022"
"67119","130050 BARREIRINHA",1,5,2,686,121,815,"2022"
"67120","130060 BENJAMIN CONSTANT",0,3,7,944,5,959,"2022"
"67121","130063 BERURI",0,0,5,414,88,507,"2022"
"67122","130068 BOA VISTA DO RAMOS",0,0,9,266,0,275,"2022"
"67123","130070 BOCA DO ACRE",1,3,9,657,7,677,"2022"
"67124","130080 BORBA",1,4,18,721,9,753,"2022"
"67125","130083 CAAPIRANGA",0,2,4,203,8,217,"2022"
"67126","130090 CANUTAMA",0,1,0,171,3,175,"2022"
"67127","130100 CARAUARI",2,9,37,515,12,575,"2022"
"67128","130110 CAREIRO",1,2,3,537,5,548,"2022"
"67129","130115 CAREIRO DA VARZEA",0,1,2,198,18,219,"2022"
"67130","130120 COARI",3,5,8,1519,1,1536,"2022"
"67131","130130 CODAJAS",1,3,3,450,0,457,"2022"
"67132","130140 EIRUNEPE",2,10,16,633,89,750,"2022"
"67133","130150 ENVIRA",1,1,2,303,36,343,"2022"
"67134","130160 FONTE BOA",0,5,10,536,2,553,"2022"
"67135","130165 GUAJARA",1,0,4,273,8,286,"2022"
"67136","130170 HUMAITA",4,5,7,977,4,997,"2022"
"67137","130180 IPIXUNA",1,0,1,330,63,395,"2022"
"67138","130185 IRANDUBA",1,1,10,891,15,918,"2022"
"67139","130190 ITACOATIARA",4,0,17,1815,39,1875,"2022"
"67140","130195 ITAMARATI",0,0,0,202,58,260,"2022"
"67141","130200 ITAPIRANGA",1,1,2,173,0,177,"2022"
"67142","130210 JAPURA",0,2,3,158,10,173,"2022"
"67143","130220 JURUA",0,2,1,205,2,210,"2022"
"67144","130230 JUTAI",1,0,2,577,120,700,"2022"
"67145","130240 LABREA",2,5,23,774,13,817,"2022"
"67146","130250 MANACAPURU",5,4,8,2006,1,2024,"2022"
"67147","130255 MANAQUIRI",1,0,3,297,4,305,"2022"
"67148","130260 MANAUS",59,72,233,33984,359,34707,"2022"
"67149","130270 MANICORE",7,5,65,786,80,943,"2022"
"67150","130280 MARAA",1,1,4,322,13,341,"2022"
"67151","130290 MAUES",5,4,34,995,248,1286,"2022"
"67152","130300 NHAMUNDA",2,3,3,309,22,339,"2022"
"67153","130310 NOVA OLINDA DO NORTE",1,0,5,551,34,591,"2022"
"67154","130320 NOVO AIRAO",1,1,2,262,1,267,"2022"
"67155","130330 NOVO ARIPUANA",1,0,27,345,16,389,"2022"
"67156","130340 PARINTINS",8,14,21,1801,79,1923,"2022"
"67157","130350 PAUINI",0,0,10,300,38,348,"2022"
"67158","130353 PRESIDENTE FIGUEIREDO",0,3,3,555,1,562,"2022"
"67159","130356 RIO PRETO DA EVA",0,1,1,387,5,394,"2022"
"67160","130360 SANTA ISABEL DO RIO NEGRO",0,0,2,168,158,328,"2022"
"67161","130370 SANTO ANTONIO DO ICA",0,0,4,609,174,787,"2022"
"67162","130380 SAO GABRIEL DA CACHOEIRA",1,2,12,943,496,1454,"2022"
"67163","130390 SAO PAULO DE OLIVENCA",2,3,4,453,461,923,"2022"
"67164","130395 SAO SEBASTIAO DO UATUMA",0,1,0,179,0,180,"2022"
"67165","130400 SILVES",1,1,3,184,2,191,"2022"
"67166","130406 TABATINGA",3,1,7,1085,420,1516,"2022"
"67167","130410 TAPAUA",2,1,4,402,35,444,"2022"
"67168","130420 TEFE",7,8,12,1824,7,1858,"2022"
"67169","130423 TONANTINS",1,1,3,433,1,439,"2022"
"67170","130426 UARINI",2,0,2,335,1,340,"2022"
"67171","130430 URUCARA",1,1,3,260,1,266,"2022"
"67172","130440 URUCURITUBA",0,0,2,281,22,305,"2022"
"67173","MUNICIPIO IGNORADO - RR",0,0,0,1,0,1,"2022"
"67174","140002 AMAJARI",1,0,1,210,219,431,"2022"
"67175","140005 ALTO ALEGRE",6,0,1,250,446,703,"2022"
"67176","140010 BOA VISTA",104,20,80,7573,62,7839,"2022"
"67177","140015 BONFIM",6,1,3,347,73,430,"2022"
"67178","140017 CANTA",9,0,4,349,31,393,"2022"
"67179","140020 CARACARAI",2,0,0,277,53,332,"2022"
"67180","140023 CAROEBE",0,0,1,177,3,181,"2022"
"67181","140028 IRACEMA",3,1,2,108,30,144,"2022"
"67182","140030 MUCAJAI",6,0,5,282,30,323,"2022"
"67183","140040 NORMANDIA",8,0,3,326,108,445,"2022"
"67184","140045 PACARAIMA",8,3,9,462,62,544,"2022"
"67185","140047 RORAINOPOLIS",4,3,6,552,5,570,"2022"
"67186","140050 SAO JOAO DA BALIZA",0,1,3,110,2,116,"2022"
"67187","140060 SAO LUIZ",0,1,1,122,1,125,"2022"
"67188","140070 UIRAMUTA",7,3,3,289,212,514,"2022"
"67189","MUNICIPIO IGNORADO - PA",0,0,0,2,0,2,"2022"
"67190","150010 ABAETETUBA",5,12,20,2406,9,2452,"2022"
"67191","150013 ABEL FIGUEIREDO",1,0,1,101,0,103,"2022"
"67192","150020 ACARA",3,4,12,908,15,942,"2022"
"67193","150030 AFUA",2,4,10,988,40,1044,"2022"
"67194","150034 AGUA AZUL DO NORTE",0,3,2,213,1,219,"2022"
"67195","150040 ALENQUER",5,10,8,1004,29,1056,"2022"
"67196","150050 ALMEIRIM",3,2,12,651,9,677,"2022"
"67197","150060 ALTAMIRA",1,6,16,2217,43,2283,"2022"
"67198","150070 ANAJAS",7,13,25,652,90,787,"2022"
"67199","150080 ANANINDEUA",19,19,66,6153,24,6281,"2022"
"67200","150085 ANAPU",0,0,1,580,2,583,"2022"
"67201","150090 AUGUSTO CORREA",3,8,12,662,13,698,"2022"
"67202","150095 AURORA DO PARA",1,2,12,336,0,351,"2022"
"67203","150100 AVEIRO",0,0,5,157,12,174,"2022"
"67204","150110 BAGRE",2,0,8,443,102,555,"2022"
"67205","150120 BAIAO",3,2,13,507,13,538,"2022"
"67206","150125 BANNACH",1,0,0,47,0,48,"2022"
"67207","150130 BARCARENA",3,6,20,2175,6,2210,"2022"
"67208","150140 BELEM",54,58,190,15502,61,15865,"2022"
"67209","150145 BELTERRA",3,0,14,326,8,351,"2022"
"67210","150150 BENEVIDES",6,9,10,832,3,860,"2022"
"67211","150157 BOM JESUS DO TOCANTINS",0,0,4,231,3,238,"2022"
"67212","150160 BONITO",0,0,1,198,0,199,"2022"
"67213","150170 BRAGANCA",2,12,22,1931,18,1985,"2022"
"67214","150172 BRASIL NOVO",1,2,0,301,0,304,"2022"
"67215","150175 BREJO GRANDE DO ARAGUAIA",0,2,1,102,3,108,"2022"
"67216","150178 BREU BRANCO",2,0,3,633,2,640,"2022"
"67217","150180 BREVES",7,19,48,2564,25,2663,"2022"
"67218","150190 BUJARU",1,0,3,379,11,394,"2022"
"67219","150195 CACHOEIRA DO PIRIA",1,0,3,290,20,314,"2022"
"67220","150200 CACHOEIRA DO ARARI",0,4,4,313,0,321,"2022"
"67221","150210 CAMETA",13,53,225,1876,46,2213,"2022"
"67222","150215 CANAA DOS CARAJAS",4,7,27,1436,2,1476,"2022"
"67223","150220 CAPANEMA",3,3,10,958,3,977,"2022"
"67224","150230 CAPITAO POCO",2,1,9,824,8,844,"2022"
"67225","150240 CASTANHAL",5,8,31,2986,4,3034,"2022"
"67226","150250 CHAVES",1,3,5,298,54,361,"2022"
"67227","150260 COLARES",1,1,0,123,5,130,"2022"
"67228","150270 CONCEICAO DO ARAGUAIA",2,2,14,691,3,712,"2022"
"67229","150275 CONCORDIA DO PARA",1,3,4,491,3,502,"2022"
"67230","150276 CUMARU DO NORTE",0,1,2,137,1,141,"2022"
"67231","150277 CURIONOPOLIS",0,0,5,360,3,368,"2022"
"67232","150280 CURRALINHO",4,3,13,607,54,681,"2022"
"67233","150285 CURUA",0,3,2,168,37,210,"2022"
"67234","150290 CURUCA",2,2,8,468,4,484,"2022"
"67235","150293 DOM ELISEU",2,1,7,624,2,636,"2022"
"67236","150295 ELDORADO DOS CARAJAS",1,1,5,431,1,439,"2022"
"67237","150300 FARO",0,1,0,124,3,128,"2022"
"67238","150304 FLORESTA DO ARAGUAIA",2,0,0,290,0,292,"2022"
"67239","150307 GARRAFAO DO NORTE",0,2,9,345,13,369,"2022"
"67240","150309 GOIANESIA DO PARA",1,0,3,517,2,523,"2022"
"67241","150310 GURUPA",1,3,6,675,36,721,"2022"
"67242","150320 IGARAPE-ACU",2,6,9,479,1,497,"2022"
"67243","150330 IGARAPE-MIRI",2,3,10,1006,29,1050,"2022"
"67244","150340 INHANGAPI",0,0,1,143,0,144,"2022"
"67245","150345 IPIXUNA DO PARA",1,2,14,552,2,571,"2022"
"67246","150350 IRITUIA",1,3,3,382,2,391,"2022"
"67247","150360 ITAITUBA",18,14,45,2430,26,2533,"2022"
"67248","150370 ITUPIRANGA",5,1,10,786,1,803,"2022"
"67249","150375 JACAREACANGA",3,2,8,349,263,625,"2022"
"67250","150380 JACUNDA",2,1,3,575,2,583,"2022"
"67251","150390 JURUTI",3,4,23,1051,42,1123,"2022"
"67252","150400 LIMOEIRO DO AJURU",0,3,32,365,17,417,"2022"
"67253","150405 MAE DO RIO",1,3,8,460,3,475,"2022"
"67254","150410 MAGALHAES BARATA",0,0,2,86,1,89,"2022"
"67255","150420 MARABA",20,10,25,4121,27,4203,"2022"
"67256","150430 MARACANA",0,1,5,319,1,326,"2022"
"67257","150440 MARAPANIM",1,2,2,264,0,269,"2022"
"67258","150442 MARITUBA",5,4,17,1525,9,1560,"2022"
"67259","150445 MEDICILANDIA",0,0,2,473,1,476,"2022"
"67260","150450 MELGACO",2,4,11,408,104,529,"2022"
"67261","150460 MOCAJUBA",2,2,11,479,7,501,"2022"
"67262","150470 MOJU",1,5,11,1106,15,1138,"2022"
"67263","150475 MOJUI DOS CAMPOS",2,3,6,360,4,375,"2022"
"67264","150480 MONTE ALEGRE",1,3,4,1086,0,1094,"2022"
"67265","150490 MUANA",1,4,26,579,5,615,"2022"
"67266","150495 NOVA ESPERANCA DO PIRIA",1,1,5,289,1,297,"2022"
"67267","150497 NOVA IPIXUNA",0,0,1,186,2,189,"2022"
"67268","150500 NOVA TIMBOTEUA",1,1,0,140,1,143,"2022"
"67269","150503 NOVO PROGRESSO",0,2,7,702,1,712,"2022"
"67270","150506 NOVO REPARTIMENTO",3,8,8,1097,1,1117,"2022"
"67271","150510 OBIDOS",4,4,17,901,62,988,"2022"
"67272","150520 OEIRAS DO PARA",5,7,35,548,28,623,"2022"
"67273","150530 ORIXIMINA",5,6,13,1308,46,1378,"2022"
"67274","150540 OUREM",0,0,0,242,2,244,"2022"
"67275","150543 OURILANDIA DO NORTE",1,2,3,621,1,628,"2022"
"67276","150548 PACAJA",2,4,4,726,2,738,"2022"
"67277","150549 PALESTINA DO PARA",0,0,0,105,1,106,"2022"
"67278","150550 PARAGOMINAS",1,7,21,1759,4,1792,"2022"
"67279","150553 PARAUAPEBAS",7,18,47,4943,4,5019,"2022"
"67280","150555 PAU D'ARCO",2,0,4,104,0,110,"2022"
"67281","150560 PEIXE-BOI",0,0,0,58,0,58,"2022"
"67282","150563 PICARRA",0,0,1,144,0,145,"2022"
"67283","150565 PLACAS",3,0,7,321,0,331,"2022"
"67284","150570 PONTA DE PEDRAS",0,2,4,344,12,362,"2022"
"67285","150580 PORTEL",13,8,5,1274,285,1585,"2022"
"67286","150590 PORTO DE MOZ",0,0,7,658,3,668,"2022"
"67287","150600 PRAINHA",1,2,10,612,74,699,"2022"
"67288","150610 PRIMAVERA",0,0,3,174,1,178,"2022"
"67289","150611 QUATIPURU",2,1,3,112,1,119,"2022"
"67290","150613 REDENCAO",3,7,23,1645,1,1679,"2022"
"67291","150616 RIO MARIA",1,0,5,264,0,270,"2022"
"67292","150618 RONDON DO PARA",1,0,4,555,0,560,"2022"
"67293","150619 RUROPOLIS",2,1,8,441,1,453,"2022"
"67294","150620 SALINOPOLIS",2,3,2,709,0,716,"2022"
"67295","150630 SALVATERRA",2,2,3,318,1,326,"2022"
"67296","150635 SANTA BARBARA DO PARA",2,1,1,307,4,315,"2022"
"67297","150640 SANTA CRUZ DO ARARI",0,2,2,66,6,76,"2022"
"67298","150650 SANTA IZABEL DO PARA",1,4,8,860,4,877,"2022"
"67299","150655 SANTA LUZIA DO PARA",1,1,1,268,2,273,"2022"
"67300","150658 SANTA MARIA DAS BARREIRAS",0,0,4,210,0,214,"2022"
"67301","150660 SANTA MARIA DO PARA",0,1,3,374,3,381,"2022"
"67302","150670 SANTANA DO ARAGUAIA",1,1,18,585,0,605,"2022"
"67303","150680 SANTAREM",25,40,116,5996,331,6508,"2022"
"67304","150690 SANTAREM NOVO",0,0,0,81,0,81,"2022"
"67305","150700 SANTO ANTONIO DO TAUA",1,3,1,406,2,413,"2022"
"67306","150710 SAO CAETANO DE ODIVELAS",0,0,2,200,3,205,"2022"
"67307","150715 SAO DOMINGOS DO ARAGUAIA",2,0,6,343,0,351,"2022"
"67308","150720 SAO DOMINGOS DO CAPIM",0,2,6,388,8,404,"2022"
"67309","150730 SAO FELIX DO XINGU",3,2,28,998,5,1036,"2022"
"67310","150740 SAO FRANCISCO DO PARA",0,0,3,195,0,198,"2022"
"67311","150745 SAO GERALDO DO ARAGUAIA",3,0,1,462,2,468,"2022"
"67312","150746 SAO JOAO DA PONTA",0,0,1,64,0,65,"2022"
"67313","150747 SAO JOAO DE PIRABAS",1,0,1,249,1,252,"2022"
"67314","150750 SAO JOAO DO ARAGUAIA",1,0,1,172,2,176,"2022"
"67315","150760 SAO MIGUEL DO GUAMA",2,3,10,878,2,895,"2022"
"67316","150770 SAO SEBASTIAO DA BOA VISTA",2,3,9,482,18,514,"2022"
"67317","150775 SAPUCAIA",0,0,3,80,0,83,"2022"
"67318","150780 SENADOR JOSE PORFIRIO",0,3,4,295,1,303,"2022"
"67319","150790 SOURE",2,0,0,389,0,391,"2022"
"67320","150795 TAILANDIA",2,3,10,1351,0,1366,"2022"
"67321","150796 TERRA ALTA",0,0,0,142,0,142,"2022"
"67322","150797 TERRA SANTA",1,0,5,262,0,268,"2022"
"67323","150800 TOME-ACU",3,0,20,1360,3,1386,"2022"
"67324","150803 TRACUATEUA",1,3,5,397,5,411,"2022"
"67325","150805 TRAIRAO",0,0,4,287,0,291,"2022"
"67326","150808 TUCUMA",0,0,10,695,1,706,"2022"
"67327","150810 TUCURUI",2,9,20,1417,7,1455,"2022"
"67328","150812 ULIANOPOLIS",0,2,4,398,0,404,"2022"
"67329","150815 URUARA",7,2,5,772,0,786,"2022"
"67330","150820 VIGIA",1,1,6,611,3,622,"2022"
"67331","150830 VISEU",2,3,8,707,106,826,"2022"
"67332","150835 VITORIA DO XINGU",0,1,3,305,1,310,"2022"
"67333","150840 XINGUARA",1,4,10,818,4,837,"2022"
"67334","160005 SERRA DO NAVIO",0,0,0,60,1,61,"2022"
"67335","160010 AMAPA",0,1,1,177,5,184,"2022"
"67336","160015 PEDRA BRANCA DO AMAPARI",0,2,6,268,14,290,"2022"
"67337","160020 CALCOENE",1,2,2,155,14,174,"2022"
"67338","160021 CUTIAS",0,0,0,100,1,101,"2022"
"67339","160023 FERREIRA GOMES",0,1,2,144,2,149,"2022"
"67340","160025 ITAUBAL",1,0,1,126,11,139,"2022"
"67341","160027 LARANJAL DO JARI",4,3,13,577,1,598,"2022"
"67342","160030 MACAPA",36,31,91,7719,86,7963,"2022"
"67343","160040 MAZAGAO",0,1,11,439,34,485,"2022"
"67344","160050 OIAPOQUE",6,4,10,464,75,559,"2022"
"67345","160053 PORTO GRANDE",1,0,2,344,6,353,"2022"
"67346","160055 PRACUUBA",0,0,1,61,16,78,"2022"
"67347","160060 SANTANA",1,8,27,1945,9,1990,"2022"
"67348","160070 TARTARUGALZINHO",1,3,6,229,46,285,"2022"
"67349","160080 VITORIA DO JARI",1,0,0,204,1,206,"2022"
"67350","170025 ABREULANDIA",0,0,1,32,1,34,"2022"
"67351","170030 AGUIARNOPOLIS",0,0,1,76,0,77,"2022"
"67352","170035 ALIANCA DO TOCANTINS",0,0,1,56,0,57,"2022"
"67353","170040 ALMAS",1,0,2,95,0,98,"2022"
"67354","170070 ALVORADA",1,1,1,117,0,120,"2022"
"67355","170100 ANANAS",0,2,0,132,1,135,"2022"
"67356","170105 ANGICO",0,0,3,38,0,41,"2022"
"67357","170110 APARECIDA DO RIO NEGRO",1,0,0,76,1,78,"2022"
"67358","170130 ARAGOMINAS",0,0,0,69,0,69,"2022"
"67359","170190 ARAGUACEMA",0,1,1,68,1,71,"2022"
"67360","170200 ARAGUACU",0,0,1,102,1,104,"2022"
"67361","170210 ARAGUAINA",2,5,41,2899,14,2961,"2022"
"67362","170215 ARAGUANA",0,1,0,44,0,45,"2022"
"67363","170220 ARAGUATINS",0,2,7,451,13,473,"2022"
"67364","170230 ARAPOEMA",0,0,3,79,0,82,"2022"
"67365","170240 ARRAIAS",0,1,4,99,1,105,"2022"
"67366","170255 AUGUSTINOPOLIS",1,2,3,275,12,293,"2022"
"67367","170270 AURORA DO TOCANTINS",0,0,1,23,0,24,"2022"
"67368","170290 AXIXA DO TOCANTINS",0,1,5,155,3,164,"2022"
"67369","170300 BABACULANDIA",0,1,2,89,1,93,"2022"
"67370","170305 BANDEIRANTES DO TOCANTINS",1,0,0,47,2,50,"2022"
"67371","170307 BARRA DO OURO",0,0,1,64,3,68,"2022"
"67372","170310 BARROLANDIA",0,0,0,59,2,61,"2022"
"67373","170320 BERNARDO SAYAO",0,0,0,45,0,45,"2022"
"67374","170330 BOM JESUS DO TOCANTINS",0,0,0,85,0,85,"2022"
"67375","170360 BRASILANDIA DO TOCANTINS",0,0,0,28,0,28,"2022"
"67376","170370 BREJINHO DE NAZARE",0,0,1,52,0,53,"2022"
"67377","170380 BURITI DO TOCANTINS",0,0,1,112,7,120,"2022"
"67378","170382 CACHOEIRINHA",0,0,0,25,1,26,"2022"
"67379","170384 CAMPOS LINDOS",0,0,3,153,4,160,"2022"
"67380","170386 CARIRI DO TOCANTINS",0,0,0,59,0,59,"2022"
"67381","170388 CARMOLANDIA",0,0,0,27,0,27,"2022"
"67382","170389 CARRASCO BONITO",1,0,3,48,2,54,"2022"
"67383","170390 CASEARA",0,0,0,62,0,62,"2022"
"67384","170410 CENTENARIO",0,0,0,15,0,15,"2022"
"67385","170460 CHAPADA DE AREIA",0,0,0,26,0,26,"2022"
"67386","170510 CHAPADA DA NATIVIDADE",0,0,0,43,0,43,"2022"
"67387","170550 COLINAS DO TOCANTINS",0,2,6,502,1,511,"2022"
"67388","170555 COMBINADO",0,1,2,54,0,57,"2022"
"67389","170560 CONCEICAO DO TOCANTINS",0,1,0,51,0,52,"2022"
"67390","170600 COUTO MAGALHAES",0,0,0,65,0,65,"2022"
"67391","170610 CRISTALANDIA",0,0,1,71,1,73,"2022"
"67392","170625 CRIXAS DO TOCANTINS",0,0,0,16,0,16,"2022"
"67393","170650 DARCINOPOLIS",1,2,3,94,2,102,"2022"
"67394","170700 DIANOPOLIS",5,2,2,279,3,291,"2022"
"67395","170710 DIVINOPOLIS DO TOCANTINS",0,0,0,87,0,87,"2022"
"67396","170720 DOIS IRMAOS DO TOCANTINS",0,0,0,82,0,82,"2022"
"67397","170730 DUERE",0,0,1,55,2,58,"2022"
"67398","170740 ESPERANTINA",0,0,1,106,11,118,"2022"
"67399","170755 FATIMA",0,0,0,53,0,53,"2022"
"67400","170765 FIGUEIROPOLIS",0,0,1,57,0,58,"2022"
"67401","170770 FILADELFIA",0,0,3,96,3,102,"2022"
"67402","170820 FORMOSO DO ARAGUAIA",0,0,7,270,1,278,"2022"
"67403","170825 FORTALEZA DO TABOCAO",0,0,0,55,0,55,"2022"
"67404","170830 GOIANORTE",0,0,1,47,1,49,"2022"
"67405","170900 GOIATINS",0,2,1,215,17,235,"2022"
"67406","170930 GUARAI",1,1,2,326,0,330,"2022"
"67407","170950 GURUPI",2,1,8,1233,0,1244,"2022"
"67408","170980 IPUEIRAS",0,0,0,9,0,9,"2022"
"67409","171050 ITACAJA",1,0,1,116,1,119,"2022"
"67410","171070 ITAGUATINS",0,0,0,62,2,64,"2022"
"67411","171090 ITAPIRATINS",0,0,1,48,0,49,"2022"
"67412","171110 ITAPORA DO TOCANTINS",0,0,0,46,0,46,"2022"
"67413","171150 JAU DO TOCANTINS",0,1,0,33,0,34,"2022"
"67414","171180 JUARINA",0,1,0,34,0,35,"2022"
"67415","171190 LAGOA DA CONFUSAO",2,0,4,251,3,260,"2022"
"67416","171195 LAGOA DO TOCANTINS",1,0,1,72,1,75,"2022"
"67417","171200 LAJEADO",0,0,1,42,0,43,"2022"
"67418","171215 LAVANDEIRA",1,0,0,22,0,23,"2022"
"67419","171240 LIZARDA",1,0,0,43,0,44,"2022"
"67420","171245 LUZINOPOLIS",0,0,0,34,2,36,"2022"
"67421","171250 MARIANOPOLIS DO TOCANTINS",0,0,1,76,0,77,"2022"
"67422","171270 MATEIROS",0,1,1,46,1,49,"2022"
"67423","171280 MAURILANDIA DO TOCANTINS",0,0,1,33,1,35,"2022"
"67424","171320 MIRACEMA DO TOCANTINS",3,1,2,264,0,270,"2022"
"67425","171330 MIRANORTE",0,1,2,187,0,190,"2022"
"67426","171360 MONTE DO CARMO",1,0,0,68,0,69,"2022"
"67427","171370 MONTE SANTO DO TOCANTINS",0,0,0,20,0,20,"2022"
"67428","171380 PALMEIRAS DO TOCANTINS",0,0,3,67,1,71,"2022"
"67429","171395 MURICILANDIA",0,0,0,34,1,35,"2022"
"67430","171420 NATIVIDADE",0,0,2,107,1,110,"2022"
"67431","171430 NAZARE",0,1,0,60,0,61,"2022"
"67432","171488 NOVA OLINDA",0,0,2,159,4,165,"2022"
"67433","171500 NOVA ROSALANDIA",0,0,0,35,0,35,"2022"
"67434","171510 NOVO ACORDO",0,0,2,78,3,83,"2022"
"67435","171515 NOVO ALEGRE",0,0,2,9,0,11,"2022"
"67436","171525 NOVO JARDIM",1,0,0,30,1,32,"2022"
"67437","171550 OLIVEIRA DE FATIMA",0,0,0,21,0,21,"2022"
"67438","171570 PALMEIRANTE",0,0,2,59,1,62,"2022"
"67439","171575 PALMEIROPOLIS",0,0,0,84,0,84,"2022"
"67440","171610 PARAISO DO TOCANTINS",2,0,3,755,0,760,"2022"
"67441","171620 PARANA",0,4,3,134,0,141,"2022"
"67442","171630 PAU D'ARCO",0,0,1,48,1,50,"2022"
"67443","171650 PEDRO AFONSO",5,1,3,213,0,222,"2022"
"67444","171660 PEIXE",1,1,1,119,1,123,"2022"
"67445","171665 PEQUIZEIRO",0,0,1,62,1,64,"2022"
"67446","171670 COLMEIA",0,0,0,106,0,106,"2022"
"67447","171700 PINDORAMA DO TOCANTINS",0,0,1,61,0,62,"2022"
"67448","171720 PIRAQUE",0,0,0,32,1,33,"2022"
"67449","171750 PIUM",0,0,2,93,0,95,"2022"
"67450","171780 PONTE ALTA DO BOM JESUS",0,0,0,41,0,41,"2022"
"67451","171790 PONTE ALTA DO TOCANTINS",0,0,5,98,1,104,"2022"
"67452","171800 PORTO ALEGRE DO TOCANTINS",1,0,0,36,0,37,"2022"
"67453","171820 PORTO NACIONAL",3,1,12,1002,7,1025,"2022"
"67454","171830 PRAIA NORTE",0,0,0,88,3,91,"2022"
"67455","171840 PRESIDENTE KENNEDY",0,0,0,33,0,33,"2022"
"67456","171845 PUGMIL",0,0,0,29,0,29,"2022"
"67457","171850 RECURSOLANDIA",0,0,2,64,0,66,"2022"
"67458","171855 RIACHINHO",0,0,0,59,0,59,"2022"
"67459","171865 RIO DA CONCEICAO",0,0,0,24,0,24,"2022"
"67460","171870 RIO DOS BOIS",0,1,0,31,0,32,"2022"
"67461","171875 RIO SONO",1,0,0,61,1,63,"2022"
"67462","171880 SAMPAIO",0,1,3,70,8,82,"2022"
"67463","171884 SANDOLANDIA",0,1,1,60,1,63,"2022"
"67464","171886 SANTA FE DO ARAGUAIA",0,0,0,119,2,121,"2022"
"67465","171888 SANTA MARIA DO TOCANTINS",0,0,1,46,0,47,"2022"
"67466","171889 SANTA RITA DO TOCANTINS",0,0,0,27,0,27,"2022"
"67467","171890 SANTA ROSA DO TOCANTINS",0,0,1,71,1,73,"2022"
"67468","171900 SANTA TEREZA DO TOCANTINS",1,1,0,48,0,50,"2022"
"67469","172000 SANTA TEREZINHA DO TOCANTINS",0,0,0,34,1,35,"2022"
"67470","172010 SAO BENTO DO TOCANTINS",0,0,5,89,8,102,"2022"
"67471","172015 SAO FELIX DO TOCANTINS",0,0,0,18,0,18,"2022"
"67472","172020 SAO MIGUEL DO TOCANTINS",0,0,3,139,3,145,"2022"
"67473","172025 SAO SALVADOR DO TOCANTINS",0,0,0,38,0,38,"2022"
"67474","172030 SAO SEBASTIAO DO TOCANTINS",0,0,1,56,5,62,"2022"
"67475","172049 SAO VALERIO",0,1,0,52,0,53,"2022"
"67476","172065 SILVANOPOLIS",0,1,1,74,0,76,"2022"
"67477","172080 SITIO NOVO DO TOCANTINS",0,2,1,120,4,127,"2022"
"67478","172085 SUCUPIRA",0,0,0,14,0,14,"2022"
"67479","172090 TAGUATINGA",0,1,1,173,0,175,"2022"
"67480","172093 TAIPAS DO TOCANTINS",0,0,0,27,1,28,"2022"
"67481","172097 TALISMA",1,0,0,27,0,28,"2022"
"67482","172100 PALMAS",26,17,38,4664,17,4762,"2022"
"67483","172110 TOCANTINIA",0,0,1,166,3,170,"2022"
"67484","172120 TOCANTINOPOLIS",0,4,5,321,1,331,"2022"
"67485","172125 TUPIRAMA",0,0,0,24,0,24,"2022"
"67486","172130 TUPIRATINS",0,0,0,22,1,23,"2022"
"67487","172208 WANDERLANDIA",0,0,0,117,3,120,"2022"
"67488","172210 XAMBIOA",0,2,1,152,1,156,"2022"
"67489","MUNICIPIO IGNORADO - MA",0,0,0,1,0,1,"2022"
"67490","210005 ACAILANDIA",4,4,25,1667,0,1700,"2022"
"67491","210010 AFONSO CUNHA",0,0,3,107,1,111,"2022"
"67492","210015 AGUA DOCE DO MARANHAO",0,0,3,146,12,161,"2022"
"67493","210020 ALCANTARA",3,6,6,139,18,172,"2022"
"67494","210030 ALDEIAS ALTAS",0,0,28,333,1,362,"2022"
"67495","210040 ALTAMIRA DO MARANHAO",0,0,0,56,0,56,"2022"
"67496","210043 ALTO ALEGRE DO MARANHAO",1,3,9,377,0,390,"2022"
"67497","210047 ALTO ALEGRE DO PINDARE",2,2,8,456,1,469,"2022"
"67498","210050 ALTO PARNAIBA",0,1,3,163,1,168,"2022"
"67499","210055 AMAPA DO MARANHAO",1,0,2,85,1,89,"2022"
"67500","210060 AMARANTE DO MARANHAO",5,4,8,664,27,708,"2022"
"67501","210070 ANAJATUBA",2,0,6,269,1,278,"2022"
"67502","210080 ANAPURUS",0,1,2,224,3,230,"2022"
"67503","210083 APICUM-ACU",0,0,3,155,85,243,"2022"
"67504","210087 ARAGUANA",0,1,1,140,2,144,"2022"
"67505","210090 ARAIOSES",3,3,6,468,9,489,"2022"
"67506","210095 ARAME",3,1,6,519,2,531,"2022"
"67507","210100 ARARI",0,2,5,330,2,339,"2022"
"67508","210110 AXIXA",1,1,3,139,9,153,"2022"
"67509","210120 BACABAL",1,6,17,1465,0,1489,"2022"
"67510","210125 BACABEIRA",1,3,7,226,3,240,"2022"
"67511","210130 BACURI",1,0,3,26,174,204,"2022"
"67512","210135 BACURITUBA",0,0,0,52,1,53,"2022"
"67513","210140 BALSAS",6,4,19,1803,8,1840,"2022"
"67514","210150 BARAO DE GRAJAU",0,0,5,248,0,253,"2022"
"67515","210160 BARRA DO CORDA",1,6,9,764,599,1379,"2022"
"67516","210170 BARREIRINHAS",3,1,7,1096,15,1122,"2022"
"67517","210173 BELAGUA",1,0,0,52,106,159,"2022"
"67518","210177 BELA VISTA DO MARANHAO",1,1,6,203,1,212,"2022"
"67519","210180 BENEDITO LEITE",1,0,1,56,1,59,"2022"
"67520","210190 BEQUIMAO",2,1,4,107,104,218,"2022"
"67521","210193 BERNARDO DO MEARIM",0,0,0,58,0,58,"2022"
"67522","210197 BOA VISTA DO GURUPI",0,0,1,103,3,107,"2022"
"67523","210200 BOM JARDIM",1,4,6,514,31,556,"2022"
"67524","210203 BOM JESUS DAS SELVAS",2,2,13,434,3,454,"2022"
"67525","210207 BOM LUGAR",1,2,2,123,0,128,"2022"
"67526","210210 BREJO",1,2,3,471,6,483,"2022"
"67527","210215 BREJO DE AREIA",0,0,0,121,0,121,"2022"
"67528","210220 BURITI",7,5,15,472,1,500,"2022"
"67529","210230 BURITI BRAVO",0,1,1,303,1,306,"2022"
"67530","210232 BURITICUPU",4,1,11,1100,2,1118,"2022"
"67531","210235 BURITIRANA",0,1,8,168,5,182,"2022"
"67532","210237 CACHOEIRA GRANDE",0,1,1,121,2,125,"2022"
"67533","210240 CAJAPIO",0,0,2,85,35,122,"2022"
"67534","210250 CAJARI",1,1,6,149,45,202,"2022"
"67535","210255 CAMPESTRE DO MARANHAO",1,0,6,185,0,192,"2022"
"67536","210260 CANDIDO MENDES",1,2,4,254,9,270,"2022"
"67537","210270 CANTANHEDE",1,0,3,211,4,219,"2022"
"67538","210275 CAPINZAL DO NORTE",0,1,2,124,1,128,"2022"
"67539","210280 CAROLINA",1,1,5,305,1,313,"2022"
"67540","210290 CARUTAPERA",0,4,13,368,14,399,"2022"
"67541","210300 CAXIAS",2,7,150,2077,18,2254,"2022"
"67542","210310 CEDRAL",0,2,0,69,40,111,"2022"
"67543","210312 CENTRAL DO MARANHAO",0,0,0,56,52,108,"2022"
"67544","210315 CENTRO DO GUILHERME",0,6,4,198,5,213,"2022"
"67545","210317 CENTRO NOVO DO MARANHAO",1,2,2,273,7,285,"2022"
"67546","210320 CHAPADINHA",4,9,17,1293,13,1336,"2022"
"67547","210325 CIDELANDIA",1,0,8,135,11,155,"2022"
"67548","210330 CODO",5,6,33,1440,10,1494,"2022"
"67549","210340 COELHO NETO",2,7,20,581,0,610,"2022"
"67550","210350 COLINAS",2,2,3,667,1,675,"2022"
"67551","210355 CONCEICAO DO LAGO-ACU",0,0,4,192,4,200,"2022"
"67552","210360 COROATA",5,2,7,919,12,945,"2022"
"67553","210370 CURURUPU",2,2,2,120,309,435,"2022"
"67554","210375 DAVINOPOLIS",1,1,2,213,3,220,"2022"
"67555","210380 DOM PEDRO",0,1,7,279,1,288,"2022"
"67556","210390 DUQUE BACELAR",0,1,6,157,0,164,"2022"
"67557","210400 ESPERANTINOPOLIS",0,0,2,253,2,257,"2022"
"67558","210405 ESTREITO",1,1,12,467,4,485,"2022"
"67559","210407 FEIRA NOVA DO MARANHAO",0,0,0,110,0,110,"2022"
"67560","210408 FERNANDO FALCAO",1,2,1,90,135,229,"2022"
"67561","210409 FORMOSA DA SERRA NEGRA",1,0,1,233,8,243,"2022"
"67562","210410 FORTALEZA DOS NOGUEIRAS",0,0,2,206,2,210,"2022"
"67563","210420 FORTUNA",1,0,5,235,2,243,"2022"
"67564","210430 GODOFREDO VIANA",0,2,3,130,0,135,"2022"
"67565","210440 GONCALVES DIAS",0,1,1,197,1,200,"2022"
"67566","210450 GOVERNADOR ARCHER",1,1,1,131,0,134,"2022"
"67567","210455 GOVERNADOR EDISON LOBAO",0,2,9,281,1,293,"2022"
"67568","210460 GOVERNADOR EUGENIO BARROS",1,1,1,227,3,233,"2022"
"67569","210462 GOVERNADOR LUIZ ROCHA",0,1,0,123,4,128,"2022"
"67570","210465 GOVERNADOR NEWTON BELLO",1,1,6,128,1,137,"2022"
"67571","210467 GOVERNADOR NUNES FREIRE",1,0,4,379,2,386,"2022"
"67572","210470 GRACA ARANHA",0,0,0,50,0,50,"2022"
"67573","210480 GRAJAU",2,4,34,1343,6,1389,"2022"
"67574","210490 GUIMARAES",0,0,0,106,16,122,"2022"
"67575","210500 HUMBERTO DE CAMPOS",0,0,4,316,72,392,"2022"
"67576","210510 ICATU",1,1,8,311,7,328,"2022"
"67577","210515 IGARAPE DO MEIO",2,2,5,243,1,253,"2022"
"67578","210520 IGARAPE GRANDE",1,0,1,163,0,165,"2022"
"67579","210530 IMPERATRIZ",18,13,88,4174,24,4317,"2022"
"67580","210535 ITAIPAVA DO GRAJAU",0,0,4,222,8,234,"2022"
"67581","210540 ITAPECURU MIRIM",1,1,9,999,7,1017,"2022"
"67582","210542 ITINGA DO MARANHAO",0,0,4,213,1,218,"2022"
"67583","210545 JATOBA",0,0,3,114,0,117,"2022"
"67584","210547 JENIPAPO DOS VIEIRAS",2,1,2,196,152,353,"2022"
"67585","210550 JOAO LISBOA",0,1,7,355,2,365,"2022"
"67586","210560 JOSELANDIA",0,0,0,238,2,240,"2022"
"67587","210565 JUNCO DO MARANHAO",0,0,1,69,1,71,"2022"
"67588","210570 LAGO DA PEDRA",4,0,4,714,2,724,"2022"
"67589","210580 LAGO DO JUNCO",1,0,2,110,2,115,"2022"
"67590","210590 LAGO VERDE",0,0,3,216,2,221,"2022"
"67591","210592 LAGOA DO MATO",2,1,2,110,1,116,"2022"
"67592","210594 LAGO DOS RODRIGUES",0,0,1,101,2,104,"2022"
"67593","210596 LAGOA GRANDE DO MARANHAO",1,0,0,233,5,239,"2022"
"67594","210598 LAJEADO NOVO",0,1,1,92,0,94,"2022"
"67595","210600 LIMA CAMPOS",0,1,3,176,1,181,"2022"
"67596","210610 LORETO",0,0,0,126,16,142,"2022"
"67597","210620 LUIS DOMINGUES",0,0,3,89,9,101,"2022"
"67598","210630 MAGALHAES DE ALMEIDA",1,0,2,169,1,173,"2022"
"67599","210632 MARACACUME",0,4,5,344,1,354,"2022"
"67600","210635 MARAJA DO SENA",0,0,3,102,0,105,"2022"
"67601","210637 MARANHAOZINHO",0,0,7,169,3,179,"2022"
"67602","210640 MATA ROMA",0,3,6,233,5,247,"2022"
"67603","210650 MATINHA",2,0,3,72,222,299,"2022"
"67604","210660 MATOES",0,2,8,385,1,396,"2022"
"67605","210663 MATOES DO NORTE",1,0,3,89,2,95,"2022"
"67606","210667 MILAGRES DO MARANHAO",0,1,2,49,1,53,"2022"
"67607","210670 MIRADOR",0,1,10,302,2,315,"2022"
"67608","210675 MIRANDA DO NORTE",0,0,2,242,2,246,"2022"
"67609","210680 MIRINZAL",0,1,2,82,110,195,"2022"
"67610","210690 MONCAO",5,2,9,387,2,405,"2022"
"67611","210700 MONTES ALTOS",0,0,5,119,2,126,"2022"
"67612","210710 MORROS",0,0,7,261,15,283,"2022"
"67613","210720 NINA RODRIGUES",2,1,4,196,1,204,"2022"
"67614","210725 NOVA COLINAS",0,0,0,84,1,85,"2022"
"67615","210730 NOVA IORQUE",0,0,0,39,1,40,"2022"
"67616","210735 NOVA OLINDA DO MARANHAO",0,1,5,249,7,262,"2022"
"67617","210740 OLHO D'AGUA DAS CUNHAS",0,0,3,183,0,186,"2022"
"67618","210745 OLINDA NOVA DO MARANHAO",2,0,1,31,141,175,"2022"
"67619","210750 PACO DO LUMIAR",8,9,27,1726,13,1783,"2022"
"67620","210760 PALMEIRANDIA",1,1,4,170,14,190,"2022"
"67621","210770 PARAIBANO",0,0,3,239,1,243,"2022"
"67622","210780 PARNARAMA",0,0,7,362,12,381,"2022"
"67623","210790 PASSAGEM FRANCA",1,1,2,262,0,266,"2022"
"67624","210800 PASTOS BONS",1,0,2,197,22,222,"2022"
"67625","210805 PAULINO NEVES",2,1,1,323,3,330,"2022"
"67626","210810 PAULO RAMOS",1,2,2,340,0,345,"2022"
"67627","210820 PEDREIRAS",0,0,5,486,2,493,"2022"
"67628","210825 PEDRO DO ROSARIO",0,1,5,272,6,284,"2022"
"67629","210830 PENALVA",1,3,4,496,27,531,"2022"
"67630","210840 PERI MIRIM",1,0,2,100,4,107,"2022"
"67631","210845 PERITORO",2,1,3,279,1,286,"2022"
"67632","210850 PINDARE-MIRIM",0,1,4,380,3,388,"2022"
"67633","210860 PINHEIRO",4,3,18,1230,28,1283,"2022"
"67634","210870 PIO XII",0,1,4,332,1,338,"2022"
"67635","210880 PIRAPEMAS",1,1,2,206,0,210,"2022"
"67636","210890 POCAO DE PEDRAS",0,1,2,151,0,154,"2022"
"67637","210900 PORTO FRANCO",1,1,2,404,1,409,"2022"
"67638","210905 PORTO RICO DO MARANHAO",1,0,1,29,24,55,"2022"
"67639","210910 PRESIDENTE DUTRA",0,1,6,717,1,725,"2022"
"67640","210920 PRESIDENTE JUSCELINO",2,2,3,147,4,158,"2022"
"67641","210923 PRESIDENTE MEDICI",0,0,3,77,2,82,"2022"
"67642","210927 PRESIDENTE SARNEY",1,1,4,274,2,282,"2022"
"67643","210930 PRESIDENTE VARGAS",0,0,2,171,6,179,"2022"
"67644","210940 PRIMEIRA CRUZ",0,0,2,117,30,149,"2022"
"67645","210945 RAPOSA",3,1,11,446,6,467,"2022"
"67646","210950 RIACHAO",0,0,1,340,0,341,"2022"
"67647","210955 RIBAMAR FIQUENE",0,0,1,88,4,93,"2022"
"67648","210960 ROSARIO",1,3,11,449,5,469,"2022"
"67649","210970 SAMBAIBA",0,0,0,67,0,67,"2022"
"67650","210975 SANTA FILOMENA DO MARANHAO",0,1,1,82,0,84,"2022"
"67651","210980 SANTA HELENA",1,0,4,425,18,448,"2022"
"67652","210990 SANTA INES",4,3,24,1311,1,1343,"2022"
"67653","211000 SANTA LUZIA",3,7,7,932,7,956,"2022"
"67654","211003 SANTA LUZIA DO PARUA",1,2,7,340,1,351,"2022"
"67655","211010 SANTA QUITERIA DO MARANHAO",1,1,24,422,2,450,"2022"
"67656","211020 SANTA RITA",3,4,26,491,1,525,"2022"
"67657","211023 SANTANA DO MARANHAO",0,1,2,113,0,116,"2022"
"67658","211027 SANTO AMARO DO MARANHAO",0,1,1,112,49,163,"2022"
"67659","211030 SANTO ANTONIO DOS LOPES",1,0,18,197,0,216,"2022"
"67660","211040 SAO BENEDITO DO RIO PRETO",0,1,8,330,22,361,"2022"
"67661","211050 SAO BENTO",2,3,3,395,7,410,"2022"
"67662","211060 SAO BERNARDO",3,1,6,345,0,355,"2022"
"67663","211065 SAO DOMINGOS DO AZEITAO",1,0,4,98,23,126,"2022"
"67664","211070 SAO DOMINGOS DO MARANHAO",0,1,3,622,1,627,"2022"
"67665","211080 SAO FELIX DE BALSAS",0,1,0,31,5,37,"2022"
"67666","211085 SAO FRANCISCO DO BREJAO",1,1,1,81,1,85,"2022"
"67667","211090 SAO FRANCISCO DO MARANHAO",0,1,3,121,11,136,"2022"
"67668","211100 SAO JOAO BATISTA",1,1,1,225,13,241,"2022"
"67669","211102 SAO JOAO DO CARU",0,2,5,196,2,205,"2022"
"67670","211105 SAO JOAO DO PARAISO",1,0,3,148,0,152,"2022"
"67671","211107 SAO JOAO DO SOTER",0,0,10,218,1,229,"2022"
"67672","211110 SAO JOAO DOS PATOS",0,2,4,319,1,326,"2022"
"67673","211120 SAO JOSE DE RIBAMAR",19,22,58,3088,39,3226,"2022"
"67674","211125 SAO JOSE DOS BASILIOS",0,0,3,79,0,82,"2022"
"67675","211130 SAO LUIS",96,52,228,13217,97,13690,"2022"
"67676","211140 SAO LUIS GONZAGA DO MARANHAO",0,2,4,194,0,200,"2022"
"67677","211150 SAO MATEUS DO MARANHAO",0,3,5,512,7,527,"2022"
"67678","211153 SAO PEDRO DA AGUA BRANCA",0,0,4,121,5,130,"2022"
"67679","211157 SAO PEDRO DOS CRENTES",0,0,0,83,0,83,"2022"
"67680","211160 SAO RAIMUNDO DAS MANGABEIRAS",1,1,6,280,22,310,"2022"
"67681","211163 SAO RAIMUNDO DO DOCA BEZERRA",0,1,2,52,42,97,"2022"
"67682","211167 SAO ROBERTO",1,1,0,57,3,62,"2022"
"67683","211170 SAO VICENTE FERRER",1,1,4,199,6,211,"2022"
"67684","211172 SATUBINHA",0,0,2,133,0,135,"2022"
"67685","211174 SENADOR ALEXANDRE COSTA",0,0,10,162,3,175,"2022"
"67686","211176 SENADOR LA ROCQUE",0,0,4,227,2,233,"2022"
"67687","211178 SERRANO DO MARANHAO",0,0,0,26,107,133,"2022"
"67688","211180 SITIO NOVO",0,0,4,258,4,266,"2022"
"67689","211190 SUCUPIRA DO NORTE",1,0,3,167,0,171,"2022"
"67690","211195 SUCUPIRA DO RIACHAO",0,0,0,29,1,30,"2022"
"67691","211200 TASSO FRAGOSO",0,0,3,133,6,142,"2022"
"67692","211210 TIMBIRAS",2,2,5,450,1,460,"2022"
"67693","211220 TIMON",3,6,31,2793,16,2849,"2022"
"67694","211223 TRIZIDELA DO VALE",0,1,7,313,6,327,"2022"
"67695","211227 TUFILANDIA",0,1,1,67,0,69,"2022"
"67696","211230 TUNTUM",1,2,4,457,10,474,"2022"
"67697","211240 TURIACU",1,0,4,443,105,553,"2022"
"67698","211245 TURILANDIA",2,0,5,258,50,315,"2022"
"67699","211250 TUTOIA",2,4,13,945,13,977,"2022"
"67700","211260 URBANO SANTOS",0,2,1,80,518,601,"2022"
"67701","211270 VARGEM GRANDE",1,4,29,671,16,721,"2022"
"67702","211280 VIANA",3,4,4,749,40,800,"2022"
"67703","211285 VILA NOVA DOS MARTIRIOS",1,0,4,147,1,153,"2022"
"67704","211290 VITORIA DO MEARIM",0,0,2,420,4,426,"2022"
"67705","211300 VITORINO FREIRE",4,2,6,436,0,448,"2022"
"67706","211400 ZE DOCA",1,4,11,605,3,624,"2022"
"67707","MUNICIPIO IGNORADO - PI",0,0,0,3,0,3,"2022"
"67708","220005 ACAUA",0,0,0,28,66,94,"2022"
"67709","220010 AGRICOLANDIA",0,2,1,56,1,60,"2022"
"67710","220020 AGUA BRANCA",0,0,7,255,1,263,"2022"
"67711","220025 ALAGOINHA DO PIAUI",0,0,0,83,0,83,"2022"
"67712","220027 ALEGRETE DO PIAUI",0,0,1,62,0,63,"2022"
"67713","220030 ALTO LONGA",0,0,2,112,0,114,"2022"
"67714","220040 ALTOS",1,1,4,543,9,558,"2022"
"67715","220045 ALVORADA DO GURGUEIA",0,2,1,82,2,87,"2022"
"67716","220050 AMARANTE",3,0,8,204,10,225,"2022"
"67717","220060 ANGICAL DO PIAUI",0,0,2,79,3,84,"2022"
"67718","220070 ANISIO DE ABREU",1,0,2,90,17,110,"2022"
"67719","220080 ANTONIO ALMEIDA",0,0,1,45,0,46,"2022"
"67720","220090 AROAZES",0,0,0,54,1,55,"2022"
"67721","220095 AROEIRAS DO ITAIM",0,0,0,18,0,18,"2022"
"67722","220100 ARRAIAL",0,1,0,45,0,46,"2022"
"67723","220105 ASSUNCAO DO PIAUI",0,1,1,75,1,78,"2022"
"67724","220110 AVELINO LOPES",0,0,1,118,28,147,"2022"
"67725","220115 BAIXA GRANDE DO RIBEIRO",0,3,1,214,42,260,"2022"
"67726","220117 BARRA D'ALCANTARA",0,0,1,40,1,42,"2022"
"67727","220120 BARRAS",3,4,12,597,4,620,"2022"
"67728","220130 BARREIRAS DO PIAUI",0,0,0,28,14,42,"2022"
"67729","220140 BARRO DURO",0,0,1,79,5,85,"2022"
"67730","220150 BATALHA",0,1,8,264,0,273,"2022"
"67731","220155 BELA VISTA DO PIAUI",1,0,1,51,1,54,"2022"
"67732","220157 BELEM DO PIAUI",0,1,0,34,0,35,"2022"
"67733","220160 BENEDITINOS",0,0,0,106,1,107,"2022"
"67734","220170 BERTOLINIA",0,0,1,71,3,75,"2022"
"67735","220173 BETANIA DO PIAUI",0,1,1,26,85,113,"2022"
"67736","220177 BOA HORA",0,1,0,66,0,67,"2022"
"67737","220180 BOCAINA",0,0,1,38,1,40,"2022"
"67738","220190 BOM JESUS",1,2,5,481,7,496,"2022"
"67739","220191 BOM PRINCIPIO DO PIAUI",0,1,2,84,1,88,"2022"
"67740","220192 BONFIM DO PIAUI",0,0,0,52,16,68,"2022"
"67741","220194 BOQUEIRAO DO PIAUI",0,0,1,74,0,75,"2022"
"67742","220196 BRASILEIRA",0,0,1,106,1,108,"2022"
"67743","220198 BREJO DO PIAUI",0,0,0,42,1,43,"2022"
"67744","220200 BURITI DOS LOPES",0,2,0,289,2,293,"2022"
"67745","220202 BURITI DOS MONTES",0,0,1,60,0,61,"2022"
"67746","220205 CABECEIRAS DO PIAUI",1,0,0,107,2,110,"2022"
"67747","220207 CAJAZEIRAS DO PIAUI",0,0,1,31,0,32,"2022"
"67748","220208 CAJUEIRO DA PRAIA",0,0,3,101,2,106,"2022"
"67749","220209 CALDEIRAO GRANDE DO PIAUI",0,1,2,66,0,69,"2022"
"67750","220210 CAMPINAS DO PIAUI",0,0,0,49,0,49,"2022"
"67751","220211 CAMPO ALEGRE DO FIDALGO",1,1,0,55,5,62,"2022"
"67752","220213 CAMPO GRANDE DO PIAUI",0,0,0,77,0,77,"2022"
"67753","220217 CAMPO LARGO DO PIAUI",0,0,2,102,1,105,"2022"
"67754","220220 CAMPO MAIOR",0,1,6,501,3,511,"2022"
"67755","220225 CANAVIEIRA",0,0,2,35,0,37,"2022"
"67756","220230 CANTO DO BURITI",0,0,2,277,12,291,"2022"
"67757","220240 CAPITAO DE CAMPOS",0,0,0,122,1,123,"2022"
"67758","220245 CAPITAO GERVASIO OLIVEIRA",0,0,0,42,0,42,"2022"
"67759","220250 CARACOL",0,0,0,117,27,144,"2022"
"67760","220253 CARAUBAS DO PIAUI",0,1,2,78,1,82,"2022"
"67761","220255 CARIDADE DO PIAUI",1,0,2,76,0,79,"2022"
"67762","220260 CASTELO DO PIAUI",1,1,1,201,7,211,"2022"
"67763","220265 CAXINGO",0,1,0,92,0,93,"2022"
"67764","220270 COCAL",1,3,9,378,2,393,"2022"
"67765","220271 COCAL DE TELHA",0,0,0,62,0,62,"2022"
"67766","220272 COCAL DOS ALVES",0,1,0,78,0,79,"2022"
"67767","220273 COIVARAS",1,1,0,43,0,45,"2022"
"67768","220275 COLONIA DO GURGUEIA",0,1,1,62,2,66,"2022"
"67769","220277 COLONIA DO PIAUI",0,0,0,88,0,88,"2022"
"67770","220280 CONCEICAO DO CANINDE",1,0,2,58,2,63,"2022"
"67771","220285 CORONEL JOSE DIAS",0,0,2,39,8,49,"2022"
"67772","220290 CORRENTE",0,0,0,185,251,436,"2022"
"67773","220300 CRISTALANDIA DO PIAUI",0,0,0,59,37,96,"2022"
"67774","220310 CRISTINO CASTRO",0,0,0,130,1,131,"2022"
"67775","220320 CURIMATA",0,0,2,102,75,179,"2022"
"67776","220323 CURRAIS",0,1,1,83,0,85,"2022"
"67777","220325 CURRALINHOS",0,1,2,62,0,65,"2022"
"67778","220327 CURRAL NOVO DO PIAUI",0,1,0,42,52,95,"2022"
"67779","220330 DEMERVAL LOBAO",0,0,1,246,4,251,"2022"
"67780","220335 DIRCEU ARCOVERDE",0,0,0,75,10,85,"2022"
"67781","220340 DOM EXPEDITO LOPES",0,0,3,79,1,83,"2022"
"67782","220342 DOMINGOS MOURAO",0,0,1,51,0,52,"2022"
"67783","220345 DOM INOCENCIO",0,0,0,51,18,69,"2022"
"67784","220350 ELESBAO VELOSO",0,1,3,141,1,146,"2022"
"67785","220360 ELISEU MARTINS",0,1,2,45,1,49,"2022"
"67786","220370 ESPERANTINA",2,1,10,593,1,607,"2022"
"67787","220375 FARTURA DO PIAUI",0,0,0,56,12,68,"2022"
"67788","220380 FLORES DO PIAUI",0,1,0,47,1,49,"2022"
"67789","220385 FLORESTA DO PIAUI",0,0,0,21,0,21,"2022"
"67790","220390 FLORIANO",1,2,16,913,5,937,"2022"
"67791","220400 FRANCINOPOLIS",0,0,1,42,0,43,"2022"
"67792","220410 FRANCISCO AYRES",0,0,1,38,0,39,"2022"
"67793","220415 FRANCISCO MACEDO",0,0,0,30,0,30,"2022"
"67794","220420 FRANCISCO SANTOS",0,0,0,100,1,101,"2022"
"67795","220430 FRONTEIRAS",0,1,2,103,0,106,"2022"
"67796","220435 GEMINIANO",0,0,1,71,1,73,"2022"
"67797","220440 GILBUES",0,0,5,127,35,167,"2022"
"67798","220450 GUADALUPE",1,0,1,136,0,138,"2022"
"67799","220455 GUARIBAS",0,0,1,66,4,71,"2022"
"67800","220460 HUGO NAPOLEAO",1,1,1,37,0,40,"2022"
"67801","220465 ILHA GRANDE",1,1,1,129,1,133,"2022"
"67802","220470 INHUMA",1,0,1,130,4,136,"2022"
"67803","220480 IPIRANGA DO PIAUI",0,1,1,99,1,102,"2022"
"67804","220490 ISAIAS COELHO",0,0,2,105,2,109,"2022"
"67805","220500 ITAINOPOLIS",0,0,0,130,1,131,"2022"
"67806","220510 ITAUEIRA",1,0,0,107,1,109,"2022"
"67807","220515 JACOBINA DO PIAUI",0,0,1,24,36,61,"2022"
"67808","220520 JAICOS",1,0,4,231,2,238,"2022"
"67809","220525 JARDIM DO MULATO",0,0,3,40,0,43,"2022"
"67810","220527 JATOBA DO PIAUI",0,0,2,42,0,44,"2022"
"67811","220530 JERUMENHA",0,1,2,56,0,59,"2022"
"67812","220535 JOAO COSTA",0,0,1,35,0,36,"2022"
"67813","220540 JOAQUIM PIRES",0,1,3,204,1,209,"2022"
"67814","220545 JOCA MARQUES",1,0,1,75,0,77,"2022"
"67815","220550 JOSE DE FREITAS",1,3,4,536,10,554,"2022"
"67816","220551 JUAZEIRO DO PIAUI",0,0,1,46,0,47,"2022"
"67817","220552 JULIO BORGES",0,1,1,45,40,87,"2022"
"67818","220553 JUREMA",0,0,0,52,5,57,"2022"
"67819","220554 LAGOINHA DO PIAUI",1,0,0,35,0,36,"2022"
"67820","220555 LAGOA ALEGRE",1,0,1,100,1,103,"2022"
"67821","220556 LAGOA DO BARRO DO PIAUI",0,0,1,67,4,72,"2022"
"67822","220557 LAGOA DE SAO FRANCISCO",0,0,1,67,0,68,"2022"
"67823","220558 LAGOA DO PIAUI",0,0,0,58,2,60,"2022"
"67824","220559 LAGOA DO SITIO",0,0,1,45,1,47,"2022"
"67825","220560 LANDRI SALES",0,0,2,63,0,65,"2022"
"67826","220570 LUIS CORREIA",1,2,9,393,13,418,"2022"
"67827","220580 LUZILANDIA",1,3,4,319,3,330,"2022"
"67828","220585 MADEIRO",0,1,1,93,0,95,"2022"
"67829","220590 MANOEL EMIDIO",0,0,0,61,1,62,"2022"
"67830","220595 MARCOLANDIA",0,0,3,111,0,114,"2022"
"67831","220600 MARCOS PARENTE",0,0,0,46,0,46,"2022"
"67832","220605 MASSAPE DO PIAUI",0,0,2,50,1,53,"2022"
"67833","220610 MATIAS OLIMPIO",0,0,2,136,1,139,"2022"
"67834","220620 MIGUEL ALVES",1,2,4,451,8,466,"2022"
"67835","220630 MIGUEL LEAO",0,0,2,14,0,16,"2022"
"67836","220635 MILTON BRANDAO",1,1,0,62,1,65,"2022"
"67837","220640 MONSENHOR GIL",0,0,0,107,3,110,"2022"
"67838","220650 MONSENHOR HIPOLITO",0,0,1,81,0,82,"2022"
"67839","220660 MONTE ALEGRE DO PIAUI",0,0,0,122,52,174,"2022"
"67840","220665 MORRO CABECA NO TEMPO",0,0,1,49,16,66,"2022"
"67841","220667 MORRO DO CHAPEU DO PIAUI",0,1,2,85,0,88,"2022"
"67842","220669 MURICI DOS PORTELAS",0,0,2,99,3,104,"2022"
"67843","220670 NAZARE DO PIAUI",0,0,1,69,0,70,"2022"
"67844","220672 NAZARIA",0,0,4,137,12,153,"2022"
"67845","220675 NOSSA SENHORA DE NAZARE",0,0,1,44,1,46,"2022"
"67846","220680 NOSSA SENHORA DOS REMEDIOS",0,0,3,134,1,138,"2022"
"67847","220690 NOVO ORIENTE DO PIAUI",0,0,1,53,0,54,"2022"
"67848","220695 NOVO SANTO ANTONIO",0,0,1,26,0,27,"2022"
"67849","220700 OEIRAS",3,4,12,435,1,455,"2022"
"67850","220710 OLHO D'AGUA DO PIAUI",0,0,1,45,1,47,"2022"
"67851","220720 PADRE MARCOS",0,0,1,77,0,78,"2022"
"67852","220730 PAES LANDIM",0,0,3,45,1,49,"2022"
"67853","220735 PAJEU DO PIAUI",0,0,0,17,0,17,"2022"
"67854","220740 PALMEIRA DO PIAUI",0,1,1,72,2,76,"2022"
"67855","220750 PALMEIRAIS",0,0,3,110,37,150,"2022"
"67856","220755 PAQUETA",0,0,0,44,0,44,"2022"
"67857","220760 PARNAGUA",0,0,1,65,103,169,"2022"
"67858","220770 PARNAIBA",6,14,28,2140,3,2191,"2022"
"67859","220775 PASSAGEM FRANCA DO PIAUI",0,0,1,39,0,40,"2022"
"67860","220777 PATOS DO PIAUI",0,1,0,36,13,50,"2022"
"67861","220779 PAU D'ARCO DO PIAUI",0,1,1,54,1,57,"2022"
"67862","220780 PAULISTANA",0,0,2,127,199,328,"2022"
"67863","220785 PAVUSSU",0,0,2,42,0,44,"2022"
"67864","220790 PEDRO II",2,6,10,410,3,431,"2022"
"67865","220793 PEDRO LAURENTINO",0,0,1,24,0,25,"2022"
"67866","220795 NOVA SANTA RITA",0,0,0,56,0,56,"2022"
"67867","220800 PICOS",1,5,11,992,0,1009,"2022"
"67868","220810 PIMENTEIRAS",0,1,1,125,1,128,"2022"
"67869","220820 PIO IX",1,1,4,211,0,217,"2022"
"67870","220830 PIRACURUCA",0,4,5,372,0,381,"2022"
"67871","220840 PIRIPIRI",2,1,4,830,1,838,"2022"
"67872","220850 PORTO",0,0,1,166,2,169,"2022"
"67873","220855 PORTO ALEGRE DO PIAUI",0,0,0,35,1,36,"2022"
"67874","220860 PRATA DO PIAUI",0,0,1,30,0,31,"2022"
"67875","220865 QUEIMADA NOVA",0,0,1,36,62,99,"2022"
"67876","220870 REDENCAO DO GURGUEIA",1,1,4,121,4,131,"2022"
"67877","220880 REGENERACAO",0,0,1,209,1,211,"2022"
"67878","220885 RIACHO FRIO",0,0,0,11,36,47,"2022"
"67879","220887 RIBEIRA DO PIAUI",0,0,0,34,0,34,"2022"
"67880","220890 RIBEIRO GONCALVES",0,0,2,12,79,93,"2022"
"67881","220900 RIO GRANDE DO PIAUI",0,3,2,58,3,66,"2022"
"67882","220910 SANTA CRUZ DO PIAUI",0,0,0,56,1,57,"2022"
"67883","220915 SANTA CRUZ DOS MILAGRES",0,0,0,22,0,22,"2022"
"67884","220920 SANTA FILOMENA",0,0,1,73,4,78,"2022"
"67885","220930 SANTA LUZ",0,0,5,62,0,67,"2022"
"67886","220935 SANTANA DO PIAUI",0,0,2,30,0,32,"2022"
"67887","220937 SANTA ROSA DO PIAUI",1,0,1,52,1,55,"2022"
"67888","220940 SANTO ANTONIO DE LISBOA",0,0,0,67,0,67,"2022"
"67889","220945 SANTO ANTONIO DOS MILAGRES",0,0,0,22,0,22,"2022"
"67890","220950 SANTO INACIO DO PIAUI",0,0,3,39,1,43,"2022"
"67891","220955 SAO BRAZ DO PIAUI",1,0,0,55,3,59,"2022"
"67892","220960 SAO FELIX DO PIAUI",0,1,0,14,2,17,"2022"
"67893","220965 SAO FRANCISCO DE ASSIS DO PIAUI",0,0,3,64,4,71,"2022"
"67894","220970 SAO FRANCISCO DO PIAUI",0,3,1,75,1,80,"2022"
"67895","220975 SAO GONCALO DO GURGUEIA",0,0,0,23,23,46,"2022"
"67896","220980 SAO GONCALO DO PIAUI",0,0,0,47,3,50,"2022"
"67897","220985 SAO JOAO DA CANABRAVA",0,0,1,56,0,57,"2022"
"67898","220987 SAO JOAO DA FRONTEIRA",0,0,0,70,1,71,"2022"
"67899","220990 SAO JOAO DA SERRA",1,0,1,41,1,44,"2022"
"67900","220995 SAO JOAO DA VARJOTA",0,0,0,37,0,37,"2022"
"67901","220997 SAO JOAO DO ARRAIAL",0,0,2,118,2,122,"2022"
"67902","221000 SAO JOAO DO PIAUI",3,1,3,273,6,286,"2022"
"67903","221005 SAO JOSE DO DIVINO",0,0,1,62,0,63,"2022"
"67904","221010 SAO JOSE DO PEIXE",0,0,0,26,0,26,"2022"
"67905","221020 SAO JOSE DO PIAUI",0,1,1,66,0,68,"2022"
"67906","221030 SAO JULIAO",1,0,0,65,0,66,"2022"
"67907","221035 SAO LOURENCO DO PIAUI",0,0,0,34,4,38,"2022"
"67908","221037 SAO LUIS DO PIAUI",0,0,1,28,0,29,"2022"
"67909","221038 SAO MIGUEL DA BAIXA GRANDE",0,0,0,17,0,17,"2022"
"67910","221039 SAO MIGUEL DO FIDALGO",0,0,2,28,1,31,"2022"
"67911","221040 SAO MIGUEL DO TAPUIO",0,2,1,142,1,146,"2022"
"67912","221050 SAO PEDRO DO PIAUI",0,1,2,173,2,178,"2022"
"67913","221060 SAO RAIMUNDO NONATO",1,2,2,436,65,506,"2022"
"67914","221062 SEBASTIAO BARROS",0,0,0,14,22,36,"2022"
"67915","221063 SEBASTIAO LEAL",0,0,0,68,0,68,"2022"
"67916","221065 SIGEFREDO PACHECO",1,0,1,91,2,95,"2022"
"67917","221070 SIMOES",0,1,3,184,1,189,"2022"
"67918","221080 SIMPLICIO MENDES",1,0,0,161,1,163,"2022"
"67919","221090 SOCORRO DO PIAUI",0,0,1,38,0,39,"2022"
"67920","221093 SUSSUAPARA",0,1,1,72,0,74,"2022"
"67921","221095 TAMBORIL DO PIAUI",0,0,0,38,1,39,"2022"
"67922","221097 TANQUE DO PIAUI",0,0,0,24,0,24,"2022"
"67923","221100 TERESINA",23,39,113,11288,99,11562,"2022"
"67924","221110 UNIAO",2,6,11,565,12,596,"2022"
"67925","221120 URUCUI",1,1,6,376,1,385,"2022"
"67926","221130 VALENCA DO PIAUI",0,0,1,237,0,238,"2022"
"67927","221135 VARZEA BRANCA",0,0,1,65,12,78,"2022"
"67928","221140 VARZEA GRANDE",0,0,0,46,1,47,"2022"
"67929","221150 VERA MENDES",0,0,0,44,0,44,"2022"
"67930","221160 VILA NOVA DO PIAUI",0,0,0,28,0,28,"2022"
"67931","221170 WALL FERRAZ",0,0,3,33,0,36,"2022"
"67932","MUNICIPIO IGNORADO - CE",0,0,1,0,0,1,"2022"
"67933","230010 ABAIARA",0,0,1,146,2,149,"2022"
"67934","230015 ACARAPE",0,2,5,176,1,184,"2022"
"67935","230020 ACARAU",3,2,11,953,0,969,"2022"
"67936","230030 ACOPIARA",2,4,9,504,0,519,"2022"
"67937","230040 AIUABA",0,2,6,153,2,163,"2022"
"67938","230050 ALCANTARAS",0,0,2,127,0,129,"2022"
"67939","230060 ALTANEIRA",1,1,4,114,0,120,"2022"
"67940","230070 ALTO SANTO",0,1,3,174,0,178,"2022"
"67941","230075 AMONTADA",0,0,14,630,14,658,"2022"
"67942","230080 ANTONINA DO NORTE",0,0,2,95,0,97,"2022"
"67943","230090 APUIARES",2,1,3,133,0,139,"2022"
"67944","230100 AQUIRAZ",6,2,12,1048,1,1069,"2022"
"67945","230110 ARACATI",2,5,15,839,5,866,"2022"
"67946","230120 ARACOIABA",0,2,7,290,2,301,"2022"
"67947","230125 ARARENDA",0,1,4,147,1,153,"2022"
"67948","230130 ARARIPE",0,0,7,291,0,298,"2022"
"67949","230140 ARATUBA",1,3,1,138,1,144,"2022"
"67950","230150 ARNEIROZ",0,0,6,69,0,75,"2022"
"67951","230160 ASSARE",0,2,3,254,0,259,"2022"
"67952","230170 AURORA",2,2,4,293,0,301,"2022"
"67953","230180 BAIXIO",0,0,0,46,0,46,"2022"
"67954","230185 BANABUIU",0,0,4,199,0,203,"2022"
"67955","230190 BARBALHA",4,1,15,1068,23,1111,"2022"
"67956","230195 BARREIRA",0,0,2,262,1,265,"2022"
"67957","230200 BARRO",0,0,5,202,0,207,"2022"
"67958","230205 BARROQUINHA",0,0,6,201,2,209,"2022"
"67959","230210 BATURITE",1,3,13,426,1,444,"2022"
"67960","230220 BEBERIBE",2,1,10,553,3,569,"2022"
"67961","230230 BELA CRUZ",1,2,9,341,3,356,"2022"
"67962","230240 BOA VIAGEM",1,3,10,546,5,565,"2022"
"67963","230250 BREJO SANTO",1,1,4,695,4,705,"2022"
"67964","230260 CAMOCIM",3,4,15,872,0,894,"2022"
"67965","230270 CAMPOS SALES",1,0,7,358,0,366,"2022"
"67966","230280 CANINDE",0,9,16,989,4,1018,"2022"
"67967","230290 CAPISTRANO",1,0,5,228,0,234,"2022"
"67968","230300 CARIDADE",1,2,2,190,0,195,"2022"
"67969","230310 CARIRE",1,0,2,205,0,208,"2022"
"67970","230320 CARIRIACU",1,3,11,368,0,383,"2022"
"67971","230330 CARIUS",0,2,4,190,0,196,"2022"
"67972","230340 CARNAUBAL",0,1,3,234,0,238,"2022"
"67973","230350 CASCAVEL",3,7,19,851,8,888,"2022"
"67974","230360 CATARINA",1,2,4,120,0,127,"2022"
"67975","230365 CATUNDA",1,0,2,96,1,100,"2022"
"67976","230370 CAUCAIA",21,11,80,4641,36,4789,"2022"
"67977","230380 CEDRO",1,1,4,257,1,264,"2022"
"67978","230390 CHAVAL",0,0,1,150,0,151,"2022"
"67979","230393 CHORO",0,2,2,141,2,147,"2022"
"67980","230395 CHOROZINHO",1,2,6,180,1,190,"2022"
"67981","230400 COREAU",0,3,2,260,1,266,"2022"
"67982","230410 CRATEUS",1,4,18,898,5,926,"2022"
"67983","230420 CRATO",4,11,30,1834,5,1884,"2022"
"67984","230423 CROATA",0,0,4,206,0,210,"2022"
"67985","230425 CRUZ",2,2,7,425,2,438,"2022"
"67986","230426 DEPUTADO IRAPUAN PINHEIRO",0,0,0,88,0,88,"2022"
"67987","230427 ERERE",0,0,0,54,0,54,"2022"
"67988","230428 EUSEBIO",8,4,13,1074,3,1102,"2022"
"67989","230430 FARIAS BRITO",1,1,8,185,0,195,"2022"
"67990","230435 FORQUILHA",0,1,2,237,0,240,"2022"
"67991","230440 FORTALEZA",105,100,447,28844,180,29676,"2022"
"67992","230445 FORTIM",0,1,2,208,3,214,"2022"
"67993","230450 FRECHEIRINHA",0,1,6,224,1,232,"2022"
"67994","230460 GENERAL SAMPAIO",0,1,2,93,0,96,"2022"
"67995","230465 GRACA",0,1,5,140,0,146,"2022"
"67996","230470 GRANJA",3,2,11,703,3,722,"2022"
"67997","230480 GRANJEIRO",0,0,1,59,0,60,"2022"
"67998","230490 GROAIRAS",0,1,0,113,0,114,"2022"
"67999","230495 GUAIUBA",1,2,1,252,2,258,"2022"
"68000","230500 GUARACIABA DO NORTE",5,4,8,574,3,594,"2022"
"68001","230510 GUARAMIRANGA",0,0,0,73,1,74,"2022"
"68002","230520 HIDROLANDIA",0,2,2,226,1,231,"2022"
"68003","230523 HORIZONTE",0,7,17,1024,1,1049,"2022"
"68004","230526 IBARETAMA",0,1,5,158,1,165,"2022"
"68005","230530 IBIAPINA",0,2,6,375,1,384,"2022"
"68006","230533 IBICUITINGA",0,0,2,111,1,114,"2022"
"68007","230535 ICAPUI",0,2,1,196,2,201,"2022"
"68008","230540 ICO",0,2,10,641,3,656,"2022"
"68009","230550 IGUATU",1,4,39,1113,12,1169,"2022"
"68010","230560 INDEPENDENCIA",0,4,7,280,4,295,"2022"
"68011","230565 IPAPORANGA",0,1,1,130,1,133,"2022"
"68012","230570 IPAUMIRIM",0,1,1,118,0,120,"2022"
"68013","230580 IPU",2,2,9,531,0,544,"2022"
"68014","230590 IPUEIRAS",1,3,6,441,1,452,"2022"
"68015","230600 IRACEMA",0,1,3,131,0,135,"2022"
"68016","230610 IRAUCUBA",1,0,2,327,0,330,"2022"
"68017","230620 ITAICABA",0,0,1,67,0,68,"2022"
"68018","230625 ITAITINGA",3,2,10,671,0,686,"2022"
"68019","230630 ITAPAGE",2,0,12,540,4,558,"2022"
"68020","230640 ITAPIPOCA",13,5,36,1967,24,2045,"2022"
"68021","230650 ITAPIUNA",0,1,2,179,0,182,"2022"
"68022","230655 ITAREMA",0,3,7,620,2,632,"2022"
"68023","230660 ITATIRA",1,1,3,238,4,247,"2022"
"68024","230670 JAGUARETAMA",1,0,2,202,1,206,"2022"
"68025","230680 JAGUARIBARA",0,0,3,119,0,122,"2022"
"68026","230690 JAGUARIBE",0,1,9,357,0,367,"2022"
"68027","230700 JAGUARUANA",0,4,7,292,1,304,"2022"
"68028","230710 JARDIM",0,1,8,332,11,352,"2022"
"68029","230720 JATI",0,0,1,91,1,93,"2022"
"68030","230725 JIJOCA DE JERICOACOARA",0,2,4,386,1,393,"2022"
"68031","230730 JUAZEIRO DO NORTE",14,7,92,3516,5,3634,"2022"
"68032","230740 JUCAS",0,0,9,286,2,297,"2022"
"68033","230750 LAVRAS DA MANGABEIRA",0,0,5,282,0,287,"2022"
"68034","230760 LIMOEIRO DO NORTE",4,2,13,678,1,698,"2022"
"68035","230763 MADALENA",1,1,2,173,1,178,"2022"
"68036","230765 MARACANAU",7,5,50,3578,18,3658,"2022"
"68037","230770 MARANGUAPE",3,9,20,1153,4,1189,"2022"
"68038","230780 MARCO",1,1,4,524,0,530,"2022"
"68039","230790 MARTINOPOLE",0,2,4,184,0,190,"2022"
"68040","230800 MASSAPE",3,3,8,500,0,514,"2022"
"68041","230810 MAURITI",5,2,10,646,2,665,"2022"
"68042","230820 MERUOCA",1,2,2,169,0,174,"2022"
"68043","230830 MILAGRES",0,1,6,346,0,353,"2022"
"68044","230835 MILHA",1,0,2,140,1,144,"2022"
"68045","230837 MIRAIMA",0,0,3,140,9,152,"2022"
"68046","230840 MISSAO VELHA",0,0,13,551,1,565,"2022"
"68047","230850 MOMBACA",2,5,30,391,2,430,"2022"
"68048","230860 MONSENHOR TABOSA",2,1,3,182,1,189,"2022"
"68049","230870 MORADA NOVA",1,1,12,667,5,686,"2022"
"68050","230880 MORAUJO",0,0,1,113,0,114,"2022"
"68051","230890 MORRINHOS",0,0,5,324,1,330,"2022"
"68052","230900 MUCAMBO",0,1,4,180,1,186,"2022"
"68053","230910 MULUNGU",1,0,3,112,0,116,"2022"
"68054","230920 NOVA OLINDA",0,1,2,223,0,226,"2022"
"68055","230930 NOVA RUSSAS",0,1,2,333,2,338,"2022"
"68056","230940 NOVO ORIENTE",3,1,3,305,0,312,"2022"
"68057","230945 OCARA",3,2,7,232,1,245,"2022"
"68058","230950 OROS",3,2,6,211,0,222,"2022"
"68059","230960 PACAJUS",1,2,20,864,2,889,"2022"
"68060","230970 PACATUBA",4,4,17,1017,7,1049,"2022"
"68061","230980 PACOTI",0,0,3,120,0,123,"2022"
"68062","230990 PACUJA",0,0,1,79,0,80,"2022"
"68063","231000 PALHANO",0,0,4,94,0,98,"2022"
"68064","231010 PALMACIA",0,0,1,78,3,82,"2022"
"68065","231020 PARACURU",2,3,5,528,2,540,"2022"
"68066","231025 PARAIPABA",1,0,10,437,1,449,"2022"
"68067","231030 PARAMBU",0,3,11,430,2,446,"2022"
"68068","231040 PARAMOTI",0,0,4,117,0,121,"2022"
"68069","231050 PEDRA BRANCA",1,3,4,395,1,404,"2022"
"68070","231060 PENAFORTE",0,1,2,128,0,131,"2022"
"68071","231070 PENTECOSTE",2,1,7,426,0,436,"2022"
"68072","231080 PEREIRO",0,2,1,175,0,178,"2022"
"68073","231085 PINDORETAMA",0,2,3,260,4,269,"2022"
"68074","231090 PIQUET CARNEIRO",1,2,2,139,1,145,"2022"
"68075","231095 PIRES FERREIRA",0,0,3,107,0,110,"2022"
"68076","231100 PORANGA",0,1,5,119,1,126,"2022"
"68077","231110 PORTEIRAS",0,0,3,256,1,260,"2022"
"68078","231120 POTENGI",0,0,1,102,0,103,"2022"
"68079","231123 POTIRETAMA",0,1,1,76,0,78,"2022"
"68080","231126 QUITERIANOPOLIS",0,5,11,210,3,229,"2022"
"68081","231130 QUIXADA",4,1,18,1185,4,1212,"2022"
"68082","231135 QUIXELO",1,1,3,171,1,177,"2022"
"68083","231140 QUIXERAMOBIM",5,6,26,1052,4,1093,"2022"
"68084","231150 QUIXERE",0,0,5,260,1,266,"2022"
"68085","231160 REDENCAO",1,2,7,349,0,359,"2022"
"68086","231170 RERIUTABA",0,1,3,222,0,226,"2022"
"68087","231180 RUSSAS",2,2,26,878,0,908,"2022"
"68088","231190 SABOEIRO",0,0,2,142,1,145,"2022"
"68089","231195 SALITRE",1,4,7,301,1,314,"2022"
"68090","231200 SANTANA DO ACARAU",2,0,4,360,2,368,"2022"
"68091","231210 SANTANA DO CARIRI",0,2,10,218,0,230,"2022"
"68092","231220 SANTA QUITERIA",0,2,9,442,0,453,"2022"
"68093","231230 SAO BENEDITO",1,5,11,745,1,763,"2022"
"68094","231240 SAO GONCALO DO AMARANTE",1,0,10,815,3,829,"2022"
"68095","231250 SAO JOAO DO JAGUARIBE",1,1,0,34,0,36,"2022"
"68096","231260 SAO LUIS DO CURU",0,0,5,106,0,111,"2022"
"68097","231270 SENADOR POMPEU",1,1,5,259,0,266,"2022"
"68098","231280 SENADOR SA",0,0,1,92,0,93,"2022"
"68099","231290 SOBRAL",7,10,53,2704,2,2776,"2022"
"68100","231300 SOLONOPOLE",0,0,2,166,1,169,"2022"
"68101","231310 TABULEIRO DO NORTE",1,2,2,308,0,313,"2022"
"68102","231320 TAMBORIL",0,5,13,323,3,344,"2022"
"68103","231325 TARRAFAS",0,1,3,74,0,78,"2022"
"68104","231330 TAUA",3,2,23,677,1,706,"2022"
"68105","231335 TEJUCUOCA",0,0,3,220,1,224,"2022"
"68106","231340 TIANGUA",6,3,9,1339,0,1357,"2022"
"68107","231350 TRAIRI",4,4,12,796,5,821,"2022"
"68108","231355 TURURU",4,1,6,237,1,249,"2022"
"68109","231360 UBAJARA",1,0,6,451,0,458,"2022"
"68110","231370 UMARI",0,1,3,69,0,73,"2022"
"68111","231375 UMIRIM",1,0,2,237,6,246,"2022"
"68112","231380 URUBURETAMA",1,0,5,303,2,311,"2022"
"68113","231390 URUOCA",1,3,3,165,1,173,"2022"
"68114","231395 VARJOTA",0,1,2,255,1,259,"2022"
"68115","231400 VARZEA ALEGRE",1,4,10,389,0,404,"2022"
"68116","231410 VICOSA DO CEARA",2,2,10,854,0,868,"2022"
"68117","MUNICIPIO IGNORADO - RN",0,0,0,1,0,1,"2022"
"68118","240010 ACARI",0,2,0,108,1,111,"2022"
"68119","240020 ACU",2,2,7,585,2,598,"2022"
"68120","240030 AFONSO BEZERRA",1,0,2,114,0,117,"2022"
"68121","240040 AGUA NOVA",0,0,0,41,0,41,"2022"
"68122","240050 ALEXANDRIA",0,1,3,133,0,137,"2022"
"68123","240060 ALMINO AFONSO",0,0,1,44,0,45,"2022"
"68124","240070 ALTO DO RODRIGUES",3,1,1,151,1,157,"2022"
"68125","240080 ANGICOS",0,0,2,128,0,130,"2022"
"68126","240090 ANTONIO MARTINS",0,0,2,75,0,77,"2022"
"68127","240100 APODI",3,1,5,366,2,377,"2022"
"68128","240110 AREIA BRANCA",1,0,5,290,2,298,"2022"
"68129","240120 ARES",0,0,3,165,2,170,"2022"
"68130","240130 AUGUSTO SEVERO",1,0,2,81,0,84,"2022"
"68131","240140 BAIA FORMOSA",1,0,2,108,1,112,"2022"
"68132","240145 BARAUNA",1,3,7,314,0,325,"2022"
"68133","240150 BARCELONA",0,0,1,38,1,40,"2022"
"68134","240160 BENTO FERNANDES",0,0,0,48,0,48,"2022"
"68135","240165 BODO",0,1,0,34,1,36,"2022"
"68136","240170 BOM JESUS",0,3,1,136,2,142,"2022"
"68137","240180 BREJINHO",0,2,2,169,1,174,"2022"
"68138","240185 CAICARA DO NORTE",0,0,0,98,0,98,"2022"
"68139","240190 CAICARA DO RIO DO VENTO",0,0,1,36,1,38,"2022"
"68140","240200 CAICO",1,4,18,556,1,580,"2022"
"68141","240210 CAMPO REDONDO",0,1,2,108,0,111,"2022"
"68142","240220 CANGUARETAMA",2,1,6,402,3,414,"2022"
"68143","240230 CARAUBAS",1,0,6,213,2,222,"2022"
"68144","240240 CARNAUBA DOS DANTAS",0,0,3,97,0,100,"2022"
"68145","240250 CARNAUBAIS",0,0,2,75,0,77,"2022"
"68146","240260 CEARA-MIRIM",1,7,14,1008,4,1034,"2022"
"68147","240270 CERRO CORA",1,0,3,123,0,127,"2022"
"68148","240280 CORONEL EZEQUIEL",0,0,0,62,1,63,"2022"
"68149","240290 CORONEL JOAO PESSOA",0,1,3,43,0,47,"2022"
"68150","240300 CRUZETA",0,0,4,59,0,63,"2022"
"68151","240310 CURRAIS NOVOS",0,4,8,435,0,447,"2022"
"68152","240320 DOUTOR SEVERIANO",0,2,1,85,0,88,"2022"
"68153","240325 PARNAMIRIM",4,12,33,3233,10,3292,"2022"
"68154","240330 ENCANTO",0,0,3,75,0,78,"2022"
"68155","240340 EQUADOR",0,0,0,46,0,46,"2022"
"68156","240350 ESPIRITO SANTO",0,2,2,83,1,88,"2022"
"68157","240360 EXTREMOZ",4,4,6,555,2,571,"2022"
"68158","240370 FELIPE GUERRA",0,0,0,45,0,45,"2022"
"68159","240375 FERNANDO PEDROZA",0,0,0,27,0,27,"2022"
"68160","240380 FLORANIA",0,2,1,100,0,103,"2022"
"68161","240390 FRANCISCO DANTAS",0,2,0,27,0,29,"2022"
"68162","240400 FRUTUOSO GOMES",0,0,1,43,0,44,"2022"
"68163","240410 GALINHOS",1,0,3,25,0,29,"2022"
"68164","240420 GOIANINHA",1,2,12,400,4,419,"2022"
"68165","240430 GOVERNADOR DIX-SEPT ROSADO",0,0,0,115,0,115,"2022"
"68166","240440 GROSSOS",0,1,2,94,0,97,"2022"
"68167","240450 GUAMARE",0,0,5,251,0,256,"2022"
"68168","240460 IELMO MARINHO",0,0,4,134,0,138,"2022"
"68169","240470 IPANGUACU",6,0,2,157,0,165,"2022"
"68170","240480 IPUEIRA",0,0,0,22,0,22,"2022"
"68171","240485 ITAJA",1,0,0,68,0,69,"2022"
"68172","240490 ITAU",0,0,0,61,0,61,"2022"
"68173","240500 JACANA",0,1,3,98,1,103,"2022"
"68174","240510 JANDAIRA",0,1,1,78,0,80,"2022"
"68175","240520 JANDUIS",0,0,0,52,0,52,"2022"
"68176","240530 JANUARIO CICCO",1,3,4,93,2,103,"2022"
"68177","240540 JAPI",0,0,4,68,1,73,"2022"
"68178","240550 JARDIM DE ANGICOS",0,0,1,34,0,35,"2022"
"68179","240560 JARDIM DE PIRANHAS",0,0,3,167,0,170,"2022"
"68180","240570 JARDIM DO SERIDO",1,1,2,85,0,89,"2022"
"68181","240580 JOAO CAMARA",3,1,11,513,2,530,"2022"
"68182","240590 JOAO DIAS",0,0,1,31,0,32,"2022"
"68183","240600 JOSE DA PENHA",0,0,0,61,0,61,"2022"
"68184","240610 JUCURUTU",1,1,2,180,0,184,"2022"
"68185","240615 JUNDIA",0,0,0,50,1,51,"2022"
"68186","240620 LAGOA D'ANTA",0,1,1,94,2,98,"2022"
"68187","240630 LAGOA DE PEDRAS",0,1,2,79,3,85,"2022"
"68188","240640 LAGOA DE VELHOS",1,0,0,31,0,32,"2022"
"68189","240650 LAGOA NOVA",2,1,6,213,1,223,"2022"
"68190","240660 LAGOA SALGADA",0,0,1,125,1,127,"2022"
"68191","240670 LAJES",0,1,4,101,2,108,"2022"
"68192","240680 LAJES PINTADAS",0,0,1,53,0,54,"2022"
"68193","240690 LUCRECIA",1,0,0,37,0,38,"2022"
"68194","240700 LUIS GOMES",0,0,0,104,0,104,"2022"
"68195","240710 MACAIBA",7,7,12,858,5,889,"2022"
"68196","240720 MACAU",1,0,3,244,0,248,"2022"
"68197","240725 MAJOR SALES",0,1,0,38,0,39,"2022"
"68198","240730 MARCELINO VIEIRA",0,1,0,76,0,77,"2022"
"68199","240740 MARTINS",0,0,2,76,0,78,"2022"
"68200","240750 MAXARANGUAPE",2,0,1,112,0,115,"2022"
"68201","240760 MESSIAS TARGINO",0,0,3,38,0,41,"2022"
"68202","240770 MONTANHAS",0,1,4,155,1,161,"2022"
"68203","240780 MONTE ALEGRE",1,3,3,271,0,278,"2022"
"68204","240790 MONTE DAS GAMELEIRAS",0,1,0,27,0,28,"2022"
"68205","240800 MOSSORO",8,6,42,3234,1,3291,"2022"
"68206","240810 NATAL",37,61,121,9295,28,9542,"2022"
"68207","240820 NISIA FLORESTA",1,1,8,351,2,363,"2022"
"68208","240830 NOVA CRUZ",0,4,5,390,4,403,"2022"
"68209","240840 OLHO-D'AGUA DO BORGES",0,0,2,34,0,36,"2022"
"68210","240850 OURO BRANCO",0,1,1,49,0,51,"2022"
"68211","240860 PARANA",0,0,0,41,0,41,"2022"
"68212","240870 PARAU",0,0,0,35,0,35,"2022"
"68213","240880 PARAZINHO",0,0,0,81,1,82,"2022"
"68214","240890 PARELHAS",1,1,0,247,0,249,"2022"
"68215","240895 RIO DO FOGO",2,1,1,145,1,150,"2022"
"68216","240910 PASSA E FICA",0,4,4,136,3,147,"2022"
"68217","240920 PASSAGEM",0,0,0,35,0,35,"2022"
"68218","240930 PATU",0,0,1,137,0,138,"2022"
"68219","240933 SANTA MARIA",0,1,5,56,2,64,"2022"
"68220","240940 PAU DOS FERROS",2,0,2,379,0,383,"2022"
"68221","240950 PEDRA GRANDE",0,0,0,53,1,54,"2022"
"68222","240960 PEDRA PRETA",0,0,0,32,0,32,"2022"
"68223","240970 PEDRO AVELINO",0,0,2,59,1,62,"2022"
"68224","240980 PEDRO VELHO",0,0,3,200,5,208,"2022"
"68225","240990 PENDENCIAS",1,0,7,149,0,157,"2022"
"68226","241000 PILOES",0,0,0,35,0,35,"2022"
"68227","241010 POCO BRANCO",1,0,3,141,2,147,"2022"
"68228","241020 PORTALEGRE",0,0,1,68,0,69,"2022"
"68229","241025 PORTO DO MANGUE",0,0,2,63,0,65,"2022"
"68230","241030 SERRA CAIADA",0,1,3,126,2,132,"2022"
"68231","241040 PUREZA",0,0,3,111,0,114,"2022"
"68232","241050 RAFAEL FERNANDES",0,0,1,56,0,57,"2022"
"68233","241060 RAFAEL GODEIRO",0,0,0,22,0,22,"2022"
"68234","241070 RIACHO DA CRUZ",0,0,1,31,0,32,"2022"
"68235","241080 RIACHO DE SANTANA",0,0,1,44,0,45,"2022"
"68236","241090 RIACHUELO",1,0,0,74,1,76,"2022"
"68237","241100 RODOLFO FERNANDES",0,0,1,51,0,52,"2022"
"68238","241105 TIBAU",0,0,1,68,0,69,"2022"
"68239","241110 RUY BARBOSA",0,0,2,43,0,45,"2022"
"68240","241120 SANTA CRUZ",0,2,21,498,2,523,"2022"
"68241","241140 SANTANA DO MATOS",0,1,2,114,0,117,"2022"
"68242","241142 SANTANA DO SERIDO",0,0,2,25,0,27,"2022"
"68243","241150 SANTO ANTONIO",1,2,0,256,1,260,"2022"
"68244","241160 SAO BENTO DO NORTE",0,0,1,44,0,45,"2022"
"68245","241170 SAO BENTO DO TRAIRI",1,2,0,40,0,43,"2022"
"68246","241180 SAO FERNANDO",0,0,1,23,0,24,"2022"
"68247","241190 SAO FRANCISCO DO OESTE",0,0,0,39,0,39,"2022"
"68248","241200 SAO GONCALO DO AMARANTE",3,7,15,1330,4,1359,"2022"
"68249","241210 SAO JOAO DO SABUGI",0,1,1,42,0,44,"2022"
"68250","241220 SAO JOSE DE MIPIBU",0,1,7,611,4,623,"2022"
"68251","241230 SAO JOSE DO CAMPESTRE",0,1,0,128,1,130,"2022"
"68252","241240 SAO JOSE DO SERIDO",0,0,1,39,0,40,"2022"
"68253","241250 SAO MIGUEL",2,0,3,303,1,309,"2022"
"68254","241255 SAO MIGUEL DO GOSTOSO",2,2,2,137,0,143,"2022"
"68255","241260 SAO PAULO DO POTENGI",0,1,2,142,1,146,"2022"
"68256","241270 SAO PEDRO",1,0,0,52,0,53,"2022"
"68257","241280 SAO RAFAEL",1,2,1,87,1,92,"2022"
"68258","241290 SAO TOME",1,0,4,95,1,101,"2022"
"68259","241300 SAO VICENTE",0,0,2,56,0,58,"2022"
"68260","241310 SENADOR ELOI DE SOUZA",0,1,2,59,1,63,"2022"
"68261","241320 SENADOR GEORGINO AVELINO",0,1,1,61,0,63,"2022"
"68262","241330 SERRA DE SAO BENTO",1,0,4,72,1,78,"2022"
"68263","241335 SERRA DO MEL",3,0,3,189,0,195,"2022"
"68264","241340 SERRA NEGRA DO NORTE",1,0,2,58,0,61,"2022"
"68265","241350 SERRINHA",0,0,0,84,0,84,"2022"
"68266","241355 SERRINHA DOS PINTOS",0,0,1,45,0,46,"2022"
"68267","241360 SEVERIANO MELO",0,2,1,57,0,60,"2022"
"68268","241370 SITIO NOVO",0,0,0,43,1,44,"2022"
"68269","241380 TABOLEIRO GRANDE",0,0,2,23,0,25,"2022"
"68270","241390 TAIPU",0,0,1,131,0,132,"2022"
"68271","241400 TANGARA",1,0,5,161,2,169,"2022"
"68272","241410 TENENTE ANANIAS",0,1,3,100,0,104,"2022"
"68273","241415 TENENTE LAURENTINO CRUZ",0,1,0,77,0,78,"2022"
"68274","241420 TIBAU DO SUL",0,1,8,253,2,264,"2022"
"68275","241430 TIMBAUBA DOS BATISTAS",0,0,0,17,0,17,"2022"
"68276","241440 TOUROS",1,1,2,447,2,453,"2022"
"68277","241445 TRIUNFO POTIGUAR",1,0,0,49,0,50,"2022"
"68278","241450 UMARIZAL",2,2,0,81,1,86,"2022"
"68279","241460 UPANEMA",1,1,3,139,0,144,"2022"
"68280","241470 VARZEA",0,1,3,67,0,71,"2022"
"68281","241475 VENHA-VER",0,0,1,47,0,48,"2022"
"68282","241480 VERA CRUZ",0,0,2,163,1,166,"2022"
"68283","241490 VICOSA",0,0,0,25,0,25,"2022"
"68284","241500 VILA FLOR",0,0,0,43,0,43,"2022"
"68285","250010 AGUA BRANCA",1,0,3,144,0,148,"2022"
"68286","250020 AGUIAR",0,0,0,46,1,47,"2022"
"68287","250030 ALAGOA GRANDE",2,3,5,354,8,372,"2022"
"68288","250040 ALAGOA NOVA",0,4,5,302,4,315,"2022"
"68289","250050 ALAGOINHA",1,1,1,185,2,190,"2022"
"68290","250053 ALCANTIL",0,0,1,92,2,95,"2022"
"68291","250057 ALGODAO DE JANDAIRA",0,0,0,46,1,47,"2022"
"68292","250060 ALHANDRA",1,2,8,314,1,326,"2022"
"68293","250070 SAO JOAO DO RIO DO PEIXE",0,0,4,164,0,168,"2022"
"68294","250073 AMPARO",0,0,1,23,0,24,"2022"
"68295","250077 APARECIDA",0,0,2,98,0,100,"2022"
"68296","250080 ARACAGI",0,0,1,159,1,161,"2022"
"68297","250090 ARARA",0,0,3,123,3,129,"2022"
"68298","250100 ARARUNA",0,0,3,192,4,199,"2022"
"68299","250110 AREIA",1,0,7,262,5,275,"2022"
"68300","250115 AREIA DE BARAUNAS",0,0,0,31,0,31,"2022"
"68301","250120 AREIAL",1,0,2,96,1,100,"2022"
"68302","250130 AROEIRAS",1,2,2,247,7,259,"2022"
"68303","250135 ASSUNCAO",0,0,4,64,0,68,"2022"
"68304","250140 BAIA DA TRAICAO",0,0,2,156,0,158,"2022"
"68305","250150 BANANEIRAS",1,1,5,285,5,297,"2022"
"68306","250153 BARAUNA",0,1,0,56,0,57,"2022"
"68307","250157 BARRA DE SANTANA",0,0,3,92,1,96,"2022"
"68308","250160 BARRA DE SANTA ROSA",2,0,1,108,2,113,"2022"
"68309","250170 BARRA DE SAO MIGUEL",0,0,0,70,1,71,"2022"
"68310","250180 BAYEUX",1,3,20,1158,2,1184,"2022"
"68311","250190 BELEM",1,0,6,171,1,179,"2022"
"68312","250200 BELEM DO BREJO DO CRUZ",0,0,1,69,0,70,"2022"
"68313","250205 BERNARDINO BATISTA",0,0,0,32,0,32,"2022"
"68314","250210 BOA VENTURA",0,2,2,67,1,72,"2022"
"68315","250215 BOA VISTA",1,1,4,78,4,88,"2022"
"68316","250220 BOM JESUS",0,1,0,26,0,27,"2022"
"68317","250230 BOM SUCESSO",0,0,1,32,0,33,"2022"
"68318","250240 BONITO DE SANTA FE",0,1,3,122,0,126,"2022"
"68319","250250 BOQUEIRAO",1,1,1,209,2,214,"2022"
"68320","250260 IGARACY",1,0,0,68,0,69,"2022"
"68321","250270 BORBOREMA",0,1,0,63,1,65,"2022"
"68322","250280 BREJO DO CRUZ",0,1,3,156,2,162,"2022"
"68323","250290 BREJO DOS SANTOS",0,1,0,60,0,61,"2022"
"68324","250300 CAAPORA",2,1,4,302,4,313,"2022"
"68325","250310 CABACEIRAS",0,0,2,56,0,58,"2022"
"68326","250320 CABEDELO",2,5,15,835,1,858,"2022"
"68327","250330 CACHOEIRA DOS INDIOS",0,0,3,102,2,107,"2022"
"68328","250340 CACIMBA DE AREIA",0,0,0,47,0,47,"2022"
"68329","250350 CACIMBA DE DENTRO",0,0,3,181,3,187,"2022"
"68330","250355 CACIMBAS",2,0,3,118,6,129,"2022"
"68331","250360 CAICARA",0,0,4,71,0,75,"2022"
"68332","250370 CAJAZEIRAS",4,7,19,749,4,783,"2022"
"68333","250375 CAJAZEIRINHAS",0,2,0,40,0,42,"2022"
"68334","250380 CALDAS BRANDAO",1,0,2,85,0,88,"2022"
"68335","250390 CAMALAU",1,1,2,78,0,82,"2022"
"68336","250400 CAMPINA GRANDE",11,19,73,5454,61,5618,"2022"
"68337","250403 CAPIM",0,0,2,124,0,126,"2022"
"68338","250407 CARAUBAS",0,0,1,71,0,72,"2022"
"68339","250410 CARRAPATEIRA",0,0,0,21,0,21,"2022"
"68340","250415 CASSERENGUE",0,0,1,68,0,69,"2022"
"68341","250420 CATINGUEIRA",0,0,1,49,1,51,"2022"
"68342","250430 CATOLE DO ROCHA",0,0,2,348,2,352,"2022"
"68343","250435 CATURITE",0,0,2,62,1,65,"2022"
"68344","250440 CONCEICAO",0,1,1,188,0,190,"2022"
"68345","250450 CONDADO",0,0,1,78,2,81,"2022"
"68346","250460 CONDE",2,1,9,445,4,461,"2022"
"68347","250470 CONGO",0,0,2,79,1,82,"2022"
"68348","250480 COREMAS",2,1,4,151,1,159,"2022"
"68349","250485 COXIXOLA",0,0,1,19,0,20,"2022"
"68350","250490 CRUZ DO ESPIRITO SANTO",0,2,4,270,2,278,"2022"
"68351","250500 CUBATI",0,1,1,90,2,94,"2022"
"68352","250510 CUITE",0,0,1,216,1,218,"2022"
"68353","250520 CUITEGI",0,1,0,93,3,97,"2022"
"68354","250523 CUITE DE MAMANGUAPE",0,0,5,93,0,98,"2022"
"68355","250527 CURRAL DE CIMA",0,0,0,67,0,67,"2022"
"68356","250530 CURRAL VELHO",1,0,0,28,0,29,"2022"
"68357","250535 DAMIAO",0,1,0,60,3,64,"2022"
"68358","250540 DESTERRO",2,0,1,100,4,107,"2022"
"68359","250550 VISTA SERRANA",0,0,1,41,0,42,"2022"
"68360","250560 DIAMANTE",0,0,2,85,0,87,"2022"
"68361","250570 DONA INES",0,0,3,116,0,119,"2022"
"68362","250580 DUAS ESTRADAS",0,0,0,39,1,40,"2022"
"68363","250590 EMAS",0,0,1,27,0,28,"2022"
"68364","250600 ESPERANCA",0,1,8,394,0,403,"2022"
"68365","250610 FAGUNDES",0,0,1,144,1,146,"2022"
"68366","250620 FREI MARTINHO",0,0,0,24,0,24,"2022"
"68367","250625 GADO BRAVO",0,0,1,108,2,111,"2022"
"68368","250630 GUARABIRA",0,3,3,752,6,764,"2022"
"68369","250640 GURINHEM",2,0,3,151,0,156,"2022"
"68370","250650 GURJAO",0,0,0,44,1,45,"2022"
"68371","250660 IBIARA",0,0,0,63,0,63,"2022"
"68372","250670 IMACULADA",1,2,5,107,3,118,"2022"
"68373","250680 INGA",2,0,9,197,5,213,"2022"
"68374","250690 ITABAIANA",0,0,5,319,0,324,"2022"
"68375","250700 ITAPORANGA",0,0,4,288,1,293,"2022"
"68376","250710 ITAPOROROCA",0,1,2,236,0,239,"2022"
"68377","250720 ITATUBA",0,0,1,145,0,146,"2022"
"68378","250730 JACARAU",0,0,0,207,1,208,"2022"
"68379","250740 JERICO",0,0,2,79,0,81,"2022"
"68380","250750 JOAO PESSOA",28,35,130,10485,49,10727,"2022"
"68381","250760 JUAREZ TAVORA",0,1,3,96,0,100,"2022"
"68382","250770 JUAZEIRINHO",2,3,2,265,5,277,"2022"
"68383","250780 JUNCO DO SERIDO",0,0,0,91,1,92,"2022"
"68384","250790 JURIPIRANGA",1,0,3,155,0,159,"2022"
"68385","250800 JURU",1,0,3,90,0,94,"2022"
"68386","250810 LAGOA",0,1,1,32,0,34,"2022"
"68387","250820 LAGOA DE DENTRO",2,1,1,86,1,91,"2022"
"68388","250830 LAGOA SECA",0,1,1,345,1,348,"2022"
"68389","250840 LASTRO",0,1,0,28,0,29,"2022"
"68390","250850 LIVRAMENTO",0,0,2,79,3,84,"2022"
"68391","250855 LOGRADOURO",0,1,0,32,0,33,"2022"
"68392","250860 LUCENA",1,1,2,198,1,203,"2022"
"68393","250870 MAE D'AGUA",1,0,0,40,0,41,"2022"
"68394","250880 MALTA",0,1,0,72,1,74,"2022"
"68395","250890 MAMANGUAPE",2,7,8,621,0,638,"2022"
"68396","250900 MANAIRA",1,2,2,135,0,140,"2022"
"68397","250905 MARCACAO",0,1,0,155,0,156,"2022"
"68398","250910 MARI",1,3,3,257,0,264,"2022"
"68399","250915 MARIZOPOLIS",0,0,1,85,0,86,"2022"
"68400","250920 MASSARANDUBA",0,0,2,149,1,152,"2022"
"68401","250930 MATARACA",1,0,1,122,1,125,"2022"
"68402","250933 MATINHAS",0,1,0,58,3,62,"2022"
"68403","250937 MATO GROSSO",0,0,1,25,0,26,"2022"
"68404","250939 MATUREIA",0,0,0,82,3,85,"2022"
"68405","250940 MOGEIRO",0,1,3,161,3,168,"2022"
"68406","250950 MONTADAS",0,0,0,77,0,77,"2022"
"68407","250960 MONTE HOREBE",0,0,1,63,1,65,"2022"
"68408","250970 MONTEIRO",3,1,2,424,0,430,"2022"
"68409","250980 MULUNGU",1,0,2,122,4,129,"2022"
"68410","250990 NATUBA",0,0,2,78,2,82,"2022"
"68411","251000 NAZAREZINHO",0,0,0,69,0,69,"2022"
"68412","251010 NOVA FLORESTA",0,2,0,112,3,117,"2022"
"68413","251020 NOVA OLINDA",1,0,0,68,0,69,"2022"
"68414","251030 NOVA PALMEIRA",0,0,0,34,1,35,"2022"
"68415","251040 OLHO D'AGUA",1,0,2,83,0,86,"2022"
"68416","251050 OLIVEDOS",0,0,0,45,0,45,"2022"
"68417","251060 OURO VELHO",0,0,1,29,0,30,"2022"
"68418","251065 PARARI",0,0,0,19,0,19,"2022"
"68419","251070 PASSAGEM",0,0,4,18,1,23,"2022"
"68420","251080 PATOS",6,6,23,1234,11,1280,"2022"
"68421","251090 PAULISTA",0,1,2,114,1,118,"2022"
"68422","251100 PEDRA BRANCA",0,0,2,50,0,52,"2022"
"68423","251110 PEDRA LAVRADA",0,0,0,68,0,68,"2022"
"68424","251120 PEDRAS DE FOGO",0,4,6,377,0,387,"2022"
"68425","251130 PIANCO",0,1,0,148,0,149,"2022"
"68426","251140 PICUI",0,0,4,229,2,235,"2022"
"68427","251150 PILAR",0,0,4,181,0,185,"2022"
"68428","251160 PILOES",2,0,1,82,4,89,"2022"
"68429","251170 PILOEZINHOS",0,0,0,78,1,79,"2022"
"68430","251180 PIRPIRITUBA",0,1,2,127,1,131,"2022"
"68431","251190 PITIMBU",3,1,6,185,2,197,"2022"
"68432","251200 POCINHOS",0,1,4,234,4,243,"2022"
"68433","251203 POCO DANTAS",0,1,0,51,0,52,"2022"
"68434","251207 POCO DE JOSE DE MOURA",0,1,1,40,2,44,"2022"
"68435","251210 POMBAL",0,1,4,357,1,363,"2022"
"68436","251220 PRATA",0,0,0,43,1,44,"2022"
"68437","251230 PRINCESA ISABEL",1,0,4,262,1,268,"2022"
"68438","251240 PUXINANA",0,0,2,178,0,180,"2022"
"68439","251250 QUEIMADAS",1,3,8,620,6,638,"2022"
"68440","251260 QUIXABA",0,0,2,23,1,26,"2022"
"68441","251270 REMIGIO",0,3,2,225,2,232,"2022"
"68442","251272 PEDRO REGIS",1,3,3,49,0,56,"2022"
"68443","251274 RIACHAO",0,0,1,26,0,27,"2022"
"68444","251275 RIACHAO DO BACAMARTE",0,0,1,59,0,60,"2022"
"68445","251276 RIACHAO DO POCO",0,0,0,62,0,62,"2022"
"68446","251278 RIACHO DE SANTO ANTONIO",0,1,0,31,1,33,"2022"
"68447","251280 RIACHO DOS CAVALOS",0,0,2,95,1,98,"2022"
"68448","251290 RIO TINTO",0,2,2,286,1,291,"2022"
"68449","251300 SALGADINHO",0,2,1,36,2,41,"2022"
"68450","251310 SALGADO DE SAO FELIX",0,0,0,137,0,137,"2022"
"68451","251315 SANTA CECILIA",0,0,1,107,1,109,"2022"
"68452","251320 SANTA CRUZ",1,0,1,60,0,62,"2022"
"68453","251330 SANTA HELENA",1,1,0,59,0,61,"2022"
"68454","251335 SANTA INES",0,0,1,42,0,43,"2022"
"68455","251340 SANTA LUZIA",1,0,3,167,1,172,"2022"
"68456","251350 SANTANA DE MANGUEIRA",0,0,0,55,0,55,"2022"
"68457","251360 SANTANA DOS GARROTES",0,1,0,62,0,63,"2022"
"68458","251365 JOCA CLAUDINO",1,0,0,29,0,30,"2022"
"68459","251370 SANTA RITA",4,9,29,1904,2,1948,"2022"
"68460","251380 SANTA TERESINHA",0,1,2,61,1,65,"2022"
"68461","251385 SANTO ANDRE",1,0,1,21,0,23,"2022"
"68462","251390 SAO BENTO",1,3,6,395,2,407,"2022"
"68463","251392 SAO BENTINHO",0,0,0,39,0,39,"2022"
"68464","251394 SAO DOMINGOS DO CARIRI",0,0,0,33,0,33,"2022"
"68465","251396 SAO DOMINGOS",0,0,0,25,0,25,"2022"
"68466","251398 SAO FRANCISCO",0,0,0,37,0,37,"2022"
"68467","251400 SAO JOAO DO CARIRI",0,0,1,57,0,58,"2022"
"68468","251410 SAO JOAO DO TIGRE",0,0,0,37,0,37,"2022"
"68469","251420 SAO JOSE DA LAGOA TAPADA",0,1,2,78,0,81,"2022"
"68470","251430 SAO JOSE DE CAIANA",0,0,2,79,0,81,"2022"
"68471","251440 SAO JOSE DE ESPINHARAS",0,0,1,46,1,48,"2022"
"68472","251445 SAO JOSE DOS RAMOS",1,0,1,71,1,74,"2022"
"68473","251450 SAO JOSE DE PIRANHAS",2,1,4,237,2,246,"2022"
"68474","251455 SAO JOSE DE PRINCESA",1,0,0,25,1,27,"2022"
"68475","251460 SAO JOSE DO BONFIM",0,2,0,38,1,41,"2022"
"68476","251465 SAO JOSE DO BREJO DO CRUZ",0,0,0,23,0,23,"2022"
"68477","251470 SAO JOSE DO SABUGI",0,0,3,39,2,44,"2022"
"68478","251480 SAO JOSE DOS CORDEIROS",1,0,0,31,0,32,"2022"
"68479","251490 SAO MAMEDE",0,0,2,87,3,92,"2022"
"68480","251500 SAO MIGUEL DE TAIPU",1,1,1,87,2,92,"2022"
"68481","251510 SAO SEBASTIAO DE LAGOA DE ROCA",0,0,2,106,1,109,"2022"
"68482","251520 SAO SEBASTIAO DO UMBUZEIRO",0,0,1,48,0,49,"2022"
"68483","251530 SAPE",2,2,18,553,2,577,"2022"
"68484","251540 SAO VICENTE DO SERIDO",0,0,0,141,4,145,"2022"
"68485","251550 SERRA BRANCA",1,0,3,126,0,130,"2022"
"68486","251560 SERRA DA RAIZ",0,0,0,25,1,26,"2022"
"68487","251570 SERRA GRANDE",0,0,0,37,0,37,"2022"
"68488","251580 SERRA REDONDA",0,0,0,82,3,85,"2022"
"68489","251590 SERRARIA",0,0,1,64,4,69,"2022"
"68490","251593 SERTAOZINHO",0,0,4,68,0,72,"2022"
"68491","251597 SOBRADO",0,1,3,121,0,125,"2022"
"68492","251600 SOLANEA",7,0,5,333,3,348,"2022"
"68493","251610 SOLEDADE",0,0,4,156,4,164,"2022"
"68494","251615 SOSSEGO",0,0,0,54,1,55,"2022"
"68495","251620 SOUSA",5,1,7,883,3,899,"2022"
"68496","251630 SUME",0,2,1,203,1,207,"2022"
"68497","251640 TACIMA",0,2,3,76,2,83,"2022"
"68498","251650 TAPEROA",1,0,4,172,1,178,"2022"
"68499","251660 TAVARES",0,1,3,170,1,175,"2022"
"68500","251670 TEIXEIRA",1,0,2,194,4,201,"2022"
"68501","251675 TENORIO",0,1,1,37,0,39,"2022"
"68502","251680 TRIUNFO",1,0,2,100,2,105,"2022"
"68503","251690 UIRAUNA",0,0,2,153,4,159,"2022"
"68504","251700 UMBUZEIRO",0,0,4,105,2,111,"2022"
"68505","251710 VARZEA",0,0,1,28,0,29,"2022"
"68506","251720 VIEIROPOLIS",1,0,0,38,0,39,"2022"
"68507","251740 ZABELE",0,0,2,31,0,33,"2022"
"68508","MUNICIPIO IGNORADO - PE",0,1,0,10,1,12,"2022"
"68509","260005 ABREU E LIMA",2,6,19,1098,17,1142,"2022"
"68510","260010 AFOGADOS DA INGAZEIRA",0,2,6,527,4,539,"2022"
"68511","260020 AFRANIO",2,2,3,213,17,237,"2022"
"68512","260030 AGRESTINA",1,1,4,359,1,366,"2022"
"68513","260040 AGUA PRETA",1,2,8,337,1,349,"2022"
"68514","260050 AGUAS BELAS",2,2,10,684,3,701,"2022"
"68515","260060 ALAGOINHA",0,1,2,180,1,184,"2022"
"68516","260070 ALIANCA",1,3,3,458,0,465,"2022"
"68517","260080 ALTINHO",0,1,4,201,1,207,"2022"
"68518","260090 AMARAJI",1,1,4,268,3,277,"2022"
"68519","260100 ANGELIM",0,1,0,123,2,126,"2022"
"68520","260105 ARACOIABA",2,4,5,266,5,282,"2022"
"68521","260110 ARARIPINA",4,10,23,1505,1,1543,"2022"
"68522","260120 ARCOVERDE",1,6,7,1001,10,1025,"2022"
"68523","260130 BARRA DE GUABIRABA",0,0,1,149,2,152,"2022"
"68524","260140 BARREIROS",0,2,10,538,9,559,"2022"
"68525","260150 BELEM DE MARIA",0,0,1,97,0,98,"2022"
"68526","260160 BELEM DE SAO FRANCISCO",1,2,3,290,0,296,"2022"
"68527","260170 BELO JARDIM",3,8,25,1114,10,1160,"2022"
"68528","260180 BETANIA",0,2,4,160,0,166,"2022"
"68529","260190 BEZERROS",1,3,5,640,2,651,"2022"
"68530","260200 BODOCO",0,4,7,519,0,530,"2022"
"68531","260210 BOM CONSELHO",4,2,5,458,3,472,"2022"
"68532","260220 BOM JARDIM",1,1,6,408,7,423,"2022"
"68533","260230 BONITO",2,5,6,526,2,541,"2022"
"68534","260240 BREJAO",0,0,1,176,0,177,"2022"
"68535","260250 BREJINHO",1,0,1,103,0,105,"2022"
"68536","260260 BREJO DA MADRE DE DEUS",0,3,11,622,7,643,"2022"
"68537","260270 BUENOS AIRES",0,0,5,159,2,166,"2022"
"68538","260280 BUIQUE",2,5,13,769,4,793,"2022"
"68539","260290 CABO DE SANTO AGOSTINHO",4,18,35,2616,23,2696,"2022"
"68540","260300 CABROBO",1,1,13,476,2,493,"2022"
"68541","260310 CACHOEIRINHA",1,2,2,290,0,295,"2022"
"68542","260320 CAETES",0,1,5,386,3,395,"2022"
"68543","260330 CALCADO",0,1,3,121,0,125,"2022"
"68544","260340 CALUMBI",0,1,0,81,0,82,"2022"
"68545","260345 CAMARAGIBE",7,7,27,1736,3,1780,"2022"
"68546","260350 CAMOCIM DE SAO FELIX",0,0,3,215,2,220,"2022"
"68547","260360 CAMUTANGA",0,0,1,100,0,101,"2022"
"68548","260370 CANHOTINHO",2,1,3,274,1,281,"2022"
"68549","260380 CAPOEIRAS",1,1,3,263,0,268,"2022"
"68550","260390 CARNAIBA",1,1,2,240,0,244,"2022"
"68551","260392 CARNAUBEIRA DA PENHA",1,1,4,247,2,255,"2022"
"68552","260400 CARPINA",4,5,8,889,4,910,"2022"
"68553","260410 CARUARU",24,17,58,5097,45,5241,"2022"
"68554","260415 CASINHAS",0,1,0,151,1,153,"2022"
"68555","260420 CATENDE",0,2,1,412,5,420,"2022"
"68556","260430 CEDRO",0,0,4,143,1,148,"2022"
"68557","260440 CHA DE ALEGRIA",2,2,4,144,1,153,"2022"
"68558","260450 CHA GRANDE",0,1,1,276,4,282,"2022"
"68559","260460 CONDADO",1,0,4,268,2,275,"2022"
"68560","260470 CORRENTES",0,0,1,170,1,172,"2022"
"68561","260480 CORTES",2,2,1,148,0,153,"2022"
"68562","260490 CUMARU",0,1,1,147,0,149,"2022"
"68563","260500 CUPIRA",0,1,2,302,3,308,"2022"
"68564","260510 CUSTODIA",1,0,4,509,1,515,"2022"
"68565","260515 DORMENTES",1,0,2,121,64,188,"2022"
"68566","260520 ESCADA",4,1,8,689,7,709,"2022"
"68567","260530 EXU",2,4,7,420,3,436,"2022"
"68568","260540 FEIRA NOVA",1,0,2,274,4,281,"2022"
"68569","260545 FERNANDO DE NORONHA",0,0,2,26,0,28,"2022"
"68570","260550 FERREIROS",1,0,4,110,0,115,"2022"
"68571","260560 FLORES",4,3,7,238,0,252,"2022"
"68572","260570 FLORESTA",4,3,7,431,1,446,"2022"
"68573","260580 FREI MIGUELINHO",1,1,0,177,3,182,"2022"
"68574","260590 GAMELEIRA",0,3,4,262,2,271,"2022"
"68575","260600 GARANHUNS",9,2,19,1942,2,1974,"2022"
"68576","260610 GLORIA DO GOITA",2,0,6,362,0,370,"2022"
"68577","260620 GOIANA",9,5,9,1058,8,1089,"2022"
"68578","260630 GRANITO",0,0,3,104,1,108,"2022"
"68579","260640 GRAVATA",0,2,7,988,18,1015,"2022"
"68580","260650 IATI",2,3,6,276,0,287,"2022"
"68581","260660 IBIMIRIM",1,1,8,367,6,383,"2022"
"68582","260670 IBIRAJUBA",0,0,1,90,0,91,"2022"
"68583","260680 IGARASSU",4,3,18,1454,13,1492,"2022"
"68584","260690 IGUARACY",1,0,1,125,0,127,"2022"
"68585","260700 INAJA",3,0,8,319,5,335,"2022"
"68586","260710 INGAZEIRA",0,0,1,53,0,54,"2022"
"68587","260720 IPOJUCA",7,9,17,1569,4,1606,"2022"
"68588","260730 IPUBI",1,3,11,492,0,507,"2022"
"68589","260740 ITACURUBA",0,0,1,73,0,74,"2022"
"68590","260750 ITAIBA",0,1,3,367,2,373,"2022"
"68591","260760 ILHA DE ITAMARACA",0,1,3,238,7,249,"2022"
"68592","260765 ITAMBE",2,4,4,394,0,404,"2022"
"68593","260770 ITAPETIM",2,0,0,169,0,171,"2022"
"68594","260775 ITAPISSUMA",1,0,6,350,3,360,"2022"
"68595","260780 ITAQUITINGA",4,1,3,177,1,186,"2022"
"68596","260790 JABOATAO DOS GUARARAPES",26,21,92,7531,67,7737,"2022"
"68597","260795 JAQUEIRA",1,1,2,143,7,154,"2022"
"68598","260800 JATAUBA",4,2,3,220,0,229,"2022"
"68599","260805 JATOBA",1,1,2,192,6,202,"2022"
"68600","260810 JOAO ALFREDO",1,0,0,290,0,291,"2022"
"68601","260820 JOAQUIM NABUCO",0,2,1,159,4,166,"2022"
"68602","260825 JUCATI",1,1,3,151,0,156,"2022"
"68603","260830 JUPI",2,0,3,237,1,243,"2022"
"68604","260840 JUREMA",0,2,2,195,2,201,"2022"
"68605","260845 LAGOA DO CARRO",2,1,1,209,0,213,"2022"
"68606","260850 LAGOA DE ITAENGA",0,1,8,276,0,285,"2022"
"68607","260860 LAGOA DO OURO",0,0,3,163,1,167,"2022"
"68608","260870 LAGOA DOS GATOS",1,1,1,145,0,148,"2022"
"68609","260875 LAGOA GRANDE",0,6,4,362,2,374,"2022"
"68610","260880 LAJEDO",1,4,12,614,1,632,"2022"
"68611","260890 LIMOEIRO",0,0,8,650,2,660,"2022"
"68612","260900 MACAPARANA",0,0,5,342,0,347,"2022"
"68613","260910 MACHADOS",0,0,0,174,4,178,"2022"
"68614","260915 MANARI",0,2,4,256,2,264,"2022"
"68615","260920 MARAIAL",1,1,0,128,3,133,"2022"
"68616","260930 MIRANDIBA",0,2,7,243,1,253,"2022"
"68617","260940 MORENO",2,2,6,665,3,678,"2022"
"68618","260950 NAZARE DA MATA",1,0,6,331,1,339,"2022"
"68619","260960 OLINDA",7,19,45,4062,29,4162,"2022"
"68620","260970 OROBO",2,1,4,237,0,244,"2022"
"68621","260980 OROCO",2,2,4,190,1,199,"2022"
"68622","260990 OURICURI",3,4,11,918,5,941,"2022"
"68623","261000 PALMARES",2,1,12,792,9,816,"2022"
"68624","261010 PALMEIRINA",0,0,0,89,1,90,"2022"
"68625","261020 PANELAS",1,1,4,299,5,310,"2022"
"68626","261030 PARANATAMA",1,1,0,179,2,183,"2022"
"68627","261040 PARNAMIRIM",0,2,4,237,1,244,"2022"
"68628","261050 PASSIRA",2,0,7,342,0,351,"2022"
"68629","261060 PAUDALHO",3,2,14,795,7,821,"2022"
"68630","261070 PAULISTA",11,8,43,3324,19,3405,"2022"
"68631","261080 PEDRA",2,0,5,305,0,312,"2022"
"68632","261090 PESQUEIRA",2,1,10,852,3,868,"2022"
"68633","261100 PETROLANDIA",2,3,6,564,2,577,"2022"
"68634","261110 PETROLINA",18,37,96,5893,79,6123,"2022"
"68635","261120 POCAO",0,0,3,146,0,149,"2022"
"68636","261130 POMBOS",1,0,5,320,4,330,"2022"
"68637","261140 PRIMAVERA",0,4,1,153,0,158,"2022"
"68638","261150 QUIPAPA",1,2,4,210,3,220,"2022"
"68639","261153 QUIXABA",0,0,1,80,0,81,"2022"
"68640","261160 RECIFE",45,66,199,16848,133,17291,"2022"
"68641","261170 RIACHO DAS ALMAS",0,1,3,254,3,261,"2022"
"68642","261180 RIBEIRAO",1,2,7,380,6,396,"2022"
"68643","261190 RIO FORMOSO",3,1,4,267,0,275,"2022"
"68644","261200 SAIRE",0,0,0,112,0,112,"2022"
"68645","261210 SALGADINHO",0,1,0,46,0,47,"2022"
"68646","261220 SALGUEIRO",1,7,16,911,1,936,"2022"
"68647","261230 SALOA",2,1,1,174,2,180,"2022"
"68648","261240 SANHARO",1,3,2,242,3,251,"2022"
"68649","261245 SANTA CRUZ",1,0,0,201,1,203,"2022"
"68650","261247 SANTA CRUZ DA BAIXA VERDE",0,1,4,139,1,145,"2022"
"68651","261250 SANTA CRUZ DO CAPIBARIBE",2,8,9,1328,8,1355,"2022"
"68652","261255 SANTA FILOMENA",1,0,5,153,2,161,"2022"
"68653","261260 SANTA MARIA DA BOA VISTA",3,2,11,568,9,593,"2022"
"68654","261270 SANTA MARIA DO CAMBUCA",1,1,3,165,1,171,"2022"
"68655","261280 SANTA TEREZINHA",0,0,4,122,2,128,"2022"
"68656","261290 SAO BENEDITO DO SUL",0,0,1,136,0,137,"2022"
"68657","261300 SAO BENTO DO UNA",0,1,9,727,10,747,"2022"
"68658","261310 SAO CAITANO",0,2,11,488,4,505,"2022"
"68659","261320 SAO JOAO",0,2,4,349,1,356,"2022"
"68660","261330 SAO JOAQUIM DO MONTE",0,1,8,272,1,282,"2022"
"68661","261340 SAO JOSE DA COROA GRANDE",1,2,1,250,6,260,"2022"
"68662","261350 SAO JOSE DO BELMONTE",0,2,6,487,1,496,"2022"
"68663","261360 SAO JOSE DO EGITO",0,1,1,403,0,405,"2022"
"68664","261370 SAO LOURENCO DA MATA",3,4,31,1367,3,1408,"2022"
"68665","261380 SAO VICENTE FERRER",1,1,1,229,1,233,"2022"
"68666","261390 SERRA TALHADA",4,5,28,1388,4,1429,"2022"
"68667","261400 SERRITA",0,1,8,197,0,206,"2022"
"68668","261410 SERTANIA",7,3,3,332,3,348,"2022"
"68669","261420 SIRINHAEM",0,1,6,481,4,492,"2022"
"68670","261430 MOREILANDIA",0,1,1,121,1,124,"2022"
"68671","261440 SOLIDAO",1,0,0,74,0,75,"2022"
"68672","261450 SURUBIM",0,2,8,782,7,799,"2022"
"68673","261460 TABIRA",1,0,6,361,1,369,"2022"
"68674","261470 TACAIMBO",2,0,2,127,0,131,"2022"
"68675","261480 TACARATU",1,3,2,275,0,281,"2022"
"68676","261485 TAMANDARE",2,3,5,336,6,352,"2022"
"68677","261500 TAQUARITINGA DO NORTE",0,0,2,338,2,342,"2022"
"68678","261510 TEREZINHA",0,0,0,77,0,77,"2022"
"68679","261520 TERRA NOVA",0,0,1,118,0,119,"2022"
"68680","261530 TIMBAUBA",1,2,3,579,3,588,"2022"
"68681","261540 TORITAMA",1,4,6,654,4,669,"2022"
"68682","261550 TRACUNHAEM",2,0,3,170,1,176,"2022"
"68683","261560 TRINDADE",1,2,14,513,1,531,"2022"
"68684","261570 TRIUNFO",1,0,4,186,0,191,"2022"
"68685","261580 TUPANATINGA",3,3,5,350,2,363,"2022"
"68686","261590 TUPARETAMA",0,0,0,117,0,117,"2022"
"68687","261600 VENTUROSA",3,0,3,235,0,241,"2022"
"68688","261610 VERDEJANTE",0,1,2,129,3,135,"2022"
"68689","261618 VERTENTE DO LERIO",1,2,0,88,2,93,"2022"
"68690","261620 VERTENTES",0,2,3,283,3,291,"2022"
"68691","261630 VICENCIA",0,2,8,320,2,332,"2022"
"68692","261640 VITORIA DE SANTO ANTAO",6,5,12,1726,4,1753,"2022"
"68693","261650 XEXEU",0,1,2,176,2,181,"2022"
"68694","270010 AGUA BRANCA",1,1,3,252,3,260,"2022"
"68695","270020 ANADIA",0,2,2,177,3,184,"2022"
"68696","270030 ARAPIRACA",4,15,53,3588,13,3673,"2022"
"68697","270040 ATALAIA",2,5,9,518,3,537,"2022"
"68698","270050 BARRA DE SANTO ANTONIO",0,3,5,277,4,289,"2022"
"68699","270060 BARRA DE SAO MIGUEL",0,0,1,148,0,149,"2022"
"68700","270070 BATALHA",0,1,9,251,0,261,"2022"
"68701","270080 BELEM",0,0,1,62,0,63,"2022"
"68702","270090 BELO MONTE",0,0,0,119,0,119,"2022"
"68703","270100 BOCA DA MATA",2,0,2,265,1,270,"2022"
"68704","270110 BRANQUINHA",1,0,0,143,1,145,"2022"
"68705","270120 CACIMBINHAS",1,0,2,142,1,146,"2022"
"68706","270130 CAJUEIRO",0,0,1,282,1,284,"2022"
"68707","270135 CAMPESTRE",0,0,1,96,0,97,"2022"
"68708","270140 CAMPO ALEGRE",3,3,4,480,2,492,"2022"
"68709","270150 CAMPO GRANDE",0,2,1,147,0,150,"2022"
"68710","270160 CANAPI",0,1,3,238,7,249,"2022"
"68711","270170 CAPELA",0,0,2,190,3,195,"2022"
"68712","270180 CARNEIROS",0,0,0,155,0,155,"2022"
"68713","270190 CHA PRETA",0,0,2,76,0,78,"2022"
"68714","270200 COITE DO NOIA",0,0,3,160,0,163,"2022"
"68715","270210 COLONIA LEOPOLDINA",1,1,2,237,1,242,"2022"
"68716","270220 COQUEIRO SECO",0,1,1,72,4,78,"2022"
"68717","270230 CORURIPE",5,3,9,772,3,792,"2022"
"68718","270235 CRAIBAS",1,1,9,423,5,439,"2022"
"68719","270240 DELMIRO GOUVEIA",1,4,11,688,4,708,"2022"
"68720","270250 DOIS RIACHOS",0,0,6,156,0,162,"2022"
"68721","270255 ESTRELA DE ALAGOAS",1,1,3,222,0,227,"2022"
"68722","270260 FEIRA GRANDE",0,2,4,351,2,359,"2022"
"68723","270270 FELIZ DESERTO",1,0,2,50,0,53,"2022"
"68724","270280 FLEXEIRAS",0,0,1,137,4,142,"2022"
"68725","270290 GIRAU DO PONCIANO",0,3,7,503,7,520,"2022"
"68726","270300 IBATEGUARA",2,2,2,218,0,224,"2022"
"68727","270310 IGACI",2,3,4,274,0,283,"2022"
"68728","270320 IGREJA NOVA",0,0,2,301,0,303,"2022"
"68729","270330 INHAPI",1,2,2,246,11,262,"2022"
"68730","270340 JACARE DOS HOMENS",0,1,1,83,0,85,"2022"
"68731","270350 JACUIPE",0,0,2,50,0,52,"2022"
"68732","270360 JAPARATINGA",0,1,3,143,0,147,"2022"
"68733","270370 JARAMATAIA",0,1,1,93,0,95,"2022"
"68734","270375 JEQUIA DA PRAIA",1,0,1,121,1,124,"2022"
"68735","270380 JOAQUIM GOMES",0,0,1,269,3,273,"2022"
"68736","270390 JUNDIA",0,1,1,54,0,56,"2022"
"68737","270400 JUNQUEIRO",0,2,5,309,2,318,"2022"
"68738","270410 LAGOA DA CANOA",0,1,1,313,1,316,"2022"
"68739","270420 LIMOEIRO DE ANADIA",0,1,3,369,2,375,"2022"
"68740","270430 MACEIO",31,41,207,12594,154,13027,"2022"
"68741","270440 MAJOR ISIDORO",0,3,2,219,2,226,"2022"
"68742","270450 MARAGOGI",3,2,9,530,0,544,"2022"
"68743","270460 MARAVILHA",0,0,0,185,0,185,"2022"
"68744","270470 MARECHAL DEODORO",3,2,9,880,5,899,"2022"
"68745","270480 MARIBONDO",0,1,3,146,0,150,"2022"
"68746","270490 MAR VERMELHO",0,0,2,30,0,32,"2022"
"68747","270500 MATA GRANDE",1,0,1,286,2,290,"2022"
"68748","270510 MATRIZ DE CAMARAGIBE",1,1,4,362,5,373,"2022"
"68749","270520 MESSIAS",0,0,1,217,7,225,"2022"
"68750","270530 MINADOR DO NEGRAO",0,1,3,79,0,83,"2022"
"68751","270540 MONTEIROPOLIS",0,1,1,108,0,110,"2022"
"68752","270550 MURICI",2,2,3,392,3,402,"2022"
"68753","270560 NOVO LINO",0,0,2,120,2,124,"2022"
"68754","270570 OLHO D'AGUA DAS FLORES",0,3,4,313,1,321,"2022"
"68755","270580 OLHO D'AGUA DO CASADO",1,0,1,131,3,136,"2022"
"68756","270590 OLHO D'AGUA GRANDE",0,0,2,74,0,76,"2022"
"68757","270600 OLIVENCA",2,1,2,175,0,180,"2022"
"68758","270610 OURO BRANCO",2,0,1,159,0,162,"2022"
"68759","270620 PALESTINA",0,0,0,76,0,76,"2022"
"68760","270630 PALMEIRA DOS INDIOS",1,4,16,1134,1,1156,"2022"
"68761","270640 PAO DE ACUCAR",1,1,6,338,0,346,"2022"
"68762","270642 PARICONHA",1,1,5,155,4,166,"2022"
"68763","270644 PARIPUEIRA",3,1,2,190,7,203,"2022"
"68764","270650 PASSO DE CAMARAGIBE",0,0,3,180,3,186,"2022"
"68765","270660 PAULO JACINTO",0,0,0,88,4,92,"2022"
"68766","270670 PENEDO",3,1,12,786,1,803,"2022"
"68767","270680 PIACABUCU",0,2,5,240,0,247,"2022"
"68768","270690 PILAR",2,2,12,564,1,581,"2022"
"68769","270700 PINDOBA",0,0,0,26,0,26,"2022"
"68770","270710 PIRANHAS",1,0,5,379,3,388,"2022"
"68771","270720 POCO DAS TRINCHEIRAS",0,1,3,192,0,196,"2022"
"68772","270730 PORTO CALVO",0,2,4,356,2,364,"2022"
"68773","270740 PORTO DE PEDRAS",0,0,3,135,1,139,"2022"
"68774","270750 PORTO REAL DO COLEGIO",0,2,8,242,2,254,"2022"
"68775","270760 QUEBRANGULO",2,0,2,159,0,163,"2022"
"68776","270770 RIO LARGO",3,4,15,1261,14,1297,"2022"
"68777","270780 ROTEIRO",0,0,0,105,0,105,"2022"
"68778","270790 SANTA LUZIA DO NORTE",0,1,1,113,2,117,"2022"
"68779","270800 SANTANA DO IPANEMA",0,5,5,755,1,766,"2022"
"68780","270810 SANTANA DO MUNDAU",0,0,2,147,1,150,"2022"
"68781","270820 SAO BRAS",0,0,2,93,0,95,"2022"
"68782","270830 SAO JOSE DA LAJE",1,1,1,318,1,322,"2022"
"68783","270840 SAO JOSE DA TAPERA",0,3,4,520,10,537,"2022"
"68784","270850 SAO LUIS DO QUITUNDE",0,4,0,448,1,453,"2022"
"68785","270860 SAO MIGUEL DOS CAMPOS",1,3,6,772,2,784,"2022"
"68786","270870 SAO MIGUEL DOS MILAGRES",0,0,3,126,4,133,"2022"
"68787","270880 SAO SEBASTIAO",0,2,9,478,0,489,"2022"
"68788","270890 SATUBA",4,2,5,293,3,307,"2022"
"68789","270895 SENADOR RUI PALMEIRA",0,1,1,173,0,175,"2022"
"68790","270900 TANQUE D'ARCA",0,0,0,49,0,49,"2022"
"68791","270910 TAQUARANA",0,1,2,276,0,279,"2022"
"68792","270915 TEOTONIO VILELA",3,1,7,561,1,573,"2022"
"68793","270920 TRAIPU",0,2,6,336,2,346,"2022"
"68794","270930 UNIAO DOS PALMARES",1,6,8,894,3,912,"2022"
"68795","270940 VICOSA",1,1,5,315,6,328,"2022"
"68796","280010 AMPARO DE SAO FRANCISCO",0,0,0,25,2,27,"2022"
"68797","280020 AQUIDABA",3,0,5,216,10,234,"2022"
"68798","280030 ARACAJU",28,39,117,7001,74,7259,"2022"
"68799","280040 ARAUA",0,0,2,121,2,125,"2022"
"68800","280050 AREIA BRANCA",1,1,3,215,4,224,"2022"
"68801","280060 BARRA DOS COQUEIROS",2,2,2,544,4,554,"2022"
"68802","280067 BOQUIM",2,0,4,257,3,266,"2022"
"68803","280070 BREJO GRANDE",0,1,2,97,16,116,"2022"
"68804","280100 CAMPO DO BRITO",0,2,2,210,1,215,"2022"
"68805","280110 CANHOBA",0,0,3,47,4,54,"2022"
"68806","280120 CANINDE DE SAO FRANCISCO",4,2,6,478,20,510,"2022"
"68807","280130 CAPELA",3,4,10,433,26,476,"2022"
"68808","280140 CARIRA",0,3,2,267,5,277,"2022"
"68809","280150 CARMOPOLIS",0,0,1,161,12,174,"2022"
"68810","280160 CEDRO DE SAO JOAO",0,0,1,47,0,48,"2022"
"68811","280170 CRISTINAPOLIS",0,1,4,243,5,253,"2022"
"68812","280190 CUMBE",0,0,0,38,2,40,"2022"
"68813","280200 DIVINA PASTORA",1,0,1,57,3,62,"2022"
"68814","280210 ESTANCIA",3,9,14,904,10,940,"2022"
"68815","280220 FEIRA NOVA",0,0,0,75,3,78,"2022"
"68816","280230 FREI PAULO",1,0,3,191,3,198,"2022"
"68817","280240 GARARU",1,3,4,114,10,132,"2022"
"68818","280250 GENERAL MAYNARD",0,0,0,27,0,27,"2022"
"68819","280260 GRACHO CARDOSO",0,1,3,59,4,67,"2022"
"68820","280270 ILHA DAS FLORES",0,0,4,124,1,129,"2022"
"68821","280280 INDIAROBA",1,1,0,235,7,244,"2022"
"68822","280290 ITABAIANA",9,4,12,1247,9,1281,"2022"
"68823","280300 ITABAIANINHA",3,2,13,502,8,528,"2022"
"68824","280310 ITABI",1,0,2,50,4,57,"2022"
"68825","280320 ITAPORANGA D'AJUDA",0,3,8,414,25,450,"2022"
"68826","280330 JAPARATUBA",0,0,4,162,15,181,"2022"
"68827","280340 JAPOATA",2,1,6,163,6,178,"2022"
"68828","280350 LAGARTO",2,4,18,1272,11,1307,"2022"
"68829","280360 LARANJEIRAS",0,0,6,337,24,367,"2022"
"68830","280370 MACAMBIRA",2,0,1,74,1,78,"2022"
"68831","280380 MALHADA DOS BOIS",0,0,0,52,0,52,"2022"
"68832","280390 MALHADOR",1,1,1,120,2,125,"2022"
"68833","280400 MARUIM",0,0,3,223,5,231,"2022"
"68834","280410 MOITA BONITA",0,0,1,108,2,111,"2022"
"68835","280420 MONTE ALEGRE DE SERGIPE",0,1,5,209,17,232,"2022"
"68836","280430 MURIBECA",0,0,3,86,6,95,"2022"
"68837","280440 NEOPOLIS",0,1,1,181,11,194,"2022"
"68838","280445 NOSSA SENHORA APARECIDA",1,2,4,98,0,105,"2022"
"68839","280450 NOSSA SENHORA DA GLORIA",1,1,8,526,52,588,"2022"
"68840","280460 NOSSA SENHORA DAS DORES",2,4,7,286,28,327,"2022"
"68841","280470 NOSSA SENHORA DE LOURDES",0,0,2,80,4,86,"2022"
"68842","280480 NOSSA SENHORA DO SOCORRO",11,12,37,2566,38,2664,"2022"
"68843","280490 PACATUBA",0,0,2,165,7,174,"2022"
"68844","280500 PEDRA MOLE",1,0,0,42,0,43,"2022"
"68845","280510 PEDRINHAS",0,1,0,93,2,96,"2022"
"68846","280520 PINHAO",0,0,0,80,2,82,"2022"
"68847","280530 PIRAMBU",0,0,1,121,3,125,"2022"
"68848","280540 POCO REDONDO",1,3,8,436,29,477,"2022"
"68849","280550 POCO VERDE",0,3,2,239,6,250,"2022"
"68850","280560 PORTO DA FOLHA",2,1,7,389,16,415,"2022"
"68851","280570 PROPRIA",1,1,8,349,7,366,"2022"
"68852","280580 RIACHAO DO DANTAS",0,0,1,195,4,200,"2022"
"68853","280590 RIACHUELO",2,2,0,113,8,125,"2022"
"68854","280600 RIBEIROPOLIS",0,1,4,169,8,182,"2022"
"68855","280610 ROSARIO DO CATETE",0,0,2,123,8,133,"2022"
"68856","280620 SALGADO",1,0,1,224,4,230,"2022"
"68857","280630 SANTA LUZIA DO ITANHY",0,1,5,175,1,182,"2022"
"68858","280640 SANTANA DO SAO FRANCISCO",0,0,3,98,4,105,"2022"
"68859","280650 SANTA ROSA DE LIMA",0,1,0,52,0,53,"2022"
"68860","280660 SANTO AMARO DAS BROTAS",0,1,5,117,3,126,"2022"
"68861","280670 SAO CRISTOVAO",2,4,18,1051,29,1104,"2022"
"68862","280680 SAO DOMINGOS",0,3,1,133,1,138,"2022"
"68863","280690 SAO FRANCISCO",0,0,0,32,0,32,"2022"
"68864","280700 SAO MIGUEL DO ALEIXO",0,2,0,31,0,33,"2022"
"68865","280710 SIMAO DIAS",2,3,12,579,3,599,"2022"
"68866","280720 SIRIRI",0,1,0,107,5,113,"2022"
"68867","280730 TELHA",0,1,0,28,5,34,"2022"
"68868","280740 TOBIAS BARRETO",4,6,12,597,12,631,"2022"
"68869","280750 TOMAR DO GERU",0,0,1,139,2,142,"2022"
"68870","280760 UMBAUBA",1,4,4,355,4,368,"2022"
"68871","MUNICIPIO IGNORADO - BA",0,0,0,3,0,3,"2022"
"68872","290010 ABAIRA",0,0,0,52,2,54,"2022"
"68873","290020 ABARE",0,0,9,270,0,279,"2022"
"68874","290030 ACAJUTIBA",1,0,2,152,1,156,"2022"
"68875","290035 ADUSTINA",1,0,3,138,4,146,"2022"
"68876","290040 AGUA FRIA",0,1,4,137,3,145,"2022"
"68877","290050 ERICO CARDOSO",0,0,0,117,1,118,"2022"
"68878","290060 AIQUARA",0,1,1,53,0,55,"2022"
"68879","290070 ALAGOINHAS",7,14,21,1821,13,1876,"2022"
"68880","290080 ALCOBACA",1,1,11,309,3,325,"2022"
"68881","290090 ALMADINA",0,0,1,42,0,43,"2022"
"68882","290100 AMARGOSA",3,4,13,413,1,434,"2022"
"68883","290110 AMELIA RODRIGUES",2,0,2,159,1,164,"2022"
"68884","290115 AMERICA DOURADA",0,1,2,199,0,202,"2022"
"68885","290120 ANAGE",0,0,6,186,1,193,"2022"
"68886","290130 ANDARAI",0,1,3,148,0,152,"2022"
"68887","290135 ANDORINHA",1,0,2,162,2,167,"2022"
"68888","290140 ANGICAL",4,2,2,180,0,188,"2022"
"68889","290150 ANGUERA",1,0,1,47,0,49,"2022"
"68890","290160 ANTAS",1,0,1,134,1,137,"2022"
"68891","290170 ANTONIO CARDOSO",1,0,3,107,1,112,"2022"
"68892","290180 ANTONIO GONCALVES",0,0,1,93,2,96,"2022"
"68893","290190 APORA",0,0,4,171,2,177,"2022"
"68894","290195 APUAREMA",1,1,3,65,2,72,"2022"
"68895","290200 ARACATU",0,1,2,168,0,171,"2022"
"68896","290205 ARACAS",0,1,2,111,2,116,"2022"
"68897","290210 ARACI",4,3,10,619,8,644,"2022"
"68898","290220 ARAMARI",0,1,0,86,1,88,"2022"
"68899","290225 ARATACA",0,2,3,71,1,77,"2022"
"68900","290230 ARATUIPE",1,0,4,106,0,111,"2022"
"68901","290240 AURELINO LEAL",2,2,6,160,7,177,"2022"
"68902","290250 BAIANOPOLIS",0,1,2,151,4,158,"2022"
"68903","290260 BAIXA GRANDE",0,1,8,137,0,146,"2022"
"68904","290265 BANZAE",0,0,1,111,7,119,"2022"
"68905","290270 BARRA",4,4,13,786,8,815,"2022"
"68906","290280 BARRA DA ESTIVA",1,1,12,345,0,359,"2022"
"68907","290290 BARRA DO CHOCA",2,6,11,423,4,446,"2022"
"68908","290300 BARRA DO MENDES",0,1,4,163,2,170,"2022"
"68909","290310 BARRA DO ROCHA",0,0,0,57,0,57,"2022"
"68910","290320 BARREIRAS",7,13,35,2330,8,2393,"2022"
"68911","290323 BARRO ALTO",0,3,1,137,0,141,"2022"
"68912","290327 BARROCAS",0,1,7,190,1,199,"2022"
"68913","290330 BARRO PRETO",1,3,0,53,1,58,"2022"
"68914","290340 BELMONTE",1,0,4,221,1,227,"2022"
"68915","290350 BELO CAMPO",2,0,1,238,2,243,"2022"
"68916","290360 BIRITINGA",0,2,5,167,5,179,"2022"
"68917","290370 BOA NOVA",1,0,1,134,3,139,"2022"
"68918","290380 BOA VISTA DO TUPIM",0,1,1,184,0,186,"2022"
"68919","290390 BOM JESUS DA LAPA",1,5,10,942,9,967,"2022"
"68920","290395 BOM JESUS DA SERRA",0,0,7,95,0,102,"2022"
"68921","290400 BONINAL",0,3,1,132,2,138,"2022"
"68922","290405 BONITO",1,2,4,207,1,215,"2022"
"68923","290410 BOQUIRA",1,1,2,217,0,221,"2022"
"68924","290420 BOTUPORA",0,2,3,123,0,128,"2022"
"68925","290430 BREJOES",1,0,5,125,0,131,"2022"
"68926","290440 BREJOLANDIA",1,2,1,86,0,90,"2022"
"68927","290450 BROTAS DE MACAUBAS",1,2,4,101,1,109,"2022"
"68928","290460 BRUMADO",3,6,15,867,2,893,"2022"
"68929","290470 BUERAREMA",0,1,3,196,1,201,"2022"
"68930","290475 BURITIRAMA",2,4,7,255,0,268,"2022"
"68931","290480 CAATIBA",0,0,1,55,1,57,"2022"
"68932","290485 CABACEIRAS DO PARAGUACU",2,0,4,199,10,215,"2022"
"68933","290490 CACHOEIRA",3,1,5,196,126,331,"2022"
"68934","290500 CACULE",1,1,10,263,2,277,"2022"
"68935","290510 CAEM",1,0,3,100,1,105,"2022"
"68936","290515 CAETANOS",0,1,2,117,1,121,"2022"
"68937","290520 CAETITE",1,3,13,604,13,634,"2022"
"68938","290530 CAFARNAUM",0,0,8,263,0,271,"2022"
"68939","290540 CAIRU",1,2,10,261,1,275,"2022"
"68940","290550 CALDEIRAO GRANDE",0,1,3,130,0,134,"2022"
"68941","290560 CAMACAN",1,2,3,306,6,318,"2022"
"68942","290570 CAMACARI",6,15,76,3712,39,3848,"2022"
"68943","290580 CAMAMU",1,3,4,469,7,484,"2022"
"68944","290590 CAMPO ALEGRE DE LOURDES",1,3,4,457,7,472,"2022"
"68945","290600 CAMPO FORMOSO",2,6,30,978,24,1040,"2022"
"68946","290610 CANAPOLIS",0,1,1,125,0,127,"2022"
"68947","290620 CANARANA",4,5,7,311,1,328,"2022"
"68948","290630 CANAVIEIRAS",0,2,5,363,6,376,"2022"
"68949","290640 CANDEAL",0,0,0,92,1,93,"2022"
"68950","290650 CANDEIAS",7,5,16,825,5,858,"2022"
"68951","290660 CANDIBA",0,0,2,140,0,142,"2022"
"68952","290670 CANDIDO SALES",1,3,1,296,3,304,"2022"
"68953","290680 CANSANCAO",1,2,7,439,1,450,"2022"
"68954","290682 CANUDOS",0,1,6,166,4,177,"2022"
"68955","290685 CAPELA DO ALTO ALEGRE",0,0,2,108,0,110,"2022"
"68956","290687 CAPIM GROSSO",0,1,9,407,1,418,"2022"
"68957","290689 CARAIBAS",0,0,2,89,2,93,"2022"
"68958","290690 CARAVELAS",0,2,6,240,4,252,"2022"
"68959","290700 CARDEAL DA SILVA",0,1,2,109,0,112,"2022"
"68960","290710 CARINHANHA",2,3,9,411,3,428,"2022"
"68961","290720 CASA NOVA",2,9,14,942,5,972,"2022"
"68962","290730 CASTRO ALVES",0,0,1,291,0,292,"2022"
"68963","290740 CATOLANDIA",0,1,2,49,0,52,"2022"
"68964","290750 CATU",2,4,3,420,3,432,"2022"
"68965","290755 CATURAMA",0,0,1,79,0,80,"2022"
"68966","290760 CENTRAL",0,2,3,182,0,187,"2022"
"68967","290770 CHORROCHO",0,0,6,119,0,125,"2022"
"68968","290780 CICERO DANTAS",0,2,3,278,6,289,"2022"
"68969","290790 CIPO",0,0,3,230,5,238,"2022"
"68970","290800 COARACI",0,0,6,179,1,186,"2022"
"68971","290810 COCOS",0,1,5,180,61,247,"2022"
"68972","290820 CONCEICAO DA FEIRA",1,1,2,138,66,208,"2022"
"68973","290830 CONCEICAO DO ALMEIDA",2,1,1,151,5,160,"2022"
"68974","290840 CONCEICAO DO COITE",0,5,8,827,0,840,"2022"
"68975","290850 CONCEICAO DO JACUIPE",2,2,7,344,2,357,"2022"
"68976","290860 CONDE",0,4,3,283,6,296,"2022"
"68977","290870 CONDEUBA",0,1,1,168,0,170,"2022"
"68978","290880 CONTENDAS DO SINCORA",0,0,2,39,1,42,"2022"
"68979","290890 CORACAO DE MARIA",2,0,5,217,1,225,"2022"
"68980","290900 CORDEIROS",0,0,2,80,0,82,"2022"
"68981","290910 CORIBE",0,2,1,141,0,144,"2022"
"68982","290920 CORONEL JOAO SA",0,0,3,162,3,168,"2022"
"68983","290930 CORRENTINA",0,1,2,76,392,471,"2022"
"68984","290940 COTEGIPE",1,0,1,160,0,162,"2022"
"68985","290950 CRAVOLANDIA",1,1,1,43,0,46,"2022"
"68986","290960 CRISOPOLIS",0,4,7,223,3,237,"2022"
"68987","290970 CRISTOPOLIS",1,3,3,143,1,151,"2022"
"68988","290980 CRUZ DAS ALMAS",4,2,11,683,5,705,"2022"
"68989","290990 CURACA",1,3,11,490,6,511,"2022"
"68990","291000 DARIO MEIRA",0,0,0,124,1,125,"2022"
"68991","291005 DIAS D'AVILA",3,3,21,866,1,894,"2022"
"68992","291010 DOM BASILIO",0,0,1,106,0,107,"2022"
"68993","291020 DOM MACEDO COSTA",0,0,0,45,1,46,"2022"
"68994","291030 ELISIO MEDRADO",0,0,2,68,0,70,"2022"
"68995","291040 ENCRUZILHADA",0,4,8,222,0,234,"2022"
"68996","291050 ENTRE RIOS",0,0,7,469,0,476,"2022"
"68997","291060 ESPLANADA",0,3,10,416,3,432,"2022"
"68998","291070 EUCLIDES DA CUNHA",1,5,21,708,12,747,"2022"
"68999","291072 EUNAPOLIS",2,12,23,1574,10,1621,"2022"
"69000","291075 FATIMA",0,0,3,187,0,190,"2022"
"69001","291077 FEIRA DA MATA",1,0,0,48,9,58,"2022"
"69002","291080 FEIRA DE SANTANA",31,40,132,8451,33,8687,"2022"
"69003","291085 FILADELFIA",1,6,10,229,0,246,"2022"
"69004","291090 FIRMINO ALVES",0,1,0,32,0,33,"2022"
"69005","291100 FLORESTA AZUL",2,1,2,59,3,67,"2022"
"69006","291110 FORMOSA DO RIO PRETO",1,2,7,387,11,408,"2022"
"69007","291120 GANDU",2,1,11,392,1,407,"2022"
"69008","291125 GAVIAO",0,0,0,30,0,30,"2022"
"69009","291130 GENTIO DO OURO",0,0,2,94,0,96,"2022"
"69010","291140 GLORIA",2,2,8,178,2,192,"2022"
"69011","291150 GONGOGI",0,0,0,79,2,81,"2022"
"69012","291160 GOVERNADOR MANGABEIRA",3,4,5,237,23,272,"2022"
"69013","291165 GUAJERU",0,0,1,76,0,77,"2022"
"69014","291170 GUANAMBI",6,2,19,1145,20,1192,"2022"
"69015","291180 GUARATINGA",1,0,3,171,0,175,"2022"
"69016","291185 HELIOPOLIS",1,0,0,121,5,127,"2022"
"69017","291190 IACU",3,1,2,310,2,318,"2022"
"69018","291200 IBIASSUCE",0,0,1,100,1,102,"2022"
"69019","291210 IBICARAI",1,3,3,215,2,224,"2022"
"69020","291220 IBICOARA",0,2,10,299,5,316,"2022"
"69021","291230 IBICUI",0,1,6,100,1,108,"2022"
"69022","291240 IBIPEBA",0,3,6,162,0,171,"2022"
"69023","291250 IBIPITANGA",0,0,2,107,4,113,"2022"
"69024","291260 IBIQUERA",0,0,0,41,0,41,"2022"
"69025","291270 IBIRAPITANGA",1,2,7,285,0,295,"2022"
"69026","291280 IBIRAPUA",0,1,3,118,2,124,"2022"
"69027","291290 IBIRATAIA",1,0,7,260,0,268,"2022"
"69028","291300 IBITIARA",0,0,2,123,1,126,"2022"
"69029","291310 IBITITA",1,1,2,174,0,178,"2022"
"69030","291320 IBOTIRAMA",1,4,7,385,1,398,"2022"
"69031","291330 ICHU",1,0,1,54,0,56,"2022"
"69032","291340 IGAPORA",0,0,3,151,5,159,"2022"
"69033","291345 IGRAPIUNA",1,2,7,135,3,148,"2022"
"69034","291350 IGUAI",2,0,5,276,0,283,"2022"
"69035","291360 ILHEUS",2,10,28,1919,71,2030,"2022"
"69036","291370 INHAMBUPE",1,1,6,397,1,406,"2022"
"69037","291380 IPECAETA",0,0,1,128,3,132,"2022"
"69038","291390 IPIAU",2,3,9,562,0,576,"2022"
"69039","291400 IPIRA",3,2,12,639,1,657,"2022"
"69040","291410 IPUPIARA",0,0,0,48,0,48,"2022"
"69041","291420 IRAJUBA",0,2,3,55,0,60,"2022"
"69042","291430 IRAMAIA",1,0,1,100,1,103,"2022"
"69043","291440 IRAQUARA",0,2,3,347,0,352,"2022"
"69044","291450 IRARA",0,1,5,237,1,244,"2022"
"69045","291460 IRECE",4,7,8,1084,0,1103,"2022"
"69046","291465 ITABELA",1,2,4,475,1,483,"2022"
"69047","291470 ITABERABA",4,0,4,768,0,776,"2022"
"69048","291480 ITABUNA",9,14,60,2130,14,2227,"2022"
"69049","291490 ITACARE",1,4,9,323,11,348,"2022"
"69050","291500 ITAETE",1,1,2,185,1,190,"2022"
"69051","291510 ITAGI",0,1,2,136,3,142,"2022"
"69052","291520 ITAGIBA",0,1,0,175,0,176,"2022"
"69053","291530 ITAGIMIRIM",0,1,3,66,1,71,"2022"
"69054","291535 ITAGUACU DA BAHIA",0,1,1,161,1,164,"2022"
"69055","291540 ITAJU DO COLONIA",0,2,9,53,2,66,"2022"
"69056","291550 ITAJUIPE",2,1,2,201,1,207,"2022"
"69057","291560 ITAMARAJU",0,4,11,888,6,909,"2022"
"69058","291570 ITAMARI",0,0,0,107,8,115,"2022"
"69059","291580 ITAMBE",0,0,3,250,0,253,"2022"
"69060","291590 ITANAGRA",1,0,0,85,4,90,"2022"
"69061","291600 ITANHEM",2,0,6,170,2,180,"2022"
"69062","291610 ITAPARICA",2,3,2,246,0,253,"2022"
"69063","291620 ITAPE",1,0,0,98,2,101,"2022"
"69064","291630 ITAPEBI",0,2,2,112,0,116,"2022"
"69065","291640 ITAPETINGA",1,5,9,813,7,835,"2022"
"69066","291650 ITAPICURU",1,3,5,295,8,312,"2022"
"69067","291660 ITAPITANGA",0,1,2,66,0,69,"2022"
"69068","291670 ITAQUARA",0,0,2,77,1,80,"2022"
"69069","291680 ITARANTIM",0,2,4,146,4,156,"2022"
"69070","291685 ITATIM",2,0,4,175,0,181,"2022"
"69071","291690 ITIRUCU",1,0,0,116,1,118,"2022"
"69072","291700 ITIUBA",0,1,15,392,7,415,"2022"
"69073","291710 ITORORO",0,1,10,152,3,166,"2022"
"69074","291720 ITUACU",0,2,6,222,2,232,"2022"
"69075","291730 ITUBERA",1,2,3,240,3,249,"2022"
"69076","291733 IUIU",1,0,7,106,2,116,"2022"
"69077","291735 JABORANDI",0,0,1,168,0,169,"2022"
"69078","291740 JACARACI",1,0,3,126,1,131,"2022"
"69079","291750 JACOBINA",4,5,13,1167,2,1191,"2022"
"69080","291760 JAGUAQUARA",1,2,6,643,0,652,"2022"
"69081","291770 JAGUARARI",1,2,7,393,0,403,"2022"
"69082","291780 JAGUARIPE",0,0,7,165,0,172,"2022"
"69083","291790 JANDAIRA",0,0,0,110,5,115,"2022"
"69084","291800 JEQUIE",6,6,19,1977,15,2023,"2022"
"69085","291810 JEREMOABO",0,3,13,444,3,463,"2022"
"69086","291820 JIQUIRICA",1,1,5,122,1,130,"2022"
"69087","291830 JITAUNA",3,0,1,141,4,149,"2022"
"69088","291835 JOAO DOURADO",0,1,7,371,1,380,"2022"
"69089","291840 JUAZEIRO",15,15,60,3708,56,3854,"2022"
"69090","291845 JUCURUCU",0,0,0,96,3,99,"2022"
"69091","291850 JUSSARA",1,0,5,183,0,189,"2022"
"69092","291855 JUSSARI",0,0,1,46,1,48,"2022"
"69093","291860 JUSSIAPE",0,0,2,60,0,62,"2022"
"69094","291870 LAFAIETE COUTINHO",0,0,0,35,1,36,"2022"
"69095","291875 LAGOA REAL",0,0,1,109,1,111,"2022"
"69096","291880 LAJE",1,2,8,223,1,235,"2022"
"69097","291890 LAJEDAO",0,0,0,38,0,38,"2022"
"69098","291900 LAJEDINHO",0,0,0,32,0,32,"2022"
"69099","291905 LAJEDO DO TABOCAL",0,0,0,62,1,63,"2022"
"69100","291910 LAMARAO",0,0,4,78,0,82,"2022"
"69101","291915 LAPAO",0,0,4,368,0,372,"2022"
"69102","291920 LAURO DE FREITAS",14,13,45,2467,36,2575,"2022"
"69103","291930 LENCOIS",4,0,3,96,0,103,"2022"
"69104","291940 LICINIO DE ALMEIDA",1,0,4,120,2,127,"2022"
"69105","291950 LIVRAMENTO DE NOSSA SENHORA",1,1,6,492,1,501,"2022"
"69106","291955 LUIS EDUARDO MAGALHAES",6,11,48,2043,6,2114,"2022"
"69107","291960 MACAJUBA",0,0,1,119,0,120,"2022"
"69108","291970 MACARANI",0,0,2,144,0,146,"2022"
"69109","291980 MACAUBAS",4,3,3,455,2,467,"2022"
"69110","291990 MACURURE",0,1,3,89,0,93,"2022"
"69111","291992 MADRE DE DEUS",0,1,2,176,1,180,"2022"
"69112","291995 MAETINGA",0,1,2,55,1,59,"2022"
"69113","292000 MAIQUINIQUE",1,1,3,103,1,109,"2022"
"69114","292010 MAIRI",0,0,4,144,0,148,"2022"
"69115","292020 MALHADA",1,0,3,216,10,230,"2022"
"69116","292030 MALHADA DE PEDRAS",1,0,1,90,1,93,"2022"
"69117","292040 MANOEL VITORINO",1,2,0,133,2,138,"2022"
"69118","292045 MANSIDAO",0,2,0,74,0,76,"2022"
"69119","292050 MARACAS",2,0,5,294,1,302,"2022"
"69120","292060 MARAGOGIPE",2,3,5,226,168,404,"2022"
"69121","292070 MARAU",0,1,1,247,8,257,"2022"
"69122","292080 MARCIONILIO SOUZA",1,0,2,109,0,112,"2022"
"69123","292090 MASCOTE",1,3,4,114,3,125,"2022"
"69124","292100 MATA DE SAO JOAO",2,2,16,625,4,649,"2022"
"69125","292105 MATINA",1,0,2,104,0,107,"2022"
"69126","292110 MEDEIROS NETO",0,1,9,278,0,288,"2022"
"69127","292120 MIGUEL CALMON",5,4,6,290,1,306,"2022"
"69128","292130 MILAGRES",0,0,2,133,1,136,"2022"
"69129","292140 MIRANGABA",2,1,2,150,0,155,"2022"
"69130","292145 MIRANTE",1,0,5,94,0,100,"2022"
"69131","292150 MONTE SANTO",6,4,5,585,3,603,"2022"
"69132","292160 MORPARA",2,1,1,98,0,102,"2022"
"69133","292170 MORRO DO CHAPEU",0,0,7,384,1,392,"2022"
"69134","292180 MORTUGABA",0,1,3,113,0,117,"2022"
"69135","292190 MUCUGE",0,1,1,172,0,174,"2022"
"69136","292200 MUCURI",0,1,8,557,2,568,"2022"
"69137","292205 MULUNGU DO MORRO",0,1,4,188,0,193,"2022"
"69138","292210 MUNDO NOVO",0,0,1,152,2,155,"2022"
"69139","292220 MUNIZ FERREIRA",0,1,2,63,1,67,"2022"
"69140","292225 MUQUEM DE SAO FRANCISCO",0,2,2,156,2,162,"2022"
"69141","292230 MURITIBA",2,0,4,257,46,309,"2022"
"69142","292240 MUTUIPE",2,1,4,237,2,246,"2022"
"69143","292250 NAZARE",1,4,6,229,0,240,"2022"
"69144","292260 NILO PECANHA",0,3,14,141,1,159,"2022"
"69145","292265 NORDESTINA",1,0,5,151,0,157,"2022"
"69146","292270 NOVA CANAA",0,1,5,119,1,126,"2022"
"69147","292273 NOVA FATIMA",0,0,2,73,0,75,"2022"
"69148","292275 NOVA IBIA",0,0,0,33,0,33,"2022"
"69149","292280 NOVA ITARANA",1,1,1,82,1,86,"2022"
"69150","292285 NOVA REDENCAO",0,1,0,82,1,84,"2022"
"69151","292290 NOVA SOURE",4,2,5,290,7,308,"2022"
"69152","292300 NOVA VICOSA",2,1,17,499,0,519,"2022"
"69153","292303 NOVO HORIZONTE",1,0,4,128,3,136,"2022"
"69154","292305 NOVO TRIUNFO",0,0,0,104,0,104,"2022"
"69155","292310 OLINDINA",0,0,4,233,7,244,"2022"
"69156","292320 OLIVEIRA DOS BREJINHOS",1,0,8,242,0,251,"2022"
"69157","292330 OURICANGAS",0,0,0,68,2,70,"2022"
"69158","292335 OUROLANDIA",0,0,4,215,0,219,"2022"
"69159","292340 PALMAS DE MONTE ALTO",1,0,3,208,3,215,"2022"
"69160","292350 PALMEIRAS",0,1,4,109,14,128,"2022"
"69161","292360 PARAMIRIM",2,1,2,213,0,218,"2022"
"69162","292370 PARATINGA",0,2,10,364,3,379,"2022"
"69163","292380 PARIPIRANGA",2,0,2,265,2,271,"2022"
"69164","292390 PAU BRASIL",4,0,4,132,2,142,"2022"
"69165","292400 PAULO AFONSO",2,11,38,1473,3,1527,"2022"
"69166","292405 PE DE SERRA",0,0,0,153,0,153,"2022"
"69167","292410 PEDRAO",0,0,0,63,3,66,"2022"
"69168","292420 PEDRO ALEXANDRE",0,0,0,187,0,187,"2022"
"69169","292430 PIATA",1,3,4,271,0,279,"2022"
"69170","292440 PILAO ARCADO",3,0,7,505,6,521,"2022"
"69171","292450 PINDAI",2,1,2,194,1,200,"2022"
"69172","292460 PINDOBACU",2,2,4,245,0,253,"2022"
"69173","292465 PINTADAS",0,0,0,79,3,82,"2022"
"69174","292467 PIRAI DO NORTE",0,0,4,89,0,93,"2022"
"69175","292470 PIRIPA",0,0,4,85,0,89,"2022"
"69176","292480 PIRITIBA",0,0,2,167,3,172,"2022"
"69177","292490 PLANALTINO",0,0,2,57,1,60,"2022"
"69178","292500 PLANALTO",0,1,5,278,3,287,"2022"
"69179","292510 POCOES",2,3,8,549,0,562,"2022"
"69180","292520 POJUCA",0,3,3,368,0,374,"2022"
"69181","292525 PONTO NOVO",1,3,7,243,1,255,"2022"
"69182","292530 PORTO SEGURO",11,11,47,2656,50,2775,"2022"
"69183","292540 POTIRAGUA",0,1,4,94,3,102,"2022"
"69184","292550 PRADO",2,2,6,521,4,535,"2022"
"69185","292560 PRESIDENTE DUTRA",1,0,5,154,0,160,"2022"
"69186","292570 PRESIDENTE JANIO QUADROS",1,1,3,114,2,121,"2022"
"69187","292575 PRESIDENTE TANCREDO NEVES",0,2,8,359,10,379,"2022"
"69188","292580 QUEIMADAS",1,2,5,247,0,255,"2022"
"69189","292590 QUIJINGUE",4,1,8,284,12,309,"2022"
"69190","292593 QUIXABEIRA",0,0,1,80,0,81,"2022"
"69191","292595 RAFAEL JAMBEIRO",0,1,7,189,6,203,"2022"
"69192","292600 REMANSO",1,2,0,526,7,536,"2022"
"69193","292610 RETIROLANDIA",0,2,4,194,1,201,"2022"
"69194","292620 RIACHAO DAS NEVES",3,4,5,247,4,263,"2022"
"69195","292630 RIACHAO DO JACUIPE",2,0,5,386,0,393,"2022"
"69196","292640 RIACHO DE SANTANA",0,2,4,279,6,291,"2022"
"69197","292650 RIBEIRA DO AMPARO",0,1,1,142,3,147,"2022"
"69198","292660 RIBEIRA DO POMBAL",2,3,10,702,36,753,"2022"
"69199","292665 RIBEIRAO DO LARGO",0,0,2,103,0,105,"2022"
"69200","292670 RIO DE CONTAS",0,0,3,112,3,118,"2022"
"69201","292680 RIO DO ANTONIO",0,1,4,135,1,141,"2022"
"69202","292690 RIO DO PIRES",0,0,1,70,0,71,"2022"
"69203","292700 RIO REAL",1,3,10,423,1,438,"2022"
"69204","292710 RODELAS",0,0,3,146,2,151,"2022"
"69205","292720 RUY BARBOSA",0,0,10,331,2,343,"2022"
"69206","292730 SALINAS DA MARGARIDA",3,2,1,170,0,176,"2022"
"69207","292740 SALVADOR",144,145,472,26152,254,27167,"2022"
"69208","292750 SANTA BARBARA",0,1,2,186,0,189,"2022"
"69209","292760 SANTA BRIGIDA",1,0,11,188,1,201,"2022"
"69210","292770 SANTA CRUZ CABRALIA",2,2,8,417,2,431,"2022"
"69211","292780 SANTA CRUZ DA VITORIA",1,0,0,62,1,64,"2022"
"69212","292790 SANTA INES",0,0,0,100,1,101,"2022"
"69213","292800 SANTALUZ",3,2,11,481,1,498,"2022"
"69214","292805 SANTA LUZIA",0,2,0,126,7,135,"2022"
"69215","292810 SANTA MARIA DA VITORIA",3,5,3,460,3,474,"2022"
"69216","292820 SANTANA",0,2,3,265,2,272,"2022"
"69217","292830 SANTANOPOLIS",0,0,5,57,0,62,"2022"
"69218","292840 SANTA RITA DE CASSIA",3,3,8,324,1,339,"2022"
"69219","292850 SANTA TERESINHA",1,0,4,125,1,131,"2022"
"69220","292860 SANTO AMARO",3,1,12,514,5,535,"2022"
"69221","292870 SANTO ANTONIO DE JESUS",10,10,37,1175,1,1233,"2022"
"69222","292880 SANTO ESTEVAO",4,3,9,617,9,642,"2022"
"69223","292890 SAO DESIDERIO",1,1,6,574,1,583,"2022"
"69224","292895 SAO DOMINGOS",1,0,1,92,0,94,"2022"
"69225","292900 SAO FELIX",0,0,0,29,94,123,"2022"
"69226","292905 SAO FELIX DO CORIBE",1,2,7,213,13,236,"2022"
"69227","292910 SAO FELIPE",2,1,9,158,4,174,"2022"
"69228","292920 SAO FRANCISCO DO CONDE",4,0,6,421,0,431,"2022"
"69229","292925 SAO GABRIEL",0,3,3,211,1,218,"2022"
"69230","292930 SAO GONCALO DOS CAMPOS",0,0,4,320,2,326,"2022"
"69231","292935 SAO JOSE DA VITORIA",0,1,6,66,0,73,"2022"
"69232","292937 SAO JOSE DO JACUIPE",0,1,0,109,0,110,"2022"
"69233","292940 SAO MIGUEL DAS MATAS",1,0,1,82,0,84,"2022"
"69234","292950 SAO SEBASTIAO DO PASSE",3,1,10,354,6,374,"2022"
"69235","292960 SAPEACU",0,1,1,204,3,209,"2022"
"69236","292970 SATIRO DIAS",1,1,2,197,7,208,"2022"
"69237","292975 SAUBARA",3,0,1,88,0,92,"2022"
"69238","292980 SAUDE",0,2,1,82,1,86,"2022"
"69239","292990 SEABRA",7,1,12,663,2,685,"2022"
"69240","293000 SEBASTIAO LARANJEIRAS",0,1,1,83,1,86,"2022"
"69241","293010 SENHOR DO BONFIM",5,10,18,927,1,961,"2022"
"69242","293015 SERRA DO RAMALHO",0,5,6,529,2,542,"2022"
"69243","293020 SENTO SE",2,1,7,449,6,465,"2022"
"69244","293030 SERRA DOURADA",0,1,6,190,8,205,"2022"
"69245","293040 SERRA PRETA",1,0,1,78,6,86,"2022"
"69246","293050 SERRINHA",3,10,63,984,0,1060,"2022"
"69247","293060 SERROLANDIA",0,2,3,130,0,135,"2022"
"69248","293070 SIMOES FILHO",8,8,28,1385,16,1445,"2022"
"69249","293075 SITIO DO MATO",0,1,3,188,4,196,"2022"
"69250","293076 SITIO DO QUINTO",0,0,1,105,0,106,"2022"
"69251","293077 SOBRADINHO",1,3,6,387,2,399,"2022"
"69252","293080 SOUTO SOARES",2,1,5,203,0,211,"2022"
"69253","293090 TABOCAS DO BREJO VELHO",0,1,2,139,0,142,"2022"
"69254","293100 TANHACU",1,2,6,225,1,235,"2022"
"69255","293105 TANQUE NOVO",1,2,3,238,1,245,"2022"
"69256","293110 TANQUINHO",0,0,0,61,0,61,"2022"
"69257","293120 TAPEROA",0,1,4,240,1,246,"2022"
"69258","293130 TAPIRAMUTA",0,0,3,134,0,137,"2022"
"69259","293135 TEIXEIRA DE FREITAS",6,10,31,2294,11,2352,"2022"
"69260","293140 TEODORO SAMPAIO",0,0,1,49,1,51,"2022"
"69261","293150 TEOFILANDIA",0,0,8,170,2,180,"2022"
"69262","293160 TEOLANDIA",0,1,2,144,6,153,"2022"
"69263","293170 TERRA NOVA",3,0,2,86,0,91,"2022"
"69264","293180 TREMEDAL",1,1,4,153,2,161,"2022"
"69265","293190 TUCANO",5,2,7,532,3,549,"2022"
"69266","293200 UAUA",0,0,11,232,9,252,"2022"
"69267","293210 UBAIRA",1,1,9,203,1,215,"2022"
"69268","293220 UBAITABA",1,5,8,227,1,242,"2022"
"69269","293230 UBATA",0,0,4,164,1,169,"2022"
"69270","293240 UIBAI",0,2,0,140,0,142,"2022"
"69271","293245 UMBURANAS",0,3,1,125,0,129,"2022"
"69272","293250 UNA",1,3,1,190,1,196,"2022"
"69273","293260 URANDI",1,3,3,155,3,165,"2022"
"69274","293270 URUCUCA",1,3,3,251,15,273,"2022"
"69275","293280 UTINGA",1,0,0,199,0,200,"2022"
"69276","293290 VALENCA",3,11,55,1119,2,1190,"2022"
"69277","293300 VALENTE",1,1,6,258,0,266,"2022"
"69278","293305 VARZEA DA ROCA",0,1,0,119,0,120,"2022"
"69279","293310 VARZEA DO POCO",1,0,0,80,0,81,"2022"
"69280","293315 VARZEA NOVA",1,3,1,174,0,179,"2022"
"69281","293317 VARZEDO",0,0,4,92,1,97,"2022"
"69282","293320 VERA CRUZ",0,2,5,480,2,489,"2022"
"69283","293325 VEREDA",0,0,3,80,0,83,"2022"
"69284","293330 VITORIA DA CONQUISTA",19,20,93,4709,42,4883,"2022"
"69285","293340 WAGNER",0,1,0,86,3,90,"2022"
"69286","293345 WANDERLEY",1,0,2,149,2,154,"2022"
"69287","293350 WENCESLAU GUIMARAES",3,1,5,256,6,271,"2022"
"69288","293360 XIQUE-XIQUE",5,2,15,768,15,805,"2022"
"69289","MUNICIPIO IGNORADO - MG",0,0,0,1,1,2,"2022"
"69290","310010 ABADIA DOS DOURADOS",1,0,1,52,0,54,"2022"
"69291","310020 ABAETE",1,0,1,207,0,209,"2022"
"69292","310030 ABRE CAMPO",0,1,1,154,32,188,"2022"
"69293","310040 ACAIACA",0,0,0,45,0,45,"2022"
"69294","310050 ACUCENA",0,1,0,92,1,94,"2022"
"69295","310060 AGUA BOA",1,0,1,141,0,143,"2022"
"69296","310070 AGUA COMPRIDA",0,0,0,15,0,15,"2022"
"69297","310080 AGUANIL",0,0,0,55,0,55,"2022"
"69298","310090 AGUAS FORMOSAS",0,2,1,253,1,257,"2022"
"69299","310100 AGUAS VERMELHAS",0,1,0,161,5,167,"2022"
"69300","310110 AIMORES",1,2,7,323,1,334,"2022"
"69301","310120 AIURUOCA",0,0,2,51,0,53,"2022"
"69302","310130 ALAGOA",0,1,0,21,0,22,"2022"
"69303","310140 ALBERTINA",0,0,0,26,0,26,"2022"
"69304","310150 ALEM PARAIBA",2,2,4,315,0,323,"2022"
"69305","310160 ALFENAS",2,4,15,894,7,922,"2022"
"69306","310163 ALFREDO VASCONCELOS",0,0,2,58,0,60,"2022"
"69307","310170 ALMENARA",6,4,5,496,3,514,"2022"
"69308","310180 ALPERCATA",0,0,3,80,1,84,"2022"
"69309","310190 ALPINOPOLIS",0,2,0,210,0,212,"2022"
"69310","310200 ALTEROSA",0,1,2,152,0,155,"2022"
"69311","310205 ALTO CAPARAO",0,1,0,77,9,87,"2022"
"69312","310210 ALTO RIO DOCE",0,1,0,93,3,97,"2022"
"69313","310220 ALVARENGA",0,1,0,48,0,49,"2022"
"69314","310230 ALVINOPOLIS",1,0,1,122,1,125,"2022"
"69315","310240 ALVORADA DE MINAS",0,1,1,59,0,61,"2022"
"69316","310250 AMPARO DO SERRA",0,0,0,59,0,59,"2022"
"69317","310260 ANDRADAS",3,0,3,442,1,449,"2022"
"69318","310270 CACHOEIRA DE PAJEU",0,0,2,81,4,87,"2022"
"69319","310280 ANDRELANDIA",0,0,1,123,0,124,"2022"
"69320","310285 ANGELANDIA",0,0,5,88,2,95,"2022"
"69321","310290 ANTONIO CARLOS",0,0,1,109,1,111,"2022"
"69322","310300 ANTONIO DIAS",0,0,1,82,1,84,"2022"
"69323","310310 ANTONIO PRADO DE MINAS",0,0,0,9,0,9,"2022"
"69324","310320 ARACAI",0,1,0,22,0,23,"2022"
"69325","310330 ARACITABA",0,0,0,15,1,16,"2022"
"69326","310340 ARACUAI",0,1,4,315,3,323,"2022"
"69327","310350 ARAGUARI",5,3,8,1249,13,1278,"2022"
"69328","310360 ARANTINA",0,1,1,23,0,25,"2022"
"69329","310370 ARAPONGA",0,0,1,115,2,118,"2022"
"69330","310375 ARAPORA",2,1,3,115,0,121,"2022"
"69331","310380 ARAPUA",0,0,1,21,0,22,"2022"
"69332","310390 ARAUJOS",0,1,4,133,0,138,"2022"
"69333","310400 ARAXA",6,3,14,1352,3,1378,"2022"
"69334","310410 ARCEBURGO",0,1,0,77,0,78,"2022"
"69335","310420 ARCOS",0,2,9,474,0,485,"2022"
"69336","310430 AREADO",1,2,1,140,0,144,"2022"
"69337","310440 ARGIRITA",0,0,0,29,0,29,"2022"
"69338","310445 ARICANDUVA",0,0,0,60,0,60,"2022"
"69339","310450 ARINOS",0,0,0,206,1,207,"2022"
"69340","310460 ASTOLFO DUTRA",0,3,1,99,1,104,"2022"
"69341","310470 ATALEIA",0,0,1,129,10,140,"2022"
"69342","310480 AUGUSTO DE LIMA",0,0,0,45,0,45,"2022"
"69343","310490 BAEPENDI",1,0,1,189,0,191,"2022"
"69344","310500 BALDIM",1,0,0,71,0,72,"2022"
"69345","310510 BAMBUI",2,1,1,238,0,242,"2022"
"69346","310520 BANDEIRA",0,1,1,41,0,43,"2022"
"69347","310530 BANDEIRA DO SUL",0,0,0,73,0,73,"2022"
"69348","310540 BARAO DE COCAIS",1,2,3,364,2,372,"2022"
"69349","310550 BARAO DE MONTE ALTO",0,0,1,36,0,37,"2022"
"69350","310560 BARBACENA",3,3,8,1210,10,1234,"2022"
"69351","310570 BARRA LONGA",0,0,1,56,1,58,"2022"
"69352","310590 BARROSO",0,1,2,245,1,249,"2022"
"69353","310600 BELA VISTA DE MINAS",2,0,0,93,0,95,"2022"
"69354","310610 BELMIRO BRAGA",0,0,0,20,0,20,"2022"
"69355","310620 BELO HORIZONTE",78,109,409,23065,98,23759,"2022"
"69356","310630 BELO ORIENTE",0,0,3,310,1,314,"2022"
"69357","310640 BELO VALE",1,0,0,94,1,96,"2022"
"69358","310650 BERILO",0,1,2,57,0,60,"2022"
"69359","310660 BERTOPOLIS",0,1,0,66,18,85,"2022"
"69360","310665 BERIZAL",0,0,1,47,1,49,"2022"
"69361","310670 BETIM",52,24,112,5231,23,5442,"2022"
"69362","310680 BIAS FORTES",0,0,0,28,0,28,"2022"
"69363","310690 BICAS",0,0,0,133,0,133,"2022"
"69364","310700 BIQUINHAS",0,0,0,16,0,16,"2022"
"69365","310710 BOA ESPERANCA",0,2,3,482,2,489,"2022"
"69366","310720 BOCAINA DE MINAS",0,0,0,15,0,15,"2022"
"69367","310730 BOCAIUVA",3,4,10,601,3,621,"2022"
"69368","310740 BOM DESPACHO",2,3,19,602,0,626,"2022"
"69369","310750 BOM JARDIM DE MINAS",0,0,2,59,1,62,"2022"
"69370","310760 BOM JESUS DA PENHA",0,2,0,57,0,59,"2022"
"69371","310770 BOM JESUS DO AMPARO",3,0,0,55,0,58,"2022"
"69372","310780 BOM JESUS DO GALHO",0,1,2,147,3,153,"2022"
"69373","310790 BOM REPOUSO",0,1,2,152,1,156,"2022"
"69374","310800 BOM SUCESSO",0,0,2,140,1,143,"2022"
"69375","310810 BONFIM",0,0,2,44,0,46,"2022"
"69376","310820 BONFINOPOLIS DE MINAS",0,0,1,39,0,40,"2022"
"69377","310825 BONITO DE MINAS",0,0,1,123,26,150,"2022"
"69378","310830 BORDA DA MATA",0,0,1,142,1,144,"2022"
"69379","310840 BOTELHOS",1,2,1,135,2,141,"2022"
"69380","310850 BOTUMIRIM",0,0,3,51,0,54,"2022"
"69381","310855 BRASILANDIA DE MINAS",2,2,3,223,0,230,"2022"
"69382","310860 BRASILIA DE MINAS",0,0,4,463,0,467,"2022"
"69383","310870 BRAS PIRES",0,0,1,45,0,46,"2022"
"69384","310880 BRAUNAS",0,0,2,34,1,37,"2022"
"69385","310890 BRAZOPOLIS",0,2,0,138,1,141,"2022"
"69386","310900 BRUMADINHO",1,0,12,464,0,477,"2022"
"69387","310910 BUENO BRANDAO",0,0,2,92,2,96,"2022"
"69388","310920 BUENOPOLIS",1,1,2,89,0,93,"2022"
"69389","310925 BUGRE",0,0,1,39,0,40,"2022"
"69390","310930 BURITIS",1,1,6,318,2,328,"2022"
"69391","310940 BURITIZEIRO",0,0,3,339,6,348,"2022"
"69392","310945 CABECEIRA GRANDE",0,0,0,68,0,68,"2022"
"69393","310950 CABO VERDE",0,0,1,102,11,114,"2022"
"69394","310960 CACHOEIRA DA PRATA",0,0,0,31,0,31,"2022"
"69395","310970 CACHOEIRA DE MINAS",0,0,1,104,1,106,"2022"
"69396","310980 CACHOEIRA DOURADA",1,0,0,24,0,25,"2022"
"69397","310990 CAETANOPOLIS",0,0,2,108,0,110,"2022"
"69398","311000 CAETE",0,5,3,414,5,427,"2022"
"69399","311010 CAIANA",1,1,0,62,0,64,"2022"
"69400","311020 CAJURI",0,0,1,45,0,46,"2022"
"69401","311030 CALDAS",0,0,2,114,1,117,"2022"
"69402","311040 CAMACHO",0,0,0,31,0,31,"2022"
"69403","311050 CAMANDUCAIA",1,0,3,299,0,303,"2022"
"69404","311060 CAMBUI",0,1,2,339,2,344,"2022"
"69405","311070 CAMBUQUIRA",0,0,1,129,0,130,"2022"
"69406","311080 CAMPANARIO",0,0,1,32,0,33,"2022"
"69407","311090 CAMPANHA",0,2,0,148,0,150,"2022"
"69408","311100 CAMPESTRE",1,5,4,192,2,204,"2022"
"69409","311110 CAMPINA VERDE",0,0,1,152,5,158,"2022"
"69410","311115 CAMPO AZUL",0,0,1,45,1,47,"2022"
"69411","311120 CAMPO BELO",0,4,9,557,2,572,"2022"
"69412","311130 CAMPO DO MEIO",0,0,2,116,1,119,"2022"
"69413","311140 CAMPO FLORIDO",0,1,1,88,0,90,"2022"
"69414","311150 CAMPOS ALTOS",0,0,2,175,0,177,"2022"
"69415","311160 CAMPOS GERAIS",0,1,2,253,2,258,"2022"
"69416","311170 CANAA",0,0,0,51,1,52,"2022"
"69417","311180 CANAPOLIS",0,0,2,103,4,109,"2022"
"69418","311190 CANA VERDE",0,0,0,51,0,51,"2022"
"69419","311200 CANDEIAS",0,1,2,114,0,117,"2022"
"69420","311205 CANTAGALO",0,0,1,49,0,50,"2022"
"69421","311210 CAPARAO",0,1,0,66,0,67,"2022"
"69422","311220 CAPELA NOVA",0,0,0,36,0,36,"2022"
"69423","311230 CAPELINHA",4,2,4,505,5,520,"2022"
"69424","311240 CAPETINGA",0,0,5,91,0,96,"2022"
"69425","311250 CAPIM BRANCO",1,0,1,93,1,96,"2022"
"69426","311260 CAPINOPOLIS",1,1,4,144,1,151,"2022"
"69427","311265 CAPITAO ANDRADE",0,1,0,49,0,50,"2022"
"69428","311270 CAPITAO ENEAS",2,0,4,197,2,205,"2022"
"69429","311280 CAPITOLIO",2,2,1,125,0,130,"2022"
"69430","311290 CAPUTIRA",0,0,1,113,0,114,"2022"
"69431","311300 CARAI",0,1,0,210,0,211,"2022"
"69432","311310 CARANAIBA",0,0,0,20,0,20,"2022"
"69433","311320 CARANDAI",0,0,3,241,1,245,"2022"
"69434","311330 CARANGOLA",0,1,3,353,0,357,"2022"
"69435","311340 CARATINGA",3,4,8,1095,9,1119,"2022"
"69436","311350 CARBONITA",0,1,1,84,0,86,"2022"
"69437","311360 CAREACU",0,0,2,59,0,61,"2022"
"69438","311370 CARLOS CHAGAS",0,3,7,211,2,223,"2022"
"69439","311380 CARMESIA",0,0,0,39,0,39,"2022"
"69440","311390 CARMO DA CACHOEIRA",0,1,0,141,0,142,"2022"
"69441","311400 CARMO DA MATA",1,0,2,99,0,102,"2022"
"69442","311410 CARMO DE MINAS",0,1,2,150,0,153,"2022"
"69443","311420 CARMO DO CAJURU",0,2,5,274,0,281,"2022"
"69444","311430 CARMO DO PARANAIBA",1,1,1,260,0,263,"2022"
"69445","311440 CARMO DO RIO CLARO",2,0,1,183,0,186,"2022"
"69446","311450 CARMOPOLIS DE MINAS",1,0,0,220,5,226,"2022"
"69447","311455 CARNEIRINHO",1,0,0,71,0,72,"2022"
"69448","311460 CARRANCAS",0,0,0,41,2,43,"2022"
"69449","311470 CARVALHOPOLIS",0,0,0,30,0,30,"2022"
"69450","311480 CARVALHOS",0,0,0,22,0,22,"2022"
"69451","311490 CASA GRANDE",0,0,1,26,0,27,"2022"
"69452","311500 CASCALHO RICO",0,0,0,20,0,20,"2022"
"69453","311510 CASSIA",0,1,8,198,0,207,"2022"
"69454","311520 CONCEICAO DA BARRA DE MINAS",0,0,0,27,0,27,"2022"
"69455","311530 CATAGUASES",2,5,8,612,0,627,"2022"
"69456","311535 CATAS ALTAS",0,0,0,54,0,54,"2022"
"69457","311540 CATAS ALTAS DA NORUEGA",0,0,3,33,0,36,"2022"
"69458","311545 CATUJI",0,0,2,102,1,105,"2022"
"69459","311547 CATUTI",0,0,0,25,35,60,"2022"
"69460","311550 CAXAMBU",0,0,2,187,21,210,"2022"
"69461","311560 CEDRO DO ABAETE",0,0,0,11,0,11,"2022"
"69462","311570 CENTRAL DE MINAS",1,0,2,81,0,84,"2022"
"69463","311580 CENTRALINA",0,0,3,89,3,95,"2022"
"69464","311590 CHACARA",0,0,0,39,0,39,"2022"
"69465","311600 CHALE",0,0,0,85,0,85,"2022"
"69466","311610 CHAPADA DO NORTE",0,0,0,93,0,93,"2022"
"69467","311615 CHAPADA GAUCHA",1,1,4,214,2,222,"2022"
"69468","311620 CHIADOR",0,0,0,30,0,30,"2022"
"69469","311630 CIPOTANEA",1,0,0,54,2,57,"2022"
"69470","311640 CLARAVAL",0,0,0,14,0,14,"2022"
"69471","311650 CLARO DOS POCOES",0,0,0,66,2,68,"2022"
"69472","311660 CLAUDIO",1,2,4,398,3,408,"2022"
"69473","311670 COIMBRA",0,0,0,63,1,64,"2022"
"69474","311680 COLUNA",1,1,1,72,0,75,"2022"
"69475","311690 COMENDADOR GOMES",0,0,0,29,0,29,"2022"
"69476","311700 COMERCINHO",0,0,1,75,1,77,"2022"
"69477","311710 CONCEICAO DA APARECIDA",0,0,0,100,0,100,"2022"
"69478","311720 CONCEICAO DAS PEDRAS",0,0,0,25,0,25,"2022"
"69479","311730 CONCEICAO DAS ALAGOAS",0,1,4,330,2,337,"2022"
"69480","311740 CONCEICAO DE IPANEMA",0,0,0,52,1,53,"2022"
"69481","311750 CONCEICAO DO MATO DENTRO",0,1,4,275,3,283,"2022"
"69482","311760 CONCEICAO DO PARA",0,0,0,48,1,49,"2022"
"69483","311770 CONCEICAO DO RIO VERDE",1,0,2,135,0,138,"2022"
"69484","311780 CONCEICAO DOS OUROS",0,0,0,94,0,94,"2022"
"69485","311783 CONEGO MARINHO",0,0,0,49,9,58,"2022"
"69486","311787 CONFINS",0,0,2,91,1,94,"2022"
"69487","311790 CONGONHAL",0,1,1,134,1,137,"2022"
"69488","311800 CONGONHAS",3,3,6,642,2,656,"2022"
"69489","311810 CONGONHAS DO NORTE",0,0,2,43,0,45,"2022"
"69490","311820 CONQUISTA",1,0,1,61,0,63,"2022"
"69491","311830 CONSELHEIRO LAFAIETE",5,7,20,1522,8,1562,"2022"
"69492","311840 CONSELHEIRO PENA",0,2,1,248,1,252,"2022"
"69493","311850 CONSOLACAO",0,0,0,14,0,14,"2022"
"69494","311860 CONTAGEM",30,31,108,7052,52,7273,"2022"
"69495","311870 COQUEIRAL",0,0,1,86,0,87,"2022"
"69496","311880 CORACAO DE JESUS",0,0,4,264,0,268,"2022"
"69497","311890 CORDISBURGO",0,0,1,59,0,60,"2022"
"69498","311900 CORDISLANDIA",0,0,0,33,0,33,"2022"
"69499","311910 CORINTO",0,1,6,294,2,303,"2022"
"69500","311920 COROACI",0,0,1,64,1,66,"2022"
"69501","311930 COROMANDEL",1,2,2,277,0,282,"2022"
"69502","311940 CORONEL FABRICIANO",4,6,17,1216,8,1251,"2022"
"69503","311950 CORONEL MURTA",0,1,2,81,3,87,"2022"
"69504","311960 CORONEL PACHECO",0,0,0,17,1,18,"2022"
"69505","311970 CORONEL XAVIER CHAVES",0,0,0,27,0,27,"2022"
"69506","311980 CORREGO DANTA",1,0,1,24,0,26,"2022"
"69507","311990 CORREGO DO BOM JESUS",0,0,0,25,0,25,"2022"
"69508","311995 CORREGO FUNDO",0,0,0,64,0,64,"2022"
"69509","312000 CORREGO NOVO",0,0,0,24,1,25,"2022"
"69510","312010 COUTO DE MAGALHAES DE MINAS",1,1,2,33,0,37,"2022"
"69511","312015 CRISOLITA",0,0,1,86,2,89,"2022"
"69512","312020 CRISTAIS",0,0,8,133,0,141,"2022"
"69513","312030 CRISTALIA",0,0,0,61,0,61,"2022"
"69514","312040 CRISTIANO OTONI",0,1,1,64,1,67,"2022"
"69515","312050 CRISTINA",0,0,1,105,0,106,"2022"
"69516","312060 CRUCILANDIA",0,1,1,40,1,43,"2022"
"69517","312070 CRUZEIRO DA FORTALEZA",0,0,0,46,1,47,"2022"
"69518","312080 CRUZILIA",1,1,2,175,0,179,"2022"
"69519","312083 CUPARAQUE",0,0,2,54,0,56,"2022"
"69520","312087 CURRAL DE DENTRO",1,0,2,90,10,103,"2022"
"69521","312090 CURVELO",1,6,18,847,4,876,"2022"
"69522","312100 DATAS",0,1,2,67,1,71,"2022"
"69523","312110 DELFIM MOREIRA",0,0,1,87,1,89,"2022"
"69524","312120 DELFINOPOLIS",0,1,6,76,1,84,"2022"
"69525","312125 DELTA",1,0,3,111,0,115,"2022"
"69526","312130 DESCOBERTO",0,0,0,41,1,42,"2022"
"69527","312140 DESTERRO DE ENTRE RIOS",0,0,2,70,0,72,"2022"
"69528","312150 DESTERRO DO MELO",0,0,0,30,1,31,"2022"
"69529","312160 DIAMANTINA",0,2,6,550,3,561,"2022"
"69530","312170 DIOGO DE VASCONCELOS",0,0,1,32,0,33,"2022"
"69531","312180 DIONISIO",0,1,0,41,2,44,"2022"
"69532","312190 DIVINESIA",0,0,0,41,1,42,"2022"
"69533","312200 DIVINO",0,0,3,286,3,292,"2022"
"69534","312210 DIVINO DAS LARANJEIRAS",0,0,1,41,0,42,"2022"
"69535","312220 DIVINOLANDIA DE MINAS",0,0,1,86,1,88,"2022"
"69536","312230 DIVINOPOLIS",4,10,39,2383,11,2447,"2022"
"69537","312235 DIVISA ALEGRE",0,1,0,77,0,78,"2022"
"69538","312240 DIVISA NOVA",0,0,1,63,0,64,"2022"
"69539","312245 DIVISOPOLIS",1,0,2,80,2,85,"2022"
"69540","312247 DOM BOSCO",1,0,0,44,4,49,"2022"
"69541","312250 DOM CAVATI",0,0,0,50,3,53,"2022"
"69542","312260 DOM JOAQUIM",0,0,1,48,0,49,"2022"
"69543","312270 DOM SILVERIO",0,0,0,39,1,40,"2022"
"69544","312280 DOM VICOSO",0,0,0,27,0,27,"2022"
"69545","312290 DONA EUSEBIA",0,1,2,69,0,72,"2022"
"69546","312300 DORES DE CAMPOS",0,0,0,91,0,91,"2022"
"69547","312310 DORES DE GUANHAES",0,0,0,58,0,58,"2022"
"69548","312320 DORES DO INDAIA",0,1,0,97,0,98,"2022"
"69549","312330 DORES DO TURVO",0,0,0,45,0,45,"2022"
"69550","312340 DORESOPOLIS",0,0,0,15,0,15,"2022"
"69551","312350 DOURADOQUARA",0,0,0,18,0,18,"2022"
"69552","312352 DURANDE",0,0,0,132,0,132,"2022"
"69553","312360 ELOI MENDES",1,0,3,308,1,313,"2022"
"69554","312370 ENGENHEIRO CALDAS",1,0,1,107,2,111,"2022"
"69555","312380 ENGENHEIRO NAVARRO",1,0,2,66,0,69,"2022"
"69556","312385 ENTRE FOLHAS",0,0,0,65,0,65,"2022"
"69557","312390 ENTRE RIOS DE MINAS",1,0,2,173,1,177,"2022"
"69558","312400 ERVALIA",1,0,6,215,6,228,"2022"
"69559","312410 ESMERALDAS",1,7,14,940,10,972,"2022"
"69560","312420 ESPERA FELIZ",1,2,4,319,2,328,"2022"
"69561","312430 ESPINOSA",2,1,6,335,35,379,"2022"
"69562","312440 ESPIRITO SANTO DO DOURADO",0,0,2,98,0,100,"2022"
"69563","312450 ESTIVA",0,1,0,120,0,121,"2022"
"69564","312460 ESTRELA DALVA",0,0,0,20,0,20,"2022"
"69565","312470 ESTRELA DO INDAIA",0,0,0,24,0,24,"2022"
"69566","312480 ESTRELA DO SUL",0,0,1,61,0,62,"2022"
"69567","312490 EUGENOPOLIS",0,1,2,107,0,110,"2022"
"69568","312500 EWBANK DA CAMARA",0,0,0,63,2,65,"2022"
"69569","312510 EXTREMA",1,6,11,786,3,807,"2022"
"69570","312520 FAMA",0,0,0,19,0,19,"2022"
"69571","312530 FARIA LEMOS",0,0,0,38,0,38,"2022"
"69572","312540 FELICIO DOS SANTOS",0,2,1,63,0,66,"2022"
"69573","312550 SAO GONCALO DO RIO PRETO",0,0,0,24,0,24,"2022"
"69574","312560 FELISBURGO",0,1,1,74,0,76,"2022"
"69575","312570 FELIXLANDIA",0,1,3,118,0,122,"2022"
"69576","312580 FERNANDES TOURINHO",0,1,1,26,1,29,"2022"
"69577","312590 FERROS",0,0,1,76,1,78,"2022"
"69578","312595 FERVEDOURO",2,1,0,148,0,151,"2022"
"69579","312600 FLORESTAL",1,1,1,56,1,60,"2022"
"69580","312610 FORMIGA",3,3,14,624,3,647,"2022"
"69581","312620 FORMOSO",0,1,0,81,0,82,"2022"
"69582","312630 FORTALEZA DE MINAS",0,0,0,23,0,23,"2022"
"69583","312640 FORTUNA DE MINAS",0,0,0,37,0,37,"2022"
"69584","312650 FRANCISCO BADARO",0,0,1,47,0,48,"2022"
"69585","312660 FRANCISCO DUMONT",0,0,2,42,0,44,"2022"
"69586","312670 FRANCISCO SA",1,0,2,204,4,211,"2022"
"69587","312675 FRANCISCOPOLIS",1,0,0,34,0,35,"2022"
"69588","312680 FREI GASPAR",1,1,2,83,1,88,"2022"
"69589","312690 FREI INOCENCIO",1,2,4,109,2,118,"2022"
"69590","312695 FREI LAGONEGRO",1,0,0,48,1,50,"2022"
"69591","312700 FRONTEIRA",1,0,2,129,0,132,"2022"
"69592","312705 FRONTEIRA DOS VALES",2,1,0,47,0,50,"2022"
"69593","312707 FRUTA DE LEITE",0,0,0,8,47,55,"2022"
"69594","312710 FRUTAL",8,0,7,673,0,688,"2022"
"69595","312720 FUNILANDIA",0,0,0,52,0,52,"2022"
"69596","312730 GALILEIA",0,0,0,75,2,77,"2022"
"69597","312733 GAMELEIRAS",0,0,0,16,36,52,"2022"
"69598","312735 GLAUCILANDIA",0,0,0,27,0,27,"2022"
"69599","312737 GOIABEIRA",0,1,0,44,0,45,"2022"
"69600","312738 GOIANA",0,0,1,30,0,31,"2022"
"69601","312740 GONCALVES",0,0,0,30,0,30,"2022"
"69602","312750 GONZAGA",0,0,1,55,1,57,"2022"
"69603","312760 GOUVEIA",1,1,1,119,0,122,"2022"
"69604","312770 GOVERNADOR VALADARES",10,12,49,3315,37,3423,"2022"
"69605","312780 GRAO MOGOL",0,0,2,107,21,130,"2022"
"69606","312790 GRUPIARA",1,0,0,10,0,11,"2022"
"69607","312800 GUANHAES",1,1,11,411,2,426,"2022"
"69608","312810 GUAPE",0,0,2,129,0,131,"2022"
"69609","312820 GUARACIABA",0,1,1,66,0,68,"2022"
"69610","312825 GUARACIAMA",0,0,1,48,0,49,"2022"
"69611","312830 GUARANESIA",0,0,2,233,1,236,"2022"
"69612","312840 GUARANI",0,0,2,72,0,74,"2022"
"69613","312850 GUARARA",0,0,0,44,1,45,"2022"
"69614","312860 GUARDA-MOR",0,1,0,73,1,75,"2022"
"69615","312870 GUAXUPE",1,4,17,521,0,543,"2022"
"69616","312880 GUIDOVAL",0,0,0,74,1,75,"2022"
"69617","312890 GUIMARANIA",0,0,2,100,1,103,"2022"
"69618","312900 GUIRICEMA",0,1,1,76,0,78,"2022"
"69619","312910 GURINHATA",0,0,0,38,0,38,"2022"
"69620","312920 HELIODORA",0,0,1,69,0,70,"2022"
"69621","312930 IAPU",1,0,0,110,3,114,"2022"
"69622","312940 IBERTIOGA",0,0,0,44,2,46,"2022"
"69623","312950 IBIA",3,1,1,240,1,246,"2022"
"69624","312960 IBIAI",0,1,1,92,3,97,"2022"
"69625","312965 IBIRACATU",0,0,0,71,0,71,"2022"
"69626","312970 IBIRACI",0,1,7,134,1,143,"2022"
"69627","312980 IBIRITE",6,11,49,2152,17,2235,"2022"
"69628","312990 IBITIURA DE MINAS",0,0,0,30,1,31,"2022"
"69629","313000 IBITURUNA",0,0,0,20,0,20,"2022"
"69630","313005 ICARAI DE MINAS",0,0,2,106,1,109,"2022"
"69631","313010 IGARAPE",3,1,9,553,6,572,"2022"
"69632","313020 IGARATINGA",0,2,0,137,2,141,"2022"
"69633","313030 IGUATAMA",0,0,0,54,0,54,"2022"
"69634","313040 IJACI",1,0,0,78,0,79,"2022"
"69635","313050 ILICINEA",0,0,3,141,1,145,"2022"
"69636","313055 IMBE DE MINAS",0,0,0,75,3,78,"2022"
"69637","313060 INCONFIDENTES",0,0,2,70,3,75,"2022"
"69638","313065 INDAIABIRA",0,2,0,63,0,65,"2022"
"69639","313070 INDIANOPOLIS",1,0,0,49,2,52,"2022"
"69640","313080 INGAI",0,0,1,23,0,24,"2022"
"69641","313090 INHAPIM",0,0,1,255,7,263,"2022"
"69642","313100 INHAUMA",0,0,0,58,1,59,"2022"
"69643","313110 INIMUTABA",0,1,1,64,1,67,"2022"
"69644","313115 IPABA",0,0,5,218,2,225,"2022"
"69645","313120 IPANEMA",0,1,1,200,1,203,"2022"
"69646","313130 IPATINGA",6,5,25,2703,25,2764,"2022"
"69647","313140 IPIACU",1,0,0,37,1,39,"2022"
"69648","313150 IPUIUNA",0,0,2,90,0,92,"2022"
"69649","313160 IRAI DE MINAS",1,1,0,80,0,82,"2022"
"69650","313170 ITABIRA",4,3,16,1235,5,1263,"2022"
"69651","313180 ITABIRINHA",0,0,2,137,2,141,"2022"
"69652","313190 ITABIRITO",2,1,21,664,1,689,"2022"
"69653","313200 ITACAMBIRA",0,0,1,27,1,29,"2022"
"69654","313210 ITACARAMBI",0,3,3,205,22,233,"2022"
"69655","313220 ITAGUARA",0,0,0,160,1,161,"2022"
"69656","313230 ITAIPE",2,0,3,162,0,167,"2022"
"69657","313240 ITAJUBA",0,6,6,1042,7,1061,"2022"
"69658","313250 ITAMARANDIBA",3,1,3,474,1,482,"2022"
"69659","313260 ITAMARATI DE MINAS",0,0,2,31,0,33,"2022"
"69660","313270 ITAMBACURI",1,1,9,313,2,326,"2022"
"69661","313280 ITAMBE DO MATO DENTRO",0,0,0,15,0,15,"2022"
"69662","313290 ITAMOGI",0,1,0,105,2,108,"2022"
"69663","313300 ITAMONTE",0,0,0,171,0,171,"2022"
"69664","313310 ITANHANDU",0,0,2,152,0,154,"2022"
"69665","313320 ITANHOMI",0,0,0,121,1,122,"2022"
"69666","313330 ITAOBIM",0,0,0,200,0,200,"2022"
"69667","313340 ITAPAGIPE",0,0,1,100,0,101,"2022"
"69668","313350 ITAPECERICA",0,1,5,143,1,150,"2022"
"69669","313360 ITAPEVA",1,1,2,135,1,140,"2022"
"69670","313370 ITATIAIUCU",0,0,1,118,0,119,"2022"
"69671","313375 ITAU DE MINAS",2,0,3,140,0,145,"2022"
"69672","313380 ITAUNA",2,3,12,945,2,964,"2022"
"69673","313390 ITAVERAVA",0,1,1,41,0,43,"2022"
"69674","313400 ITINGA",0,0,1,133,0,134,"2022"
"69675","313410 ITUETA",0,1,3,74,0,78,"2022"
"69676","313420 ITUIUTABA",10,2,8,1016,2,1038,"2022"
"69677","313430 ITUMIRIM",0,0,1,58,0,59,"2022"
"69678","313440 ITURAMA",2,0,3,450,3,458,"2022"
"69679","313450 ITUTINGA",0,1,0,37,1,39,"2022"
"69680","313460 JABOTICATUBAS",1,1,3,182,1,188,"2022"
"69681","313470 JACINTO",1,0,4,100,0,105,"2022"
"69682","313480 JACUI",0,2,1,101,0,104,"2022"
"69683","313490 JACUTINGA",0,0,1,283,0,284,"2022"
"69684","313500 JAGUARACU",0,0,0,29,0,29,"2022"
"69685","313505 JAIBA",2,2,2,488,47,541,"2022"
"69686","313507 JAMPRUCA",0,0,1,63,2,66,"2022"
"69687","313510 JANAUBA",1,0,10,951,7,969,"2022"
"69688","313520 JANUARIA",0,4,12,758,169,943,"2022"
"69689","313530 JAPARAIBA",0,0,3,50,0,53,"2022"
"69690","313535 JAPONVAR",0,0,0,106,0,106,"2022"
"69691","313540 JECEABA",0,0,0,54,0,54,"2022"
"69692","313545 JENIPAPO DE MINAS",0,1,1,72,0,74,"2022"
"69693","313550 JEQUERI",0,0,0,111,1,112,"2022"
"69694","313560 JEQUITAI",0,0,2,66,1,69,"2022"
"69695","313570 JEQUITIBA",1,0,0,53,0,54,"2022"
"69696","313580 JEQUITINHONHA",0,2,4,258,1,265,"2022"
"69697","313590 JESUANIA",0,1,0,58,0,59,"2022"
"69698","313600 JOAIMA",0,0,3,153,1,157,"2022"
"69699","313610 JOANESIA",0,0,1,33,1,35,"2022"
"69700","313620 JOAO MONLEVADE",2,2,7,879,1,891,"2022"
"69701","313630 JOAO PINHEIRO",3,6,9,659,2,679,"2022"
"69702","313640 JOAQUIM FELICIO",0,0,0,28,1,29,"2022"
"69703","313650 JORDANIA",0,0,6,95,0,101,"2022"
"69704","313652 JOSE GONCALVES DE MINAS",0,0,0,39,0,39,"2022"
"69705","313655 JOSE RAYDAN",0,0,0,45,0,45,"2022"
"69706","313657 JOSENOPOLIS",1,0,0,22,16,39,"2022"
"69707","313660 NOVA UNIAO",0,0,0,63,0,63,"2022"
"69708","313665 JUATUBA",3,4,12,375,6,400,"2022"
"69709","313670 JUIZ DE FORA",10,16,89,5396,36,5547,"2022"
"69710","313680 JURAMENTO",0,0,0,33,0,33,"2022"
"69711","313690 JURUAIA",0,0,3,145,0,148,"2022"
"69712","313695 JUVENILIA",1,0,1,18,41,61,"2022"
"69713","313700 LADAINHA",2,2,2,131,4,141,"2022"
"69714","313710 LAGAMAR",0,0,0,47,0,47,"2022"
"69715","313720 LAGOA DA PRATA",2,4,22,569,0,597,"2022"
"69716","313730 LAGOA DOS PATOS",0,1,1,31,0,33,"2022"
"69717","313740 LAGOA DOURADA",0,0,2,136,1,139,"2022"
"69718","313750 LAGOA FORMOSA",1,0,2,194,0,197,"2022"
"69719","313753 LAGOA GRANDE",1,0,2,88,0,91,"2022"
"69720","313760 LAGOA SANTA",2,6,21,855,2,886,"2022"
"69721","313770 LAJINHA",0,3,2,308,0,313,"2022"
"69722","313780 LAMBARI",1,0,1,190,0,192,"2022"
"69723","313790 LAMIM",0,0,1,28,0,29,"2022"
"69724","313800 LARANJAL",0,0,1,55,0,56,"2022"
"69725","313810 LASSANCE",0,0,1,70,3,74,"2022"
"69726","313820 LAVRAS",2,3,6,1231,4,1246,"2022"
"69727","313830 LEANDRO FERREIRA",1,0,0,28,0,29,"2022"
"69728","313835 LEME DO PRADO",0,1,1,46,0,48,"2022"
"69729","313840 LEOPOLDINA",2,5,10,476,0,493,"2022"
"69730","313850 LIBERDADE",0,1,1,38,0,40,"2022"
"69731","313860 LIMA DUARTE",0,0,2,185,1,188,"2022"
"69732","313862 LIMEIRA DO OESTE",0,0,1,97,0,98,"2022"
"69733","313865 LONTRA",0,0,2,112,1,115,"2022"
"69734","313867 LUISBURGO",1,0,1,103,0,105,"2022"
"69735","313868 LUISLANDIA",3,0,0,73,0,76,"2022"
"69736","313870 LUMINARIAS",1,0,0,52,0,53,"2022"
"69737","313880 LUZ",1,2,2,179,0,184,"2022"
"69738","313890 MACHACALIS",0,1,1,62,0,64,"2022"
"69739","313900 MACHADO",2,2,4,447,0,455,"2022"
"69740","313910 MADRE DE DEUS DE MINAS",0,1,0,44,0,45,"2022"
"69741","313920 MALACACHETA",0,0,1,204,2,207,"2022"
"69742","313925 MAMONAS",0,0,0,12,47,59,"2022"
"69743","313930 MANGA",1,0,5,30,244,280,"2022"
"69744","313940 MANHUACU",4,3,16,1248,1,1272,"2022"
"69745","313950 MANHUMIRIM",0,0,6,233,23,262,"2022"
"69746","313960 MANTENA",2,0,2,320,1,325,"2022"
"69747","313970 MARAVILHAS",0,0,1,69,0,70,"2022"
"69748","313980 MAR DE ESPANHA",1,1,2,161,3,168,"2022"
"69749","313990 MARIA DA FE",0,0,0,173,3,176,"2022"
"69750","314000 MARIANA",1,4,6,767,13,791,"2022"
"69751","314010 MARILAC",0,0,2,54,2,58,"2022"
"69752","314015 MARIO CAMPOS",1,0,4,189,2,196,"2022"
"69753","314020 MARIPA DE MINAS",0,0,0,32,1,33,"2022"
"69754","314030 MARLIERIA",0,0,1,41,3,45,"2022"
"69755","314040 MARMELOPOLIS",0,0,0,35,0,35,"2022"
"69756","314050 MARTINHO CAMPOS",0,1,2,123,0,126,"2022"
"69757","314053 MARTINS SOARES",0,1,3,126,0,130,"2022"
"69758","314055 MATA VERDE",1,0,0,86,0,87,"2022"
"69759","314060 MATERLANDIA",0,0,1,40,0,41,"2022"
"69760","314070 MATEUS LEME",3,3,10,430,4,450,"2022"
"69761","314080 MATIAS BARBOSA",1,2,0,144,2,149,"2022"
"69762","314085 MATIAS CARDOSO",0,0,4,95,37,136,"2022"
"69763","314090 MATIPO",0,1,1,255,16,273,"2022"
"69764","314100 MATO VERDE",0,0,0,50,102,152,"2022"
"69765","314110 MATOZINHOS",1,0,6,401,3,411,"2022"
"69766","314120 MATUTINA",0,0,0,40,0,40,"2022"
"69767","314130 MEDEIROS",0,0,0,36,0,36,"2022"
"69768","314140 MEDINA",0,1,1,228,0,230,"2022"
"69769","314150 MENDES PIMENTEL",0,0,2,52,2,56,"2022"
"69770","314160 MERCES",0,0,0,79,0,79,"2022"
"69771","314170 MESQUITA",0,1,2,59,0,62,"2022"
"69772","314180 MINAS NOVAS",3,0,0,251,0,254,"2022"
"69773","314190 MINDURI",0,0,1,38,0,39,"2022"
"69774","314200 MIRABELA",0,0,1,140,1,142,"2022"
"69775","314210 MIRADOURO",0,0,1,82,1,84,"2022"
"69776","314220 MIRAI",0,0,3,119,1,123,"2022"
"69777","314225 MIRAVANIA",0,0,0,5,37,42,"2022"
"69778","314230 MOEDA",0,1,1,60,0,62,"2022"
"69779","314240 MOEMA",0,1,1,87,0,89,"2022"
"69780","314250 MONJOLOS",0,0,0,12,0,12,"2022"
"69781","314260 MONSENHOR PAULO",0,0,0,61,0,61,"2022"
"69782","314270 MONTALVANIA",0,0,2,66,108,176,"2022"
"69783","314280 MONTE ALEGRE DE MINAS",1,1,2,160,21,185,"2022"
"69784","314290 MONTE AZUL",0,0,0,42,175,217,"2022"
"69785","314300 MONTE BELO",0,0,3,143,0,146,"2022"
"69786","314310 MONTE CARMELO",2,2,5,514,0,523,"2022"
"69787","314315 MONTE FORMOSO",0,0,1,59,0,60,"2022"
"69788","314320 MONTE SANTO DE MINAS",0,3,2,224,1,230,"2022"
"69789","314330 MONTES CLAROS",9,22,61,5461,17,5570,"2022"
"69790","314340 MONTE SIAO",0,0,5,165,17,187,"2022"
"69791","314345 MONTEZUMA",0,0,0,73,3,76,"2022"
"69792","314350 MORADA NOVA DE MINAS",0,0,1,103,1,105,"2022"
"69793","314360 MORRO DA GARCA",0,0,1,29,0,30,"2022"
"69794","314370 MORRO DO PILAR",0,0,0,38,1,39,"2022"
"69795","314380 MUNHOZ",0,0,0,54,5,59,"2022"
"69796","314390 MURIAE",7,7,23,1108,1,1146,"2022"
"69797","314400 MUTUM",1,0,2,321,1,325,"2022"
"69798","314410 MUZAMBINHO",1,1,1,245,0,248,"2022"
"69799","314420 NACIP RAYDAN",0,0,0,18,0,18,"2022"
"69800","314430 NANUQUE",2,2,16,436,6,462,"2022"
"69801","314435 NAQUE",0,1,0,92,5,98,"2022"
"69802","314437 NATALANDIA",0,0,0,35,1,36,"2022"
"69803","314440 NATERCIA",1,0,0,39,0,40,"2022"
"69804","314450 NAZARENO",0,0,0,77,0,77,"2022"
"69805","314460 NEPOMUCENO",1,1,0,308,0,310,"2022"
"69806","314465 NINHEIRA",0,1,1,94,2,98,"2022"
"69807","314467 NOVA BELEM",0,0,2,44,1,47,"2022"
"69808","314470 NOVA ERA",3,0,0,157,0,160,"2022"
"69809","314480 NOVA LIMA",5,3,24,1225,6,1263,"2022"
"69810","314490 NOVA MODICA",0,0,1,43,0,44,"2022"
"69811","314500 NOVA PONTE",0,1,3,204,3,211,"2022"
"69812","314505 NOVA PORTEIRINHA",0,1,1,110,0,112,"2022"
"69813","314510 NOVA RESENDE",0,0,4,220,0,224,"2022"
"69814","314520 NOVA SERRANA",4,11,17,1706,2,1740,"2022"
"69815","314530 NOVO CRUZEIRO",2,1,6,327,3,339,"2022"
"69816","314535 NOVO ORIENTE DE MINAS",0,0,3,113,2,118,"2022"
"69817","314537 NOVORIZONTE",0,0,0,21,38,59,"2022"
"69818","314540 OLARIA",0,0,0,11,0,11,"2022"
"69819","314545 OLHOS-D'AGUA",0,0,1,56,0,57,"2022"
"69820","314550 OLIMPIO NORONHA",0,0,0,25,0,25,"2022"
"69821","314560 OLIVEIRA",3,2,12,433,0,450,"2022"
"69822","314570 OLIVEIRA FORTES",0,0,0,15,1,16,"2022"
"69823","314580 ONCA DE PITANGUI",0,0,0,24,0,24,"2022"
"69824","314585 ORATORIOS",0,0,0,62,0,62,"2022"
"69825","314587 ORIZANIA",0,0,1,131,0,132,"2022"
"69826","314590 OURO BRANCO",1,3,8,521,1,534,"2022"
"69827","314600 OURO FINO",0,1,3,252,27,283,"2022"
"69828","314610 OURO PRETO",1,4,25,742,7,779,"2022"
"69829","314620 OURO VERDE DE MINAS",0,0,3,88,1,92,"2022"
"69830","314625 PADRE CARVALHO",0,0,0,13,50,63,"2022"
"69831","314630 PADRE PARAISO",0,1,4,226,2,233,"2022"
"69832","314640 PAINEIRAS",0,0,0,33,1,34,"2022"
"69833","314650 PAINS",1,0,2,79,1,83,"2022"
"69834","314655 PAI PEDRO",0,0,1,48,2,51,"2022"
"69835","314660 PAIVA",0,0,0,11,0,11,"2022"
"69836","314670 PALMA",0,1,1,55,0,57,"2022"
"69837","314675 PALMOPOLIS",1,0,4,65,0,70,"2022"
"69838","314690 PAPAGAIOS",0,1,2,144,3,150,"2022"
"69839","314700 PARACATU",1,5,13,1345,4,1368,"2022"
"69840","314710 PARA DE MINAS",0,4,14,1120,2,1140,"2022"
"69841","314720 PARAGUACU",0,1,1,242,1,245,"2022"
"69842","314730 PARAISOPOLIS",0,1,1,180,2,184,"2022"
"69843","314740 PARAOPEBA",0,0,0,256,1,257,"2022"
"69844","314750 PASSABEM",0,0,0,14,1,15,"2022"
"69845","314760 PASSA QUATRO",0,0,2,161,2,165,"2022"
"69846","314770 PASSA TEMPO",1,1,0,64,0,66,"2022"
"69847","314780 PASSA-VINTE",0,0,0,21,0,21,"2022"
"69848","314790 PASSOS",4,4,25,1295,3,1331,"2022"
"69849","314795 PATIS",0,0,0,47,0,47,"2022"
"69850","314800 PATOS DE MINAS",8,3,18,1844,13,1886,"2022"
"69851","314810 PATROCINIO",1,3,14,1162,2,1182,"2022"
"69852","314820 PATROCINIO DO MURIAE",1,1,1,40,1,44,"2022"
"69853","314830 PAULA CANDIDO",0,0,1,83,1,85,"2022"
"69854","314840 PAULISTAS",0,0,0,42,1,43,"2022"
"69855","314850 PAVAO",0,0,1,50,3,54,"2022"
"69856","314860 PECANHA",2,2,0,182,0,186,"2022"
"69857","314870 PEDRA AZUL",1,2,4,225,3,235,"2022"
"69858","314875 PEDRA BONITA",0,0,0,108,12,120,"2022"
"69859","314880 PEDRA DO ANTA",0,0,1,31,0,32,"2022"
"69860","314890 PEDRA DO INDAIA",0,0,1,33,0,34,"2022"
"69861","314900 PEDRA DOURADA",0,0,0,29,0,29,"2022"
"69862","314910 PEDRALVA",0,0,0,128,2,130,"2022"
"69863","314915 PEDRAS DE MARIA DA CRUZ",0,0,1,78,22,101,"2022"
"69864","314920 PEDRINOPOLIS",0,0,0,26,0,26,"2022"
"69865","314930 PEDRO LEOPOLDO",2,1,9,672,6,690,"2022"
"69866","314940 PEDRO TEIXEIRA",0,0,1,22,0,23,"2022"
"69867","314950 PEQUERI",0,0,1,39,0,40,"2022"
"69868","314960 PEQUI",0,2,0,50,0,52,"2022"
"69869","314970 PERDIGAO",0,0,2,162,1,165,"2022"
"69870","314980 PERDIZES",1,0,2,245,1,249,"2022"
"69871","314990 PERDOES",0,3,3,191,1,198,"2022"
"69872","314995 PERIQUITO",0,0,1,92,1,94,"2022"
"69873","315000 PESCADOR",0,0,1,42,0,43,"2022"
"69874","315010 PIAU",0,0,0,23,0,23,"2022"
"69875","315015 PIEDADE DE CARATINGA",1,0,1,132,1,135,"2022"
"69876","315020 PIEDADE DE PONTE NOVA",0,1,1,55,0,57,"2022"
"69877","315030 PIEDADE DO RIO GRANDE",0,1,0,47,0,48,"2022"
"69878","315040 PIEDADE DOS GERAIS",0,0,0,44,2,46,"2022"
"69879","315050 PIMENTA",0,0,3,62,1,66,"2022"
"69880","315053 PINGO-D'AGUA",0,0,1,44,0,45,"2022"
"69881","315057 PINTOPOLIS",1,0,2,69,3,75,"2022"
"69882","315060 PIRACEMA",0,0,2,59,0,61,"2022"
"69883","315070 PIRAJUBA",0,0,1,74,0,75,"2022"
"69884","315080 PIRANGA",0,3,3,125,0,131,"2022"
"69885","315090 PIRANGUCU",1,0,0,64,1,66,"2022"
"69886","315100 PIRANGUINHO",0,0,0,129,1,130,"2022"
"69887","315110 PIRAPETINGA",0,0,0,139,0,139,"2022"
"69888","315120 PIRAPORA",1,2,11,719,6,739,"2022"
"69889","315130 PIRAUBA",0,1,1,100,1,103,"2022"
"69890","315140 PITANGUI",0,2,6,307,3,318,"2022"
"69891","315150 PIUMHI",1,4,7,367,2,381,"2022"
"69892","315160 PLANURA",1,0,1,106,0,108,"2022"
"69893","315170 POCO FUNDO",0,0,1,148,1,150,"2022"
"69894","315180 POCOS DE CALDAS",6,4,26,1719,2,1757,"2022"
"69895","315190 POCRANE",0,1,2,65,0,68,"2022"
"69896","315200 POMPEU",1,1,2,411,0,415,"2022"
"69897","315210 PONTE NOVA",1,3,1,658,1,664,"2022"
"69898","315213 PONTO CHIQUE",0,0,1,54,0,55,"2022"
"69899","315217 PONTO DOS VOLANTES",0,2,3,129,0,134,"2022"
"69900","315220 PORTEIRINHA",0,0,2,404,2,408,"2022"
"69901","315230 PORTO FIRME",0,0,0,94,2,96,"2022"
"69902","315240 POTE",1,1,0,158,3,163,"2022"
"69903","315250 POUSO ALEGRE",2,5,19,1836,7,1869,"2022"
"69904","315260 POUSO ALTO",0,0,0,44,0,44,"2022"
"69905","315270 PRADOS",0,0,1,84,0,85,"2022"
"69906","315280 PRATA",1,3,4,377,1,386,"2022"
"69907","315290 PRATAPOLIS",0,1,4,77,0,82,"2022"
"69908","315300 PRATINHA",0,0,0,31,0,31,"2022"
"69909","315310 PRESIDENTE BERNARDES",0,1,0,48,2,51,"2022"
"69910","315320 PRESIDENTE JUSCELINO",0,0,2,35,0,37,"2022"
"69911","315330 PRESIDENTE KUBITSCHEK",0,0,0,36,0,36,"2022"
"69912","315340 PRESIDENTE OLEGARIO",1,1,3,142,1,148,"2022"
"69913","315350 ALTO JEQUITIBA",1,0,3,93,6,103,"2022"
"69914","315360 PRUDENTE DE MORAIS",0,1,0,149,0,150,"2022"
"69915","315370 QUARTEL GERAL",0,0,1,30,0,31,"2022"
"69916","315380 QUELUZITO",0,0,1,16,0,17,"2022"
"69917","315390 RAPOSOS",2,0,4,168,0,174,"2022"
"69918","315400 RAUL SOARES",1,1,1,231,0,234,"2022"
"69919","315410 RECREIO",1,0,0,72,1,74,"2022"
"69920","315415 REDUTO",0,0,0,111,2,113,"2022"
"69921","315420 RESENDE COSTA",1,0,2,110,0,113,"2022"
"69922","315430 RESPLENDOR",2,3,2,194,1,202,"2022"
"69923","315440 RESSAQUINHA",0,0,0,46,0,46,"2022"
"69924","315445 RIACHINHO",0,0,0,81,3,84,"2022"
"69925","315450 RIACHO DOS MACHADOS",0,0,3,93,4,100,"2022"
"69926","315460 RIBEIRAO DAS NEVES",15,27,73,3950,37,4102,"2022"
"69927","315470 RIBEIRAO VERMELHO",0,0,0,46,0,46,"2022"
"69928","315480 RIO ACIMA",0,1,1,104,1,107,"2022"
"69929","315490 RIO CASCA",1,1,1,130,2,135,"2022"
"69930","315500 RIO DOCE",0,2,1,24,2,29,"2022"
"69931","315510 RIO DO PRADO",0,1,0,39,1,41,"2022"
"69932","315520 RIO ESPERA",0,0,1,30,0,31,"2022"
"69933","315530 RIO MANSO",0,0,0,32,2,34,"2022"
"69934","315540 RIO NOVO",1,0,1,90,0,92,"2022"
"69935","315550 RIO PARANAIBA",0,0,1,155,0,156,"2022"
"69936","315560 RIO PARDO DE MINAS",0,0,3,354,3,360,"2022"
"69937","315570 RIO PIRACICABA",1,0,2,136,0,139,"2022"
"69938","315580 RIO POMBA",0,1,1,187,0,189,"2022"
"69939","315590 RIO PRETO",0,0,1,32,0,33,"2022"
"69940","315600 RIO VERMELHO",0,1,4,97,1,103,"2022"
"69941","315610 RITAPOLIS",0,0,0,30,0,30,"2022"
"69942","315620 ROCHEDO DE MINAS",0,0,0,16,0,16,"2022"
"69943","315630 RODEIRO",0,0,0,116,2,118,"2022"
"69944","315640 ROMARIA",0,0,0,35,0,35,"2022"
"69945","315645 ROSARIO DA LIMEIRA",0,0,0,51,0,51,"2022"
"69946","315650 RUBELITA",0,0,1,6,38,45,"2022"
"69947","315660 RUBIM",0,1,3,94,0,98,"2022"
"69948","315670 SABARA",2,9,34,1323,22,1390,"2022"
"69949","315680 SABINOPOLIS",1,0,4,144,0,149,"2022"
"69950","315690 SACRAMENTO",2,0,5,304,3,314,"2022"
"69951","315700 SALINAS",3,1,2,111,379,496,"2022"
"69952","315710 SALTO DA DIVISA",0,2,3,57,0,62,"2022"
"69953","315720 SANTA BARBARA",0,2,6,377,3,388,"2022"
"69954","315725 SANTA BARBARA DO LESTE",2,0,0,98,2,102,"2022"
"69955","315727 SANTA BARBARA DO MONTE VERDE",0,0,0,31,0,31,"2022"
"69956","315730 SANTA BARBARA DO TUGURIO",0,0,1,35,1,37,"2022"
"69957","315733 SANTA CRUZ DE MINAS",0,0,0,72,0,72,"2022"
"69958","315737 SANTA CRUZ DE SALINAS",0,0,0,6,28,34,"2022"
"69959","315740 SANTA CRUZ DO ESCALVADO",0,0,0,47,1,48,"2022"
"69960","315750 SANTA EFIGENIA DE MINAS",0,0,0,43,6,49,"2022"
"69961","315760 SANTA FE DE MINAS",0,0,0,36,1,37,"2022"
"69962","315765 SANTA HELENA DE MINAS",0,0,1,57,7,65,"2022"
"69963","315770 SANTA JULIANA",0,0,3,236,0,239,"2022"
"69964","315780 SANTA LUZIA",5,15,50,2645,21,2736,"2022"
"69965","315790 SANTA MARGARIDA",1,1,3,208,0,213,"2022"
"69966","315800 SANTA MARIA DE ITABIRA",0,1,1,126,2,130,"2022"
"69967","315810 SANTA MARIA DO SALTO",1,0,2,48,0,51,"2022"
"69968","315820 SANTA MARIA DO SUACUI",0,0,2,147,0,149,"2022"
"69969","315830 SANTANA DA VARGEM",0,0,1,72,0,73,"2022"
"69970","315840 SANTANA DE CATAGUASES",0,0,0,27,0,27,"2022"
"69971","315850 SANTANA DE PIRAPAMA",0,0,0,62,0,62,"2022"
"69972","315860 SANTANA DO DESERTO",0,1,0,26,1,28,"2022"
"69973","315870 SANTANA DO GARAMBEU",0,0,0,20,0,20,"2022"
"69974","315880 SANTANA DO JACARE",0,1,0,38,0,39,"2022"
"69975","315890 SANTANA DO MANHUACU",0,1,5,143,0,149,"2022"
"69976","315895 SANTANA DO PARAISO",4,1,6,726,9,746,"2022"
"69977","315900 SANTANA DO RIACHO",0,1,0,54,0,55,"2022"
"69978","315910 SANTANA DOS MONTES",0,0,0,31,0,31,"2022"
"69979","315920 SANTA RITA DE CALDAS",0,1,2,68,1,72,"2022"
"69980","315930 SANTA RITA DE JACUTINGA",0,0,2,38,0,40,"2022"
"69981","315935 SANTA RITA DE MINAS",0,0,2,85,1,88,"2022"
"69982","315940 SANTA RITA DE IBITIPOCA",0,0,0,31,0,31,"2022"
"69983","315950 SANTA RITA DO ITUETO",0,0,0,70,1,71,"2022"
"69984","315960 SANTA RITA DO SAPUCAI",0,0,4,440,6,450,"2022"
"69985","315970 SANTA ROSA DA SERRA",0,0,0,32,0,32,"2022"
"69986","315980 SANTA VITORIA",0,3,2,207,1,213,"2022"
"69987","315990 SANTO ANTONIO DO AMPARO",1,0,0,158,2,161,"2022"
"69988","316000 SANTO ANTONIO DO AVENTUREIRO",0,0,2,26,0,28,"2022"
"69989","316010 SANTO ANTONIO DO GRAMA",0,0,0,50,2,52,"2022"
"69990","316020 SANTO ANTONIO DO ITAMBE",0,1,1,28,1,31,"2022"
"69991","316030 SANTO ANTONIO DO JACINTO",0,1,3,105,1,110,"2022"
"69992","316040 SANTO ANTONIO DO MONTE",1,1,114,259,0,375,"2022"
"69993","316045 SANTO ANTONIO DO RETIRO",1,1,1,60,4,67,"2022"
"69994","316050 SANTO ANTONIO DO RIO ABAIXO",0,0,1,20,0,21,"2022"
"69995","316060 SANTO HIPOLITO",0,0,0,27,0,27,"2022"
"69996","316070 SANTOS DUMONT",2,1,5,442,4,454,"2022"
"69997","316080 SAO BENTO ABADE",0,0,0,76,1,77,"2022"
"69998","316090 SAO BRAS DO SUACUI",0,0,0,32,1,33,"2022"
"69999","316095 SAO DOMINGOS DAS DORES",0,0,0,80,1,81,"2022"
"70000","316100 SAO DOMINGOS DO PRATA",0,0,0,158,0,158,"2022"
"70001","316105 SAO FELIX DE MINAS",0,0,1,37,0,38,"2022"
"70002","316110 SAO FRANCISCO",1,0,10,693,6,710,"2022"
"70003","316120 SAO FRANCISCO DE PAULA",0,0,0,46,0,46,"2022"
"70004","316130 SAO FRANCISCO DE SALES",0,0,0,60,0,60,"2022"
"70005","316140 SAO FRANCISCO DO GLORIA",0,0,1,46,0,47,"2022"
"70006","316150 SAO GERALDO",0,0,0,102,0,102,"2022"
"70007","316160 SAO GERALDO DA PIEDADE",0,0,2,44,0,46,"2022"
"70008","316165 SAO GERALDO DO BAIXIO",0,0,1,36,2,39,"2022"
"70009","316170 SAO GONCALO DO ABAETE",2,0,0,45,1,48,"2022"
"70010","316180 SAO GONCALO DO PARA",1,0,4,110,0,115,"2022"
"70011","316190 SAO GONCALO DO RIO ABAIXO",0,1,4,179,1,185,"2022"
"70012","316200 SAO GONCALO DO SAPUCAI",0,0,6,319,2,327,"2022"
"70013","316210 SAO GOTARDO",3,3,3,724,3,736,"2022"
"70014","316220 SAO JOAO BATISTA DO GLORIA",0,0,0,95,1,96,"2022"
"70015","316225 SAO JOAO DA LAGOA",0,0,1,42,0,43,"2022"
"70016","316230 SAO JOAO DA MATA",0,0,0,31,0,31,"2022"
"70017","316240 SAO JOAO DA PONTE",1,1,5,274,1,282,"2022"
"70018","316245 SAO JOAO DAS MISSOES",0,0,3,96,144,243,"2022"
"70019","316250 SAO JOAO DEL REI",1,1,1,862,1,866,"2022"
"70020","316255 SAO JOAO DO MANHUACU",1,0,2,191,0,194,"2022"
"70021","316257 SAO JOAO DO MANTENINHA",1,0,1,56,1,59,"2022"
"70022","316260 SAO JOAO DO ORIENTE",1,1,1,89,2,94,"2022"
"70023","316265 SAO JOAO DO PACUI",0,0,0,35,0,35,"2022"
"70024","316270 SAO JOAO DO PARAISO",1,1,0,256,16,274,"2022"
"70025","316280 SAO JOAO EVANGELISTA",1,1,6,184,2,194,"2022"
"70026","316290 SAO JOAO NEPOMUCENO",0,0,4,225,3,232,"2022"
"70027","316292 SAO JOAQUIM DE BICAS",4,2,15,438,4,463,"2022"
"70028","316294 SAO JOSE DA BARRA",2,0,2,93,1,98,"2022"
"70029","316295 SAO JOSE DA LAPA",1,2,8,298,4,313,"2022"
"70030","316300 SAO JOSE DA SAFIRA",0,1,1,46,3,51,"2022"
"70031","316310 SAO JOSE DA VARGINHA",0,0,0,34,0,34,"2022"
"70032","316320 SAO JOSE DO ALEGRE",1,0,2,45,0,48,"2022"
"70033","316330 SAO JOSE DO DIVINO",1,0,0,31,0,32,"2022"
"70034","316340 SAO JOSE DO GOIABAL",0,0,0,48,2,50,"2022"
"70035","316350 SAO JOSE DO JACURI",0,0,0,66,2,68,"2022"
"70036","316360 SAO JOSE DO MANTIMENTO",0,0,0,38,0,38,"2022"
"70037","316370 SAO LOURENCO",0,0,7,462,1,470,"2022"
"70038","316380 SAO MIGUEL DO ANTA",0,0,1,53,0,54,"2022"
"70039","316390 SAO PEDRO DA UNIAO",0,0,3,45,0,48,"2022"
"70040","316400 SAO PEDRO DOS FERROS",0,0,0,77,0,77,"2022"
"70041","316410 SAO PEDRO DO SUACUI",0,0,1,58,0,59,"2022"
"70042","316420 SAO ROMAO",0,1,2,90,0,93,"2022"
"70043","316430 SAO ROQUE DE MINAS",0,0,1,70,1,72,"2022"
"70044","316440 SAO SEBASTIAO DA BELA VISTA",0,0,0,69,0,69,"2022"
"70045","316443 SAO SEBASTIAO DA VARGEM ALEGRE",0,0,0,36,1,37,"2022"
"70046","316447 SAO SEBASTIAO DO ANTA",1,0,1,76,2,80,"2022"
"70047","316450 SAO SEBASTIAO DO MARANHAO",0,1,0,103,0,104,"2022"
"70048","316460 SAO SEBASTIAO DO OESTE",0,1,2,151,1,155,"2022"
"70049","316470 SAO SEBASTIAO DO PARAISO",0,0,4,792,7,803,"2022"
"70050","316480 SAO SEBASTIAO DO RIO PRETO",0,0,0,14,0,14,"2022"
"70051","316490 SAO SEBASTIAO DO RIO VERDE",0,0,0,21,0,21,"2022"
"70052","316500 SAO TIAGO",0,2,2,106,0,110,"2022"
"70053","316510 SAO TOMAS DE AQUINO",0,0,1,70,0,71,"2022"
"70054","316520 SAO THOME DAS LETRAS",0,0,0,47,0,47,"2022"
"70055","316530 SAO VICENTE DE MINAS",0,0,0,77,0,77,"2022"
"70056","316540 SAPUCAI-MIRIM",0,0,0,50,1,51,"2022"
"70057","316550 SARDOA",0,0,1,57,1,59,"2022"
"70058","316553 SARZEDO",6,1,8,500,2,517,"2022"
"70059","316555 SETUBINHA",0,0,2,146,3,151,"2022"
"70060","316556 SEM-PEIXE",0,0,1,15,2,18,"2022"
"70061","316557 SENADOR AMARAL",0,0,1,118,0,119,"2022"
"70062","316560 SENADOR CORTES",0,0,0,20,1,21,"2022"
"70063","316570 SENADOR FIRMINO",0,0,0,85,0,85,"2022"
"70064","316580 SENADOR JOSE BENTO",0,0,0,15,0,15,"2022"
"70065","316590 SENADOR MODESTINO GONCALVES",0,1,0,35,0,36,"2022"
"70066","316600 SENHORA DE OLIVEIRA",0,0,2,48,0,50,"2022"
"70067","316610 SENHORA DO PORTO",0,1,1,23,0,25,"2022"
"70068","316620 SENHORA DOS REMEDIOS",0,0,1,88,0,89,"2022"
"70069","316630 SERICITA",0,0,0,81,3,84,"2022"
"70070","316640 SERITINGA",0,0,1,21,0,22,"2022"
"70071","316650 SERRA AZUL DE MINAS",0,1,1,34,1,37,"2022"
"70072","316660 SERRA DA SAUDADE",0,0,0,5,0,5,"2022"
"70073","316670 SERRA DOS AIMORES",0,2,5,81,3,91,"2022"
"70074","316680 SERRA DO SALITRE",0,3,2,174,0,179,"2022"
"70075","316690 SERRANIA",0,0,4,77,0,81,"2022"
"70076","316695 SERRANOPOLIS DE MINAS",1,0,1,41,0,43,"2022"
"70077","316700 SERRANOS",0,0,0,26,0,26,"2022"
"70078","316710 SERRO",0,0,2,257,0,259,"2022"
"70079","316720 SETE LAGOAS",14,4,26,2519,8,2571,"2022"
"70080","316730 SILVEIRANIA",1,0,0,26,0,27,"2022"
"70081","316740 SILVIANOPOLIS",0,1,0,59,1,61,"2022"
"70082","316750 SIMAO PEREIRA",0,0,1,28,0,29,"2022"
"70083","316760 SIMONESIA",1,0,2,304,2,309,"2022"
"70084","316770 SOBRALIA",0,0,0,58,0,58,"2022"
"70085","316780 SOLEDADE DE MINAS",0,0,0,52,0,52,"2022"
"70086","316790 TABULEIRO",0,0,2,31,2,35,"2022"
"70087","316800 TAIOBEIRAS",0,4,6,444,8,462,"2022"
"70088","316805 TAPARUBA",0,0,0,52,0,52,"2022"
"70089","316810 TAPIRA",0,0,0,61,0,61,"2022"
"70090","316820 TAPIRAI",0,0,0,13,0,13,"2022"
"70091","316830 TAQUARACU DE MINAS",0,0,0,48,0,48,"2022"
"70092","316840 TARUMIRIM",0,0,0,119,1,120,"2022"
"70093","316850 TEIXEIRAS",0,0,0,125,0,125,"2022"
"70094","316860 TEOFILO OTONI",2,5,23,1588,14,1632,"2022"
"70095","316870 TIMOTEO",1,1,4,877,11,894,"2022"
"70096","316880 TIRADENTES",0,0,0,86,0,86,"2022"
"70097","316890 TIROS",0,0,0,84,0,84,"2022"
"70098","316900 TOCANTINS",0,0,1,165,0,166,"2022"
"70099","316905 TOCOS DO MOJI",0,0,0,29,0,29,"2022"
"70100","316910 TOLEDO",0,0,0,80,0,80,"2022"
"70101","316920 TOMBOS",0,0,1,76,0,77,"2022"
"70102","316930 TRES CORACOES",4,5,7,911,1,928,"2022"
"70103","316935 TRES MARIAS",0,2,2,396,2,402,"2022"
"70104","316940 TRES PONTAS",1,1,14,630,2,648,"2022"
"70105","316950 TUMIRITINGA",0,1,2,70,0,73,"2022"
"70106","316960 TUPACIGUARA",1,0,1,218,7,227,"2022"
"70107","316970 TURMALINA",1,0,1,225,3,230,"2022"
"70108","316980 TURVOLANDIA",0,0,0,72,0,72,"2022"
"70109","316990 UBA",3,4,11,1225,11,1254,"2022"
"70110","317000 UBAI",0,1,0,135,0,136,"2022"
"70111","317005 UBAPORANGA",1,1,2,124,1,129,"2022"
"70112","317010 UBERABA",49,7,51,3493,2,3602,"2022"
"70113","317020 UBERLANDIA",21,22,94,8150,90,8377,"2022"
"70114","317030 UMBURATIBA",0,0,0,32,0,32,"2022"
"70115","317040 UNAI",0,2,6,1286,1,1295,"2022"
"70116","317043 UNIAO DE MINAS",0,0,0,39,0,39,"2022"
"70117","317047 URUANA DE MINAS",0,1,0,15,0,16,"2022"
"70118","317050 URUCANIA",0,1,2,129,1,133,"2022"
"70119","317052 URUCUIA",0,0,4,126,0,130,"2022"
"70120","317057 VARGEM ALEGRE",0,1,1,62,0,64,"2022"
"70121","317060 VARGEM BONITA",0,1,0,22,0,23,"2022"
"70122","317065 VARGEM GRANDE DO RIO PARDO",0,0,0,61,1,62,"2022"
"70123","317070 VARGINHA",5,5,17,1636,2,1665,"2022"
"70124","317075 VARJAO DE MINAS",2,0,0,82,0,84,"2022"
"70125","317080 VARZEA DA PALMA",0,7,8,397,7,419,"2022"
"70126","317090 VARZELANDIA",1,3,9,226,2,241,"2022"
"70127","317100 VAZANTE",0,0,2,204,0,206,"2022"
"70128","317103 VERDELANDIA",0,0,1,119,0,120,"2022"
"70129","317107 VEREDINHA",0,0,0,46,0,46,"2022"
"70130","317110 VERISSIMO",0,0,0,21,0,21,"2022"
"70131","317115 VERMELHO NOVO",0,0,0,51,1,52,"2022"
"70132","317120 VESPASIANO",9,8,27,1626,13,1683,"2022"
"70133","317130 VICOSA",0,5,15,862,7,889,"2022"
"70134","317140 VIEIRAS",0,0,1,25,0,26,"2022"
"70135","317150 MATHIAS LOBATO",0,1,0,36,3,40,"2022"
"70136","317160 VIRGEM DA LAPA",0,1,2,104,2,109,"2022"
"70137","317170 VIRGINIA",0,0,1,96,0,97,"2022"
"70138","317180 VIRGINOPOLIS",1,0,3,127,0,131,"2022"
"70139","317190 VIRGOLANDIA",0,2,1,41,1,45,"2022"
"70140","317200 VISCONDE DO RIO BRANCO",0,2,5,470,1,478,"2022"
"70141","317210 VOLTA GRANDE",0,0,0,52,0,52,"2022"
"70142","317220 WENCESLAU BRAZ",0,0,0,14,0,14,"2022"
"70143","320010 AFONSO CLAUDIO",1,1,5,381,2,390,"2022"
"70144","320013 AGUIA BRANCA",0,0,1,147,2,150,"2022"
"70145","320016 AGUA DOCE DO NORTE",0,1,1,163,0,165,"2022"
"70146","320020 ALEGRE",1,0,6,309,1,317,"2022"
"70147","320030 ALFREDO CHAVES",0,0,2,117,0,119,"2022"
"70148","320035 ALTO RIO NOVO",0,0,1,77,0,78,"2022"
"70149","320040 ANCHIETA",2,3,6,375,2,388,"2022"
"70150","320050 APIACA",0,1,0,67,0,68,"2022"
"70151","320060 ARACRUZ",3,2,16,1481,6,1508,"2022"
"70152","320070 ATILIO VIVACQUA",0,1,0,131,0,132,"2022"
"70153","320080 BAIXO GUANDU",1,0,9,377,1,388,"2022"
"70154","320090 BARRA DE SAO FRANCISCO",1,4,6,575,2,588,"2022"
"70155","320100 BOA ESPERANCA",0,1,2,175,2,180,"2022"
"70156","320110 BOM JESUS DO NORTE",0,1,1,73,0,75,"2022"
"70157","320115 BREJETUBA",1,4,3,217,3,228,"2022"
"70158","320120 CACHOEIRO DE ITAPEMIRIM",4,11,25,2500,2,2542,"2022"
"70159","320130 CARIACICA",7,9,51,4938,42,5047,"2022"
"70160","320140 CASTELO",0,3,4,465,3,475,"2022"
"70161","320150 COLATINA",1,6,20,1465,0,1492,"2022"
"70162","320160 CONCEICAO DA BARRA",1,0,4,394,4,403,"2022"
"70163","320170 CONCEICAO DO CASTELO",0,2,1,147,0,150,"2022"
"70164","320180 DIVINO DE SAO LOURENCO",1,0,1,58,0,60,"2022"
"70165","320190 DOMINGOS MARTINS",2,0,4,412,3,421,"2022"
"70166","320200 DORES DO RIO PRETO",0,0,1,68,0,69,"2022"
"70167","320210 ECOPORANGA",0,0,3,263,1,267,"2022"
"70168","320220 FUNDAO",1,1,2,233,4,241,"2022"
"70169","320225 GOVERNADOR LINDENBERG",2,0,0,139,0,141,"2022"
"70170","320230 GUACUI",0,0,6,436,1,443,"2022"
"70171","320240 GUARAPARI",1,0,25,1739,14,1779,"2022"
"70172","320245 IBATIBA",0,0,7,341,4,352,"2022"
"70173","320250 IBIRACU",0,0,3,137,0,140,"2022"
"70174","320255 IBITIRAMA",0,0,1,130,0,131,"2022"
"70175","320260 ICONHA",0,0,4,142,1,147,"2022"
"70176","320265 IRUPI",1,0,3,167,0,171,"2022"
"70177","320270 ITAGUACU",0,1,2,136,2,141,"2022"
"70178","320280 ITAPEMIRIM",0,2,1,560,1,564,"2022"
"70179","320290 ITARANA",0,0,2,123,1,126,"2022"
"70180","320300 IUNA",0,1,3,444,3,451,"2022"
"70181","320305 JAGUARE",1,1,6,499,0,507,"2022"
"70182","320310 JERONIMO MONTEIRO",0,1,3,139,2,145,"2022"
"70183","320313 JOAO NEIVA",1,1,2,165,0,169,"2022"
"70184","320316 LARANJA DA TERRA",0,0,0,88,0,88,"2022"
"70185","320320 LINHARES",7,6,27,2623,1,2664,"2022"
"70186","320330 MANTENOPOLIS",0,0,2,131,0,133,"2022"
"70187","320332 MARATAIZES",1,2,7,508,1,519,"2022"
"70188","320334 MARECHAL FLORIANO",0,1,3,190,3,197,"2022"
"70189","320335 MARILANDIA",0,1,0,136,0,137,"2022"
"70190","320340 MIMOSO DO SUL",1,0,3,270,1,275,"2022"
"70191","320350 MONTANHA",1,1,4,267,0,273,"2022"
"70192","320360 MUCURICI",0,0,0,69,1,70,"2022"
"70193","320370 MUNIZ FREIRE",0,2,2,206,1,211,"2022"
"70194","320380 MUQUI",1,0,0,153,0,154,"2022"
"70195","320390 NOVA VENECIA",0,4,12,683,4,703,"2022"
"70196","320400 PANCAS",0,0,5,222,1,228,"2022"
"70197","320405 PEDRO CANARIO",0,1,3,339,1,344,"2022"
"70198","320410 PINHEIROS",2,0,2,302,11,317,"2022"
"70199","320420 PIUMA",1,1,3,303,0,308,"2022"
"70200","320425 PONTO BELO",0,1,3,75,2,81,"2022"
"70201","320430 PRESIDENTE KENNEDY",1,1,2,186,0,190,"2022"
"70202","320435 RIO BANANAL",2,3,2,311,0,318,"2022"
"70203","320440 RIO NOVO DO SUL",0,1,1,125,0,127,"2022"
"70204","320450 SANTA LEOPOLDINA",2,0,1,108,0,111,"2022"
"70205","320455 SANTA MARIA DE JETIBA",4,1,2,645,4,656,"2022"
"70206","320460 SANTA TERESA",0,1,1,304,0,306,"2022"
"70207","320465 SAO DOMINGOS DO NORTE",0,0,0,107,0,107,"2022"
"70208","320470 SAO GABRIEL DA PALHA",0,4,4,412,0,420,"2022"
"70209","320480 SAO JOSE DO CALCADO",0,0,1,116,1,118,"2022"
"70210","320490 SAO MATEUS",3,4,9,1779,14,1809,"2022"
"70211","320495 SAO ROQUE DO CANAA",0,0,0,106,0,106,"2022"
"70212","320500 SERRA",21,17,87,7337,55,7517,"2022"
"70213","320501 SOORETAMA",1,5,5,421,1,433,"2022"
"70214","320503 VARGEM ALTA",0,0,1,243,1,245,"2022"
"70215","320506 VENDA NOVA DO IMIGRANTE",1,1,3,345,0,350,"2022"
"70216","320510 VIANA",2,3,12,878,4,899,"2022"
"70217","320515 VILA PAVAO",1,0,1,118,1,121,"2022"
"70218","320517 VILA VALERIO",0,1,3,223,0,227,"2022"
"70219","320520 VILA VELHA",13,20,59,5622,43,5757,"2022"
"70220","320530 VITORIA",8,12,42,3765,35,3862,"2022"
"70221","MUNICIPIO IGNORADO - RJ",0,0,0,14,2,16,"2022"
"70222","330010 ANGRA DOS REIS",2,7,44,1987,24,2064,"2022"
"70223","330015 APERIBE",0,0,3,134,1,138,"2022"
"70224","330020 ARARUAMA",2,5,37,1515,24,1583,"2022"
"70225","330022 AREAL",1,0,1,146,1,149,"2022"
"70226","330023 ARMACAO DOS BUZIOS",2,2,12,622,9,647,"2022"
"70227","330025 ARRAIAL DO CABO",2,2,12,374,0,390,"2022"
"70228","330030 BARRA DO PIRAI",3,4,20,846,6,879,"2022"
"70229","330040 BARRA MANSA",2,4,31,1779,2,1818,"2022"
"70230","330045 BELFORD ROXO",12,34,110,5675,92,5923,"2022"
"70231","330050 BOM JARDIM",7,1,4,289,0,301,"2022"
"70232","330060 BOM JESUS DO ITABAPOANA",2,4,4,489,2,501,"2022"
"70233","330070 CABO FRIO",3,6,45,2417,13,2484,"2022"
"70234","330080 CACHOEIRAS DE MACACU",1,4,8,593,4,610,"2022"
"70235","330090 CAMBUCI",0,0,3,137,0,140,"2022"
"70236","330093 CARAPEBUS",1,1,4,123,1,130,"2022"
"70237","330095 COMENDADOR LEVY GASPARIAN",1,0,0,96,0,97,"2022"
"70238","330100 CAMPOS DOS GOYTACAZES",20,29,62,6208,42,6361,"2022"
"70239","330110 CANTAGALO",0,0,1,171,2,174,"2022"
"70240","330115 CARDOSO MOREIRA",0,1,2,132,1,136,"2022"
"70241","330120 CARMO",0,0,1,155,0,156,"2022"
"70242","330130 CASIMIRO DE ABREU",0,3,4,560,0,567,"2022"
"70243","330140 CONCEICAO DE MACABU",2,0,2,240,0,244,"2022"
"70244","330150 CORDEIRO",0,1,6,224,0,231,"2022"
"70245","330160 DUAS BARRAS",0,2,4,64,1,71,"2022"
"70246","330170 DUQUE DE CAXIAS",26,46,212,10585,145,11014,"2022"
"70247","330180 ENGENHEIRO PAULO DE FRONTIN",0,1,6,120,0,127,"2022"
"70248","330185 GUAPIMIRIM",0,2,14,654,6,676,"2022"
"70249","330187 IGUABA GRANDE",0,0,6,324,0,330,"2022"
"70250","330190 ITABORAI",10,6,36,2571,26,2649,"2022"
"70251","330200 ITAGUAI",4,5,26,1584,12,1631,"2022"
"70252","330205 ITALVA",0,1,0,141,0,142,"2022"
"70253","330210 ITAOCARA",1,1,3,233,1,239,"2022"
"70254","330220 ITAPERUNA",1,5,25,1078,3,1112,"2022"
"70255","330225 ITATIAIA",0,1,7,371,2,381,"2022"
"70256","330227 JAPERI",2,9,33,1082,13,1139,"2022"
"70257","330230 LAJE DO MURIAE",0,0,1,27,0,28,"2022"
"70258","330240 MACAE",5,13,58,3102,27,3205,"2022"
"70259","330245 MACUCO",0,2,0,94,1,97,"2022"
"70260","330250 MAGE",7,9,57,2959,8,3040,"2022"
"70261","330260 MANGARATIBA",2,1,5,462,1,471,"2022"
"70262","330270 MARICA",9,5,33,2077,9,2133,"2022"
"70263","330280 MENDES",0,3,1,141,0,145,"2022"
"70264","330285 MESQUITA",4,4,35,1769,27,1839,"2022"
"70265","330290 MIGUEL PEREIRA",0,1,3,239,1,244,"2022"
"70266","330300 MIRACEMA",0,1,1,349,1,352,"2022"
"70267","330310 NATIVIDADE",0,0,3,160,0,163,"2022"
"70268","330320 NILOPOLIS",3,6,23,1309,10,1351,"2022"
"70269","330330 NITEROI",26,17,70,5039,22,5174,"2022"
"70270","330340 NOVA FRIBURGO",8,1,30,1790,7,1836,"2022"
"70271","330350 NOVA IGUACU",29,43,183,9436,120,9811,"2022"
"70272","330360 PARACAMBI",2,0,9,445,1,457,"2022"
"70273","330370 PARAIBA DO SUL",0,1,9,416,4,430,"2022"
"70274","330380 PARATY",5,1,9,576,2,593,"2022"
"70275","330385 PATY DO ALFERES",2,3,11,338,1,355,"2022"
"70276","330390 PETROPOLIS",7,15,73,3005,38,3138,"2022"
"70277","330395 PINHEIRAL",1,1,4,240,0,246,"2022"
"70278","330400 PIRAI",0,2,7,341,1,351,"2022"
"70279","330410 PORCIUNCULA",0,0,2,197,0,199,"2022"
"70280","330411 PORTO REAL",0,1,1,268,2,272,"2022"
"70281","330412 QUATIS",1,2,3,122,0,128,"2022"
"70282","330414 QUEIMADOS",7,8,35,1815,19,1884,"2022"
"70283","330415 QUISSAMA",0,1,5,293,1,300,"2022"
"70284","330420 RESENDE",4,1,26,1509,1,1541,"2022"
"70285","330430 RIO BONITO",0,1,6,606,2,615,"2022"
"70286","330440 RIO CLARO",0,3,1,179,0,183,"2022"
"70287","330450 RIO DAS FLORES",1,0,0,75,1,77,"2022"
"70288","330452 RIO DAS OSTRAS",7,11,25,1680,17,1740,"2022"
"70289","330455 RIO DE JANEIRO",141,269,1106,62684,778,64978,"2022"
"70290","330460 SANTA MARIA MADALENA",0,0,2,93,4,99,"2022"
"70291","330470 SANTO ANTONIO DE PADUA",1,2,6,442,0,451,"2022"
"70292","330475 SAO FRANCISCO DE ITABAPOANA",3,1,7,515,7,533,"2022"
"70293","330480 SAO FIDELIS",0,2,4,306,73,385,"2022"
"70294","330490 SAO GONCALO",18,24,101,8508,104,8755,"2022"
"70295","330500 SAO JOAO DA BARRA",1,1,2,485,3,492,"2022"
"70296","330510 SAO JOAO DE MERITI",20,30,92,4608,52,4802,"2022"
"70297","330513 SAO JOSE DE UBA",0,2,4,104,0,110,"2022"
"70298","330515 SAO JOSE DO VALE DO RIO PRETO",1,2,8,281,2,294,"2022"
"70299","330520 SAO PEDRO DA ALDEIA",9,3,22,1543,7,1584,"2022"
"70300","330530 SAO SEBASTIAO DO ALTO",0,0,1,67,0,68,"2022"
"70301","330540 SAPUCAIA",1,0,3,162,1,167,"2022"
"70302","330550 SAQUAREMA",1,8,20,1093,13,1135,"2022"
"70303","330555 SEROPEDICA",2,7,18,949,13,989,"2022"
"70304","330560 SILVA JARDIM",0,0,2,226,2,230,"2022"
"70305","330570 SUMIDOURO",0,1,3,204,0,208,"2022"
"70306","330575 TANGUA",0,0,2,377,1,380,"2022"
"70307","330580 TERESOPOLIS",5,5,26,1901,19,1956,"2022"
"70308","330590 TRAJANO DE MORAES",0,0,0,89,2,91,"2022"
"70309","330600 TRES RIOS",7,1,15,939,1,963,"2022"
"70310","330610 VALENCA",1,9,22,669,4,705,"2022"
"70311","330615 VARRE-SAI",0,0,6,173,0,179,"2022"
"70312","330620 VASSOURAS",0,0,9,439,2,450,"2022"
"70313","330630 VOLTA REDONDA",9,7,31,2661,9,2717,"2022"
"70314","MUNICIPIO IGNORADO - SP",0,0,0,1,4,5,"2022"
"70315","350010 ADAMANTINA",1,0,3,377,0,381,"2022"
"70316","350020 ADOLFO",0,0,0,54,0,54,"2022"
"70317","350030 AGUAI",2,1,3,362,2,370,"2022"
"70318","350040 AGUAS DA PRATA",0,1,2,66,0,69,"2022"
"70319","350050 AGUAS DE LINDOIA",1,0,2,209,1,213,"2022"
"70320","350055 AGUAS DE SANTA BARBARA",0,0,0,65,0,65,"2022"
"70321","350060 AGUAS DE SAO PEDRO",0,0,0,21,0,21,"2022"
"70322","350070 AGUDOS",1,4,3,469,2,479,"2022"
"70323","350075 ALAMBARI",1,0,1,69,0,71,"2022"
"70324","350080 ALFREDO MARCONDES",0,0,0,39,0,39,"2022"
"70325","350090 ALTAIR",0,0,0,40,0,40,"2022"
"70326","350100 ALTINOPOLIS",0,1,3,177,1,182,"2022"
"70327","350110 ALTO ALEGRE",1,0,0,28,0,29,"2022"
"70328","350115 ALUMINIO",0,0,3,177,2,182,"2022"
"70329","350120 ALVARES FLORENCE",0,0,2,32,0,34,"2022"
"70330","350130 ALVARES MACHADO",1,2,1,326,1,331,"2022"
"70331","350140 ALVARO DE CARVALHO",0,0,1,31,0,32,"2022"
"70332","350150 ALVINLANDIA",1,0,0,25,0,26,"2022"
"70333","350160 AMERICANA",4,7,29,2399,4,2443,"2022"
"70334","350170 AMERICO BRASILIENSE",1,2,3,342,4,352,"2022"
"70335","350180 AMERICO DE CAMPOS",0,0,0,41,0,41,"2022"
"70336","350190 AMPARO",0,2,7,702,1,712,"2022"
"70337","350200 ANALANDIA",0,1,2,50,0,53,"2022"
"70338","350210 ANDRADINA",0,1,5,575,1,582,"2022"
"70339","350220 ANGATUBA",0,3,2,316,0,321,"2022"
"70340","350230 ANHEMBI",0,1,3,61,1,66,"2022"
"70341","350240 ANHUMAS",0,1,0,49,0,50,"2022"
"70342","350250 APARECIDA",0,0,4,320,3,327,"2022"
"70343","350260 APARECIDA D'OESTE",0,0,0,47,0,47,"2022"
"70344","350270 APIAI",1,0,1,285,2,289,"2022"
"70345","350275 ARACARIGUAMA",1,0,5,345,1,352,"2022"
"70346","350280 ARACATUBA",4,2,18,1987,2,2013,"2022"
"70347","350290 ARACOIABA DA SERRA",0,0,6,359,1,366,"2022"
"70348","350300 ARAMINA",2,1,0,57,0,60,"2022"
"70349","350310 ARANDU",1,0,1,75,0,77,"2022"
"70350","350315 ARAPEI",0,0,0,23,0,23,"2022"
"70351","350320 ARARAQUARA",6,6,14,2460,13,2499,"2022"
"70352","350330 ARARAS",7,3,12,1406,7,1435,"2022"
"70353","350335 ARCO-IRIS",0,0,0,14,0,14,"2022"
"70354","350340 AREALVA",0,1,2,94,0,97,"2022"
"70355","350350 AREIAS",0,0,0,38,0,38,"2022"
"70356","350360 AREIOPOLIS",0,0,2,117,1,120,"2022"
"70357","350370 ARIRANHA",0,1,1,76,0,78,"2022"
"70358","350380 ARTUR NOGUEIRA",2,1,8,597,3,611,"2022"
"70359","350390 ARUJA",1,3,24,1292,1,1321,"2022"
"70360","350395 ASPASIA",0,0,0,21,0,21,"2022"
"70361","350400 ASSIS",4,3,10,946,0,963,"2022"
"70362","350410 ATIBAIA",6,10,22,1947,8,1993,"2022"
"70363","350420 AURIFLAMA",0,0,3,140,0,143,"2022"
"70364","350430 AVAI",0,0,3,69,2,74,"2022"
"70365","350440 AVANHANDAVA",0,2,0,114,0,116,"2022"
"70366","350450 AVARE",5,4,12,1065,1,1087,"2022"
"70367","350460 BADY BASSITT",1,0,3,334,0,338,"2022"
"70368","350470 BALBINOS",0,0,0,14,0,14,"2022"
"70369","350480 BALSAMO",0,0,0,101,0,101,"2022"
"70370","350490 BANANAL",2,0,1,71,1,75,"2022"
"70371","350500 BARAO DE ANTONINA",0,0,2,47,0,49,"2022"
"70372","350510 BARBOSA",0,0,0,77,0,77,"2022"
"70373","350520 BARIRI",1,2,1,335,2,341,"2022"
"70374","350530 BARRA BONITA",0,0,7,298,0,305,"2022"
"70375","350535 BARRA DO CHAPEU",0,0,1,84,2,87,"2022"
"70376","350540 BARRA DO TURVO",0,0,2,52,3,57,"2022"
"70377","350550 BARRETOS",4,1,15,1366,6,1392,"2022"
"70378","350560 BARRINHA",1,3,8,367,0,379,"2022"
"70379","350570 BARUERI",17,15,45,5156,1,5234,"2022"
"70380","350580 BASTOS",0,1,5,260,0,266,"2022"
"70381","350590 BATATAIS",3,5,5,603,5,621,"2022"
"70382","350600 BAURU",5,10,48,4231,21,4315,"2022"
"70383","350610 BEBEDOURO",2,5,4,774,0,785,"2022"
"70384","350620 BENTO DE ABREU",0,0,0,32,0,32,"2022"
"70385","350630 BERNARDINO DE CAMPOS",0,0,1,109,0,110,"2022"
"70386","350635 BERTIOGA",1,7,23,922,1,954,"2022"
"70387","350640 BILAC",0,0,0,64,0,64,"2022"
"70388","350650 BIRIGUI",2,0,12,1168,5,1187,"2022"
"70389","350660 BIRITIBA-MIRIM",0,1,0,354,3,358,"2022"
"70390","350670 BOA ESPERANCA DO SUL",0,1,2,168,3,174,"2022"
"70391","350680 BOCAINA",1,1,2,119,1,124,"2022"
"70392","350690 BOFETE",1,1,1,116,2,121,"2022"
"70393","350700 BOITUVA",1,4,11,773,1,790,"2022"
"70394","350710 BOM JESUS DOS PERDOES",0,1,0,297,0,298,"2022"
"70395","350715 BOM SUCESSO DE ITARARE",1,0,4,68,1,74,"2022"
"70396","350720 BORA",0,0,0,4,0,4,"2022"
"70397","350730 BORACEIA",0,0,1,71,0,72,"2022"
"70398","350740 BORBOREMA",2,2,0,132,1,137,"2022"
"70399","350745 BOREBI",0,0,1,23,0,24,"2022"
"70400","350750 BOTUCATU",7,9,60,1482,5,1563,"2022"
"70401","350760 BRAGANCA PAULISTA",5,8,24,2211,5,2253,"2022"
"70402","350770 BRAUNA",0,0,0,64,0,64,"2022"
"70403","350775 BREJO ALEGRE",0,0,0,24,0,24,"2022"
"70404","350780 BRODOWSKI",0,2,8,259,1,270,"2022"
"70405","350790 BROTAS",1,1,2,256,1,261,"2022"
"70406","350800 BURI",0,1,14,273,0,288,"2022"
"70407","350810 BURITAMA",0,0,4,161,0,165,"2022"
"70408","350820 BURITIZAL",0,0,0,49,1,50,"2022"
"70409","350830 CABRALIA PAULISTA",0,0,0,42,0,42,"2022"
"70410","350840 CABREUVA",0,6,10,712,3,731,"2022"
"70411","350850 CACAPAVA",3,7,9,1053,7,1079,"2022"
"70412","350860 CACHOEIRA PAULISTA",3,0,9,320,7,339,"2022"
"70413","350870 CACONDE",0,0,3,167,1,171,"2022"
"70414","350880 CAFELANDIA",2,1,3,178,0,184,"2022"
"70415","350890 CAIABU",0,0,0,37,0,37,"2022"
"70416","350900 CAIEIRAS",5,5,13,1156,6,1185,"2022"
"70417","350910 CAIUA",0,1,0,28,0,29,"2022"
"70418","350920 CAJAMAR",2,4,7,1280,5,1298,"2022"
"70419","350925 CAJATI",2,3,9,418,0,432,"2022"
"70420","350930 CAJOBI",0,0,1,84,0,85,"2022"
"70421","350940 CAJURU",1,1,2,343,0,347,"2022"
"70422","350945 CAMPINA DO MONTE ALEGRE",0,0,0,72,0,72,"2022"
"70423","350950 CAMPINAS",44,42,99,12434,35,12654,"2022"
"70424","350960 CAMPO LIMPO PAULISTA",1,4,10,820,8,843,"2022"
"70425","350970 CAMPOS DO JORDAO",0,0,9,697,0,706,"2022"
"70426","350980 CAMPOS NOVOS PAULISTA",0,1,0,46,0,47,"2022"
"70427","350990 CANANEIA",1,2,2,164,1,170,"2022"
"70428","350995 CANAS",1,0,1,60,0,62,"2022"
"70429","351000 CANDIDO MOTA",1,0,1,299,0,301,"2022"
"70430","351010 CANDIDO RODRIGUES",0,0,0,36,0,36,"2022"
"70431","351015 CANITAR",0,2,0,98,0,100,"2022"
"70432","351020 CAPAO BONITO",1,1,7,546,0,555,"2022"
"70433","351030 CAPELA DO ALTO",1,0,2,291,1,295,"2022"
"70434","351040 CAPIVARI",5,2,2,665,4,678,"2022"
"70435","351050 CARAGUATATUBA",4,0,12,1683,6,1705,"2022"
"70436","351060 CARAPICUIBA",27,22,88,5180,25,5342,"2022"
"70437","351070 CARDOSO",0,0,0,103,0,103,"2022"
"70438","351080 CASA BRANCA",1,1,6,284,0,292,"2022"
"70439","351090 CASSIA DOS COQUEIROS",0,0,0,16,0,16,"2022"
"70440","351100 CASTILHO",1,0,1,192,0,194,"2022"
"70441","351110 CATANDUVA",2,1,18,1168,3,1192,"2022"
"70442","351120 CATIGUA",0,0,0,60,0,60,"2022"
"70443","351130 CEDRAL",1,0,3,133,0,137,"2022"
"70444","351140 CERQUEIRA CESAR",1,1,3,215,0,220,"2022"
"70445","351150 CERQUILHO",0,1,6,468,0,475,"2022"
"70446","351160 CESARIO LANGE",1,1,4,231,1,238,"2022"
"70447","351170 CHARQUEADA",0,2,1,188,1,192,"2022"
"70448","351190 CLEMENTINA",0,0,2,86,0,88,"2022"
"70449","351200 COLINA",1,1,0,216,0,218,"2022"
"70450","351210 COLOMBIA",1,0,1,77,0,79,"2022"
"70451","351220 CONCHAL",2,0,6,404,1,413,"2022"
"70452","351230 CONCHAS",0,0,3,165,3,171,"2022"
"70453","351240 CORDEIROPOLIS",0,2,6,285,0,293,"2022"
"70454","351250 COROADOS",0,0,0,46,1,47,"2022"
"70455","351260 CORONEL MACEDO",0,1,3,37,0,41,"2022"
"70456","351270 CORUMBATAI",0,0,0,40,0,40,"2022"
"70457","351280 COSMOPOLIS",3,4,6,602,1,616,"2022"
"70458","351290 COSMORAMA",0,0,0,102,0,102,"2022"
"70459","351300 COTIA",21,10,37,3612,12,3692,"2022"
"70460","351310 CRAVINHOS",0,3,9,347,1,360,"2022"
"70461","351320 CRISTAIS PAULISTA",1,0,0,107,1,109,"2022"
"70462","351330 CRUZALIA",0,0,0,12,0,12,"2022"
"70463","351340 CRUZEIRO",3,6,16,827,2,854,"2022"
"70464","351350 CUBATAO",4,4,17,1304,12,1341,"2022"
"70465","351360 CUNHA",0,2,2,237,0,241,"2022"
"70466","351370 DESCALVADO",1,2,0,284,0,287,"2022"
"70467","351380 DIADEMA",11,18,63,4132,11,4235,"2022"
"70468","351385 DIRCE REIS",0,0,0,12,0,12,"2022"
"70469","351390 DIVINOLANDIA",0,0,1,114,0,115,"2022"
"70470","351400 DOBRADA",0,1,1,105,0,107,"2022"
"70471","351410 DOIS CORREGOS",1,0,1,267,2,271,"2022"
"70472","351420 DOLCINOPOLIS",0,0,0,23,0,23,"2022"
"70473","351430 DOURADO",2,0,1,82,0,85,"2022"
"70474","351440 DRACENA",0,1,2,496,0,499,"2022"
"70475","351450 DUARTINA",0,0,0,135,0,135,"2022"
"70476","351460 DUMONT",0,0,1,106,0,107,"2022"
"70477","351470 ECHAPORA",0,0,0,82,0,82,"2022"
"70478","351480 ELDORADO",2,1,1,141,1,146,"2022"
"70479","351490 ELIAS FAUSTO",1,1,6,180,2,190,"2022"
"70480","351492 ELISIARIO",0,0,0,18,0,18,"2022"
"70481","351495 EMBAUBA",0,0,1,13,0,14,"2022"
"70482","351500 EMBU DAS ARTES",8,12,40,3364,16,3440,"2022"
"70483","351510 EMBU-GUACU",0,3,11,737,4,755,"2022"
"70484","351512 EMILIANOPOLIS",0,0,1,23,0,24,"2022"
"70485","351515 ENGENHEIRO COELHO",1,0,4,251,0,256,"2022"
"70486","351518 ESPIRITO SANTO DO PINHAL",1,3,10,380,0,394,"2022"
"70487","351519 ESPIRITO SANTO DO TURVO",0,0,0,70,0,70,"2022"
"70488","351520 ESTRELA D'OESTE",0,0,3,81,0,84,"2022"
"70489","351530 ESTRELA DO NORTE",0,0,1,22,0,23,"2022"
"70490","351535 EUCLIDES DA CUNHA PAULISTA",0,1,0,92,0,93,"2022"
"70491","351540 FARTURA",0,1,3,175,0,179,"2022"
"70492","351550 FERNANDOPOLIS",4,0,9,737,1,751,"2022"
"70493","351560 FERNANDO PRESTES",0,0,0,57,0,57,"2022"
"70494","351565 FERNAO",0,0,0,19,0,19,"2022"
"70495","351570 FERRAZ DE VASCONCELOS",5,14,30,2301,23,2373,"2022"
"70496","351580 FLORA RICA",0,0,0,16,0,16,"2022"
"70497","351590 FLOREAL",0,0,0,19,0,19,"2022"
"70498","351600 FLORIDA PAULISTA",0,0,0,89,0,89,"2022"
"70499","351610 FLORINIA",0,0,0,30,0,30,"2022"
"70500","351620 FRANCA",14,15,56,4124,20,4229,"2022"
"70501","351630 FRANCISCO MORATO",6,11,30,2533,17,2597,"2022"
"70502","351640 FRANCO DA ROCHA",3,3,21,1905,11,1943,"2022"
"70503","351650 GABRIEL MONTEIRO",0,0,1,20,0,21,"2022"
"70504","351660 GALIA",0,0,4,49,0,53,"2022"
"70505","351670 GARCA",3,3,17,425,1,449,"2022"
"70506","351680 GASTAO VIDIGAL",0,0,0,25,1,26,"2022"
"70507","351685 GAVIAO PEIXOTO",1,0,1,45,0,47,"2022"
"70508","351690 GENERAL SALGADO",0,0,1,95,0,96,"2022"
"70509","351700 GETULINA",0,0,0,79,0,79,"2022"
"70510","351710 GLICERIO",1,0,0,37,0,38,"2022"
"70511","351720 GUAICARA",0,0,0,146,0,146,"2022"
"70512","351730 GUAIMBE",1,0,1,49,0,51,"2022"
"70513","351740 GUAIRA",1,5,7,422,2,437,"2022"
"70514","351750 GUAPIACU",1,0,6,227,2,236,"2022"
"70515","351760 GUAPIARA",0,1,3,190,0,194,"2022"
"70516","351770 GUARA",0,0,2,198,1,201,"2022"
"70517","351780 GUARACAI",0,0,0,47,0,47,"2022"
"70518","351790 GUARACI",0,0,4,113,0,117,"2022"
"70519","351800 GUARANI D'OESTE",1,0,0,21,0,22,"2022"
"70520","351810 GUARANTA",0,0,3,82,0,85,"2022"
"70521","351820 GUARARAPES",0,0,3,304,0,307,"2022"
"70522","351830 GUARAREMA",2,1,4,333,0,340,"2022"
"70523","351840 GUARATINGUETA",3,8,17,1285,2,1315,"2022"
"70524","351850 GUAREI",0,0,1,132,0,133,"2022"
"70525","351860 GUARIBA",2,4,8,435,0,449,"2022"
"70526","351870 GUARUJA",7,20,84,3537,19,3667,"2022"
"70527","351880 GUARULHOS",31,69,211,17231,70,17612,"2022"
"70528","351885 GUATAPARA",0,2,2,76,0,80,"2022"
"70529","351890 GUZOLANDIA",0,0,1,42,0,43,"2022"
"70530","351900 HERCULANDIA",0,0,1,106,0,107,"2022"
"70531","351905 HOLAMBRA",1,1,5,224,1,232,"2022"
"70532","351907 HORTOLANDIA",8,5,17,2682,7,2719,"2022"
"70533","351910 IACANGA",0,0,0,133,0,133,"2022"
"70534","351920 IACRI",0,1,0,66,0,67,"2022"
"70535","351925 IARAS",0,0,1,72,0,73,"2022"
"70536","351930 IBATE",0,0,17,409,0,426,"2022"
"70537","351940 IBIRA",0,0,3,127,0,130,"2022"
"70538","351950 IBIRAREMA",1,0,2,57,0,60,"2022"
"70539","351960 IBITINGA",1,4,11,700,2,718,"2022"
"70540","351970 IBIUNA",5,3,12,1027,1,1048,"2022"
"70541","351980 ICEM",0,0,0,91,0,91,"2022"
"70542","351990 IEPE",0,0,1,84,0,85,"2022"
"70543","352000 IGARACU DO TIETE",2,0,1,226,0,229,"2022"
"70544","352010 IGARAPAVA",1,1,1,275,1,279,"2022"
"70545","352020 IGARATA",0,1,0,138,0,139,"2022"
"70546","352030 IGUAPE",2,1,3,299,1,306,"2022"
"70547","352040 ILHABELA",1,3,6,475,0,485,"2022"
"70548","352042 ILHA COMPRIDA",2,0,1,141,2,146,"2022"
"70549","352044 ILHA SOLTEIRA",0,4,2,210,0,216,"2022"
"70550","352050 INDAIATUBA",8,22,51,3118,5,3204,"2022"
"70551","352060 INDIANA",0,0,1,30,0,31,"2022"
"70552","352070 INDIAPORA",0,0,0,41,0,41,"2022"
"70553","352080 INUBIA PAULISTA",0,0,1,36,0,37,"2022"
"70554","352090 IPAUSSU",4,1,1,167,0,173,"2022"
"70555","352100 IPERO",1,3,8,365,0,377,"2022"
"70556","352110 IPEUNA",0,0,2,63,0,65,"2022"
"70557","352115 IPIGUA",0,0,1,72,0,73,"2022"
"70558","352120 IPORANGA",1,0,0,48,0,49,"2022"
"70559","352130 IPUA",0,1,3,143,0,147,"2022"
"70560","352140 IRACEMAPOLIS",1,2,3,214,1,221,"2022"
"70561","352150 IRAPUA",0,0,1,51,1,53,"2022"
"70562","352160 IRAPURU",0,1,1,53,0,55,"2022"
"70563","352170 ITABERA",0,3,6,192,0,201,"2022"
"70564","352180 ITAI",0,2,5,334,1,342,"2022"
"70565","352190 ITAJOBI",1,0,4,197,0,202,"2022"
"70566","352200 ITAJU",0,0,0,36,0,36,"2022"
"70567","352210 ITANHAEM",2,12,23,1279,12,1328,"2022"
"70568","352215 ITAOCA",0,0,1,43,0,44,"2022"
"70569","352220 ITAPECERICA DA SERRA",7,9,24,2018,18,2076,"2022"
"70570","352230 ITAPETININGA",5,5,30,1913,1,1954,"2022"
"70571","352240 ITAPEVA",2,9,61,1170,10,1252,"2022"
"70572","352250 ITAPEVI",14,6,41,3463,27,3551,"2022"
"70573","352260 ITAPIRA",2,3,4,643,1,653,"2022"
"70574","352265 ITAPIRAPUA PAULISTA",0,0,1,73,1,75,"2022"
"70575","352270 ITAPOLIS",0,1,4,418,0,423,"2022"
"70576","352280 ITAPORANGA",0,1,2,166,1,170,"2022"
"70577","352290 ITAPUI",0,1,3,188,0,192,"2022"
"70578","352300 ITAPURA",0,1,0,43,0,44,"2022"
"70579","352310 ITAQUAQUECETUBA",14,28,59,5032,31,5164,"2022"
"70580","352320 ITARARE",0,2,13,551,1,567,"2022"
"70581","352330 ITARIRI",0,1,1,150,1,153,"2022"
"70582","352340 ITATIBA",7,5,14,1311,3,1340,"2022"
"70583","352350 ITATINGA",3,1,7,235,3,249,"2022"
"70584","352360 ITIRAPINA",0,1,2,154,0,157,"2022"
"70585","352370 ITIRAPUA",0,0,1,50,1,52,"2022"
"70586","352380 ITOBI",0,0,0,81,0,81,"2022"
"70587","352390 ITU",2,4,17,2069,4,2096,"2022"
"70588","352400 ITUPEVA",3,2,6,880,0,891,"2022"
"70589","352410 ITUVERAVA",3,2,8,442,5,460,"2022"
"70590","352420 JABORANDI",2,0,0,52,0,54,"2022"
"70591","352430 JABOTICABAL",1,3,9,716,0,729,"2022"
"70592","352440 JACAREI",7,12,33,2625,3,2680,"2022"
"70593","352450 JACI",0,0,1,83,0,84,"2022"
"70594","352460 JACUPIRANGA",0,0,2,178,1,181,"2022"
"70595","352470 JAGUARIUNA",0,5,7,766,3,781,"2022"
"70596","352480 JALES",0,0,1,499,0,500,"2022"
"70597","352490 JAMBEIRO",0,0,2,54,0,56,"2022"
"70598","352500 JANDIRA",4,6,17,1281,7,1315,"2022"
"70599","352510 JARDINOPOLIS",0,4,14,488,1,507,"2022"
"70600","352520 JARINU",1,1,8,406,6,422,"2022"
"70601","352530 JAU",2,1,6,1469,3,1481,"2022"
"70602","352540 JERIQUARA",0,0,0,43,0,43,"2022"
"70603","352550 JOANOPOLIS",0,1,2,119,0,122,"2022"
"70604","352560 JOAO RAMALHO",0,0,0,58,0,58,"2022"
"70605","352570 JOSE BONIFACIO",2,0,3,417,0,422,"2022"
"70606","352580 JULIO MESQUITA",1,0,0,55,0,56,"2022"
"70607","352585 JUMIRIM",0,0,1,39,0,40,"2022"
"70608","352590 JUNDIAI",5,12,55,5362,13,5447,"2022"
"70609","352600 JUNQUEIROPOLIS",0,0,2,193,0,195,"2022"
"70610","352610 JUQUIA",1,2,4,256,0,263,"2022"
"70611","352620 JUQUITIBA",1,1,7,329,7,345,"2022"
"70612","352630 LAGOINHA",0,0,0,39,0,39,"2022"
"70613","352640 LARANJAL PAULISTA",0,0,5,327,3,335,"2022"
"70614","352650 LAVINIA",0,0,0,54,0,54,"2022"
"70615","352660 LAVRINHAS",0,1,0,95,1,97,"2022"
"70616","352670 LEME",1,0,4,1005,5,1015,"2022"
"70617","352680 LENCOIS PAULISTA",2,0,16,808,1,827,"2022"
"70618","352690 LIMEIRA",5,14,41,3193,2,3255,"2022"
"70619","352700 LINDOIA",0,0,0,63,0,63,"2022"
"70620","352710 LINS",3,1,7,785,1,797,"2022"
"70621","352720 LORENA",1,1,14,999,13,1028,"2022"
"70622","352725 LOURDES",0,0,0,18,0,18,"2022"
"70623","352730 LOUVEIRA",1,0,3,705,2,711,"2022"
"70624","352740 LUCELIA",0,0,1,169,2,172,"2022"
"70625","352750 LUCIANOPOLIS",0,0,0,24,0,24,"2022"
"70626","352760 LUIS ANTONIO",0,2,0,144,0,146,"2022"
"70627","352770 LUIZIANIA",0,0,1,68,0,69,"2022"
"70628","352780 LUPERCIO",0,0,3,42,0,45,"2022"
"70629","352790 LUTECIA",0,0,0,20,0,20,"2022"
"70630","352800 MACATUBA",0,0,1,153,7,161,"2022"
"70631","352810 MACAUBAL",0,0,1,72,0,73,"2022"
"70632","352820 MACEDONIA",0,1,0,39,0,40,"2022"
"70633","352830 MAGDA",0,0,2,24,0,26,"2022"
"70634","352840 MAIRINQUE",3,1,6,572,1,583,"2022"
"70635","352850 MAIRIPORA",1,3,10,924,11,949,"2022"
"70636","352860 MANDURI",0,0,2,80,0,82,"2022"
"70637","352870 MARABA PAULISTA",0,0,0,31,0,31,"2022"
"70638","352880 MARACAI",0,0,0,106,0,106,"2022"
"70639","352885 MARAPOAMA",0,0,0,31,1,32,"2022"
"70640","352890 MARIAPOLIS",0,0,1,27,0,28,"2022"
"70641","352900 MARILIA",16,12,66,2707,11,2812,"2022"
"70642","352910 MARINOPOLIS",0,0,0,17,0,17,"2022"
"70643","352920 MARTINOPOLIS",1,2,0,257,0,260,"2022"
"70644","352930 MATAO",0,2,13,771,0,786,"2022"
"70645","352940 MAUA",4,13,72,4282,19,4390,"2022"
"70646","352950 MENDONCA",1,0,0,75,0,76,"2022"
"70647","352960 MERIDIANO",0,0,0,38,0,38,"2022"
"70648","352965 MESOPOLIS",0,0,0,20,0,20,"2022"
"70649","352970 MIGUELOPOLIS",0,0,4,224,0,228,"2022"
"70650","352980 MINEIROS DO TIETE",0,0,1,134,0,135,"2022"
"70651","352990 MIRACATU",1,4,10,230,0,245,"2022"
"70652","353000 MIRA ESTRELA",0,0,1,24,0,25,"2022"
"70653","353010 MIRANDOPOLIS",0,0,1,203,0,204,"2022"
"70654","353020 MIRANTE DO PARANAPANEMA",0,0,2,162,0,164,"2022"
"70655","353030 MIRASSOL",1,1,2,720,1,725,"2022"
"70656","353040 MIRASSOLANDIA",0,0,0,45,0,45,"2022"
"70657","353050 MOCOCA",1,1,7,705,1,715,"2022"
"70658","353060 MOGI DAS CRUZES",10,21,60,5261,41,5393,"2022"
"70659","353070 MOGI GUACU",2,6,25,1703,5,1741,"2022"
"70660","353080 MOGI MIRIM",0,2,6,897,4,909,"2022"
"70661","353090 MOMBUCA",0,0,0,52,0,52,"2022"
"70662","353100 MONCOES",0,1,0,13,0,14,"2022"
"70663","353110 MONGAGUA",2,5,11,679,6,703,"2022"
"70664","353120 MONTE ALEGRE DO SUL",0,1,0,72,0,73,"2022"
"70665","353130 MONTE ALTO",0,1,3,458,2,464,"2022"
"70666","353140 MONTE APRAZIVEL",1,0,3,211,0,215,"2022"
"70667","353150 MONTE AZUL PAULISTA",0,0,0,202,0,202,"2022"
"70668","353160 MONTE CASTELO",0,0,2,47,0,49,"2022"
"70669","353170 MONTEIRO LOBATO",1,0,0,41,1,43,"2022"
"70670","353180 MONTE MOR",3,2,6,881,1,893,"2022"
"70671","353190 MORRO AGUDO",2,1,14,298,0,315,"2022"
"70672","353200 MORUNGABA",0,0,0,190,0,190,"2022"
"70673","353205 MOTUCA",0,0,0,23,0,23,"2022"
"70674","353210 MURUTINGA DO SUL",0,0,1,31,0,32,"2022"
"70675","353215 NANTES",0,0,0,41,0,41,"2022"
"70676","353220 NARANDIBA",1,0,2,74,0,77,"2022"
"70677","353230 NATIVIDADE DA SERRA",0,1,5,57,1,64,"2022"
"70678","353240 NAZARE PAULISTA",0,1,4,203,1,209,"2022"
"70679","353250 NEVES PAULISTA",0,0,1,87,0,88,"2022"
"70680","353260 NHANDEARA",0,0,0,75,0,75,"2022"
"70681","353270 NIPOA",1,0,0,66,0,67,"2022"
"70682","353280 NOVA ALIANCA",0,0,1,72,0,73,"2022"
"70683","353282 NOVA CAMPINA",2,2,5,117,0,126,"2022"
"70684","353284 NOVA CANAA PAULISTA",0,1,0,17,0,18,"2022"
"70685","353286 NOVA CASTILHO",0,0,0,13,0,13,"2022"
"70686","353290 NOVA EUROPA",1,1,0,92,0,94,"2022"
"70687","353300 NOVA GRANADA",0,0,4,232,0,236,"2022"
"70688","353310 NOVA GUATAPORANGA",0,0,0,21,0,21,"2022"
"70689","353320 NOVA INDEPENDENCIA",0,0,1,40,0,41,"2022"
"70690","353325 NOVAIS",0,0,0,51,0,51,"2022"
"70691","353330 NOVA LUZITANIA",0,0,0,24,0,24,"2022"
"70692","353340 NOVA ODESSA",2,3,4,566,2,577,"2022"
"70693","353350 NOVO HORIZONTE",0,1,1,388,0,390,"2022"
"70694","353360 NUPORANGA",0,0,1,73,0,74,"2022"
"70695","353370 OCAUCU",0,1,1,72,0,74,"2022"
"70696","353380 OLEO",0,0,0,15,0,15,"2022"
"70697","353390 OLIMPIA",0,3,11,606,1,621,"2022"
"70698","353400 ONDA VERDE",0,0,0,52,0,52,"2022"
"70699","353410 ORIENTE",0,0,3,66,0,69,"2022"
"70700","353420 ORINDIUVA",0,0,1,74,0,75,"2022"
"70701","353430 ORLANDIA",2,0,1,410,0,413,"2022"
"70702","353440 OSASCO",39,29,75,7962,13,8118,"2022"
"70703","353450 OSCAR BRESSANE",0,0,0,15,0,15,"2022"
"70704","353460 OSVALDO CRUZ",0,2,2,310,0,314,"2022"
"70705","353470 OURINHOS",1,3,12,1154,1,1171,"2022"
"70706","353475 OUROESTE",2,0,1,89,0,92,"2022"
"70707","353480 OURO VERDE",2,0,1,95,1,99,"2022"
"70708","353490 PACAEMBU",0,1,0,92,0,93,"2022"
"70709","353500 PALESTINA",0,0,0,104,0,104,"2022"
"70710","353510 PALMARES PAULISTA",0,0,2,102,1,105,"2022"
"70711","353520 PALMEIRA D'OESTE",0,0,0,71,0,71,"2022"
"70712","353530 PALMITAL",0,1,0,182,0,183,"2022"
"70713","353540 PANORAMA",2,1,1,169,0,173,"2022"
"70714","353550 PARAGUACU PAULISTA",2,1,6,433,0,442,"2022"
"70715","353560 PARAIBUNA",1,1,0,200,1,203,"2022"
"70716","353570 PARAISO",0,0,0,60,0,60,"2022"
"70717","353580 PARANAPANEMA",0,0,4,281,0,285,"2022"
"70718","353590 PARANAPUA",0,0,0,46,0,46,"2022"
"70719","353600 PARAPUA",0,0,0,90,0,90,"2022"
"70720","353610 PARDINHO",0,0,1,100,2,103,"2022"
"70721","353620 PARIQUERA-ACU",1,0,5,231,1,238,"2022"
"70722","353625 PARISI",0,0,0,28,0,28,"2022"
"70723","353630 PATROCINIO PAULISTA",0,2,5,172,0,179,"2022"
"70724","353640 PAULICEIA",1,1,0,97,0,99,"2022"
"70725","353650 PAULINIA",7,7,6,1326,5,1351,"2022"
"70726","353657 PAULISTANIA",0,0,0,24,0,24,"2022"
"70727","353660 PAULO DE FARIA",0,1,2,71,0,74,"2022"
"70728","353670 PEDERNEIRAS",1,1,6,530,0,538,"2022"
"70729","353680 PEDRA BELA",0,0,0,74,0,74,"2022"
"70730","353690 PEDRANOPOLIS",0,0,0,18,0,18,"2022"
"70731","353700 PEDREGULHO",2,0,6,192,0,200,"2022"
"70732","353710 PEDREIRA",2,1,2,440,0,445,"2022"
"70733","353715 PEDRINHAS PAULISTA",0,0,1,33,0,34,"2022"
"70734","353720 PEDRO DE TOLEDO",0,0,1,89,1,91,"2022"
"70735","353730 PENAPOLIS",0,3,13,664,0,680,"2022"
"70736","353740 PEREIRA BARRETO",1,0,3,194,0,198,"2022"
"70737","353750 PEREIRAS",0,0,2,102,0,104,"2022"
"70738","353760 PERUIBE",1,10,21,871,2,905,"2022"
"70739","353770 PIACATU",1,0,1,52,0,54,"2022"
"70740","353780 PIEDADE",3,2,9,601,0,615,"2022"
"70741","353790 PILAR DO SUL",3,1,6,355,1,366,"2022"
"70742","353800 PINDAMONHANGABA",2,7,15,2088,5,2117,"2022"
"70743","353810 PINDORAMA",0,0,2,99,2,103,"2022"
"70744","353820 PINHALZINHO",1,1,0,126,0,128,"2022"
"70745","353830 PIQUEROBI",0,0,1,23,1,25,"2022"
"70746","353850 PIQUETE",1,0,3,105,3,112,"2022"
"70747","353860 PIRACAIA",1,2,2,353,1,359,"2022"
"70748","353870 PIRACICABA",15,8,50,4681,13,4767,"2022"
"70749","353880 PIRAJU",0,2,3,291,0,296,"2022"
"70750","353890 PIRAJUI",0,0,1,177,4,182,"2022"
"70751","353900 PIRANGI",0,0,2,118,0,120,"2022"
"70752","353910 PIRAPORA DO BOM JESUS",0,2,0,233,1,236,"2022"
"70753","353920 PIRAPOZINHO",1,1,4,251,0,257,"2022"
"70754","353930 PIRASSUNUNGA",1,1,3,759,0,764,"2022"
"70755","353940 PIRATININGA",0,0,1,163,1,165,"2022"
"70756","353950 PITANGUEIRAS",0,0,2,390,0,392,"2022"
"70757","353960 PLANALTO",0,0,0,36,0,36,"2022"
"70758","353970 PLATINA",0,0,0,32,0,32,"2022"
"70759","353980 POA",4,6,17,1225,9,1261,"2022"
"70760","353990 POLONI",0,0,0,62,0,62,"2022"
"70761","354000 POMPEIA",1,1,2,207,1,212,"2022"
"70762","354010 PONGAI",0,0,0,30,0,30,"2022"
"70763","354020 PONTAL",2,0,3,483,0,488,"2022"
"70764","354025 PONTALINDA",0,0,0,46,0,46,"2022"
"70765","354030 PONTES GESTAL",0,0,0,28,0,28,"2022"
"70766","354040 POPULINA",0,0,0,25,0,25,"2022"
"70767","354050 PORANGABA",0,0,1,91,1,93,"2022"
"70768","354060 PORTO FELIZ",0,0,8,600,1,609,"2022"
"70769","354070 PORTO FERREIRA",1,1,3,541,0,546,"2022"
"70770","354075 POTIM",1,1,0,223,7,232,"2022"
"70771","354080 POTIRENDABA",1,0,0,206,0,207,"2022"
"70772","354085 PRACINHA",0,0,0,21,0,21,"2022"
"70773","354090 PRADOPOLIS",1,0,2,147,0,150,"2022"
"70774","354100 PRAIA GRANDE",7,40,99,4053,15,4214,"2022"
"70775","354105 PRATANIA",0,0,1,80,0,81,"2022"
"70776","354110 PRESIDENTE ALVES",0,1,2,34,1,38,"2022"
"70777","354120 PRESIDENTE BERNARDES",0,0,1,120,1,122,"2022"
"70778","354130 PRESIDENTE EPITACIO",2,0,3,374,2,381,"2022"
"70779","354140 PRESIDENTE PRUDENTE",10,8,21,2415,7,2461,"2022"
"70780","354150 PRESIDENTE VENCESLAU",1,0,2,278,0,281,"2022"
"70781","354160 PROMISSAO",1,4,3,361,0,369,"2022"
"70782","354165 QUADRA",0,0,0,50,0,50,"2022"
"70783","354170 QUATA",0,0,1,158,0,159,"2022"
"70784","354180 QUEIROZ",0,0,0,51,0,51,"2022"
"70785","354190 QUELUZ",0,0,4,120,0,124,"2022"
"70786","354200 QUINTANA",0,0,0,81,0,81,"2022"
"70787","354210 RAFARD",0,0,0,103,0,103,"2022"
"70788","354220 RANCHARIA",0,2,1,297,0,300,"2022"
"70789","354230 REDENCAO DA SERRA",0,0,2,35,0,37,"2022"
"70790","354240 REGENTE FEIJO",0,0,2,198,0,200,"2022"
"70791","354250 REGINOPOLIS",0,0,0,59,1,60,"2022"
"70792","354260 REGISTRO",4,3,16,680,0,703,"2022"
"70793","354270 RESTINGA",0,1,2,80,0,83,"2022"
"70794","354280 RIBEIRA",0,0,3,34,1,38,"2022"
"70795","354290 RIBEIRAO BONITO",0,0,1,133,0,134,"2022"
"70796","354300 RIBEIRAO BRANCO",0,0,10,231,4,245,"2022"
"70797","354310 RIBEIRAO CORRENTE",0,0,3,55,0,58,"2022"
"70798","354320 RIBEIRAO DO SUL",0,0,0,51,0,51,"2022"
"70799","354323 RIBEIRAO DOS INDIOS",0,0,1,14,0,15,"2022"
"70800","354325 RIBEIRAO GRANDE",0,0,0,78,0,78,"2022"
"70801","354330 RIBEIRAO PIRES",2,2,6,1037,5,1052,"2022"
"70802","354340 RIBEIRAO PRETO",15,29,121,7750,30,7945,"2022"
"70803","354350 RIVERSUL",0,0,0,57,1,58,"2022"
"70804","354360 RIFAINA",0,0,0,45,0,45,"2022"
"70805","354370 RINCAO",0,0,0,80,0,80,"2022"
"70806","354380 RINOPOLIS",0,0,2,89,2,93,"2022"
"70807","354390 RIO CLARO",5,10,23,2190,5,2233,"2022"
"70808","354400 RIO DAS PEDRAS",0,0,1,364,0,365,"2022"
"70809","354410 RIO GRANDE DA SERRA",1,3,5,452,5,466,"2022"
"70810","354420 RIOLANDIA",0,0,1,96,0,97,"2022"
"70811","354425 ROSANA",0,0,2,199,0,201,"2022"
"70812","354430 ROSEIRA",0,0,2,90,3,95,"2022"
"70813","354440 RUBIACEA",0,0,1,21,0,22,"2022"
"70814","354450 RUBINEIA",0,0,1,35,0,36,"2022"
"70815","354460 SABINO",0,0,0,38,0,38,"2022"
"70816","354470 SAGRES",0,0,0,32,0,32,"2022"
"70817","354480 SALES",0,0,0,55,0,55,"2022"
"70818","354490 SALES OLIVEIRA",0,0,0,128,0,128,"2022"
"70819","354500 SALESOPOLIS",0,0,2,172,3,177,"2022"
"70820","354510 SALMOURAO",0,0,0,44,0,44,"2022"
"70821","354515 SALTINHO",0,0,3,82,0,85,"2022"
"70822","354520 SALTO",2,7,25,1558,5,1597,"2022"
"70823","354530 SALTO DE PIRAPORA",2,1,6,474,1,484,"2022"
"70824","354540 SALTO GRANDE",0,0,0,88,0,88,"2022"
"70825","354550 SANDOVALINA",0,0,1,46,0,47,"2022"
"70826","354560 SANTA ADELIA",0,0,1,152,0,153,"2022"
"70827","354570 SANTA ALBERTINA",0,0,0,57,0,57,"2022"
"70828","354580 SANTA BARBARA D'OESTE",7,4,18,1893,6,1928,"2022"
"70829","354600 SANTA BRANCA",0,1,1,123,0,125,"2022"
"70830","354610 SANTA CLARA D'OESTE",0,0,0,24,0,24,"2022"
"70831","354620 SANTA CRUZ DA CONCEICAO",1,0,0,29,0,30,"2022"
"70832","354625 SANTA CRUZ DA ESPERANCA",0,0,0,23,0,23,"2022"
"70833","354630 SANTA CRUZ DAS PALMEIRAS",1,1,11,328,0,341,"2022"
"70834","354640 SANTA CRUZ DO RIO PARDO",1,4,8,583,1,597,"2022"
"70835","354650 SANTA ERNESTINA",0,0,0,71,0,71,"2022"
"70836","354660 SANTA FE DO SUL",0,2,3,387,2,394,"2022"
"70837","354670 SANTA GERTRUDES",0,0,5,255,2,262,"2022"
"70838","354680 SANTA ISABEL",1,4,13,586,1,605,"2022"
"70839","354690 SANTA LUCIA",0,0,1,80,1,82,"2022"
"70840","354700 SANTA MARIA DA SERRA",1,0,2,56,0,59,"2022"
"70841","354710 SANTA MERCEDES",0,1,0,30,0,31,"2022"
"70842","354720 SANTANA DA PONTE PENSA",0,0,0,15,0,15,"2022"
"70843","354730 SANTANA DE PARNAIBA",3,6,18,2193,6,2226,"2022"
"70844","354740 SANTA RITA D'OESTE",0,0,1,19,0,20,"2022"
"70845","354750 SANTA RITA DO PASSA QUATRO",0,1,2,213,0,216,"2022"
"70846","354760 SANTA ROSA DE VITERBO",0,1,5,207,1,214,"2022"
"70847","354765 SANTA SALETE",0,0,0,12,0,12,"2022"
"70848","354770 SANTO ANASTACIO",0,0,4,180,0,184,"2022"
"70849","354780 SANTO ANDRE",14,16,78,7487,30,7625,"2022"
"70850","354790 SANTO ANTONIO DA ALEGRIA",0,0,2,76,1,79,"2022"
"70851","354800 SANTO ANTONIO DE POSSE",0,0,3,276,1,280,"2022"
"70852","354805 SANTO ANTONIO DO ARACANGUA",0,0,0,67,0,67,"2022"
"70853","354810 SANTO ANTONIO DO JARDIM",1,1,0,54,0,56,"2022"
"70854","354820 SANTO ANTONIO DO PINHAL",0,0,1,81,1,83,"2022"
"70855","354830 SANTO EXPEDITO",0,0,0,32,0,32,"2022"
"70856","354840 SANTOPOLIS DO AGUAPEI",0,0,0,47,0,47,"2022"
"70857","354850 SANTOS",6,21,65,3655,7,3754,"2022"
"70858","354860 SAO BENTO DO SAPUCAI",0,1,3,97,0,101,"2022"
"70859","354870 SAO BERNARDO DO CAMPO",20,25,101,7855,29,8030,"2022"
"70860","354880 SAO CAETANO DO SUL",4,6,8,1366,3,1387,"2022"
"70861","354890 SAO CARLOS",6,11,31,2549,10,2607,"2022"
"70862","354900 SAO FRANCISCO",0,0,0,29,0,29,"2022"
"70863","354910 SAO JOAO DA BOA VISTA",1,5,10,906,0,922,"2022"
"70864","354920 SAO JOAO DAS DUAS PONTES",0,1,0,28,0,29,"2022"
"70865","354925 SAO JOAO DE IRACEMA",0,0,0,25,0,25,"2022"
"70866","354930 SAO JOAO DO PAU D'ALHO",0,0,0,19,0,19,"2022"
"70867","354940 SAO JOAQUIM DA BARRA",0,4,21,461,0,486,"2022"
"70868","354950 SAO JOSE DA BELA VISTA",0,0,1,74,0,75,"2022"
"70869","354960 SAO JOSE DO BARREIRO",0,0,1,38,0,39,"2022"
"70870","354970 SAO JOSE DO RIO PARDO",2,1,4,531,0,538,"2022"
"70871","354980 SAO JOSE DO RIO PRETO",7,14,53,4921,9,5004,"2022"
"70872","354990 SAO JOSE DOS CAMPOS",22,33,87,7895,35,8072,"2022"
"70873","354995 SAO LOURENCO DA SERRA",0,2,3,197,2,204,"2022"
"70874","355000 SAO LUIS DO PARAITINGA",1,1,5,97,1,105,"2022"
"70875","355010 SAO MANUEL",2,2,8,410,0,422,"2022"
"70876","355020 SAO MIGUEL ARCANJO",0,1,5,345,0,351,"2022"
"70877","355030 SAO PAULO",380,529,1582,128950,609,132050,"2022"
"70878","355040 SAO PEDRO",1,2,4,402,0,409,"2022"
"70879","355050 SAO PEDRO DO TURVO",0,0,3,86,0,89,"2022"
"70880","355060 SAO ROQUE",3,3,11,885,2,904,"2022"
"70881","355070 SAO SEBASTIAO",2,5,16,1088,0,1111,"2022"
"70882","355080 SAO SEBASTIAO DA GRAMA",0,0,0,95,0,95,"2022"
"70883","355090 SAO SIMAO",0,0,2,120,1,123,"2022"
"70884","355100 SAO VICENTE",8,11,102,3344,32,3497,"2022"
"70885","355110 SARAPUI",0,0,0,110,0,110,"2022"
"70886","355120 SARUTAIA",0,0,2,47,0,49,"2022"
"70887","355130 SEBASTIANOPOLIS DO SUL",0,0,0,27,0,27,"2022"
"70888","355140 SERRA AZUL",0,0,2,102,0,104,"2022"
"70889","355150 SERRANA",5,4,7,521,5,542,"2022"
"70890","355160 SERRA NEGRA",0,1,4,247,1,253,"2022"
"70891","355170 SERTAOZINHO",9,3,19,1406,0,1437,"2022"
"70892","355180 SETE BARRAS",1,0,6,137,0,144,"2022"
"70893","355190 SEVERINIA",0,1,3,142,1,147,"2022"
"70894","355200 SILVEIRAS",1,0,2,67,1,71,"2022"
"70895","355210 SOCORRO",1,0,3,404,0,408,"2022"
"70896","355220 SOROCABA",21,21,133,8608,31,8814,"2022"
"70897","355230 SUD MENNUCCI",0,0,2,71,2,75,"2022"
"70898","355240 SUMARE",10,8,32,3192,10,3252,"2022"
"70899","355250 SUZANO",30,15,62,3852,9,3968,"2022"
"70900","355255 SUZANAPOLIS",0,0,0,30,0,30,"2022"
"70901","355260 TABAPUA",0,1,4,89,0,94,"2022"
"70902","355270 TABATINGA",1,1,4,174,0,180,"2022"
"70903","355280 TABOAO DA SERRA",8,9,49,3227,5,3298,"2022"
"70904","355290 TACIBA",0,0,0,88,0,88,"2022"
"70905","355300 TAGUAI",2,0,2,146,0,150,"2022"
"70906","355310 TAIACU",0,0,0,49,0,49,"2022"
"70907","355320 TAIUVA",0,0,1,51,0,52,"2022"
"70908","355330 TAMBAU",0,0,0,234,1,235,"2022"
"70909","355340 TANABI",1,2,3,255,0,261,"2022"
"70910","355350 TAPIRAI",0,0,1,96,2,99,"2022"
"70911","355360 TAPIRATIBA",1,0,1,87,0,89,"2022"
"70912","355365 TAQUARAL",0,0,0,20,0,20,"2022"
"70913","355370 TAQUARITINGA",2,4,11,510,0,527,"2022"
"70914","355380 TAQUARITUBA",1,0,5,268,1,275,"2022"
"70915","355385 TAQUARIVAI",0,1,4,69,0,74,"2022"
"70916","355390 TARABAI",0,0,0,63,0,63,"2022"
"70917","355395 TARUMA",0,0,2,183,0,185,"2022"
"70918","355400 TATUI",5,3,32,1649,0,1689,"2022"
"70919","355410 TAUBATE",4,17,70,3246,11,3348,"2022"
"70920","355420 TEJUPA",0,0,0,51,0,51,"2022"
"70921","355430 TEODORO SAMPAIO",1,0,1,248,0,250,"2022"
"70922","355440 TERRA ROXA",0,0,0,71,0,71,"2022"
"70923","355450 TIETE",1,3,2,433,0,439,"2022"
"70924","355460 TIMBURI",0,0,0,16,0,16,"2022"
"70925","355465 TORRE DE PEDRA",0,1,0,24,0,25,"2022"
"70926","355470 TORRINHA",0,0,0,105,0,105,"2022"
"70927","355475 TRABIJU",0,0,0,18,1,19,"2022"
"70928","355480 TREMEMBE",0,3,9,438,2,452,"2022"
"70929","355490 TRES FRONTEIRAS",0,1,0,58,0,59,"2022"
"70930","355495 TUIUTI",0,0,0,57,0,57,"2022"
"70931","355500 TUPA",0,0,10,588,0,598,"2022"
"70932","355510 TUPI PAULISTA",0,1,0,133,0,134,"2022"
"70933","355520 TURIUBA",0,0,1,14,0,15,"2022"
"70934","355530 TURMALINA",0,0,0,12,0,12,"2022"
"70935","355535 UBARANA",0,0,1,54,0,55,"2022"
"70936","355540 UBATUBA",5,4,26,1199,0,1234,"2022"
"70937","355550 UBIRAJARA",0,0,0,72,1,73,"2022"
"70938","355560 UCHOA",0,0,3,93,0,96,"2022"
"70939","355570 UNIAO PAULISTA",0,0,0,20,0,20,"2022"
"70940","355580 URANIA",0,0,0,85,0,85,"2022"
"70941","355590 URU",0,0,0,12,0,12,"2022"
"70942","355600 URUPES",1,0,2,130,3,136,"2022"
"70943","355610 VALENTIM GENTIL",0,1,1,164,0,166,"2022"
"70944","355620 VALINHOS",2,3,17,1211,0,1233,"2022"
"70945","355630 VALPARAISO",0,0,1,254,1,256,"2022"
"70946","355635 VARGEM",1,0,1,120,0,122,"2022"
"70947","355640 VARGEM GRANDE DO SUL",0,0,2,462,1,465,"2022"
"70948","355645 VARGEM GRANDE PAULISTA",3,0,4,661,2,670,"2022"
"70949","355650 VARZEA PAULISTA",2,3,24,1241,22,1292,"2022"
"70950","355660 VERA CRUZ",0,0,2,108,0,110,"2022"
"70951","355670 VINHEDO",4,8,6,862,0,880,"2022"
"70952","355680 VIRADOURO",0,0,0,211,0,211,"2022"
"70953","355690 VISTA ALEGRE DO ALTO",0,1,2,69,0,72,"2022"
"70954","355695 VITORIA BRASIL",0,0,1,25,0,26,"2022"
"70955","355700 VOTORANTIM",4,10,17,1548,12,1591,"2022"
"70956","355710 VOTUPORANGA",4,3,8,1057,1,1073,"2022"
"70957","355715 ZACARIAS",0,0,0,18,0,18,"2022"
"70958","355720 CHAVANTES",0,0,1,137,0,138,"2022"
"70959","355730 ESTIVA GERBI",0,0,0,124,2,126,"2022"
"70960","MUNICIPIO IGNORADO - PR",0,0,0,2,0,2,"2022"
"70961","410010 ABATIA",0,0,1,80,0,81,"2022"
"70962","410020 ADRIANOPOLIS",0,0,1,69,0,70,"2022"
"70963","410030 AGUDOS DO SUL",0,0,3,146,4,153,"2022"
"70964","410040 ALMIRANTE TAMANDARE",3,7,12,1534,13,1569,"2022"
"70965","410045 ALTAMIRA DO PARANA",0,0,0,42,1,43,"2022"
"70966","410050 ALTONIA",0,0,9,197,0,206,"2022"
"70967","410060 ALTO PARANA",0,1,0,164,0,165,"2022"
"70968","410070 ALTO PIQUIRI",0,0,2,118,0,120,"2022"
"70969","410080 ALVORADA DO SUL",0,0,0,92,0,92,"2022"
"70970","410090 AMAPORA",0,0,1,53,0,54,"2022"
"70971","410100 AMPERE",0,1,5,265,0,271,"2022"
"70972","410105 ANAHY",0,1,0,32,0,33,"2022"
"70973","410110 ANDIRA",2,0,2,198,1,203,"2022"
"70974","410115 ANGULO",0,0,2,42,0,44,"2022"
"70975","410120 ANTONINA",0,0,1,182,0,183,"2022"
"70976","410130 ANTONIO OLINTO",0,0,1,52,0,53,"2022"
"70977","410140 APUCARANA",4,10,17,1482,6,1519,"2022"
"70978","410150 ARAPONGAS",2,3,15,1496,1,1517,"2022"
"70979","410160 ARAPOTI",1,1,8,356,1,367,"2022"
"70980","410165 ARAPUA",0,0,0,47,0,47,"2022"
"70981","410170 ARARUNA",0,2,4,177,6,189,"2022"
"70982","410180 ARAUCARIA",0,6,30,1905,10,1951,"2022"
"70983","410185 ARIRANHA DO IVAI",0,0,1,25,0,26,"2022"
"70984","410190 ASSAI",0,1,2,148,0,151,"2022"
"70985","410200 ASSIS CHATEAUBRIAND",1,1,8,433,0,443,"2022"
"70986","410210 ASTORGA",2,0,3,314,0,319,"2022"
"70987","410220 ATALAIA",2,0,1,31,0,34,"2022"
"70988","410230 BALSA NOVA",0,3,3,159,0,165,"2022"
"70989","410240 BANDEIRANTES",0,1,4,374,0,379,"2022"
"70990","410250 BARBOSA FERRAZ",0,0,4,109,1,114,"2022"
"70991","410260 BARRACAO",0,0,3,127,1,131,"2022"
"70992","410270 BARRA DO JACARE",0,0,0,29,0,29,"2022"
"70993","410275 BELA VISTA DA CAROBA",0,0,0,47,0,47,"2022"
"70994","410280 BELA VISTA DO PARAISO",0,0,3,151,1,155,"2022"
"70995","410290 BITURUNA",0,1,2,252,0,255,"2022"
"70996","410300 BOA ESPERANCA",0,1,1,40,0,42,"2022"
"70997","410302 BOA ESPERANCA DO IGUACU",0,0,0,28,0,28,"2022"
"70998","410304 BOA VENTURA DE SAO ROQUE",0,0,1,67,0,68,"2022"
"70999","410305 BOA VISTA DA APARECIDA",1,1,1,103,0,106,"2022"
"71000","410310 BOCAIUVA DO SUL",0,0,2,166,1,169,"2022"
"71001","410315 BOM JESUS DO SUL",1,0,2,38,0,41,"2022"
"71002","410320 BOM SUCESSO",0,1,1,66,0,68,"2022"
"71003","410322 BOM SUCESSO DO SUL",0,1,0,39,0,40,"2022"
"71004","410330 BORRAZOPOLIS",0,0,1,82,1,84,"2022"
"71005","410335 BRAGANEY",0,0,0,57,0,57,"2022"
"71006","410337 BRASILANDIA DO SUL",0,0,0,43,0,43,"2022"
"71007","410340 CAFEARA",0,0,0,23,0,23,"2022"
"71008","410345 CAFELANDIA",1,3,9,248,1,262,"2022"
"71009","410347 CAFEZAL DO SUL",0,0,0,50,0,50,"2022"
"71010","410350 CALIFORNIA",0,1,0,96,1,98,"2022"
"71011","410360 CAMBARA",0,1,1,233,1,236,"2022"
"71012","410370 CAMBE",3,4,20,1230,4,1261,"2022"
"71013","410380 CAMBIRA",0,0,1,109,0,110,"2022"
"71014","410390 CAMPINA DA LAGOA",0,1,1,204,0,206,"2022"
"71015","410395 CAMPINA DO SIMAO",0,0,0,70,0,70,"2022"
"71016","410400 CAMPINA GRANDE DO SUL",3,1,8,683,0,695,"2022"
"71017","410405 CAMPO BONITO",0,0,0,57,0,57,"2022"
"71018","410410 CAMPO DO TENENTE",1,0,2,112,1,116,"2022"
"71019","410420 CAMPO LARGO",3,7,30,1497,20,1557,"2022"
"71020","410425 CAMPO MAGRO",0,2,10,327,1,340,"2022"
"71021","410430 CAMPO MOURAO",0,5,18,1165,3,1191,"2022"
"71022","410440 CANDIDO DE ABREU",0,0,5,174,2,181,"2022"
"71023","410442 CANDOI",0,0,3,192,0,195,"2022"
"71024","410445 CANTAGALO",0,0,1,176,0,177,"2022"
"71025","410450 CAPANEMA",0,0,1,272,0,273,"2022"
"71026","410460 CAPITAO LEONIDAS MARQUES",2,0,5,202,0,209,"2022"
"71027","410465 CARAMBEI",0,2,5,337,0,344,"2022"
"71028","410470 CARLOPOLIS",1,2,2,234,0,239,"2022"
"71029","410480 CASCAVEL",9,20,110,4597,1,4737,"2022"
"71030","410490 CASTRO",3,4,21,944,1,973,"2022"
"71031","410500 CATANDUVAS",0,1,4,111,0,116,"2022"
"71032","410510 CENTENARIO DO SUL",0,0,1,104,0,105,"2022"
"71033","410520 CERRO AZUL",0,0,0,204,3,207,"2022"
"71034","410530 CEU AZUL",0,0,5,98,0,103,"2022"
"71035","410540 CHOPINZINHO",0,0,8,289,1,298,"2022"
"71036","410550 CIANORTE",0,1,3,965,2,971,"2022"
"71037","410560 CIDADE GAUCHA",0,0,2,172,0,174,"2022"
"71038","410570 CLEVELANDIA",0,0,3,232,0,235,"2022"
"71039","410580 COLOMBO",9,17,55,2866,9,2956,"2022"
"71040","410590 COLORADO",0,0,4,275,0,279,"2022"
"71041","410600 CONGONHINHAS",0,2,1,112,0,115,"2022"
"71042","410610 CONSELHEIRO MAIRINCK",0,0,0,45,0,45,"2022"
"71043","410620 CONTENDA",3,2,5,215,0,225,"2022"
"71044","410630 CORBELIA",2,0,5,227,0,234,"2022"
"71045","410640 CORNELIO PROCOPIO",2,1,3,437,4,447,"2022"
"71046","410645 CORONEL DOMINGOS SOARES",1,0,1,99,0,101,"2022"
"71047","410650 CORONEL VIVIDA",0,0,3,309,1,313,"2022"
"71048","410655 CORUMBATAI DO SUL",0,0,2,37,0,39,"2022"
"71049","410657 CRUZEIRO DO IGUACU",0,0,0,35,0,35,"2022"
"71050","410660 CRUZEIRO DO OESTE",0,0,6,249,1,256,"2022"
"71051","410670 CRUZEIRO DO SUL",0,0,0,46,0,46,"2022"
"71052","410680 CRUZ MACHADO",0,0,1,197,1,199,"2022"
"71053","410685 CRUZMALTINA",0,0,0,37,0,37,"2022"
"71054","410690 CURITIBA",44,79,295,17872,106,18396,"2022"
"71055","410700 CURIUVA",1,0,0,158,0,159,"2022"
"71056","410710 DIAMANTE DO NORTE",0,0,0,42,0,42,"2022"
"71057","410712 DIAMANTE DO SUL",0,0,1,36,0,37,"2022"
"71058","410715 DIAMANTE D'OESTE",0,0,3,52,0,55,"2022"
"71059","410720 DOIS VIZINHOS",4,0,5,638,0,647,"2022"
"71060","410725 DOURADINA",1,0,1,98,0,100,"2022"
"71061","410730 DOUTOR CAMARGO",0,0,0,57,1,58,"2022"
"71062","410740 ENEAS MARQUES",1,0,2,85,0,88,"2022"
"71063","410750 ENGENHEIRO BELTRAO",0,0,5,114,0,119,"2022"
"71064","410752 ESPERANCA NOVA",0,0,1,11,0,12,"2022"
"71065","410753 ENTRE RIOS DO OESTE",0,1,0,73,0,74,"2022"
"71066","410754 ESPIGAO ALTO DO IGUACU",0,1,2,54,0,57,"2022"
"71067","410755 FAROL",0,0,0,28,0,28,"2022"
"71068","410760 FAXINAL",0,1,2,235,0,238,"2022"
"71069","410765 FAZENDA RIO GRANDE",5,15,27,1866,9,1922,"2022"
"71070","410770 FENIX",0,0,1,64,0,65,"2022"
"71071","410773 FERNANDES PINHEIRO",1,2,1,58,0,62,"2022"
"71072","410775 FIGUEIRA",1,0,0,82,0,83,"2022"
"71073","410780 FLORAI",0,0,1,44,0,45,"2022"
"71074","410785 FLOR DA SERRA DO SUL",1,0,1,64,1,67,"2022"
"71075","410790 FLORESTA",0,1,1,146,0,148,"2022"
"71076","410800 FLORESTOPOLIS",0,0,1,118,1,120,"2022"
"71077","410810 FLORIDA",0,0,3,34,0,37,"2022"
"71078","410820 FORMOSA DO OESTE",0,0,5,75,0,80,"2022"
"71079","410830 FOZ DO IGUACU",9,8,54,3938,11,4020,"2022"
"71080","410832 FRANCISCO ALVES",0,1,4,116,0,121,"2022"
"71081","410840 FRANCISCO BELTRAO",1,5,14,1246,0,1266,"2022"
"71082","410845 FOZ DO JORDAO",0,0,1,74,0,75,"2022"
"71083","410850 GENERAL CARNEIRO",0,0,2,167,0,169,"2022"
"71084","410855 GODOY MOREIRA",0,0,0,32,0,32,"2022"
"71085","410860 GOIOERE",0,0,4,294,0,298,"2022"
"71086","410865 GOIOXIM",0,0,1,101,0,102,"2022"
"71087","410870 GRANDES RIOS",0,0,1,74,0,75,"2022"
"71088","410880 GUAIRA",1,2,7,432,0,442,"2022"
"71089","410890 GUAIRACA",0,0,1,98,0,99,"2022"
"71090","410895 GUAMIRANGA",0,0,0,102,0,102,"2022"
"71091","410900 GUAPIRAMA",0,0,1,70,0,71,"2022"
"71092","410910 GUAPOREMA",0,0,0,26,0,26,"2022"
"71093","410920 GUARACI",1,0,2,52,0,55,"2022"
"71094","410930 GUARANIACU",0,1,7,158,0,166,"2022"
"71095","410940 GUARAPUAVA",5,5,24,2563,1,2598,"2022"
"71096","410950 GUARAQUECABA",0,1,0,97,0,98,"2022"
"71097","410960 GUARATUBA",1,2,10,498,3,514,"2022"
"71098","410965 HONORIO SERPA",0,0,0,63,0,63,"2022"
"71099","410970 IBAITI",1,1,4,360,0,366,"2022"
"71100","410975 IBEMA",0,0,4,79,0,83,"2022"
"71101","410980 IBIPORA",1,3,10,612,0,626,"2022"
"71102","410990 ICARAIMA",0,0,2,128,1,131,"2022"
"71103","411000 IGUARACU",0,0,0,43,0,43,"2022"
"71104","411005 IGUATU",0,0,1,16,0,17,"2022"
"71105","411007 IMBAU",0,1,3,187,0,191,"2022"
"71106","411010 IMBITUVA",3,0,8,443,0,454,"2022"
"71107","411020 INACIO MARTINS",0,0,3,143,1,147,"2022"
"71108","411030 INAJA",0,0,0,31,0,31,"2022"
"71109","411040 INDIANOPOLIS",0,0,1,45,0,46,"2022"
"71110","411050 IPIRANGA",3,1,3,173,1,181,"2022"
"71111","411060 IPORA",0,0,5,159,1,165,"2022"
"71112","411065 IRACEMA DO OESTE",0,0,1,26,0,27,"2022"
"71113","411070 IRATI",0,3,4,759,0,766,"2022"
"71114","411080 IRETAMA",0,1,3,119,0,123,"2022"
"71115","411090 ITAGUAJE",0,0,1,56,0,57,"2022"
"71116","411095 ITAIPULANDIA",0,1,2,147,3,153,"2022"
"71117","411100 ITAMBARACA",0,0,0,58,0,58,"2022"
"71118","411110 ITAMBE",0,1,0,56,0,57,"2022"
"71119","411120 ITAPEJARA D'OESTE",0,0,2,142,0,144,"2022"
"71120","411125 ITAPERUCU",0,3,8,481,8,500,"2022"
"71121","411130 ITAUNA DO SUL",0,0,0,40,0,40,"2022"
"71122","411140 IVAI",1,2,4,202,1,210,"2022"
"71123","411150 IVAIPORA",1,2,12,359,0,374,"2022"
"71124","411155 IVATE",0,0,2,68,0,70,"2022"
"71125","411160 IVATUBA",0,0,0,28,0,28,"2022"
"71126","411170 JABOTI",0,0,1,74,1,76,"2022"
"71127","411180 JACAREZINHO",2,1,2,516,1,522,"2022"
"71128","411190 JAGUAPITA",1,2,2,206,0,211,"2022"
"71129","411200 JAGUARIAIVA",0,0,8,486,1,495,"2022"
"71130","411210 JANDAIA DO SUL",1,0,6,241,0,248,"2022"
"71131","411220 JANIOPOLIS",0,0,0,65,0,65,"2022"
"71132","411230 JAPIRA",1,0,1,46,0,48,"2022"
"71133","411240 JAPURA",0,0,1,82,0,83,"2022"
"71134","411250 JARDIM ALEGRE",0,2,3,136,0,141,"2022"
"71135","411260 JARDIM OLINDA",0,0,0,14,0,14,"2022"
"71136","411270 JATAIZINHO",1,0,4,148,0,153,"2022"
"71137","411275 JESUITAS",0,1,3,93,0,97,"2022"
"71138","411280 JOAQUIM TAVORA",0,0,2,176,1,179,"2022"
"71139","411290 JUNDIAI DO SUL",0,0,0,34,0,34,"2022"
"71140","411295 JURANDA",0,1,0,88,0,89,"2022"
"71141","411300 JUSSARA",0,0,4,60,0,64,"2022"
"71142","411310 KALORE",0,0,1,43,0,44,"2022"
"71143","411320 LAPA",1,2,18,512,0,533,"2022"
"71144","411325 LARANJAL",0,0,1,87,0,88,"2022"
"71145","411330 LARANJEIRAS DO SUL",0,0,6,506,2,514,"2022"
"71146","411340 LEOPOLIS",0,0,0,37,1,38,"2022"
"71147","411342 LIDIANOPOLIS",0,0,0,28,0,28,"2022"
"71148","411345 LINDOESTE",2,0,2,82,0,86,"2022"
"71149","411350 LOANDA",0,1,4,322,0,327,"2022"
"71150","411360 LOBATO",0,0,2,37,0,39,"2022"
"71151","411370 LONDRINA",22,21,80,5968,25,6116,"2022"
"71152","411373 LUIZIANA",0,0,3,77,0,80,"2022"
"71153","411375 LUNARDELLI",0,1,1,42,0,44,"2022"
"71154","411380 LUPIONOPOLIS",0,0,0,48,1,49,"2022"
"71155","411390 MALLET",2,0,0,158,0,160,"2022"
"71156","411400 MAMBORE",0,1,2,136,0,139,"2022"
"71157","411410 MANDAGUACU",0,1,5,394,0,400,"2022"
"71158","411420 MANDAGUARI",2,1,9,434,0,446,"2022"
"71159","411430 MANDIRITUBA",2,0,4,353,2,361,"2022"
"71160","411435 MANFRINOPOLIS",0,0,0,38,0,38,"2022"
"71161","411440 MANGUEIRINHA",0,0,5,226,0,231,"2022"
"71162","411450 MANOEL RIBAS",0,0,3,219,0,222,"2022"
"71163","411460 MARECHAL CANDIDO RONDON",0,2,11,717,2,732,"2022"
"71164","411470 MARIA HELENA",0,1,1,61,0,63,"2022"
"71165","411480 MARIALVA",2,3,9,545,0,559,"2022"
"71166","411490 MARILANDIA DO SUL",0,0,4,98,0,102,"2022"
"71167","411500 MARILENA",0,0,1,91,0,92,"2022"
"71168","411510 MARILUZ",0,0,2,112,0,114,"2022"
"71169","411520 MARINGA",10,21,64,4554,4,4653,"2022"
"71170","411530 MARIOPOLIS",0,0,0,92,0,92,"2022"
"71171","411535 MARIPA",1,0,1,71,0,73,"2022"
"71172","411540 MARMELEIRO",1,0,2,209,0,212,"2022"
"71173","411545 MARQUINHO",0,0,0,52,0,52,"2022"
"71174","411550 MARUMBI",1,1,0,61,0,63,"2022"
"71175","411560 MATELANDIA",1,2,5,251,0,259,"2022"
"71176","411570 MATINHOS",3,1,5,496,4,509,"2022"
"71177","411573 MATO RICO",0,0,0,29,0,29,"2022"
"71178","411575 MAUA DA SERRA",1,0,1,122,2,126,"2022"
"71179","411580 MEDIANEIRA",1,0,14,755,0,770,"2022"
"71180","411585 MERCEDES",0,0,0,59,0,59,"2022"
"71181","411590 MIRADOR",0,0,0,29,0,29,"2022"
"71182","411600 MIRASELVA",0,0,0,7,0,7,"2022"
"71183","411605 MISSAL",0,0,1,122,0,123,"2022"
"71184","411610 MOREIRA SALES",0,0,0,119,0,119,"2022"
"71185","411620 MORRETES",0,0,4,197,3,204,"2022"
"71186","411630 MUNHOZ DE MELO",0,0,0,46,0,46,"2022"
"71187","411640 NOSSA SENHORA DAS GRACAS",0,0,0,56,0,56,"2022"
"71188","411650 NOVA ALIANCA DO IVAI",0,0,1,15,0,16,"2022"
"71189","411660 NOVA AMERICA DA COLINA",0,0,0,43,1,44,"2022"
"71190","411670 NOVA AURORA",0,1,3,150,0,154,"2022"
"71191","411680 NOVA CANTU",0,2,0,97,1,100,"2022"
"71192","411690 NOVA ESPERANCA",0,0,10,293,0,303,"2022"
"71193","411695 NOVA ESPERANCA DO SUDOESTE",0,0,2,78,0,80,"2022"
"71194","411700 NOVA FATIMA",0,0,0,71,2,73,"2022"
"71195","411705 NOVA LARANJEIRAS",1,3,1,187,2,194,"2022"
"71196","411710 NOVA LONDRINA",0,0,2,178,0,180,"2022"
"71197","411720 NOVA OLIMPIA",0,0,3,58,0,61,"2022"
"71198","411721 NOVA SANTA BARBARA",0,0,0,53,0,53,"2022"
"71199","411722 NOVA SANTA ROSA",1,0,1,95,0,97,"2022"
"71200","411725 NOVA PRATA DO IGUACU",0,0,0,128,0,128,"2022"
"71201","411727 NOVA TEBAS",0,1,7,81,0,89,"2022"
"71202","411729 NOVO ITACOLOMI",0,0,1,36,0,37,"2022"
"71203","411730 ORTIGUEIRA",2,3,8,323,2,338,"2022"
"71204","411740 OURIZONA",1,0,1,36,0,38,"2022"
"71205","411745 OURO VERDE DO OESTE",0,0,4,83,0,87,"2022"
"71206","411750 PAICANDU",4,2,11,583,1,601,"2022"
"71207","411760 PALMAS",3,4,9,793,2,811,"2022"
"71208","411770 PALMEIRA",0,5,14,445,0,464,"2022"
"71209","411780 PALMITAL",0,1,2,156,0,159,"2022"
"71210","411790 PALOTINA",0,2,5,531,0,538,"2022"
"71211","411800 PARAISO DO NORTE",0,0,3,172,0,175,"2022"
"71212","411810 PARANACITY",0,1,1,122,0,124,"2022"
"71213","411820 PARANAGUA",11,2,26,2064,17,2120,"2022"
"71214","411830 PARANAPOEMA",0,0,0,30,0,30,"2022"
"71215","411840 PARANAVAI",2,2,6,1124,1,1135,"2022"
"71216","411845 PATO BRAGADO",0,1,0,59,0,60,"2022"
"71217","411850 PATO BRANCO",2,4,11,1311,0,1328,"2022"
"71218","411860 PAULA FREITAS",0,0,3,59,1,63,"2022"
"71219","411870 PAULO FRONTIN",0,0,1,83,0,84,"2022"
"71220","411880 PEABIRU",0,1,3,156,1,161,"2022"
"71221","411885 PEROBAL",0,0,3,98,0,101,"2022"
"71222","411890 PEROLA",0,0,5,125,0,130,"2022"
"71223","411900 PEROLA D'OESTE",0,1,1,85,0,87,"2022"
"71224","411910 PIEN",0,0,3,191,3,197,"2022"
"71225","411915 PINHAIS",3,8,28,1436,10,1485,"2022"
"71226","411920 PINHALAO",0,0,1,70,0,71,"2022"
"71227","411925 PINHAL DE SAO BENTO",0,0,0,25,0,25,"2022"
"71228","411930 PINHAO",2,2,4,494,1,503,"2022"
"71229","411940 PIRAI DO SUL",0,1,8,303,0,312,"2022"
"71230","411950 PIRAQUARA",2,10,24,1436,10,1482,"2022"
"71231","411960 PITANGA",0,2,4,441,0,447,"2022"
"71232","411965 PITANGUEIRAS",0,0,0,29,0,29,"2022"
"71233","411970 PLANALTINA DO PARANA",0,0,1,65,0,66,"2022"
"71234","411980 PLANALTO",0,1,1,123,0,125,"2022"
"71235","411990 PONTA GROSSA",14,26,102,4517,4,4663,"2022"
"71236","411995 PONTAL DO PARANA",0,0,0,322,3,325,"2022"
"71237","412000 PORECATU",1,3,2,105,1,112,"2022"
"71238","412010 PORTO AMAZONAS",0,1,1,52,1,55,"2022"
"71239","412015 PORTO BARREIRO",0,0,1,40,1,42,"2022"
"71240","412020 PORTO RICO",0,0,0,28,0,28,"2022"
"71241","412030 PORTO VITORIA",0,0,1,50,0,51,"2022"
"71242","412033 PRADO FERREIRA",0,0,0,51,1,52,"2022"
"71243","412035 PRANCHITA",0,0,2,67,0,69,"2022"
"71244","412040 PRESIDENTE CASTELO BRANCO",0,0,0,36,1,37,"2022"
"71245","412050 PRIMEIRO DE MAIO",1,0,1,98,0,100,"2022"
"71246","412060 PRUDENTOPOLIS",0,1,6,599,0,606,"2022"
"71247","412065 QUARTO CENTENARIO",0,0,3,41,0,44,"2022"
"71248","412070 QUATIGUA",0,0,1,107,0,108,"2022"
"71249","412080 QUATRO BARRAS",0,0,5,291,0,296,"2022"
"71250","412085 QUATRO PONTES",0,0,1,47,0,48,"2022"
"71251","412090 QUEDAS DO IGUACU",5,1,14,432,1,453,"2022"
"71252","412100 QUERENCIA DO NORTE",0,0,3,123,0,126,"2022"
"71253","412110 QUINTA DO SOL",0,0,0,55,0,55,"2022"
"71254","412120 QUITANDINHA",2,2,0,207,1,212,"2022"
"71255","412125 RAMILANDIA",0,0,0,54,0,54,"2022"
"71256","412130 RANCHO ALEGRE",0,1,1,38,0,40,"2022"
"71257","412135 RANCHO ALEGRE D'OESTE",0,1,0,22,0,23,"2022"
"71258","412140 REALEZA",0,0,2,238,0,240,"2022"
"71259","412150 REBOUCAS",2,0,2,163,0,167,"2022"
"71260","412160 RENASCENCA",0,0,0,87,0,87,"2022"
"71261","412170 RESERVA",0,1,5,332,0,338,"2022"
"71262","412175 RESERVA DO IGUACU",0,0,1,93,0,94,"2022"
"71263","412180 RIBEIRAO CLARO",0,0,2,125,0,127,"2022"
"71264","412190 RIBEIRAO DO PINHAL",0,2,3,164,0,169,"2022"
"71265","412200 RIO AZUL",0,0,2,167,0,169,"2022"
"71266","412210 RIO BOM",0,0,1,39,0,40,"2022"
"71267","412215 RIO BONITO DO IGUACU",2,1,1,195,3,202,"2022"
"71268","412217 RIO BRANCO DO IVAI",0,1,1,44,0,46,"2022"
"71269","412220 RIO BRANCO DO SUL",0,1,5,497,3,506,"2022"
"71270","412230 RIO NEGRO",0,0,7,322,0,329,"2022"
"71271","412240 ROLANDIA",5,6,17,914,0,942,"2022"
"71272","412250 RONCADOR",0,0,2,157,0,159,"2022"
"71273","412260 RONDON",0,1,0,129,1,131,"2022"
"71274","412265 ROSARIO DO IVAI",0,0,1,57,0,58,"2022"
"71275","412270 SABAUDIA",1,0,1,110,0,112,"2022"
"71276","412280 SALGADO FILHO",0,0,2,51,0,53,"2022"
"71277","412290 SALTO DO ITARARE",0,0,1,48,0,49,"2022"
"71278","412300 SALTO DO LONTRA",0,0,0,171,0,171,"2022"
"71279","412310 SANTA AMELIA",0,0,0,38,1,39,"2022"
"71280","412320 SANTA CECILIA DO PAVAO",0,0,1,50,2,53,"2022"
"71281","412330 SANTA CRUZ DE MONTE CASTELO",0,0,0,99,0,99,"2022"
"71282","412340 SANTA FE",0,0,1,107,0,108,"2022"
"71283","412350 SANTA HELENA",0,0,1,353,1,355,"2022"
"71284","412360 SANTA INES",0,1,0,24,0,25,"2022"
"71285","412370 SANTA ISABEL DO IVAI",0,0,1,93,0,94,"2022"
"71286","412380 SANTA IZABEL DO OESTE",0,0,3,139,0,142,"2022"
"71287","412382 SANTA LUCIA",0,0,0,57,0,57,"2022"
"71288","412385 SANTA MARIA DO OESTE",1,1,1,134,1,138,"2022"
"71289","412390 SANTA MARIANA",0,0,1,138,0,139,"2022"
"71290","412395 SANTA MONICA",0,0,1,34,0,35,"2022"
"71291","412400 SANTANA DO ITARARE",0,1,1,45,0,47,"2022"
"71292","412402 SANTA TEREZA DO OESTE",0,2,4,192,0,198,"2022"
"71293","412405 SANTA TEREZINHA DE ITAIPU",5,0,2,265,5,277,"2022"
"71294","412410 SANTO ANTONIO DA PLATINA",0,3,3,561,4,571,"2022"
"71295","412420 SANTO ANTONIO DO CAIUA",0,0,0,28,0,28,"2022"
"71296","412430 SANTO ANTONIO DO PARAISO",0,0,0,25,1,26,"2022"
"71297","412440 SANTO ANTONIO DO SUDOESTE",0,0,4,263,0,267,"2022"
"71298","412450 SANTO INACIO",0,0,3,88,0,91,"2022"
"71299","412460 SAO CARLOS DO IVAI",0,0,2,72,0,74,"2022"
"71300","412470 SAO JERONIMO DA SERRA",1,0,1,124,1,127,"2022"
"71301","412480 SAO JOAO",0,1,4,138,0,143,"2022"
"71302","412490 SAO JOAO DO CAIUA",0,0,0,54,0,54,"2022"
"71303","412500 SAO JOAO DO IVAI",0,0,4,116,0,120,"2022"
"71304","412510 SAO JOAO DO TRIUNFO",0,1,2,152,0,155,"2022"
"71305","412520 SAO JORGE D'OESTE",0,0,1,129,0,130,"2022"
"71306","412530 SAO JORGE DO IVAI",0,1,0,41,0,42,"2022"
"71307","412535 SAO JORGE DO PATROCINIO",0,0,1,66,0,67,"2022"
"71308","412540 SAO JOSE DA BOA VISTA",0,0,2,64,0,66,"2022"
"71309","412545 SAO JOSE DAS PALMEIRAS",1,0,3,50,0,54,"2022"
"71310","412550 SAO JOSE DOS PINHAIS",7,17,85,4130,21,4260,"2022"
"71311","412555 SAO MANOEL DO PARANA",0,0,1,24,0,25,"2022"
"71312","412560 SAO MATEUS DO SUL",0,3,10,506,1,520,"2022"
"71313","412570 SAO MIGUEL DO IGUACU",0,3,7,390,0,400,"2022"
"71314","412575 SAO PEDRO DO IGUACU",1,0,2,65,0,68,"2022"
"71315","412580 SAO PEDRO DO IVAI",0,1,1,88,0,90,"2022"
"71316","412590 SAO PEDRO DO PARANA",0,0,0,32,0,32,"2022"
"71317","412600 SAO SEBASTIAO DA AMOREIRA",0,1,0,89,0,90,"2022"
"71318","412610 SAO TOME",0,0,0,55,0,55,"2022"
"71319","412620 SAPOPEMA",0,0,2,87,0,89,"2022"
"71320","412625 SARANDI",6,7,25,1453,1,1492,"2022"
"71321","412627 SAUDADE DO IGUACU",1,0,0,94,0,95,"2022"
"71322","412630 SENGES",1,0,5,224,1,231,"2022"
"71323","412635 SERRANOPOLIS DO IGUACU",1,0,0,66,0,67,"2022"
"71324","412640 SERTANEJA",0,0,0,52,0,52,"2022"
"71325","412650 SERTANOPOLIS",0,0,4,164,0,168,"2022"
"71326","412660 SIQUEIRA CAMPOS",0,0,3,264,0,267,"2022"
"71327","412665 SULINA",0,0,2,42,0,44,"2022"
"71328","412667 TAMARANA",0,0,4,161,1,166,"2022"
"71329","412670 TAMBOARA",0,0,0,54,0,54,"2022"
"71330","412680 TAPEJARA",0,0,1,178,0,179,"2022"
"71331","412690 TAPIRA",0,0,2,62,1,65,"2022"
"71332","412700 TEIXEIRA SOARES",2,0,1,136,0,139,"2022"
"71333","412710 TELEMACO BORBA",2,4,13,1023,0,1042,"2022"
"71334","412720 TERRA BOA",0,2,3,203,2,210,"2022"
"71335","412730 TERRA RICA",0,0,1,161,0,162,"2022"
"71336","412740 TERRA ROXA",0,0,10,214,3,227,"2022"
"71337","412750 TIBAGI",1,2,5,249,0,257,"2022"
"71338","412760 TIJUCAS DO SUL",0,3,3,199,1,206,"2022"
"71339","412770 TOLEDO",10,15,43,1940,7,2015,"2022"
"71340","412780 TOMAZINA",0,0,0,77,0,77,"2022"
"71341","412785 TRES BARRAS DO PARANA",1,2,3,145,0,151,"2022"
"71342","412788 TUNAS DO PARANA",1,1,1,98,2,103,"2022"
"71343","412790 TUNEIRAS DO OESTE",0,0,0,89,0,89,"2022"
"71344","412795 TUPASSI",0,0,3,78,0,81,"2022"
"71345","412796 TURVO",2,0,1,204,0,207,"2022"
"71346","412800 UBIRATA",0,3,4,290,0,297,"2022"
"71347","412810 UMUARAMA",2,6,27,1479,0,1514,"2022"
"71348","412820 UNIAO DA VITORIA",2,1,13,733,2,751,"2022"
"71349","412830 UNIFLOR",0,0,0,18,0,18,"2022"
"71350","412840 URAI",0,0,0,88,0,88,"2022"
"71351","412850 WENCESLAU BRAZ",0,1,2,267,0,270,"2022"
"71352","412853 VENTANIA",0,0,3,130,0,133,"2022"
"71353","412855 VERA CRUZ DO OESTE",0,1,4,89,0,94,"2022"
"71354","412860 VERE",0,0,0,101,0,101,"2022"
"71355","412862 ALTO PARAISO",0,0,3,54,0,57,"2022"
"71356","412863 DOUTOR ULYSSES",0,0,0,70,0,70,"2022"
"71357","412865 VIRMOND",0,0,0,53,1,54,"2022"
"71358","412870 VITORINO",0,0,1,125,0,126,"2022"
"71359","412880 XAMBRE",0,0,2,67,0,69,"2022"
"71360","MUNICIPIO IGNORADO - SC",0,0,0,2,0,2,"2022"
"71361","420005 ABDON BATISTA",0,0,0,33,0,33,"2022"
"71362","420010 ABELARDO LUZ",0,1,2,256,1,260,"2022"
"71363","420020 AGROLANDIA",0,1,3,139,0,143,"2022"
"71364","420030 AGRONOMICA",1,1,0,69,0,71,"2022"
"71365","420040 AGUA DOCE",0,1,1,84,0,86,"2022"
"71366","420050 AGUAS DE CHAPECO",0,0,2,75,0,77,"2022"
"71367","420055 AGUAS FRIAS",0,0,0,39,0,39,"2022"
"71368","420060 AGUAS MORNAS",0,1,1,80,0,82,"2022"
"71369","420070 ALFREDO WAGNER",0,1,3,107,0,111,"2022"
"71370","420075 ALTO BELA VISTA",0,0,0,16,0,16,"2022"
"71371","420080 ANCHIETA",0,0,3,69,0,72,"2022"
"71372","420090 ANGELINA",0,0,0,54,1,55,"2022"
"71373","420100 ANITA GARIBALDI",2,2,4,92,2,102,"2022"
"71374","420110 ANITAPOLIS",0,0,1,40,1,42,"2022"
"71375","420120 ANTONIO CARLOS",0,0,1,144,1,146,"2022"
"71376","420125 APIUNA",0,0,4,135,0,139,"2022"
"71377","420127 ARABUTA",0,0,3,38,0,41,"2022"
"71378","420130 ARAQUARI",2,2,14,731,11,760,"2022"
"71379","420140 ARARANGUA",2,7,12,907,3,931,"2022"
"71380","420150 ARMAZEM",0,0,1,121,1,123,"2022"
"71381","420160 ARROIO TRINTA",1,0,0,40,0,41,"2022"
"71382","420165 ARVOREDO",0,0,0,30,0,30,"2022"
"71383","420170 ASCURRA",1,0,1,81,2,85,"2022"
"71384","420180 ATALANTA",0,0,3,35,0,38,"2022"
"71385","420190 AURORA",0,0,5,81,0,86,"2022"
"71386","420195 BALNEARIO ARROIO DO SILVA",2,1,4,186,0,193,"2022"
"71387","420200 BALNEARIO CAMBORIU",0,3,30,1570,5,1608,"2022"
"71388","420205 BALNEARIO BARRA DO SUL",2,0,7,124,3,136,"2022"
"71389","420207 BALNEARIO GAIVOTA",0,0,2,167,0,169,"2022"
"71390","420208 BANDEIRANTE",1,1,0,38,0,40,"2022"
"71391","420209 BARRA BONITA",0,0,0,19,0,19,"2022"
"71392","420210 BARRA VELHA",2,3,11,581,5,602,"2022"
"71393","420213 BELA VISTA DO TOLDO",0,0,0,75,0,75,"2022"
"71394","420215 BELMONTE",0,0,0,35,0,35,"2022"
"71395","420220 BENEDITO NOVO",0,0,1,124,0,125,"2022"
"71396","420230 BIGUACU",2,4,23,914,4,947,"2022"
"71397","420240 BLUMENAU",4,16,43,4296,20,4379,"2022"
"71398","420243 BOCAINA DO SUL",0,0,2,35,0,37,"2022"
"71399","420245 BOMBINHAS",2,0,6,299,3,310,"2022"
"71400","420250 BOM JARDIM DA SERRA",0,0,0,48,0,48,"2022"
"71401","420253 BOM JESUS",0,0,0,37,0,37,"2022"
"71402","420257 BOM JESUS DO OESTE",0,0,0,21,0,21,"2022"
"71403","420260 BOM RETIRO",0,1,3,129,0,133,"2022"
"71404","420270 BOTUVERA",0,0,1,48,0,49,"2022"
"71405","420280 BRACO DO NORTE",1,2,3,510,3,519,"2022"
"71406","420285 BRACO DO TROMBUDO",0,0,2,51,1,54,"2022"
"71407","420287 BRUNOPOLIS",0,0,0,36,0,36,"2022"
"71408","420290 BRUSQUE",1,4,17,1972,6,2000,"2022"
"71409","420300 CACADOR",4,6,11,1037,4,1062,"2022"
"71410","420310 CAIBI",0,0,1,71,0,72,"2022"
"71411","420315 CALMON",0,0,2,44,1,47,"2022"
"71412","420320 CAMBORIU",4,8,28,1500,9,1549,"2022"
"71413","420325 CAPAO ALTO",0,0,2,26,1,29,"2022"
"71414","420330 CAMPO ALEGRE",0,0,1,156,0,157,"2022"
"71415","420340 CAMPO BELO DO SUL",0,0,9,83,0,92,"2022"
"71416","420350 CAMPO ERE",0,3,2,130,0,135,"2022"
"71417","420360 CAMPOS NOVOS",1,6,4,533,1,545,"2022"
"71418","420370 CANELINHA",0,0,6,154,0,160,"2022"
"71419","420380 CANOINHAS",4,1,10,712,1,728,"2022"
"71420","420390 CAPINZAL",0,1,4,372,1,378,"2022"
"71421","420395 CAPIVARI DE BAIXO",1,1,2,238,0,242,"2022"
"71422","420400 CATANDUVAS",0,0,4,187,2,193,"2022"
"71423","420410 CAXAMBU DO SUL",0,0,1,64,0,65,"2022"
"71424","420415 CELSO RAMOS",0,0,0,30,0,30,"2022"
"71425","420417 CERRO NEGRO",0,0,5,35,0,40,"2022"
"71426","420419 CHAPADAO DO LAGEADO",0,0,1,29,0,30,"2022"
"71427","420420 CHAPECO",13,23,58,3716,1,3811,"2022"
"71428","420425 COCAL DO SUL",1,0,6,186,0,193,"2022"
"71429","420430 CONCORDIA",0,2,16,1110,2,1130,"2022"
"71430","420435 CORDILHEIRA ALTA",0,0,0,44,0,44,"2022"
"71431","420440 CORONEL FREITAS",2,0,1,130,0,133,"2022"
"71432","420445 CORONEL MARTINS",0,0,0,30,0,30,"2022"
"71433","420450 CORUPA",0,0,3,191,0,194,"2022"
"71434","420455 CORREIA PINTO",0,1,13,184,1,199,"2022"
"71435","420460 CRICIUMA",5,7,44,2770,8,2834,"2022"
"71436","420470 CUNHA PORA",0,1,2,134,0,137,"2022"
"71437","420475 CUNHATAI",0,1,0,15,0,16,"2022"
"71438","420480 CURITIBANOS",1,3,9,590,2,605,"2022"
"71439","420490 DESCANSO",0,1,1,83,0,85,"2022"
"71440","420500 DIONISIO CERQUEIRA",1,0,6,183,1,191,"2022"
"71441","420510 DONA EMMA",0,0,2,49,1,52,"2022"
"71442","420515 DOUTOR PEDRINHO",0,0,0,38,0,38,"2022"
"71443","420517 ENTRE RIOS",0,0,0,57,0,57,"2022"
"71444","420519 ERMO",0,0,0,28,0,28,"2022"
"71445","420520 ERVAL VELHO",0,0,0,63,0,63,"2022"
"71446","420530 FAXINAL DOS GUEDES",0,0,1,164,0,165,"2022"
"71447","420535 FLOR DO SERTAO",0,0,0,23,0,23,"2022"
"71448","420540 FLORIANOPOLIS",13,17,71,5944,37,6082,"2022"
"71449","420543 FORMOSA DO SUL",0,0,1,29,0,30,"2022"
"71450","420545 FORQUILHINHA",1,2,4,471,2,480,"2022"
"71451","420550 FRAIBURGO",1,1,13,545,1,561,"2022"
"71452","420555 FREI ROGERIO",0,0,1,33,0,34,"2022"
"71453","420560 GALVAO",0,0,2,44,0,46,"2022"
"71454","420570 GAROPABA",0,1,2,336,1,340,"2022"
"71455","420580 GARUVA",1,0,6,295,3,305,"2022"
"71456","420590 GASPAR",1,1,10,961,2,975,"2022"
"71457","420600 GOVERNADOR CELSO RAMOS",1,1,5,203,1,211,"2022"
"71458","420610 GRAO PARA",0,0,3,107,0,110,"2022"
"71459","420620 GRAVATAL",2,0,2,121,0,125,"2022"
"71460","420630 GUABIRUBA",1,2,0,311,2,316,"2022"
"71461","420640 GUARACIABA",1,2,1,98,0,102,"2022"
"71462","420650 GUARAMIRIM",2,3,14,654,1,674,"2022"
"71463","420660 GUARUJA DO SUL",0,1,1,53,0,55,"2022"
"71464","420665 GUATAMBU",0,0,0,125,0,125,"2022"
"71465","420670 HERVAL D'OESTE",0,2,7,272,1,282,"2022"
"71466","420675 IBIAM",0,0,0,22,0,22,"2022"
"71467","420680 IBICARE",0,0,0,37,0,37,"2022"
"71468","420690 IBIRAMA",0,0,6,263,1,270,"2022"
"71469","420700 ICARA",0,3,13,761,6,783,"2022"
"71470","420710 ILHOTA",0,1,3,178,0,182,"2022"
"71471","420720 IMARUI",0,0,1,92,1,94,"2022"
"71472","420730 IMBITUBA",2,0,10,661,0,673,"2022"
"71473","420740 IMBUIA",0,1,3,75,0,79,"2022"
"71474","420750 INDAIAL",1,1,10,887,1,900,"2022"
"71475","420757 IOMERE",0,0,1,31,0,32,"2022"
"71476","420760 IPIRA",0,0,1,43,0,44,"2022"
"71477","420765 IPORA DO OESTE",0,0,1,102,0,103,"2022"
"71478","420768 IPUACU",1,0,5,132,3,141,"2022"
"71479","420770 IPUMIRIM",0,0,6,95,0,101,"2022"
"71480","420775 IRACEMINHA",0,0,0,46,0,46,"2022"
"71481","420780 IRANI",1,0,2,133,0,136,"2022"
"71482","420785 IRATI",0,0,0,32,0,32,"2022"
"71483","420790 IRINEOPOLIS",1,0,1,123,0,125,"2022"
"71484","420800 ITA",0,1,1,74,0,76,"2022"
"71485","420810 ITAIOPOLIS",0,0,3,311,1,315,"2022"
"71486","420820 ITAJAI",8,12,54,3607,25,3706,"2022"
"71487","420830 ITAPEMA",2,3,20,1075,2,1102,"2022"
"71488","420840 ITAPIRANGA",0,0,3,190,0,193,"2022"
"71489","420845 ITAPOA",0,1,7,299,4,311,"2022"
"71490","420850 ITUPORANGA",1,1,15,397,0,414,"2022"
"71491","420860 JABORA",0,0,2,49,0,51,"2022"
"71492","420870 JACINTO MACHADO",0,0,2,117,1,120,"2022"
"71493","420880 JAGUARUNA",1,0,2,268,0,271,"2022"
"71494","420890 JARAGUA DO SUL",7,11,39,2343,4,2404,"2022"
"71495","420895 JARDINOPOLIS",0,0,0,16,0,16,"2022"
"71496","420900 JOACABA",6,0,7,379,0,392,"2022"
"71497","420910 JOINVILLE",18,33,139,7280,27,7497,"2022"
"71498","420915 JOSE BOITEUX",0,0,3,88,1,92,"2022"
"71499","420917 JUPIA",0,0,0,29,0,29,"2022"
"71500","420920 LACERDOPOLIS",0,0,1,26,0,27,"2022"
"71501","420930 LAGES",2,20,138,1928,12,2100,"2022"
"71502","420940 LAGUNA",1,2,6,431,1,441,"2022"
"71503","420945 LAJEADO GRANDE",0,0,0,22,0,22,"2022"
"71504","420950 LAURENTINO",0,0,1,99,0,100,"2022"
"71505","420960 LAURO MULLER",3,1,5,145,1,155,"2022"
"71506","420970 LEBON REGIS",0,0,3,174,0,177,"2022"
"71507","420980 LEOBERTO LEAL",0,0,5,36,0,41,"2022"
"71508","420985 LINDOIA DO SUL",0,0,1,54,0,55,"2022"
"71509","420990 LONTRAS",1,0,6,170,0,177,"2022"
"71510","421000 LUIZ ALVES",1,0,3,185,1,190,"2022"
"71511","421003 LUZERNA",0,0,1,61,0,62,"2022"
"71512","421005 MACIEIRA",0,0,0,18,0,18,"2022"
"71513","421010 MAFRA",2,3,12,729,1,747,"2022"
"71514","421020 MAJOR GERCINO",0,0,2,36,1,39,"2022"
"71515","421030 MAJOR VIEIRA",0,0,0,80,0,80,"2022"
"71516","421040 MARACAJA",0,0,0,114,0,114,"2022"
"71517","421050 MARAVILHA",1,1,7,391,0,400,"2022"
"71518","421055 MAREMA",0,0,0,20,0,20,"2022"
"71519","421060 MASSARANDUBA",0,1,2,196,0,199,"2022"
"71520","421070 MATOS COSTA",0,0,0,26,1,27,"2022"
"71521","421080 MELEIRO",0,1,1,85,0,87,"2022"
"71522","421085 MIRIM DOCE",0,0,0,32,0,32,"2022"
"71523","421090 MODELO",1,0,2,56,0,59,"2022"
"71524","421100 MONDAI",0,1,2,122,0,125,"2022"
"71525","421105 MONTE CARLO",0,2,5,160,0,167,"2022"
"71526","421110 MONTE CASTELO",0,0,1,114,0,115,"2022"
"71527","421120 MORRO DA FUMACA",1,0,4,234,3,242,"2022"
"71528","421125 MORRO GRANDE",0,0,0,35,0,35,"2022"
"71529","421130 NAVEGANTES",3,4,11,1398,4,1420,"2022"
"71530","421140 NOVA ERECHIM",0,0,2,72,0,74,"2022"
"71531","421145 NOVA ITABERABA",0,0,1,41,0,42,"2022"
"71532","421150 NOVA TRENTO",0,0,0,149,1,150,"2022"
"71533","421160 NOVA VENEZA",0,1,4,140,1,146,"2022"
"71534","421165 NOVO HORIZONTE",0,0,0,26,0,26,"2022"
"71535","421170 ORLEANS",0,2,5,288,1,296,"2022"
"71536","421175 OTACILIO COSTA",0,2,12,207,0,221,"2022"
"71537","421180 OURO",0,0,0,77,0,77,"2022"
"71538","421185 OURO VERDE",1,0,0,30,0,31,"2022"
"71539","421187 PAIAL",0,0,0,22,0,22,"2022"
"71540","421189 PAINEL",0,0,3,28,0,31,"2022"
"71541","421190 PALHOCA",4,11,48,2766,16,2845,"2022"
"71542","421200 PALMA SOLA",0,0,1,113,0,114,"2022"
"71543","421205 PALMEIRA",1,0,3,31,0,35,"2022"
"71544","421210 PALMITOS",2,1,0,167,0,170,"2022"
"71545","421220 PAPANDUVA",2,0,3,228,1,234,"2022"
"71546","421223 PARAISO",1,0,0,49,0,50,"2022"
"71547","421225 PASSO DE TORRES",0,0,3,137,0,140,"2022"
"71548","421227 PASSOS MAIA",0,0,0,62,0,62,"2022"
"71549","421230 PAULO LOPES",0,0,2,80,1,83,"2022"
"71550","421240 PEDRAS GRANDES",0,0,0,44,1,45,"2022"
"71551","421250 PENHA",1,2,9,420,5,437,"2022"
"71552","421260 PERITIBA",0,0,0,27,0,27,"2022"
"71553","421265 PESCARIA BRAVA",0,0,1,101,0,102,"2022"
"71554","421270 PETROLANDIA",0,1,6,76,0,83,"2022"
"71555","421280 BALNEARIO PICARRAS",0,0,6,376,4,386,"2022"
"71556","421290 PINHALZINHO",0,1,3,297,0,301,"2022"
"71557","421300 PINHEIRO PRETO",0,0,0,62,0,62,"2022"
"71558","421310 PIRATUBA",1,0,2,68,0,71,"2022"
"71559","421315 PLANALTO ALEGRE",0,0,1,43,1,45,"2022"
"71560","421320 POMERODE",0,1,14,397,0,412,"2022"
"71561","421330 PONTE ALTA",1,0,2,53,0,56,"2022"
"71562","421335 PONTE ALTA DO NORTE",0,0,1,53,0,54,"2022"
"71563","421340 PONTE SERRADA",0,2,4,160,0,166,"2022"
"71564","421350 PORTO BELO",1,1,3,325,1,331,"2022"
"71565","421360 PORTO UNIAO",0,1,8,373,0,382,"2022"
"71566","421370 POUSO REDONDO",0,0,4,213,1,218,"2022"
"71567","421380 PRAIA GRANDE",0,0,2,99,0,101,"2022"
"71568","421390 PRESIDENTE CASTELLO BRANCO",0,0,0,14,0,14,"2022"
"71569","421400 PRESIDENTE GETULIO",1,0,5,289,3,298,"2022"
"71570","421410 PRESIDENTE NEREU",0,0,1,17,0,18,"2022"
"71571","421415 PRINCESA",1,0,0,41,0,42,"2022"
"71572","421420 QUILOMBO",0,2,4,147,0,153,"2022"
"71573","421430 RANCHO QUEIMADO",0,0,1,31,0,32,"2022"
"71574","421440 RIO DAS ANTAS",0,1,0,74,0,75,"2022"
"71575","421450 RIO DO CAMPO",0,0,3,79,0,82,"2022"
"71576","421460 RIO DO OESTE",0,0,1,95,0,96,"2022"
"71577","421470 RIO DOS CEDROS",0,0,0,113,0,113,"2022"
"71578","421480 RIO DO SUL",1,1,16,864,1,883,"2022"
"71579","421490 RIO FORTUNA",0,1,3,66,0,70,"2022"
"71580","421500 RIO NEGRINHO",1,1,8,602,0,612,"2022"
"71581","421505 RIO RUFINO",0,0,2,28,1,31,"2022"
"71582","421507 RIQUEZA",0,0,1,52,0,53,"2022"
"71583","421510 RODEIO",0,0,1,127,1,129,"2022"
"71584","421520 ROMELANDIA",0,0,0,31,0,31,"2022"
"71585","421530 SALETE",1,0,1,100,0,102,"2022"
"71586","421535 SALTINHO",0,0,0,45,0,45,"2022"
"71587","421540 SALTO VELOSO",0,0,0,49,0,49,"2022"
"71588","421545 SANGAO",0,0,2,154,1,157,"2022"
"71589","421550 SANTA CECILIA",1,2,4,250,2,259,"2022"
"71590","421555 SANTA HELENA",0,0,1,26,0,27,"2022"
"71591","421560 SANTA ROSA DE LIMA",0,0,1,20,0,21,"2022"
"71592","421565 SANTA ROSA DO SUL",0,1,6,113,0,120,"2022"
"71593","421567 SANTA TEREZINHA",0,0,3,86,2,91,"2022"
"71594","421568 SANTA TEREZINHA DO PROGRESSO",1,0,0,32,0,33,"2022"
"71595","421569 SANTIAGO DO SUL",0,0,0,20,0,20,"2022"
"71596","421570 SANTO AMARO DA IMPERATRIZ",1,0,8,341,2,352,"2022"
"71597","421575 SAO BERNARDINO",0,0,0,40,0,40,"2022"
"71598","421580 SAO BENTO DO SUL",0,3,9,1010,3,1025,"2022"
"71599","421590 SAO BONIFACIO",0,0,0,24,0,24,"2022"
"71600","421600 SAO CARLOS",0,0,1,102,0,103,"2022"
"71601","421605 SAO CRISTOVAO DO SUL",0,0,1,57,1,59,"2022"
"71602","421610 SAO DOMINGOS",0,0,1,104,2,107,"2022"
"71603","421620 SAO FRANCISCO DO SUL",4,3,17,595,4,623,"2022"
"71604","421625 SAO JOAO DO OESTE",0,0,0,71,0,71,"2022"
"71605","421630 SAO JOAO BATISTA",1,1,12,492,3,509,"2022"
"71606","421635 SAO JOAO DO ITAPERIU",0,0,4,72,0,76,"2022"
"71607","421640 SAO JOAO DO SUL",0,1,0,111,2,114,"2022"
"71608","421650 SAO JOAQUIM",0,7,22,368,0,397,"2022"
"71609","421660 SAO JOSE",3,14,67,3041,15,3140,"2022"
"71610","421670 SAO JOSE DO CEDRO",0,2,3,154,0,159,"2022"
"71611","421680 SAO JOSE DO CERRITO",0,0,7,90,1,98,"2022"
"71612","421690 SAO LOURENCO DO OESTE",1,2,4,352,0,359,"2022"
"71613","421700 SAO LUDGERO",0,1,2,206,2,211,"2022"
"71614","421710 SAO MARTINHO",0,1,1,50,0,52,"2022"
"71615","421715 SAO MIGUEL DA BOA VISTA",0,0,0,27,0,27,"2022"
"71616","421720 SAO MIGUEL DO OESTE",2,1,5,533,0,541,"2022"
"71617","421725 SAO PEDRO DE ALCANTARA",0,0,0,29,1,30,"2022"
"71618","421730 SAUDADES",0,0,1,118,0,119,"2022"
"71619","421740 SCHROEDER",1,2,7,250,0,260,"2022"
"71620","421750 SEARA",0,0,1,268,1,270,"2022"
"71621","421755 SERRA ALTA",1,0,0,38,0,39,"2022"
"71622","421760 SIDEROPOLIS",0,1,1,125,1,128,"2022"
"71623","421770 SOMBRIO",1,0,4,364,1,370,"2022"
"71624","421775 SUL BRASIL",0,0,0,31,0,31,"2022"
"71625","421780 TAIO",1,0,4,265,2,272,"2022"
"71626","421790 TANGARA",0,0,0,81,0,81,"2022"
"71627","421795 TIGRINHOS",0,0,0,25,0,25,"2022"
"71628","421800 TIJUCAS",2,1,13,758,4,778,"2022"
"71629","421810 TIMBE DO SUL",0,0,0,76,0,76,"2022"
"71630","421820 TIMBO",1,1,4,492,1,499,"2022"
"71631","421825 TIMBO GRANDE",0,1,1,102,0,104,"2022"
"71632","421830 TRES BARRAS",0,1,4,322,0,327,"2022"
"71633","421835 TREVISO",0,1,0,17,1,19,"2022"
"71634","421840 TREZE DE MAIO",0,1,0,101,0,102,"2022"
"71635","421850 TREZE TILIAS",0,0,2,115,0,117,"2022"
"71636","421860 TROMBUDO CENTRAL",0,0,3,93,1,97,"2022"
"71637","421870 TUBARAO",3,6,16,1414,4,1443,"2022"
"71638","421875 TUNAPOLIS",1,0,0,55,0,56,"2022"
"71639","421880 TURVO",0,0,3,153,3,159,"2022"
"71640","421885 UNIAO DO OESTE",0,0,0,29,0,29,"2022"
"71641","421890 URUBICI",0,0,7,105,1,113,"2022"
"71642","421895 URUPEMA",0,0,2,43,1,46,"2022"
"71643","421900 URUSSANGA",0,0,2,229,0,231,"2022"
"71644","421910 VARGEAO",0,0,1,44,0,45,"2022"
"71645","421915 VARGEM",0,1,0,26,0,27,"2022"
"71646","421917 VARGEM BONITA",0,0,1,62,0,63,"2022"
"71647","421920 VIDAL RAMOS",1,0,3,69,0,73,"2022"
"71648","421930 VIDEIRA",0,1,5,824,0,830,"2022"
"71649","421935 VITOR MEIRELES",0,1,1,69,1,72,"2022"
"71650","421940 WITMARSUM",0,0,3,48,1,52,"2022"
"71651","421950 XANXERE",0,2,2,732,2,738,"2022"
"71652","421960 XAVANTINA",0,0,0,27,0,27,"2022"
"71653","421970 XAXIM",0,2,7,439,0,448,"2022"
"71654","421985 ZORTEA",0,0,1,52,0,53,"2022"
"71655","422000 BALNEARIO RINCAO",0,0,2,200,0,202,"2022"
"71656","430003 ACEGUA",0,0,0,49,1,50,"2022"
"71657","430005 AGUA SANTA",0,0,0,49,0,49,"2022"
"71658","430010 AGUDO",0,0,2,146,0,148,"2022"
"71659","430020 AJURICABA",0,0,0,58,0,58,"2022"
"71660","430030 ALECRIM",0,0,3,55,0,58,"2022"
"71661","430040 ALEGRETE",0,2,13,730,0,745,"2022"
"71662","430045 ALEGRIA",0,0,1,38,0,39,"2022"
"71663","430047 ALMIRANTE TAMANDARE DO SUL",0,0,0,22,0,22,"2022"
"71664","430050 ALPESTRE",0,1,0,58,0,59,"2022"
"71665","430055 ALTO ALEGRE",0,0,0,16,0,16,"2022"
"71666","430057 ALTO FELIZ",0,0,0,20,0,20,"2022"
"71667","430060 ALVORADA",6,8,33,2185,4,2236,"2022"
"71668","430063 AMARAL FERRADOR",0,1,0,25,0,26,"2022"
"71669","430064 AMETISTA DO SUL",0,0,3,106,1,110,"2022"
"71670","430066 ANDRE DA ROCHA",0,0,0,15,0,15,"2022"
"71671","430070 ANTA GORDA",0,0,3,54,0,57,"2022"
"71672","430080 ANTONIO PRADO",0,0,6,138,0,144,"2022"
"71673","430085 ARAMBARE",0,0,0,36,1,37,"2022"
"71674","430087 ARARICA",0,0,1,85,0,86,"2022"
"71675","430090 ARATIBA",0,0,0,56,0,56,"2022"
"71676","430100 ARROIO DO MEIO",0,4,4,255,0,263,"2022"
"71677","430105 ARROIO DO SAL",0,0,0,124,1,125,"2022"
"71678","430107 ARROIO DO PADRE",0,0,1,25,0,26,"2022"
"71679","430110 ARROIO DOS RATOS",0,0,3,124,0,127,"2022"
"71680","430120 ARROIO DO TIGRE",0,0,3,133,0,136,"2022"
"71681","430130 ARROIO GRANDE",0,2,1,197,1,201,"2022"
"71682","430140 ARVOREZINHA",0,2,0,96,1,99,"2022"
"71683","430150 AUGUSTO PESTANA",0,0,2,82,0,84,"2022"
"71684","430155 AUREA",0,0,2,31,0,33,"2022"
"71685","430160 BAGE",2,10,13,1298,7,1330,"2022"
"71686","430163 BALNEARIO PINHAL",1,1,1,138,2,143,"2022"
"71687","430165 BARAO",0,1,3,57,0,61,"2022"
"71688","430170 BARAO DE COTEGIPE",0,0,1,61,1,63,"2022"
"71689","430175 BARAO DO TRIUNFO",0,0,0,50,1,51,"2022"
"71690","430180 BARRACAO",0,0,1,37,0,38,"2022"
"71691","430185 BARRA DO GUARITA",0,0,0,40,0,40,"2022"
"71692","430187 BARRA DO QUARAI",0,0,4,38,0,42,"2022"
"71693","430190 BARRA DO RIBEIRO",0,0,4,125,2,131,"2022"
"71694","430192 BARRA DO RIO AZUL",0,0,1,6,0,7,"2022"
"71695","430195 BARRA FUNDA",0,0,1,27,0,28,"2022"
"71696","430200 BARROS CASSAL",0,0,0,82,0,82,"2022"
"71697","430205 BENJAMIN CONSTANT DO SUL",0,0,1,41,1,43,"2022"
"71698","430210 BENTO GONCALVES",7,10,31,1401,3,1452,"2022"
"71699","430215 BOA VISTA DAS MISSOES",0,0,0,25,0,25,"2022"
"71700","430220 BOA VISTA DO BURICA",0,0,3,100,0,103,"2022"
"71701","430222 BOA VISTA DO CADEADO",0,0,1,20,0,21,"2022"
"71702","430223 BOA VISTA DO INCRA",0,1,2,38,0,41,"2022"
"71703","430225 BOA VISTA DO SUL",0,0,0,17,0,17,"2022"
"71704","430230 BOM JESUS",1,0,3,180,0,184,"2022"
"71705","430235 BOM PRINCIPIO",2,1,2,146,1,152,"2022"
"71706","430237 BOM PROGRESSO",1,0,0,27,0,28,"2022"
"71707","430240 BOM RETIRO DO SUL",0,1,1,154,0,156,"2022"
"71708","430245 BOQUEIRAO DO LEAO",0,0,2,60,0,62,"2022"
"71709","430250 BOSSOROCA",0,0,0,62,0,62,"2022"
"71710","430258 BOZANO",0,0,0,19,0,19,"2022"
"71711","430260 BRAGA",0,0,1,40,0,41,"2022"
"71712","430265 BROCHIER",0,0,0,44,0,44,"2022"
"71713","430270 BUTIA",0,1,5,190,0,196,"2022"
"71714","430280 CACAPAVA DO SUL",1,2,2,274,4,283,"2022"
"71715","430290 CACEQUI",0,1,3,93,0,97,"2022"
"71716","430300 CACHOEIRA DO SUL",3,3,11,846,3,866,"2022"
"71717","430310 CACHOEIRINHA",0,5,18,1485,3,1511,"2022"
"71718","430320 CACIQUE DOBLE",0,0,0,45,0,45,"2022"
"71719","430330 CAIBATE",0,0,1,41,0,42,"2022"
"71720","430340 CAICARA",0,0,1,40,0,41,"2022"
"71721","430350 CAMAQUA",3,3,12,722,10,750,"2022"
"71722","430355 CAMARGO",0,0,1,28,0,29,"2022"
"71723","430360 CAMBARA DO SUL",0,0,0,80,0,80,"2022"
"71724","430367 CAMPESTRE DA SERRA",0,0,2,20,0,22,"2022"
"71725","430370 CAMPINA DAS MISSOES",0,0,0,48,0,48,"2022"
"71726","430380 CAMPINAS DO SUL",0,0,1,51,1,53,"2022"
"71727","430390 CAMPO BOM",0,1,7,699,0,707,"2022"
"71728","430400 CAMPO NOVO",0,0,2,71,0,73,"2022"
"71729","430410 CAMPOS BORGES",0,0,1,23,0,24,"2022"
"71730","430420 CANDELARIA",0,0,7,289,0,296,"2022"
"71731","430430 CANDIDO GODOI",0,0,0,57,0,57,"2022"
"71732","430435 CANDIOTA",0,1,3,126,3,133,"2022"
"71733","430440 CANELA",0,3,11,623,2,639,"2022"
"71734","430450 CANGUCU",2,6,6,507,7,528,"2022"
"71735","430460 CANOAS",10,24,73,3905,11,4023,"2022"
"71736","430461 CANUDOS DO VALE",0,0,0,6,0,6,"2022"
"71737","430462 CAPAO BONITO DO SUL",0,0,0,20,0,20,"2022"
"71738","430463 CAPAO DA CANOA",3,2,11,891,1,908,"2022"
"71739","430465 CAPAO DO CIPO",0,0,0,43,0,43,"2022"
"71740","430466 CAPAO DO LEAO",1,1,3,287,3,295,"2022"
"71741","430467 CAPIVARI DO SUL",0,0,0,48,0,48,"2022"
"71742","430468 CAPELA DE SANTANA",0,0,2,144,0,146,"2022"
"71743","430469 CAPITAO",0,0,2,37,0,39,"2022"
"71744","430470 CARAZINHO",2,1,5,791,1,800,"2022"
"71745","430471 CARAA",0,0,1,55,4,60,"2022"
"71746","430480 CARLOS BARBOSA",1,1,6,314,1,323,"2022"
"71747","430485 CARLOS GOMES",0,0,0,9,0,9,"2022"
"71748","430490 CASCA",0,0,3,98,0,101,"2022"
"71749","430495 CASEIROS",0,1,2,37,0,40,"2022"
"71750","430500 CATUIPE",0,0,0,74,0,74,"2022"
"71751","430510 CAXIAS DO SUL",20,41,141,5069,11,5282,"2022"
"71752","430511 CENTENARIO",0,0,1,19,0,20,"2022"
"71753","430512 CERRITO",0,0,1,46,1,48,"2022"
"71754","430513 CERRO BRANCO",0,0,0,14,0,14,"2022"
"71755","430515 CERRO GRANDE",0,0,1,38,0,39,"2022"
"71756","430517 CERRO GRANDE DO SUL",0,1,0,93,1,95,"2022"
"71757","430520 CERRO LARGO",0,0,1,137,0,138,"2022"
"71758","430530 CHAPADA",0,0,2,99,0,101,"2022"
"71759","430535 CHARQUEADAS",0,0,5,295,1,301,"2022"
"71760","430537 CHARRUA",0,0,0,32,0,32,"2022"
"71761","430540 CHIAPETTA",0,1,1,43,0,45,"2022"
"71762","430543 CHUI",0,0,1,21,0,22,"2022"
"71763","430544 CHUVISCA",0,0,1,51,0,52,"2022"
"71764","430545 CIDREIRA",1,0,2,161,2,166,"2022"
"71765","430550 CIRIACO",0,0,2,46,0,48,"2022"
"71766","430558 COLINAS",0,0,0,17,0,17,"2022"
"71767","430560 COLORADO",0,0,0,23,0,23,"2022"
"71768","430570 CONDOR",0,0,0,72,0,72,"2022"
"71769","430580 CONSTANTINA",0,1,3,141,0,145,"2022"
"71770","430583 COQUEIRO BAIXO",1,0,0,7,0,8,"2022"
"71771","430585 COQUEIROS DO SUL",0,0,0,20,0,20,"2022"
"71772","430587 CORONEL BARROS",0,0,0,19,0,19,"2022"
"71773","430590 CORONEL BICACO",1,0,0,78,0,79,"2022"
"71774","430593 CORONEL PILAR",0,0,0,10,0,10,"2022"
"71775","430595 COTIPORA",0,0,1,29,0,30,"2022"
"71776","430597 COXILHA",0,0,1,29,0,30,"2022"
"71777","430600 CRISSIUMAL",1,0,1,136,0,138,"2022"
"71778","430605 CRISTAL",1,0,1,76,1,79,"2022"
"71779","430607 CRISTAL DO SUL",0,0,1,34,0,35,"2022"
"71780","430610 CRUZ ALTA",0,2,12,683,0,697,"2022"
"71781","430613 CRUZALTENSE",0,0,0,12,0,12,"2022"
"71782","430620 CRUZEIRO DO SUL",0,0,5,102,0,107,"2022"
"71783","430630 DAVID CANABARRO",0,0,0,45,0,45,"2022"
"71784","430632 DERRUBADAS",0,0,0,30,0,30,"2022"
"71785","430635 DEZESSEIS DE NOVEMBRO",0,0,0,25,0,25,"2022"
"71786","430637 DILERMANDO DE AGUIAR",0,0,2,22,0,24,"2022"
"71787","430640 DOIS IRMAOS",0,0,4,352,0,356,"2022"
"71788","430642 DOIS IRMAOS DAS MISSOES",0,0,0,21,0,21,"2022"
"71789","430645 DOIS LAJEADOS",0,0,0,31,0,31,"2022"
"71790","430650 DOM FELICIANO",0,3,0,125,1,129,"2022"
"71791","430655 DOM PEDRO DE ALCANTARA",0,0,1,27,0,28,"2022"
"71792","430660 DOM PEDRITO",2,0,5,360,0,367,"2022"
"71793","430670 DONA FRANCISCA",0,0,1,20,0,21,"2022"
"71794","430673 DOUTOR MAURICIO CARDOSO",0,0,0,32,0,32,"2022"
"71795","430675 DOUTOR RICARDO",0,1,0,17,0,18,"2022"
"71796","430676 ELDORADO DO SUL",0,2,10,443,3,458,"2022"
"71797","430680 ENCANTADO",0,0,3,240,0,243,"2022"
"71798","430690 ENCRUZILHADA DO SUL",1,2,7,272,0,282,"2022"
"71799","430692 ENGENHO VELHO",0,0,1,24,0,25,"2022"
"71800","430693 ENTRE-IJUIS",0,0,3,95,0,98,"2022"
"71801","430695 ENTRE RIOS DO SUL",0,0,1,24,0,25,"2022"
"71802","430697 EREBANGO",0,0,1,51,0,52,"2022"
"71803","430700 ERECHIM",1,7,32,1237,2,1279,"2022"
"71804","430705 ERNESTINA",0,0,2,31,0,33,"2022"
"71805","430710 HERVAL",0,0,0,51,0,51,"2022"
"71806","430720 ERVAL GRANDE",0,0,0,55,1,56,"2022"
"71807","430730 ERVAL SECO",0,0,1,77,0,78,"2022"
"71808","430740 ESMERALDA",0,1,0,35,0,36,"2022"
"71809","430745 ESPERANCA DO SUL",0,0,1,25,0,26,"2022"
"71810","430750 ESPUMOSO",0,0,3,173,0,176,"2022"
"71811","430755 ESTACAO",0,0,2,51,0,53,"2022"
"71812","430760 ESTANCIA VELHA",0,1,7,453,4,465,"2022"
"71813","430770 ESTEIO",1,3,8,870,2,884,"2022"
"71814","430780 ESTRELA",0,2,15,363,0,380,"2022"
"71815","430781 ESTRELA VELHA",0,0,1,44,0,45,"2022"
"71816","430783 EUGENIO DE CASTRO",0,0,0,18,0,18,"2022"
"71817","430786 FAGUNDES VARELA",0,1,0,15,0,16,"2022"
"71818","430790 FARROUPILHA",1,4,18,803,0,826,"2022"
"71819","430800 FAXINAL DO SOTURNO",0,1,2,68,0,71,"2022"
"71820","430805 FAXINALZINHO",0,0,1,27,0,28,"2022"
"71821","430807 FAZENDA VILANOVA",0,0,1,49,0,50,"2022"
"71822","430810 FELIZ",0,0,2,153,0,155,"2022"
"71823","430820 FLORES DA CUNHA",0,0,6,380,0,386,"2022"
"71824","430825 FLORIANO PEIXOTO",0,0,0,9,0,9,"2022"
"71825","430830 FONTOURA XAVIER",2,1,1,94,0,98,"2022"
"71826","430840 FORMIGUEIRO",0,0,1,54,0,55,"2022"
"71827","430843 FORQUETINHA",0,0,0,23,0,23,"2022"
"71828","430845 FORTALEZA DOS VALOS",0,0,0,47,0,47,"2022"
"71829","430850 FREDERICO WESTPHALEN",0,1,6,430,2,439,"2022"
"71830","430860 GARIBALDI",0,2,3,391,0,396,"2022"
"71831","430865 GARRUCHOS",0,0,0,24,0,24,"2022"
"71832","430870 GAURAMA",0,0,0,60,0,60,"2022"
"71833","430880 GENERAL CAMARA",0,0,0,66,0,66,"2022"
"71834","430885 GENTIL",0,0,0,22,0,22,"2022"
"71835","430890 GETULIO VARGAS",1,1,5,147,0,154,"2022"
"71836","430900 GIRUA",0,0,6,150,0,156,"2022"
"71837","430905 GLORINHA",0,0,0,75,0,75,"2022"
"71838","430910 GRAMADO",0,4,8,512,1,525,"2022"
"71839","430912 GRAMADO DOS LOUREIROS",1,0,2,33,1,37,"2022"
"71840","430915 GRAMADO XAVIER",0,0,0,29,0,29,"2022"
"71841","430920 GRAVATAI",6,14,50,2784,16,2870,"2022"
"71842","430925 GUABIJU",0,1,0,3,0,4,"2022"
"71843","430930 GUAIBA",1,0,22,893,6,922,"2022"
"71844","430940 GUAPORE",0,0,7,270,0,277,"2022"
"71845","430950 GUARANI DAS MISSOES",0,0,0,58,0,58,"2022"
"71846","430955 HARMONIA",0,2,1,58,0,61,"2022"
"71847","430957 HERVEIRAS",0,0,0,25,0,25,"2022"
"71848","430960 HORIZONTINA",0,0,1,206,0,207,"2022"
"71849","430965 HULHA NEGRA",0,0,2,87,0,89,"2022"
"71850","430970 HUMAITA",0,1,1,42,0,44,"2022"
"71851","430975 IBARAMA",1,0,0,30,0,31,"2022"
"71852","430980 IBIACA",0,0,1,36,0,37,"2022"
"71853","430990 IBIRAIARAS",0,0,0,73,0,73,"2022"
"71854","430995 IBIRAPUITA",0,0,3,35,0,38,"2022"
"71855","431000 IBIRUBA",1,1,3,244,0,249,"2022"
"71856","431010 IGREJINHA",1,1,9,473,0,484,"2022"
"71857","431020 IJUI",0,3,9,957,1,970,"2022"
"71858","431030 ILOPOLIS",0,0,0,44,0,44,"2022"
"71859","431033 IMBE",0,1,2,251,1,255,"2022"
"71860","431036 IMIGRANTE",0,0,0,31,0,31,"2022"
"71861","431040 INDEPENDENCIA",0,0,0,66,0,66,"2022"
"71862","431041 INHACORA",0,0,0,26,0,26,"2022"
"71863","431043 IPE",0,0,0,68,0,68,"2022"
"71864","431046 IPIRANGA DO SUL",1,0,0,14,0,15,"2022"
"71865","431050 IRAI",0,0,2,81,0,83,"2022"
"71866","431053 ITAARA",0,0,0,53,1,54,"2022"
"71867","431055 ITACURUBI",1,0,0,25,0,26,"2022"
"71868","431057 ITAPUCA",0,0,0,27,0,27,"2022"
"71869","431060 ITAQUI",4,1,8,402,7,422,"2022"
"71870","431065 ITATI",0,0,0,25,0,25,"2022"
"71871","431070 ITATIBA DO SUL",0,1,1,32,0,34,"2022"
"71872","431075 IVORA",0,0,0,12,0,12,"2022"
"71873","431080 IVOTI",0,0,5,222,1,228,"2022"
"71874","431085 JABOTICABA",0,0,3,40,0,43,"2022"
"71875","431087 JACUIZINHO",0,0,0,23,0,23,"2022"
"71876","431090 JACUTINGA",0,0,1,38,0,39,"2022"
"71877","431100 JAGUARAO",2,0,5,277,0,284,"2022"
"71878","431110 JAGUARI",0,0,1,78,1,80,"2022"
"71879","431112 JAQUIRANA",0,0,1,41,0,42,"2022"
"71880","431113 JARI",0,0,1,26,0,27,"2022"
"71881","431115 JOIA",0,1,2,76,0,79,"2022"
"71882","431120 JULIO DE CASTILHOS",0,1,5,163,0,169,"2022"
"71883","431123 LAGOA BONITA DO SUL",0,0,0,11,0,11,"2022"
"71884","431125 LAGOAO",0,1,1,56,0,58,"2022"
"71885","431127 LAGOA DOS TRES CANTOS",0,1,0,12,0,13,"2022"
"71886","431130 LAGOA VERMELHA",0,0,4,330,0,334,"2022"
"71887","431140 LAJEADO",2,3,16,1184,1,1206,"2022"
"71888","431142 LAJEADO DO BUGRE",0,0,4,37,0,41,"2022"
"71889","431150 LAVRAS DO SUL",0,0,4,71,0,75,"2022"
"71890","431160 LIBERATO SALZANO",0,0,0,55,0,55,"2022"
"71891","431162 LINDOLFO COLLOR",0,1,4,79,0,84,"2022"
"71892","431164 LINHA NOVA",0,0,0,12,0,12,"2022"
"71893","431170 MACHADINHO",0,0,1,67,0,68,"2022"
"71894","431171 MACAMBARA",0,0,0,59,0,59,"2022"
"71895","431173 MAMPITUBA",0,0,0,25,0,25,"2022"
"71896","431175 MANOEL VIANA",0,0,3,70,0,73,"2022"
"71897","431177 MAQUINE",0,0,0,64,1,65,"2022"
"71898","431179 MARATA",0,0,0,19,0,19,"2022"
"71899","431180 MARAU",0,0,12,541,1,554,"2022"
"71900","431190 MARCELINO RAMOS",0,1,1,42,2,46,"2022"
"71901","431198 MARIANA PIMENTEL",0,0,1,35,0,36,"2022"
"71902","431200 MARIANO MORO",0,0,0,14,0,14,"2022"
"71903","431205 MARQUES DE SOUZA",0,1,2,26,0,29,"2022"
"71904","431210 MATA",0,0,4,34,0,38,"2022"
"71905","431213 MATO CASTELHANO",0,0,1,29,0,30,"2022"
"71906","431215 MATO LEITAO",0,0,3,34,1,38,"2022"
"71907","431217 MATO QUEIMADO",0,0,2,13,0,15,"2022"
"71908","431220 MAXIMILIANO DE ALMEIDA",0,0,0,45,0,45,"2022"
"71909","431225 MINAS DO LEAO",0,0,4,79,0,83,"2022"
"71910","431230 MIRAGUAI",0,0,0,72,0,72,"2022"
"71911","431235 MONTAURI",0,0,0,13,0,13,"2022"
"71912","431237 MONTE ALEGRE DOS CAMPOS",0,0,2,37,0,39,"2022"
"71913","431238 MONTE BELO DO SUL",0,0,0,23,0,23,"2022"
"71914","431240 MONTENEGRO",2,8,13,824,2,849,"2022"
"71915","431242 MORMACO",1,0,0,25,0,26,"2022"
"71916","431244 MORRINHOS DO SUL",0,0,0,34,0,34,"2022"
"71917","431245 MORRO REDONDO",0,1,3,37,0,41,"2022"
"71918","431247 MORRO REUTER",0,0,2,78,0,80,"2022"
"71919","431250 MOSTARDAS",0,0,5,122,1,128,"2022"
"71920","431260 MUCUM",0,0,0,34,0,34,"2022"
"71921","431261 MUITOS CAPOES",0,0,0,26,0,26,"2022"
"71922","431262 MULITERNO",1,0,0,26,0,27,"2022"
"71923","431265 NAO-ME-TOQUE",0,0,2,204,1,207,"2022"
"71924","431267 NICOLAU VERGUEIRO",0,0,0,19,0,19,"2022"
"71925","431270 NONOAI",0,1,2,191,0,194,"2022"
"71926","431275 NOVA ALVORADA",0,0,0,36,0,36,"2022"
"71927","431280 NOVA ARACA",1,0,1,98,0,100,"2022"
"71928","431290 NOVA BASSANO",0,0,1,78,0,79,"2022"
"71929","431295 NOVA BOA VISTA",0,0,0,18,0,18,"2022"
"71930","431300 NOVA BRESCIA",0,0,0,20,0,20,"2022"
"71931","431301 NOVA CANDELARIA",0,0,0,34,0,34,"2022"
"71932","431303 NOVA ESPERANCA DO SUL",1,1,0,48,0,50,"2022"
"71933","431306 NOVA HARTZ",0,3,6,248,0,257,"2022"
"71934","431308 NOVA PADUA",0,2,0,17,0,19,"2022"
"71935","431310 NOVA PALMA",0,0,2,46,0,48,"2022"
"71936","431320 NOVA PETROPOLIS",0,1,7,237,0,245,"2022"
"71937","431330 NOVA PRATA",1,1,3,287,0,292,"2022"
"71938","431333 NOVA RAMADA",0,0,1,18,0,19,"2022"
"71939","431335 NOVA ROMA DO SUL",0,0,0,35,0,35,"2022"
"71940","431337 NOVA SANTA RITA",2,0,6,374,0,382,"2022"
"71941","431339 NOVO CABRAIS",0,0,0,25,0,25,"2022"
"71942","431340 NOVO HAMBURGO",6,17,39,2658,10,2730,"2022"
"71943","431342 NOVO MACHADO",0,0,1,26,0,27,"2022"
"71944","431344 NOVO TIRADENTES",0,0,0,18,0,18,"2022"
"71945","431346 NOVO XINGU",0,0,0,26,0,26,"2022"
"71946","431349 NOVO BARREIRO",0,0,2,39,0,41,"2022"
"71947","431350 OSORIO",0,2,6,542,1,551,"2022"
"71948","431360 PAIM FILHO",0,0,1,36,0,37,"2022"
"71949","431365 PALMARES DO SUL",0,0,2,119,0,121,"2022"
"71950","431370 PALMEIRA DAS MISSOES",1,2,10,409,2,424,"2022"
"71951","431380 PALMITINHO",0,0,0,89,0,89,"2022"
"71952","431390 PANAMBI",0,2,15,478,1,496,"2022"
"71953","431395 PANTANO GRANDE",0,0,2,119,0,121,"2022"
"71954","431400 PARAI",2,0,0,74,1,77,"2022"
"71955","431402 PARAISO DO SUL",1,0,1,50,0,52,"2022"
"71956","431403 PARECI NOVO",0,0,1,52,0,53,"2022"
"71957","431405 PAROBE",2,5,16,732,0,755,"2022"
"71958","431406 PASSA SETE",0,0,0,40,0,40,"2022"
"71959","431407 PASSO DO SOBRADO",0,0,2,59,0,61,"2022"
"71960","431410 PASSO FUNDO",6,11,45,2596,4,2662,"2022"
"71961","431413 PAULO BENTO",0,0,0,17,0,17,"2022"
"71962","431415 PAVERAMA",0,0,0,80,0,80,"2022"
"71963","431417 PEDRAS ALTAS",0,0,2,28,0,30,"2022"
"71964","431420 PEDRO OSORIO",1,0,3,64,1,69,"2022"
"71965","431430 PEJUCARA",0,0,0,39,0,39,"2022"
"71966","431440 PELOTAS",8,19,81,3288,17,3413,"2022"
"71967","431442 PICADA CAFE",0,0,0,43,0,43,"2022"
"71968","431445 PINHAL",0,0,4,42,1,47,"2022"
"71969","431446 PINHAL DA SERRA",0,0,0,20,0,20,"2022"
"71970","431447 PINHAL GRANDE",0,0,1,21,0,22,"2022"
"71971","431449 PINHEIRINHO DO VALE",0,0,0,50,0,50,"2022"
"71972","431450 PINHEIRO MACHADO",0,1,1,100,0,102,"2022"
"71973","431454 PINTO BANDEIRA",0,0,0,28,0,28,"2022"
"71974","431455 PIRAPO",0,0,0,12,0,12,"2022"
"71975","431460 PIRATINI",0,1,5,126,3,135,"2022"
"71976","431470 PLANALTO",0,0,0,147,0,147,"2022"
"71977","431475 POCO DAS ANTAS",0,0,1,21,0,22,"2022"
"71978","431477 PONTAO",0,0,0,34,0,34,"2022"
"71979","431478 PONTE PRETA",0,0,0,9,0,9,"2022"
"71980","431480 PORTAO",1,0,12,402,0,415,"2022"
"71981","431490 PORTO ALEGRE",31,67,276,13251,54,13679,"2022"
"71982","431500 PORTO LUCENA",0,0,0,27,0,27,"2022"
"71983","431505 PORTO MAUA",0,0,0,14,0,14,"2022"
"71984","431507 PORTO VERA CRUZ",0,0,0,18,0,18,"2022"
"71985","431510 PORTO XAVIER",0,0,1,103,0,104,"2022"
"71986","431513 POUSO NOVO",0,0,0,15,0,15,"2022"
"71987","431514 PRESIDENTE LUCENA",0,1,2,43,0,46,"2022"
"71988","431515 PROGRESSO",0,0,3,47,0,50,"2022"
"71989","431517 PROTASIO ALVES",0,0,0,12,0,12,"2022"
"71990","431520 PUTINGA",0,0,0,36,0,36,"2022"
"71991","431530 QUARAI",3,1,3,245,1,253,"2022"
"71992","431531 QUATRO IRMAOS",0,0,1,20,0,21,"2022"
"71993","431532 QUEVEDOS",0,0,0,24,0,24,"2022"
"71994","431535 QUINZE DE NOVEMBRO",1,0,2,39,0,42,"2022"
"71995","431540 REDENTORA",0,2,1,185,1,189,"2022"
"71996","431545 RELVADO",0,1,1,12,0,14,"2022"
"71997","431550 RESTINGA SECA",1,1,2,138,0,142,"2022"
"71998","431555 RIO DOS INDIOS",0,0,1,19,0,20,"2022"
"71999","431560 RIO GRANDE",3,17,71,1977,10,2078,"2022"
"72000","431570 RIO PARDO",0,2,2,336,0,340,"2022"
"72001","431575 RIOZINHO",0,0,2,43,1,46,"2022"
"72002","431580 ROCA SALES",0,0,4,96,0,100,"2022"
"72003","431590 RODEIO BONITO",0,0,0,94,0,94,"2022"
"72004","431595 ROLADOR",0,0,0,19,0,19,"2022"
"72005","431600 ROLANTE",1,0,0,264,0,265,"2022"
"72006","431610 RONDA ALTA",0,0,0,100,1,101,"2022"
"72007","431620 RONDINHA",0,0,0,30,0,30,"2022"
"72008","431630 ROQUE GONZALES",0,0,0,67,0,67,"2022"
"72009","431640 ROSARIO DO SUL",1,3,11,399,1,415,"2022"
"72010","431642 SAGRADA FAMILIA",0,0,1,23,0,24,"2022"
"72011","431643 SALDANHA MARINHO",0,0,0,19,0,19,"2022"
"72012","431645 SALTO DO JACUI",0,0,3,110,0,113,"2022"
"72013","431647 SALVADOR DAS MISSOES",0,0,0,38,0,38,"2022"
"72014","431650 SALVADOR DO SUL",0,1,3,73,0,77,"2022"
"72015","431660 SANANDUVA",0,0,1,171,0,172,"2022"
"72016","431670 SANTA BARBARA DO SUL",0,0,2,85,1,88,"2022"
"72017","431673 SANTA CECILIA DO SUL",0,0,1,27,0,28,"2022"
"72018","431675 SANTA CLARA DO SUL",0,0,0,58,0,58,"2022"
"72019","431680 SANTA CRUZ DO SUL",2,9,35,1405,5,1456,"2022"
"72020","431690 SANTA MARIA",8,16,52,2905,12,2993,"2022"
"72021","431695 SANTA MARIA DO HERVAL",1,0,1,47,0,49,"2022"
"72022","431697 SANTA MARGARIDA DO SUL",0,0,0,9,0,9,"2022"
"72023","431700 SANTANA DA BOA VISTA",0,0,2,43,1,46,"2022"
"72024","431710 SANT'ANA DO LIVRAMENTO",2,5,6,851,29,893,"2022"
"72025","431720 SANTA ROSA",1,4,36,942,2,985,"2022"
"72026","431725 SANTA TEREZA",0,0,0,8,0,8,"2022"
"72027","431730 SANTA VITORIA DO PALMAR",0,2,6,282,0,290,"2022"
"72028","431740 SANTIAGO",1,0,3,525,3,532,"2022"
"72029","431750 SANTO ANGELO",0,0,10,921,4,935,"2022"
"72030","431755 SANTO ANTONIO DO PALMA",0,0,0,14,0,14,"2022"
"72031","431760 SANTO ANTONIO DA PATRULHA",1,2,6,393,0,402,"2022"
"72032","431770 SANTO ANTONIO DAS MISSOES",0,0,0,87,0,87,"2022"
"72033","431775 SANTO ANTONIO DO PLANALTO",0,0,0,22,0,22,"2022"
"72034","431780 SANTO AUGUSTO",0,1,3,168,0,172,"2022"
"72035","431790 SANTO CRISTO",0,1,1,152,0,154,"2022"
"72036","431795 SANTO EXPEDITO DO SUL",0,0,0,20,0,20,"2022"
"72037","431800 SAO BORJA",3,0,2,657,0,662,"2022"
"72038","431805 SAO DOMINGOS DO SUL",0,0,1,15,0,16,"2022"
"72039","431810 SAO FRANCISCO DE ASSIS",0,1,4,135,0,140,"2022"
"72040","431820 SAO FRANCISCO DE PAULA",0,1,5,252,3,261,"2022"
"72041","431830 SAO GABRIEL",2,1,9,686,0,698,"2022"
"72042","431840 SAO JERONIMO",0,0,0,236,0,236,"2022"
"72043","431842 SAO JOAO DA URTIGA",0,0,0,42,0,42,"2022"
"72044","431843 SAO JOAO DO POLESINE",0,0,0,26,0,26,"2022"
"72045","431844 SAO JORGE",0,0,0,31,0,31,"2022"
"72046","431845 SAO JOSE DAS MISSOES",0,0,0,24,0,24,"2022"
"72047","431846 SAO JOSE DO HERVAL",0,1,0,22,0,23,"2022"
"72048","431848 SAO JOSE DO HORTENCIO",0,0,1,28,0,29,"2022"
"72049","431849 SAO JOSE DO INHACORA",0,0,0,23,0,23,"2022"
"72050","431850 SAO JOSE DO NORTE",2,5,5,255,1,268,"2022"
"72051","431860 SAO JOSE DO OURO",1,1,0,71,0,73,"2022"
"72052","431861 SAO JOSE DO SUL",0,0,0,28,0,28,"2022"
"72053","431862 SAO JOSE DOS AUSENTES",0,2,3,69,1,75,"2022"
"72054","431870 SAO LEOPOLDO",3,8,60,2404,25,2500,"2022"
"72055","431880 SAO LOURENCO DO SUL",1,1,4,360,1,367,"2022"
"72056","431890 SAO LUIZ GONZAGA",1,1,2,455,0,459,"2022"
"72057","431900 SAO MARCOS",1,1,5,191,0,198,"2022"
"72058","431910 SAO MARTINHO",0,0,0,51,0,51,"2022"
"72059","431912 SAO MARTINHO DA SERRA",0,0,0,30,0,30,"2022"
"72060","431915 SAO MIGUEL DAS MISSOES",0,1,0,82,1,84,"2022"
"72061","431920 SAO NICOLAU",0,0,1,45,0,46,"2022"
"72062","431930 SAO PAULO DAS MISSOES",0,0,0,61,1,62,"2022"
"72063","431935 SAO PEDRO DA SERRA",0,0,0,40,0,40,"2022"
"72064","431936 SAO PEDRO DAS MISSOES",0,0,0,29,0,29,"2022"
"72065","431937 SAO PEDRO DO BUTIA",0,0,0,26,0,26,"2022"
"72066","431940 SAO PEDRO DO SUL",0,0,6,166,0,172,"2022"
"72067","431950 SAO SEBASTIAO DO CAI",1,1,4,269,0,275,"2022"
"72068","431960 SAO SEPE",0,2,5,221,0,228,"2022"
"72069","431970 SAO VALENTIM",0,0,1,30,1,32,"2022"
"72070","431971 SAO VALENTIM DO SUL",0,0,0,17,0,17,"2022"
"72071","431973 SAO VALERIO DO SUL",1,0,0,36,0,37,"2022"
"72072","431975 SAO VENDELINO",0,0,1,18,0,19,"2022"
"72073","431980 SAO VICENTE DO SUL",0,0,1,88,0,89,"2022"
"72074","431990 SAPIRANGA",3,2,21,1042,2,1070,"2022"
"72075","432000 SAPUCAIA DO SUL",1,8,24,1398,2,1433,"2022"
"72076","432010 SARANDI",0,0,6,268,0,274,"2022"
"72077","432020 SEBERI",0,0,0,192,0,192,"2022"
"72078","432023 SEDE NOVA",0,0,0,27,0,27,"2022"
"72079","432026 SEGREDO",0,1,0,65,0,66,"2022"
"72080","432030 SELBACH",0,0,0,40,0,40,"2022"
"72081","432032 SENADOR SALGADO FILHO",0,0,1,25,0,26,"2022"
"72082","432035 SENTINELA DO SUL",0,0,1,45,0,46,"2022"
"72083","432040 SERAFINA CORREA",0,0,4,178,0,182,"2022"
"72084","432045 SERIO",0,1,0,15,0,16,"2022"
"72085","432050 SERTAO",1,1,4,50,0,56,"2022"
"72086","432055 SERTAO SANTANA",0,0,0,63,1,64,"2022"
"72087","432057 SETE DE SETEMBRO",0,0,1,18,0,19,"2022"
"72088","432060 SEVERIANO DE ALMEIDA",0,0,1,40,0,41,"2022"
"72089","432065 SILVEIRA MARTINS",0,0,0,16,0,16,"2022"
"72090","432067 SINIMBU",0,0,1,67,0,68,"2022"
"72091","432070 SOBRADINHO",0,1,1,154,0,156,"2022"
"72092","432080 SOLEDADE",0,2,4,387,0,393,"2022"
"72093","432085 TABAI",0,1,1,59,0,61,"2022"
"72094","432090 TAPEJARA",0,0,3,386,0,389,"2022"
"72095","432100 TAPERA",2,1,1,108,0,112,"2022"
"72096","432110 TAPES",0,0,1,148,0,149,"2022"
"72097","432120 TAQUARA",4,0,4,616,1,625,"2022"
"72098","432130 TAQUARI",1,0,2,275,0,278,"2022"
"72099","432132 TAQUARUCU DO SUL",0,0,0,43,0,43,"2022"
"72100","432135 TAVARES",0,0,2,38,1,41,"2022"
"72101","432140 TENENTE PORTELA",0,0,2,213,2,217,"2022"
"72102","432143 TERRA DE AREIA",0,0,3,120,0,123,"2022"
"72103","432145 TEUTONIA",0,1,5,389,0,395,"2022"
"72104","432146 TIO HUGO",0,0,2,36,0,38,"2022"
"72105","432147 TIRADENTES DO SUL",0,0,3,38,0,41,"2022"
"72106","432149 TOROPI",0,0,0,20,0,20,"2022"
"72107","432150 TORRES",2,3,9,503,1,518,"2022"
"72108","432160 TRAMANDAI",2,1,10,731,3,747,"2022"
"72109","432162 TRAVESSEIRO",0,0,0,12,0,12,"2022"
"72110","432163 TRES ARROIOS",0,0,0,19,0,19,"2022"
"72111","432166 TRES CACHOEIRAS",0,0,3,133,1,137,"2022"
"72112","432170 TRES COROAS",1,0,3,244,0,248,"2022"
"72113","432180 TRES DE MAIO",0,0,3,284,0,287,"2022"
"72114","432183 TRES FORQUILHAS",0,0,0,34,0,34,"2022"
"72115","432185 TRES PALMEIRAS",0,1,1,60,0,62,"2022"
"72116","432190 TRES PASSOS",1,2,5,312,0,320,"2022"
"72117","432195 TRINDADE DO SUL",0,0,1,98,0,99,"2022"
"72118","432200 TRIUNFO",0,1,7,282,0,290,"2022"
"72119","432210 TUCUNDUVA",0,0,0,45,0,45,"2022"
"72120","432215 TUNAS",0,0,1,37,0,38,"2022"
"72121","432218 TUPANCI DO SUL",0,0,0,6,0,6,"2022"
"72122","432220 TUPANCIRETA",0,1,7,220,0,228,"2022"
"72123","432225 TUPANDI",0,0,2,71,0,73,"2022"
"72124","432230 TUPARENDI",0,0,1,60,0,61,"2022"
"72125","432232 TURUCU",0,2,4,22,0,28,"2022"
"72126","432234 UBIRETAMA",0,0,0,18,0,18,"2022"
"72127","432235 UNIAO DA SERRA",0,0,0,7,0,7,"2022"
"72128","432237 UNISTALDA",0,0,1,17,0,18,"2022"
"72129","432240 URUGUAIANA",4,5,43,1402,15,1469,"2022"
"72130","432250 VACARIA",1,3,9,864,5,882,"2022"
"72131","432252 VALE VERDE",0,1,1,24,0,26,"2022"
"72132","432253 VALE DO SOL",0,0,1,76,0,77,"2022"
"72133","432254 VALE REAL",0,1,3,71,0,75,"2022"
"72134","432255 VANINI",0,0,0,12,0,12,"2022"
"72135","432260 VENANCIO AIRES",0,1,8,750,2,761,"2022"
"72136","432270 VERA CRUZ",2,2,6,270,0,280,"2022"
"72137","432280 VERANOPOLIS",2,0,5,237,1,245,"2022"
"72138","432285 VESPASIANO CORREA",0,0,1,19,0,20,"2022"
"72139","432290 VIADUTOS",0,1,0,33,0,34,"2022"
"72140","432300 VIAMAO",6,11,37,2085,27,2166,"2022"
"72141","432310 VICENTE DUTRA",0,0,0,43,0,43,"2022"
"72142","432320 VICTOR GRAEFF",0,0,0,29,0,29,"2022"
"72143","432330 VILA FLORES",0,0,1,46,0,47,"2022"
"72144","432335 VILA LANGARO",0,0,0,21,0,21,"2022"
"72145","432340 VILA MARIA",0,2,1,44,0,47,"2022"
"72146","432345 VILA NOVA DO SUL",0,0,0,30,0,30,"2022"
"72147","432350 VISTA ALEGRE",0,0,0,27,0,27,"2022"
"72148","432360 VISTA ALEGRE DO PRATA",0,0,0,13,0,13,"2022"
"72149","432370 VISTA GAUCHA",0,0,0,30,0,30,"2022"
"72150","432375 VITORIA DAS MISSOES",0,0,1,32,0,33,"2022"
"72151","432377 WESTFALIA",0,0,0,36,0,36,"2022"
"72152","432380 XANGRI-LA",3,2,5,196,0,206,"2022"
"72153","500020 AGUA CLARA",2,1,2,285,0,290,"2022"
"72154","500025 ALCINOPOLIS",0,0,1,47,0,48,"2022"
"72155","500060 AMAMBAI",0,3,10,654,1,668,"2022"
"72156","500070 ANASTACIO",1,0,3,377,2,383,"2022"
"72157","500080 ANAURILANDIA",0,0,0,74,0,74,"2022"
"72158","500085 ANGELICA",0,0,0,139,0,139,"2022"
"72159","500090 ANTONIO JOAO",0,2,3,142,2,149,"2022"
"72160","500100 APARECIDA DO TABOADO",0,0,0,384,3,387,"2022"
"72161","500110 AQUIDAUANA",1,0,6,681,6,694,"2022"
"72162","500124 ARAL MOREIRA",0,1,8,151,8,168,"2022"
"72163","500150 BANDEIRANTES",0,0,1,96,0,97,"2022"
"72164","500190 BATAGUASSU",2,0,3,327,0,332,"2022"
"72165","500200 BATAYPORA",0,1,1,129,0,131,"2022"
"72166","500210 BELA VISTA",1,0,1,428,0,430,"2022"
"72167","500215 BODOQUENA",0,0,1,116,0,117,"2022"
"72168","500220 BONITO",1,0,6,342,2,351,"2022"
"72169","500230 BRASILANDIA",0,0,1,139,0,140,"2022"
"72170","500240 CAARAPO",1,3,3,477,0,484,"2022"
"72171","500260 CAMAPUA",2,0,2,157,1,162,"2022"
"72172","500270 CAMPO GRANDE",26,39,140,12105,35,12345,"2022"
"72173","500280 CARACOL",1,0,0,65,0,66,"2022"
"72174","500290 CASSILANDIA",0,1,4,234,1,240,"2022"
"72175","500295 CHAPADAO DO SUL",0,2,2,512,1,517,"2022"
"72176","500310 CORGUINHO",0,1,0,26,1,28,"2022"
"72177","500315 CORONEL SAPUCAIA",1,3,15,311,15,345,"2022"
"72178","500320 CORUMBA",5,8,11,1753,4,1781,"2022"
"72179","500325 COSTA RICA",0,0,2,414,0,416,"2022"
"72180","500330 COXIM",0,4,4,460,0,468,"2022"
"72181","500345 DEODAPOLIS",0,1,3,149,0,153,"2022"
"72182","500348 DOIS IRMAOS DO BURITI",0,0,2,156,0,158,"2022"
"72183","500350 DOURADINA",1,0,2,65,2,70,"2022"
"72184","500370 DOURADOS",6,20,58,3664,29,3777,"2022"
"72185","500375 ELDORADO",0,0,0,191,1,192,"2022"
"72186","500380 FATIMA DO SUL",1,1,2,231,0,235,"2022"
"72187","500390 FIGUEIRAO",0,0,0,35,0,35,"2022"
"72188","500400 GLORIA DE DOURADOS",1,0,4,88,0,93,"2022"
"72189","500410 GUIA LOPES DA LAGUNA",0,0,0,140,0,140,"2022"
"72190","500430 IGUATEMI",0,0,3,219,0,222,"2022"
"72191","500440 INOCENCIA",0,0,2,95,1,98,"2022"
"72192","500450 ITAPORA",0,0,1,211,1,213,"2022"
"72193","500460 ITAQUIRAI",0,0,6,270,0,276,"2022"
"72194","500470 IVINHEMA",1,1,3,390,0,395,"2022"
"72195","500480 JAPORA",0,0,22,127,0,149,"2022"
"72196","500490 JARAGUARI",0,0,0,54,0,54,"2022"
"72197","500500 JARDIM",1,2,5,396,1,405,"2022"
"72198","500510 JATEI",0,0,1,55,0,56,"2022"
"72199","500515 JUTI",0,0,0,98,0,98,"2022"
"72200","500520 LADARIO",0,0,1,348,3,352,"2022"
"72201","500525 LAGUNA CARAPA",0,1,2,100,2,105,"2022"
"72202","500540 MARACAJU",2,2,7,747,2,760,"2022"
"72203","500560 MIRANDA",1,1,4,475,0,481,"2022"
"72204","500568 MUNDO NOVO",0,0,132,130,0,262,"2022"
"72205","500570 NAVIRAI",3,1,11,734,0,749,"2022"
"72206","500580 NIOAQUE",0,0,0,159,0,159,"2022"
"72207","500600 NOVA ALVORADA DO SUL",0,0,1,321,0,322,"2022"
"72208","500620 NOVA ANDRADINA",0,2,1,614,2,619,"2022"
"72209","500625 NOVO HORIZONTE DO SUL",0,1,2,60,0,63,"2022"
"72210","500627 PARAISO DAS AGUAS",0,0,1,59,0,60,"2022"
"72211","500630 PARANAIBA",1,0,5,478,0,484,"2022"
"72212","500635 PARANHOS",2,3,5,258,55,323,"2022"
"72213","500640 PEDRO GOMES",0,2,1,83,0,86,"2022"
"72214","500660 PONTA PORA",2,5,21,1666,1,1695,"2022"
"72215","500690 PORTO MURTINHO",0,0,3,206,0,209,"2022"
"72216","500710 RIBAS DO RIO PARDO",0,1,2,351,0,354,"2022"
"72217","500720 RIO BRILHANTE",5,2,3,529,3,542,"2022"
"72218","500730 RIO NEGRO",0,0,1,59,0,60,"2022"
"72219","500740 RIO VERDE DE MATO GROSSO",2,0,3,284,0,289,"2022"
"72220","500750 ROCHEDO",0,0,1,67,1,69,"2022"
"72221","500755 SANTA RITA DO PARDO",0,0,0,68,0,68,"2022"
"72222","500769 SAO GABRIEL DO OESTE",0,4,9,498,3,514,"2022"
"72223","500770 SETE QUEDAS",0,2,0,139,0,141,"2022"
"72224","500780 SELVIRIA",0,1,3,72,0,76,"2022"
"72225","500790 SIDROLANDIA",2,3,3,693,3,704,"2022"
"72226","500793 SONORA",0,0,4,201,0,205,"2022"
"72227","500795 TACURU",0,0,3,173,0,176,"2022"
"72228","500797 TAQUARUSSU",0,0,0,42,1,43,"2022"
"72229","500800 TERENOS",0,0,4,190,0,194,"2022"
"72230","500830 TRES LAGOAS",1,7,12,1955,0,1975,"2022"
"72231","500840 VICENTINA",0,0,0,77,0,77,"2022"
"72232","MUNICIPIO IGNORADO - MT",0,0,0,2,0,2,"2022"
"72233","510010 ACORIZAL",0,0,0,58,0,58,"2022"
"72234","510020 AGUA BOA",1,2,6,431,13,453,"2022"
"72235","510025 ALTA FLORESTA",0,0,12,935,0,947,"2022"
"72236","510030 ALTO ARAGUAIA",3,0,0,188,0,191,"2022"
"72237","510035 ALTO BOA VISTA",2,0,0,52,36,90,"2022"
"72238","510040 ALTO GARCAS",0,1,2,165,0,168,"2022"
"72239","510050 ALTO PARAGUAI",0,0,0,92,0,92,"2022"
"72240","510060 ALTO TAQUARI",0,0,0,164,0,164,"2022"
"72241","510080 APIACAS",1,1,7,146,1,156,"2022"
"72242","510100 ARAGUAIANA",1,0,1,38,0,40,"2022"
"72243","510120 ARAGUAINHA",0,0,0,8,0,8,"2022"
"72244","510125 ARAPUTANGA",0,0,0,207,0,207,"2022"
"72245","510130 ARENAPOLIS",1,1,0,166,0,168,"2022"
"72246","510140 ARIPUANA",1,3,4,399,0,407,"2022"
"72247","510160 BARAO DE MELGACO",0,0,0,46,0,46,"2022"
"72248","510170 BARRA DO BUGRES",2,0,4,419,0,425,"2022"
"72249","510180 BARRA DO GARCAS",5,3,4,1045,4,1061,"2022"
"72250","510185 BOM JESUS DO ARAGUAIA",0,0,1,95,5,101,"2022"
"72251","510190 BRASNORTE",1,3,3,319,3,329,"2022"
"72252","510250 CACERES",5,2,21,1367,8,1403,"2022"
"72253","510260 CAMPINAPOLIS",2,2,10,280,139,433,"2022"
"72254","510263 CAMPO NOVO DO PARECIS",1,4,14,792,1,812,"2022"
"72255","510267 CAMPO VERDE",1,2,15,764,1,783,"2022"
"72256","510268 CAMPOS DE JULIO",0,1,2,151,0,154,"2022"
"72257","510269 CANABRAVA DO NORTE",1,0,1,90,0,92,"2022"
"72258","510270 CANARANA",0,1,3,435,28,467,"2022"
"72259","510279 CARLINDA",0,1,1,136,0,138,"2022"
"72260","510285 CASTANHEIRA",0,0,1,90,0,91,"2022"
"72261","510300 CHAPADA DOS GUIMARAES",1,2,3,238,0,244,"2022"
"72262","510305 CLAUDIA",0,0,1,145,2,148,"2022"
"72263","510310 COCALINHO",0,0,2,64,0,66,"2022"
"72264","510320 COLIDER",2,2,7,509,0,520,"2022"
"72265","510325 COLNIZA",1,0,8,417,0,426,"2022"
"72266","510330 COMODORO",2,2,6,324,3,337,"2022"
"72267","510335 CONFRESA",4,4,5,713,3,729,"2022"
"72268","510336 CONQUISTA D'OESTE",0,0,1,60,0,61,"2022"
"72269","510337 COTRIGUACU",0,0,2,169,0,171,"2022"
"72270","510340 CUIABA",22,13,115,9380,5,9535,"2022"
"72271","510343 CURVELANDIA",0,0,0,55,2,57,"2022"
"72272","510345 DENISE",0,0,2,82,0,84,"2022"
"72273","510350 DIAMANTINO",1,0,2,363,1,367,"2022"
"72274","510360 DOM AQUINO",0,0,1,72,0,73,"2022"
"72275","510370 FELIZ NATAL",1,0,1,183,5,190,"2022"
"72276","510380 FIGUEIROPOLIS D'OESTE",0,0,0,22,0,22,"2022"
"72277","510385 GAUCHA DO NORTE",1,2,1,168,10,182,"2022"
"72278","510390 GENERAL CARNEIRO",0,1,3,144,8,156,"2022"
"72279","510395 GLORIA D'OESTE",0,0,1,22,0,23,"2022"
"72280","510410 GUARANTA DO NORTE",1,3,12,543,1,560,"2022"
"72281","510420 GUIRATINGA",0,1,1,85,1,88,"2022"
"72282","510450 INDIAVAI",0,0,0,36,0,36,"2022"
"72283","510452 IPIRANGA DO NORTE",0,0,4,127,0,131,"2022"
"72284","510454 ITANHANGA",1,0,0,122,0,123,"2022"
"72285","510455 ITAUBA",1,0,1,79,0,81,"2022"
"72286","510460 ITIQUIRA",1,0,2,144,1,148,"2022"
"72287","510480 JACIARA",0,2,2,405,2,411,"2022"
"72288","510490 JANGADA",0,1,0,95,0,96,"2022"
"72289","510500 JAURU",0,1,1,107,0,109,"2022"
"72290","510510 JUARA",2,0,4,631,1,638,"2022"
"72291","510515 JUINA",3,1,9,689,13,715,"2022"
"72292","510517 JURUENA",0,1,3,182,0,186,"2022"
"72293","510520 JUSCIMEIRA",0,2,1,111,0,114,"2022"
"72294","510523 LAMBARI D'OESTE",0,1,0,62,0,63,"2022"
"72295","510525 LUCAS DO RIO VERDE",3,4,13,1526,3,1549,"2022"
"72296","510530 LUCIARA",0,0,1,35,0,36,"2022"
"72297","510550 VILA BELA DA SANTISSIMA TRINDADE",0,2,4,299,4,309,"2022"
"72298","510558 MARCELANDIA",1,1,4,225,13,244,"2022"
"72299","510560 MATUPA",1,3,8,350,0,362,"2022"
"72300","510562 MIRASSOL D'OESTE",0,1,15,410,0,426,"2022"
"72301","510590 NOBRES",1,1,5,259,0,266,"2022"
"72302","510600 NORTELANDIA",0,0,0,91,0,91,"2022"
"72303","510610 NOSSA SENHORA DO LIVRAMENTO",0,0,0,114,0,114,"2022"
"72304","510615 NOVA BANDEIRANTES",0,0,0,221,0,221,"2022"
"72305","510617 NOVA NAZARE",0,0,1,76,34,111,"2022"
"72306","510618 NOVA LACERDA",1,1,1,103,1,107,"2022"
"72307","510619 NOVA SANTA HELENA",0,1,1,69,0,71,"2022"
"72308","510620 NOVA BRASILANDIA",0,0,2,38,0,40,"2022"
"72309","510621 NOVA CANAA DO NORTE",0,2,1,162,0,165,"2022"
"72310","510622 NOVA MUTUM",6,4,13,1023,3,1049,"2022"
"72311","510623 NOVA OLIMPIA",0,0,4,217,0,221,"2022"
"72312","510624 NOVA UBIRATA",0,1,3,227,1,232,"2022"
"72313","510625 NOVA XAVANTINA",1,1,4,322,0,328,"2022"
"72314","510626 NOVO MUNDO",0,1,0,117,0,118,"2022"
"72315","510627 NOVO HORIZONTE DO NORTE",0,1,0,46,0,47,"2022"
"72316","510628 NOVO SAO JOAQUIM",0,3,3,105,1,112,"2022"
"72317","510629 PARANAITA",0,0,1,178,0,179,"2022"
"72318","510630 PARANATINGA",4,3,12,388,15,422,"2022"
"72319","510631 NOVO SANTO ANTONIO",0,1,0,30,0,31,"2022"
"72320","510637 PEDRA PRETA",3,0,4,216,3,226,"2022"
"72321","510642 PEIXOTO DE AZEVEDO",4,3,8,620,4,639,"2022"
"72322","510645 PLANALTO DA SERRA",0,0,0,46,0,46,"2022"
"72323","510650 POCONE",1,0,7,475,1,484,"2022"
"72324","510665 PONTAL DO ARAGUAIA",0,0,0,82,0,82,"2022"
"72325","510670 PONTE BRANCA",0,0,0,16,0,16,"2022"
"72326","510675 PONTES E LACERDA",3,2,10,837,1,853,"2022"
"72327","510677 PORTO ALEGRE DO NORTE",1,1,4,190,0,196,"2022"
"72328","510680 PORTO DOS GAUCHOS",0,0,1,88,0,89,"2022"
"72329","510682 PORTO ESPERIDIAO",1,3,2,161,2,169,"2022"
"72330","510685 PORTO ESTRELA",0,0,0,33,0,33,"2022"
"72331","510700 POXOREO",0,0,1,217,4,222,"2022"
"72332","510704 PRIMAVERA DO LESTE",2,3,23,1486,0,1514,"2022"
"72333","510706 QUERENCIA",0,0,5,538,9,552,"2022"
"72334","510710 SAO JOSE DOS QUATRO MARCOS",2,0,4,197,0,203,"2022"
"72335","510715 RESERVA DO CABACAL",0,0,1,21,0,22,"2022"
"72336","510718 RIBEIRAO CASCALHEIRA",0,0,1,139,22,162,"2022"
"72337","510719 RIBEIRAOZINHO",0,1,0,15,0,16,"2022"
"72338","510720 RIO BRANCO",0,0,2,61,0,63,"2022"
"72339","510724 SANTA CARMEM",0,0,1,96,0,97,"2022"
"72340","510726 SANTO AFONSO",0,0,0,29,1,30,"2022"
"72341","510729 SAO JOSE DO POVO",0,0,0,16,1,17,"2022"
"72342","510730 SAO JOSE DO RIO CLARO",0,0,3,227,1,231,"2022"
"72343","510735 SAO JOSE DO XINGU",0,1,1,121,3,126,"2022"
"72344","510740 SAO PEDRO DA CIPA",0,0,1,50,0,51,"2022"
"72345","510757 RONDOLANDIA",1,0,0,37,0,38,"2022"
"72346","510760 RONDONOPOLIS",16,7,66,3662,7,3758,"2022"
"72347","510770 ROSARIO OESTE",0,0,1,177,0,178,"2022"
"72348","510774 SANTA CRUZ DO XINGU",0,0,0,37,0,37,"2022"
"72349","510775 SALTO DO CEU",0,0,0,60,0,60,"2022"
"72350","510776 SANTA RITA DO TRIVELATO",0,0,0,50,0,50,"2022"
"72351","510777 SANTA TEREZINHA",0,0,1,101,0,102,"2022"
"72352","510779 SANTO ANTONIO DO LESTE",0,0,0,62,10,72,"2022"
"72353","510780 SANTO ANTONIO DO LEVERGER",0,0,0,232,0,232,"2022"
"72354","510785 SAO FELIX DO ARAGUAIA",0,1,3,129,5,138,"2022"
"72355","510787 SAPEZAL",1,6,9,594,2,612,"2022"
"72356","510788 SERRA NOVA DOURADA",1,0,1,26,0,28,"2022"
"72357","510790 SINOP",6,3,29,3483,24,3545,"2022"
"72358","510792 SORRISO",1,4,23,2060,2,2090,"2022"
"72359","510794 TABAPORA",0,0,1,184,0,185,"2022"
"72360","510795 TANGARA DA SERRA",4,6,28,1688,3,1729,"2022"
"72361","510800 TAPURAH",0,0,3,248,0,251,"2022"
"72362","510805 TERRA NOVA DO NORTE",1,1,1,167,0,170,"2022"
"72363","510810 TESOURO",0,0,0,50,0,50,"2022"
"72364","510820 TORIXOREU",0,0,0,34,1,35,"2022"
"72365","510830 UNIAO DO SUL",0,0,0,73,0,73,"2022"
"72366","510835 VALE DE SAO DOMINGOS",0,0,0,39,0,39,"2022"
"72367","510840 VARZEA GRANDE",9,21,48,4464,23,4565,"2022"
"72368","510850 VERA",0,0,1,145,0,146,"2022"
"72369","510860 VILA RICA",3,0,9,275,3,290,"2022"
"72370","510880 NOVA GUARITA",0,0,0,68,0,68,"2022"
"72371","510885 NOVA MARILANDIA",1,0,0,49,0,50,"2022"
"72372","510890 NOVA MARINGA",0,0,2,84,0,86,"2022"
"72373","510895 NOVA MONTE VERDE",0,1,1,123,1,126,"2022"
"72374","MUNICIPIO IGNORADO - GO",0,0,0,4,1,5,"2022"
"72375","520005 ABADIA DE GOIAS",0,2,4,256,0,262,"2022"
"72376","520010 ABADIANIA",0,2,5,204,1,212,"2022"
"72377","520013 ACREUNA",1,0,50,184,2,237,"2022"
"72378","520015 ADELANDIA",0,1,0,28,0,29,"2022"
"72379","520017 AGUA FRIA DE GOIAS",0,0,2,50,0,52,"2022"
"72380","520020 AGUA LIMPA",0,0,0,16,0,16,"2022"
"72381","520025 AGUAS LINDAS DE GOIAS",10,19,59,2996,42,3126,"2022"
"72382","520030 ALEXANIA",0,2,8,385,6,401,"2022"
"72383","520050 ALOANDIA",0,0,0,18,0,18,"2022"
"72384","520055 ALTO HORIZONTE",0,0,1,100,0,101,"2022"
"72385","520060 ALTO PARAISO DE GOIAS",1,0,3,151,2,157,"2022"
"72386","520080 ALVORADA DO NORTE",0,0,2,102,0,104,"2022"
"72387","520082 AMARALINA",0,0,0,19,0,19,"2022"
"72388","520085 AMERICANO DO BRASIL",0,0,1,85,0,86,"2022"
"72389","520090 AMORINOPOLIS",0,0,1,24,0,25,"2022"
"72390","520110 ANAPOLIS",12,19,110,5556,23,5720,"2022"
"72391","520120 ANHANGUERA",0,0,0,9,0,9,"2022"
"72392","520130 ANICUNS",0,0,4,215,1,220,"2022"
"72393","520140 APARECIDA DE GOIANIA",24,20,81,6656,38,6819,"2022"
"72394","520145 APARECIDA DO RIO DOCE",0,0,0,30,0,30,"2022"
"72395","520150 APORE",0,0,1,70,0,71,"2022"
"72396","520160 ARACU",0,0,0,35,1,36,"2022"
"72397","520170 ARAGARCAS",0,0,3,193,1,197,"2022"
"72398","520180 ARAGOIANIA",0,0,0,133,1,134,"2022"
"72399","520215 ARAGUAPAZ",0,1,0,44,0,45,"2022"
"72400","520235 ARENOPOLIS",0,0,0,38,1,39,"2022"
"72401","520250 ARUANA",1,1,0,97,0,99,"2022"
"72402","520260 AURILANDIA",1,0,1,25,0,27,"2022"
"72403","520280 AVELINOPOLIS",0,0,1,34,0,35,"2022"
"72404","520310 BALIZA",0,0,1,30,0,31,"2022"
"72405","520320 BARRO ALTO",1,3,9,144,0,157,"2022"
"72406","520330 BELA VISTA DE GOIAS",0,2,5,422,0,429,"2022"
"72407","520340 BOM JARDIM DE GOIAS",0,1,0,93,0,94,"2022"
"72408","520350 BOM JESUS DE GOIAS",0,0,1,302,1,304,"2022"
"72409","520355 BONFINOPOLIS",0,0,0,110,0,110,"2022"
"72410","520357 BONOPOLIS",0,0,0,46,0,46,"2022"
"72411","520360 BRAZABRANTES",0,0,0,47,0,47,"2022"
"72412","520380 BRITANIA",2,0,1,78,0,81,"2022"
"72413","520390 BURITI ALEGRE",0,0,3,106,2,111,"2022"
"72414","520393 BURITI DE GOIAS",0,0,0,26,0,26,"2022"
"72415","520396 BURITINOPOLIS",0,0,1,36,0,37,"2022"
"72416","520400 CABECEIRAS",1,0,1,98,1,101,"2022"
"72417","520410 CACHOEIRA ALTA",0,1,3,104,0,108,"2022"
"72418","520420 CACHOEIRA DE GOIAS",0,0,0,14,0,14,"2022"
"72419","520425 CACHOEIRA DOURADA",0,0,1,39,1,41,"2022"
"72420","520430 CACU",0,0,2,138,0,140,"2022"
"72421","520440 CAIAPONIA",1,1,4,169,0,175,"2022"
"72422","520450 CALDAS NOVAS",3,6,11,1211,3,1234,"2022"
"72423","520455 CALDAZINHA",0,0,0,32,0,32,"2022"
"72424","520460 CAMPESTRE DE GOIAS",0,0,1,47,0,48,"2022"
"72425","520465 CAMPINACU",0,0,0,34,0,34,"2022"
"72426","520470 CAMPINORTE",0,0,4,148,0,152,"2022"
"72427","520480 CAMPO ALEGRE DE GOIAS",1,1,2,78,0,82,"2022"
"72428","520485 CAMPO LIMPO DE GOIAS",0,2,1,122,0,125,"2022"
"72429","520490 CAMPOS BELOS",3,3,6,267,0,279,"2022"
"72430","520495 CAMPOS VERDES",0,0,1,40,0,41,"2022"
"72431","520500 CARMO DO RIO VERDE",0,1,1,83,0,85,"2022"
"72432","520505 CASTELANDIA",0,0,1,28,1,30,"2022"
"72433","520510 CATALAO",5,6,19,1364,2,1396,"2022"
"72434","520520 CATURAI",1,0,1,51,1,54,"2022"
"72435","520530 CAVALCANTE",0,1,4,139,2,146,"2022"
"72436","520540 CERES",0,0,1,237,0,238,"2022"
"72437","520545 CEZARINA",0,0,1,97,0,98,"2022"
"72438","520547 CHAPADAO DO CEU",0,1,4,223,2,230,"2022"
"72439","520549 CIDADE OCIDENTAL",6,4,17,1148,7,1182,"2022"
"72440","520551 COCALZINHO DE GOIAS",0,2,4,215,1,222,"2022"
"72441","520552 COLINAS DO SUL",0,0,2,33,0,35,"2022"
"72442","520570 CORREGO DO OURO",0,0,1,18,0,19,"2022"
"72443","520580 CORUMBA DE GOIAS",0,0,3,89,0,92,"2022"
"72444","520590 CORUMBAIBA",0,0,0,106,0,106,"2022"
"72445","520620 CRISTALINA",1,0,9,946,14,970,"2022"
"72446","520630 CRISTIANOPOLIS",0,0,1,34,0,35,"2022"
"72447","520640 CRIXAS",1,0,1,204,0,206,"2022"
"72448","520650 CROMINIA",0,0,0,28,0,28,"2022"
"72449","520660 CUMARI",0,0,0,22,0,22,"2022"
"72450","520670 DAMIANOPOLIS",0,0,0,50,0,50,"2022"
"72451","520680 DAMOLANDIA",0,0,0,30,0,30,"2022"
"72452","520690 DAVINOPOLIS",0,0,0,21,0,21,"2022"
"72453","520710 DIORAMA",0,0,0,20,0,20,"2022"
"72454","520725 DOVERLANDIA",0,1,2,75,0,78,"2022"
"72455","520735 EDEALINA",0,0,0,29,0,29,"2022"
"72456","520740 EDEIA",0,1,1,142,0,144,"2022"
"72457","520750 ESTRELA DO NORTE",0,0,1,34,0,35,"2022"
"72458","520753 FAINA",0,0,1,53,0,54,"2022"
"72459","520760 FAZENDA NOVA",0,0,0,58,1,59,"2022"
"72460","520780 FIRMINOPOLIS",0,2,2,95,0,99,"2022"
"72461","520790 FLORES DE GOIAS",0,0,1,94,2,97,"2022"
"72462","520800 FORMOSA",8,3,29,1563,9,1612,"2022"
"72463","520810 FORMOSO",0,2,4,47,0,53,"2022"
"72464","520815 GAMELEIRA DE GOIAS",0,0,0,25,0,25,"2022"
"72465","520830 DIVINOPOLIS DE GOIAS",0,0,1,68,3,72,"2022"
"72466","520840 GOIANAPOLIS",0,0,3,171,2,176,"2022"
"72467","520850 GOIANDIRA",0,0,0,47,0,47,"2022"
"72468","520860 GOIANESIA",4,1,35,954,1,995,"2022"
"72469","520870 GOIANIA",70,33,221,18317,44,18685,"2022"
"72470","520880 GOIANIRA",4,2,14,885,2,907,"2022"
"72471","520890 GOIAS",1,0,1,227,1,230,"2022"
"72472","520910 GOIATUBA",0,0,1,397,1,399,"2022"
"72473","520915 GOUVELANDIA",0,0,0,53,0,53,"2022"
"72474","520920 GUAPO",1,2,3,216,1,223,"2022"
"72475","520929 GUARAITA",0,0,0,16,0,16,"2022"
"72476","520940 GUARANI DE GOIAS",0,0,2,39,0,41,"2022"
"72477","520945 GUARINOS",0,0,1,24,0,25,"2022"
"72478","520960 HEITORAI",0,0,0,21,0,21,"2022"
"72479","520970 HIDROLANDIA",1,0,6,335,2,344,"2022"
"72480","520980 HIDROLINA",0,0,0,33,0,33,"2022"
"72481","520990 IACIARA",1,1,4,183,0,189,"2022"
"72482","520993 INACIOLANDIA",0,1,0,58,0,59,"2022"
"72483","520995 INDIARA",0,0,2,181,0,183,"2022"
"72484","521000 INHUMAS",3,0,14,551,0,568,"2022"
"72485","521010 IPAMERI",0,1,7,246,0,254,"2022"
"72486","521015 IPIRANGA DE GOIAS",0,0,0,20,0,20,"2022"
"72487","521020 IPORA",0,1,5,440,0,446,"2022"
"72488","521030 ISRAELANDIA",0,0,0,15,0,15,"2022"
"72489","521040 ITABERAI",1,2,7,523,0,533,"2022"
"72490","521056 ITAGUARI",0,0,1,37,0,38,"2022"
"72491","521060 ITAGUARU",0,0,0,35,0,35,"2022"
"72492","521080 ITAJA",0,0,0,53,0,53,"2022"
"72493","521090 ITAPACI",0,1,4,250,0,255,"2022"
"72494","521100 ITAPIRAPUA",0,0,0,69,0,69,"2022"
"72495","521120 ITAPURANGA",0,1,2,317,0,320,"2022"
"72496","521130 ITARUMA",0,0,0,81,0,81,"2022"
"72497","521140 ITAUCU",2,0,1,74,1,78,"2022"
"72498","521150 ITUMBIARA",3,3,9,1153,5,1173,"2022"
"72499","521160 IVOLANDIA",0,0,0,24,0,24,"2022"
"72500","521170 JANDAIA",0,2,0,48,0,50,"2022"
"72501","521180 JARAGUA",0,5,6,539,0,550,"2022"
"72502","521190 JATAI",2,2,13,1409,0,1426,"2022"
"72503","521200 JAUPACI",0,0,0,32,0,32,"2022"
"72504","521205 JESUPOLIS",0,0,0,21,0,21,"2022"
"72505","521210 JOVIANIA",0,0,0,101,0,101,"2022"
"72506","521220 JUSSARA",0,2,1,234,0,237,"2022"
"72507","521225 LAGOA SANTA",0,0,0,17,0,17,"2022"
"72508","521230 LEOPOLDO DE BULHOES",0,0,1,89,1,91,"2022"
"72509","521250 LUZIANIA",5,12,51,2811,36,2915,"2022"
"72510","521260 MAIRIPOTABA",0,0,0,19,0,19,"2022"
"72511","521270 MAMBAI",0,1,1,143,0,145,"2022"
"72512","521280 MARA ROSA",0,0,1,118,1,120,"2022"
"72513","521290 MARZAGAO",0,1,0,40,0,41,"2022"
"72514","521295 MATRINCHA",0,0,0,40,0,40,"2022"
"72515","521300 MAURILANDIA",1,0,0,129,0,130,"2022"
"72516","521305 MIMOSO DE GOIAS",0,0,1,14,1,16,"2022"
"72517","521308 MINACU",0,0,1,343,0,344,"2022"
"72518","521310 MINEIROS",0,2,8,1040,0,1050,"2022"
"72519","521340 MOIPORA",0,0,0,21,0,21,"2022"
"72520","521350 MONTE ALEGRE DE GOIAS",0,1,4,110,0,115,"2022"
"72521","521370 MONTES CLAROS DE GOIAS",0,1,1,86,1,89,"2022"
"72522","521375 MONTIVIDIU",1,0,3,156,1,161,"2022"
"72523","521377 MONTIVIDIU DO NORTE",0,0,0,43,0,43,"2022"
"72524","521380 MORRINHOS",3,1,3,612,1,620,"2022"
"72525","521385 MORRO AGUDO DE GOIAS",0,0,0,26,0,26,"2022"
"72526","521390 MOSSAMEDES",0,0,0,31,1,32,"2022"
"72527","521400 MOZARLANDIA",2,0,1,261,1,265,"2022"
"72528","521405 MUNDO NOVO",0,0,1,86,0,87,"2022"
"72529","521410 MUTUNOPOLIS",0,1,0,51,0,52,"2022"
"72530","521440 NAZARIO",0,1,0,84,0,85,"2022"
"72531","521450 NEROPOLIS",1,0,8,432,1,442,"2022"
"72532","521460 NIQUELANDIA",0,0,1,377,0,378,"2022"
"72533","521470 NOVA AMERICA",0,0,1,14,0,15,"2022"
"72534","521480 NOVA AURORA",0,0,1,21,0,22,"2022"
"72535","521483 NOVA CRIXAS",0,0,0,177,0,177,"2022"
"72536","521486 NOVA GLORIA",0,0,1,84,0,85,"2022"
"72537","521487 NOVA IGUACU DE GOIAS",1,0,0,37,0,38,"2022"
"72538","521490 NOVA ROMA",0,0,1,28,0,29,"2022"
"72539","521500 NOVA VENEZA",1,1,2,113,0,117,"2022"
"72540","521520 NOVO BRASIL",0,0,0,36,0,36,"2022"
"72541","521523 NOVO GAMA",5,4,34,1239,14,1296,"2022"
"72542","521525 NOVO PLANALTO",0,0,1,39,0,40,"2022"
"72543","521530 ORIZONA",0,0,4,194,0,198,"2022"
"72544","521540 OURO VERDE DE GOIAS",0,0,2,40,0,42,"2022"
"72545","521550 OUVIDOR",0,0,1,88,0,89,"2022"
"72546","521560 PADRE BERNARDO",2,3,4,425,1,435,"2022"
"72547","521565 PALESTINA DE GOIAS",0,0,0,40,0,40,"2022"
"72548","521570 PALMEIRAS DE GOIAS",1,1,4,447,2,455,"2022"
"72549","521580 PALMELO",0,0,1,17,0,18,"2022"
"72550","521590 PALMINOPOLIS",0,0,0,41,0,41,"2022"
"72551","521600 PANAMA",0,0,0,16,0,16,"2022"
"72552","521630 PARANAIGUARA",0,1,0,88,0,89,"2022"
"72553","521640 PARAUNA",0,1,2,151,0,154,"2022"
"72554","521645 PEROLANDIA",0,1,0,36,0,37,"2022"
"72555","521680 PETROLINA DE GOIAS",0,0,2,77,1,80,"2022"
"72556","521690 PILAR DE GOIAS",1,0,0,25,0,26,"2022"
"72557","521710 PIRACANJUBA",0,0,2,233,1,236,"2022"
"72558","521720 PIRANHAS",0,0,6,101,0,107,"2022"
"72559","521730 PIRENOPOLIS",0,2,6,289,2,299,"2022"
"72560","521740 PIRES DO RIO",1,3,2,397,0,403,"2022"
"72561","521760 PLANALTINA",2,5,16,1467,18,1508,"2022"
"72562","521770 PONTALINA",1,0,2,193,0,196,"2022"
"72563","521800 PORANGATU",1,5,6,499,3,514,"2022"
"72564","521805 PORTEIRAO",0,0,0,43,0,43,"2022"
"72565","521810 PORTELANDIA",0,0,0,43,1,44,"2022"
"72566","521830 POSSE",1,3,5,484,0,493,"2022"
"72567","521839 PROFESSOR JAMIL",0,0,0,33,0,33,"2022"
"72568","521850 QUIRINOPOLIS",0,2,2,617,0,621,"2022"
"72569","521860 RIALMA",1,1,1,147,0,150,"2022"
"72570","521870 RIANAPOLIS",1,0,0,50,0,51,"2022"
"72571","521878 RIO QUENTE",0,1,1,43,0,45,"2022"
"72572","521880 RIO VERDE",6,9,35,3183,11,3244,"2022"
"72573","521890 RUBIATABA",0,0,0,245,0,245,"2022"
"72574","521900 SANCLERLANDIA",0,0,2,87,0,89,"2022"
"72575","521910 SANTA BARBARA DE GOIAS",0,0,1,57,0,58,"2022"
"72576","521920 SANTA CRUZ DE GOIAS",0,1,0,12,0,13,"2022"
"72577","521925 SANTA FE DE GOIAS",0,0,0,72,0,72,"2022"
"72578","521930 SANTA HELENA DE GOIAS",1,5,3,471,2,482,"2022"
"72579","521935 SANTA ISABEL",0,0,0,40,0,40,"2022"
"72580","521940 SANTA RITA DO ARAGUAIA",1,0,0,70,0,71,"2022"
"72581","521945 SANTA RITA DO NOVO DESTINO",0,0,0,20,0,20,"2022"
"72582","521950 SANTA ROSA DE GOIAS",0,0,0,42,0,42,"2022"
"72583","521960 SANTA TEREZA DE GOIAS",0,0,1,40,0,41,"2022"
"72584","521970 SANTA TEREZINHA DE GOIAS",0,4,1,94,0,99,"2022"
"72585","521971 SANTO ANTONIO DA BARRA",1,0,0,35,0,36,"2022"
"72586","521973 SANTO ANTONIO DE GOIAS",0,0,3,67,0,70,"2022"
"72587","521975 SANTO ANTONIO DO DESCOBERTO",2,5,8,864,5,884,"2022"
"72588","521980 SAO DOMINGOS",1,0,0,108,0,109,"2022"
"72589","521990 SAO FRANCISCO DE GOIAS",0,0,0,64,0,64,"2022"
"72590","522000 SAO JOAO D'ALIANCA",0,0,3,139,1,143,"2022"
"72591","522005 SAO JOAO DA PARAUNA",0,0,0,14,0,14,"2022"
"72592","522010 SAO LUIS DE MONTES BELOS",0,1,7,400,0,408,"2022"
"72593","522015 SAO LUIZ DO NORTE",0,0,1,64,0,65,"2022"
"72594","522020 SAO MIGUEL DO ARAGUAIA",1,2,4,287,0,294,"2022"
"72595","522026 SAO MIGUEL DO PASSA QUATRO",0,1,1,48,0,50,"2022"
"72596","522028 SAO PATRICIO",0,0,0,21,0,21,"2022"
"72597","522040 SAO SIMAO",0,1,1,183,0,185,"2022"
"72598","522045 SENADOR CANEDO",5,11,29,2025,7,2077,"2022"
"72599","522050 SERRANOPOLIS",0,0,0,99,0,99,"2022"
"72600","522060 SILVANIA",0,0,1,257,0,258,"2022"
"72601","522068 SIMOLANDIA",1,0,0,73,0,74,"2022"
"72602","522070 SITIO D'ABADIA",0,0,3,32,0,35,"2022"
"72603","522100 TAQUARAL DE GOIAS",0,0,1,31,0,32,"2022"
"72604","522108 TERESINA DE GOIAS",0,0,1,41,0,42,"2022"
"72605","522119 TEREZOPOLIS DE GOIAS",0,0,3,97,0,100,"2022"
"72606","522130 TRES RANCHOS",0,0,0,23,0,23,"2022"
"72607","522140 TRINDADE",6,10,21,1738,7,1782,"2022"
"72608","522145 TROMBAS",0,0,0,37,1,38,"2022"
"72609","522150 TURVANIA",0,0,0,45,0,45,"2022"
"72610","522155 TURVELANDIA",1,0,0,54,0,55,"2022"
"72611","522157 UIRAPURU",1,0,3,31,0,35,"2022"
"72612","522160 URUACU",3,3,12,513,0,531,"2022"
"72613","522170 URUANA",0,0,0,121,0,121,"2022"
"72614","522180 URUTAI",0,1,0,31,0,32,"2022"
"72615","522185 VALPARAISO DE GOIAS",4,13,40,2245,18,2320,"2022"
"72616","522190 VARJAO",0,0,0,33,1,34,"2022"
"72617","522200 VIANOPOLIS",1,0,1,168,0,170,"2022"
"72618","522205 VICENTINOPOLIS",0,3,0,118,0,121,"2022"
"72619","522220 VILA BOA",0,0,2,38,0,40,"2022"
"72620","522230 VILA PROPICIO",0,0,4,69,0,73,"2022"
"72621","530010 BRASILIA",132,128,513,35016,139,35928,"2022"
